,user,trd_times,total_count,B_out,C_in,out_count,in_count
0,U20440,8671,-19250.880000000037,8146,525,5063044.37,5043793.49
1,U10881,4379,-15735.62999999742,4293,86,599398.270000013,583662.6400000156
2,U42153,3023,50458.280000000144,2498,525,2474831.7300000004,2525290.0100000007
3,U19071,2671,-223398.51000000018,2138,533,7168370.949999999,6944972.4399999995
4,U31428,2239,218.58000000001135,986,1253,4699039.849999999,4699258.429999999
5,U1175333,1891,228.84000000002038,1220,671,1692180.8400000005,1692409.6800000006
6,U19556,1862,0.479999999816755,304,1558,2414665.3600000003,2414665.8400000003
7,U42451,1817,-60537.35000000022,1614,203,1866594.5100000096,1806057.1600000092
8,U20312,1816,-15481.689999999944,1667,149,1316517.5699999945,1301035.8799999945
9,U26506,1741,-43828.799999999814,1419,322,6047631.629999999,6003802.829999999
10,U21425,1719,-503.5099999999936,1714,5,13915.969999999948,13412.459999999955
11,U43309,1714,20949.28000000005,364,1350,3963643.33,3984592.6100000003
12,U31655,1708,38017.13000000005,1313,395,1519880.4800000004,1557897.6100000006
13,U17064,1660,367967.97000000055,1358,302,12815715.38,13183683.350000001
14,U687224,1587,-14167.280000000714,1063,524,215452.78000000003,201285.4999999993
15,U1281200,1510,-761.259999999767,1088,422,1177389.0700000005,1176627.8100000008
16,U27471,1508,-1949416.1599999908,321,1187,172068302.48999998,170118886.32999998
17,U42462,1488,7901.600000000039,1329,159,463385.87000000017,471287.4700000002
18,U24518,1451,5919.4299999997265,420,1031,753730.2299999997,759649.6599999995
19,U43409,1385,5251.540000000101,1169,216,1736528.8499999996,1741780.3899999997
20,U32708,1375,97065.15000000014,1287,88,2781526.6899999995,2878591.84
21,U18250,1355,96353.04000000349,1266,89,622140.8600000136,718493.9000000171
22,U13866,1346,23541.499999675034,608,738,327725935.9299998,327749477.42999953
23,U10249,1321,12001.710000001096,674,647,38406411.5,38418413.21
24,U22595,1315,132038.30999999997,1190,125,809287.5700000009,941325.8800000008
25,U38564,1306,62963.46000000043,1041,265,19503875.740000013,19566839.200000014
26,U32479,1305,-4945.88999999686,409,896,3184096.5300000017,3179150.640000005
27,U711263,1270,600.010000000002,918,352,71465.12999999999,72065.13999999998
28,U581683,1255,1639.0500000000075,704,551,396139.25999999983,397778.3099999998
29,U25890,1251,1045085.8599999996,558,693,1712073.6699999997,2757159.5299999993
30,U707020,1227,-1061.6499999999646,835,392,681557.4000000001,680495.7500000002
31,U892952,1210,-168.73999999999467,718,492,74716.85,74548.11000000002
32,U20566,1209,-1361.7999999998992,394,815,1258403.2699999998,1257041.47
33,U11188,1206,580.9999999999959,945,261,556357.89,556938.89
34,U14256,1200,450995.7000000002,339,861,2199106.5900000003,2650102.2900000005
35,U16529,1172,-46133.209999996994,621,551,60316237.38000001,60270104.17000002
36,U29428,1167,-533508.6400000002,972,195,1504308.5499999984,970799.9099999982
37,U13708,1128,27537.539999999964,1048,80,3628222.819999991,3655760.359999991
38,U23105,1124,249540.92999999985,1037,87,5303694.199999997,5553235.129999997
39,U14417,1098,-24833.900000001555,112,986,2231953.0,2207119.099999998
40,U11398,1090,13796.840000000013,1006,84,791291.6300000001,805088.4700000001
41,U18737,1082,-109451.16999999978,864,218,4235710.24,4126259.0700000003
42,U11014,1081,-4616.00000000002,704,377,1166625.9699999997,1162009.9699999997
43,U38074,1077,428095.53999999876,970,107,5242793.879999995,5670889.419999994
44,U30847,1076,3347790.199999999,386,690,6441200.35,9788990.549999999
45,U21589,1053,17.050000000032014,853,200,1668878.74,1668895.79
46,U17413,1049,-17603.580000000635,662,387,55935419.569999956,55917815.98999996
47,U40999,1046,-7131.59,750,296,964470.7100000001,957339.1200000001
48,U31211,1042,17316.36999999997,1006,36,424783.43000000017,442099.80000000016
49,U637347,1031,-4553.559999999999,627,404,44297.10000000001,39743.540000000015
50,U851605,1022,2915.9499999999825,644,378,1918851.199999999,1921767.149999999
51,U8453,1017,-2421.2499999999995,627,390,570690.1900000008,568268.9400000008
52,U42913,1006,69103.19000000015,400,606,3301851.89,3370955.08
53,U14274,993,-27461.789999999964,946,47,733804.14,706342.3500000001
54,U30810,987,681.7600000000015,667,320,79299.72,79981.48
55,U12931,976,19593.109999999997,381,595,994240.3700000002,1013833.4800000002
56,U8142,974,-2322.250000000117,363,611,1535655.9100000001,1533333.66
57,U29775,972,-131418.09999999998,960,12,255400.53000000003,123982.43000000005
58,U18897,966,15211.870000000023,240,726,759436.9299999996,774648.7999999996
59,U896497,959,456.3899999999993,497,462,29501.38,29957.77
60,U35415,950,-7437.590000000006,730,220,857644.7000000004,850207.1100000005
61,U11287,946,18109.850000000006,681,265,742194.0300000001,760303.8800000001
62,U36900,937,-11875.240000000014,913,24,221565.02000000008,209689.78000000006
63,U38301,930,-2312.0900000000656,640,290,1070383.6700000002,1068071.58
64,U13931,917,-100761.06999999953,560,357,24785132.370000128,24684371.300000127
65,U33213,916,-3053.050000000036,770,146,408712.54999999993,405659.4999999999
66,U43535,916,92376.77999999996,361,555,1899556.5200000005,1991933.3000000005
67,U35377,913,18798.18999999872,414,499,7072771.38,7091569.569999998
68,U10609,911,300.83999999995194,615,296,926788.7900000002,927089.6300000001
69,U20726,908,4480.400000000043,816,92,414456.8699999996,418937.2699999996
70,U622273,908,6131.130000000013,519,389,285102.03,291233.16000000003
71,U31658,878,33942.70000000026,255,623,790554.3199999998,824497.0200000001
72,U12406,875,-303904.02999999933,847,28,697260.9900000019,393356.9600000025
73,U33087,871,3972.6599999999903,681,190,134271.0600000003,138243.7200000003
74,U13145,870,-113.84999999993306,420,450,617183.9099999998,617070.0599999998
75,U872868,868,840.140000000014,513,355,5731656.029999999,5732496.169999999
76,U28293,857,38137.57000000002,727,130,3898199.9899999998,3936337.5599999996
77,U18309,854,-5090.199999999987,465,389,627656.0299999999,622565.83
78,U8825,853,-11807.019999999986,499,354,907833.3100000002,896026.2900000002
79,U1181701,847,3492.4299999999967,498,349,159653.24,163145.66999999998
80,U19172,843,2786.4299999998475,281,562,1416127.0199999998,1418913.4499999997
81,U28151,841,-3960.2900000000436,155,686,1257092.8100000003,1253132.5200000003
82,U22673,839,-100751.48000000001,772,67,836485.0400000007,735733.5600000008
83,U1310524,837,-414.9899999999976,769,68,24900.180000000004,24485.190000000006
84,U753615,835,5041.68000000002,534,301,387852.00999999995,392893.68999999994
85,U983181,826,370.6599999999962,445,381,332334.37,332705.02999999997
86,U1190164,820,6523.389999999949,420,400,759463.7000000001,765987.09
87,U27699,818,119509.54999999989,734,84,2268720.360000001,2388229.9100000006
88,U11237,818,432.7100000000564,293,525,589098.06,589530.7700000001
89,U32142,815,10056.879999999983,418,397,2828679.4299999997,2838736.3099999996
90,U1132232,815,-3.900000000004269,473,342,71226.24,71222.34
91,U32466,813,2790.609999999966,346,467,2153349.21,2156139.82
92,U1374634,808,-2689.729999999999,483,325,75849.45999999999,73159.73
93,U22134,806,116697.89999999997,550,256,1771406.63,1888104.5299999998
94,U9765,805,1050.9300000000019,490,315,402537.2700000001,403588.20000000007
95,U1274194,801,3812.8099999999763,406,395,1254001.4599999997,1257814.2699999998
96,U9075,796,9115.18000000008,550,246,3691433.380000001,3700548.560000001
97,U12544,796,256690.7199999997,762,34,1916629.1000000003,2173319.82
98,U20011,772,60408.1400000001,548,224,775724.4099999998,836132.5499999999
99,U38866,772,44165.66000000006,430,342,4821194.79,4865360.45
100,U24192,771,126201.49999999997,306,465,4326468.73,4452670.23
101,U14702,769,986.2300000000328,389,380,1970579.7899999996,1971566.0199999996
102,U1187613,769,5302.480000000004,418,351,635067.2699999999,640369.7499999999
103,U8734,767,-923063.5499999998,534,233,4181503.360000001,3258439.810000001
104,U31361,766,5676.770000000085,635,131,331645.2500000008,337322.0200000009
105,U37795,760,12504.060000000229,464,296,3237096.2699999996,3249600.3299999996
106,U24038,759,-3.819999996642764,462,297,15745786.959999997,15745783.14
107,U13121,758,1668052.6199999996,315,443,2795769.190000001,4463821.8100000005
108,U11225,757,32850.52999999994,338,419,5912506.979999999,5945357.509999999
109,U11123,756,-81572.68,670,86,404547.00999999983,322974.32999999984
110,U40183,756,383223.32999999984,196,560,1118931.9100000001,1502155.24
111,U43259,753,-1449.8300000000381,384,369,1927096.8299999998,1925646.9999999998
112,U10637,741,-26690.33000000002,727,14,114711.10999999984,88020.77999999982
113,U34767,740,-71240.27,686,54,439074.89000000013,367834.6200000001
114,U17533,735,21492.490000000536,401,334,7079288.900000001,7100781.3900000015
115,U40301,733,-166545.03999999998,523,210,3386749.8800000004,3220204.8400000003
116,U16398,732,9680.809999999983,609,123,898551.5600000009,908232.3700000008
117,U37015,728,259066.6999999999,425,303,9560513.540000003,9819580.240000002
118,U17167,726,-44767.920000000144,525,201,2344266.0399999856,2299498.1199999857
119,U17807,725,-10483.00000000001,477,248,1043877.4100000001,1033394.4100000001
120,U10569,721,-34303.65000000003,676,45,687311.3899999999,653007.7399999999
121,U10541,720,19439.12999999996,541,179,3361467.1199999996,3380906.2499999995
122,U984620,720,-1259.7900000000009,428,292,492465.92,491206.13
123,U30505,718,3461.6899999999987,440,278,418829.12,422290.81
124,U16376,715,-3064.3299999999776,352,363,1069497.4900000002,1066433.1600000001
125,U40386,713,32819.58000000035,137,576,1603309.2699999998,1636128.85
126,U10719,712,-6352.90000000002,515,197,902194.1000000004,895841.2000000004
127,U979139,711,2735.3400000000056,413,298,213312.56000000003,216047.90000000002
128,U27703,710,3253.0899999999892,171,539,449221.50000000006,452474.59
129,U15462,710,771923.4200000002,257,453,457319.3500000001,1229242.7700000003
130,U14744,709,110449.51999999997,622,87,3050641.690000002,3161091.210000002
131,U23003,708,-9486.850000000071,394,314,3717232.24,3707745.39
132,U32198,708,-48582.349999999205,576,132,3155627.8599999994,3107045.5100000002
133,U18363,707,-22486.850000000395,664,43,1261699.7199999997,1239212.8699999994
134,U1057392,704,-0.8599999999997863,354,350,28677.659999999993,28676.799999999992
135,U18382,704,38009.479999999945,581,123,5473562.270000001,5511571.750000001
136,U13087,703,-142041.44,561,142,1157640.1600000001,1015598.7200000002
137,U18065,701,20.289999999938345,444,257,1138130.4800000002,1138150.7700000003
138,U32305,700,-6904.430000000051,465,235,7566929.629999999,7560025.199999999
139,U15234,699,1921.4700000000105,539,160,299972.25,301893.72000000003
140,U21006,699,2392798.8100000084,677,22,200268518.35,202661317.16
141,U20864,696,-133594.04999999978,420,276,2538877.7799999993,2405283.7299999995
142,U16754,695,17355.050000000043,549,146,817649.2600000002,835004.3100000003
143,U14842,695,-3890.5200000000027,575,120,485158.2299999999,481267.7099999999
144,U14421,692,-14557.719999999974,545,147,458052.3600000009,443494.64000000095
145,U42846,690,26628.38999999998,494,196,245439.77999999985,272068.1699999998
146,U21226,685,132287.6799999998,289,396,753510.0500000003,885797.7300000001
147,U42223,683,-77262.39000000004,525,158,492583.6499999999,415321.2599999999
148,U17601,683,-16244.750000000013,609,74,1666603.9099999992,1650359.1599999992
149,U15515,680,202924.72999999992,431,249,18401143.759999983,18604068.489999983
150,U39568,673,-42319.64999999998,517,156,1092610.2700000003,1050290.6200000003
151,U14097,671,-5870.600000000004,443,228,1605592.170000001,1599721.570000001
152,U27578,670,51056.40000000016,355,315,5522808.8900000015,5573865.290000002
153,U1174606,668,180.4699999999998,506,162,107755.41999999997,107935.88999999997
154,U16927,665,-7235.400000000094,448,217,1287622.86,1280387.46
155,U21682,664,-18575.890000000003,651,13,255692.92,237117.03
156,U18553,662,3330.2900000000686,268,394,406929.32,410259.6100000001
157,U10622,657,-3784.5600000000136,568,89,423897.7100000003,420113.1500000003
158,U24582,656,-108618.8300000004,566,90,5114530.619999999,5005911.789999999
159,U16153,654,-15957.869999999963,494,160,854245.7699999999,838287.8999999999
160,U1378289,652,-16989.579999999976,418,234,363013.53999999986,346023.9599999999
161,U19856,652,355582.02000000014,397,255,17573400.649999995,17928982.669999994
162,U18548,651,-34393.719999999885,472,179,2135611.89,2101218.1700000004
163,U23185,649,170583.20000000007,632,17,162069.70999999996,332652.91000000003
164,U25093,649,39408.48999999987,316,333,982812.66,1022221.1499999999
165,U10432,648,3268.8999999999687,362,286,1254993.1099999999,1258262.0099999998
166,U16921,647,-223254.41999999946,479,168,4400107.229999999,4176852.809999999
167,U22216,644,808496.2100000008,513,131,1853968.2699999998,2662464.4800000004
168,U858055,641,-61.960000000092,308,333,2082380.6799999995,2082318.7199999993
169,U26537,639,13394.810000000049,513,126,1266902.8300000008,1280297.6400000008
170,U25017,639,33906.64,478,161,629178.3799999999,663085.0199999999
171,U1141250,637,10.429999999988457,369,268,490855.2799999998,490865.7099999998
172,U15160,637,269331.99999999994,595,42,451134.0900000001,720466.0900000001
173,U24578,634,31245.160000000316,594,40,298022.0299999999,329267.19000000024
174,U32013,633,-89672.96999999999,602,31,1114035.3700000003,1024362.4000000004
175,U8662,632,3987.1299999999355,589,43,1151096.5900000003,1155083.7200000002
176,U30706,629,-365.7799999999999,253,376,28614.210000000003,28248.430000000004
177,U16899,629,-877746.5799999998,515,114,19857976.179999992,18980229.599999994
178,U29920,629,43838.49000000009,456,173,1856807.8999999992,1900646.3899999992
179,U14709,629,206645.3000000003,499,130,6597295.539999998,6803940.839999999
180,U24810,627,-1196.7999999997082,397,230,6028289.39,6027092.59
181,U43825,624,-991.1499999999988,482,142,77675.22,76684.07
182,U24586,624,13764.88000000002,521,103,2101930.059999999,2115694.939999999
183,U16324,621,-90604.18000000047,590,31,136308.09000000064,45703.91000000016
184,U27835,621,10719.169999999967,461,160,868201.3100000003,878920.4800000002
185,U1340844,619,-2562.189999999995,315,304,117894.59000000003,115332.40000000002
186,U8685,619,-17797.619999999955,438,181,560129.2399999999,542331.6199999999
187,U799657,618,-23.39000000000533,455,163,148477.71,148454.31999999998
188,U13426,617,71219.88000000003,493,124,1505621.7899999998,1576841.67
189,U1375738,617,-435.1200000000007,322,295,88837.73,88402.61
190,U9619,616,4339.029999999991,476,140,383777.25999999983,388116.2899999998
191,U41508,616,20394.549999999945,519,97,1149404.7600000005,1169799.3100000005
192,U36741,615,52927.0,442,173,514071.62999999995,566998.6299999999
193,U33198,615,-69179.02999999514,479,136,22024694.13000002,21955515.100000028
194,U15406,615,-16841.73999999995,408,207,2163240.9700000007,2146399.230000001
195,U11805,615,3856.1400000001436,577,38,1527680.0299999972,1531536.1699999974
196,U26536,613,-18411.40000000001,333,280,1802725.28,1784313.8800000001
197,U34790,613,169901.93000000005,564,49,681017.8700000005,850919.8000000005
198,U40989,612,-356.8199999998833,445,167,1420155.32,1419798.5000000002
199,U38318,609,-75561.81000000001,549,60,1410738.5500000005,1335176.7400000005
200,U42029,609,-4804.119999999981,592,17,788984.8600000001,784180.7400000001
201,U9195,606,26291.81999999999,526,80,173053.54000000004,199345.36000000002
202,U19119,605,-2929.609999999986,422,183,596517.9199999999,593588.3099999999
203,U36619,605,-7679.120000000013,568,37,186063.45999999996,178384.33999999994
204,U27809,605,-7849.760000000021,456,149,1230892.9600000004,1223043.2000000004
205,U41609,605,-96687.98000000004,559,46,295281.0800000002,198593.10000000015
206,U40695,605,28441.24999999996,460,145,1556191.99,1584633.24
207,U23510,604,-179.94000000001597,369,235,1803543.1099999987,1803363.1699999988
208,U991212,603,-1665.0600000000054,334,269,392195.54,390530.48
209,U976539,600,8466.210000000086,391,209,1692844.6700000002,1701310.8800000004
210,U12978,600,-8672.2399999999,358,242,3216093.86,3207421.62
211,U12641,600,-7054.700000000083,551,49,950899.1099999999,943844.4099999998
212,U8886,600,3904.54999999995,504,96,272549.3699999999,276453.9199999998
213,U8203,599,-34372.68000000012,549,50,743638.0700000003,709265.3900000001
214,U9053,599,-2881.2500000002174,172,427,496969.73999999993,494088.4899999997
215,U23428,599,-14922.509999999953,574,25,263342.1599999996,248419.64999999967
216,U17491,599,-157975.62999999995,484,115,6842153.86,6684178.23
217,U18421,599,5368.170000000017,397,202,190607.19000000003,195975.36000000004
218,U20320,598,-272024.1600000002,440,158,12927586.11000001,12655561.95000001
219,U17951,597,-19163.459999999992,501,96,1529774.0300000014,1510610.5700000015
220,U688634,597,246.72000000000023,369,228,61770.23999999998,62016.959999999985
221,U13397,596,-45235.75999999995,518,78,1125635.409999999,1080399.649999999
222,U31859,595,10787.580000000014,561,34,56767.800000000025,67555.38000000003
223,U37146,594,3604.7500000000036,351,243,1023524.9100000003,1027129.6600000003
224,U36192,594,1573.6199999998244,364,230,1036015.5499999998,1037589.1699999997
225,U29506,594,-13639.480000000029,344,250,2085230.4199999992,2071590.9399999992
226,U686233,593,37.32999999999447,328,265,516579.88,516617.21
227,U21821,593,45162.080000000045,423,170,1349859.2000000004,1395021.2800000005
228,U1222346,591,8104.549999999982,318,273,551757.9599999998,559862.5099999998
229,U34360,591,-45388.379999999976,539,52,401940.6800000003,356552.3000000003
230,U25033,590,-40375.469999999994,408,182,99241.84999999996,58866.37999999997
231,U14975,590,-2520.180000000012,402,188,457675.19000000035,455155.01000000036
232,U28456,590,53963.62000000013,207,383,513956.26999999996,567919.8900000001
233,U21205,589,-12994.729999999872,387,202,2022381.4700000004,2009386.7400000005
234,U20146,589,57604.48000000002,372,217,1117511.8,1175116.28
235,U1367271,589,2189.810000000003,330,259,301088.67,303278.48
236,U34422,589,35995.87999999954,461,128,1003503.8999999997,1039499.7799999992
237,U32785,586,-30088.120000000035,341,245,1051164.93,1021076.8099999999
238,U23920,585,-821897.6999999993,116,469,3677289.4599999995,2855391.7600000002
239,U37611,585,3144.32,422,163,334969.80999999994,338114.12999999995
240,U23097,583,36652.039999999986,483,100,385092.2699999999,421744.3099999999
241,U31330,583,10761.430000000033,426,157,797759.4900000003,808520.9200000004
242,U10169,582,120868.60999999946,496,86,6115148.590000002,6236017.200000001
243,U8133,582,-107401.87,462,120,656218.3400000001,548816.4700000001
244,U27046,581,23117.560000000023,331,250,2662318.47,2685436.0300000003
245,U15671,580,9690.269999999759,356,224,4297415.0,4307105.27
246,U33157,579,3240.3299999999444,341,238,1535066.7100000002,1538307.04
247,U25006,579,65132.62000000008,539,40,199963.54999999993,265096.17000000004
248,U23309,578,-187778.56,365,213,7957698.640000001,7769920.080000001
249,U17191,577,-173632.8899999992,532,45,8109842.959999999,7936210.07
250,U13288,576,60940.82000000001,436,140,1319110.5899999999,1380051.41
251,U13422,576,-8644.890000000101,557,19,2097460.07,2088815.1799999997
252,U30757,574,28.12000000018088,311,263,1783476.85,1783504.9700000002
253,U16132,571,67508.6300000018,342,229,6333612.979999993,6401121.609999995
254,U11907,571,-32605.72,529,42,149492.25999999983,116886.53999999983
255,U41389,570,-5201.450000000005,490,80,133477.0,128275.54999999999
256,U16293,569,208847.96000000008,495,74,1883975.2400000007,2092823.2000000007
257,U8945,569,-135456.96999999997,549,20,164986.12999999998,29529.160000000003
258,U12790,568,6035.8800000000165,332,236,143645.40000000005,149681.28000000006
259,U12667,568,1864.8999999999455,521,47,850399.7900000002,852264.6900000001
260,U16025,568,-18085.109999999986,150,418,497274.38,479189.27
261,U11340,568,-9039.040000000014,429,139,100213.76,91174.71999999999
262,U37576,567,287.7800000000152,472,95,740962.0599999998,741249.8399999999
263,U34004,567,37656.489999999794,406,161,2365633.299999994,2403289.789999994
264,U23360,566,-40965.45000000003,521,45,207174.84999999986,166209.39999999982
265,U14377,565,-6947.289999999888,559,6,72731.3699999999,65784.08
266,U17030,565,-6326693.880000006,517,48,7098312.7100000065,771618.8300000001
267,U9762,565,937.9400000001151,333,232,6100409.269999997,6101347.209999997
268,U16888,565,-517886.4100000004,391,174,8279030.72,7761144.31
269,U40250,564,262054.37,524,40,1042998.7700000006,1305053.1400000006
270,U21134,564,-5172.16,513,51,411568.82000000007,406396.6600000001
271,U16923,562,38533.39000000002,470,92,2641339.9899999993,2679873.3799999994
272,U859624,560,291.09999999996217,524,36,235433.77999999985,235724.87999999983
273,U20272,560,-4956.390000000048,505,55,197888.43,192932.03999999995
274,U1356732,559,-39899.42999999998,380,179,471683.4400000001,431784.0100000001
275,U37074,558,-3184.7299999999996,527,31,41996.26000000001,38811.53000000001
276,U9591,558,7660.890000000036,532,26,514528.0299999997,522188.9199999997
277,U41033,557,-40889.71000000003,532,25,3341700.849999997,3300811.139999997
278,U12446,556,-4374.180000000004,451,105,116510.11000000004,112135.93000000004
279,U32780,556,13302.989999999903,286,270,4417093.71,4430396.7
280,U20307,556,-541.7900000000025,496,60,345679.62000000005,345137.8300000001
281,U43791,555,-55784.60000000003,169,386,644425.0599999999,588640.46
282,U26529,554,51912.48000000001,235,319,744572.4700000006,796484.9500000005
283,U41929,554,-44588.09999999999,494,60,188772.82,144184.72000000003
284,U29686,554,-20070.240000000045,470,84,558270.6000000004,538200.3600000005
285,U703365,554,324.86000000000297,369,185,702605.29,702930.15
286,U19832,553,-7781.980000000012,436,117,3300811.869999999,3293029.889999999
287,U32000,553,-579830.6200000001,526,27,871136.8600000002,291306.2400000001
288,U17683,551,2973.9599999999336,221,330,1195197.51,1198171.47
289,U27410,549,-31730.969999999892,494,55,13873443.740000006,13841712.770000005
290,U25110,549,-12851.490000000029,516,33,171380.50999999992,158529.0199999999
291,U10871,549,298345.56000000023,354,195,2625228.23,2923573.79
292,U20590,549,-312.71000000020035,141,408,1085036.19,1084723.4799999997
293,U8027,549,20321.249999999964,532,17,468049.7400000002,488370.99000000017
294,U31782,548,-3350.8100000000036,489,59,322015.9600000001,318665.1500000001
295,U36246,547,-239.120000000005,411,136,100924.23,100685.10999999999
296,U26797,546,2651.0700000000015,414,132,204815.89000000004,207466.96000000005
297,U16684,546,-9102.980000000003,440,106,425759.59,416656.61000000004
298,U25811,544,-1093630.8399999999,515,29,1411507.3199999998,317876.48
299,U28521,544,-1558.7200000000146,286,258,667126.3899999999,665567.6699999999
300,U22145,543,7427.550000000001,287,256,929544.8399999999,936972.3899999999
301,U40890,543,11485.819999999989,346,197,737558.58,749044.3999999999
302,U20482,542,-2694.5300000000243,336,206,783299.6799999996,780605.1499999996
303,U33161,542,325750.5800000006,429,113,3883565.3299999996,4209315.91
304,U9322,541,3685.230000000007,516,25,128628.8699999999,132314.0999999999
305,U18545,540,4977.129999999989,358,182,1278259.1600000001,1283236.29
306,U12172,540,-1730.4399999999678,300,240,668249.3300000001,666518.8900000001
307,U43007,540,9669.710000000006,517,23,91257.1400000001,100926.85000000011
308,U25320,540,5031.420000000101,349,191,392539.9100000001,397571.3300000002
309,U32675,538,-2857.470000000068,444,94,1175146.46,1172288.99
310,U20877,538,1590.3600000000151,139,399,1583357.8200000003,1584948.1800000004
311,U38794,538,-15142.500000000528,405,133,2092021.3099999998,2076878.8099999994
312,U34254,537,-5931.469999999896,274,263,1164067.8300000003,1158136.3600000003
313,U1371286,537,-4893.100000000002,293,244,418584.11,413691.01
314,U9231,537,-92555.01000000001,489,48,102058.25,9503.23999999999
315,U32183,536,1495.3600000000138,449,87,172970.2000000012,174465.56000000122
316,U32381,535,-1111.0199999999995,168,367,546489.37,545378.35
317,U16268,535,-1236.2300000000255,317,218,1193280.5699999998,1192044.3399999999
318,U15041,533,-153334.63999999137,374,159,79460534.0,79307199.36000001
319,U16365,533,-1070.2200000000014,506,27,51386.93000000001,50316.71000000001
320,U20623,533,8544.39999999787,400,133,13562300.260000011,13570844.66000001
321,U30781,533,-21663.279999999984,316,217,590364.81,568701.53
322,U12554,532,1305.2400000000089,441,91,298444.88999999996,299750.12999999995
323,U8664,532,2497.5800000001764,365,167,2005640.3399999994,2008137.9199999995
324,U748525,531,-5.789999999994961,276,255,211115.47999999998,211109.68999999997
325,U9964,530,-8380.749999999998,526,4,20422.589999999997,12041.839999999998
326,U10599,529,-16282.360000000017,307,222,2536498.81,2520216.45
327,U29830,529,-4370.760000000003,488,41,121541.51999999996,117170.75999999995
328,U18249,528,-40519.17000000001,482,46,484456.79,443937.62
329,U41628,528,-394564.16,417,111,2063357.5200000003,1668793.3600000003
330,U10178,528,-445077.9000000001,393,135,1165712.19,720634.2899999998
331,U35720,528,665.6900000000023,372,156,312807.64999999997,313473.33999999997
332,U14303,528,9990.08999999978,484,44,4988416.610000001,4998406.700000001
333,U12762,527,-7263.579999999999,292,235,892611.3700000001,885347.7900000002
334,U13161,526,-3051.2899999999845,386,140,755619.5300000006,752568.2400000006
335,U9257,526,-59930.34000000001,466,60,300554.5499999999,240624.20999999985
336,U9101,525,52017.649999999776,288,237,4295091.08,4347108.7299999995
337,U36460,525,336475.18000000017,379,146,10347705.28,10684180.459999999
338,U21661,524,13681.500000000004,293,231,432636.6099999998,446318.1099999998
339,U16236,524,-3862.24,495,29,53188.09999999999,49325.85999999999
340,U16164,524,14041.939999999995,82,442,377465.6900000002,391507.6300000002
341,U8842,524,-3347.109999999967,449,75,295536.88999999996,292189.77999999997
342,U42868,523,34353.03999999997,276,247,762417.5,796770.5399999999
343,U19166,523,18342.70000000004,295,228,1414518.3699999999,1432861.0699999998
344,U14266,522,198658.77000000048,313,209,31022484.680000003,31221143.450000003
345,U35765,522,-94035.17999999995,511,11,245453.08,151417.90000000002
346,U22027,522,-56496.05999999998,475,47,374463.7700000001,317967.7100000001
347,U749303,521,114.94000000000364,265,256,446561.43,446676.37
348,U31030,520,-548.6999999998786,490,30,234413.49999999977,233864.7999999999
349,U27734,519,-28530.55000000005,485,34,3500645.550000001,3472115.000000001
350,U21282,519,-26058.57000000018,426,93,1327830.02,1301771.4499999997
351,U13655,518,-3613.3799999999937,504,14,44336.63000000001,40723.250000000015
352,U14397,518,-28587.569999999927,464,54,649218.2600000002,620630.6900000003
353,U19708,518,-13961.759999999855,492,26,366644.1900000012,352682.4300000014
354,U1356012,518,1330.8200000000006,310,208,228188.25,229519.07
355,U12474,518,-2907.159999999995,459,59,139857.63999999998,136950.47999999998
356,U42773,518,-2352.440000000046,370,148,998443.88,996091.44
357,U1372910,518,5319.699999999993,294,224,1067804.7000000002,1073124.4000000001
358,U17211,517,-1086271.9999999988,457,60,16536505.020000001,15450233.020000003
359,U40762,516,316099.82999999984,125,391,5317588.34,5633688.17
360,U22796,516,-10710.610000000179,443,73,1855347.8099999984,1844637.1999999983
361,U42570,515,2443.249999999998,427,88,368212.50999999995,370655.75999999995
362,U33813,515,-29821.550000000003,384,131,489127.01000000007,459305.4600000001
363,U36785,515,8240.270000000004,497,18,48635.990000000034,56876.26000000004
364,U23662,514,-30661.41999999988,484,30,1429422.6499999997,1398761.2299999997
365,U15424,514,-306447.3899999997,327,187,557511.8200000002,251064.43000000046
366,U8583,514,21041.510000000068,438,76,2692367.98,2713409.49
367,U40648,513,3253.849999999744,446,67,12101719.06,12104972.91
368,U34909,513,4845.570000000373,351,162,7717064.260000002,7721909.830000002
369,U12610,512,-17268.899999999936,477,35,461625.9799999995,444357.0799999996
370,U26348,512,4887.249999999967,152,360,2115487.68,2120374.93
371,U27178,511,9547.720000000108,430,81,753770.2800000004,763318.0000000005
372,U12438,511,11574.90999999988,303,208,1102333.2000000002,1113908.11
373,U31223,511,-40686.04000000002,333,178,640969.2299999999,600283.1899999998
374,U19912,510,-29496.770000000008,402,108,205873.26999999996,176376.49999999994
375,U40370,510,272.90999999999804,472,38,173033.58,173306.49
376,U40294,510,21428.750000000047,442,68,397813.9600000002,419242.71000000025
377,U35324,509,-112387.00000000001,492,17,198615.68,86228.67999999998
378,U12231,509,19998.150000000005,494,15,75000.62999999999,94998.78
379,U8449,508,41064.52999999999,262,246,1028744.65,1069809.18
380,U26410,508,-40235.91000000005,216,292,996470.8699999998,956234.9599999997
381,U42379,506,-10138.839999999984,238,268,1760390.4700000065,1750251.6300000064
382,U21633,506,25990.699999999604,208,298,123526677.16000001,123552667.86000001
383,U34825,505,-11131.17000000017,436,69,8537269.670000006,8526138.500000006
384,U37465,504,-25251.49,491,13,95976.28000000007,70724.79000000007
385,U26368,504,-999.7600000000095,442,62,196143.08,195143.31999999998
386,U863761,504,3981.7800000000034,301,203,126502.23,130484.01
387,U35656,504,-18955.209999999825,396,108,1241227.0199999998,1222271.81
388,U16841,503,-202244.41000000018,478,25,653466.2599999998,451221.8499999996
389,U39553,503,-5069.510000000009,479,24,248055.2,242985.69
390,U14624,503,-384564.9900000001,457,46,1514029.01,1129464.02
391,U1319578,502,-149.57000000000005,274,228,8687.51,8537.94
392,U27199,502,-95322.18999999987,487,15,274315.4900000003,178993.3000000004
393,U34007,502,-199294.32,421,81,1135471.9799999997,936177.6599999997
394,U28483,501,-4874.200000000042,301,200,978152.0000000002,973277.8000000002
395,U11807,501,-21190.619999999937,338,163,1810572.23,1789381.61
396,U11501,501,1644.319999999998,431,70,82122.21,83766.53
397,U38279,501,-824.8699999999953,417,84,647442.6599999999,646617.7899999999
398,U14123,500,657.1400000000249,332,168,736048.2999999998,736705.4399999998
399,U14854,500,-119265.89000000004,475,25,1786317.6900000006,1667051.8000000005
400,U14715,499,28152.820000000036,478,21,664649.74,692802.56
401,U19469,499,-2568.1100000000088,424,75,233533.94,230965.83
402,U30038,499,-29100.52999999999,369,130,580333.87,551233.34
403,U25558,499,6405.689999999603,423,76,2516049.7100000004,2522455.4
404,U10984,498,-1391.5700000001161,361,137,4770859.059999999,4769467.489999998
405,U33478,498,-185268.86999999994,438,60,871284.37,686015.5
406,U23255,498,80819.20000000023,467,31,1662858.08,1743677.2800000003
407,U40784,498,73665.02000000008,455,43,1291374.0699999994,1365039.0899999994
408,U34367,497,84356.63000000006,395,102,697582.4899999998,781939.1199999999
409,U33544,496,-8736.279999999937,272,224,1244205.73,1235469.45
410,U14812,495,-67265.31000000081,313,182,13700984.489999995,13633719.179999994
411,U40061,495,691445.8699999999,375,120,6808467.649999999,7499913.52
412,U23435,495,39732.17000000004,287,208,4076891.2199999983,4116623.3899999983
413,U729632,494,6.000000000000881,251,243,49821.76,49827.76
414,U17465,494,-218799.70000000016,474,20,773252.1100000003,554452.4100000001
415,U29386,494,-27983.999999999993,466,28,69381.16999999998,41397.16999999999
416,U41296,494,5480.170000000035,373,121,200853.77000000002,206333.94000000006
417,U12948,494,1019.4800000010109,394,100,2891647.990000002,2892667.470000003
418,U1047192,493,-459.5300000000002,265,228,22883.719999999998,22424.19
419,U40266,493,45383.70999999997,457,36,143137.17,188520.87999999998
420,U28485,492,106900.34000000023,250,242,912905.4700000002,1019805.8100000004
421,U32467,492,28463.059999999998,449,43,580257.29,608720.3500000001
422,U39205,492,-10651.819999999998,474,18,98245.72,87593.90000000001
423,U30880,492,197208.37999999995,472,20,209369.91000000003,406578.29
424,U12883,492,35304.01000000004,344,148,1519905.4300000002,1555209.4400000002
425,U37846,491,-16626.22000000001,481,10,134441.3699999999,117815.1499999999
426,U34866,491,-21511.16999999999,466,25,98480.18000000002,76969.01000000004
427,U14002,491,384903.7900000015,289,202,1293537.9100000001,1678441.7000000016
428,U33728,490,2681.989999999935,324,166,209237.87,211919.85999999993
429,U11719,489,1934.7099999999957,463,26,17167.28999999997,19101.999999999967
430,U8297,489,-273.06999999999334,445,44,278177.12000000005,277904.05000000005
431,U11325,489,1635.8799999999992,393,96,457431.4799999999,459067.3599999999
432,U38344,488,-7131.390000000889,441,47,704068.860000001,696937.4700000001
433,U23382,488,-76964.12000000007,472,16,728907.45,651943.3299999998
434,U12579,488,15263.35999999999,421,67,84550.23999999999,99813.59999999998
435,U12392,487,93751.54000000015,390,97,2705880.5800000005,2799632.1200000006
436,U27571,487,-12381.170000000006,443,44,968609.1800000005,956228.0100000005
437,U43053,485,2879.530000000054,405,80,5330497.640000004,5333377.170000005
438,U26682,485,67326.36999999998,461,24,176471.53999999983,243797.9099999998
439,U10979,485,-4610.67999999999,471,14,114746.95999999999,110136.28
440,U27241,484,1544.1499999999178,346,138,1650754.8499999996,1652298.9999999995
441,U34733,484,4405.560000000005,457,27,45294.060000000005,49699.62000000001
442,U17238,484,-67125.51999999999,436,48,372728.1,305602.57999999996
443,U34509,484,4357.659999999971,292,192,1054301.7000000002,1058659.36
444,U31397,483,-949.909999999941,462,21,173133.50999999986,172183.59999999992
445,U1140585,483,-4872.439999999977,306,177,942115.4,937242.9600000001
446,U35594,482,-14366.390000000003,469,13,60788.81000000003,46422.42000000003
447,U31046,482,8472.64999999979,236,246,6551929.200000001,6560401.850000001
448,U1081680,482,-29.0200000000099,75,407,145048.99999999997,145019.97999999995
449,U43860,482,-4981.310000000091,412,70,956915.19,951933.8799999999
450,U35811,482,-94434.83,449,33,240292.41000000003,145857.58000000002
451,U16992,481,2403.4199999999983,413,68,438804.20999999985,441207.62999999983
452,U29056,481,-5843.150000000001,426,55,89976.18000000001,84133.03000000001
453,U43383,481,2350.430000000005,431,50,108933.78000000001,111284.21000000002
454,U27327,481,9560.990000000005,425,56,262747.2699999999,272308.2599999999
455,U11686,480,-18.219999999999118,410,70,85679.85,85661.63
456,U13385,480,744148.5699999994,424,56,2359566.0599999977,3103714.629999997
457,U39982,480,23555.189999999988,460,20,381373.75999999995,404928.94999999995
458,U31718,478,62433.99000000092,422,56,4195123.600000001,4257557.590000002
459,U11303,478,30581.430000000004,458,20,229774.34999999995,260355.77999999994
460,U9026,477,-9611.52000000002,447,30,138616.69,129005.16999999998
461,U814346,477,-60.43000000000056,298,179,28225.579999999984,28165.149999999983
462,U9847,477,28146.530000000002,398,79,213775.16999999987,241921.69999999987
463,U40585,477,-1009.4200000000042,453,24,93692.08000000002,92682.66000000002
464,U43562,476,86530.30999999997,372,104,240420.27000000008,326950.5800000001
465,U8055,476,41730.79,460,16,137901.55000000005,179632.34000000005
466,U25688,476,-10427.340000000017,427,49,160026.4399999999,149599.09999999986
467,U32465,476,15274.080000000147,204,272,4270441.550000001,4285715.630000001
468,U34908,476,9654.300000000047,453,23,1251919.27,1261573.57
469,U13125,476,-16390.14999999995,261,215,2334122.91,2317732.7600000002
470,U26990,476,97247.05999999917,294,182,7379114.719999999,7476361.779999998
471,U8798,475,-10599.689999999993,360,115,296704.07999999996,286104.38999999996
472,U36254,475,-5331.160000000018,434,41,491821.63000000006,486490.47000000003
473,U13716,473,11748.7599999999,273,200,1205019.23,1216767.99
474,U29438,473,19892.769999999953,448,25,374164.58999999985,394057.3599999998
475,U10860,473,-325656.94999999955,246,227,5500003.969999995,5174347.019999996
476,U16334,473,-22232.239999999998,89,384,387392.32,365160.08
477,U13915,473,54966.14,244,229,1501113.2700000005,1556079.4100000004
478,U41164,473,-4220.019999999997,428,45,63417.900000000045,59197.88000000005
479,U16218,473,-521027.7500000001,239,234,6191246.229999998,5670218.479999998
480,U19835,472,-22135.269999999975,158,314,2044530.8499999996,2022395.5799999996
481,U8934,472,819.9600000000246,150,322,1160553.6299999997,1161373.5899999996
482,U38504,472,3689.3599999999888,442,30,115607.81999999999,119297.17999999998
483,U10240,472,7828.719999999994,353,119,508268.63999999996,516097.3599999999
484,U16705,471,-38332.75000000006,321,150,4879613.180000002,4841280.430000002
485,U28245,471,8020.569999999969,401,70,142959.21999999994,150979.78999999992
486,U1117862,471,729.5199999999998,254,217,57145.84000000003,57875.36000000003
487,U16724,469,5744343.28,378,91,42264089.01999999,48008432.29999999
488,U21407,469,-42398.309999999976,297,172,283907.1800000001,241508.87000000014
489,U35639,469,134519.34000000008,402,67,822494.9700000001,957014.3100000002
490,U38208,468,-5260.849999999991,402,66,313548.86,308288.01
491,U15305,468,31351.649999999983,403,65,1048132.3799999994,1079484.0299999993
492,U24618,468,-17850.18000000008,219,249,1021179.1699999999,1003328.9899999999
493,U20162,468,-2601.8400000000374,151,317,700022.1299999999,697420.2899999998
494,U993621,468,-4472.950000000033,333,135,553339.2399999996,548866.2899999996
495,U9893,467,-17732.220000000034,316,151,685860.5200000003,668128.3000000002
496,U31308,467,-13978.600000000004,400,67,393562.38,379583.78
497,U16613,467,-27877.660000000014,439,28,211178.30000000002,183300.64
498,U38636,467,110689.13000000003,361,106,2387509.1199999996,2498198.2499999995
499,U14626,467,-356117.9100000001,415,52,11019170.500000004,10663052.590000004
500,U19623,466,4515.519999999988,239,227,417710.59,422226.11
501,U13423,466,-7752.619999999997,443,23,52909.590000000004,45156.97000000001
502,U33923,466,13981.579999999987,296,170,448815.45999999996,462797.0399999999
503,U26976,466,-1862.11,436,30,122838.38,120976.27
504,U27604,465,3263.1599999999976,340,125,44602.40999999998,47865.56999999998
505,U23760,464,-35943.05000000028,285,179,6903593.6400000015,6867650.590000002
506,U25676,464,-103239.25000000026,453,11,1254323.8499999999,1151084.5999999996
507,U36200,464,-6878.039999999988,263,201,381947.86,375069.82
508,U18259,464,10503.879999999957,402,62,343931.12999999995,354435.0099999999
509,U38727,463,-722.5699999999907,424,39,101366.8599999999,100644.2899999999
510,U32659,463,-2143.419999999995,254,209,866782.6600000004,864639.2400000003
511,U42720,463,-140928.43999999916,273,190,7424763.289999998,7283834.849999999
512,U32094,462,82280.69000000058,246,216,1672870.4600000002,1755151.1500000008
513,U38162,462,22063.46000000005,436,26,880116.2899999998,902179.7499999999
514,U27311,462,-29037.11000000021,172,290,510913.10000000003,481875.9899999998
515,U24198,462,27801.930000000008,444,18,103933.06000000006,131734.99000000005
516,U16583,461,-5932849.289999995,311,150,36280356.72,30347507.430000003
517,U35229,461,-87859.95999999989,424,37,669105.04,581245.0800000002
518,U1150710,461,-10545.679999999998,368,93,129734.32000000002,119188.64000000003
519,U992691,461,-29670.84000000001,277,184,2090812.5100000002,2061141.6700000002
520,U1269314,461,-689.9200000000374,337,124,484756.71,484066.79
521,U14684,460,-50258.37000000001,412,48,1968732.2499999998,1918473.8799999997
522,U14038,460,-61492.909999999945,447,13,549932.5899999999,488439.67999999993
523,U16272,460,694.3400000000505,364,96,612211.9200000005,612906.2600000006
524,U13986,460,-17891.880000000012,438,22,161195.0299999999,143303.1499999999
525,U20117,459,-198.30999999999682,400,59,68763.95,68565.64
526,U22935,459,57833.68,427,32,322998.20999999996,380831.88999999996
527,U20363,459,3907.860000000006,287,172,647640.4,651548.26
528,U9389,459,-5179.790000000008,432,27,220671.77,215491.97999999998
529,U43850,459,35399.379999999706,410,49,439849.13000000064,475248.51000000036
530,U26480,458,19647.13000000004,365,93,2954157.2000000007,2973804.3300000005
531,U37199,457,-12105.969999999998,408,49,341279.55000000005,329173.5800000001
532,U17193,457,60834.99999999994,226,231,10763196.55,10824031.55
533,U14259,457,331951.18999999965,387,70,4065491.3899999997,4397442.579999999
534,U32296,457,-421024.8799999996,401,56,1106136.5700000008,685111.6900000011
535,U9147,457,-15702.480000000001,361,96,263590.6300000001,247888.1500000001
536,U25626,456,1186.239999999999,383,73,52181.91000000001,53368.15000000001
537,U42997,456,-44581.470000000016,342,114,252833.29999999993,208251.8299999999
538,U29893,456,11417.00000000003,219,237,891320.53,902737.53
539,U37950,456,9901.81,432,24,57934.50999999984,67836.31999999985
540,U27061,455,4341.159999999954,438,17,1231214.760000001,1235555.9200000009
541,U30995,454,-1661.9699999999873,447,7,25489.079999999984,23827.109999999997
542,U14422,454,-1317.909999999828,253,201,3108582.3199999994,3107264.4099999997
543,U1160485,453,-6492.810000000003,334,119,74596.06,68103.25
544,U15612,453,-52779.14999999988,387,66,24310452.59000001,24257673.440000013
545,U12690,453,-51135.58000000001,361,92,726632.5699999998,675496.9899999999
546,U30863,453,348.8000000000045,418,35,41443.63000000002,41792.43000000002
547,U20064,452,-5119.899999999987,410,42,298514.11,293394.21
548,U16942,452,-9395.969999999998,428,24,103486.51,94090.54
549,U13358,452,1390.1400000000049,432,20,138689.33000000002,140079.47000000003
550,U16441,452,5120.699999999997,429,23,50770.14000000001,55890.840000000004
551,U42488,451,31354.78,414,37,297755.0799999999,329109.85999999987
552,U15544,451,7178.889999999991,339,112,612056.3200000001,619235.2100000001
553,U12627,451,34843.529999999984,335,116,2203872.57,2238716.0999999996
554,U43194,450,-16834.26000000006,358,92,2043226.3299999998,2026392.0699999998
555,U35212,450,37827.86999999998,437,13,267715.07,305542.94
556,U13623,449,30548.100000000013,313,136,411005.0800000001,441553.1800000001
557,U23474,449,23379.609999999986,307,142,772870.7199999996,796250.3299999996
558,U32648,449,2325.990000000027,362,87,140747.00000000055,143072.99000000057
559,U13747,449,-10484.33999999998,246,203,872621.35,862137.01
560,U19829,448,7763.46000000001,420,28,1158288.7200000002,1166052.1800000002
561,U14446,448,-7604.829999999991,91,357,610034.66,602429.8300000001
562,U19771,448,-8285.249999999975,425,23,246867.16999999987,238581.9199999999
563,U27941,447,-10453.439999999951,421,26,941796.2400000001,931342.8000000002
564,U14248,447,-598.6800000000075,433,14,33667.979999999996,33069.29999999999
565,U36792,447,134897.10000000024,414,33,1624645.2100000018,1759542.3100000022
566,U38714,447,-24181.409999999945,395,52,2813899.7600000002,2789718.35
567,U41472,447,-30700.83999999988,399,48,2296291.6800000006,2265590.840000001
568,U44046,447,272470.33999999997,411,36,682586.7199999999,955057.0599999998
569,U18432,447,1109.0600000000122,352,95,473758.53,474867.59
570,U30166,447,382618.44000000024,395,52,4068303.59,4450922.03
571,U1166180,447,-1751.7400000000016,258,189,154002.33999999997,152250.59999999998
572,U1325828,447,7764.2999999999365,224,223,46958.83999999992,54723.139999999854
573,U11597,446,2761.600000000056,377,69,376324.04000000044,379085.6400000005
574,U757609,446,-2164.8100000000004,324,122,185945.93999999997,183781.12999999998
575,U40348,445,-52681.82000000017,212,233,1202683.4900000002,1150001.6700000002
576,U36511,445,-22081.840000000062,260,185,1149213.74,1127131.9
577,U21971,445,-5098.159999999916,244,201,2107995.579999999,2102897.419999999
578,U39542,445,-26087.869999999933,379,66,584872.7899999998,558784.9199999999
579,U18438,445,1850.740000000002,420,25,58582.93000000001,60433.67000000001
580,U16935,445,-157786.67000000004,350,95,4885775.77,4727989.1
581,U11259,444,7233.909999999974,231,213,1106590.5499999998,1113824.4599999997
582,U23197,444,38329.15000000006,417,27,496911.36,535240.51
583,U38828,444,-18357.479999999872,354,90,1285287.7700000005,1266930.2900000005
584,U8683,444,-59196.859999999935,407,37,922346.3000000005,863149.4400000005
585,U35767,443,-38631.18000000008,355,88,1397043.8499999999,1358412.6699999997
586,U31805,443,50129.740000000005,367,76,589851.5599999999,639981.2999999999
587,U11383,442,80623.68999999994,286,156,167166.51000000004,247790.19999999998
588,U17177,442,648.2999999999611,405,37,764840.4400000001,765488.74
589,U26214,442,-407379.75000000006,380,62,9442196.410000006,9034816.660000006
590,U34644,442,-397079.38999999984,424,18,1076177.5000000005,679098.1100000006
591,U11976,441,5272.889999999984,214,227,1147178.2899999996,1152451.1799999995
592,U24279,441,14432.669999999998,259,182,829127.5199999998,843560.1899999998
593,U9753,441,31700.329999999944,339,102,1092930.8800000004,1124631.2100000002
594,U14508,441,39410.81000000386,213,228,17402911.25,17442322.060000002
595,U32831,441,-1589.089999999967,378,63,1022972.9800000001,1021383.8900000001
596,U43824,441,-1578.7800000000043,410,31,44724.70999999995,43145.92999999994
597,U627675,440,-7251.6900000000005,330,110,36448.929999999986,29197.239999999983
598,U28838,440,-13058.230000000014,360,80,870166.5900000003,857108.3600000003
599,U43205,440,-3498.009999999999,425,15,43364.49000000002,39866.48000000002
600,U14314,440,-118112.06000000003,379,61,1099177.4300000002,981065.3700000001
601,U18512,440,-126128.59999999979,312,128,345399.8100000003,219271.2100000005
602,U27425,439,-21389.450000000055,251,188,1132052.229999999,1110662.779999999
603,U26829,439,188890.65000000002,418,21,1841975.76,2030866.4100000001
604,U14601,439,-33752.049999999996,400,39,164988.52999999994,131236.47999999995
605,U19784,438,-10402.719999999914,298,140,747715.55,737312.8300000001
606,U38965,438,477434.3799999979,368,70,19452602.790000007,19930037.170000006
607,U21130,437,327.1999999999978,149,288,459800.51,460127.71
608,U30216,437,-4371.109999999996,348,89,62733.70999999999,58362.6
609,U8658,437,-33072.999999999985,400,37,446173.57,413100.57
610,U42922,437,7696.709999999732,375,62,1197367.8199999998,1205064.5299999996
611,U13941,437,50134.7099999997,266,171,1982488.3600000003,2032623.07
612,U20171,436,-20333.449999999888,368,68,1634165.7299999997,1613832.2799999998
613,U12732,436,-23923.340000000037,298,138,849778.1399999999,825854.7999999998
614,U19954,436,54.55999999999452,365,71,51002.22000000002,51056.78000000002
615,U22203,436,63464.81999999937,218,218,13725808.02,13789272.84
616,U27614,436,-32414.130000000034,387,49,431414.6,399000.47
617,U32568,436,904022.9400000001,238,198,1057395.1899999997,1961418.13
618,U13939,436,84012.00000000004,391,45,806210.9099999999,890222.9099999999
619,U22143,435,-1249045.1199999973,345,90,24362113.12,23113068.000000004
620,U41244,435,28817.229999999978,379,56,2288945.380000001,2317762.610000001
621,U15221,434,-11058.569999999958,333,101,2284385.9199999976,2273327.3499999978
622,U22484,434,73443.54999999993,392,42,1830548.25,1903991.7999999998
623,U13261,434,27324.409999999996,327,107,1672203.1900000006,1699527.6000000006
624,U40822,434,3575.2399999997388,382,52,1003379.6599999998,1006954.8999999996
625,U37955,434,-407243.16,414,20,713852.4100000011,306609.2500000011
626,U11619,434,-719.3499999989748,324,110,6451747.010000002,6451027.660000003
627,U38230,433,3071.530000000039,221,212,770272.4299999999,773343.96
628,U32078,433,31684.36000000005,273,160,1114227.85,1145912.2100000002
629,U15949,433,93928.24999999999,361,72,371865.2399999997,465793.4899999997
630,U22215,433,-27578.380000000012,287,146,1063710.74,1036132.36
631,U15780,433,-61087.61999999989,384,49,1501592.6499999994,1440505.0299999996
632,U43397,433,15515.240000000107,395,38,1642829.5299999989,1658344.769999999
633,U21981,433,-22074.840000000047,296,137,910372.4800000001,888297.64
634,U1184086,432,-11556.119999999997,223,209,521856.56000000006,510300.44000000006
635,U30630,432,-325.4500000000014,371,61,182836.36999999997,182510.91999999995
636,U27834,432,539330.7999999993,313,119,2770156.35,3309487.1499999994
637,U21681,432,-86475.86000000002,274,158,1843648.2600000002,1757172.4000000001
638,U26443,432,37676.989999999954,304,128,993734.16,1031411.15
639,U15989,432,92727.59,397,35,115905.79000000001,208633.38
640,U37752,432,-30328.679999999928,362,70,3207961.27,3177632.5900000003
641,U40040,431,-406076.4199999999,418,13,814108.2000000008,408031.78000000084
642,U15631,430,3483.1300000002957,404,26,640214.0699999996,643697.2
643,U38581,430,-8067.2700000000095,387,43,193364.1700000001,185296.90000000008
644,U40672,430,-6127.39999999992,388,42,7460032.320000021,7453904.92000002
645,U16433,430,-71867.18999999942,298,132,3835672.1599999997,3763804.97
646,U32527,430,71082.0800000001,345,85,2172339.4099999997,2243421.4899999998
647,U21467,429,-10424.949999999943,387,42,326046.6799999995,315621.7299999996
648,U26397,429,53350.86,249,180,1466683.1000000003,1520033.9600000004
649,U40347,429,4936.230000000004,275,154,329530.72,334466.94999999995
650,U40429,429,-48472.36999999998,412,17,151483.97000000012,103011.60000000014
651,U38854,428,-659.8399999999992,272,156,24918.789999999994,24258.949999999993
652,U14236,428,212038.03999999998,369,59,1600086.6599999997,1812124.6999999997
653,U9404,428,-54998.15000000001,408,20,253163.37999999986,198165.22999999986
654,U20473,428,-4331.809999999992,407,21,98388.95999999996,94057.14999999997
655,U12962,427,-40794.17000000004,301,126,1053165.3299999998,1012371.1599999998
656,U14864,427,-157313.36999999997,385,42,604477.05,447163.68000000005
657,U41926,427,-1481.9500000000044,369,58,276665.87,275183.92
658,U12119,427,46684.92999999999,397,30,398626.34,445311.27
659,U12181,426,-47071.22,371,55,97258.54000000004,50187.320000000036
660,U23584,426,-26905.850000000035,385,41,2995000.08,2968094.23
661,U12321,426,92079.79000000002,371,55,363745.66000000003,455825.45000000007
662,U13030,426,-2406.610000000059,366,60,2067784.729999999,2065378.119999999
663,U12523,426,-22075.529999999995,269,157,454936.45999999985,432860.9299999999
664,U21677,425,41297.139999999985,348,77,518989.2800000001,560286.42
665,U26264,425,-5323.559999999954,180,245,750312.5900000001,744989.0300000001
666,U16602,425,-12727.920000000004,319,106,2180185.859999999,2167457.939999999
667,U34487,425,-21954.390000000007,251,174,873099.0299999999,851144.6399999999
668,U16424,425,-11965.749999999989,400,25,191561.99999999994,179596.24999999994
669,U20474,425,-55537.19,374,51,794213.8099999999,738676.6199999999
670,U9216,425,-246932.06,244,181,626663.78,379731.72000000003
671,U16123,424,-35299.16000000001,400,24,243928.8899999999,208629.7299999999
672,U41347,424,-54608.01999999994,317,107,1246185.3699999999,1191577.3499999999
673,U11128,424,23345.92999999998,405,19,167814.18000000008,191160.11000000004
674,U11228,423,-2840.3800000000165,396,27,269038.8300000001,266198.45000000007
675,U40070,423,-6081.959999999774,392,31,622327.6599999996,616245.6999999998
676,U14924,423,-32162.169999999835,364,59,5616923.39,5584761.22
677,U13953,423,1814.7700000000261,294,129,2335913.2800000003,2337728.0500000003
678,U8815,423,3058.5200000000223,272,151,634487.4299999999,637545.95
679,U40484,423,5154.900000000016,345,78,278240.62,283395.52
680,U27180,423,-20134.700000000004,361,62,1050402.9100000001,1030268.2100000002
681,U30844,423,15105.5,314,109,678248.5499999997,693354.0499999997
682,U993001,422,7423.1400000000285,274,148,3646584.02,3654007.16
683,U8129,422,-1545.7200000000084,392,30,222246.33000000002,220700.61000000002
684,U16406,422,-35592.00000000005,287,135,557038.53,521446.52999999997
685,U40352,422,44551.06,376,46,4218580.77,4263131.829999999
686,U33384,421,4710.789999999979,317,104,1005691.95,1010402.74
687,U37548,421,-142.82999999999083,242,179,959157.8599999999,959015.0299999999
688,U20031,421,303.78000000000793,327,94,191065.04000000007,191368.82000000007
689,U17215,421,-157319.63000000003,373,48,1110105.08,952785.4500000001
690,U18243,421,40041.86999999999,390,31,6407707.079999998,6447748.949999998
691,U9421,421,-51921.37999999998,387,34,400988.49999999994,349067.11999999994
692,U984246,420,-4774.130000000004,330,90,221467.9899999999,216693.8599999999
693,U25190,420,-38255.97999999999,357,63,815791.2599999999,777535.2799999999
694,U20336,420,30326.830000000016,385,35,269423.69,299750.52
695,U1237358,420,-5013.609999999981,288,132,478283.4699999999,473269.8599999999
696,U17848,420,-2155.830000000006,230,190,181371.03,179215.19999999998
697,U39772,419,-164698.33,404,15,574599.7400000002,409901.41000000027
698,U12704,419,-70027.44000000005,352,67,3778423.08,3708395.64
699,U36482,419,-3827.9400000000023,382,37,53329.150000000016,49501.210000000014
700,U40992,419,488.2899999996589,140,279,826195.75,826684.0399999997
701,U37162,419,320963.99000000005,319,100,3587611.389999997,3908575.379999997
702,U27608,419,397653.88999999984,236,183,2299191.24,2696845.13
703,U14260,418,17324.30999999974,254,164,62377560.11999999,62394884.42999999
704,U27469,418,55153.31999999994,335,83,898365.68,953519.0
705,U30212,418,8604.409999999996,356,62,151044.45,159648.86000000002
706,U39281,418,-55107.380000000165,356,62,2407412.08,2352304.6999999997
707,U23619,418,75561.8700000004,341,77,4647103.5900000045,4722665.460000005
708,U16155,418,-16983.579999999987,393,25,166608.37,149624.79
709,U9103,418,-44080.03999999994,411,7,182310.78999999995,138230.75
710,U24988,418,34435.67,385,33,248736.65,283172.32
711,U8087,417,-33321.36000000002,244,173,1661169.8700000003,1627848.5100000002
712,U16051,417,2802.840000000112,245,172,5000607.270000001,5003410.110000001
713,U32043,417,93296.37,402,15,181130.50000000003,274426.87
714,U20098,417,-7796.85000000001,401,16,60956.99999999998,53160.149999999965
715,U13684,416,-206740.8799999999,400,16,2028387.5,1821646.62
716,U40924,416,-185.70000000001824,325,91,191534.28999999998,191348.58999999997
717,U38725,416,4656.749999999942,361,55,1317633.7600000002,1322290.5100000002
718,U26872,415,67209.55000000006,396,19,1190757.2499999998,1257966.7999999998
719,U16195,415,-32181.760000000017,258,157,904133.7,871951.94
720,U16340,415,-99432.4199999998,348,67,12027216.860000005,11927784.440000005
721,U36566,415,-47325.41000000002,316,99,976715.5499999999,929390.1399999999
722,U12139,414,-89199.74,373,41,359762.80999999994,270563.06999999995
723,U15998,414,47.56000000011918,202,212,6221405.449999997,6221453.009999998
724,U38251,414,6837.050000000016,352,62,417645.28,424482.33
725,U19593,414,112002.64000000001,230,184,884911.7400000002,996914.3800000002
726,U44015,414,2182.139999999996,372,42,246200.92999999993,248383.06999999992
727,U8068,414,-8169.98000000005,235,179,512466.91,504296.92999999993
728,U26447,413,-109383.31000000046,380,33,2382338.840000001,2272955.5300000003
729,U12747,413,5825.459999999987,383,30,270805.0200000001,276630.48000000004
730,U12372,413,-1922.4200000000978,379,34,1382910.6500000004,1380988.2300000002
731,U24799,413,-375013.69000000024,349,64,1590104.5399999998,1215090.8499999996
732,U13648,413,-33274.67000000004,383,30,233482.83,200208.15999999995
733,U13590,413,190701.7,396,17,163124.62999999998,353826.32999999996
734,U17729,413,31871.990000000056,367,46,549357.79,581229.7800000001
735,U41558,413,41405.880000000005,390,23,44961.61,86367.49
736,U17217,413,11756.820000000007,385,28,88237.50999999998,99994.32999999999
737,U36047,413,-44733.81,394,19,343179.24,298445.43
738,U37310,413,-50193.259999999995,348,65,304750.9,254557.64
739,U8602,413,7160.999999999993,221,192,1458543.8699999996,1465704.8699999996
740,U9804,412,80.36000000000247,341,71,233889.84000000008,233970.2000000001
741,U14158,412,-32137.55999999981,386,26,1522638.1800000037,1490500.6200000038
742,U8196,412,-7676.510000000004,367,45,226450.01,218773.5
743,U22572,412,65029.8899999999,380,32,1561502.5399999989,1626532.4299999988
744,U14748,412,27456.26000000003,378,34,1007411.8800000008,1034868.1400000008
745,U10168,412,1042.6099999999524,172,240,569857.8800000001,570900.4900000001
746,U35262,412,18987.73999999999,333,79,1046819.8199999998,1065807.5599999998
747,U30814,412,33556.319999999985,310,102,237032.33999999997,270588.66
748,U16814,411,-124877.57000000085,289,122,11259357.940000001,11134480.370000001
749,U17293,411,-155884.39999999997,346,65,579721.4800000001,423837.08000000013
750,U24761,411,-7297.2699999999895,373,38,202578.99,195281.72
751,U8489,411,470.1900000000005,304,107,186724.26,187194.45
752,U10470,411,10257.340000000066,214,197,916864.2300000002,927121.5700000003
753,U10161,411,-1968.0500000000147,375,36,179322.85999999996,177354.80999999994
754,U21447,411,326.7999999999997,321,90,51042.410000000025,51369.21000000003
755,U33787,411,-14746.849999999999,372,39,166047.71,151300.86
756,U19185,411,-11855.550000000014,322,89,352587.4,340731.85000000003
757,U10910,410,-111.37000000000255,360,50,323391.6399999997,323280.2699999997
758,U21426,410,4852.269999999893,211,199,1166524.2699999998,1171376.5399999996
759,U25883,410,-4082.390000000005,377,33,35951.25,31868.859999999993
760,U31715,410,-12200.929999999998,367,43,257936.15999999992,245735.22999999992
761,U16926,410,-39583.52999999998,367,43,416118.32999999996,376534.8
762,U17121,410,-53852.81000000017,376,34,6302199.2,6248346.39
763,U682027,410,-9608.180000000002,318,92,36413.04,26804.86
764,U578715,410,-4192.3999999999605,226,184,173166.05000000002,168973.65000000005
765,U41606,410,-29483.0,163,247,1490060.1,1460577.1
766,U17777,410,996.5100000000102,272,138,250469.46999999997,251465.97999999998
767,U38334,410,4.510000000040236,229,181,2345659.23,2345663.74
768,U8352,409,-1531.5400000000016,394,15,52335.329999999994,50803.78999999999
769,U10284,409,7668.08,290,119,177914.39000000004,185582.47000000003
770,U14124,409,-704179.6599999992,343,66,16616957.86,15912778.2
771,U18283,408,-920.8199999999724,294,114,355139.7100000001,354218.89000000013
772,U29207,408,-486.4800000000064,366,42,1325349.82,1324863.34
773,U24565,408,-46466.56000000006,371,37,621666.4500000005,575199.8900000005
774,U15324,408,-23937.520000000353,339,69,8402472.870000001,8378535.350000001
775,U17586,408,-31385.34999999986,248,160,5315386.090000001,5284000.740000001
776,U1369425,408,-6592.709999999969,313,95,254625.10000000003,248032.39000000007
777,U1116740,408,-1485.2200000000007,215,193,45775.550000000025,44290.33000000002
778,U14991,408,-11397.95000000001,310,98,2281419.3500000006,2270021.4000000004
779,U30312,408,-6470.45000000002,360,48,392618.2900000001,386147.8400000001
780,U35899,407,-588.3900000000039,286,121,72377.78999999998,71789.39999999998
781,U16011,407,-1383.4800000000278,351,56,433109.18999999977,431725.70999999973
782,U28369,407,10002.849999999993,382,25,192638.81999999998,202641.66999999998
783,U41597,407,-31948.27999999991,241,166,1673500.7299999997,1641552.4499999997
784,U29929,407,25759.380000000005,245,162,1267476.8000000003,1293236.1800000002
785,U17451,406,-4282.860000000017,300,106,1306581.8799999997,1302299.0199999996
786,U32390,406,7871.860000000086,378,28,794866.0500000002,802737.9100000003
787,U20709,406,19939.43999999996,365,41,687568.7999999999,707508.2399999999
788,U42907,406,-3093.4699999999775,280,126,564062.7299999999,560969.2599999999
789,U15084,405,84936.39000000004,372,33,171137.48999999985,256073.8799999999
790,U14412,405,91765.87,340,65,333635.28,425401.15
791,U12094,405,-4640.9000000000015,238,167,252482.50999999998,247841.61
792,U17020,405,-10185.330000000007,228,177,506670.33999999997,496485.00999999995
793,U18678,405,-8441.07999999997,319,86,750717.1,742276.02
794,U36751,405,62941.02,362,43,270769.85,333710.87
795,U12920,404,16935.239999999994,366,38,212952.5499999998,229887.7899999998
796,U40922,404,8313.250000000015,382,22,106609.9,114923.15000000001
797,U34753,404,-52883.20000000001,357,47,468554.1600000001,415670.9600000001
798,U38839,404,64408.16000000016,250,154,1706132.1699999997,1770540.3299999998
799,U30047,404,-68306.98999999998,343,61,192970.59999999998,124663.61
800,U25524,404,-55552.73999999993,161,243,1100628.3100000003,1045075.5700000003
801,U37705,403,52136.76000000002,344,59,945592.2999999999,997729.0599999999
802,U24684,403,685657.1799999989,132,271,1376603.2399999998,2062260.4199999985
803,U22237,403,9789.490000000002,380,23,163816.26999999996,173605.75999999995
804,U25515,402,-12401.779999999995,114,288,373184.88000000006,360783.1000000001
805,U14175,402,-3566.8100000000613,358,44,859882.3199999998,856315.5099999998
806,U15685,402,23271.429999999924,349,53,2809961.81,2833233.2399999998
807,U902220,402,-5850.60999999999,292,110,242690.91999999998,236840.31
808,U30662,401,668.7900000000045,296,105,418224.44,418893.23
809,U17911,401,-6298.899999999994,278,123,1135535.6400000001,1129236.7400000002
810,U33730,401,-58279.919999999984,279,122,1192267.3100000003,1133987.3900000004
811,U43510,401,31483.10999999995,313,88,320972.58999999944,352455.6999999994
812,U27103,401,-4182.029999999981,375,26,214483.26,210301.23000000004
813,U14706,401,-352620.85999999987,349,52,1885079.4899999993,1532458.6299999994
814,U34563,401,-7829.660000000007,355,46,129587.74,121758.08
815,U22345,401,-11221.989999999852,314,87,748506.1000000002,737284.1100000003
816,U900335,400,77.63999999999582,199,201,245027.19,245104.83
817,U30820,400,1060504.1699999997,347,53,4977034.91,6037539.08
818,U14725,400,-41385.150000000016,378,22,255917.38000000012,214532.2300000001
819,U17480,400,13940.580000000009,371,29,137418.02999999985,151358.60999999987
820,U12886,400,-273465.2,373,27,714176.2799999998,440711.0799999998
821,U23788,400,-67718.47999999992,347,53,1530216.5000000005,1462498.0200000005
822,U25245,399,-161042.4200000001,313,86,4822127.8100000005,4661085.390000001
823,U28186,399,-5681.529999999995,357,42,156608.94999999998,150927.41999999998
824,U10041,399,-5129.949999999988,355,44,745269.52,740139.5700000001
825,U32917,399,984.5900000000056,386,13,35788.48,36773.07000000001
826,U12980,399,-178.05000000000808,308,91,150753.0999999999,150575.04999999987
827,U37756,399,-27731.62000000001,308,91,493331.10000000003,465599.48000000004
828,U29492,399,-25009.310000000045,372,27,146261.34999999983,121252.03999999979
829,U13038,399,-137041.74000000017,362,37,419294.7200000003,282252.98000000016
830,U9794,398,7536.109999999999,368,30,223750.92000000025,231287.03000000023
831,U691457,398,-5911.890000000032,269,129,299064.8900000001,293153.00000000006
832,U14660,398,-709292.0799999997,379,19,1704881.0100000005,995588.9300000007
833,U38469,398,-6119.650000000023,271,127,1720235.7999999984,1714116.1499999985
834,U35490,398,-13162.010000000028,167,231,1375442.2900000003,1362280.2800000003
835,U20012,398,-11102.76,280,118,583335.6099999998,572232.8499999997
836,U10723,398,-13937.730000000065,320,78,928882.7199999999,914944.9899999998
837,U8703,397,-539574.03,377,20,895785.2300000001,356211.20000000007
838,U602424,397,-12432.00999999998,284,113,52722.389999999956,40290.379999999976
839,U29688,397,7113.560000000003,344,53,56417.939999999995,63531.5
840,U42271,397,-7966.440000000001,379,18,96935.48000000007,88969.04000000007
841,U621508,397,1254.9500000000298,309,88,372694.32999999996,373949.27999999997
842,U17361,397,-1370053.5999999985,373,24,6152792.129999999,4782738.53
843,U37136,397,-4617.569999999992,383,14,135166.23,130548.66000000002
844,U1183733,397,-23612.98999999999,273,124,278101.86,254488.87
845,U38372,396,-662274.4099999977,120,276,41153316.06,40491041.650000006
846,U20180,396,-8978.099999999993,292,104,102838.84999999996,93860.74999999997
847,U42829,396,4908.320000000022,372,24,248162.3599999998,253070.67999999985
848,U13303,396,-8228.01000000001,355,41,269126.9999999999,260898.98999999987
849,U29967,396,-145897.02999999985,170,226,1888820.92,1742923.8900000001
850,U29831,395,-920.1899999999862,171,224,871807.68,870887.4900000001
851,U17032,395,-65161.35000000001,363,32,349287.14,284125.79
852,U8760,395,-5439.33,369,26,44474.17,39034.84
853,U39942,395,2628.029999999954,342,53,639328.9300000007,641956.9600000007
854,U19719,395,927.1899999999343,363,32,245770.25000000006,246697.44
855,U30183,394,15952.819999999956,280,114,1642234.71,1658187.53
856,U8262,394,33537.660000000025,296,98,455460.79,488998.45
857,U1062296,394,450.54000000000167,208,186,232104.51000000004,232555.05000000005
858,U15444,394,4529.67000000014,144,250,6634912.649999999,6639442.319999999
859,U20579,394,-48296.65000000001,341,53,314049.83999999985,265753.1899999998
860,U13800,394,-50257.38000000009,305,89,190917.2,140659.81999999992
861,U8427,394,6668.420000000003,275,119,855526.4000000006,862194.8200000006
862,U31516,394,-16083.649999999965,266,128,1400218.4499999997,1384134.7999999998
863,U39700,393,5467.780000000012,361,32,92523.52000000009,97991.3000000001
864,U17350,393,18834.3400000001,335,58,567864.2000000005,586698.5400000006
865,U19475,393,30477.05000000002,296,97,382741.64999999997,413218.7
866,U32588,393,20729.65999999998,351,42,681023.16,701752.8200000001
867,U25578,393,4558.650000000125,274,119,2230132.58,2234691.23
868,U10156,393,-28694.140000000018,271,122,218688.93000000008,189994.79000000007
869,U20355,392,178011.81999999998,362,30,1313825.810000001,1491837.630000001
870,U39945,392,-1468519.7100000002,342,50,3787522.95,2319003.24
871,U12239,392,-1424042.02,365,27,2207710.4699999993,783668.4499999993
872,U39520,392,4205.769999999999,353,39,247271.76999999996,251477.53999999995
873,U19410,392,-12092.01999999999,176,216,1172207.06,1160115.04
874,U15434,392,103712.19999999998,283,109,355405.4900000002,459117.6900000002
875,U16951,392,-21248.51,346,46,590826.29,569577.78
876,U36847,391,31961.09000000001,358,33,595486.5399999999,627447.6299999999
877,U29467,391,2985.969999999965,319,72,919691.3699999998,922677.3399999997
878,U32367,391,2889.3400000000256,219,172,3053615.059999999,3056504.399999999
879,U30334,391,1695831.2199999993,359,32,5815969.5,7511800.719999999
880,U24441,391,103857.08000000007,348,43,1038580.4199999998,1142437.5
881,U37909,391,208500.45999999993,239,152,1440636.8499999994,1649137.3099999994
882,U33429,391,-3099.299999999996,382,9,29912.27,26812.970000000005
883,U984029,391,-15628.710000000003,221,170,175516.48,159887.77000000002
884,U37400,391,-22164.20000000001,354,37,247728.1,225563.9
885,U27668,390,4090.6399999999794,319,71,312503.79000000004,316594.43
886,U25243,390,-935824.2199999995,328,62,14558097.279999997,13622273.059999999
887,U10229,390,18575.91000000001,352,38,92388.07999999999,110963.98999999999
888,U20298,390,-123928.08000000066,359,31,6139580.68,6015652.599999999
889,U24302,390,-117278.7700000004,343,47,6123148.930000004,6005870.160000004
890,U33748,389,-7739.390000000002,366,23,221533.90999999995,213794.51999999993
891,U22278,389,20561.02999999996,362,27,253260.11999999997,273821.1499999999
892,U43094,389,-401047.80000000034,202,187,10212494.16,9811446.36
893,U20021,388,-4701.719999999998,270,118,239398.48000000007,234696.76000000007
894,U16484,388,-91104.80999999997,327,61,360326.3700000002,269221.5600000003
895,U15090,388,-1423368.6699999997,286,102,17111997.11000001,15688628.44000001
896,U9570,388,-39540.86999999994,322,66,491826.56999999983,452285.6999999999
897,U1135193,388,341.78000000000236,241,147,78412.1,78753.88
898,U27832,388,-21902.640000000032,204,184,833080.0599999998,811177.4199999998
899,U20224,387,154233.69,362,25,498040.72000000003,652274.41
900,U22176,387,-87794.73000000001,254,133,1459555.78,1371761.05
901,U17431,386,1283498.3700000008,269,117,707939.82,1991438.1900000009
902,U9743,386,282.02000000000123,376,10,5913.340000000008,6195.36000000001
903,U16666,386,83324.04,367,19,152311.87999999995,235635.91999999993
904,U36704,386,5233.399999999998,305,81,576452.6700000002,581686.0700000002
905,U20930,386,-21949.799999999977,361,25,928703.3800000002,906753.5800000003
906,U10737,386,-16554.269999999986,369,17,80073.82000000005,63519.55000000006
907,U42388,385,-2911.069999999997,336,49,145535.56000000006,142624.49000000005
908,U41527,385,33122.62000000001,299,86,792678.7799999997,825801.3999999997
909,U13501,385,219351.59999999992,319,66,421913.9300000002,641265.5300000001
910,U37330,385,-106313.25000000023,135,250,884453.7599999998,778140.5099999995
911,U31329,385,-6997.789999999993,347,38,33704.840000000004,26707.05000000001
912,U41626,385,5630.82000000008,281,104,3090343.809999999,3095974.6299999994
913,U43458,384,19357.390000000014,323,61,1406971.6899999995,1426329.0799999996
914,U25823,384,33806.31,342,42,188518.7199999999,222325.0299999999
915,U30857,384,-86769.95999999999,341,43,179170.18000000002,92400.22000000003
916,U1094419,384,-0.05999999999812644,197,187,67314.74,67314.68000000001
917,U39601,384,2761.3600000000097,354,30,557376.11,560137.47
918,U24641,384,-6451.450000000021,216,168,402209.06,395757.61
919,U15312,383,-4499.9900000000025,330,53,137043.07999999996,132543.08999999997
920,U11712,383,137341.88999999996,318,65,1414337.8699999996,1551679.7599999995
921,U16964,383,26816.70000000028,194,189,16005476.63,16032293.330000002
922,U8265,383,19630.209999999995,368,15,154198.51,173828.72
923,U9750,383,-133065.74999999948,286,97,5865647.709999998,5732581.959999999
924,U30176,383,16134.019999999642,352,31,1461866.6700000002,1478000.6899999997
925,U16420,383,-3280.229999999947,243,140,795807.2899999996,792527.0599999996
926,U941161,382,45.840000000001936,233,149,132478.38000000003,132524.22000000003
927,U11257,382,-56893.71000000039,247,135,4410732.89,4353839.18
928,U35312,382,7469.090000000001,365,17,112469.98000000005,119939.07000000005
929,U17258,382,4461.729999999974,330,52,990219.5599999999,994681.2899999999
930,U9236,382,4938.460000000012,320,62,639660.3899999998,644598.8499999997
931,U10323,382,13972.740000000009,295,87,239887.3599999999,253860.09999999992
932,U10591,382,-8253.34000000002,359,23,226875.22999999984,218621.8899999998
933,U25809,381,111060.03999999985,303,78,6407389.569999999,6518449.609999999
934,U16770,381,20.880000000003292,292,89,940615.1400000001,940636.0200000001
935,U1335894,381,-4229.44,222,159,91150.87999999999,86921.43999999999
936,U33582,381,-21908.199999999983,215,166,674122.5999999999,652214.3999999999
937,U31591,381,1050913.96,148,233,1225180.7900000003,2276094.75
938,U23481,380,-18199.630000000096,295,85,1515256.1800000002,1497056.55
939,U31061,380,10390.989999999985,324,56,691461.48,701852.47
940,U20203,380,-33614.12999999989,256,124,471568.39,437954.2600000001
941,U16609,380,-63678.56999999992,341,39,3391979.559999998,3328300.9899999984
942,U33474,380,11772.53000000003,356,24,368077.34999999986,379849.8799999999
943,U15404,380,-11005.759999999933,358,22,239959.00999999975,228953.24999999983
944,U21126,380,-12693.760000000022,319,61,388271.71999999974,375577.95999999973
945,U16879,380,705259.7799999997,331,49,394258.65000000014,1099518.4299999997
946,U20731,380,-168.13999999998742,227,153,230651.07000000004,230482.93000000005
947,U19981,380,31764.010000000024,279,101,434002.02999999985,465766.03999999986
948,U41096,380,254.38999999998487,336,44,421537.36,421791.75
949,U26846,379,302654.5099999999,312,67,2072880.2399999995,2375534.7499999995
950,U10787,379,-26218.010000000002,368,11,92645.11,66427.1
951,U15262,379,7035.98999999996,313,66,418117.55000000016,425153.5400000001
952,U33911,379,-30955.90999999999,369,10,105547.70000000004,74591.79000000005
953,U19102,379,50918.909999999996,216,163,290957.92999999993,341876.8399999999
954,U18834,379,-19617.329999999984,277,102,854027.8200000002,834410.4900000002
955,U11275,379,334.8000000000006,364,15,15555.009999999997,15889.809999999998
956,U21322,379,3475.270000000012,368,11,18084.039999999994,21559.310000000005
957,U23503,378,-51647.22000000002,343,35,186126.23999999985,134479.01999999981
958,U20712,378,-7463.870000000022,211,167,693212.8800000012,685749.0100000012
959,U16672,378,-8794.909999998286,277,101,6507557.23,6498762.320000002
960,U14198,378,-39136.02000000043,340,38,13486203.960000008,13447067.940000009
961,U33962,377,-15123.14000000002,316,61,545946.4899999999,530823.3499999999
962,U38404,377,-7767.360000000035,358,19,568202.7700000001,560435.4100000001
963,U29649,377,6529.249999999964,350,27,370756.28,377285.52999999997
964,U9665,377,117193.18000000014,277,100,2087903.479999999,2205096.659999999
965,U613083,377,-3161.299999999991,303,74,282733.31999999995,279572.01999999996
966,U18348,377,-14381.259999999995,259,118,560022.2699999999,545641.0099999999
967,U746154,377,2966.540000000001,276,101,80330.55,83297.09
968,U10705,377,-1533.159999999999,320,57,38698.02999999999,37164.869999999995
969,U8871,376,2392.199999999998,150,226,137624.36000000002,140016.56000000003
970,U23951,376,-1261.0800000000074,317,59,71782.70000000004,70521.62000000004
971,U18853,376,-27110.380000000005,355,21,111165.08,84054.7
972,U23533,376,5978.690000000013,218,158,586956.5600000002,592935.2500000002
973,U40708,376,-55722.579999999994,332,44,415552.15,359829.57
974,U32643,376,5736.390000000005,318,58,155084.37999999983,160820.76999999984
975,U24811,376,23316.740000000038,344,32,553246.16,576562.9
976,U14813,376,-423882.18999999994,128,248,1724473.83,1300591.6400000001
977,U26612,376,-134518.64999999997,365,11,301245.11000000004,166726.46000000008
978,U687192,376,42.08000000000038,224,152,14173.98,14216.06
979,U28261,376,186812.81000000006,271,105,136579.88999999998,323392.70000000007
980,U40678,375,61896.52999999997,347,28,973666.7900000007,1035563.3200000008
981,U25156,375,-44744.71000000001,322,53,499089.2600000002,454344.55000000016
982,U1272029,375,734.7099999999969,215,160,196824.02000000008,197558.73000000007
983,U16928,375,-509.97000000000634,285,90,1028939.9900000001,1028430.0200000001
984,U20998,375,-7463.540000000055,259,116,547472.4899999998,540008.9499999997
985,U13111,375,-33223.64000000035,285,90,4259378.1899999995,4226154.549999999
986,U17659,375,16686.08999999994,322,53,769220.6299999998,785906.7199999997
987,U43828,375,17705.039999999994,299,76,601952.03,619657.0700000001
988,U17941,374,-3724.929999999994,338,36,93881.91000000009,90156.9800000001
989,U11835,374,-610.5599999999979,359,15,11494.280000000012,10883.720000000014
990,U41599,374,-797.6499999998854,244,130,3352046.250000002,3351248.600000002
991,U22944,374,379923.94000000024,255,119,4389376.490000001,4769300.430000002
992,U39898,374,-211416.37,306,68,2448262.51,2236846.1399999997
993,U18693,374,-220.09999999996217,318,56,2271467.26,2271247.1599999997
994,U17778,374,-2140.3300000000368,278,96,315872.19000000006,313731.86000000004
995,U31480,374,-36219.679999999986,356,18,69082.88000000002,32863.20000000003
996,U10771,374,45120.22000000044,322,52,8913284.779999997,8958404.999999998
997,U27538,374,9384.709999999997,259,115,193368.62000000002,202753.33000000002
998,U27755,373,25511.91999999999,347,26,229372.1599999999,254884.07999999987
999,U32947,373,-494.4799999999923,208,165,1132436.86,1131942.3800000001
1000,U35033,373,3296.14000000001,330,43,97206.37000000001,100502.51000000002
1001,U31946,373,-3839.109999999991,334,39,172783.81000000003,168944.70000000004
1002,U11363,373,-285274.43999999977,360,13,1099034.2600000002,813759.8200000005
1003,U13875,373,-50813.88000000012,351,22,130325.59000000011,79511.70999999999
1004,U26525,373,-7066.369999999997,340,33,61318.39000000001,54252.02000000001
1005,U43418,373,-799.4499999999971,344,29,140644.99,139845.53999999998
1006,U13950,373,-6236.520000000005,234,139,302512.85000000003,296276.33
1007,U31539,373,44956.03,338,35,100489.80999999997,145445.83999999997
1008,U12458,373,-16582.21000000002,204,169,573272.15,556689.94
1009,U10898,373,-718.5499999999674,252,121,508399.07999999996,507680.52999999997
1010,U9754,373,-23013.879999999997,343,30,65803.14000000001,42789.26000000002
1011,U18567,373,-18497.66000000015,287,86,1322613.34,1304115.68
1012,U43305,373,361732.1499999999,297,76,1091813.3000000003,1453545.4500000002
1013,U18012,373,-247538.71999999997,353,20,331827.5999999999,84288.87999999995
1014,U31802,372,168609.81000000026,361,11,941100.5600000004,1109710.3700000006
1015,U16485,372,768233.5700000001,334,38,4999701.080000002,5767934.650000002
1016,U1106492,372,2193.579999999999,201,171,35254.09,37447.67
1017,U20686,372,-4604.520000000006,350,22,765297.0500000006,760692.5300000006
1018,U11705,372,-7757.980000000018,350,22,88883.27000000002,81125.29000000001
1019,U30978,372,315.5599999999873,304,68,164653.64999999973,164969.20999999973
1020,U42491,372,-7653.48999999998,290,82,431735.8299999999,424082.3399999999
1021,U15731,372,-9055.470000000016,316,56,299358.63000000006,290303.16000000003
1022,U22214,372,-632.1799999998184,308,64,598942.2100000001,598310.0300000003
1023,U40197,372,-7335.699999999825,311,61,6375904.879999998,6368569.179999998
1024,U26991,372,-9018.25000000001,304,68,283877.5799999998,274859.3299999998
1025,U983880,371,196388.55999999985,154,217,533948.5699999998,730337.1299999997
1026,U29918,371,-8247.080000000002,338,33,155440.74,147193.65999999997
1027,U30070,371,-6657.050000000047,285,86,1191186.4100000001,1184529.36
1028,U26376,371,618.0800000000036,319,52,86046.04999999999,86664.12999999999
1029,U26262,370,6577.220000000019,310,60,733771.9700000003,740349.1900000003
1030,U21406,370,19195.739999999918,248,122,409294.3600000003,428490.1000000002
1031,U14249,370,-39000.86999999998,342,28,667641.3200000002,628640.4500000002
1032,U22800,370,147577.3200000002,315,55,200535.83999999982,348113.16000000003
1033,U29852,370,-52261.47000000006,240,130,175315.82000000004,123054.34999999998
1034,U15828,370,-288269.37000000017,295,75,456237.0000000001,167967.62999999995
1035,U9292,370,1551.5699999996832,351,19,1880857.5699999996,1882409.1399999992
1036,U29334,370,-508853.7200000002,260,110,4352896.779999999,3844043.059999999
1037,U33717,370,69827.52999999997,264,106,1764010.9500000002,1833838.4800000002
1038,U24009,369,-58457.710000000014,350,19,227958.98999999985,169501.27999999982
1039,U10116,369,50142.350000000006,337,32,723012.4000000004,773154.7500000003
1040,U34979,369,-2853.55,355,14,60726.85,57873.299999999996
1041,U28582,369,13829.400000000021,205,164,327589.49,341418.89
1042,U9098,369,7302.390000000025,332,37,532454.6599999998,539757.0499999998
1043,U32549,369,23830.68000000006,260,109,940600.93,964431.6100000001
1044,U41715,369,56433.27999999997,304,65,1135517.8100000005,1191951.0900000005
1045,U34798,368,-20814.920000000006,316,52,760007.38,739192.46
1046,U15516,368,11229.159999999958,324,44,367740.6999999999,378969.85999999987
1047,U34466,368,-1182.0900000000113,340,28,127634.24000000005,126452.15000000004
1048,U22052,368,-10770.460000000068,267,101,5423463.770000001,5412693.310000001
1049,U19967,368,-20265.399999999983,343,25,78164.16000000003,57898.76000000005
1050,U10469,368,-12207.720000000005,357,11,165940.29,153732.57
1051,U39852,368,17960.149999999983,328,40,343102.5700000001,361062.7200000001
1052,U1093090,368,0.0,184,184,119800.0,119800.0
1053,U31116,368,540548.39,326,42,1337737.48,1878285.87
1054,U36096,367,53523.71999999996,344,23,327098.07999999967,380621.79999999964
1055,U8285,367,-22253.570000000003,344,23,116053.92000000004,93800.35000000003
1056,U26603,367,-102369.87000000002,336,31,440698.23000000004,338328.36
1057,U41725,367,-25354.11,343,24,191638.69,166284.58000000002
1058,U28447,367,-543.7400000000125,322,45,429394.5,428850.76
1059,U20790,367,306.1400000000029,355,12,33480.65,33786.79
1060,U31517,367,30077.29000000016,233,134,1610638.3700000003,1640715.6600000006
1061,U20078,367,-166204.28,249,118,1015986.9099999999,849782.6299999999
1062,U9344,367,14330.900000000003,354,13,43622.34999999998,57953.24999999998
1063,U15392,367,32535.160000000033,330,37,578716.1900000001,611251.3500000001
1064,U42239,367,-17776.02999999999,347,20,124825.06999999998,107049.03999999998
1065,U1314199,367,58.09000000000008,243,124,13372.809999999998,13430.899999999998
1066,U27801,366,-636761.1499999992,314,52,2572895.7899999996,1936134.6400000004
1067,U41362,366,6038.3800000000065,331,35,94798.87,100837.25
1068,U17990,366,-40303.020000002565,323,43,39295296.779999994,39254993.75999999
1069,U16246,366,-1840.329999999983,331,35,221671.03000000003,219830.70000000004
1070,U19861,366,-27214.209999999977,145,221,250224.21000000008,223010.00000000012
1071,U43841,366,-19579.019999999997,338,28,196141.88999999996,176562.86999999997
1072,U42315,366,-40985.43999999997,285,81,834504.3300000001,793518.8900000001
1073,U1236417,366,3961.719999999994,215,151,80299.44,84261.16
1074,U11826,366,-140337.07000000004,340,26,1634371.8900000008,1494034.8200000008
1075,U16812,366,2371.2099999999855,310,56,393378.89999999997,395750.1099999999
1076,U27856,366,-16043.800000000007,214,152,266448.53,250404.73
1077,U15962,366,-54989.869999999995,325,41,1280260.39,1225270.52
1078,U42629,366,-149209.95999999967,284,82,3835633.3799999994,3686423.42
1079,U34153,366,-1177.8700000001338,322,44,1043132.03,1041954.1599999999
1080,U42703,365,52653.80999999996,340,25,747703.65,800357.46
1081,U18317,365,-37683.11000000001,318,47,696063.01,658379.9
1082,U14426,365,75160.96999999994,279,86,611738.65,686899.62
1083,U606264,365,-320.00000000000057,243,122,19941.799999999992,19621.799999999992
1084,U40048,365,48937.13000000004,275,90,1403129.4299999995,1452066.5599999996
1085,U9021,365,-25642.999999999844,339,26,2122015.2800000003,2096372.2800000005
1086,U1318907,365,1577.9699999999984,201,164,36021.8,37599.770000000004
1087,U27495,365,-90293.45000000003,259,106,310173.3599999999,219879.90999999992
1088,U21671,365,-73513.38999999958,311,54,6043460.170000002,5969946.780000002
1089,U13250,365,5668.650000000013,208,157,523538.26999999996,529206.9199999999
1090,U16727,365,-45133.35,301,64,539341.63,494208.28
1091,U43373,364,-1200.6700000000017,340,24,46396.480000000025,45195.81000000003
1092,U43472,364,101583.57999999997,241,123,839680.3300000001,941263.91
1093,U21645,364,16530.269999999993,244,120,1254928.6200000003,1271458.8900000004
1094,U10818,364,-3774.1900000000146,308,56,196586.49999999985,192812.30999999985
1095,U43166,364,-1241.7100000000044,290,74,140704.40999999995,139462.69999999995
1096,U25241,364,-5212.019999999946,240,124,2332655.95,2327443.93
1097,U29365,364,395921.0800000002,336,28,760604.1200000005,1156525.2000000007
1098,U30716,364,1195.1000000000015,345,19,48188.130000000005,49383.23
1099,U43732,364,11444.569999999994,330,34,112618.63,124063.2
1100,U24859,364,-4653.159999999982,333,31,215044.23000000004,210391.07000000007
1101,U15627,364,-6704.789999999981,320,44,245573.49999999968,238868.7099999997
1102,U41786,363,11960.070000000002,264,99,445399.20999999985,457359.27999999985
1103,U41285,363,-340541.51000000007,218,145,3307255.6399999997,2966714.1299999994
1104,U27136,363,-9746.790000000012,305,58,374719.2200000001,364972.43000000005
1105,U23299,363,-5326.510000000047,337,26,399902.4800000001,394575.97000000003
1106,U35545,363,-4577.759999999933,335,28,1188317.0500000003,1183739.2900000003
1107,U30264,363,-21488.540000000008,322,41,114567.56000000001,93079.02
1108,U28837,363,21195.030000000203,312,51,1530304.67,1551499.7000000002
1109,U40840,363,217224.74000000008,348,15,67332.09000000003,284556.8300000001
1110,U31549,362,-21642.979999999985,353,9,152182.17000000004,130539.19000000006
1111,U9206,362,-2484.6800000000003,291,71,115360.48,112875.79999999999
1112,U18926,362,4994498.239999993,320,42,880318.4200000006,5874816.659999994
1113,U28330,362,-4409.999999999996,332,30,124723.84,120313.84
1114,U9242,362,-546617.6399999999,340,22,1154537.4,607919.76
1115,U10271,362,-11042.120000000003,348,14,25348.759999999984,14306.639999999981
1116,U28766,362,-21641.840000000004,315,47,620147.7099999998,598505.8699999999
1117,U23101,362,574.5899999999897,299,63,66340.51000000001,66915.1
1118,U32601,362,1963.7699999999968,307,55,122703.48000000001,124667.25
1119,U22918,362,-45330.600000000006,230,132,775566.469999999,730235.8699999991
1120,U33194,362,337.9599999999991,307,55,84196.25,84534.20999999999
1121,U9237,362,-448998.33999999997,351,11,581615.4799999999,132617.1399999999
1122,U8958,362,-137633.56,352,10,294798.45000000007,157164.89000000007
1123,U8926,361,4998.7800000000225,329,32,564707.1199999998,569705.8999999998
1124,U32098,361,-1244.15999999999,315,46,769950.0200000005,768705.8600000005
1125,U41892,361,16887.75,318,43,129797.68000000001,146685.43
1126,U13312,361,-19113.889999999898,239,122,1614128.0400000003,1595014.1500000004
1127,U36168,361,1699.949999999927,256,105,954597.7000000001,956297.65
1128,U13813,361,3798.4700000000125,317,44,65815.50000000007,69613.97000000009
1129,U10937,361,661.7100000000069,209,152,262984.03,263645.74000000005
1130,U32829,361,-44015.420000000006,339,22,403422.49,359407.07
1131,U35897,361,-12456.57999999998,248,113,636978.8300000001,624522.2500000001
1132,U20026,361,-4849.649999999994,311,50,108517.35,103667.70000000001
1133,U26280,361,-4524.939999999975,342,19,286697.58999999997,282172.64999999997
1134,U10828,361,-7081.4599999999955,291,70,459975.81,452894.35
1135,U23525,361,-4109.480000000014,326,35,187964.32999999993,183854.84999999992
1136,U25368,360,-177945.91999999993,328,32,473329.26999999996,295383.35000000003
1137,U33513,360,755785.94,246,114,1263676.1500000006,2019462.0900000005
1138,U27694,360,87982.63,321,39,693351.1000000006,781333.7300000006
1139,U16930,360,-1538.8700000000044,336,24,57572.560000000005,56033.69
1140,U19026,360,5059.3900000000185,220,140,526523.1500000001,531582.5400000002
1141,U35909,360,-133315.16000000012,258,102,1228563.010000001,1095247.8500000008
1142,U37196,360,2228.6600000000017,343,17,27236.809999999994,29465.469999999994
1143,U24632,360,36593.22999999963,291,69,7895489.42,7932082.649999999
1144,U22933,360,-1369629.5699999998,333,27,4725038.2600000035,3355408.6900000037
1145,U11693,360,-10783.730000000049,290,70,1585553.53,1574769.8
1146,U13777,360,-55634.26999999999,318,42,308648.7700000002,253014.5000000002
1147,U8050,360,-604.2499999999827,324,36,85796.00000000007,85191.75000000009
1148,U8536,359,1629.7600000000061,310,49,197909.75,199539.51
1149,U20553,359,-16738.380000000005,341,18,254710.11999999997,237971.73999999996
1150,U22449,359,48164.42,333,26,420708.72000000003,468873.14
1151,U40046,359,-51.419999999999426,322,37,21679.359999999993,21627.939999999995
1152,U40624,359,-53332.14000000006,336,23,403042.0499999999,349709.9099999998
1153,U42151,359,-27400.010000000006,118,241,2068146.77,2040746.76
1154,U14649,359,214147.7099999999,279,80,6083650.800000001,6297798.510000001
1155,U35418,359,-129131.26999999993,324,35,962823.5000000005,833692.2300000006
1156,U15000,359,-500.49000000001024,337,22,210827.49,210326.99999999997
1157,U40016,359,-9892.930000000004,344,15,155304.51999999996,145411.58999999997
1158,U12973,359,-3748.4200000000087,314,45,297677.87000000005,293929.45000000007
1159,U34728,358,-4951.230000000002,267,91,384353.75000000006,379402.5200000001
1160,U29772,358,-113739.95000000001,341,17,316246.09,202506.14
1161,U39907,358,-4655.059999999994,322,36,40032.97999999997,35377.91999999997
1162,U42728,358,-6452.129999999999,300,58,306121.3799999999,299669.2499999999
1163,U15091,358,87238.72,330,28,237311.70999999993,324550.42999999993
1164,U11969,358,-39859.74999999999,342,16,149795.62999999998,109935.87999999998
1165,U15395,358,296146.2199999996,330,28,64565.240000000056,360711.4599999997
1166,U27213,358,-8406.070000000007,204,154,1565856.23,1557450.16
1167,U34094,358,13964.52999999997,318,40,176115.10999999984,190079.6399999998
1168,U14981,357,-736077.29,335,22,22084290.839999996,21348213.549999997
1169,U32428,357,28423.560000000016,191,166,935278.4200000002,963701.9800000002
1170,U15982,357,333394.4099999999,333,24,496640.03,830034.44
1171,U24977,357,-17876.50000000002,330,27,309579.56999999995,291703.06999999995
1172,U19061,357,28800.290000000045,200,157,3961233.4399999985,3990033.7299999986
1173,U27236,357,-13012.380000000023,279,78,533532.45,520520.06999999995
1174,U29908,357,-346.7300000000006,283,74,18717.879999999986,18371.149999999987
1175,U8371,357,61832.34999999993,279,78,1018658.5100000004,1080490.8600000003
1176,U978850,357,980.7800000000007,207,150,214853.5,215834.28
1177,U8634,357,6889.089999999882,324,33,916737.7299999999,923626.8199999997
1178,U23783,356,-17186.849999999973,319,37,1973242.8799999987,1956056.0299999989
1179,U32779,356,-26923.309999999994,253,103,1612629.7599999998,1585706.4499999997
1180,U39550,356,34104.26999999999,344,12,36588.280000000006,70692.54999999999
1181,U13335,356,23394.859999999997,325,31,845464.55,868859.41
1182,U21049,356,104889.56999999996,268,88,372265.2699999997,477154.8399999997
1183,U23251,356,-24357.610000000335,230,126,13564261.91,13539904.3
1184,U29544,356,-2763.569999999974,270,86,204339.7000000001,201576.13000000012
1185,U9353,356,-29899.380000000023,334,22,166974.21999999994,137074.8399999999
1186,U30037,356,3060.509999999984,330,26,122012.75000000001,125073.26
1187,U22455,356,180322.70000000007,308,48,462575.11,642897.81
1188,U40899,356,-4419.690000000004,313,43,35862.37999999998,31442.68999999998
1189,U42602,356,2999.5500000000047,332,24,115838.41,118837.96
1190,U33261,356,-7930.92,325,31,113204.85,105273.93000000001
1191,U21045,356,116495.77000000005,304,52,1298040.4300000004,1414536.2000000004
1192,U13369,356,-6695.850000000035,329,27,1032863.3900000001,1026167.54
1193,U20001,356,28301.880000000005,272,84,158975.98,187277.86000000002
1194,U23745,355,-263.6400000000865,261,94,455950.31,455686.6699999999
1195,U29601,355,2163.009999999971,274,81,96806.60999999999,98969.61999999995
1196,U35466,355,-32603.219999999998,349,6,61687.299999999996,29084.079999999998
1197,U22926,355,-38386.980000000025,325,30,903272.6699999999,864885.69
1198,U1373948,355,4868.04,292,63,194975.55,199843.59
1199,U20367,355,-3249.479999999982,314,41,245305.69999999975,242056.21999999977
1200,U11467,355,108474.21000000002,267,88,385992.82,494467.03
1201,U41265,355,-788.8599999999817,330,25,143047.66,142258.80000000002
1202,U8340,355,9133.15,204,151,10721.409999999998,19854.559999999998
1203,U41369,355,12178.359999999986,314,41,2108059.26,2120237.6199999996
1204,U21366,355,-147533.75,212,143,1455555.82,1308022.07
1205,U44025,355,-76624.39000000006,218,137,449487.13000000006,372862.74
1206,U31150,355,27547.80000000002,212,143,763936.6799999998,791484.4799999999
1207,U25941,355,131024.73999999998,274,81,1356357.66,1487382.4
1208,U675374,355,14.490000000004855,191,164,19585.640000000007,19600.130000000012
1209,U35896,354,-1353.0400000000025,341,13,23547.86,22194.82
1210,U16275,354,-34209.15000000006,282,72,147446.74,113237.58999999994
1211,U32440,354,-208981.82999999993,293,61,11739713.750000006,11530731.920000006
1212,U20242,354,10515.939999999957,335,19,63775.399999999805,74291.33999999976
1213,U13132,354,75593.09000000013,225,129,1684638.6400000006,1760231.7300000007
1214,U13320,354,11965.82999999999,283,71,679857.3400000004,691823.1700000004
1215,U40706,354,-26243.319999999985,328,26,92672.44999999995,66429.12999999998
1216,U17304,354,7639.1399999999985,201,153,1302129.7200000004,1309768.8600000003
1217,U26817,353,123813.31000000001,330,23,209398.97999999995,333212.29
1218,U758410,353,883.6300000000036,231,122,264871.84,265755.47000000003
1219,U41705,353,117015.44000000028,321,32,3226809.0,3343824.4400000004
1220,U29364,353,352300.85000000003,274,79,4263151.699999999,4615452.549999999
1221,U39187,353,306538.09,292,61,1196037.57,1502575.6600000001
1222,U35238,353,89100.38000000003,331,22,939398.93,1028499.31
1223,U935307,353,1036.159999999998,313,40,87004.28,88040.44
1224,U31310,353,-1400.319999999996,318,35,81382.1,79981.78000000001
1225,U42225,353,1196.4599999999953,334,19,32450.899999999998,33647.35999999999
1226,U28590,353,-18351.82999999998,258,95,1495979.7099999993,1477627.8799999992
1227,U23911,353,32342.350000000006,340,13,112315.01000000001,144657.36000000002
1228,U33050,353,52633.01999999996,315,38,1116412.0999999999,1169045.1199999999
1229,U27945,352,-9236.430000000017,322,30,547989.48,538753.0499999999
1230,U27232,352,-6032.500000000014,323,29,204862.75999999986,198830.25999999986
1231,U20992,352,26216.809999999965,270,82,1090103.1200000008,1116319.9300000009
1232,U25525,352,29953.749999999996,258,94,848495.5599999998,878449.3099999998
1233,U12970,352,-78615.61000000004,311,41,1532747.4499999986,1454131.8399999985
1234,U34498,352,6333.870000000021,329,23,99357.24000000005,105691.11000000007
1235,U20437,352,12973.050000000003,327,25,91799.05,104772.1
1236,U10977,351,-84786.60999999999,265,86,799045.1300000001,714258.5200000001
1237,U14526,351,72622.30000000009,339,12,644902.5900000001,717524.8900000001
1238,U29341,351,-82567.98999999999,319,32,1478700.4199999995,1396132.4299999995
1239,U41901,351,98007.57,184,167,3360556.2800000003,3458563.85
1240,U11795,351,5472.470000000005,256,95,427904.4199999998,433376.88999999984
1241,U32627,351,-128165.87999999999,327,24,460637.70000000007,332471.82000000007
1242,U1383755,351,-2040.619999999988,228,123,174622.03,172581.41
1243,U26212,351,-37981.79000000006,326,25,317756.9400000001,279775.1500000001
1244,U38935,351,115635.40999999999,320,31,411096.48,526731.89
1245,U16849,351,-468733.66999999946,262,89,24592539.1,24123805.430000003
1246,U41195,351,-9830.57000000006,192,159,968117.05,958286.48
1247,U39105,351,-1269526.96,236,115,3949069.64,2679542.68
1248,U33212,351,1715.1400000000085,265,86,138547.25999999998,140262.4
1249,U17154,351,30648.179999999993,316,35,359308.24,389956.42
1250,U42099,351,-1995727.8899999994,330,21,2275993.19,280265.3000000005
1251,U24794,351,19635.18999999999,344,7,70904.85999999999,90540.04999999997
1252,U15497,350,-9971.270000000102,240,110,821146.4299999997,811175.1599999996
1253,U832833,350,457.78999999999974,260,90,17410.410000000003,17868.200000000004
1254,U25098,350,9473.750000000004,262,88,199164.50000000015,208638.25000000015
1255,U13737,350,896.7699999999808,224,126,1247269.5399999996,1248166.3099999996
1256,U25391,350,-408430.3599999999,272,78,3093314.14,2684883.7800000003
1257,U8384,350,-794.5399999999936,286,64,75915.05000000003,75120.51000000004
1258,U43387,350,10735.840000000006,330,20,71530.56000000001,82266.40000000002
1259,U42737,350,-3083.230000000007,299,51,145816.21000000002,142732.98
1260,U38941,350,17265.71,310,40,201306.48999999993,218572.19999999992
1261,U29981,350,-21544.84999999998,298,52,964936.0999999999,943391.2499999999
1262,U11427,350,-109953.87999999992,176,174,1042619.9599999996,932666.0799999997
1263,U11721,350,113322.66999999997,325,25,211925.62000000002,325248.29
1264,U8944,349,-1872.7999999999902,210,139,737770.4,735897.6
1265,U17549,349,10318.12000000001,310,39,217528.4200000001,227846.5400000001
1266,U9315,349,7595.879999999983,306,43,69100.89000000001,76696.76999999999
1267,U41752,349,39004.3100000002,273,76,2065941.74,2104946.0500000003
1268,U25704,349,-6950.600000000007,325,24,103201.81000000001,96251.21
1269,U25109,349,515.2099999999627,286,63,2436538.39,2437053.6
1270,U25635,349,2450.3300000000454,219,130,939428.8700000001,941879.2000000002
1271,U31486,349,-110628.00999999992,316,33,186976.68999999983,76348.6799999999
1272,U43968,349,24567.869999999923,238,111,941959.8500000003,966527.7200000002
1273,U14419,349,-56970.260000000024,309,40,1213038.6700000002,1156068.4100000001
1274,U36980,349,-429.97999999999934,332,17,21421.77,20991.79
1275,U12625,349,-1030.3400000000038,313,36,38352.46000000001,37322.12
1276,U11855,349,-2136.399999999994,324,25,316092.3,313955.9
1277,U24738,349,-180110.1299999999,300,49,2970130.8,2790020.67
1278,U16863,348,-53273.42000000003,221,127,742129.6500000003,688856.2300000002
1279,U38297,348,-14331.500000000004,193,155,190570.08,176238.58
1280,U29917,348,5695.829999999999,279,69,61759.21,67455.04
1281,U35147,348,-52603.609999999935,248,100,4314168.540000001,4261564.930000001
1282,U26100,348,3808.8900000000003,219,129,47577.73,51386.62
1283,U20020,348,-2494.1699999999964,223,125,107679.12000000002,105184.95000000003
1284,U12234,348,4396.450000000005,280,68,309282.56000000006,313679.01000000007
1285,U17772,348,-24071.230000000003,333,15,81285.91,57214.68
1286,U28578,348,-81175.04999999996,297,51,680220.2000000002,599045.1500000003
1287,U40511,348,-11598.640000000003,333,15,115480.40000000002,103881.76000000002
1288,U30929,348,-11634.119999999995,270,78,2185126.499999999,2173492.379999999
1289,U25509,348,-277.00999999994747,96,252,261183.33000000002,260906.32000000007
1290,U19490,347,38573.170000000035,255,92,342597.32,381170.49000000005
1291,U32666,347,6133.509999999972,161,186,617878.11,624011.62
1292,U27105,347,283663.83000000013,303,44,7016017.460000003,7299681.290000003
1293,U40374,347,10647.869999999988,216,131,475842.97,486490.83999999997
1294,U21122,347,163036.0600000003,306,41,548971.3300000005,712007.3900000008
1295,U18686,347,-267152.54999999993,252,95,5438455.289999999,5171302.739999999
1296,U30163,347,-298999.6300000004,302,45,1226041.61,927041.9799999997
1297,U23613,347,-517433.50999999995,307,40,1620378.39,1102944.88
1298,U32475,347,7455.869999999984,169,178,408360.81,415816.68
1299,U8399,347,352.2700000000011,244,103,125769.99999999993,126122.26999999993
1300,U11024,347,-103115.47999999975,267,80,791824.32,688708.8400000002
1301,U28480,347,1586.720000000001,320,27,119687.30999999995,121274.02999999996
1302,U13088,346,4735.220000000014,288,58,629029.5,633764.72
1303,U41219,346,-23418.790000000037,309,37,663480.2800000001,640061.4900000001
1304,U14382,346,-30400.51999999999,326,20,105242.49999999999,74841.98
1305,U14364,346,97420.21000000008,250,96,2261694.5999999996,2359114.8099999996
1306,U39989,346,-62196.50000000003,324,22,420048.95,357852.44999999995
1307,U14187,346,-2848.2300000000378,264,82,408934.3600000002,406086.1300000002
1308,U21390,346,-22125.4,323,23,75953.73999999999,53828.33999999999
1309,U12555,346,36509.40999999992,316,30,437047.0900000001,473556.5
1310,U41185,346,-30018.889999999996,321,25,85519.11999999998,55500.22999999998
1311,U621474,346,502.2800000000025,182,164,107079.99000000002,107582.27000000002
1312,U8101,346,-39422.10000000006,317,29,290965.6500000001,251543.55000000002
1313,U44058,346,-9306.930000000004,319,27,66549.54000000004,57242.61000000003
1314,U43965,346,-7438.589999999988,320,26,119605.6,112167.01000000002
1315,U41473,346,-56044.62999999995,315,31,640738.89,584694.26
1316,U951878,346,3.637978807091713e-12,180,166,140893.84,140893.84
1317,U17684,346,-36082.01000000007,319,27,327762.57000000007,291680.56
1318,U38959,346,66337.44,316,30,269527.01999999996,335864.45999999996
1319,U10471,346,-51148.710000000014,317,29,408644.55000000005,357495.84
1320,U40205,346,-77010.64000000007,302,44,846137.7700000003,769127.1300000001
1321,U33767,346,9128.230000000005,299,47,200655.61000000007,209783.84000000008
1322,U23499,346,-24292.85000000002,257,89,1099122.56,1074829.71
1323,U42130,345,16039.210000000006,239,106,32741.69,48780.90000000001
1324,U35022,345,-42398.91000000015,334,11,2274364.2199999997,2231965.3099999996
1325,U35559,345,-33423.02,328,17,495849.0100000001,462425.9900000001
1326,U18821,345,13236.23999999983,280,65,5381018.47,5394254.71
1327,U15575,345,648082.8200000002,279,66,809850.0399999999,1457932.86
1328,U28210,345,-59256.92,309,36,119452.53,60195.61
1329,U9924,345,-73236.61000000002,271,74,485110.1099999999,411873.4999999999
1330,U34325,345,2.650000000016007,317,28,392893.15999999986,392895.8099999999
1331,U1128890,344,-444.2499999999952,239,105,73006.80000000002,72562.55000000002
1332,U27706,344,-10568.889999999996,317,27,87017.26,76448.37
1333,U15457,344,-575157.9000000005,302,42,1168106.97,592949.0699999995
1334,U22949,344,-1105.5099999999993,323,21,20518.189999999995,19412.679999999997
1335,U16168,344,-6659.809999999969,96,248,944012.64,937352.8300000001
1336,U28746,344,-98259.59999999998,311,33,422879.98999999993,324620.38999999996
1337,U880883,344,-0.010000000002058584,179,165,267376.41,267376.39999999997
1338,U17458,344,-22302.96000000019,304,40,2713282.4399999995,2690979.4799999995
1339,U34147,344,-3989.919999999992,308,36,155946.31,151956.39
1340,U18094,344,28559.73999999993,254,90,6234720.91,6263280.65
1341,U28307,344,-3260.690000000015,244,100,688265.3900000001,685004.7000000001
1342,U32490,344,4866.540000000006,313,31,64884.87000000001,69751.41000000002
1343,U36239,344,-9882.890000000023,330,14,55058.380000000034,45175.49000000001
1344,U12096,344,-41056.92000000002,271,73,342799.35000000027,301742.4300000002
1345,U17557,344,4493.409999999945,196,148,207741.89000000004,212235.3
1346,U8023,344,-201.77999999996246,208,136,1298023.22,1297821.44
1347,U14223,344,-255934.3700000002,241,103,3617233.1399999964,3361298.7699999963
1348,U23200,344,999.9299999999944,288,56,85476.54999999997,86476.47999999997
1349,U27952,344,-134316.79000000004,293,51,1705476.5799999991,1571159.789999999
1350,U26631,344,20428.760000000013,316,28,163363.56999999995,183792.32999999996
1351,U42702,344,7301.000000000001,205,139,147160.00999999992,154461.00999999992
1352,U21324,344,-149986.8400000003,174,170,4039904.88,3889918.0399999996
1353,U21370,344,8758.370000000015,262,82,716382.6699999999,725141.0399999999
1354,U10792,344,217238.3599999982,317,27,32438407.589999996,32655645.949999996
1355,U24936,344,-3824.87,312,32,78256.75999999998,74431.88999999998
1356,U13195,344,-49335.35,319,25,202341.12000000008,153005.77000000008
1357,U37080,343,-19354.510000000006,268,75,297462.32999999996,278107.81999999995
1358,U32436,343,2616.530000000017,316,27,192029.52999999994,194646.05999999997
1359,U34997,343,412.51,304,39,42597.52000000008,43010.03000000008
1360,U38826,343,132335.52,328,15,984127.3500000001,1116462.87
1361,U1295251,343,8.860000000001094,255,88,48570.69999999998,48579.55999999998
1362,U36676,343,12230.070000000002,313,30,221770.63000000003,234000.70000000004
1363,U22523,343,-23115.189999999944,285,58,994131.6900000003,971016.5000000003
1364,U33934,343,15885.069999999985,251,92,729258.0000000003,745143.0700000003
1365,U19413,343,107802.01999999992,251,92,2991835.49,3099637.5100000002
1366,U20756,342,1435.0799999999963,241,101,253445.21000000002,254880.29
1367,U34228,342,2414.119999999999,332,10,17693.899999999998,20108.019999999997
1368,U43256,342,-10994.27,310,32,67327.51,56333.23999999999
1369,U34216,342,50098.079999999696,287,55,4227522.21,4277620.29
1370,U40671,342,46998.010000000024,333,9,540722.2999999999,587720.3099999999
1371,U15684,342,-5873.420000000028,225,117,889567.0900000002,883693.6700000002
1372,U26248,342,-50803.08999999989,302,40,1352391.7400000002,1301588.6500000004
1373,U19764,341,126971.90999999997,74,267,550634.8999999999,677606.8099999998
1374,U35175,341,27972.729999999996,247,94,529666.5,557639.23
1375,U12571,341,476428.6599999999,216,125,1348280.3900000001,1824709.05
1376,U15810,341,-17103.729999999934,302,39,671167.1700000006,654063.4400000006
1377,U12512,341,245.62999999999718,324,17,45901.25999999998,46146.88999999998
1378,U23566,341,2583.3800000000056,294,47,187597.8299999999,190181.2099999999
1379,U10607,341,-24352.580000000038,215,126,2503392.01,2479039.4299999997
1380,U37241,341,-79.31000000001904,280,61,225469.07999999996,225389.76999999993
1381,U40819,341,397899.99000000005,305,36,973572.28,1371472.27
1382,U11418,341,-143447.1600000001,234,107,3177954.67,3034507.51
1383,U33124,341,-2184.76,315,26,57280.39000000003,55095.63000000003
1384,U9248,341,-55811.200000000004,293,48,172301.25,116490.04999999999
1385,U25161,341,71419.78000000006,327,14,60429.970000000016,131849.75000000006
1386,U17246,340,297.8800000000767,301,39,1130065.2500000007,1130363.1300000008
1387,U25063,340,169789.00000000003,300,40,1299942.99,1469731.99
1388,U42382,340,-4098.58,315,25,36038.939999999995,31940.359999999993
1389,U9876,340,5265.970000000012,269,71,333563.7800000002,338829.75000000023
1390,U1318434,340,2.8,170,170,32770.0,32772.8
1391,U12218,340,-36248.35000000001,269,71,300866.05,264617.69999999995
1392,U19462,340,36251.40000000002,290,50,633465.19,669716.59
1393,U41968,340,-783.1999999999994,264,76,64739.43000000002,63956.230000000025
1394,U42197,340,24495.64,246,94,585142.9,609638.54
1395,U37965,340,-367.00000000000034,325,15,66309.43000000002,65942.43000000002
1396,U41873,340,27634.120000000028,302,38,855298.9200000007,882933.0400000007
1397,U11607,340,-4832.14000000001,213,127,620008.57,615176.4299999999
1398,U15191,340,-31292.79000000003,285,55,376327.49000000005,345034.7
1399,U23636,340,-50133.05000000002,321,19,160803.57,110670.51999999999
1400,U14140,340,-5284.329999999995,299,41,72176.66999999997,66892.33999999997
1401,U31057,340,14933.799999999981,143,197,1286580.7599999998,1301514.5599999998
1402,U43069,340,5709.0300000000125,194,146,1012245.3800000001,1017954.4100000001
1403,U35514,339,-6687.670000000002,301,38,177830.12999999992,171142.4599999999
1404,U34400,339,-38388.57000000003,297,42,2057724.1599999997,2019335.5899999996
1405,U22947,339,8439.849999999977,290,49,738691.59,747131.44
1406,U21096,339,68176.45999999999,281,58,644005.86,712182.32
1407,U35766,339,-27735.349999999977,306,33,1022181.7699999999,994446.4199999999
1408,U21115,339,-257841.07999999996,319,20,401335.02999999997,143493.95
1409,U15261,339,11008.680000000002,308,31,190422.05000000002,201430.73
1410,U13896,339,-4111.329999999969,275,64,1816679.0899999996,1812567.7599999995
1411,U38139,339,8898.400000000007,322,17,24855.43999999999,33753.84
1412,U16185,339,17925.959999999963,308,31,355750.5600000007,373676.52000000066
1413,U11081,339,-1384.6600000000035,294,45,112844.92,111460.26
1414,U23387,339,-4047.859999999993,319,20,144128.56999999998,140080.71
1415,U36286,339,-57045.70000000003,316,23,410132.2400000002,353086.5400000002
1416,U8935,339,19043.469999999998,315,24,85927.57,104971.04000000001
1417,U36462,339,2924.0000000000014,326,13,89779.95000000004,92703.95000000004
1418,U8334,339,3524.0100000000043,314,25,78955.77000000002,82479.78000000003
1419,U18746,339,7538.849999999911,215,124,1293018.5699999998,1300557.4199999997
1420,U8621,339,-463.71000000000674,297,42,189004.8399999999,188541.1299999999
1421,U10507,339,-1854.5699999999888,263,76,305725.37999999995,303870.80999999994
1422,U26579,338,-21704.529999999864,304,34,537091.87,515387.34000000014
1423,U19848,338,4601.409999999984,210,128,362946.11000000034,367547.5200000003
1424,U12584,338,16027.78999999996,209,129,1182348.8900000001,1198376.6800000002
1425,U34786,338,-126605.65000000001,326,12,182549.43,55943.779999999984
1426,U12908,338,-322795.8700000013,223,115,5982789.7399999965,5659993.869999995
1427,U41879,338,9350.099999999984,278,60,462748.06,472098.16
1428,U25805,338,-65830.88000000003,310,28,627626.1200000002,561795.2400000002
1429,U8884,338,2415.080000000003,327,11,103287.43,105702.51
1430,U32966,338,429436.18000000005,272,66,1594113.8499999996,2023550.0299999998
1431,U37609,338,-12997.069999999992,279,59,1488563.7899999996,1475566.7199999995
1432,U19448,338,16533.250000000007,314,24,96180.01999999999,112713.26999999999
1433,U28269,338,1623.57,325,13,19138.060000000012,20761.630000000012
1434,U25269,338,-4026.7399999999893,311,27,326542.42999999993,322515.68999999994
1435,U14555,338,10894.730000000007,274,64,232162.47000000012,243057.20000000013
1436,U34415,338,-4664.249999999999,243,95,696591.1499999999,691926.8999999999
1437,U8365,338,-6309.740000000054,261,77,1062843.76,1056534.02
1438,U33046,338,38672.87,290,48,975697.8300000002,1014370.7000000002
1439,U26985,338,11410.920000000013,309,29,142566.35999999993,153977.27999999994
1440,U969602,338,-24952.519999999997,209,129,206481.42,181528.90000000002
1441,U21298,337,-3147.1299999999924,320,17,140241.41999999998,137094.28999999998
1442,U22887,337,2983.6900000000196,201,136,115000.1599999999,117983.84999999992
1443,U12180,337,75984.12,226,111,584999.6399999998,660983.7599999998
1444,U31545,337,-156.24999999999767,258,79,501176.60000000027,501020.35000000027
1445,U11064,337,-434624.64,300,37,2059523.4999999995,1624898.8599999994
1446,U12988,337,5996.320000000002,313,24,288035.5899999999,294031.9099999999
1447,U26490,337,-5180.920000000013,315,22,139148.33000000002,133967.41
1448,U36424,337,22621.459999999992,236,101,405624.7200000001,428246.18000000005
1449,U41384,337,-20422.850000000013,318,19,152986.59,132563.74
1450,U973704,337,-11457.699999999997,288,49,51267.18000000002,39809.480000000025
1451,U17670,337,605.8199999999993,299,38,38567.25000000001,39173.07000000001
1452,U36061,337,58689.68999999997,273,64,995188.4600000003,1053878.1500000004
1453,U22031,337,-88902.81000000148,274,63,20476816.229999993,20387913.41999999
1454,U27373,337,3416.8999999999974,288,49,167936.63999999998,171353.53999999998
1455,U31449,336,20983.259999999962,206,130,1089936.4499999997,1110919.7099999997
1456,U42817,336,-22835.010000000002,180,156,1040559.6000000001,1017724.5900000001
1457,U8806,336,-1478.8399999999947,286,50,89646.68999999999,88167.84999999999
1458,U37342,336,10451.659999999942,154,182,1503036.0,1513487.66
1459,U28933,336,-7621.139999999967,313,23,250439.10999999996,242817.97
1460,U1339499,336,-373.8099999999991,217,119,189122.40999999995,188748.59999999995
1461,U12563,336,34558.38000000001,291,45,386307.7199999998,420866.0999999998
1462,U19266,336,-26272.400000000012,304,32,88779.35999999994,62506.959999999934
1463,U12922,336,207217.02999999994,184,152,898452.73,1105669.76
1464,U27201,336,221.90000000002237,306,30,266655.44999999984,266877.34999999986
1465,U22914,336,-56567.819999999985,319,17,776108.7700000001,719540.9500000002
1466,U40889,336,4925.010000000024,312,24,148996.71999999997,153921.72999999998
1467,U19428,336,74092.39000000013,299,37,938081.6900000001,1012174.0800000002
1468,U9474,336,-2593.529999999563,286,50,5416730.710000001,5414137.180000002
1469,U8320,336,34886.59999999992,309,27,1725950.87,1760837.47
1470,U12111,336,-2890.860000000023,232,104,401740.4099999998,398849.54999999976
1471,U16092,336,-143822.62999999995,307,29,1783228.43,1639405.8
1472,U12872,336,5248.710000000035,212,124,1001356.6900000001,1006605.4000000001
1473,U21431,336,-18434.94000000002,306,30,721727.1700000005,703292.2300000004
1474,U16328,336,-14880.249999999989,244,92,340992.31000000006,326112.06000000006
1475,U20824,335,-29526.269999999982,258,77,329723.9299999998,300197.65999999986
1476,U42044,335,-93067.60999999997,180,155,1219005.2,1125937.59
1477,U26424,335,2798.9000000001092,291,44,607974.95,610773.8500000001
1478,U34975,335,19262.759999999995,269,66,490154.10999999987,509416.8699999999
1479,U34713,335,-5964.799999999998,329,6,26259.659999999993,20294.859999999993
1480,U27270,335,-101950.9,275,60,481156.57,379205.67000000004
1481,U28469,335,707.8899999999994,296,39,28018.15,28726.04
1482,U10872,335,324152.4700000002,295,40,1116785.29,1440937.7600000002
1483,U975388,335,-2.3599999999833017,211,124,388196.88999999996,388194.52999999997
1484,U22817,335,346016.38,219,116,2858301.83,3204318.21
1485,U25940,335,91031.51000000021,315,20,1016098.0000000003,1107129.5100000005
1486,U745223,334,0.5300000000047476,175,159,101304.98000000001,101305.51000000001
1487,U20481,334,-52630.47000000001,285,49,367842.82000000007,315212.35000000003
1488,U20045,334,9312.310000000038,230,104,753680.6000000002,762992.9100000003
1489,U43945,334,-320.8900000000008,315,19,13039.459999999994,12718.569999999992
1490,U27084,334,1593.630000000002,270,64,105236.04000000007,106829.67000000007
1491,U22634,334,-191791.79000000004,315,19,650183.3599999999,458391.56999999983
1492,U33569,334,27192.000000000044,305,29,150348.0299999999,177540.02999999997
1493,U14809,334,-175457.57000000004,285,49,1778714.3000000003,1603256.7300000002
1494,U28052,334,35.999999999997044,162,172,178387.33000000007,178423.33000000007
1495,U845778,333,1457.6999999999975,188,145,19117.570000000003,20575.27
1496,U13908,333,-347068.17999999993,277,56,8235358.08,7888289.9
1497,U15948,333,133299.39,247,86,1540991.51,1674290.9
1498,U36650,333,-34849.34,320,13,58768.53,23919.190000000002
1499,U17392,333,-117540.77,267,66,408590.63000000006,291049.86000000004
1500,U21195,333,-66820.4300000001,288,45,1147536.5600000003,1080716.1300000001
1501,U26144,333,-3200.1999999999925,293,40,498581.18,495380.98
1502,U15164,333,-53814.55999999988,179,154,662476.1199999999,608661.56
1503,U21509,333,29136.659999999996,311,22,152177.6199999999,181314.2799999999
1504,U31736,333,104293.37999999998,289,44,778937.3600000001,883230.7400000001
1505,U17899,333,-1377.8799999999956,272,61,221629.19999999998,220251.31999999998
1506,U37293,333,552.1799999999976,319,14,95517.68999999999,96069.86999999998
1507,U40272,333,12730.929999999991,311,22,271835.01999999984,284565.94999999984
1508,U11778,333,25722.58,313,20,48344.090000000004,74066.67000000001
1509,U13914,333,-145221.04000000004,290,43,1209677.7400000005,1064456.7000000004
1510,U11010,332,-60049.70000000001,304,28,143131.9700000001,83082.27000000008
1511,U10207,332,-7110330.550000002,272,60,42864387.229999974,35754056.67999997
1512,U13094,332,48378.82999999999,309,23,156677.03,205055.86
1513,U39877,332,32723.240000000016,302,30,453466.1300000002,486189.37000000017
1514,U715484,332,27184.859999999935,154,178,508883.24000000005,536068.1
1515,U16987,332,-22169.24999999999,316,16,182357.40000000002,160188.15000000002
1516,U37560,332,-7456.2799999999825,187,145,842665.2599999999,835208.9799999999
1517,U22401,332,848221.0000000001,253,79,1276840.7100000007,2125061.710000001
1518,U14880,332,-11924.230000000014,318,14,118050.22999999992,106125.99999999991
1519,U8155,332,2432.5700000000215,265,67,502145.72,504578.29
1520,U19048,332,79657.93000000001,214,118,1805201.000000001,1884858.9300000009
1521,U24957,331,-156.08000000000072,265,66,47440.060000000005,47283.98
1522,U1207254,331,-8.770000000000891,174,157,92889.84999999996,92881.07999999996
1523,U20742,331,-558.7700000000186,236,95,300664.47,300105.69999999995
1524,U31346,331,-7195.129999999997,247,84,209002.62,201807.49
1525,U8108,331,4673.820000000001,316,15,88752.39000000006,93426.21000000006
1526,U11105,331,1068.82999999997,257,74,258196.11999999976,259264.94999999972
1527,U37100,331,56262.17999999999,302,29,569579.4900000001,625841.6700000002
1528,U37024,331,-17611.65000000001,220,111,453665.58,436053.93
1529,U10775,331,-10780.829999999987,306,25,441441.6099999999,430660.7799999999
1530,U21506,331,-1110.5500000000002,315,16,36061.08000000001,34950.530000000006
1531,U23461,331,-4927.9500000000135,257,74,103476.41,98548.45999999999
1532,U14659,331,1285.6400000000356,276,55,737640.3599999999,738925.9999999999
1533,U22890,331,12837.960000000006,268,63,97668.71,110506.67000000001
1534,U42068,331,-7605.380000000007,272,59,479413.49999999994,471808.11999999994
1535,U33094,331,-1093.0099999999957,296,35,169086.99000000005,167993.98000000004
1536,U40210,331,-41927.68000000003,233,98,457502.61000000004,415574.93
1537,U43598,331,-7238.599999999974,304,27,65995.09999999996,58756.499999999985
1538,U17365,331,545003.76,308,23,107187.56999999999,652191.33
1539,U32693,330,7292.330000000002,161,169,416033.87000000005,423326.20000000007
1540,U29457,330,10963.659999999902,248,82,1732104.89,1743068.5499999998
1541,U41271,330,-40681.93999999997,313,17,336773.1599999999,296091.22
1542,U9073,330,-225529.3299999998,249,81,2914223.500000001,2688694.1700000013
1543,U40553,330,15679.710000000017,243,87,1259474.81,1275154.52
1544,U9030,330,81.4700000000114,232,98,301409.75999999995,301491.23
1545,U22966,330,20822.34000000007,253,77,1635711.7699999972,1656534.1099999973
1546,U41091,330,15981.540000000046,310,20,727139.7500000001,743121.2900000002
1547,U41300,330,2746.4100000000085,267,63,474869.07999999996,477615.49
1548,U12047,330,23119.789999999997,315,15,122895.31999999999,146015.11
1549,U13560,330,-19298.459999999992,298,32,72691.0,53392.54000000001
1550,U15037,330,2413.2100000000028,314,16,62412.870000000024,64826.08000000003
1551,U32154,330,5375.020000000026,262,68,509979.36999999994,515354.38999999996
1552,U39819,330,-81035.79000000027,239,91,4408914.55,4327878.76
1553,U27254,330,-790.5299999999988,260,70,1212324.1099999996,1211533.5799999996
1554,U40704,329,428.56000000000313,238,91,254861.26,255289.82
1555,U10612,329,-16397.39000000002,172,157,1947531.58,1931134.19
1556,U26624,329,-190749.29,294,35,453255.8600000001,262506.57000000007
1557,U12138,329,3960.7400000000034,305,24,207613.02999999988,211573.76999999987
1558,U35400,329,212.76000000001014,285,44,167030.71999999997,167243.47999999998
1559,U19881,329,936.3700000000075,300,29,173529.6600000004,174466.0300000004
1560,U12177,329,26344.109999999986,239,90,882753.4400000001,909097.55
1561,U25343,329,34839.99999999997,230,99,109784.99000000002,144624.99
1562,U34902,329,4553.899999999997,322,7,27141.499999999996,31695.399999999994
1563,U43782,329,1152.109999999955,289,40,456244.1099999998,457396.21999999974
1564,U8729,329,-45165.29999999999,287,42,474327.68,429162.38
1565,U1374933,328,16278.55,183,145,224119.28999999998,240397.83999999997
1566,U42545,328,116109.34000000003,210,118,1275837.02,1391946.36
1567,U20056,328,20061.189999999966,305,23,332561.0400000001,352622.23000000004
1568,U20284,328,8175.360000000003,315,13,230068.30999999997,238243.66999999998
1569,U17842,328,8326.549999999988,239,89,127759.16,136085.71
1570,U1245042,328,1940.3200000000093,314,14,50633.86999999999,52574.189999999995
1571,U39745,328,16509.81999999999,299,29,215119.32,231629.13999999998
1572,U8823,328,-48893.73999999998,275,53,330006.61999999976,281112.8799999998
1573,U13678,328,72310.91999999997,296,32,293191.18000000005,365502.10000000003
1574,U17936,328,-15019.669999999998,303,25,53668.920000000006,38649.25000000001
1575,U17385,328,-29897.070000000105,209,119,1156086.0599999996,1126188.9899999995
1576,U26149,328,11850.530000000006,301,27,190568.57,202419.1
1577,U29545,328,-223483.52999999994,294,34,545579.4600000001,322095.93000000017
1578,U8477,327,1380.7799999999938,306,21,81353.93999999999,82734.71999999999
1579,U17226,327,17334.82999999992,211,116,470874.31,488209.1399999999
1580,U33075,327,-4859.019999999999,306,21,20253.730000000003,15394.710000000005
1581,U34256,327,-5867.869999999879,276,51,1884585.1400000004,1878717.2700000005
1582,U16639,327,-7812.860000000465,274,53,4822690.389999997,4814877.529999997
1583,U1352949,327,-9506.360000000004,290,37,83117.72999999998,73611.36999999998
1584,U26873,327,-72500.42000000023,303,24,3596623.1200000006,3524122.7
1585,U12842,327,2923.980000000001,310,17,50876.22000000001,53800.20000000001
1586,U15372,327,16347.71999999998,264,63,238131.59999999998,254479.31999999995
1587,U27087,327,-91654.13000000006,300,27,174314.80000000005,82660.66999999998
1588,U30614,327,31090.380000000005,190,137,4070915.9299999997,4102006.3099999996
1589,U25130,327,-14869.37,256,71,293435.54,278566.17
1590,U41356,327,105897.63,265,62,72075.93999999999,177973.57
1591,U41622,327,-38942.31999999999,290,37,317539.99999999994,278597.67999999993
1592,U32485,326,-55709.289999999884,276,50,1503636.1599999983,1447926.8699999985
1593,U31083,326,7541.5400000000245,212,114,884408.1199999999,891949.6599999999
1594,U29717,326,474257.6999999998,294,32,116657.15999999995,590914.8599999998
1595,U23029,326,4160.550000000007,293,33,43124.040000000015,47284.590000000026
1596,U25061,326,-29642.889999999996,280,46,237873.6400000001,208230.75000000012
1597,U40379,326,-2356.729999999991,287,39,109029.53000000001,106672.80000000002
1598,U20335,326,-130401.98000000005,200,126,3853398.389999999,3722996.409999999
1599,U30045,326,-7659.3499999999985,308,18,77231.08000000003,69571.73000000004
1600,U11070,326,6911.860000000004,311,15,35124.72000000001,42036.580000000016
1601,U12159,326,-1460.300000000017,253,73,535433.5299999999,533973.2299999999
1602,U39750,326,19002.22,293,33,583102.1,602104.32
1603,U984987,326,785.9900000000005,242,84,489332.0999999999,490118.0899999999
1604,U30222,326,-84185.75999999998,307,19,451166.88000000006,366981.1200000001
1605,U22375,326,-2239.580000000009,282,44,115433.29999999999,113193.71999999997
1606,U18572,326,-1845.9799999999645,281,45,189581.80999999997,187735.83000000002
1607,U34508,326,17248.670000000002,296,30,119843.83000000012,137092.50000000012
1608,U34638,326,-222.75000000000017,308,18,35850.62,35627.87
1609,U13769,326,-261217.43,304,22,611204.14,349986.71
1610,U8296,326,-6334.960000000027,296,30,868151.17,861816.21
1611,U28514,326,76081.36000000002,301,25,733466.1800000003,809547.5400000003
1612,U36007,326,-50845.32000000001,311,15,89853.7,39008.37999999999
1613,U12338,326,802241.7699999999,268,58,1359904.9099999997,2162146.6799999997
1614,U15523,326,15214.849999999971,259,67,697204.500000001,712419.350000001
1615,U853585,326,2.3799999999873673,169,157,132084.79999999996,132087.17999999993
1616,U15202,326,27774.579999999976,145,181,1531504.5399999998,1559279.1199999999
1617,U14714,326,20476.910000000003,286,40,382413.6000000001,402890.5100000001
1618,U24454,325,-1360.439999999995,215,110,825019.4199999999,823658.98
1619,U38973,325,4007.630000000003,291,34,240327.09000000003,244334.72000000003
1620,U24607,325,18851.650000000263,283,42,2021533.5599999998,2040385.2100000002
1621,U15448,325,20245.94,290,35,126798.05000000008,147043.99000000008
1622,U24371,325,-21202.750000000044,204,121,146490.94,125288.18999999996
1623,U26578,325,373291.5800000001,293,32,872635.1100000002,1245926.6900000004
1624,U15895,325,3991.6399999999708,262,63,2360728.859999998,2364720.499999998
1625,U21482,325,945.5100000000002,304,21,28803.739999999998,29749.25
1626,U25462,325,-17167.819999999978,260,65,550282.45,533114.63
1627,U14205,325,-89276.52,282,43,154704.6599999999,65428.13999999988
1628,U41262,325,-24289.000000000007,311,14,87006.32999999999,62717.32999999998
1629,U37581,325,472.20000000003597,281,44,1549391.93,1549864.13
1630,U21891,324,-15235.310000000009,286,38,412959.70999999996,397724.39999999997
1631,U20927,324,-4983.429999999993,305,19,145970.18,140986.75
1632,U11428,324,21391.350000000013,244,80,491554.08000000013,512945.43000000017
1633,U38300,324,222548.20000000013,243,81,993803.5300000003,1216351.7300000004
1634,U22631,324,-13056.310000000143,291,33,1855502.11,1842445.8
1635,U39738,324,3967.8200000000516,275,49,580819.0899999999,584786.9099999999
1636,U8341,324,11133.340000000013,207,117,101258.72000000002,112392.06000000003
1637,U42440,324,-42323.160000000025,278,46,836748.4199999996,794425.2599999995
1638,U10962,324,-47502.24999999997,297,27,434424.59,386922.3400000001
1639,U37499,324,-103903.95,280,44,1126546.26,1022642.31
1640,U752276,324,6.389999999998553,188,136,118362.29999999999,118368.68999999999
1641,U26353,324,94379.24000000017,283,41,917906.04,1012285.2800000003
1642,U33173,324,-62347.43,284,40,270291.84000000014,207944.41000000015
1643,U24816,324,103.70000000000095,224,100,70369.69,70473.39
1644,U14588,323,-72156.59,306,17,605035.4,532878.81
1645,U30997,323,-7064.179999999906,81,242,890573.56,883509.3800000001
1646,U25303,323,736.1500000000087,120,203,751839.16,752575.31
1647,U35918,323,-6827.689999999997,268,55,78587.90000000001,71760.21
1648,U30474,323,-6856.480000000009,225,98,163363.46000000002,156506.98
1649,U27450,323,3415.8799999999974,220,103,223872.6000000001,227288.4800000001
1650,U36567,323,-3964.160000000009,235,88,107258.10999999999,103293.94999999998
1651,U21665,323,121920.90999999999,183,140,444514.8499999997,566435.7599999997
1652,U13600,323,-27870.80999999993,283,40,1065077.0399999998,1037206.2299999999
1653,U42854,323,1415.100000000008,290,33,193903.87000000002,195318.97000000003
1654,U29713,323,5235.689999999976,297,26,309458.32,314694.01
1655,U40548,323,-9425.64,131,192,395807.0300000001,386381.3900000001
1656,U12400,323,78596.30999999985,211,112,3307861.0,3386457.31
1657,U859352,323,-15.940000000002328,164,159,358244.83,358228.89
1658,U1062551,323,17.59000000000583,198,125,95022.42,95040.01000000001
1659,U20230,323,52944.37999999999,303,20,146500.40999999995,199444.78999999992
1660,U18326,323,53351.48999999999,291,32,102489.88000000005,155841.37000000005
1661,U21832,322,3592.869999999879,288,34,1356614.3299999994,1360207.1999999993
1662,U28603,322,2107.419999999973,235,87,1041948.0499999999,1044055.4699999999
1663,U14637,322,102631.54000000002,305,17,189265.91999999998,291897.46
1664,U21870,322,12962.830000000049,280,42,634780.9,647743.7300000001
1665,U28296,322,13025.479999999989,299,23,206234.3,219259.77999999997
1666,U42544,322,-27804.11,298,24,188826.36,161022.25
1667,U17467,322,-183448.23000000004,281,41,1320532.4100000004,1137084.1800000004
1668,U32260,322,-61940.97999999999,232,90,1526446.8399999987,1464505.8599999987
1669,U37947,322,-4363.800000000031,290,32,121418.5900000003,117054.79000000027
1670,U20459,322,-11424.47000000003,260,62,1701175.59,1689751.12
1671,U18010,322,27077.319999999996,293,29,214493.84000000003,241571.16000000003
1672,U34792,322,-2434.04,317,5,14994.520000000002,12560.480000000003
1673,U13304,321,-144544.47000000003,293,28,414999.9900000001,270455.5200000001
1674,U15473,321,-41071.38999999999,299,22,283143.9400000001,242072.55000000013
1675,U24606,321,14003.379999999983,300,21,281577.2499999999,295580.6299999999
1676,U33417,321,12797.860000000277,243,78,3597301.740000001,3610099.6000000015
1677,U10908,321,188990.3900000001,300,21,116662.41999999958,305652.8099999997
1678,U25604,321,31651.089999999982,293,28,330611.9799999999,362263.0699999999
1679,U23915,321,-287.9099999999992,296,25,27699.770000000004,27411.860000000004
1680,U31405,321,-30754.019999999946,232,89,529085.36,498331.34
1681,U43247,321,6135.839999999992,284,37,240373.0699999999,246508.9099999999
1682,U11729,321,-22250.52999999991,286,35,94128.32999999984,71877.79999999993
1683,U20070,321,-50424.83999999997,304,17,425749.19000000006,375324.3500000001
1684,U13732,321,-89123.24000000008,303,18,495934.62000000087,406811.3800000008
1685,U21711,321,5110.220000000004,312,9,35002.420000000006,40112.64000000001
1686,U31479,321,-346731.1800000001,294,27,1663960.9900000005,1317229.8100000003
1687,U43496,321,3109.4499999999957,237,84,70962.57000000005,74072.02000000005
1688,U27164,321,-4681.25999999996,240,81,1646197.6099999999,1641516.3499999999
1689,U14059,321,-20698.07999999998,295,26,821745.7,801047.62
1690,U20386,321,-4642.83,290,31,90137.42,85494.59
1691,U22422,321,-2834.830000000001,300,21,74097.51999999997,71262.68999999997
1692,U11746,321,253823.71999999994,308,13,381893.88,635717.6
1693,U25863,321,-6679.699999999997,237,84,615351.7999999999,608672.1
1694,U22702,320,288.39999999999554,199,121,323742.15,324030.55000000005
1695,U777399,320,5591.850000000002,179,141,92985.45,98577.3
1696,U23391,320,-1782.1600000000517,277,43,575251.1099999999,573468.9499999998
1697,U10545,320,-3131.359999999986,275,45,616995.1399999999,613863.7799999999
1698,U25996,320,7179.419999999969,262,58,2079822.82,2087002.24
1699,U25699,320,5534.290000000002,306,14,42657.57,48191.86
1700,U38168,320,27106.290000000183,294,26,2635541.629999999,2662647.919999999
1701,U18084,320,-22981.769999999902,277,43,1196464.51,1173482.7400000002
1702,U8723,320,13813.51999999999,286,34,416063.47,429876.99
1703,U43561,320,465.5799999999895,280,40,680819.6899999996,681285.2699999996
1704,U23070,320,-4434.089999999991,298,22,273508.4099999999,269074.31999999995
1705,U20278,320,-21.48999999999501,192,128,72765.19000000002,72743.70000000003
1706,U38952,320,-3194.390000000014,261,59,161145.05999999997,157950.66999999995
1707,U33013,320,-5601.119999999988,262,58,484096.51999999996,478495.39999999997
1708,U20403,320,6641.870000000019,205,115,118690.38999999991,125332.25999999994
1709,U25421,320,-7709.640000000073,183,137,466634.4699999996,458924.82999999955
1710,U38730,320,-16481.470000000005,304,16,43188.06,26706.589999999993
1711,U27330,319,-5271.64,278,41,118776.56000000001,113504.92000000001
1712,U32360,319,-59978.86000000003,303,16,106327.56999999998,46348.70999999995
1713,U32273,319,-6347.370000000001,304,15,92852.67000000006,86505.30000000006
1714,U22011,319,-64362.77000000001,297,22,216306.94999999992,151944.1799999999
1715,U37708,319,-20721.27000000001,242,77,214293.23999999996,193571.96999999994
1716,U25608,319,2742.4399999999987,297,22,102397.01999999999,105139.45999999999
1717,U36645,319,2937.7500000000455,301,18,42015.65999999988,44953.40999999992
1718,U28300,319,-43547.26000000001,131,188,587172.56,543625.3
1719,U8187,319,-249943.79999999984,268,51,955978.1000000006,706034.3000000007
1720,U17100,319,-4748.529999999997,310,9,24625.989999999994,19877.46
1721,U31730,319,-85443.13,283,36,1769732.72,1684289.5899999999
1722,U1316206,319,-85.43999999999966,197,122,12323.369999999999,12237.929999999998
1723,U22256,319,-1436.0699999995618,221,98,4887861.620000001,4886425.550000002
1724,U14640,319,-44715.020000000004,282,37,273228.10999999987,228513.08999999985
1725,U1361762,319,0.16000000001113257,171,148,371422.11999999994,371422.27999999997
1726,U37681,318,80685.39,238,80,457358.09,538043.48
1727,U8251,318,-112349.23000000004,275,43,737601.0199999999,625251.7899999998
1728,U36456,318,-7160.920000000042,269,49,1165592.4199999997,1158431.4999999995
1729,U20631,318,-248188.7299999999,300,18,1654864.5600000008,1406675.8300000008
1730,U687907,318,876.3099999999904,226,92,607898.74,608775.0499999999
1731,U14341,318,-562.8899999999899,282,36,125775.5299999999,125212.63999999991
1732,U33615,318,644.4299999999965,296,22,99056.46,99700.89
1733,U12359,318,144660.5600000001,299,19,427183.9699999998,571844.5299999999
1734,U15970,318,4257.590000000426,258,60,7800478.28,7804735.870000001
1735,U11604,318,-5941.599999999987,295,23,1876490.750000001,1870549.1500000008
1736,U24451,318,-13923.110000000028,278,40,1336767.6900000004,1322844.5800000003
1737,U8831,318,-24207.15999999999,295,23,217766.18,193559.02000000002
1738,U33159,318,28828.72,296,22,165471.71000000002,194300.43000000002
1739,U32107,318,-585.8599999999278,190,128,1632819.04,1632233.1800000002
1740,U13202,318,-31481.009999999995,302,16,96406.39000000001,64925.38000000002
1741,U42025,318,266726.04000000015,280,38,2469251.0300000003,2735977.0700000003
1742,U19918,318,-137429.68000000002,291,27,390924.64000000036,253494.96000000034
1743,U34717,318,7433.699999999998,215,103,72986.56,80420.26
1744,U34428,318,-81388.39,277,41,421136.37,339747.98
1745,U23015,318,5028.720000000008,304,14,133810.71999999997,138839.43999999997
1746,U42884,318,-31107.02,307,11,188660.32999999996,157553.30999999997
1747,U41732,317,11212.72,263,54,120388.98999999992,131601.7099999999
1748,U13324,317,9346.319999999956,240,77,585732.2,595078.5199999999
1749,U8230,317,-9226.929999999982,249,68,688870.6599999998,679643.7299999999
1750,U17950,317,82923.5800000001,258,59,3444890.019999999,3527813.599999999
1751,U35948,317,-353307.8900000004,151,166,3853631.34,3500323.4499999993
1752,U16932,317,46464.15000000044,203,114,6688413.739999999,6734877.89
1753,U43821,317,156097.21000000005,200,117,76539.58000000002,232636.79000000007
1754,U39560,317,10796.759999999993,296,21,144698.64,155495.4
1755,U36991,317,16770.530000000002,302,15,42134.46,58904.990000000005
1756,U36608,317,75977.35999999999,297,20,185268.22999999998,261245.58999999997
1757,U43344,317,7791.2400000000125,262,55,171986.8400000001,179778.08000000013
1758,U14888,317,-13845.139999999983,128,189,1331440.53,1317595.3900000001
1759,U27672,317,-12497.010000000006,283,34,74235.47999999995,61738.46999999994
1760,U11970,317,1192348.3899999997,278,39,2274799.21,3467147.5999999996
1761,U13647,317,12894.93999999999,298,19,122103.93999999999,134998.87999999998
1762,U8993,317,18319.020000000004,285,32,261661.15999999986,279980.1799999999
1763,U27546,316,66323.48000000001,290,26,100752.37,167075.85
1764,U13858,316,1225.67,275,41,428575.66000000003,429801.33
1765,U39132,316,-20995.279999999944,254,62,1965887.36,1944892.08
1766,U13519,316,-19185.019999999993,311,5,135008.56,115823.54000000001
1767,U25674,316,22924.719999999994,201,115,946456.1699999998,969380.8899999998
1768,U33062,316,41108.42000000001,282,34,59686.829999999994,100795.25
1769,U42188,316,-1402.6700000000128,195,121,2557738.1700000027,2556335.500000003
1770,U11527,316,-52251.29999999999,297,19,119408.63000000005,67157.33000000006
1771,U40843,316,7701.83,289,27,285974.6900000001,293676.52000000014
1772,U25705,316,-14139.869999999999,291,25,52720.74000000001,38580.87000000001
1773,U19109,316,17070.15,202,114,503858.6,520928.75
1774,U28065,316,3010.8200000000043,297,19,61633.68000000001,64644.500000000015
1775,U20391,316,56702.46999999999,272,44,553430.0299999999,610132.4999999999
1776,U18927,316,-14846.139999999978,303,13,46791.38000000008,31945.2400000001
1777,U9714,315,14791.540000000008,225,90,986418.79,1001210.3300000001
1778,U17621,315,-16535.839999999997,286,29,157519.15,140983.31
1779,U28857,315,16822.610000000062,277,38,314118.66000000015,330941.2700000002
1780,U23046,315,-11895.129999999994,273,42,190472.56999999995,178577.43999999994
1781,U28886,315,-8072.899999999992,69,246,305459.85,297386.95
1782,U20212,315,5683.300000000016,296,19,113921.66000000006,119604.96000000008
1783,U17188,315,-16792.089999999997,295,20,80403.74999999999,63611.65999999999
1784,U13808,315,5626.85,289,26,21738.94,27365.79
1785,U8601,315,-72039.35,260,55,475682.2499999999,403642.8999999999
1786,U1309898,315,-10.289999999999964,249,66,4365.750000000001,4355.460000000001
1787,U16740,315,1487.7800000000052,284,31,116392.16000000002,117879.94000000002
1788,U25493,315,3371.3399999999365,187,128,321984.35000000003,325355.68999999994
1789,U37249,315,26461.70999999997,271,44,223487.15000000002,249948.86
1790,U16491,315,12849.359999999942,235,80,215704.54,228553.89999999997
1791,U16614,315,283124.61000000016,292,23,403183.79999999993,686308.4100000001
1792,U12720,315,-13597.400000000023,268,47,667802.9699999997,654205.5699999997
1793,U43444,315,-264929.69999999995,257,58,982725.9400000001,717796.2400000001
1794,U15936,315,22647.4,255,60,53800.04000000001,76447.44
1795,U36841,315,111560.70000000001,294,21,177918.61000000002,289479.31000000006
1796,U22126,315,1906.8199999999815,284,31,328459.5899999999,330366.4099999999
1797,U28351,314,-48003.10000000001,235,79,1851712.0000000005,1803708.9000000004
1798,U29564,314,1273.5400000000031,204,110,662905.4,664178.9400000001
1799,U32930,314,-7343.1299999999865,246,68,246350.1400000001,239007.01000000013
1800,U11876,314,20941.320000000036,286,28,472218.30000000005,493159.6200000001
1801,U41159,314,-27250.240000000027,298,16,65548.69,38298.449999999975
1802,U43281,314,31622.960000000487,185,129,4025942.5599999987,4057565.519999999
1803,U41092,314,60526.95999999995,276,38,336207.57000000007,396734.53
1804,U43946,314,-9187.190000000046,246,68,1754387.7999999996,1745200.6099999996
1805,U24539,314,4981.04000000001,220,94,1464208.6999999997,1469189.7399999998
1806,U16780,314,1469874.1999999997,271,43,1759821.7199999995,3229695.919999999
1807,U36343,314,-10390.860000000008,298,16,42968.07,32577.209999999992
1808,U32781,314,268814.68999999994,252,62,608841.0499999997,877655.7399999996
1809,U36739,314,1937.0699999997018,31,283,278993.0,280930.0699999997
1810,U27678,314,7067.100000000035,217,97,407398.46,414465.56000000006
1811,U34101,314,-18470.620000000014,184,130,489132.00000000006,470661.38000000006
1812,U11893,314,-1245.1900000001915,251,63,1968699.3,1967454.1099999999
1813,U12398,313,22619.960000000006,262,51,1754450.9100000004,1777070.8700000003
1814,U40410,313,2913862.84,258,55,1582919.48,4496782.32
1815,U15389,313,-88318.98000000004,286,27,1785408.2999999998,1697089.3199999998
1816,U42785,313,37457.99,292,21,150167.18000000002,187625.17
1817,U20290,313,-13643.429999999877,260,53,1369267.2699999998,1355623.8399999999
1818,U39285,313,-749.9500000000024,300,13,45745.890000000014,44995.94000000001
1819,U8346,313,19074.84000000002,134,179,544365.3300000001,563440.17
1820,U31622,313,4765.429999999982,202,111,512217.4399999999,516982.8699999999
1821,U40224,313,922469.9099999998,284,29,2285012.289999999,3207482.199999999
1822,U16262,313,1329.1399999999987,305,8,25201.019999999986,26530.159999999985
1823,U41341,313,30094.579999999973,297,16,188149.58,218244.15999999997
1824,U41352,313,10279.379999999997,286,27,173489.8599999999,183769.2399999999
1825,U31831,313,18682.820000000007,265,48,2469321.040000001,2488003.860000001
1826,U13415,313,94376.11000000002,210,103,1294575.1400000001,1388951.2500000002
1827,U11938,313,14188.920000000022,244,69,335376.5799999999,349565.49999999994
1828,U36298,313,23020.150000000012,288,25,105700.27999999998,128720.43
1829,U11936,313,13373.009999999987,302,11,46644.06999999998,60017.079999999965
1830,U33240,312,31035.04000000002,299,13,102551.70000000001,133586.74000000002
1831,U10494,312,-17246.74999999998,285,27,249343.20999999996,232096.46
1832,U12017,312,10249.669999999998,276,36,52997.170000000035,63246.84000000003
1833,U24190,312,32776.27999999996,284,28,369390.70999999973,402166.9899999997
1834,U39863,312,-214361.03000000137,218,94,12095104.780000001,11880743.75
1835,U38480,312,-66396.35999999999,245,67,824379.6699999998,757983.3099999998
1836,U13232,312,-9182.819999999989,255,57,124651.37999999999,115468.56
1837,U37997,312,-6506.309999999997,301,11,37920.75,31414.440000000002
1838,U35748,312,207196.83999999994,283,29,565459.92,772656.76
1839,U29829,312,-19585.060000000005,280,32,244987.63,225402.57
1840,U20638,312,-4887.999999999998,218,94,179865.8900000002,174977.8900000002
1841,U14368,312,25059.160000000058,289,23,235101.03999999998,260160.20000000004
1842,U22557,312,-8447.220000000003,308,4,13823.250000000007,5376.030000000004
1843,U20359,312,10519.199999999992,299,13,56193.73999999998,66712.93999999997
1844,U16569,312,-32331.829999999994,296,16,270935.7799999999,238603.94999999992
1845,U16399,312,-23170.339999999982,274,38,384883.0499999999,361712.7099999999
1846,U37385,312,366811.14999999997,285,27,123527.17,490338.31999999995
1847,U27374,312,-10394.759999999998,284,28,436039.4800000001,425644.7200000001
1848,U35422,311,3948.990000000007,237,74,1316111.2700000003,1320060.2600000002
1849,U14562,311,-62978.269999999866,165,146,4607453.019999999,4544474.749999999
1850,U37237,311,-3000.36,303,8,13831.519999999997,10831.159999999996
1851,U8844,311,559.5400000000445,231,80,719148.09,719707.63
1852,U33175,311,-3629.0899999999974,280,31,42297.650000000016,38668.56000000002
1853,U12436,311,-193511.63999999996,213,98,7897815.170000002,7704303.530000002
1854,U36802,311,-780.4599999999934,288,23,241727.5,240947.04
1855,U19411,311,1518.8700000000003,278,33,24936.519999999986,26455.389999999985
1856,U38756,311,5993.700000000008,300,11,143490.94,149484.64
1857,U21996,311,-29962.00999999998,237,74,2269699.650000001,2239737.640000001
1858,U23596,311,-10779.689999999993,297,14,60345.69000000004,49566.000000000044
1859,U39455,311,19103.820000000007,276,35,2764547.2699999996,2783651.0899999994
1860,U18810,311,-16088.030000000374,154,157,42944283.3,42928195.269999996
1861,U41995,311,4256.760000000015,259,52,18079.439999999984,22336.199999999997
1862,U24717,311,-170117.77999999988,296,15,223503.71999999994,53385.94000000006
1863,U16959,311,-283143.5999999998,224,87,2111470.91,1828327.3100000003
1864,U27916,311,-63678.89000000013,179,132,2589901.8099999996,2526222.9199999995
1865,U41294,311,-37131.27,222,89,779914.3800000001,742783.1100000001
1866,U9071,311,-22189.609999999964,253,58,420510.93,398321.32
1867,U17171,311,1441175.42,207,104,5264437.719999997,6705613.139999997
1868,U29147,311,28119.90000000004,273,38,833792.6300000002,861912.5300000003
1869,U17382,311,-13102.250000000115,246,65,4397945.069999998,4384842.819999998
1870,U34277,311,-15208.169999999986,264,47,273804.9499999998,258596.7799999998
1871,U27113,311,-139721.04000000012,270,41,6839025.16,6699304.12
1872,U21899,311,40585.07999999996,248,63,1293196.2899999993,1333781.3699999992
1873,U41927,311,-3505.309999999991,280,31,161071.01000000004,157565.70000000004
1874,U43989,310,-26694.13000000002,238,72,760164.2200000002,733470.0900000002
1875,U19920,310,8062.72,294,16,67744.49000000002,75807.21000000002
1876,U32902,310,-5569.410000000002,286,24,39506.87999999999,33937.46999999999
1877,U41430,310,-7532.820000000014,94,216,928256.1,920723.2799999999
1878,U39088,310,-97931.25999999988,278,32,277488.9200000001,179557.6600000002
1879,U8910,310,-21277.330000000078,187,123,1305975.47,1284698.14
1880,U15924,310,-206166.44,277,33,833746.6599999999,627580.22
1881,U11788,310,4930.140000000003,289,21,49941.979999999996,54872.119999999995
1882,U8585,310,-228669.41999999995,283,27,1638576.9099999995,1409907.4899999995
1883,U32021,310,7362.75,245,65,201514.23,208876.98
1884,U23307,310,-56993.71999999999,290,20,190590.16999999998,133596.45
1885,U8505,310,16297.04,287,23,530729.95,547026.99
1886,U9902,310,-94043.84999999969,121,189,2674250.89,2580207.0400000005
1887,U16662,310,-683419.8000000005,284,26,2158578.419999999,1475158.6199999985
1888,U17095,310,140321.59000000017,242,68,4774096.900000001,4914418.490000001
1889,U33977,310,1516.4599999999991,271,39,164581.23,166097.69
1890,U13815,310,40814.15,284,26,253275.77999999994,294089.92999999993
1891,U41316,310,-44034.049999999974,300,10,120387.45000000006,76353.40000000008
1892,U43767,310,36485.67999999999,230,80,259282.70999999996,295768.38999999996
1893,U9959,309,128.06999999999528,251,58,640783.1499999997,640911.2199999996
1894,U41359,309,-16.310000000012224,260,49,363215.20999999996,363198.89999999997
1895,U35120,309,428.9600000000155,273,36,107150.90000000001,107579.86000000003
1896,U32439,309,-1796.8800000005867,139,170,1921282.46,1919485.5799999994
1897,U33589,309,-5433.499999999997,300,9,34608.61,29175.110000000004
1898,U38002,309,-20205.439999999533,282,27,5496636.969999999,5476431.529999999
1899,U10398,309,-2412.2099999999987,284,25,35564.549999999996,33152.34
1900,U13334,309,24424.220000000023,278,31,273775.04000000004,298199.26000000007
1901,U22862,309,-4247.07000000007,270,39,635771.4200000004,631524.3500000003
1902,U32677,309,-8684.559999999996,294,15,52369.91000000002,43685.35000000002
1903,U12822,309,728188.9999999997,287,22,720985.2700000003,1449174.27
1904,U10358,309,-41373.91,278,31,186943.21000000008,145569.30000000008
1905,U8666,309,-164.6899999999996,245,64,105221.87,105057.18
1906,U37062,309,18726.649999999987,240,69,1296705.4200000006,1315432.0700000005
1907,U14047,309,2361.9399999999787,241,68,110743.72999999998,113105.66999999995
1908,U20231,308,5236.540000000009,196,112,1360571.2399999995,1365807.7799999996
1909,U27769,308,868.5900000000056,298,10,37276.04999999999,38144.63999999999
1910,U22117,308,14645.440000000013,256,52,320675.71,335321.15
1911,U27827,308,23547.789999999983,275,33,38195.14999999999,61742.93999999997
1912,U17461,308,-17291.72999999998,235,73,1114540.18,1097248.45
1913,U27702,308,-38177.12,291,17,183974.44000000058,145797.3200000006
1914,U11853,308,-9969.209999999744,147,161,1658395.82,1648426.6100000003
1915,U37358,308,41586.03,290,18,108263.08999999997,149849.11999999997
1916,U34803,308,-153754.92,248,60,593917.9199999998,440162.99999999977
1917,U12212,308,-639559.4,293,15,877681.2999999999,238121.8999999999
1918,U24442,308,-11121.569999999985,264,44,608810.8400000001,597689.2700000001
1919,U15704,308,13282.109999999935,109,199,901219.0199999998,914501.1299999998
1920,U42909,308,10716.09999999999,245,63,1334309.0600000003,1345025.1600000004
1921,U16595,308,26673.510000000097,230,78,839981.1000000003,866654.6100000005
1922,U33052,308,-52870.52,275,33,240624.91,187754.39
1923,U12294,308,-12231.129999999957,266,42,462629.9699999997,450398.83999999973
1924,U42007,308,-3587.189999999933,274,34,558422.22,554835.03
1925,U11871,308,177882.91999999993,261,47,1176769.0299999984,1354651.9499999983
1926,U14270,307,-4680.799999999996,230,77,90488.73999999999,85807.94
1927,U34438,307,19601.269999999975,253,54,1123018.0399999998,1142619.3099999998
1928,U20645,307,-44180.96000000004,115,192,617587.06,573406.1
1929,U35311,307,-196489.00999999995,193,114,756878.6300000001,560389.6200000001
1930,U31478,307,4054.969999999994,182,125,962350.5800000002,966405.5500000002
1931,U35283,307,13116.790000000008,236,71,766800.5399999998,779917.3299999998
1932,U9116,307,154379.03000000003,245,62,727603.18,881982.2100000001
1933,U14858,307,-21236.819999999963,281,26,343437.88,322201.06000000006
1934,U1099105,307,-563.2199999999998,178,129,78628.70000000001,78065.48000000001
1935,U34696,307,-9198.430000000008,276,31,346578.62,337380.19
1936,U37308,307,-17249.159999999974,229,78,1606829.26,1589580.1
1937,U11376,307,-10409.110000000044,169,138,3447376.7600000002,3436967.6500000004
1938,U17555,307,-57121.62000000001,220,87,4247450.0600000005,4190328.4400000004
1939,U42510,307,-4823.750000000008,268,39,123755.50999999997,118931.75999999995
1940,U901385,307,23136.93999999995,154,153,157354.58000000002,180491.51999999996
1941,U15123,307,-52315.21999999951,286,21,6040423.3599999985,5988108.139999999
1942,U28277,307,-16913.180000000008,297,10,32275.58,15362.399999999994
1943,U33043,307,-13272.080000000034,201,106,867652.0,854379.9199999999
1944,U8755,307,656.4999999999754,265,42,490761.94000000006,491418.44000000006
1945,U40194,307,-4072.1500000000015,181,126,238489.97999999998,234417.83
1946,U27361,307,-836998.0999999996,274,33,2908072.21,2071074.1100000003
1947,U8088,307,223504.0,285,22,601449.36,824953.36
1948,U16493,307,-17983.730000000003,275,32,199874.71999999988,181890.98999999987
1949,U40947,306,92021.70999999998,241,65,214848.25999999995,306869.9699999999
1950,U29382,306,-60106.87999999998,128,178,705637.4699999999,645530.5899999999
1951,U9845,306,11191.000000000004,295,11,121406.37000000004,132597.37000000005
1952,U40189,306,-90186.02000000009,267,39,2358048.92,2267862.9
1953,U37406,306,-55709.35000000002,255,51,1117662.3899999997,1061953.0399999996
1954,U37210,306,23453.65,289,17,45062.060000000005,68515.71
1955,U12316,306,50719.94,265,41,1210770.9600000004,1261490.9000000004
1956,U11664,306,-9087.810000000005,268,38,257384.47,248296.66
1957,U14695,306,-14563.100000000013,292,14,196782.54999999987,182219.44999999987
1958,U12003,306,-70383.02999999993,214,92,3502439.279999999,3432056.249999999
1959,U17033,306,205066.59000000023,287,19,6612003.509999999,6817070.099999999
1960,U10676,306,-27952.810000000056,279,27,907923.7699999999,879970.9599999998
1961,U29351,306,149474.4000000001,270,36,295316.0599999998,444790.45999999996
1962,U15060,306,-43806.869999999995,176,130,441608.74000000005,397801.87000000005
1963,U43134,306,-1777.12999999999,197,109,2024000.5999999999,2022223.47
1964,U1192605,306,313.7199999999043,120,186,960826.44,961140.1599999998
1965,U14669,306,-122849.12,241,65,1709614.0400000003,1586764.9200000004
1966,U16161,306,-69173.38000000002,282,24,325567.68,256394.3
1967,U16225,306,-146748.9900000002,255,51,586934.61,440185.61999999976
1968,U33048,305,-5037.290000000018,290,15,151645.15999999997,146607.86999999997
1969,U26813,305,-3067300.2899999996,265,40,11355067.82,8287767.530000001
1970,U978123,305,-712.5799999999995,209,96,86071.39000000001,85358.81000000001
1971,U1267670,305,1671.5700000000015,211,94,48992.389999999985,50663.959999999985
1972,U8824,305,-9650.870000000008,296,9,35818.30000000001,26167.43
1973,U38051,305,-1369.4900000000073,288,17,94382.31999999998,93012.82999999997
1974,U27063,305,69977.23999999995,244,61,573257.1200000001,643234.3600000001
1975,U11213,305,-62257.09000000002,103,202,622841.81,560584.7200000001
1976,U12573,305,-7730.339999999998,211,94,434591.7300000001,426861.3900000001
1977,U14500,305,5820.269999999997,255,50,59689.59,65509.85999999999
1978,U16196,305,26350.68,263,42,797548.0800000005,823898.7600000006
1979,U11276,305,15093.610000000008,181,124,802837.7600000001,817931.3700000001
1980,U13789,305,91664.73,268,37,741940.89,833605.62
1981,U26831,305,-3504.929999999999,239,66,274821.97,271317.04
1982,U39846,305,4081.079999999999,266,39,76946.73000000003,81027.81000000003
1983,U20198,305,1129.5199999999604,257,48,1318466.1800000002,1319595.7000000002
1984,U37047,305,-12224.219999999998,287,18,64399.86000000004,52175.64000000004
1985,U34845,305,-69323.18999999999,278,27,595025.2500000001,525702.0600000002
1986,U10072,304,-29291.99000000017,290,14,126409.49000000021,97117.50000000004
1987,U41274,304,-143977.30999999994,282,22,884468.4100000001,740491.1000000002
1988,U23912,304,50727.43999999998,261,43,1010808.7900000003,1061536.2300000002
1989,U24639,304,314266.0799999997,208,96,4396854.089999995,4711120.169999995
1990,U25600,304,-193.16999999999504,289,15,27590.540000000008,27397.370000000014
1991,U37227,304,462980.87,255,49,84401.53,547382.4
1992,U33576,304,-33657.12,223,81,159076.0,125418.88
1993,U38717,304,-4451.850000000019,190,114,881656.5700000001,877204.7200000001
1994,U17309,304,-6654.949999999535,275,29,2068699.7399999998,2062044.7900000003
1995,U26502,304,7304.360000000004,280,24,55826.9,63131.26000000001
1996,U9965,304,-4646.819999999999,295,9,35327.820000000014,30681.000000000015
1997,U8181,304,-10350.859999999995,288,16,77413.99999999999,67063.13999999998
1998,U29167,304,-80523.04,282,22,472582.0499999999,392059.0099999999
1999,U40620,304,37610.459999999846,156,148,2931380.52,2968990.98
2000,U16189,304,153773.22999999998,275,29,296326.53,450099.76
2001,U8739,303,-10788.380000000003,212,91,111042.7,100254.31999999999
2002,U31873,303,26.379999999991004,253,50,165851.37000000002,165877.75000000003
2003,U25094,303,-63109.77999999999,288,15,158276.40000000002,95166.62000000002
2004,U17104,303,2836.919999999907,207,96,953234.9600000005,956071.8800000005
2005,U13928,303,-5899.68,257,46,55265.39,49365.71
2006,U16043,303,5541.92999999997,200,103,635139.5200000001,640681.4500000001
2007,U8263,303,358580.81999999983,276,27,198293.96999999997,556874.7899999998
2008,U22922,303,-271662.9299999994,212,91,9097375.84,8825712.91
2009,U31011,303,-24311.390000000007,245,58,1628688.9099999992,1604377.5199999993
2010,U43363,303,3634.9100000000203,252,51,199309.63,202944.54000000004
2011,U10903,303,-64064.67999999998,200,103,500974.12999999983,436909.44999999984
2012,U40608,303,21654.38000000004,202,101,810704.2600000001,832358.6400000001
2013,U17629,303,5668.840000000002,282,21,177578.39999999994,183247.23999999993
2014,U21505,303,145189.21000000005,279,24,89602.31000000001,234791.52000000008
2015,U41928,303,43179.84000000001,248,55,352472.93000000017,395652.7700000002
2016,U12535,302,-27694.759999999944,263,39,1071278.6800000002,1043583.9200000003
2017,U16742,302,-1427.890000000164,242,60,2425374.4600000004,2423946.5700000003
2018,U12493,302,160615.53999999838,245,57,11839874.269999998,12000489.809999997
2019,U16500,302,155634.8699999999,247,55,4399266.269999999,4554901.139999999
2020,U26000,302,-5566.999999999998,250,52,93441.84000000004,87874.84000000004
2021,U26485,302,5595.680000000019,161,141,1106378.239999999,1111973.919999999
2022,U22461,302,-23688.460000000025,228,74,762993.9000000007,739305.4400000006
2023,U1377888,302,1038.089999999999,286,16,36026.740000000005,37064.83
2024,U31032,302,-18181.34000000002,276,26,243129.53000000014,224948.19000000012
2025,U35357,302,-36862.19000000002,269,33,178541.82999999993,141679.6399999999
2026,U19886,302,72942.89,269,33,317847.9900000001,390790.8800000001
2027,U28240,302,-18.580000000008113,241,61,1097929.8300000005,1097911.2500000005
2028,U43351,302,-27077.25999999995,162,140,2154628.79,2127551.5300000003
2029,U15370,302,60026.01999999993,267,35,1807619.0400000005,1867645.0600000005
2030,U36837,302,8354.569999999994,280,22,796502.1399999999,804856.7099999998
2031,U36065,302,38304.08999999998,278,24,192492.4900000001,230796.58000000007
2032,U12318,302,-11710.490000000145,241,61,2485133.379999999,2473422.8899999987
2033,U17063,302,5287.030000000009,267,35,109680.38000000003,114967.41000000005
2034,U612851,302,-5290.190000000016,183,119,99430.24999999994,94140.05999999992
2035,U16134,302,15020.080000000053,163,139,2787627.09,2802647.17
2036,U31501,302,-1410.6300000000015,285,17,58482.03999999999,57071.40999999999
2037,U35570,302,11876.560000000007,286,16,39296.18,51172.740000000005
2038,U10807,302,928.1200000000513,238,64,1228765.55,1229693.6700000002
2039,U14550,302,492.8100000000286,278,24,588239.74,588732.55
2040,U28927,302,-138.1500000000026,183,119,180408.71999999994,180270.56999999995
2041,U26587,302,14216.95999999997,283,19,282840.2999999999,297057.25999999983
2042,U19355,301,3010.780000000001,295,6,21258.05999999999,24268.839999999993
2043,U34197,301,-1042722.1200000008,260,41,1685253.5399999993,642531.4199999985
2044,U26041,301,38195.45999999996,250,51,208148.84,246344.29999999996
2045,U27949,301,6474.080000000005,248,53,46984.19999999999,53458.28
2046,U32594,301,162207.80000000002,256,45,181318.58,343526.38
2047,U23886,301,-9101.079999999998,267,34,124708.19000000008,115607.11000000007
2048,U8333,301,-7267.490000000004,268,33,149765.56999999995,142498.07999999996
2049,U23620,301,11731.350000000002,242,59,1779912.27,1791643.62
2050,U33660,301,-4888.11999999999,284,17,236420.29000000004,231532.17000000004
2051,U12028,301,-3124425.8700000015,263,38,5823851.010000003,2699425.140000001
2052,U19322,301,-125983.26000000001,244,57,2813149.3200000003,2687166.0600000005
2053,U37243,301,-25483.950000000037,265,36,432803.0700000002,407319.12000000017
2054,U10875,301,-2755.12999999999,288,13,46418.31,43663.18000000001
2055,U42373,301,-11493.160000000003,288,13,63686.87000000001,52193.71000000001
2056,U40281,301,44155.64000000001,184,117,203137.62000000002,247293.26000000004
2057,U39692,301,3914.179999999999,286,15,28799.309999999994,32713.489999999994
2058,U39808,301,-731512.73,253,48,5368932.1000000015,4637419.370000001
2059,U31318,301,4758.770000000001,289,12,87526.57000000002,92285.34000000003
2060,U30331,301,-183945.06,283,18,446583.88,262638.82
2061,U16690,301,-21688.17999999877,257,44,12363846.61,12342158.43
2062,U27696,301,-19143.330000000013,279,22,271529.7,252386.37
2063,U34682,300,-2815.989999999989,284,16,168461.18,165645.19
2064,U30580,300,5840.480000000014,272,28,410578.8300000001,416419.3100000001
2065,U18632,300,5788.220000000026,256,44,431215.58000000037,437003.8000000004
2066,U17969,300,-806177.0700000001,268,32,2993808.34,2187631.2699999996
2067,U9719,300,-21406.84000000007,257,43,1293740.9699999997,1272334.1299999997
2068,U1364787,300,-488.73000000000167,245,55,14935.859999999999,14447.129999999997
2069,U40920,300,-2295.629999999988,175,125,1211208.4200000002,1208912.7900000003
2070,U40811,300,2407.4800000000128,267,33,42651.24,45058.72000000001
2071,U20408,300,3745.30999999999,226,74,138514.89,142260.2
2072,U26833,300,-18236.040000000034,154,146,323797.11000000004,305561.07
2073,U15447,300,-2023.549999999998,249,51,257564.94999999992,255541.39999999994
2074,U21739,300,-34022.45999999996,278,22,10555135.969999999,10521113.509999998
2075,U12596,300,-70437.66000000019,258,42,888716.1800000009,818278.5200000007
2076,U43812,300,46891.44999999999,265,35,76093.93000000002,122985.38
2077,U32037,300,-4769.859999999999,275,25,80289.7,75519.84
2078,U34304,300,4461.999999999997,205,95,99768.61,104230.61
2079,U23023,300,18193.949999999975,267,33,354938.9499999998,373132.89999999973
2080,U23109,300,-13641.750000000007,283,17,182238.05000000002,168596.30000000002
2081,U40092,300,-589425.4799999996,284,16,3580362.2699999996,2990936.79
2082,U16455,300,-116997.52000000025,268,32,2385483.0500000007,2268485.5300000003
2083,U14591,300,99151.64,280,20,114723.24000000002,213874.88
2084,U16982,300,15646.989999999932,249,51,2861708.8800000004,2877355.87
2085,U26391,300,-15246.04999999993,242,58,1364009.8900000001,1348763.8400000003
2086,U8848,300,-1394.4999999999986,287,13,21823.719999999998,20429.219999999998
2087,U26013,300,-404757.64,234,66,2519877.8600000003,2115120.22
2088,U12798,299,450591.7799999992,242,57,15809282.360000001,16259874.14
2089,U32145,299,-2033.5599999999617,211,88,1063275.29,1061241.73
2090,U9552,299,-8195.760000000015,216,83,502126.34,493930.58
2091,U22851,299,-78062.61000000002,277,22,209426.07,131363.46
2092,U32814,299,4002.9700000000066,210,89,1715268.2500000002,1719271.2200000002
2093,U33467,299,-37976.19000000002,265,34,302438.62,264462.43
2094,U13804,299,-28097.05999999999,255,44,465975.93,437878.87
2095,U35879,299,4367.820000000443,254,45,4302171.890000001,4306539.710000001
2096,U31219,299,-48234.41000000002,236,63,409354.15999999974,361119.7499999997
2097,U41554,299,4982.890000000014,280,19,305871.67999999993,310854.56999999995
2098,U13408,299,25645.43000000003,273,26,120659.42999999989,146304.85999999993
2099,U39648,299,21066.709999999992,260,39,603056.75,624123.46
2100,U19866,299,-2193.209999999992,268,31,197780.49000000005,195587.28000000006
2101,U24841,299,-11741.540000000014,275,24,125730.76999999999,113989.22999999998
2102,U20926,299,-1993.8299999999972,183,116,66258.90999999999,64265.079999999994
2103,U33284,299,-13977.259999999993,278,21,133054.48999999993,119077.22999999994
2104,U19043,299,-140877.92000000004,226,73,3943502.08,3802624.16
2105,U40207,299,47656.610000000015,245,54,782819.7399999998,830476.3499999997
2106,U43788,299,2497.959999999992,154,145,1529832.9499999995,1532330.9099999995
2107,U28032,299,-69386.94000000002,283,16,121658.04,52271.09999999998
2108,U40800,298,157592.91,263,35,791778.9299999999,949371.84
2109,U36920,298,27735.210000000006,276,22,148109.13999999998,175844.34999999998
2110,U25738,298,97716.86000000002,175,123,525150.6000000001,622867.4600000001
2111,U9852,298,2160.419999999997,281,17,46898.5,49058.92
2112,U1345387,298,-485.46000000000015,162,136,14275.36,13789.9
2113,U15343,298,-29804.6,266,32,375774.22999999975,345969.6299999998
2114,U13134,298,13200.810000000018,275,23,312041.1300000001,325241.9400000001
2115,U942332,298,-3592.7199999999993,158,140,51391.06999999999,47798.34999999999
2116,U14115,298,28045.160000000007,180,118,1109416.7799999998,1137461.9399999997
2117,U41884,298,11012.290000000132,225,73,1586351.34,1597363.6300000001
2118,U42866,298,4926.360000000002,221,77,89245.24000000003,94171.60000000003
2119,U22355,297,5079.629999999997,256,41,289215.15,294294.78
2120,U39682,297,99499.08,258,39,220487.04,319986.12
2121,U10099,297,14478.840000000106,133,164,726038.0,740516.8400000001
2122,U9681,297,-2510.419999999995,241,56,146285.10000000003,143774.68000000005
2123,U39040,297,-33863.820000000196,253,44,1849765.96,1815902.1399999997
2124,U14726,297,-4617.909999999998,268,29,61519.81000000003,56901.90000000003
2125,U8530,297,123236.25000000001,284,13,715665.06,838901.31
2126,U41127,297,7140.049999999999,225,72,105232.0699999999,112372.11999999991
2127,U24651,297,-2398.919999999987,281,16,154401.68999999997,152002.77
2128,U28134,297,41500.27000000002,238,59,408428.9400000002,449929.2100000002
2129,U1247698,297,17643.93000000001,164,133,329574.21,347218.14
2130,U34448,297,-27520.610000000062,213,84,1493913.43,1466392.8199999998
2131,U27382,297,-3557.050000000001,248,49,107468.48,103911.43
2132,U11047,297,-14702.350000000053,242,55,5937642.789999997,5922940.439999998
2133,U16231,297,5256.330000000056,204,93,1196003.0000000002,1201259.3300000003
2134,U11647,297,-91392.60999999997,185,112,347555.09,256162.48000000004
2135,U8075,297,-11990.659999999983,283,14,77297.92,65307.26000000002
2136,U26034,297,7119.3499999999885,263,34,1292217.2599999998,1299336.6099999999
2137,U16394,297,18106.57000000004,274,23,697204.8500000006,715311.4200000006
2138,U14243,296,-66559.61999999998,271,25,894547.44,827987.82
2139,U42045,296,4799.679999999998,264,32,19523.809999999987,24323.489999999983
2140,U41322,296,-21090.61,281,15,114865.03,93774.42
2141,U16579,296,42640.250000000015,273,23,206682.6999999999,249322.9499999999
2142,U36285,296,254539.8,216,80,620527.3600000001,875067.1600000001
2143,U22224,296,-66429.09999999993,274,22,378912.8899999996,312483.7899999997
2144,U37635,296,1287.7699999999986,289,7,38913.53,40201.299999999996
2145,U26298,296,-30258.260000000013,290,6,82539.96,52281.7
2146,U1204226,296,299.52999999999776,167,129,158413.33,158712.86
2147,U41629,296,9495.45,200,96,329880.84000000084,339376.29000000085
2148,U10749,296,-3944.220000000005,245,51,116979.80999999992,113035.58999999992
2149,U12213,296,89339.99000000005,154,142,3265272.4699999997,3354612.46
2150,U1377115,296,81874.28999999995,147,149,411768.4700000001,493642.76
2151,U38021,296,7114.100000000007,263,33,130317.42999999996,137431.52999999997
2152,U25642,296,8116.5,281,15,130105.59,138222.09
2153,U11888,296,75610.07999999993,242,54,440288.07,515898.1499999999
2154,U10627,296,10023.370000000003,269,27,93115.14000000001,103138.51000000001
2155,U12216,296,-9300.410000000129,269,27,850003.0899999995,840702.6799999994
2156,U40656,296,3579.5500000002794,197,99,10225738.790000001,10229318.340000002
2157,U25923,296,550636.8099999999,203,93,1780209.72,2330846.53
2158,U15059,296,-6180.699999999967,161,135,677375.5999999996,671194.8999999997
2159,U975810,296,-110.52000000000862,229,67,110691.59,110581.06999999999
2160,U41967,296,216497.56,287,9,66228.73999999998,282726.3
2161,U16006,296,64512.49999999997,260,36,2406232.38,2470744.88
2162,U14910,295,-94037.15999999996,264,31,557876.7,463839.54
2163,U35263,295,217.36999999999588,246,49,10587.909999999993,10805.279999999988
2164,U9048,295,-54516.06999999999,278,17,204138.05,149621.97999999998
2165,U10028,295,1704.170000000002,230,65,33138.35000000001,34842.52000000002
2166,U20201,295,-11033.23,281,14,95581.55,84548.32
2167,U15518,295,25576.87999999997,254,41,146042.05,171618.92999999996
2168,U14217,295,-10076.580000000042,136,159,1554233.2,1544156.6199999999
2169,U37871,295,8495.090000000002,278,17,56553.930000000015,65049.02000000002
2170,U23507,295,34050.53,248,47,295942.54000000004,329993.07000000007
2171,U22528,295,240297.79000000004,274,21,638345.8700000006,878643.6600000006
2172,U37605,295,38915.98,191,104,117522.5899999999,156438.5699999999
2173,U34782,295,26806.39999999998,158,137,421822.6099999998,448629.0099999998
2174,U9397,295,106410.37000000004,270,25,505494.54000000004,611904.91
2175,U40545,295,68507.44000000006,255,40,397427.3999999999,465934.83999999997
2176,U30101,295,-11456.160000000003,271,24,133890.23999999993,122434.07999999993
2177,U36716,295,974.1400000000012,188,107,448312.4800000001,449286.6200000001
2178,U1139875,295,-3.980000000006612,148,147,147265.59000000017,147261.61000000016
2179,U11957,295,84526.31999999996,278,17,450645.76,535172.08
2180,U37716,295,-4949.289999999996,236,59,366803.95,361854.66000000003
2181,U30802,295,-157475.75999999992,247,48,2930720.300000001,2773244.5400000014
2182,U1377705,294,-178.77999999999753,157,137,76416.37000000002,76237.59000000003
2183,U28120,294,-38299.939999999704,238,56,1522651.6699999985,1484351.7299999988
2184,U36438,294,103491.39999999997,270,24,384171.77,487663.17
2185,U31193,294,7422.820000000008,219,75,285497.63,292920.45
2186,U9708,294,14514.949999999995,270,24,45345.139999999985,59860.08999999998
2187,U32956,294,-11025.57999999994,223,71,649803.4999999998,638777.9199999998
2188,U34995,294,3924.770000000004,256,38,47930.56000000001,51855.330000000016
2189,U43287,294,10242.089999999991,234,60,275240.18999999994,285482.2799999999
2190,U44063,294,-25431.649999999998,257,37,270027.92,244596.27
2191,U27553,294,-56091.65000000011,255,39,866290.7599999998,810199.1099999996
2192,U602881,294,-772.2199999999934,193,101,122140.43999999997,121368.21999999999
2193,U10135,294,5700.240000000023,252,42,672292.48,677992.72
2194,U10803,294,11114.979999999996,272,22,98161.79000000007,109276.77000000006
2195,U36444,294,-245958.15000000002,256,38,935784.9800000001,689826.8300000001
2196,U31820,294,20987.919999999966,246,48,305316.56,326304.48
2197,U15245,293,-11095.51,280,13,84465.64,73370.13
2198,U11006,293,122464.21,259,34,1270892.4900000002,1393356.7000000002
2199,U33036,293,85025.63999999993,208,85,898799.93,983825.57
2200,U34864,293,5977.379999999996,205,88,46460.13999999999,52437.51999999999
2201,U13306,293,-18356.129999999994,267,26,69987.09999999999,51630.97
2202,U42263,293,12102.54999999998,233,60,150136.07,162238.62
2203,U40132,293,-1000830.27,271,22,1801469.8399999999,800639.5699999998
2204,U19035,293,-5186.3300000000145,262,31,136366.46000000002,131180.13
2205,U43410,293,4219.0599999999995,253,40,56647.710000000065,60866.77000000006
2206,U24293,293,-16501.46999999996,234,59,106012.36000000003,89510.89000000007
2207,U18795,293,1255.789999999999,248,45,36425.520000000004,37681.310000000005
2208,U14379,293,-377592.02999999997,266,27,546799.9600000001,169207.9300000001
2209,U43961,293,-419.9600000000023,175,118,96507.68999999999,96087.72999999998
2210,U14876,293,17007.040000000008,271,22,86257.83000000002,103264.87000000002
2211,U30157,293,-5017.910000000001,249,44,31373.18,26355.27
2212,U26647,293,55430.58000000001,274,19,58412.94000000001,113843.52000000002
2213,U35966,293,166795.54000000004,257,36,542726.0400000004,709521.5800000004
2214,U12651,293,87992.88999999996,263,30,665170.6899999997,753163.5799999996
2215,U16080,293,107886.26999999986,193,100,5679790.090000001,5787676.36
2216,U16304,293,11628.590000000046,212,81,1110450.7899999998,1122079.38
2217,U40496,293,-8210.850000000039,198,95,783465.1599999999,775254.3099999998
2218,U35797,293,-21132.22999999999,217,76,677048.7300000001,655916.5000000001
2219,U14116,293,-119065.07000000004,260,33,375058.8599999997,255993.78999999966
2220,U38371,292,-930.0399999999902,275,17,25436.249999999996,24506.210000000006
2221,U25341,292,-18945.229999999996,262,30,102938.54999999999,83993.31999999999
2222,U22402,292,-11220.459999999981,269,23,136952.59,125732.13000000002
2223,U1166006,292,1878.6799999999903,266,26,80216.28000000001,82094.96
2224,U11584,292,-133662.8,236,56,914934.1499999999,781271.3499999999
2225,U11371,292,21611.979999999876,261,31,1270593.27,1292205.25
2226,U36885,292,-2052.5800000000013,269,23,41261.700000000004,39209.12
2227,U28291,292,-1814.960000000001,255,37,167539.81999999983,165724.85999999984
2228,U27951,292,23195.88000000001,262,30,393953.27999999997,417149.16
2229,U17934,292,-462.98999999999796,219,73,292835.1399999999,292372.1499999999
2230,U23328,292,70290.14000000017,138,154,4978168.92,5048459.0600000005
2231,U11331,292,-4541.440000000022,203,89,247481.22000000003,242939.78
2232,U12297,292,-5039.020000000028,263,29,178169.94999999998,173130.92999999996
2233,U11393,292,131761.60999999993,263,29,680943.9600000002,812705.5700000001
2234,U12492,292,-3128.0500000000175,261,31,104750.64999999997,101622.59999999995
2235,U9928,292,265239.33999999997,267,25,1100476.4899999993,1365715.8299999991
2236,U17418,292,-411953.33999999973,265,27,6481540.64,6069587.3
2237,U8927,292,-377.8400000000065,261,31,169567.15999999997,169189.31999999998
2238,U37875,292,569.9299999999998,215,77,159337.5599999997,159907.4899999997
2239,U22111,292,-4810.530000000005,254,38,172857.4,168046.87
2240,U29897,292,43185.90999999997,277,15,71082.08000000003,114267.98999999999
2241,U22492,291,-31432.750000000004,278,13,81478.07999999997,50045.32999999997
2242,U788995,291,214.11000000000467,156,135,182214.24000000002,182428.35000000003
2243,U22161,291,103994.65999999999,171,120,630228.1500000001,734222.8100000002
2244,U30235,291,163401.81999999998,254,37,303265.4799999999,466667.29999999993
2245,U39788,291,-7194.009999999983,225,66,426417.74,419223.73
2246,U26659,291,14762.689999999995,276,15,56087.47000000004,70850.16000000003
2247,U14371,291,-305716.72,272,19,510446.21,204729.49000000005
2248,U18453,291,2449.260000000002,248,43,142368.62999999998,144817.88999999998
2249,U24541,291,-107414.49000000002,243,48,443544.7900000001,336130.30000000005
2250,U36848,291,8704.04000000001,275,16,73277.20999999996,81981.24999999997
2251,U33065,291,-6504.139999999995,190,101,30060.43,23556.290000000005
2252,U41135,291,560.1000000000049,280,11,30593.750000000007,31153.850000000013
2253,U13258,291,-41926.65000000002,248,43,1109425.27,1067498.62
2254,U34028,291,-3480.780000000004,271,20,17670.179999999997,14189.399999999992
2255,U43686,291,-3662.6300000000033,261,30,53553.64000000004,49891.01000000004
2256,U13338,291,-55063.28999999985,233,58,836504.2199999987,781440.9299999989
2257,U18168,291,10781.860000000046,214,77,3369336.7699999986,3380118.6299999985
2258,U13347,291,60088.790000001,265,26,1071858.33,1131947.120000001
2259,U35397,291,-7777.479999999992,280,11,113071.1,105293.62000000001
2260,U13850,291,25363.42000000002,197,94,706080.58,731444.0
2261,U41361,291,-296401.43999999994,274,17,540947.7700000004,244546.33000000042
2262,U9256,291,-6980.180000000042,203,88,2558148.58,2551168.4
2263,U17417,291,2068.75999999991,232,59,2360563.25,2362632.01
2264,U40222,290,1619371.1900000018,230,60,29843121.86,31462493.05
2265,U1092183,290,0.030000000000086402,150,140,37408.490000000005,37408.520000000004
2266,U16526,290,15874.200000000114,238,52,1277735.689999999,1293609.8899999992
2267,U8859,290,-30328.660000000014,277,13,160322.21000000002,129993.55
2268,U21102,290,-42608.56000000002,271,19,330396.63,287788.07
2269,U9401,290,10475.370000000239,208,82,4006535.9800000004,4017011.3500000006
2270,U33770,290,5737.0200000000095,281,9,60128.619999999995,65865.64
2271,U32635,290,195570.66000000003,248,42,950290.96,1145861.62
2272,U27368,290,94989.40000000013,211,79,83928.0199999999,178917.42000000004
2273,U11096,290,-5442.819999999998,263,27,208273.3099999997,202830.4899999997
2274,U14490,290,-4568.109999999993,259,31,38565.76000000002,33997.65000000002
2275,U16519,290,-4023.2000000002154,219,71,1319909.2000000002,1315886.0
2276,U11623,290,-301043.57999999996,250,40,1516505.3599999996,1215461.7799999998
2277,U12483,290,-116105.91,257,33,410981.99000000005,294876.0800000001
2278,U9585,289,158585.37000000005,265,24,1170127.5099999998,1328712.88
2279,U14312,289,-5248.140000000001,236,53,306579.12,301330.98
2280,U29431,289,93636.10999999996,264,25,783990.5399999999,877626.6499999999
2281,U31808,289,-6673.229999999997,269,20,36946.60999999999,30273.379999999997
2282,U22159,289,-4937.580000000014,232,57,489289.30000000005,484351.72000000003
2283,U34188,289,33463.71000000002,262,27,250558.53999999995,284022.25
2284,U10385,289,104853.62000000005,228,61,378643.93000000005,483497.5500000001
2285,U31095,289,-21527.209999999974,137,152,626317.76,604790.55
2286,U37951,289,34442.90999999999,276,13,126540.15999999997,160983.06999999995
2287,U32545,289,-881.9699999999539,196,93,599723.8200000001,598841.8500000001
2288,U17898,289,-21822.810000000027,251,38,329570.01999999984,307747.20999999985
2289,U38291,289,117841.03000000004,275,14,101563.86000000003,219404.89000000007
2290,U9084,289,-1613.5300000000086,245,44,438221.49999999994,436607.9699999999
2291,U10626,289,8054.410000000002,247,42,39477.389999999985,47531.79999999999
2292,U35763,289,3331.21000000005,271,18,251242.33000000002,254573.54000000007
2293,U33330,289,221614.81999999983,252,37,191947.87000000017,413562.69
2294,U13609,289,-70742.08999999998,241,48,610259.8999999999,539517.8099999999
2295,U39009,289,-26783.169999999995,213,76,280642.44000000006,253859.27000000008
2296,U43201,289,-9927.189999999997,278,11,35209.16,25281.97000000001
2297,U15329,289,18066.59000000006,212,77,1231862.96,1249929.55
2298,U40805,288,-12481.419999999995,240,48,567785.8899999998,555304.4699999997
2299,U40336,288,-107633.11999999998,249,39,3067275.04,2959641.92
2300,U11023,288,49.110000000065384,238,50,152286.8700000003,152335.98000000036
2301,U26135,288,-29696.969999999976,212,76,1208906.6,1179209.6300000001
2302,U42653,288,-43844.509999999995,233,55,835240.7600000004,791396.2500000003
2303,U8691,288,18353.789999999994,241,47,276575.75,294929.54
2304,U32409,288,-15849.339999999998,277,11,37616.81000000001,21767.470000000016
2305,U24933,288,-12032.300000000007,192,96,1007839.59,995807.2899999999
2306,U37458,288,-6053.910000000003,273,15,99328.9,93274.98999999999
2307,U36041,288,16143.000000000022,267,21,128736.52000000002,144879.52000000005
2308,U26245,288,-26052.05000000032,243,45,6233955.570000002,6207903.520000001
2309,U12929,288,-104824.21,229,59,738989.4400000002,634165.2300000002
2310,U39714,288,-30250.609999999997,279,9,38836.250000000015,8585.640000000018
2311,U32837,288,-56490.18000000046,254,34,1152399.369999999,1095909.1899999985
2312,U41386,288,4531.409999999998,241,47,61883.74000000003,66415.15000000002
2313,U20348,288,-18710.760000000002,232,56,249292.61999999994,230581.85999999993
2314,U12431,288,-678.1599999999988,275,13,145449.73000000013,144771.57000000012
2315,U8244,288,10202.920000000013,269,19,234708.86999999997,244911.78999999998
2316,U21627,288,-47675.10000000001,264,24,259830.12999999995,212155.02999999994
2317,U42631,287,-55747.96999999998,261,26,220789.44999999998,165041.48
2318,U25375,287,-22961.520000000044,244,43,401000.79999999993,378039.2799999999
2319,U29704,287,22269.669999999976,217,70,255493.57,277763.24
2320,U20956,287,-667.9199999999951,270,17,74278.14,73610.22
2321,U41332,287,8094.050000000008,256,31,172223.5,180317.55000000002
2322,U36644,287,-18752.750000000044,241,46,1072752.0899999999,1053999.3399999999
2323,U19152,287,30396.179999999982,251,36,64948.329999999914,95344.5099999999
2324,U9025,287,-4983.119999999995,268,19,66283.35000000002,61300.230000000025
2325,U26912,287,-36134.350000000064,145,142,693207.8299999998,657073.4799999997
2326,U41993,287,5674.250000000005,280,7,31472.530000000013,37146.78000000002
2327,U28461,287,-18328.319999999403,257,30,1746173.3399999987,1727845.0199999993
2328,U34829,287,5926.2299999999905,108,179,180300.08999999994,186226.31999999992
2329,U38818,287,-420.879999999996,252,35,348651.4700000001,348230.5900000001
2330,U14675,287,81922.32000000004,143,144,574365.3400000001,656287.6600000001
2331,U16215,287,65465.799999999916,268,19,253852.84999999992,319318.64999999985
2332,U17073,287,-19387.01,267,20,214963.13999999996,195576.12999999995
2333,U17682,287,-15379.04999999997,229,58,2924665.71,2909286.66
2334,U31464,287,3402.790000000012,187,100,848016.1899999998,851418.9799999999
2335,U31445,287,12411.3,239,48,221469.34999999992,233880.6499999999
2336,U16940,287,176562.39000000028,235,52,9962247.780000012,10138810.170000013
2337,U37637,287,2195.2299999999977,272,15,31080.059999999998,33275.28999999999
2338,U27610,287,-123873.70000000004,265,22,504294.5299999999,380420.82999999984
2339,U35472,287,25672.270000000077,244,43,3542411.3699999996,3568083.6399999997
2340,U30418,287,-366867.30000000005,225,62,911416.6500000001,544549.3500000001
2341,U30143,286,-8470.759999999893,204,82,4738710.959999999,4730240.199999999
2342,U27681,286,-58768.709999999766,254,32,1895160.46,1836391.7500000002
2343,U20449,286,-23040.519999999997,212,74,258423.8399999999,235383.31999999992
2344,U13877,286,7660.319999999989,244,42,149887.91999999998,157548.23999999996
2345,U13263,286,412.6599999999862,160,126,1099527.42,1099940.0799999998
2346,U17981,286,-2382.340000000002,251,35,43200.920000000006,40818.58
2347,U8648,286,21489.54999999993,271,15,709185.01,730674.5599999999
2348,U21461,286,2433.120000000001,267,19,57906.49,60339.61
2349,U17689,286,183337.89999999997,176,110,1873328.4,2056666.2999999998
2350,U23234,286,-27597.18999999999,224,62,183421.35,155824.16
2351,U23890,286,-7798.529999999976,258,28,118014.89000000001,110216.36000000004
2352,U17627,286,-27558.03,225,61,211530.52000000002,183972.49000000002
2353,U1246609,286,-251.1500000000005,185,101,18393.7,18142.55
2354,U37863,286,-1775.8899999999978,264,22,124274.45999999996,122498.56999999996
2355,U27840,286,-526.0399999999986,269,17,99726.05999999998,99200.01999999999
2356,U41112,286,-1280.7299999999843,279,7,100116.31999999998,98835.59
2357,U31179,286,-2618.6799999999994,224,62,71233.62,68614.94
2358,U43004,286,4235.450000000001,162,124,113298.39000000006,117533.84000000005
2359,U40027,286,35760.700000000004,276,10,25828.43,61589.130000000005
2360,U38388,286,450.65999999999707,267,19,63231.76000000005,63682.42000000005
2361,U36233,285,-30737.010000000013,207,78,180374.4699999997,149637.4599999997
2362,U31023,285,15239.089999999997,263,22,227962.02000000005,243201.11000000004
2363,U12039,285,-7863.559999999996,238,47,162594.76999999987,154731.20999999988
2364,U38266,285,-16434.88,266,19,53632.420000000006,37197.54000000001
2365,U39345,285,4940.070000000003,268,17,14684.3,19624.370000000003
2366,U39708,285,-1742.8700000000133,170,115,792429.6500000001,790686.7800000001
2367,U23057,285,3363.569999999976,250,35,193876.95000000007,197240.52000000005
2368,U27264,285,-22474.059999999823,251,34,3198813.3099999996,3176339.25
2369,U11146,285,-30070.660000000003,276,9,77140.88,47070.22
2370,U35913,285,-12503.769999999986,271,14,143062.03999999998,130558.26999999999
2371,U26186,285,4129.860000000029,196,89,671415.62,675545.48
2372,U32569,285,364.069999999944,182,103,414133.37,414497.43999999994
2373,U32181,285,-8440.540000000017,216,69,477270.18999999994,468829.6499999999
2374,U20060,285,2324.1799999999953,76,209,476451.6099999999,478775.7899999999
2375,U1173543,285,157.50999999999954,166,119,271298.85,271456.36
2376,U9732,285,-20886.770000000015,247,38,469912.42000000033,449025.6500000003
2377,U17699,285,-32433.68999999998,268,17,2022686.4599999993,1990252.7699999993
2378,U36597,285,-79867.63,245,40,264164.2,184296.57
2379,U1095707,285,16191.409999999985,162,123,325766.45999999996,341957.86999999994
2380,U1079686,285,-3.0699999999995202,162,123,18445.499999999993,18442.429999999993
2381,U37350,285,-3683.7800000000093,272,13,27539.89000000001,23856.11
2382,U30682,285,37231.55999999996,266,19,213279.06999999998,250510.62999999995
2383,U40745,284,-2403685.2000000007,253,31,3082570.0699999994,678884.8699999987
2384,U25661,284,-5523.429999999995,228,56,33979.89,28456.460000000006
2385,U40223,284,14962.359999999851,235,49,4079357.08,4094319.44
2386,U34587,284,41711.43,261,23,111490.45,153201.88
2387,U15190,284,161552.8200000002,244,40,8478566.990000002,8640119.810000002
2388,U9506,284,-18680.789999999746,275,9,537266.2800000005,518585.49000000075
2389,U15072,284,-10721.029999999997,269,15,84930.27999999998,74209.24999999999
2390,U11229,284,-14145935.209999995,249,35,21464147.659999996,7318212.450000001
2391,U37466,284,14100.860000000006,270,14,28346.109999999982,42446.96999999999
2392,U22707,284,-71381.53999999998,259,25,193308.08999999997,121926.54999999999
2393,U17639,284,285865.5700000001,243,41,216289.05999999997,502154.6300000001
2394,U8335,284,-5541.8900000000085,239,45,364531.56000000023,358989.6700000002
2395,U40129,284,-63052.080000000016,179,105,1065980.1300000001,1002928.05
2396,U24153,284,-66249.13,224,60,470700.36000000004,404451.23000000004
2397,U29450,283,-93218.07,266,17,261860.54000000007,168642.47000000006
2398,U13014,283,-11505671.569999998,258,25,22761818.360000007,11256146.790000008
2399,U20215,283,107325.47000000004,223,60,2778112.439999998,2885437.9099999983
2400,U9234,283,-17152.75000000001,255,28,263618.9499999998,246466.19999999978
2401,U10110,283,475.23000000000206,237,46,31340.74,31815.970000000005
2402,U17553,283,-73834.96999999984,211,72,1608340.8100000005,1534505.8400000008
2403,U22291,283,-69850.01000000001,236,47,1295923.52,1226073.51
2404,U41247,283,-773.4600000000032,261,22,113921.45000000001,113147.99
2405,U26305,283,-47151.17999999999,253,30,198439.09,151287.91
2406,U9601,283,7997.4000000000015,269,14,69202.65999999999,77200.06
2407,U39644,283,-8445.880000000003,243,40,201087.43000000002,192641.55000000002
2408,U40795,283,-2656.7899999998513,151,132,5559700.440000002,5557043.650000002
2409,U33143,283,6499.099999999985,213,70,126582.4,133081.49999999997
2410,U18547,283,-4386.98999999999,262,21,36217.110000000015,31830.120000000024
2411,U27805,283,676.3500000000149,176,107,509576.60999999987,510252.9599999999
2412,U26715,283,-5793.970000000001,213,70,143225.86,137431.88999999998
2413,U20013,283,168972.1899999999,243,40,129534.14000000003,298506.3299999999
2414,U19803,283,58943.679999999986,213,70,815532.9700000002,874476.6500000001
2415,U16854,283,4496.99000000002,197,86,1303978.69,1308475.68
2416,U27775,283,54240.78999999994,231,52,718495.2100000011,772736.000000001
2417,U9278,283,-371.6900000000169,227,56,633512.85,633141.1599999999
2418,U36919,283,-11893.280000000057,241,42,810144.7299999997,798251.4499999997
2419,U20282,283,-3802.430000000004,254,29,66981.48999999993,63179.059999999925
2420,U16758,283,732926.149999998,162,121,53714225.45000001,54447151.60000001
2421,U40364,283,-708.5699999999919,259,24,42133.97,41425.40000000001
2422,U42176,283,629000.1599999998,226,57,1080692.53,1709692.69
2423,U21715,283,44030.270000000004,264,19,164199.26000000004,208229.53000000003
2424,U27707,283,-21500.319999999996,175,108,613515.3599999999,592015.0399999999
2425,U34750,282,-1546.7300000000014,265,17,81153.75000000001,79607.02000000002
2426,U8962,282,-33131.19999999998,194,88,954103.5000000002,920972.3000000003
2427,U16487,282,12408.200000000037,213,69,1088997.1300000004,1101405.3300000003
2428,U16631,282,-143866.4899999999,226,56,489342.4700000002,345475.98000000033
2429,U14375,282,13298.759999999986,227,55,191511.55999999994,204810.31999999992
2430,U10752,282,23852.16999999999,266,16,101565.53999999998,125417.70999999996
2431,U17620,282,38689.129999999976,220,62,549813.1200000001,588502.2500000001
2432,U23858,282,-383.2100000000007,264,18,44797.37999999992,44414.16999999992
2433,U13549,282,-65953.54999999999,265,17,388180.50999999995,322226.95999999996
2434,U36849,282,29321.35999999999,253,29,90771.66999999995,120093.02999999994
2435,U15709,282,-27408.979999999967,243,39,1125355.38,1097946.4
2436,U18962,282,7628.279999999933,242,40,500437.11999999994,508065.39999999985
2437,U643094,282,-1949.5300000000007,172,110,126254.56999999999,124305.04
2438,U32913,282,-2265.19,256,26,42762.920000000006,40497.73
2439,U39282,282,-21174.149999999994,249,33,220508.83000000002,199334.68000000002
2440,U31766,282,-21657.089999999997,268,14,147409.24000000005,125752.15000000005
2441,U16319,282,118520.02000000002,253,29,303719.28,422239.30000000005
2442,U29520,282,3344.030000000007,201,81,350385.4800000001,353729.5100000001
2443,U34921,282,20746.280000000002,136,146,358150.0999999999,378896.37999999995
2444,U16956,281,1473.9100000000053,261,20,136066.2699999999,137540.1799999999
2445,U30797,281,-3969.6099999999997,264,17,14774.389999999998,10804.779999999999
2446,U40938,281,112788.69000000002,263,18,96171.41,208960.10000000003
2447,U16981,281,122545.52000000002,243,38,731308.47,853853.99
2448,U13719,281,-12642.339999999997,173,108,961326.33,948683.99
2449,U977861,281,17281.04000000003,239,42,44958.810000000005,62239.850000000035
2450,U29888,281,12476.429999999995,248,33,145799.28999999998,158275.71999999997
2451,U22881,281,-23678.220000000012,213,68,8250375.909999999,8226697.6899999995
2452,U19113,281,308.62000000000336,173,108,590928.0099999999,591236.6299999999
2453,U15476,281,24775.199999999997,257,24,146811.71000000002,171586.91000000003
2454,U20472,281,16387.929999999986,195,86,218806.6900000001,235194.62000000008
2455,U899197,281,486.8200000000002,168,113,16299.049999999996,16785.869999999995
2456,U16384,281,56157.009999999995,239,42,631638.81,687795.8200000001
2457,U11811,281,-6221.979999999996,168,113,1481982.2499999998,1475760.2699999998
2458,U12309,281,27396.530000000028,138,143,631341.7700000001,658738.3000000002
2459,U38440,281,-32325.449999999953,242,39,896879.92,864554.4700000001
2460,U20783,281,-41701.50000000001,264,17,133088.7099999999,91387.2099999999
2461,U40747,281,865.7899999999995,262,19,46794.96,47660.75
2462,U10233,281,-151193.15999999997,249,32,1347635.0900000003,1196441.9300000004
2463,U16170,281,5668.8299999999945,218,63,349072.73000000004,354741.56000000006
2464,U638035,281,-8144.52,251,30,60989.700000000004,52845.18000000001
2465,U30807,281,1965.2300000000105,204,77,1289643.09,1291608.32
2466,U16204,281,-40915.91000000003,245,36,174341.99999999994,133426.0899999999
2467,U20446,281,7175.590000000004,260,21,49291.630000000005,56467.22000000001
2468,U38840,281,-29415.150000000005,263,18,86667.17999999998,57252.02999999997
2469,U1326583,281,1.1999999999999318,171,110,30511.749999999985,30512.949999999986
2470,U10834,280,-1347.3100000001505,215,65,4094984.900000001,4093637.590000001
2471,U31058,280,-68760.17999999998,184,96,1037747.55,968987.3700000001
2472,U8545,280,119390.12000000004,264,16,119571.91999999997,238962.04
2473,U26220,280,74.77000000004773,254,26,1829989.06,1830063.83
2474,U32523,280,-98820.61999999998,250,30,393163.58,294342.96
2475,U31939,280,-8106.63000000001,224,56,421433.48000000004,413326.85000000003
2476,U9507,280,2456.110000000011,257,23,102906.36000000003,105362.47000000004
2477,U10027,280,1595.4800000000032,258,22,206776.69000000003,208372.17000000004
2478,U20975,280,12070.110000000024,103,177,1169573.6600000001,1181643.7700000003
2479,U13010,280,-106734.54000000005,247,33,2471810.5700000003,2365076.0300000003
2480,U21548,280,-31501.480000000014,191,89,722257.8700000001,690756.3900000001
2481,U25745,280,267455.2700000014,192,88,33824788.370000005,34092243.64000001
2482,U1254729,280,-2716.899999999997,213,67,104512.98000000007,101796.08000000007
2483,U20323,280,1846.9800000000164,151,129,536034.27,537881.25
2484,U906699,280,-9.740000000001828,146,134,132791.07999999996,132781.33999999997
2485,U11542,280,-4532.16000000001,251,29,181364.54999999996,176832.38999999996
2486,U8053,280,-27585.349999999995,263,17,91288.86999999997,63703.519999999975
2487,U13710,280,205152.2000000002,241,39,2622675.24,2827827.4400000004
2488,U24066,280,-8715.179999999995,259,21,105050.20000000001,96335.02000000002
2489,U12102,280,786.1999999999944,268,12,15696.420000000006,16482.62
2490,U28775,280,14870.459999999988,171,109,1430106.64,1444977.0999999999
2491,U40622,280,-19800.58999999999,253,27,414078.03,394277.44000000006
2492,U23973,280,171777.72999999998,160,120,818481.9299999999,990259.6599999999
2493,U19052,280,157227.3800000002,251,29,650495.4900000006,807722.8700000008
2494,U24463,280,-13323.890000000001,257,23,206298.98000000007,192975.09000000005
2495,U23031,280,-5332.730000000004,238,42,154758.98,149426.25
2496,U22351,280,-22384.630000000034,229,51,3429997.2099999976,3407612.5799999977
2497,U16341,280,11218.869999999999,256,24,25947.110000000004,37165.98
2498,U26908,280,32213.5,255,25,95173.24000000003,127386.74000000003
2499,U20412,280,86152.95999999999,130,150,694251.26,780404.22
2500,U28222,280,-10694.029999999999,194,86,520958.8599999999,510264.82999999996
2501,U42542,279,-15074.03000000001,257,22,53733.18999999999,38659.159999999974
2502,U11691,279,-25258.97000000004,139,140,780405.9999999998,755147.0299999997
2503,U10288,279,608969.5000000002,210,69,15142646.869999997,15751616.369999997
2504,U21429,279,-1423.7200000000028,262,17,70130.03,68706.31
2505,U9171,279,9925.840000000013,190,89,30459.250000000022,40385.09000000003
2506,U982612,279,-8296.570000000009,140,139,259658.56,251361.99
2507,U10295,279,17909.29999999998,158,121,590367.7699999999,608277.0699999998
2508,U14088,279,-95478.1400000001,123,156,2711281.79,2615803.65
2509,U34169,279,4462.820000000009,146,133,221247.91,225710.73
2510,U40515,279,188184.5400000001,143,136,1136436.08,1324620.62
2511,U12708,279,8845.070000000014,262,17,91616.97000000004,100462.04000000007
2512,U17973,279,-123049.66,256,23,453176.54000000004,330126.88
2513,U27010,279,-10885.49,227,52,1310326.1200000008,1299440.6300000008
2514,U15047,279,13134.290000000015,256,23,244496.2600000001,257630.5500000001
2515,U12895,279,-131806.39,254,25,498429.75,366623.36
2516,U12593,279,-98407.05,216,63,866838.51,768431.46
2517,U15795,279,-564184.7900000002,255,24,1058631.3799999997,494446.5899999995
2518,U15859,279,34824.749999999585,241,38,3963327.11,3998151.8599999994
2519,U31741,279,-13581.859999999991,266,13,42373.169999999984,28791.30999999999
2520,U41666,279,166.6099999999915,251,28,169792.75999999995,169959.36999999994
2521,U19291,278,-169957.95999999985,151,127,1629445.6499999994,1459487.6899999995
2522,U31259,278,-16152.639999999992,230,48,76664.84999999999,60512.21
2523,U25257,278,10605.580000000014,232,46,215031.48000000004,225637.06000000006
2524,U23177,278,180253.3899999996,243,35,990216.1300000001,1170469.5199999998
2525,U17273,278,-3295.8100000000086,238,40,375552.3999999999,372256.5899999999
2526,U15552,278,120027.20999999996,256,22,968706.3100000002,1088733.52
2527,U29267,278,4310.690000000001,254,24,33679.219999999994,37989.909999999996
2528,U33654,278,-22682.410000000025,208,70,283064.73999999993,260382.3299999999
2529,U24919,278,24107.570000000032,133,145,1068521.47,1092629.04
2530,U13982,278,-346567.0799999999,201,77,1617038.2900000003,1270471.2100000004
2531,U33030,278,21858.279999999922,200,78,415949.61,437807.8899999999
2532,U26051,278,-5767.510000000009,163,115,709002.5700000001,703235.06
2533,U37721,278,-10710.919999999922,214,64,1448715.2299999993,1438004.3099999994
2534,U11358,278,-1408.7199999999987,266,12,35402.30000000001,33993.58000000001
2535,U11925,278,-1074.9800000000032,202,76,627685.38,626610.4
2536,U11324,278,-12868.86,250,28,64241.09000000002,51372.23000000002
2537,U13166,278,109944.67000000004,246,32,959003.3099999999,1068947.98
2538,U22332,278,-18842.590000000004,263,15,206125.87999999992,187283.28999999992
2539,U38456,278,-4333.279999999999,265,13,13730.459999999995,9397.179999999997
2540,U41766,278,112120.09000000007,242,36,1539746.93,1651867.02
2541,U33741,278,15518.010000000002,235,43,63678.75000000001,79196.76000000001
2542,U1375381,278,-6082.659999999998,221,57,130070.38000000002,123987.72000000002
2543,U17296,278,1239.4500000000119,242,36,196602.50000000006,197841.95000000007
2544,U10272,278,-64235.679999999986,259,19,628578.4400000001,564342.7600000001
2545,U20411,278,-135727.59999999998,267,11,277958.87000000005,142231.27000000008
2546,U38776,278,13037.990000000058,235,43,192058.85,205096.84000000005
2547,U20787,277,-2223.229999999966,240,37,497787.9700000001,495564.7400000001
2548,U16977,277,-11809.410000000022,215,62,1857263.5199999998,1845454.1099999999
2549,U965622,277,-9.790000000047598,135,142,75705.22000000002,75695.42999999996
2550,U20431,277,-20468.610000000026,247,30,329890.41000000003,309421.8
2551,U17009,277,-24367.949999999833,225,52,2422889.9299999964,2398521.9799999967
2552,U34215,277,-27722.930000000015,198,79,472140.9099999999,444417.9799999999
2553,U33801,277,-5857.22999999999,216,61,353776.97,347919.74
2554,U13826,277,-1203.9799999999948,172,105,406846.78,405642.80000000005
2555,U17369,277,2075.8700000001118,217,60,3860614.3200000003,3862690.1900000004
2556,U21921,277,-12193.999999999889,255,22,1164376.1199999994,1152182.1199999994
2557,U30172,277,-16583.890000000072,207,70,2003977.15,1987393.2599999998
2558,U20068,277,-9913.710000000003,261,16,98557.63,88643.92
2559,U27729,277,5622.720000000005,248,29,75243.60000000005,80866.32000000005
2560,U13884,277,393.33999999998383,269,8,121032.98,121426.31999999998
2561,U30450,277,954.9899999999881,228,49,138890.28999999998,139845.27999999997
2562,U15495,277,158920.20999999993,181,96,3304077.2599999993,3462997.4699999993
2563,U11201,277,-37863.21999999994,159,118,1579448.0099999998,1541584.7899999998
2564,U16116,277,-14924.550000000003,208,69,1523641.4800000002,1508716.9300000002
2565,U1380979,277,-2.6400000000630826,160,117,157539.23,157536.58999999994
2566,U11609,277,-665661.2500000003,267,10,713785.2900000004,48124.04000000004
2567,U27093,277,-6525.290000000023,212,65,527884.1100000001,521358.82000000007
2568,U9574,277,-7255.660000000002,268,9,47484.34,40228.67999999999
2569,U21074,277,2931.5900000000024,225,52,59405.70999999998,62337.29999999998
2570,U36750,276,-33716.750000000015,261,15,115943.95000000001,82227.2
2571,U39469,276,506212.8099999999,206,70,2570919.4499999997,3077132.26
2572,U35745,276,-2830.7800000000007,205,71,188591.45,185760.67
2573,U21594,276,-2495.6699999999933,264,12,16183.620000000028,13687.950000000035
2574,U25947,276,-7148.66,266,10,39218.00000000001,32069.340000000007
2575,U773014,276,3040.21,110,166,6195.280000000001,9235.490000000002
2576,U22534,276,-15755.159999999996,192,84,170990.22999999995,155235.06999999995
2577,U12185,276,-1197.6999999999869,258,18,144924.7699999998,143727.0699999998
2578,U19599,276,4108.66,200,76,139370.81000000003,143479.47000000003
2579,U41502,276,-17250.179999999964,231,45,293096.19,275846.01
2580,U34609,276,-8244.619999999997,262,14,1086584.4100000001,1078339.79
2581,U43445,276,-3999.949999999999,228,48,67459.64,63459.69
2582,U9837,276,7424.150000000009,231,45,133260.1600000002,140684.31000000023
2583,U11011,276,-0.17999999999273086,150,126,196745.21,196745.03
2584,U15330,276,-14978.389999999992,254,22,177174.82999999987,162196.4399999999
2585,U17457,276,2953.880000000001,231,45,310014.8300000001,312968.7100000001
2586,U33097,276,27892.47000000001,232,44,1019831.8300000003,1047724.3000000003
2587,U38398,276,20578.990000000023,220,56,813136.3799999999,833715.3699999999
2588,U19562,276,-81.66999999999942,230,46,34452.54000000003,34370.87000000003
2589,U10674,276,-388.11999999999796,267,9,8550.629999999996,8162.5099999999975
2590,U11987,276,-56146.160000000054,248,28,3114210.66,3058064.5
2591,U33382,276,-5900.259999999995,246,30,84134.22000000002,78233.96000000002
2592,U19728,276,-2259.8399999999915,177,99,350514.76,348254.92000000004
2593,U25052,276,1070.209999999999,232,44,31269.969999999998,32340.179999999997
2594,U10015,276,-4387.520000000011,177,99,856524.5100000001,852136.9900000001
2595,U16027,276,-9960.77000000001,201,75,174509.02999999994,164548.25999999992
2596,U11304,276,573.1100000000224,152,124,863844.3900000001,864417.5000000001
2597,U639229,276,-4000.090000000004,144,132,250140.64000000004,246140.55000000005
2598,U15814,276,-12362.670000000391,241,35,9865526.34,9853163.67
2599,U26419,276,83968.4,264,12,110069.36,194037.76
2600,U14096,276,554516.2,261,15,170719.24,725235.44
2601,U28936,276,-86289.88000000002,169,107,1935221.55,1848931.67
2602,U40384,276,-17234.300000000032,257,19,165043.88,147809.57999999996
2603,U11559,275,20300.360000000073,240,35,693454.35,713754.7100000001
2604,U31202,275,-192621.32000000007,243,32,489068.89,296447.56999999995
2605,U41372,275,473341.75,266,9,150039.48,623381.23
2606,U24728,275,-21597.700000000004,257,18,91121.08000000002,69523.38
2607,U40942,275,82624.53999999998,223,52,880943.59,963568.1299999999
2608,U32173,275,-175643.78,239,36,636114.4700000001,460470.69000000006
2609,U22041,275,-16607.92000000002,206,69,472910.26999999996,456302.3499999999
2610,U13750,275,45.090000000002874,208,67,78868.96999999999,78914.05999999998
2611,U14611,275,9212.89999999999,228,47,141190.5,150403.4
2612,U40057,275,-96158.75999999998,254,21,116411.22999999997,20252.469999999987
2613,U31671,275,-5265.769999999999,257,18,99342.94999999984,94077.17999999983
2614,U39667,275,-43662.700000000004,264,11,64406.50000000001,20743.800000000003
2615,U11834,275,4186.489999999982,73,202,252810.08000000005,256996.57000000004
2616,U11026,275,573.2200000000003,255,20,34272.280000000006,34845.50000000001
2617,U34193,275,-51338.919999999925,97,178,1183373.52,1132034.6
2618,U40465,275,127079.32000000008,227,48,1425759.5900000005,1552838.9100000006
2619,U9800,275,805.2399999999917,225,50,151885.48,152690.72
2620,U26577,275,-5382.320000000001,260,15,35138.77000000003,29756.450000000033
2621,U32238,275,-2305.379999999999,260,15,28865.730000000003,26560.350000000006
2622,U26401,275,-422578.61000000034,260,15,888192.0800000001,465613.46999999974
2623,U40494,275,-14832.099999999995,266,9,37788.5,22956.400000000005
2624,U38619,275,-21297.209999999992,240,35,247020.6699999999,225723.4599999999
2625,U10374,275,26065.429999999957,221,54,821442.45,847507.8799999999
2626,U21840,275,-11790.78999999998,179,96,651969.9199999999,640179.1299999999
2627,U20099,275,-54.77000000001054,249,26,315842.4599999999,315787.6899999999
2628,U15899,275,-11827.850000000082,234,41,1833720.5100000002,1821892.6600000001
2629,U26269,275,561023.6799999999,235,40,410427.09,971450.77
2630,U10536,275,64498.319999999934,186,89,1596683.18,1661181.4999999998
2631,U37450,275,-20816.870000000017,242,33,336864.76,316047.89
2632,U9094,275,-53675.77000000001,237,38,969542.4000000003,915866.6300000002
2633,U11440,275,455183.35999999987,242,33,85464.63000000006,540647.99
2634,U39997,275,4406.749999999996,250,25,1609516.219999999,1613922.969999999
2635,U40665,275,-39132.22,250,25,286941.83999999997,247809.61999999997
2636,U18953,275,-43330.790000000095,131,144,6692648.3,6649317.51
2637,U24609,275,-32463.80999999999,247,28,885071.2100000005,852607.4000000006
2638,U14233,275,34726.71,243,32,233698.67999999993,268425.38999999996
2639,U22418,274,-8404524.790000003,236,38,39435964.13,31031439.34
2640,U18039,274,-1681.0600000000009,249,25,75339.78,73658.72
2641,U17019,274,950780.3799999997,150,124,2635686.7900000005,3586467.17
2642,U41331,274,-163390.83000000005,255,19,681287.0800000001,517896.25
2643,U30965,274,-1028.4000000000005,250,24,23545.679999999993,22517.27999999999
2644,U18773,274,-25293.699999999997,236,38,143349.46000000002,118055.76000000002
2645,U12295,274,-214857.78000000032,244,30,1141223.749999999,926365.9699999988
2646,U10631,274,10297.0,263,11,48532.12000000001,58829.12000000001
2647,U9200,274,803.0400000000016,260,14,46756.86000000001,47559.90000000001
2648,U1248280,274,632.3299999999988,158,116,52349.83999999998,52982.169999999984
2649,U14469,274,5161.389999999997,255,19,86292.19999999998,91453.58999999998
2650,U42329,274,48437.04999999999,246,28,87158.19,135595.24
2651,U993336,274,-13508.309999999998,140,134,37325.09,23816.78
2652,U12562,274,-44926.01999999999,214,60,1302743.32,1257817.3
2653,U1106236,274,64.79999999998546,212,62,151857.52,151922.31999999998
2654,U13984,274,-12330.519999999999,262,12,49397.39,37066.87
2655,U8098,274,19510.23,258,16,101120.37000000001,120630.6
2656,U716163,274,-345.2800000000036,178,96,167146.69000000003,166801.41000000003
2657,U30913,274,-473107.4399999999,182,92,1707554.8900000001,1234447.4500000002
2658,U13658,274,-153601.4799999999,259,15,699663.940000001,546062.4600000011
2659,U9575,274,-159597.06000000006,191,83,1341673.83,1182076.77
2660,U41052,274,5915.320000000015,161,113,998089.0799999998,1004004.3999999999
2661,U37730,274,14476.229999999989,132,142,401819.2899999998,416295.5199999998
2662,U26623,274,694.9599999999955,147,127,610315.4599999998,611010.4199999998
2663,U1301466,274,322.9299999999994,170,104,167513.56999999998,167836.49999999997
2664,U9035,273,2675.960000000033,233,40,291225.0699999999,293901.0299999999
2665,U9545,273,-26111.53000000001,246,27,131497.61,105386.07999999997
2666,U987491,273,-8450.650000000009,167,106,190000.43999999997,181549.78999999998
2667,U676733,273,-1856.5599999999981,149,124,175517.92,173661.36000000002
2668,U16880,273,4487.460000000037,254,19,753515.65,758003.1100000001
2669,U36473,273,262831.51,196,77,331350.5399999999,594182.0499999999
2670,U1120292,273,609.8300000000014,151,122,83665.5,84275.33
2671,U41325,273,-750770.3899999999,263,10,852316.79,101546.40000000014
2672,U43286,273,-24134.54,262,11,85111.18000000001,60976.64000000001
2673,U23476,273,-109989.34999999998,192,81,1403773.2900000003,1293783.9400000004
2674,U1127109,273,-13011.81999999999,151,122,52608.850000000006,39597.03000000001
2675,U10000,273,718.1399999999958,155,118,200808.21000000008,201526.35000000006
2676,U35037,273,143.02999999992463,249,24,469279.23000000004,469422.25999999995
2677,U12365,273,-1080.9000000000003,238,35,23055.210000000006,21974.310000000005
2678,U39557,273,57230.15999999978,245,28,920781.7999999997,978011.9599999995
2679,U29399,273,138766.05000000022,194,79,3101462.98,3240229.0300000003
2680,U21940,273,4546.3900000000185,111,162,700612.9099999999,705159.2999999999
2681,U14663,273,-293429.37000000005,244,29,1697228.0899999996,1403798.7199999995
2682,U29577,273,-9285.729999999998,211,62,61958.979999999996,52673.25
2683,U14463,273,-26937.23,269,4,29876.529999999995,2939.2999999999956
2684,U29910,273,-64305.31,198,75,299936.3999999998,235631.0899999998
2685,U31711,273,-2212.879999999919,262,11,1064433.97,1062221.09
2686,U27237,273,31589.40000000001,243,30,271021.47,302610.87
2687,U37612,273,-12681.0,250,23,65270.020000000026,52589.020000000026
2688,U14244,273,-2268.370000000021,190,83,383443.6199999999,381175.2499999999
2689,U42845,273,2297.2699999999923,260,13,78861.78,81159.04999999999
2690,U10159,273,-11512.360000000015,244,29,249469.55999999982,237957.1999999998
2691,U18083,273,-10035.300000000081,181,92,500132.99999999994,490097.69999999984
2692,U26216,273,-106286.77000000022,224,49,541611.93,435325.1599999998
2693,U42771,273,18730.909999999963,231,42,1233698.6799999997,1252429.5899999996
2694,U12388,273,-12878.339999999962,186,87,591399.1500000001,578520.8100000002
2695,U13569,273,25704.339999999997,215,58,82184.33,107888.67
2696,U9940,272,-826.7999999999993,208,64,77728.18,76901.37999999999
2697,U11130,272,-55840.47999999996,253,19,1704769.91,1648929.43
2698,U9273,272,3493.300000000003,238,34,566626.45,570119.75
2699,U27592,272,6365.2700000000095,236,36,101085.07000000021,107450.34000000021
2700,U28257,272,37423.76999999999,237,35,180842.06000000003,218265.83000000002
2701,U16402,272,-517280.4400000033,136,136,11460812.300000003,10943531.86
2702,U20131,272,33911.780000000035,210,62,433744.75,467656.53
2703,U31891,272,6565.4499999999925,263,9,25756.600000000006,32322.05
2704,U31923,272,-132305.76000000004,225,47,1350124.1400000001,1217818.3800000001
2705,U21811,272,-27914.859999999997,255,17,230997.38999999998,203082.53
2706,U14852,272,-47505.98,250,22,283803.99,236298.00999999998
2707,U23421,272,-60159.79999999999,238,34,1223224.5999999999,1163064.7999999998
2708,U37797,272,2998.8899999999603,232,40,1056586.68,1059585.5699999998
2709,U39720,272,-18180.099999999966,237,35,185788.59999999995,167608.49999999997
2710,U12390,272,18649.349999999977,233,39,917227.08,935876.4299999999
2711,U35666,272,-177603.77999999962,219,53,8864473.270000001,8686869.490000002
2712,U27804,272,-57389.98000000001,220,52,111852.47000000004,54462.490000000034
2713,U41744,272,-306135.63000000006,226,46,992419.38,686283.75
2714,U9592,272,-1587.6700000000005,171,101,50080.829999999994,48493.159999999996
2715,U21330,272,48953.59999999999,229,43,2017092.1900000006,2066045.7900000007
2716,U16434,272,33770.31000000005,226,46,513029.28999999986,546799.5999999999
2717,U40662,272,-723.6199999999486,216,56,492341.00000000006,491617.3800000001
2718,U26598,272,16566.63999999997,167,105,588992.6499999999,605559.2899999999
2719,U42507,272,-62829.22999999998,259,13,125289.07999999999,62459.850000000006
2720,U9249,271,-18874.39,256,15,208346.13999999998,189471.75
2721,U33016,271,13093.559999999989,182,89,707044.9199999999,720138.4799999999
2722,U26441,271,-2619.3999999999955,246,25,50429.59000000002,47810.190000000024
2723,U10829,271,17310.489999999998,259,12,83828.87999999998,101139.36999999997
2724,U8631,271,14697.020000000091,174,97,4233475.83,4248172.850000001
2725,U16419,271,1252256.6499999994,246,25,888131.99,2140388.6399999997
2726,U18205,271,-7966.009999999988,245,26,159537.33000000005,151571.32000000007
2727,U42832,271,-895.8500000000047,200,71,440155.89999999997,439260.05
2728,U1182652,271,-17488.730000000032,155,116,695961.8500000001,678473.1200000001
2729,U22605,271,4544.920000000004,247,24,42901.94999999999,47446.869999999995
2730,U28803,271,-5249.159999999989,254,17,79746.52000000002,74497.36000000003
2731,U9085,271,-6497.449999999995,197,74,154052.65999999995,147555.20999999996
2732,U11656,271,-15386.549999999997,256,15,150515.75,135129.2
2733,U25285,271,1997185.2,220,51,3164768.65,5161953.85
2734,U22759,271,6719.249999999997,258,13,80052.74,86771.99
2735,U17023,271,-9476.140000000001,227,44,48994.52999999998,39518.38999999998
2736,U43749,271,-2014.949999999998,255,16,20358.280000000017,18343.33000000002
2737,U24208,271,-160656.80999999994,252,19,275785.71999999986,115128.90999999992
2738,U33414,271,-5136.5999999999985,247,24,12055.919999999998,6919.32
2739,U30085,271,41949.820000000065,219,52,2328017.13,2369966.95
2740,U30502,271,76670.46,239,32,224589.22,301259.68
2741,U10055,271,-6966.479999999981,239,32,226772.63999999996,219806.15999999997
2742,U39777,271,13201.409999999996,246,25,134532.41999999998,147733.83
2743,U21267,271,-23120.119999999995,235,36,337000.2700000001,313880.1500000001
2744,U20745,270,-1082.8399999999967,198,72,92545.80999999995,91462.96999999996
2745,U27654,270,-52242.699999999946,249,21,145933.00000000006,93690.3000000001
2746,U12182,270,22868.680000000008,197,73,704396.1299999995,727264.8099999996
2747,U33034,270,227.8799999999893,181,89,268933.79999999993,269161.67999999993
2748,U15104,270,-4855.250000000002,155,115,140825.94999999998,135970.69999999998
2749,U8255,270,103599.97,246,24,131301.14,234901.11000000002
2750,U1356881,270,-6921.340000000004,193,77,80186.01000000001,73264.67000000001
2751,U40191,270,-12832.310000000001,248,22,165299.70000000004,152467.39000000004
2752,U41834,270,-13415.339999999997,260,10,74061.30999999998,60645.96999999999
2753,U38235,270,-62298.270000000004,241,29,234668.0399999999,172369.7699999999
2754,U40346,270,-28187.69,256,14,127321.34000000001,99133.65000000001
2755,U15167,270,9408.369999999999,254,16,85559.45999999999,94967.82999999999
2756,U29260,270,22616.930000000004,197,73,767755.2199999995,790372.1499999996
2757,U25628,270,-11736.210000000001,249,21,45067.00999999997,33330.799999999974
2758,U26496,270,-12115.530000000006,242,28,321937.87999999983,309822.3499999998
2759,U29863,270,2895.9800000000087,241,29,141635.96999999997,144531.94999999998
2760,U40404,270,-67095.87,242,28,530608.05,463512.18000000005
2761,U29748,270,48921.82000000002,211,59,475498.29999999993,524420.12
2762,U24212,270,-99936.67999999993,206,64,1274143.7200000002,1174207.0400000003
2763,U43056,270,11735.200000000117,235,35,907076.9600000002,918812.1600000003
2764,U15375,270,-16659.06999999997,198,72,695385.05,678725.9800000001
2765,U40218,270,-2772.420000000115,156,114,5039182.159999998,5036409.739999998
2766,U33304,270,-316.5700000000015,240,30,14340.989999999989,14024.419999999987
2767,U38896,270,-50121.440000000024,247,23,302386.88,252265.43999999997
2768,U33515,269,-8650.920000000058,238,31,323486.26,314835.33999999997
2769,U15007,269,8188.570000000007,236,33,132325.74,140514.31
2770,U33556,269,16004.329999999973,204,65,58230.00000000004,74234.33000000002
2771,U25835,269,14868.509999999971,103,166,231817.24,246685.74999999997
2772,U39193,269,-295081.24,263,6,362736.05000000005,67654.81000000006
2773,U38047,269,45941.21999999998,213,56,96759.87999999996,142701.09999999995
2774,U16541,269,4573.860000000001,191,78,496629.58,501203.44
2775,U22353,269,53754.09999999998,228,41,2067608.8599999996,2121362.9599999995
2776,U22001,269,1693.7800000000097,192,77,434576.68000000005,436270.4600000001
2777,U40393,269,-74566.70000000006,194,75,806795.9699999999,732229.2699999998
2778,U24395,269,26502.169999999995,242,27,196567.92999999996,223070.09999999995
2779,U10929,269,69024.84999999998,211,58,917469.4400000001,986494.29
2780,U20366,269,437453.80000000005,250,19,1076023.94,1513477.74
2781,U35193,269,-435869.02999999985,246,23,711271.7000000004,275402.67000000057
2782,U17709,269,-297027.12,206,63,834341.7200000001,537314.6000000001
2783,U17776,269,9750.740000000147,232,37,151107.32,160858.06000000014
2784,U40923,269,-50094.27,247,22,251463.53999999998,201369.27
2785,U43538,269,2593.2700000000004,250,19,49730.32000000001,52323.59000000001
2786,U29841,269,-57830.580000000016,228,41,2922436.829999998,2864606.249999998
2787,U34135,269,-4508.15,261,8,23683.81,19175.660000000003
2788,U35481,269,-569.3299999999117,242,27,1038928.0500000002,1038358.7200000002
2789,U27153,269,-86458.54000000001,251,18,504264.43999999994,417805.8999999999
2790,U38752,269,-39825.97999999999,249,20,260821.10999999996,220995.12999999998
2791,U38516,269,5080.17,259,10,24635.299999999996,29715.469999999994
2792,U43717,269,14748.46,263,6,62370.05,77118.51000000001
2793,U747077,269,980.3599999999999,194,75,22577.620000000003,23557.980000000003
2794,U41922,269,-662.6700000000128,236,33,245118.93999999997,244456.26999999996
2795,U12982,269,335180.0100000001,156,113,5750351.33,6085531.34
2796,U29338,269,-114158.75000000012,239,30,2554941.42,2440782.67
2797,U23622,269,-88989.07000000004,247,22,324532.9699999999,235543.89999999988
2798,U34311,269,-4946.389999999998,266,3,23270.44,18324.050000000003
2799,U10500,269,6920.459999999999,245,24,47695.710000000014,54616.17000000001
2800,U39046,268,-16704.819999999992,224,44,101449.04999999997,84744.22999999998
2801,U34045,268,-140287.63999999996,236,32,495083.31,354795.67000000004
2802,U14334,268,-3998.4900000000143,229,39,178412.8899999999,174414.39999999988
2803,U33761,268,64112.489999999976,223,45,508668.18,572780.6699999999
2804,U8368,268,-7635.349999999999,240,28,129877.33000000005,122241.98000000004
2805,U34301,268,7409.739999999999,246,22,115457.41000000018,122867.15000000018
2806,U15791,268,-22664.579999999998,251,17,167382.98999999996,144718.40999999997
2807,U15532,268,-2972.750000000022,234,34,302269.99,299297.24
2808,U38386,268,-2739.9199999999987,226,42,173919.3199999999,171179.39999999988
2809,U10706,268,-62941.88999999995,246,22,328376.1399999999,265434.24999999994
2810,U28749,268,-21381.33,250,18,109336.51,87955.18
2811,U42117,268,7960.46,242,26,17818.910000000018,25779.370000000017
2812,U11560,268,44823.30999999993,229,39,1426461.3500000006,1471284.6600000004
2813,U25910,268,-21914.58999999999,242,26,215012.12,193097.53
2814,U23789,268,-22521.019999999946,229,39,2371026.96,2348505.94
2815,U10949,268,9092.159999999998,250,18,75566.94999999984,84659.10999999984
2816,U16656,268,-7351.650000000005,255,13,93790.92999999998,86439.27999999997
2817,U1165312,268,-0.6700000000001012,139,129,10044.11,10043.44
2818,U42071,268,-273.6500000000001,157,111,262906.5299999999,262632.8799999999
2819,U8531,268,-8757.720000000001,173,95,118896.26000000001,110138.54000000001
2820,U22843,268,31250.049999999985,236,32,830421.6999999997,861671.7499999997
2821,U19392,268,-6960.1799999999985,228,40,111783.31000000001,104823.13000000002
2822,U9308,268,69656.70999999996,236,32,148806.87999999998,218463.58999999994
2823,U11051,268,27847.98000000001,222,46,1724624.89,1752472.8699999999
2824,U15472,268,140291.26000000018,237,31,2133959.47,2274250.7300000004
2825,U19846,268,44596.86000000004,184,84,145850.0,190446.86000000004
2826,U36480,268,-717.9399999999077,233,35,1425506.8099999996,1424788.8699999996
2827,U28318,268,-10567.15,247,21,42001.729999999996,31434.579999999994
2828,U11899,268,18691.36000000002,252,16,74801.95999999999,93493.32
2829,U30224,267,33080.18999999999,238,29,220275.00999999992,253355.1999999999
2830,U17433,267,3949.189999999995,230,37,282340.38,286289.57
2831,U17606,267,-85109.8500000001,187,80,2607869.3,2522759.4499999997
2832,U38241,267,56240.25999999984,171,96,3515708.07,3571948.3299999996
2833,U32567,267,-584982.87,198,69,774678.74,189695.87
2834,U39142,267,23781.969999999983,250,17,81577.23000000001,105359.2
2835,U11759,267,48411.11999999962,215,52,945623.5100000002,994034.6299999999
2836,U37343,267,-868.2199999999992,250,17,188070.09,187201.87
2837,U21828,267,-9664.560000000025,233,34,385656.58999999997,375992.02999999997
2838,U31828,267,19230.39000000001,245,22,200721.12,219951.51
2839,U22241,267,1316.9400000000107,238,29,194411.89999999997,195728.83999999997
2840,U27560,267,-3080.459999999988,152,115,617479.0,614398.54
2841,U8523,267,41380.010000000046,229,38,725995.39,767375.4
2842,U12631,267,-77137.29999999997,131,136,283214.9100000001,206077.6100000001
2843,U16156,267,-34.34000000000162,244,23,667884.5500000002,667850.2100000002
2844,U41820,267,15139.330000000002,242,25,44798.42000000001,59937.750000000015
2845,U17448,267,7247.660000000016,211,56,491762.50000000006,499010.1600000001
2846,U29996,267,16503.590000000004,253,14,91314.35,107817.94
2847,U31474,267,79060.71000000006,242,25,135922.52,214983.23000000004
2848,U936734,267,1066.5999999999997,165,102,104694.25,105760.85
2849,U43715,267,-3853.5199999999986,249,18,17255.990000000005,13402.470000000007
2850,U8355,267,45505.15000000005,194,73,1409357.74,1454862.8900000001
2851,U23330,267,13041.899999999907,249,18,203447.09000000003,216488.98999999993
2852,U8727,267,-20762.409999999996,233,34,293119.35000000003,272356.94000000006
2853,U22729,267,-1023.0100000000045,258,9,82739.19,81716.18
2854,U27210,267,9908.850000000006,238,29,420250.02999999997,430158.88
2855,U29186,267,15413.829999999958,165,102,613884.3799999999,629298.2099999998
2856,U903301,266,-2802.0299999999993,242,24,13274.420000000002,10472.390000000003
2857,U11391,266,-8639.140000000007,241,25,244553.25999999998,235914.11999999997
2858,U27580,266,27623.960000000003,239,27,356559.00999999995,384182.97
2859,U31928,266,-436.6900000000023,188,78,685101.1299999999,684664.44
2860,U32940,266,7845.29,250,16,26860.190000000006,34705.48
2861,U36594,266,-1136.6099999999954,244,22,134007.52999999997,132870.91999999998
2862,U30013,266,90431.76999999997,241,25,674000.0500000002,764431.8200000002
2863,U8269,266,12065.46,253,13,50180.399999999994,62245.85999999999
2864,U27398,266,-17194.94999999999,217,49,160351.34,143156.39
2865,U31962,266,-4748.3900000000185,203,63,292588.3399999999,287839.9499999999
2866,U16286,266,-43537.50000000003,220,46,387115.25,343577.75
2867,U31612,266,233338.2499999996,245,21,972834.0100000002,1206172.2599999998
2868,U36428,266,-8158.839999999998,252,14,166717.90999999992,158559.06999999992
2869,U13507,266,-5375.240000000002,222,44,54898.21,49522.97
2870,U33721,266,-11425.069999999994,234,32,340740.27,329315.2
2871,U11734,266,-2124.779999999999,203,63,286806.91,284682.13
2872,U24312,266,197.839999999989,237,29,624028.1300000006,624225.9700000006
2873,U21166,266,-24000.799999999912,161,105,485565.06999999995,461564.27
2874,U38524,266,-31157.659999999953,225,41,805746.2299999999,774588.57
2875,U20942,266,-18234.170000000013,250,16,142774.85999999996,124540.68999999994
2876,U18408,266,-1700.3699999999735,200,66,865617.8200000002,863917.4500000002
2877,U17851,266,-130775.79999999994,198,68,278163.4099999999,147387.61
2878,U38977,266,24187.469999999983,237,29,237044.38999999993,261231.8599999999
2879,U14781,266,20133.730000000014,199,67,934559.1999999998,954692.9299999998
2880,U36371,266,1941.9899999999998,233,33,28368.91,30310.9
2881,U14325,266,-10087.820000000047,214,52,1530849.7299999984,1520761.9099999983
2882,U9914,266,-12337.179999999968,204,62,893658.2799999999,881321.1
2883,U40734,266,47340.440000000075,238,28,1397900.1700000002,1445240.6100000003
2884,U41233,265,-788.0000000000091,245,20,58914.239999999976,58126.23999999997
2885,U29263,265,-1313.170000000005,227,38,89282.15,87968.98
2886,U32971,265,70442.93999999999,234,31,493986.02,564428.96
2887,U13966,265,-49361.839999999975,210,55,1207010.5100000002,1157648.6700000002
2888,U11291,265,-58706.86999999999,243,22,279438.87,220732.0
2889,U42893,265,11724.13000000002,255,10,216727.97000000003,228452.10000000003
2890,U34201,265,533107.1099999998,247,18,1006550.0700000002,1539657.18
2891,U30557,265,-48178.500000000065,225,40,793095.0800000001,744916.58
2892,U13799,265,-19465.839999999997,211,54,1050535.3399999999,1031069.4999999999
2893,U33667,265,50882.54999999999,230,35,255457.13000000006,306339.68000000005
2894,U25728,265,-8359.6199999999,165,100,187861.78000000012,179502.1600000002
2895,U20889,265,1579.9000000000242,176,89,1284062.6199999996,1285642.5199999998
2896,U36853,265,14820.629999999997,239,26,97409.95999999999,112230.59
2897,U9319,265,-13444.77999999994,246,19,582425.91,568981.1300000001
2898,U39522,265,-3184.799999999948,251,14,738352.45,735167.65
2899,U28660,265,388.5200000000259,123,142,1167965.43,1168353.95
2900,U10453,265,-9448.519999999968,199,66,793400.2000000002,783951.6800000002
2901,U9636,265,-92916.59000000008,241,24,1409347.0099999993,1316430.4199999992
2902,U18461,265,18981.710000000006,249,16,111166.88999999998,130148.59999999999
2903,U15258,265,-1167933.5399999998,255,10,1403161.5399999998,235228.0
2904,U20399,265,4075.359999999999,257,8,24103.870000000003,28179.230000000003
2905,U39678,265,-6056.459999999985,239,26,100333.69,94277.23000000001
2906,U604814,265,-21284.390000000003,176,89,384453.52,363169.13
2907,U43745,265,-6719.509999999997,237,28,96534.89000000001,89815.38000000002
2908,U35090,265,-2750.9300000000003,253,12,30958.170000000002,28207.24
2909,U28670,265,-68196.2,233,32,1225148.1699999995,1156951.9699999995
2910,U31348,264,9104.860000000026,157,107,1296182.7500000002,1305287.6100000003
2911,U10641,264,-9215.270000001217,222,42,5492121.690000001,5482906.42
2912,U8381,264,-28183.36,231,33,120218.95000000008,92035.59000000008
2913,U16107,264,275742.0199999999,249,15,747421.1399999997,1023163.1599999996
2914,U15628,264,60667.10999999998,226,38,333608.35000000015,394275.46000000014
2915,U24472,264,-73395.96999999999,241,23,81524.53,8128.560000000012
2916,U13963,264,-37308.37999999999,244,20,561915.61,524607.23
2917,U9974,264,-110300.60000000003,240,24,217305.3,107004.69999999995
2918,U36029,264,-99943.51000000004,250,14,258924.21000000002,158980.69999999998
2919,U41286,264,-14688.899999999878,189,75,1650723.4799999993,1636034.5799999994
2920,U41050,264,13669.86999999999,231,33,207325.00999999995,220994.87999999995
2921,U898269,264,-2535.8600000000024,144,120,88853.31,86317.45
2922,U11415,264,-899.5199999999895,232,32,193319.32000000047,192419.80000000048
2923,U33290,264,1833605.0000000007,217,47,1665152.409999999,3498757.4099999997
2924,U9325,264,-2690.5299999999997,248,16,37090.17999999999,34399.649999999994
2925,U37326,264,-39907.80000000001,231,33,459863.23,419955.43
2926,U29754,264,-61273.219999999994,246,18,668364.59,607091.37
2927,U26756,264,1738.5899999999842,179,85,477361.60000000003,479100.19
2928,U1322954,264,-2621.309999999997,177,87,18834.360000000008,16213.05000000001
2929,U43416,264,4014.329999999999,235,29,35158.42000000002,39172.75000000002
2930,U16021,264,137737.06000000003,232,32,732876.1600000001,870613.2200000002
2931,U31499,264,-6265.58,248,16,83517.16000000006,77251.58000000006
2932,U36829,264,-6393.040000000037,163,101,1389327.51,1382934.47
2933,U10832,264,-8229.4,173,91,470876.22000000003,462646.82
2934,U34413,264,6173.050000000003,212,52,165500.23,171673.28000000003
2935,U40087,264,62540.360000000495,150,114,4483909.22,4546449.58
2936,U19851,264,-107427.57000000018,239,25,3393508.59,3286081.0199999996
2937,U44066,264,1917.6700000000017,251,13,65802.65,67720.31999999999
2938,U27816,264,161949.90999999992,236,28,605027.2400000001,766977.15
2939,U16457,264,-6038.84,212,52,140099.6,134060.76
2940,U23009,264,9250.100000000011,244,20,97609.85000000005,106859.95000000006
2941,U28168,264,-23521.57000000002,208,56,203836.58,180315.00999999995
2942,U15125,264,-13393.79999999993,196,68,1692685.1400000001,1679291.3400000003
2943,U8189,263,817.8699999999981,225,38,117851.10000000003,118668.97000000003
2944,U13784,263,-164796.65000000002,239,24,408773.12999999995,243976.47999999992
2945,U15623,263,15643.300000000087,211,52,728019.3600000001,743662.6600000001
2946,U9343,263,1692.660000000004,235,28,354577.07999999996,356269.74
2947,U21059,263,-2145.169999999962,240,23,323639.09,321493.92000000004
2948,U43948,263,-33014.2,217,46,502179.2100000001,469165.01000000007
2949,U37177,263,19043.970000000005,197,66,164320.22999999992,183364.19999999992
2950,U42963,263,2382.310000000009,199,64,34040.06000000001,36422.370000000024
2951,U35390,263,135095.31000000003,188,75,245727.62000000002,380822.93000000005
2952,U14488,263,5884.389999999999,169,94,441382.0699999999,447266.4599999999
2953,U16264,263,-1461585.3999999987,234,29,15413400.990000004,13951815.590000005
2954,U16497,263,-50347.820000000014,246,17,241781.33999999988,191433.51999999987
2955,U34549,263,6880.780000000007,233,30,108384.93999999996,115265.71999999997
2956,U43729,263,-10698.669999999986,236,27,91527.04999999997,80828.37999999999
2957,U29939,263,-1165.6299999999987,246,17,47500.310000000005,46334.68000000001
2958,U22177,263,7502.73,164,99,196052.77,203555.5
2959,U20850,263,-392125.39999999997,243,20,502123.2899999999,109997.88999999996
2960,U582548,263,-674.01,198,65,17757.000000000004,17082.990000000005
2961,U8186,263,44717.52999999996,250,13,97412.74,142130.26999999996
2962,U16374,263,-71932.29000000005,204,59,263582.0900000001,191649.80000000005
2963,U18518,263,2005.6600000000026,253,10,37051.58999999999,39057.24999999999
2964,U23079,262,16068.600000000002,197,65,743194.2100000003,759262.8100000003
2965,U44019,262,33552.79000000001,235,27,135498.66,169051.45
2966,U20415,262,-55553.35999999999,259,3,56250.03999999999,696.6800000000003
2967,U17656,262,-342.2500000000389,237,25,40638.68000000011,40296.43000000007
2968,U19074,262,28304.439999999995,206,56,129422.11999999998,157726.55999999997
2969,U30432,262,-49073.88000000002,252,10,70102.65999999997,21028.779999999955
2970,U39459,262,285374.61000000004,235,27,533106.6600000001,818481.2700000003
2971,U10430,262,-11729.579999999987,235,27,273039.27999999997,261309.69999999998
2972,U23580,262,5058.590000000008,243,19,118082.26000000002,123140.85000000003
2973,U24084,262,9573.600000000148,158,104,4378541.239999999,4388114.84
2974,U39508,262,-270369.22,224,38,765169.21,494799.99
2975,U11923,262,21509.870000000003,228,34,257435.07000000004,278944.94000000006
2976,U14365,262,44731.660000000236,45,217,3107585.5700000008,3152317.230000001
2977,U10864,262,-19788.23999999999,212,50,1191806.73,1172018.49
2978,U26943,262,4639.99999999999,240,22,85347.41999999994,89987.41999999993
2979,U14872,262,-26475.549999999992,227,35,81825.97999999997,55350.42999999998
2980,U25337,262,-27065.28000000008,170,92,1977406.73,1950341.45
2981,U18912,262,-2405.9300000000035,219,43,188137.21999999994,185731.28999999995
2982,U18969,262,-184.9199999999836,193,69,911057.75,910872.8300000001
2983,U24233,262,305781.29,236,26,159474.84,465256.13
2984,U36715,262,57582.25,206,56,387011.4,444593.65
2985,U18273,262,11331.740000000076,211,51,648857.82,660189.56
2986,U15965,262,-4686.569999999989,246,16,71406.81,66720.24
2987,U29164,262,-6197.930000000022,225,37,216038.75999999998,209840.82999999996
2988,U11044,261,9989.369999999986,136,125,251588.2000000001,261577.5700000001
2989,U18277,261,-1810.5800000000054,245,16,84081.44999999994,82270.86999999994
2990,U39435,261,88116.77999999993,197,64,1729614.6299999997,1817731.4099999997
2991,U11185,261,2606.979999999712,246,15,1592668.139999996,1595275.1199999957
2992,U15878,261,-98228.09999999986,228,33,3298527.550000001,3200299.450000001
2993,U33314,261,-4159.919999999997,246,15,69700.29999999997,65540.37999999998
2994,U10114,261,19286.14000000013,225,36,291852.99,311139.1300000001
2995,U20696,261,-615.010000000012,146,115,404468.82999999996,403853.81999999995
2996,U37479,261,27977.500000000025,241,20,145954.05000000002,173931.55000000005
2997,U18711,261,39503.22,241,20,24755.949999999997,64259.17
2998,U25665,261,-34552.11000000004,220,41,616715.58,582163.47
2999,U15585,261,4106.799999999987,195,66,230855.13,234961.93
3000,U24404,261,5445.079999999996,216,45,140765.69,146210.77
3001,U11210,261,108498.83999999998,248,13,113300.33000000002,221799.16999999998
3002,U16924,261,-11055.330000000002,239,22,558716.6499999998,547661.3199999998
3003,U11333,261,-929448.0200000004,211,50,6617336.029999999,5687888.009999999
3004,U8551,261,78883.33000000002,228,33,332289.8099999999,411173.1399999999
3005,U40850,261,77175.75000000001,199,62,2687039.55,2764215.3
3006,U38559,261,-22896.699999999997,252,9,263260.08999999997,240363.38999999996
3007,U15158,261,8271.30000000111,127,134,26400661.2,26408932.5
3008,U37493,261,364.81000000000057,247,14,19290.74,19655.550000000003
3009,U42671,261,-103109.29,243,18,118962.62999999999,15853.339999999997
3010,U43074,261,-29773.620000000017,225,36,241948.46999999997,212174.84999999995
3011,U37640,261,-7208.710000000001,256,5,38516.76,31308.050000000003
3012,U41522,261,1478.5900000000013,225,36,144877.0300000004,146355.6200000004
3013,U42348,261,83894.26000000002,222,39,1613051.96,1696946.22
3014,U16305,261,635.2100000000064,239,22,93695.00000000006,94330.21000000006
3015,U24845,261,115783.84000000001,244,17,97416.83,213200.67
3016,U33323,261,-68366.46,246,15,1343914.02,1275547.56
3017,U41801,261,10032.64999999996,218,43,2295476.2499999995,2305508.8999999994
3018,U22898,261,3966.460000000001,231,30,113942.76,117909.22
3019,U977122,261,7786.030000000004,141,120,73169.14,80955.17
3020,U35156,261,14452.880000000025,206,55,58136.87000000002,72589.75000000004
3021,U21582,261,15214.62,219,42,96276.89000000006,111491.51000000005
3022,U13023,261,14569.859999999979,237,24,267127.30000000005,281697.16000000003
3023,U13472,261,7609.739999999985,234,27,420720.14999999997,428329.88999999996
3024,U15218,260,-61382.45999999999,223,37,70475.68999999999,9093.229999999996
3025,U15209,260,-1153.1900000000057,199,61,320310.75999999983,319157.56999999983
3026,U41115,260,-23167.48000000004,176,84,1762302.32,1739134.84
3027,U21044,260,-5665.459999999997,235,25,56157.46000000005,50492.00000000005
3028,U15821,260,9050.429999999877,239,21,1066416.74,1075467.17
3029,U31552,260,4.639999999999418,148,112,324678.0,324682.64
3030,U21484,260,-20824.970000000023,228,32,172564.40000000002,151739.43
3031,U27328,260,75544.16999999987,227,33,1578049.4600000007,1653593.6300000006
3032,U20301,260,32961.65,223,37,256780.22999999995,289741.87999999995
3033,U14362,260,81975.34999999986,169,91,5322181.720000001,5404157.07
3034,U22589,260,-6579.220000000021,231,29,287085.06999999995,280505.8499999999
3035,U43136,260,-21547.84,247,13,68927.56000000001,47379.720000000016
3036,U25312,260,-2283.0599999999904,211,49,89304.39999999998,87021.34
3037,U11910,260,-9217.280000000485,194,66,8619759.01,8610541.729999999
3038,U32510,260,2470.6099999997678,208,52,2024784.55,2027255.16
3039,U15238,260,-2138184.0500000007,207,53,4998928.939999996,2860744.889999995
3040,U19456,260,-297221.2899999994,225,35,2296191.4999999977,1998970.2099999983
3041,U33021,260,-7463.650000000006,231,29,30029.679999999975,22566.02999999997
3042,U8116,260,2110.6199999999717,189,71,384774.35000000003,386884.97000000003
3043,U44002,260,11101.000000000005,201,59,85437.21,96538.21
3044,U37123,260,-1194.220000000002,238,22,51855.98,50661.76
3045,U13781,260,-21138.860000000168,237,23,1906643.53,1885504.67
3046,U42296,260,-39874.23999999999,238,22,211451.05999999994,171576.81999999995
3047,U22559,260,-15936.12,225,35,17592.49,1656.3700000000008
3048,U28223,260,-17186.109999999935,197,63,1054849.1500000004,1037663.0400000004
3049,U11405,260,113138.87,209,51,627841.2999999999,740980.1699999999
3050,U43221,260,16573.540000000005,242,18,120641.46999999999,137215.00999999998
3051,U19097,260,7743.720000000002,137,123,37620.28999999999,45364.009999999995
3052,U26764,260,42288.149999999994,243,17,72055.75000000001,114343.90000000001
3053,U17622,260,10809.029999999999,217,43,123623.42999999992,134432.4599999999
3054,U24100,260,-944.4700000000239,239,21,547719.05,546774.5800000001
3055,U28932,260,8579.260000000004,228,32,184907.01,193486.27000000002
3056,U21857,260,-4839.949999999953,160,100,6422260.1,6417420.149999999
3057,U38426,260,3502.230000000003,236,24,82227.23,85729.45999999999
3058,U42779,260,-15648.210000000034,247,13,62483.099999999984,46834.88999999995
3059,U30102,260,-116066.46999999997,219,41,508071.05,392004.58
3060,U33020,260,-4182.4799999999905,161,99,253811.51000000007,249629.0300000001
3061,U33976,260,-8197.48000000001,208,52,226590.08000000005,218392.60000000003
3062,U13100,259,-8489.640000000021,219,40,450349.72000000003,441860.08
3063,U8586,259,13395.119999999806,167,92,7043150.189999999,7056545.309999999
3064,U38770,259,-25501.390000000007,215,44,597668.5900000001,572167.2000000001
3065,U8557,259,-3156.4800000000005,227,32,49227.67999999999,46071.19999999999
3066,U13580,259,548350.0200000001,191,68,4687983.890000001,5236333.910000001
3067,U32912,259,-7255.72000000003,207,52,1182797.94,1175542.22
3068,U16948,259,1984.660000000089,196,63,5748235.1899999995,5750219.85
3069,U9486,259,-36059.990000008525,217,42,21932462.279999997,21896402.289999988
3070,U16637,259,-98667.12000000001,232,27,250296.47999999998,151629.36
3071,U19897,259,-2596.1400000000212,154,105,3343458.889999999,3340862.749999999
3072,U31157,259,-2867.0200000000004,225,34,139538.00000000003,136670.98000000004
3073,U33128,259,-14020.230000000009,238,21,96308.81999999999,82288.58999999998
3074,U41723,259,-44842.38000000005,243,16,188016.91999999998,143174.53999999992
3075,U16032,259,25070.509999999977,244,15,120226.53,145297.03999999998
3076,U16167,259,16055.279999999962,200,59,1448958.92,1465014.2
3077,U38326,259,584887.2499999998,203,56,5165866.3,5750753.55
3078,U42742,259,15183.030000000044,207,52,1983763.01,1998946.04
3079,U31088,259,-14087.949999999995,236,23,61337.28000000002,47249.33000000002
3080,U11554,259,-2869.4999999999854,234,25,431190.63,428321.13
3081,U33832,259,11853.289999999963,205,54,178896.4999999999,190749.78999999986
3082,U32853,259,11168.860000000006,210,49,337470.9,348639.76
3083,U22127,259,-268111.21999999986,216,43,739722.3099999998,471611.08999999997
3084,U38496,259,-146.74999999999835,238,21,24147.770000000004,24001.020000000004
3085,U16046,259,3502.1200000001418,212,47,1870540.0,1874042.12
3086,U9017,259,20579.85000000001,243,16,78883.60000000002,99463.45000000003
3087,U21653,258,764.3899999999994,153,105,963000.0100000001,963764.4000000001
3088,U30883,258,-3927.9699999999866,224,34,230171.70999999996,226243.74
3089,U16907,258,239941.0700000001,214,44,762306.8099999997,1002247.8799999998
3090,U8829,258,-561259.4999999999,238,20,1583940.02,1022680.5200000001
3091,U26461,258,12824.840000000002,244,14,151378.09000000003,164202.93000000002
3092,U20249,258,-22126.51000000038,138,120,7244053.73,7221927.22
3093,U38681,258,-2356.7399999999993,222,36,36547.61,34190.87
3094,U8329,258,400.8000000000082,120,138,170327.39999999994,170728.19999999995
3095,U39450,258,-8914.139999999963,241,17,406492.22,397578.08
3096,U34791,258,417.7800000000001,238,20,69233.36,69651.14
3097,U40476,258,25571.37,236,22,965782.3400000001,991353.7100000001
3098,U12455,258,-15174.30000000004,226,32,839463.2700000003,824288.9700000002
3099,U13849,258,-3837.8099999999977,233,25,59745.15,55907.340000000004
3100,U43502,258,-1207.5400000000102,168,90,154513.10999999996,153305.56999999995
3101,U22665,258,21851.900000000333,222,36,5275385.4,5297237.300000001
3102,U24156,258,-1005.0899999999992,235,23,112792.96000000006,111787.87000000007
3103,U24598,258,32261.72999999991,179,79,5517747.750000001,5550009.48
3104,U15248,258,-419.97000000001225,239,19,73492.69,73072.71999999999
3105,U30940,258,-14207.37000000001,249,9,106234.33000000002,92026.96
3106,U18641,258,-20259.80999999999,249,9,73959.73000000001,53699.92000000002
3107,U16336,258,15250.760000000013,181,77,453575.61,468826.37
3108,U14090,258,-23233.200000000008,194,64,2206531.0700000003,2183297.87
3109,U44020,258,53548.85000000002,196,62,851887.2999999999,905436.1499999999
3110,U35814,258,-36528.58999999998,197,61,697688.19,661159.6
3111,U14558,258,-1141.630000000001,243,15,7617.51,6475.879999999999
3112,U27026,257,29483.610000000044,235,22,102767.80999999988,132251.41999999993
3113,U43674,257,92980.7400000001,213,44,1790649.6,1883630.3400000003
3114,U29496,257,2776.7199999999875,220,37,281570.67,284347.38999999996
3115,U12407,257,-1023.7800000000208,228,29,53152.03,52128.24999999998
3116,U25690,257,24127.099999999984,136,121,419086.13000000006,443213.23000000004
3117,U13432,257,12672.81000000003,208,49,500976.37000000017,513649.1800000002
3118,U22265,257,-62584.02000000004,244,13,201571.05999999982,138987.03999999978
3119,U11573,257,-4826.650000000015,184,73,179655.87000000002,174829.22
3120,U14465,257,-165692.27000000025,215,42,13544694.730000002,13379002.460000003
3121,U27473,257,-49194.029999999955,188,69,510150.63999999844,460956.6099999985
3122,U10504,257,65491.24000000003,124,133,1242608.26,1308099.5
3123,U8024,257,-8842.000000000033,238,19,873315.25,864473.25
3124,U1309628,257,-4752.84,162,95,58304.40000000001,53551.56000000001
3125,U42821,257,5295.080000000004,168,89,402007.7,407302.78
3126,U25819,257,32826.799999999996,239,18,189515.26999999996,222342.06999999995
3127,U8839,257,96.68000000000048,150,107,35197.049999999996,35293.729999999996
3128,U16473,257,2763.2499999999927,215,42,250317.72999999995,253080.97999999995
3129,U18002,257,-257445.53000000032,109,148,5248931.87,4991486.34
3130,U32661,257,6981.170000000024,234,23,96092.12999999999,103073.30000000002
3131,U8651,257,-3038.029999999999,243,14,31901.6,28863.57
3132,U41620,257,69740.21999999999,242,15,182387.29,252127.51
3133,U16750,257,-26082.68000000005,222,35,3070964.3699999996,3044881.6899999995
3134,U38364,257,39963.78999999998,64,193,781906.9299999999,821870.72
3135,U15412,257,-13760.990000000054,217,40,1018990.21,1005229.2199999999
3136,U20364,257,-2588.98,212,45,57201.68,54612.7
3137,U38565,257,-7730.469999999998,238,19,121359.55000000003,113629.08000000003
3138,U17352,257,-450488.8700000005,232,25,1775422.9499999997,1324934.0799999991
3139,U13350,257,36221.599999999795,232,25,2903977.619999999,2940199.219999999
3140,U31951,257,168526.3399999999,233,24,753026.7700000003,921553.1100000001
3141,U21626,257,73606.38999999998,234,23,346970.6300000002,420577.02000000014
3142,U11173,257,2134.560000000004,192,65,119293.65,121428.20999999999
3143,U35696,257,100814.31000000019,166,91,2224474.149999999,2325288.459999999
3144,U16101,257,-244656.7299999999,142,115,3107263.3599999994,2862606.6299999994
3145,U38144,257,-29908.11999999998,231,26,373480.66000000003,343572.54000000004
3146,U21750,256,17080.38000000004,205,51,623669.1699999998,640749.5499999998
3147,U31415,256,3359.809999999999,249,7,29585.479999999992,32945.28999999999
3148,U8469,256,62112.81999999999,235,21,158183.75,220296.57
3149,U16891,256,-15030.180000000008,236,20,48621.96,33591.77999999999
3150,U10256,256,588.080000000009,169,87,296153.06,296741.14
3151,U9489,256,-25056.759999999995,215,41,54764.46000000001,29707.70000000001
3152,U15877,256,-7404.480000000009,228,28,125633.25,118228.76999999999
3153,U41951,256,14660.029999999979,177,79,484357.86999999994,499017.8999999999
3154,U9926,256,-4945.139999999999,226,30,96509.42999999995,91564.28999999995
3155,U17828,256,-4957.38000000002,141,115,212178.34,207220.95999999996
3156,U38121,256,690.5400000000009,243,13,22360.48,23051.02
3157,U26964,256,-2903.309999999996,230,26,111892.54999999996,108989.23999999996
3158,U28119,256,18587.089999999993,228,28,384578.9300000001,403166.0200000001
3159,U12301,256,-254690.8900000002,220,36,2709240.3,2454549.4099999997
3160,U24109,256,-2699.59,235,21,45830.83000000004,43131.240000000034
3161,U17322,256,-2208.6300000000015,208,48,116004.23,113795.59999999999
3162,U20818,256,-3669.079999999999,230,26,51082.82000000001,47413.740000000005
3163,U23171,256,774.0100000000118,228,28,108695.85000000003,109469.86000000004
3164,U14544,256,-5216.48000000001,236,20,94372.87999999999,89156.39999999998
3165,U8071,256,-47806.15,227,29,185304.47000000003,137498.32000000004
3166,U800118,256,22421.54999999999,145,111,172610.94999999998,195032.49999999997
3167,U11866,256,-18681.67000000001,242,14,112449.50999999997,93767.83999999995
3168,U840913,256,-7.330000000001604,144,112,34481.73,34474.4
3169,U31126,256,3972.4100000000035,227,29,135594.28000000006,139566.69000000006
3170,U20342,256,792.6800000000057,243,13,52369.57,53162.25000000001
3171,U40145,256,26478.12999999994,224,32,379681.17999999993,406159.3099999999
3172,U16611,256,-12239.949999999912,225,31,1887013.0,1874773.05
3173,U42047,255,19723.460000000043,244,11,7437.390000000011,27160.850000000053
3174,U28735,255,-25365.64,221,34,597676.6600000001,572311.0200000001
3175,U15181,255,-6060.959999999998,221,34,98418.08000000002,92357.12000000002
3176,U25123,255,1509.0600000000006,226,29,90995.1,92504.16
3177,U32327,255,-1916.6299999999999,232,23,26459.879999999994,24543.249999999993
3178,U37897,255,-5483.529999999999,244,11,44769.59000000002,39286.06000000002
3179,U25023,255,4642.119999999995,229,26,129413.65999999999,134055.77999999997
3180,U16240,255,-3447.179999999979,237,18,40448.50999999998,37001.33
3181,U42008,255,40130.74999999996,237,18,279490.4100000001,319621.16000000003
3182,U16843,255,9487.430000000031,200,55,96426.77000000002,105914.20000000006
3183,U41278,255,67926.04000000001,240,15,65891.11000000002,133817.15000000002
3184,U13419,255,-18101.240000000005,217,38,568846.8500000003,550745.6100000003
3185,U26290,255,-6952.549999999995,227,28,40412.26999999999,33459.719999999994
3186,U41343,255,6381.860000000007,224,31,53012.320000000014,59394.18000000002
3187,U22679,255,-20287.030000000006,151,104,330718.02999999997,310430.99999999994
3188,U22580,255,45916.05000000005,243,12,108083.78,153999.83000000005
3189,U29241,255,-24229.66000000001,205,50,262202.69999999995,237973.03999999995
3190,U8781,255,-23483.61,205,50,1670225.21,1646741.5999999999
3191,U13743,255,-16666.220000000263,212,43,6575568.14,6558901.919999999
3192,U25856,255,2409.330000000027,236,19,762618.1000000001,765027.4300000002
3193,U12888,255,81373.31999999998,216,39,800899.8400000001,882273.16
3194,U39514,255,-9891.119999999997,163,92,130691.94999999998,120800.82999999999
3195,U15177,255,-23851.820000000007,247,8,82433.03000000001,58581.21000000001
3196,U31293,255,11933.05,192,63,187723.65000000005,199656.70000000004
3197,U29037,255,36662.39999999997,182,73,671206.4,707868.8
3198,U14152,255,272758.12000000005,237,18,269250.56,542008.68
3199,U24982,255,-11517.419999999995,234,21,70277.11,58759.69
3200,U981419,255,-493.63999999999214,145,110,306508.14,306014.5
3201,U34642,255,-21927.389999999996,229,26,105255.77000000005,83328.38000000005
3202,U26561,255,10726.269999999975,202,53,468492.38999999966,479218.6599999996
3203,U38988,255,-1616.0500000000131,204,51,481811.0100000002,480194.9600000002
3204,U35716,255,-661.0099999999883,159,96,102571.63999999998,101910.62999999999
3205,U34546,255,31402.979999999905,227,28,484377.6599999999,515780.63999999984
3206,U27798,255,4170321.940000001,219,36,1458145.4200000004,5628467.360000001
3207,U20705,255,12388.109999999995,206,49,196455.05000000008,208843.16000000006
3208,U21513,255,1797.420000000001,235,20,94444.01000000004,96241.43000000004
3209,U17183,255,-13770.530000000012,214,41,346992.7200000001,333222.19000000006
3210,U33960,255,-23798.91999999994,169,86,148050.96000000008,124252.04000000014
3211,U10428,255,5853.420000000079,142,113,3077189.36,3083042.78
3212,U675597,255,-619.1200000000001,163,92,35784.28999999999,35165.16999999999
3213,U17348,255,-17451.91999999992,225,30,769454.4600000002,752002.5400000003
3214,U9133,254,-8133.719999999999,225,29,56975.04000000001,48841.32000000001
3215,U34012,254,-4416.230000000001,181,73,193406.43,188990.19999999998
3216,U15991,254,-2419.7599999999074,213,41,797607.5,795187.7400000001
3217,U18704,254,-52007.98,190,64,1556344.78,1504336.8
3218,U31335,254,-26996.780000000006,236,18,82481.53999999998,55484.75999999997
3219,U36294,254,353.5799999999999,231,23,54045.93000000001,54399.51000000001
3220,U8894,254,4665.900000000009,232,22,140972.32999999996,145638.22999999998
3221,U29983,254,159902.7600000002,155,99,120158318.24999999,120318221.00999999
3222,U30399,254,16781.160000000003,238,16,42498.47999999999,59279.63999999999
3223,U40234,254,-21729.849999999988,245,9,51821.710000000014,30091.860000000026
3224,U1081998,254,-26.63000000000124,179,75,14091.13999999999,14064.50999999999
3225,U23237,254,-18781.079999999864,237,17,3139168.67,3120387.59
3226,U37102,254,11940.56999999992,193,61,593667.0000000001,605607.5700000001
3227,U31935,254,1671.5600000000002,237,17,23207.26,24878.82
3228,U1095126,254,1675.1700000000098,158,96,54141.329999999994,55816.50000000001
3229,U37194,254,-11873.940000000004,213,41,82404.8,70530.86
3230,U10493,254,-30697.78,219,35,159861.30999999997,129163.52999999997
3231,U11254,254,-4300.330000000016,229,25,508288.14,503987.81
3232,U32302,254,-82476.64999999995,193,61,589678.3300000001,507201.6800000001
3233,U16464,254,-41378.61999999998,220,34,1086753.6199999999,1045374.9999999999
3234,U35995,254,4228.230000000009,241,13,53068.61999999999,57296.85
3235,U17492,254,3283.0900000000547,132,122,1017158.9400000001,1020442.0300000001
3236,U35085,254,-7688.579999999993,192,62,180547.69999999998,172859.12
3237,U28263,254,4246.800000000068,225,29,276298.5399999999,280545.33999999997
3238,U28896,254,-49779.52999999999,240,14,164100.62000000005,114321.09000000005
3239,U10424,254,2295266.06,223,31,1643908.56,3939174.62
3240,U12421,254,-1048259.5700000001,218,36,1139231.25,90971.67999999993
3241,U746408,254,-3678.749999999999,179,75,111731.41000000002,108052.66000000002
3242,U23431,254,-77015.38999999996,220,34,1885759.37,1808743.9800000002
3243,U12303,254,39990.069999999985,214,40,523620.0699999997,563610.1399999997
3244,U12540,254,12697.360000000237,220,34,1869524.8899999997,1882222.25
3245,U34198,254,445973.6399999999,191,63,1679828.0800000003,2125801.72
3246,U41319,254,195739.3300000001,236,18,44631.960000000036,240371.29000000015
3247,U28044,254,-3446.2099999999987,219,35,47105.31,43659.1
3248,U21215,254,213393.30999999982,204,50,2666480.91,2879874.2199999997
3249,U41460,254,-13663.49,234,20,150125.43999999997,136461.94999999998
3250,U23338,254,251.78000000002794,195,59,5823764.73,5824016.510000001
3251,U20222,254,-57447.56999999999,229,25,204428.1199999999,146980.54999999993
3252,U27135,254,39097.83000000004,192,62,1065998.3499999999,1105096.18
3253,U35510,253,11919.21999999999,175,78,375578.02000000014,387497.2400000001
3254,U14477,253,3132.709999999958,206,47,822645.46,825778.1699999999
3255,U9297,253,-61305.300000000025,231,22,98706.52000000005,37401.22000000002
3256,U22123,253,-49053.569999999985,205,48,1718227.8999999994,1669174.3299999994
3257,U14610,253,-1484.8699999999399,214,39,611812.9199999999,610328.0499999999
3258,U36647,253,16752.969999999994,241,12,71065.13999999998,87818.10999999999
3259,U35816,253,489.39999999999463,201,52,226875.70999999996,227365.10999999996
3260,U41887,253,-32404.62,240,13,42644.670000000035,10240.050000000036
3261,U23509,253,-1061.7099999999937,230,23,51552.260000000024,50490.55000000003
3262,U15146,253,-417726.25999999983,229,24,960781.7199999999,543055.46
3263,U11362,253,-107564.2,246,7,166334.3,58770.09999999999
3264,U33242,253,-101600.72999999997,226,27,208292.23999999996,106691.51
3265,U23931,253,-1187033.9199999997,173,80,2309069.5000000014,1122035.5800000017
3266,U23906,253,-34867.17000000007,230,23,1147886.5499999996,1113019.3799999994
3267,U16795,253,-35057.16,245,8,41496.180000000015,6439.020000000011
3268,U42364,253,-93491.83999999997,238,15,176607.19999999992,83115.35999999996
3269,U33898,253,2105.769999999997,138,115,112354.95999999996,114460.72999999995
3270,U16253,253,-40423.649999999965,187,66,625744.1100000001,585320.4600000002
3271,U31435,253,164647.02000000002,241,12,245265.06,409912.08
3272,U8268,253,-1650.4299999999819,206,47,654691.5400000002,653041.1100000002
3273,U15334,253,45463.28000000001,197,56,609640.31,655103.5900000001
3274,U26760,253,29283.280000000002,212,41,196179.21000000002,225462.49000000002
3275,U37296,253,-5200.600000000007,189,64,463908.6600000001,458708.06000000006
3276,U37491,253,2848.04,236,17,21408.640000000003,24256.680000000004
3277,U14896,253,2723.95999999999,218,35,58486.45999999997,61210.41999999996
3278,U23888,253,23219.510000000002,242,11,86152.62000000001,109372.13
3279,U16832,253,-787406.029999999,204,49,24977275.080000006,24189869.05000001
3280,U11981,253,12130.710000000021,240,13,646733.5800000001,658864.29
3281,U27791,253,-14177.970000000005,239,14,124993.42,110815.45
3282,U33018,252,68090.90000000001,173,79,496741.37000000005,564832.27
3283,U14437,252,-25672.900000000012,221,31,512364.57,486691.67
3284,U40208,252,-720815.4200000003,215,37,4147675.7400000007,3426860.3200000003
3285,U18490,252,372710.26,184,68,3456202.23,3828912.49
3286,U16778,252,47479.159999999996,174,78,187582.23,235061.39
3287,U15087,252,-155969.21999999997,229,23,1001475.97,845506.75
3288,U16133,252,-28621.480000000003,210,42,1241887.25,1213265.77
3289,U17867,252,-13499.77000000002,232,20,100138.92999999996,86639.15999999995
3290,U40155,252,-3879.4300000000267,219,33,1343330.8099999998,1339451.38
3291,U29271,252,-1368.8200000000052,198,54,213952.29,212583.47
3292,U11639,252,1022.8299999999984,218,34,192886.7599999998,193909.5899999998
3293,U11215,252,-75694.01999999999,223,29,732530.1,656836.08
3294,U38633,252,8315.960000000003,219,33,140837.3,149153.25999999998
3295,U31776,252,948.6600000000071,177,75,354251.5,355200.16000000003
3296,U20300,252,-63830.55000000003,246,6,79544.34000000004,15713.790000000008
3297,U14267,252,60509.08999999998,219,33,260147.65000000002,320656.74
3298,U42523,252,-9159.759999999982,183,69,512950.57000000007,503790.81000000006
3299,U34472,252,5393.130000000002,189,63,141160.6,146553.73
3300,U14161,252,-1155.4499999999857,238,14,48719.0399999998,47563.589999999815
3301,U9985,252,-4249.420000000015,226,26,160465.6899999997,156216.2699999997
3302,U18604,252,41799.35000000002,224,28,124456.33000000005,166255.68000000005
3303,U33874,252,-8749.58,212,40,81102.42999999998,72352.84999999998
3304,U34610,252,-420707.5299999999,225,27,1432055.7300000011,1011348.2000000012
3305,U11949,252,1584.239999999897,209,43,707962.7299999999,709546.9699999997
3306,U27481,252,-15866.940000000022,234,18,345876.5599999999,330009.6199999999
3307,U20668,252,-103248.89000000028,177,75,7775562.4,7672313.51
3308,U11982,252,1252.1700000000128,193,59,317048.48,318300.65
3309,U39536,252,66781.56000000007,187,65,225643.15,292424.7100000001
3310,U13956,252,30157.660000000025,230,22,745416.25,775573.91
3311,U42141,252,-21510.94999999999,238,14,53177.48999999998,31666.539999999994
3312,U38252,252,5516.719999999987,189,63,489703.74000000005,495220.46
3313,U25986,252,51274.77999999991,239,13,1067684.83,1118959.6099999999
3314,U16252,252,-21501.180000000073,226,26,469813.71000000054,448312.5300000005
3315,U39335,252,-229452.6,224,28,610244.7300000002,380792.13000000024
3316,U8717,251,572.6199999999815,220,31,30345.909999999993,30918.529999999973
3317,U16243,251,15985.360000000011,237,14,93554.62000000001,109539.98000000003
3318,U38910,251,40561.869999999995,218,33,2056669.5,2097231.37
3319,U1383122,251,3050.999999999999,159,92,80080.37000000002,83131.37000000002
3320,U31536,251,-6269.269999999996,226,25,101610.04,95340.77
3321,U17897,251,-11546.220000000016,203,48,270287.19000000006,258740.97000000003
3322,U22987,251,73685.80999999998,208,43,51503.91,125189.71999999999
3323,U40067,251,4461.420000000104,174,77,1064522.92,1068984.34
3324,U32146,251,-106548.41999999998,235,16,426055.71,319507.29000000004
3325,U893441,251,509.7199999999998,188,63,52932.49000000001,53442.210000000014
3326,U10320,251,-2508.500000000017,240,11,215920.16999999993,213411.6699999999
3327,U8021,251,-6385.099999999988,212,39,488593.13000000006,482208.0300000001
3328,U26949,251,6226.709999999921,218,33,222285.47999999998,228512.18999999992
3329,U29621,251,864.7199999999985,237,14,24176.81,25041.53
3330,U1289856,251,105.45999999999992,129,122,8209.689999999999,8315.149999999998
3331,U21577,251,-75491.77999999994,191,60,1775672.6400000001,1700180.86
3332,U9362,251,-3384.5499999999997,244,7,50294.900000000016,46910.35000000001
3333,U26839,251,-185.55999999998522,236,15,29824.13999999999,29638.58
3334,U12385,251,-43373.31000000026,227,24,1281093.3299999998,1237720.0199999996
3335,U11012,251,-82094.52999999996,174,77,662679.0600000002,580584.5300000003
3336,U8527,251,-2439.140000000003,158,93,492392.64,489953.5
3337,U1283206,251,-11298.270000000004,232,19,32087.569999999992,20789.29999999999
3338,U42772,251,36129.7,187,64,266179.94,302309.64
3339,U39860,251,58173.92000000001,217,34,246681.22000000047,304855.1400000005
3340,U17420,251,-5876.089999999997,230,21,95299.86,89423.77
3341,U21799,251,35914.55000000004,180,71,752764.0700000002,788678.6200000002
3342,U23297,251,-3731.960000000014,221,30,970987.9200000003,967255.9600000003
3343,U37559,251,-23551.199999999986,236,15,152595.17999999996,129043.97999999998
3344,U21242,251,-3371.54999999999,220,31,238964.18999999992,235592.63999999993
3345,U32775,251,-8739.419999999987,223,28,230067.57,221328.15000000002
3346,U21465,251,-1261.9800000000505,126,125,494376.9099999998,493114.92999999976
3347,U37593,251,-40796.17999999999,242,9,74458.31999999999,33662.14
3348,U9840,251,-652.6699999999837,142,109,711070.33,710417.6599999999
3349,U30836,251,12468.969999999996,152,99,1012338.6200000002,1024807.5900000002
3350,U16757,251,-84881.49,228,23,266340.8100000001,181459.32000000012
3351,U25908,251,21039.509999999802,198,53,721352.4900000001,742391.9999999999
3352,U40464,251,-3496.489999999994,235,16,127610.69999999995,124114.20999999996
3353,U20819,250,5028.120000000083,223,27,1197351.8399999999,1202379.96
3354,U42302,250,-2354.3000000000043,238,12,50439.960000000014,48085.66000000001
3355,U22873,250,-55381.52999999995,224,26,423574.26999999996,368192.74
3356,U24254,250,7267.020000000003,193,57,51326.16999999998,58593.18999999998
3357,U11407,250,-1622.729999999846,210,40,850445.7700000001,848823.0400000003
3358,U41001,250,-1798.6299999999997,212,38,38299.02,36500.39
3359,U19807,250,9269.849999999991,182,68,272113.23000000004,281383.08
3360,U31280,250,-13938.479999999998,239,11,145638.67,131700.19
3361,U23661,250,-33321.50999999997,219,31,129655.23000000001,96333.72000000003
3362,U16184,250,-27561.240000000034,178,72,1185828.8,1158267.56
3363,U16075,250,-8453.810000000005,218,32,80928.29999999999,72474.48999999999
3364,U34706,250,-1776.5099999999998,233,17,23034.159999999996,21257.649999999998
3365,U20919,250,-41176.700000000004,235,15,67377.68000000001,26200.980000000003
3366,U16516,250,10348.109999999993,225,25,226350.31000000006,236698.42000000004
3367,U15487,250,-96219.14999999997,244,6,326636.3600000001,230417.21000000014
3368,U12727,250,-23771.620000000003,223,27,82888.08000000005,59116.46000000004
3369,U28619,250,666.300000000002,213,37,131648.62999999995,132314.92999999993
3370,U25352,250,-3234.390000000001,196,54,18419.760000000002,15185.37
3371,U11172,250,-616320.16,218,32,5692009.550000002,5075689.3900000015
3372,U15064,250,-96873.02000000008,210,40,1155308.6500000001,1058435.6300000001
3373,U42002,250,-871.229999999999,202,48,31207.49999999999,30336.26999999999
3374,U19844,250,1088.12999999995,60,190,820924.0,822012.13
3375,U33534,250,-22286.689999999988,235,15,229409.86999999997,207123.18
3376,U43150,250,-1125.5900000000008,226,24,15195.91,14070.32
3377,U18353,250,1588.0599999999804,183,67,399600.2299999999,401188.2899999999
3378,U12193,250,-107952.23000000001,202,48,1269471.02,1161518.79
3379,U31412,250,-5973.989999999991,222,28,534321.5900000002,528347.6000000002
3380,U21232,250,-1467.6900000000096,222,28,438829.67,437361.98
3381,U18822,250,31588.120000000075,174,76,5547733.169999999,5579321.289999999
3382,U42660,250,-5098.819999999972,208,42,589431.99,584333.17
3383,U39170,250,-11967.439999999991,227,23,146822.68000000002,134855.24000000002
3384,U14832,250,-30485.05000000001,217,33,546654.1100000001,516169.0600000001
3385,U26500,249,8078.379999999961,219,30,890421.4000000001,898499.7800000001
3386,U10176,249,-7385.750000000008,234,15,59915.16000000002,52529.41000000001
3387,U12401,249,83850.74,214,35,176787.10000000006,260637.84000000008
3388,U26119,249,37411.75999999997,218,31,196199.96999999986,233611.72999999984
3389,U17170,249,33804.719999999994,238,11,102242.22,136046.94
3390,U11675,249,-15703.129999999997,223,26,119032.68999999999,103329.56
3391,U15484,249,11843.78000000005,178,71,694002.7900000003,705846.5700000003
3392,U25519,249,-96739.66999999993,169,80,741163.5,644423.8300000001
3393,U33129,249,-3106.2800000000007,240,9,24107.05000000001,21000.77000000001
3394,U14206,249,-3819.8700000000076,225,24,102289.88999999998,98470.01999999997
3395,U21691,249,-66172.07999999989,211,38,425894.47,359722.3900000001
3396,U26763,249,14483.989999999974,175,74,671010.6399999998,685494.6299999998
3397,U23281,249,-29814.769999999873,190,59,2220504.5000000005,2190689.7300000004
3398,U10210,249,40697.60999999987,228,21,631343.9700000002,672041.5800000001
3399,U25412,249,11223.18,155,94,458255.66,469478.83999999997
3400,U972887,249,-23932.45000000001,175,74,389949.33,366016.88
3401,U34911,249,7059.569999999992,231,18,136131.32,143190.89
3402,U11217,249,-21069.02999999999,169,80,130669.25000000001,109600.22000000003
3403,U37659,249,-18880.769999999997,239,10,52686.13999999999,33805.369999999995
3404,U26228,249,-7228.089999999995,227,22,169074.35999999993,161846.26999999993
3405,U43296,249,-18189.420000000013,217,32,263887.31000000006,245697.89000000004
3406,U16720,249,5763.0600000000295,194,55,579778.1000000003,585541.1600000004
3407,U24891,249,-9973.949999999993,220,29,165688.25999999998,155714.31
3408,U19706,249,15716.130000000005,234,15,36549.44999999996,52265.579999999965
3409,U21336,249,1853.6299999999765,204,45,122339.45000000003,124193.08
3410,U21948,249,1085117.8399999999,217,32,553585.1799999998,1638703.0199999996
3411,U23516,249,-28587.56000000004,220,29,155861.71999999997,127274.15999999993
3412,U12061,249,-90211.96,231,18,249692.89,159480.93
3413,U14553,249,-62614.440000000024,201,48,401827.76000000007,339213.32000000007
3414,U9328,249,65743.45999999999,214,35,234147.51,299890.97
3415,U15352,249,191.41999999999427,224,25,61682.10000000003,61873.52000000002
3416,U39143,249,13529.110000000004,206,43,225133.91999999998,238663.03
3417,U39192,249,29532.50000000001,229,20,71084.89000000001,100617.39000000003
3418,U15097,249,9178.050000000001,224,25,160116.84999999998,169294.89999999997
3419,U15152,249,-322467.72999999975,236,13,493841.3199999997,171373.58999999997
3420,U37515,249,-14078.569999999998,226,23,127934.87000000002,113856.30000000003
3421,U33297,249,-1227.7300000000014,229,20,20329.379999999997,19101.649999999994
3422,U23379,249,513.2599999999875,119,130,659658.41,660171.67
3423,U17558,249,17717.879999999983,186,63,1426710.4199999997,1444428.2999999996
3424,U36812,249,22502.350000000006,203,46,94066.64,116568.99
3425,U21020,249,73823.62999999998,225,24,236349.87999999986,310173.50999999983
3426,U13593,249,-44432.18000000003,225,24,505993.90999999974,461561.7299999997
3427,U11725,249,1546.580000000009,218,31,290668.10000000003,292214.68000000005
3428,U38820,249,-40258.59,212,37,607684.2800000005,567425.6900000005
3429,U13676,249,-17329.84000000001,220,29,121827.37999999999,104497.53999999998
3430,U37064,249,53622.25999999981,223,26,1669519.0599999998,1723141.3199999996
3431,U39498,249,-14985.919999999998,241,8,29866.600000000002,14880.680000000004
3432,U30666,249,711.7900000000002,234,15,9501.810000000001,10213.600000000002
3433,U9329,249,1018.4200000000122,176,73,316774.38000000006,317792.80000000005
3434,U12775,249,-3374.0099999999884,203,46,383667.60000000003,380293.59
3435,U28075,249,-6919.2899999999945,126,123,41030.42999999999,34111.14
3436,U21638,248,57109.10000000001,123,125,1426419.07,1483528.1700000002
3437,U40635,248,-2548.0299999999734,194,54,672422.1,669874.07
3438,U23668,248,290.9000000000026,197,51,174708.47999999995,174999.37999999995
3439,U34920,248,265621.8699999999,231,17,1357650.8400000003,1623272.7100000002
3440,U10426,248,2785.7499999999945,228,20,48697.46000000001,51483.21
3441,U36782,248,-13151.899999999927,145,103,1826148.1599999997,1812996.2599999998
3442,U14034,248,-263267.25999999966,212,36,579474.6699999998,316207.41000000015
3443,U33356,248,-12333.66,240,8,123590.84999999998,111257.18999999997
3444,U38068,248,-2149.209999999816,145,103,985932.67,983783.4600000002
3445,U26884,248,-9105.029999999993,211,37,226638.46999999994,217533.43999999994
3446,U21164,248,480274.4300000006,192,56,820116.7600000001,1300391.1900000006
3447,U29308,248,24738.839999999997,198,50,154047.13000000047,178785.97000000047
3448,U8218,248,143943.62000000002,219,29,306909.37,450852.99
3449,U36081,248,-4494.419999999972,201,47,509871.5800000001,505377.1600000001
3450,U32052,248,-6751.390000000004,178,70,133454.82000000004,126703.43000000004
3451,U25641,248,-24361.530000000002,237,11,208795.53999999986,184434.00999999986
3452,U8033,248,-3656.2399999999816,239,9,42609.80999999989,38953.569999999905
3453,U30240,248,23231.110000000015,224,24,148393.37999999998,171624.49
3454,U17043,248,185801.03999999753,203,45,32028879.550000004,32214680.590000004
3455,U20262,248,81824.53000000009,226,22,1477079.16,1558903.69
3456,U11271,248,-451.2600000000536,203,45,405271.52999999997,404820.2699999999
3457,U14568,248,317.18000000000563,222,26,31943.06000000001,32260.240000000013
3458,U29759,248,132327.30000000005,204,44,1619344.2999999996,1751671.5999999996
3459,U33899,248,-11037.960000000006,216,32,189446.53999999998,178408.57999999996
3460,U31673,248,-1698730.2100000014,210,38,12774850.680000007,11076120.470000006
3461,U21703,248,-71438.88,227,21,226225.05000000002,154786.17
3462,U13191,248,42263.40999999999,220,28,120085.69999999997,162349.10999999996
3463,U13151,248,-151137.56,223,25,734658.2500000001,583520.6900000002
3464,U15984,248,496358.68999999936,158,90,18330048.51,18826407.2
3465,U35795,248,6616.46999999994,195,53,1552675.4500000004,1559291.9200000004
3466,U28111,248,4998.9800000000105,204,44,215191.31,220190.29
3467,U8750,248,-67399.38000000006,217,31,2191407.0,2124007.62
3468,U27443,248,-12896.549999999976,237,11,33177.439999999966,20280.889999999992
3469,U15201,247,-9319.059999999998,223,24,62597.11000000001,53278.05000000001
3470,U40946,247,-15521.119999999995,226,21,104784.01999999999,89262.9
3471,U30406,247,21410.100000000035,173,74,1630226.59,1651636.6900000002
3472,U13234,247,-1978217.3800000001,230,17,2131990.29,153772.90999999992
3473,U10859,247,3641.420000000003,229,18,215537.9999999997,219179.41999999972
3474,U14577,247,335.3900000000006,226,21,322577.43000000017,322912.8200000002
3475,U34907,247,-5705.220000000003,207,40,20138.239999999987,14433.019999999984
3476,U18954,247,74426.47,172,75,2290753.4899999993,2365179.9599999995
3477,U13116,247,-298637.80000000005,228,19,563356.95,264719.1499999999
3478,U25326,247,-6985.410000000001,227,20,56679.39000000001,49693.98
3479,U13035,247,-40757.26,205,42,1388519.4099999995,1347762.1499999994
3480,U39583,247,-21308.0,218,29,209209.34000000005,187901.34000000005
3481,U9487,247,16336.540000000015,209,38,496992.0299999999,513328.56999999995
3482,U40209,247,3389.6699999999164,197,50,1753434.3800000001,1756824.05
3483,U25904,247,48987.710000000065,29,218,261073.63,310061.3400000001
3484,U38629,247,6563.769999999982,210,37,351773.43000000005,358337.2
3485,U34234,247,-4591.899999999961,225,22,435012.3,430420.4
3486,U20365,247,1292.550000000032,140,107,1156598.8000000003,1157891.3500000003
3487,U35119,247,879.6799999999984,234,13,15515.009999999997,16394.689999999995
3488,U38946,247,-239713.9400000002,160,87,3723038.820000001,3483324.880000001
3489,U29257,247,12421.980000000023,234,13,112438.17,124860.15000000002
3490,U968730,247,36881.88,112,135,131186.49,168068.37
3491,U14328,247,22680.87999999981,191,56,1337609.7099999997,1360290.5899999996
3492,U15724,247,-6557.130000000007,228,19,131196.38000000003,124639.25000000003
3493,U10656,247,-5637.849999999993,213,34,1072012.4,1066374.5499999998
3494,U29025,247,-12056.500000000015,214,33,521627.83,509571.33
3495,U13456,247,371236.2600000002,236,11,208036.77999999985,579273.04
3496,U16822,247,43738.429999999986,230,17,63772.27000000002,107510.70000000001
3497,U14262,247,340576.58000000013,146,101,593090.7400000001,933667.3200000003
3498,U41764,247,74360.87,208,39,224037.36,298398.23
3499,U28167,247,-135982.78000000003,232,15,153335.22999999998,17352.449999999953
3500,U40140,247,105643.03000000006,188,59,1504445.9699999995,1610088.9999999995
3501,U17572,247,7651.94,216,31,73630.50000000001,81282.44000000002
3502,U27532,247,390.86999999999716,164,83,488658.22,489049.08999999997
3503,U9593,247,13286.019999999973,163,84,793124.1900000003,806410.2100000003
3504,U15266,247,9905.25,199,48,93517.42,103422.67
3505,U20771,247,-11122.559999999994,220,27,140865.77000000005,129743.21000000005
3506,U31535,247,25143.40999999985,174,73,2006182.5,2031325.91
3507,U26626,246,7714.479999999988,196,50,471530.03,479244.51
3508,U948930,246,0.6799999999993815,126,120,29070.25,29070.93
3509,U34474,246,3268.960000000009,143,103,362809.08,366078.04000000004
3510,U12103,246,-20446.900000000005,206,40,612115.4499999997,591668.5499999997
3511,U34337,246,9688.92999999999,192,54,445652.74999999994,455341.67999999993
3512,U16743,246,142550.08000000002,205,41,952924.3900000002,1095474.4700000002
3513,U20381,246,-79648.14999999998,208,38,197907.6,118259.45000000003
3514,U8876,246,-7432.5400000000445,191,55,571894.7899999998,564462.2499999998
3515,U43017,246,11404.140000000025,179,67,732409.3800000001,743813.5200000001
3516,U22434,246,45974.97000000001,232,14,31753.429999999993,77728.4
3517,U32191,246,-310145.1900000002,220,26,805171.7700000007,495026.58000000054
3518,U16563,246,-36168.290000000066,221,25,1290631.05,1254462.76
3519,U31196,246,-315660.72999999975,224,22,3118904.8400000003,2803244.1100000003
3520,U34167,246,408.0400000000227,201,45,779746.69,780154.73
3521,U13056,246,-47437.28999999995,215,31,698620.7300000001,651183.4400000002
3522,U31455,246,-51858.84999999996,220,26,128054.85000000005,76196.00000000009
3523,U15977,246,-48765.42000000003,201,45,325201.7999999999,276436.37999999983
3524,U10147,246,21788.87000000004,220,26,366469.19999999995,388258.07
3525,U27982,246,2087.580000000001,214,32,262463.0399999999,264550.61999999994
3526,U36850,246,-49852.74,208,38,631989.6399999999,582136.8999999999
3527,U9572,246,253615.65000000014,138,108,1538445.9900000005,1792061.6400000006
3528,U27402,246,-4825.710000000192,165,81,1718295.8299999996,1713470.1199999994
3529,U38765,246,20385.58999999999,222,24,242594.69999999987,262980.28999999986
3530,U23260,246,-5025.419999999911,162,84,2010776.9,2005751.48
3531,U37768,246,-4370.469999999997,234,12,51054.87000000001,46684.400000000016
3532,U8905,246,-8716.220000000014,207,39,119391.40000000001,110675.18
3533,U38550,246,-1274.0500000000113,239,7,265356.79999999993,264082.74999999994
3534,U15808,246,-262488.32,231,15,538938.3099999998,276449.9899999998
3535,U25089,246,9678.429999999578,160,86,1399831.840000001,1409510.2700000005
3536,U43501,246,2411.750000000009,219,27,182859.27999999997,185271.02999999997
3537,U20194,246,-31449.370000000003,206,40,117351.61000000003,85902.24000000002
3538,U31705,246,-3407.30000000001,212,34,109738.06000000001,106330.76000000001
3539,U9846,246,961.4300000000076,191,55,261602.63000000003,262564.06000000006
3540,U18006,246,7787.7000000000035,207,39,746511.2000000004,754298.9000000004
3541,U17983,246,-656.29,237,9,13648.029999999995,12991.739999999994
3542,U28763,245,4163.450000000004,225,20,42574.440000000024,46737.89000000003
3543,U12282,245,15907.710000000028,155,90,900221.45,916129.16
3544,U12612,245,16130.679999999997,239,6,28943.010000000002,45073.69
3545,U36465,245,13659.390000000001,208,37,16610.09,30269.480000000003
3546,U26919,245,52689.379999999976,222,23,209454.14,262143.52
3547,U14085,245,-11646.910000000018,183,62,645854.1000000001,634207.1900000001
3548,U17677,245,-2841.100000000007,229,16,102186.69000000009,99345.59000000008
3549,U32889,245,-2546.3399999999974,227,18,28764.99,26218.650000000005
3550,U30229,245,-7006.719999999979,169,76,408627.94000000006,401621.2200000001
3551,U32015,245,-21084.589999999975,219,26,347446.9700000001,326362.3800000001
3552,U15139,245,854.0199999999581,215,30,1213283.11,1214137.1300000001
3553,U41003,245,-22962.589999999876,234,11,551434.5300000001,528471.9400000003
3554,U37090,245,-10584.920000000015,222,23,98935.47999999998,88350.55999999997
3555,U14970,245,-118695.10999999997,227,18,405343.26000000007,286648.1500000001
3556,U35710,245,93.05000000000291,226,19,328108.29999999993,328201.3499999999
3557,U29314,245,-45.64000000093091,221,24,9645711.490000004,9645665.850000003
3558,U8389,245,-26765.12999999995,186,59,772715.7799999996,745950.6499999996
3559,U1185381,245,-19.960000000002765,167,78,223561.01,223541.05000000002
3560,U18373,245,-70597.09,230,15,155594.27000000002,84997.18000000002
3561,U23460,245,-78828.17,228,17,210513.29,131685.12
3562,U1021077,245,-879.52,198,47,76945.34000000001,76065.82
3563,U14436,245,-7296.310000000007,218,27,97045.59999999999,89749.28999999998
3564,U37036,245,-91256.03999999995,202,43,804364.13,713108.0900000001
3565,U1172816,245,10.72000000000857,128,117,251561.75000000006,251572.47000000006
3566,U31969,245,3111.0700000000397,124,121,977798.8300000001,980909.9000000001
3567,U32690,245,-99199.63000000018,194,51,3631851.8099999996,3532652.1799999992
3568,U39106,245,7189.450000000035,188,57,1975773.2499999998,1982962.6999999997
3569,U12440,245,-21130.68000000006,225,20,2098896.12,2077765.44
3570,U15691,245,-447575.39,221,24,558598.97,111023.57999999996
3571,U15834,245,-170410.91,180,65,1734578.3,1564167.3900000001
3572,U30850,245,-38089.05000000002,165,80,882359.69,844270.6399999999
3573,U12983,245,88970.10999999987,199,46,1101299.9900000002,1190270.1
3574,U16302,245,73554.26999999997,175,70,1554847.05,1628401.32
3575,U39943,245,3177.010000000003,205,40,106963.41,110140.42000000001
3576,U20872,245,56689.30999999997,225,20,998385.49,1055074.8
3577,U34978,245,-2148.819999999987,201,44,199720.50999999998,197571.69
3578,U34673,245,-36469.78999999999,232,13,355713.15999999986,319243.3699999999
3579,U17792,245,-5122.910000000005,199,46,135774.96,130652.04999999999
3580,U25124,245,1135.999999999971,218,27,175905.82999999996,177041.82999999993
3581,U9038,245,-113259.33000000048,187,58,5731692.08,5618432.75
3582,U9232,245,-1149351.5000000002,237,8,2982190.5300000003,1832839.03
3583,U10673,244,21339.40999999998,177,67,335047.46,356386.87
3584,U18645,244,-51151.41999999999,223,21,329508.22000000003,278356.80000000005
3585,U16756,244,97626.67999999998,211,33,955478.26,1053104.94
3586,U742498,244,-3070.97,146,98,349184.32000000007,346113.3500000001
3587,U14424,244,-2755.5800000000168,221,23,280897.4899999999,278141.90999999986
3588,U16919,244,1993.7400000000032,226,18,81237.10999999999,83230.84999999999
3589,U14250,244,-5262.159999999997,224,20,77301.94000000002,72039.78000000001
3590,U11272,244,1684.0699999999729,216,28,213072.60000000068,214756.67000000065
3591,U32957,244,-3936.679999999996,173,71,64477.53000000003,60540.850000000035
3592,U31120,244,-576056.4799999997,207,37,1571864.72,995808.2400000002
3593,U39224,244,-122441.04000000002,209,35,1056908.92,934467.8799999999
3594,U29220,244,9862.269999999982,206,38,135256.33000000002,145118.6
3595,U27272,244,-4956.309999999987,216,28,399767.53,394811.22000000003
3596,U32067,244,3709.4400000000023,181,63,876947.51,880656.95
3597,U11346,244,-2759.330000000001,223,21,43160.689999999995,40401.35999999999
3598,U30011,244,213588.09999999998,201,43,538565.0299999998,752153.1299999998
3599,U19688,244,10673.539999999997,170,74,178722.55,189396.09
3600,U13239,244,-69696.88000000002,218,26,712862.3300000002,643165.4500000002
3601,U752482,244,-8177.869999999996,136,108,535638.7,527460.83
3602,U29792,244,84441.85000000005,234,10,217898.27,302340.12000000005
3603,U17354,244,432009.0,197,47,7316508.12,7748517.12
3604,U10623,244,-10196.330000000027,198,46,959565.8599999999,949369.5299999998
3605,U16444,244,-25943.37999999999,222,22,444838.35000000015,418894.97000000015
3606,U13150,244,-27283.089999999997,218,26,169395.06,142111.97
3607,U22393,244,49259.51999999996,226,18,409387.31,458646.82999999996
3608,U11464,244,2141.9500000000126,230,14,32819.90999999999,34961.86
3609,U23075,244,2494.5600000000018,229,15,81240.58999999988,83735.14999999988
3610,U41775,244,2133.8099999997094,205,39,2696467.3999999966,2698601.2099999962
3611,U25474,244,44754.56999999957,162,82,10834236.670000004,10878991.240000004
3612,U26350,244,-26079.640000000003,229,15,120091.42,94011.78
3613,U32650,244,77985.61999999963,215,29,4547912.279999999,4625897.8999999985
3614,U19882,244,17074.37,229,15,86057.3,103131.67
3615,U31707,244,69188.47000000006,192,52,342902.05000000005,412090.52000000014
3616,U33745,244,4640.109999999996,224,20,77265.50000000004,81905.61000000004
3617,U14472,243,-64695.16000000002,209,34,432499.98000000004,367804.82
3618,U21449,243,-33698.48,181,62,229948.35,196249.87
3619,U11280,243,82038.62,157,86,1469507.3200000003,1551545.9400000004
3620,U40549,243,20545.27,183,60,1856462.2199999997,1877007.4899999998
3621,U40493,243,-2465.7099999999964,235,8,24961.610000000015,22495.90000000002
3622,U21931,243,-6648.35,217,26,25343.849999999988,18695.499999999985
3623,U31949,243,-20605.16999999999,231,12,141836.87000000002,121231.70000000004
3624,U11756,243,-4715.5199999999895,184,59,234873.14000000007,230157.62000000008
3625,U29427,243,88623.22000000018,212,31,9550914.969999999,9639538.19
3626,U12662,243,-23000.399999999954,188,55,1057455.21,1034454.81
3627,U28361,243,71145.60999999999,208,35,178522.27,249667.87999999998
3628,U19072,243,-8912.600000000004,228,15,77739.61999999998,68827.01999999997
3629,U31824,243,182649.73000000024,208,35,1456282.749999998,1638932.4799999981
3630,U29513,243,-4137.979999999999,219,24,56459.59,52321.61
3631,U21361,243,2947224.8899999964,178,65,113766240.28999999,116713465.17999999
3632,U33956,243,-19798.119999999984,212,31,94544.37000000001,74746.25000000003
3633,U19042,243,7466.349999999948,206,37,994820.77,1002287.12
3634,U31005,243,-11764.820000000002,226,17,106454.34000000004,94689.52000000003
3635,U13311,243,32407.539999999997,193,50,2639231.079999999,2671638.619999999
3636,U40119,243,-21536.039999999997,222,21,116529.78000000001,94993.74000000002
3637,U11937,243,10068.100000000079,136,107,836021.82,846089.92
3638,U27142,243,-16950.019999999873,187,56,808515.3899999998,791565.3699999999
3639,U25547,243,3172.46,219,24,37137.600000000006,40310.060000000005
3640,U1207163,243,-249.07000000000048,135,108,34300.9,34051.83
3641,U23010,243,49258.21000000001,220,23,365589.9200000001,414848.1300000001
3642,U38884,243,-48189.76000000001,218,25,121756.07000000002,73566.31000000001
3643,U21763,243,-6091.660000000033,105,138,627944.0600000004,621852.4000000004
3644,U42465,243,-34521.12000000001,203,40,146799.6,112278.48
3645,U15740,243,-9758.14,208,35,36704.240000000005,26946.100000000006
3646,U22035,243,-42872.37000000002,171,72,2344920.26,2302047.8899999997
3647,U40099,243,-248893.16000000018,196,47,2567254.7599999984,2318361.599999998
3648,U29194,243,-200330.3099999999,220,23,342965.27999999997,142634.97000000006
3649,U27851,243,-833.7900000000373,174,69,1365448.1500000001,1364614.36
3650,U26040,243,-5496.949999999997,191,52,371067.73,365570.77999999997
3651,U16062,243,-362099.85999999975,231,12,1206018.870000001,843919.0100000013
3652,U43793,243,-256372.47999999995,218,25,602419.2700000001,346046.79000000015
3653,U20532,243,56772.580000000016,217,26,127142.79999999999,183915.38
3654,U25767,243,32716.449999999986,196,47,747559.31,780275.76
3655,U38877,242,-2226.509999999992,224,18,169907.98,167681.47000000003
3656,U11284,242,-714.1900000000023,230,12,105284.17,104569.98
3657,U43865,242,-31733.510000000017,231,11,138988.13999999998,107254.62999999998
3658,U10362,242,-31420.679999999982,234,8,65738.41000000005,34317.73000000007
3659,U43482,242,3642.1099999999924,226,16,272824.91000000003,276467.02
3660,U42218,242,-1551.62,234,8,14710.1,13158.48
3661,U12532,242,-23070.78999999995,236,6,303260.95999999996,280190.17000000004
3662,U1192278,242,-10815.980000000016,172,70,315742.79,304926.80999999994
3663,U8731,242,2363.55000000046,173,69,4830109.029999999,4832472.58
3664,U1207956,242,-4378.319999999984,159,83,67357.70999999998,62979.38999999999
3665,U32936,242,-7899.3299999999435,217,25,1776893.3699999996,1768994.0399999998
3666,U16301,242,-86626.96999999997,202,40,987576.99,900950.02
3667,U17319,242,27961.650000000012,202,40,339465.01999999984,367426.66999999987
3668,U24256,242,43160.75999999997,225,17,291467.81,334628.56999999995
3669,U20463,242,3437.699999999997,214,28,209097.32999999996,212535.02999999997
3670,U14255,242,20693.259999999995,226,16,728130.5899999999,748823.8499999999
3671,U19419,242,-127.11000000000024,239,3,3927.7400000000002,3800.63
3672,U9148,242,260.1200000000392,205,37,2000546.2800000012,2000806.4000000013
3673,U14791,242,-67113.83000000022,199,43,1324567.7600000002,1257453.93
3674,U14494,242,19598.520000000004,139,103,700558.4700000004,720156.9900000005
3675,U9782,242,138371.51,127,115,569885.14,708256.65
3676,U32603,242,1452.8499999999804,183,59,499730.36000000016,501183.21000000014
3677,U23222,242,-68782.3,228,14,232290.71000000002,163508.41000000003
3678,U19574,242,6252.379999999996,132,110,454917.12,461169.5
3679,U34418,242,-686.4800000000032,207,35,120071.85,119385.37
3680,U15766,242,95306.52000000002,189,53,928643.4500000001,1023949.9700000001
3681,U37923,242,2793.0700000000015,228,14,56933.999999999985,59727.069999999985
3682,U27226,242,-3926.620000000003,204,38,224047.67,220121.05000000002
3683,U41854,242,-2877.759999999951,209,33,765140.7400000001,762262.9800000002
3684,U23588,242,-46510.190000000024,197,45,231236.5599999999,184726.36999999988
3685,U32772,242,-4079.469999999991,205,37,169140.46000000002,165060.99000000002
3686,U9399,242,4081.479999999996,124,118,286341.82999999996,290423.30999999994
3687,U29129,242,-6641.240000000003,204,38,209658.62999999998,203017.38999999998
3688,U34830,242,33097.599999999984,206,36,278420.53,311518.13
3689,U8637,241,1681.169999999992,200,41,51779.00000000001,53460.17
3690,U42592,241,-7441.709999999996,208,33,123405.0099999999,115963.2999999999
3691,U32377,241,-92724.55000000002,161,80,1527983.1300000001,1435258.58
3692,U26711,241,384870.82999999996,222,19,617068.8899999999,1001939.7199999999
3693,U36216,241,-7870.52,234,7,46646.880000000005,38776.36
3694,U17840,241,-39918.53000000006,210,31,276166.54999999993,236248.01999999987
3695,U17468,241,-36077.52,170,71,596544.3700000001,560466.8500000001
3696,U38286,241,-428.699999999998,137,104,156930.66999999998,156501.96999999997
3697,U20309,241,38644.67,205,36,156483.78999999998,195128.45999999996
3698,U34479,241,-141281.47999999998,228,13,243665.64999999997,102384.16999999998
3699,U21309,241,-1139.8600000000006,183,58,115032.86000000002,113893.00000000001
3700,U11812,241,-118364.88999999994,182,59,1600731.8899999997,1482366.9999999998
3701,U32220,241,188719.78000000012,236,5,362054.28,550774.0600000002
3702,U27011,241,-8502.890000000021,214,27,707827.6700000003,699324.7800000003
3703,U18505,241,42668.779999999955,179,62,100592.86,143261.63999999996
3704,U42454,241,-12015.960000000005,203,38,504143.31000000006,492127.35000000003
3705,U35624,241,7533.839999999999,224,17,9067.899999999992,16601.73999999999
3706,U26847,241,6941.400000000002,176,65,21284.75,28226.15
3707,U33823,241,-1167.6799999999957,230,11,27276.960000000014,26109.280000000017
3708,U21628,241,-48212.15999999993,230,11,1229331.170000001,1181119.0100000012
3709,U40573,241,-4278.199999999959,206,35,1758822.4,1754544.2
3710,U22643,241,-40112.67999999994,203,38,343496.0500000001,303383.37000000017
3711,U15231,241,-17765.320000000003,222,19,248577.55000000002,230812.23
3712,U42988,241,-3688.749999999998,211,30,56459.27999999999,52770.52999999999
3713,U15967,241,-659.2699999999963,229,12,92969.68,92310.41
3714,U10963,241,-2199.219999999997,230,11,20827.74999999997,18628.529999999973
3715,U14747,241,12190.50999999997,165,76,242580.47999999995,254770.98999999993
3716,U1157796,241,-6586.789999999994,146,95,648155.0399999999,641568.2499999999
3717,U38476,241,-7928.02,234,7,30234.600000000002,22306.58
3718,U12996,241,3829.5200000000027,158,83,91661.04000000001,95490.56000000001
3719,U19234,241,129.92000000002963,230,11,174146.35000000006,174276.2700000001
3720,U17034,241,55381.39999999993,195,46,3766326.7599999974,3821708.1599999974
3721,U17311,241,2783.4399999999996,222,19,75925.41000000005,78708.85000000005
3722,U18314,241,-6100.60999999987,203,38,2667001.55,2660900.94
3723,U32113,241,11330.260000000007,198,43,169012.87,180343.13
3724,U38485,241,-65932.49000000002,219,22,520239.70999999996,454307.22
3725,U25399,241,-789.3399999999638,182,59,160707.97,159918.63000000003
3726,U23126,241,-26401.979999999992,202,39,203331.33999999988,176929.3599999999
3727,U43768,241,5872.9200000002775,167,74,17611140.92000001,17617013.84000001
3728,U16585,241,74749.22000000003,171,70,518698.63000000006,593447.8500000001
3729,U974687,240,-4632.540000000013,143,97,59920.499999999985,55287.95999999997
3730,U38779,240,5322.399999999768,207,33,7164103.8199999975,7169426.219999997
3731,U25463,240,-1202.6200000000026,207,33,150730.0,149527.38
3732,U39744,240,-199776.93999999992,214,26,373069.83999999997,173292.90000000005
3733,U43253,240,-48714.6499999999,205,35,366778.24999999994,318063.60000000003
3734,U42793,240,804.8299999999995,231,9,26671.570000000003,27476.4
3735,U38327,240,-41606.53,221,19,189385.40999999997,147778.87999999998
3736,U18521,240,258360.83999999997,187,53,337167.91000000003,595528.75
3737,U30998,240,-5724.189999999999,141,99,106057.70999999999,100333.51999999999
3738,U33413,240,956.7400000000071,194,46,146062.71,147019.45
3739,U34050,240,-2936.7499999999945,205,35,106527.96,103591.21
3740,U40533,240,-118269.36,224,16,715442.2900000009,597172.9300000009
3741,U14311,240,10471.719999999994,193,47,393899.36999999994,404371.0899999999
3742,U8982,240,-10242.690000000004,219,21,473462.07999999996,463219.38999999996
3743,U9141,240,106691.30999999998,198,42,1202728.56,1309419.87
3744,U17419,240,114537.66000000003,220,20,195572.44,310110.10000000003
3745,U1383754,240,39545.979999999996,157,83,282687.99,322233.97
3746,U32484,240,-67115.68999999997,222,18,232249.33999999994,165133.64999999997
3747,U24968,240,-10426.789999999999,225,15,47117.35,36690.56
3748,U22100,240,317.38999999999834,229,11,48391.31000000001,48708.70000000001
3749,U28740,240,20685.14000000001,214,26,108057.91999999998,128743.06
3750,U985301,240,-8085.13,182,58,329421.7699999997,321336.6399999997
3751,U33918,240,82169.08000000009,123,117,614043.5499999999,696212.63
3752,U24726,240,-758.5700000000049,150,90,389175.71999999986,388417.14999999985
3753,U35443,240,-1117722.479999999,219,21,3494368.160000001,2376645.680000002
3754,U12044,240,-174502.06999999995,218,22,863987.1499999999,689485.08
3755,U42784,240,1121.96999999998,192,48,500852.12999999983,501974.0999999998
3756,U34511,240,-604.4799999999996,178,62,213502.24000000002,212897.76
3757,U26950,240,-40253.33000000001,200,40,220970.47000000003,180717.14
3758,U27301,240,-22106.37999999999,165,75,384817.3299999999,362710.9499999999
3759,U8556,240,-23017.20999999997,213,27,382803.8400000002,359786.63000000024
3760,U14652,240,-1093796.7299999993,196,44,6305597.970000002,5211801.240000002
3761,U32387,240,-812.1899999999987,172,68,39085.32,38273.130000000005
3762,U22026,240,21922.32,207,33,41757.540000000015,63679.860000000015
3763,U17481,240,-43263.120000000024,146,94,4512941.34,4469678.22
3764,U27303,240,-3460.4899999999934,220,20,160248.99999999962,156788.50999999963
3765,U22197,240,-1052639.3800000004,222,18,2426063.809999999,1373424.4299999988
3766,U34449,239,4570.269999999997,176,63,362620.37999999995,367190.64999999997
3767,U27649,239,1742.060000000005,214,25,42761.07,44503.130000000005
3768,U14859,239,-299897.2899999999,208,31,518392.79000000004,218495.50000000012
3769,U33946,239,1076.4100000000026,154,85,739950.5599999999,741026.97
3770,U20723,239,4297.24000000004,198,41,464102.99000000005,468400.2300000001
3771,U20125,239,65469.30999999997,198,41,144673.48999999996,210142.79999999993
3772,U36806,239,4867.64,224,15,194045.86000000002,198913.50000000003
3773,U41496,239,-16767.310000000005,212,27,183583.46999999997,166816.15999999997
3774,U42118,239,747119.2899999996,171,68,3022326.6299999994,3769445.919999999
3775,U21462,239,38683.559999999714,212,27,162415.23000000019,201098.7899999999
3776,U13644,239,-196686.78999999998,223,16,579452.35,382765.56
3777,U22856,239,10753.829999999996,213,26,236121.3799999999,246875.20999999988
3778,U23540,239,-197087.0499999998,224,15,1271875.2200000002,1074788.1700000004
3779,U32852,239,-7983.700000000014,158,81,823374.5999999997,815390.8999999997
3780,U30818,239,21236.90999999999,190,49,490178.90000000014,511415.8100000001
3781,U28575,239,-37572.69999999999,218,21,187950.96000000002,150378.26000000004
3782,U24711,239,-63445.19,203,36,205454.64,142009.45
3783,U26918,239,90529.15000000001,204,35,276029.56,366558.71
3784,U34910,239,-14640.539999999992,226,13,240676.46,226035.92
3785,U14780,239,-42685.340000000004,221,18,164966.36000000002,122281.02000000002
3786,U43222,239,2961.5599999999995,229,10,104529.59,107491.15
3787,U11984,239,-10849.939999999997,93,146,253136.01,242286.07
3788,U21014,239,-28980.66000000001,195,44,311029.8,282049.13999999996
3789,U972801,239,-647.639999999998,195,44,43204.34000000001,42556.70000000001
3790,U19885,239,1269.170000000001,212,27,35077.4,36346.57
3791,U24355,239,16385.4,226,13,57651.96,74037.36
3792,U35026,239,14167.509999999998,219,20,51807.42999999999,65974.93999999999
3793,U21771,239,-428101.98,205,34,1001564.7900000002,573462.8100000002
3794,U28587,239,-12327.799999999996,210,29,152769.6199999999,140441.81999999992
3795,U17173,239,-58826.459999999985,190,49,1197295.01,1138468.55
3796,U11679,239,55396.04,225,14,310625.9200000001,366021.9600000001
3797,U23140,239,37988.73,131,108,752848.3300000002,790837.0600000002
3798,U36539,239,-6233.269999999997,222,17,55026.579999999994,48793.31
3799,U22254,239,36047.759999999995,222,17,100094.86,136142.62
3800,U8252,239,-8594.880000000023,220,19,217014.40999999995,208419.5299999999
3801,U15195,239,-136347.83,209,30,765202.8199999998,628854.9899999999
3802,U13040,239,5908.449999999995,205,34,56139.77999999999,62048.22999999999
3803,U36859,239,-667.1199999999964,212,27,45491.15000000001,44824.03000000001
3804,U15744,239,3659.8000000001275,162,77,874405.7800000005,878065.5800000007
3805,U1166647,239,19351.609999999986,134,105,437872.81,457224.42
3806,U36825,238,-3527.8699999999735,209,29,265987.02999999997,262459.16
3807,U15161,238,-868.6199999999967,193,45,125297.37000000001,124428.75000000001
3808,U21162,238,5973.119999999996,180,58,21780.94999999999,27754.069999999985
3809,U17391,238,-89563.83,201,37,236370.79,146806.96000000002
3810,U31952,238,20472.670000000013,210,28,709007.1799999999,729479.85
3811,U31726,238,-1010.799999999995,224,14,21265.899999999998,20255.100000000002
3812,U28826,238,20111.3,228,10,171173.70999999996,191285.00999999995
3813,U21566,238,452.08999999999924,227,11,24581.809999999998,25033.899999999998
3814,U20174,238,-48902.50999999998,228,10,178461.12,129558.61000000002
3815,U33275,238,-678.0300000000002,194,44,120029.81000000003,119351.78000000003
3816,U20343,238,446.2099999999975,178,60,133405.97000000003,133852.18000000002
3817,U17204,238,-108621.23,196,42,675535.5300000001,566914.3000000002
3818,U38267,238,22695.260000000115,215,23,774905.0,797600.2600000001
3819,U43486,238,22796.19,204,34,219657.75,242453.94
3820,U39646,238,-5748.600000000002,186,52,186837.6599999999,181089.05999999988
3821,U780460,238,-1079.480000000005,132,106,564778.69,563699.21
3822,U33523,238,5354.079999999996,223,15,97285.01000000001,102639.09000000001
3823,U37827,238,-5376.730000000001,224,14,235744.34000000008,230367.61000000007
3824,U42065,238,-26728.659999999967,216,22,2827047.969999996,2800319.309999996
3825,U23080,238,-33667.000000000044,214,24,54180.980000000025,20513.97999999998
3826,U22875,238,-11027.81999999999,222,16,90737.63999999991,79709.81999999992
3827,U13543,238,-3694.5400000000054,209,29,184823.5,181128.96
3828,U10526,238,8655.210000000008,191,47,397630.25999999983,406285.46999999986
3829,U33459,238,-60030.15000000004,221,17,387699.87999999995,327669.7299999999
3830,U15797,238,-38637.130000000034,151,87,1568246.2299999997,1529609.0999999996
3831,U30276,238,-900.8000000000022,194,44,194155.83999999973,193255.03999999975
3832,U39575,238,-2552.6899999999996,232,6,10719.310000000001,8166.620000000002
3833,U14617,238,37784.390000000014,197,41,376025.02,413809.41000000003
3834,U9371,238,5948.410000000091,214,24,418995.71,424944.1200000001
3835,U13638,238,-212750.5000000001,216,22,1252991.17,1040240.6699999998
3836,U13524,238,-185901.53,222,16,442248.97999999986,256347.44999999987
3837,U24743,238,-67311.11000000002,224,14,402633.17000000004,335322.06000000006
3838,U17035,238,8879.129999999926,195,43,1142759.1399999997,1151638.2699999996
3839,U17482,238,-121015.49999999988,110,128,5968478.5,5847463.0
3840,U9960,238,-38099.22000000003,201,37,281497.62000000005,243398.40000000002
3841,U17112,238,-941.2699999999954,163,75,3109904.1900000004,3108962.9200000004
3842,U594709,238,-145.54999999999532,199,39,28562.780000000002,28417.230000000007
3843,U1196026,237,-4067.719999999999,177,60,65334.74,61267.02
3844,U14561,237,-43935.44000000002,215,22,542230.74,498295.3
3845,U8915,237,-1906.0999999999967,189,48,100851.50999999997,98945.40999999997
3846,U28990,237,81041.54999999994,213,24,967000.6500000003,1048042.2000000002
3847,U26828,237,18835.870000000104,188,49,378818.85000000015,397654.72000000026
3848,U14331,237,73167.06,143,94,956320.8800000001,1029487.9400000002
3849,U947287,237,474.6900000000014,151,86,67079.79000000001,67554.48000000001
3850,U21302,237,2466.060000000012,165,72,880769.6800000002,883235.7400000002
3851,U41827,237,333462.5900000002,213,24,7324071.35,7657533.9399999995
3852,U11197,237,-4359.7199999999975,206,31,93653.79,89294.06999999999
3853,U37849,237,-9664.719999999996,229,8,25500.250000000007,15835.530000000012
3854,U25009,237,9830.149999999985,175,62,795097.9600000002,804928.1100000002
3855,U12498,237,4137.550000000005,163,74,158449.91999999998,162587.47
3856,U18001,237,7083.580000000004,211,26,28459.38,35542.96000000001
3857,U31611,237,-141428.36999999997,226,11,312854.6800000001,171426.31000000014
3858,U18820,237,-102137.71000000002,192,45,1286210.9699999997,1184073.2599999998
3859,U37614,237,-4711.630000000001,219,18,29778.28,25066.649999999998
3860,U8801,237,-142437.67000000004,205,32,1141683.24,999245.57
3861,U22131,237,-230758.77999999997,183,54,3005269.9799999995,2774511.1999999997
3862,U26998,237,3790.0499999999884,220,17,165697.99999999994,169488.04999999993
3863,U41045,237,74225.70000000007,160,77,2526951.599999999,2601177.2999999993
3864,U33628,237,10360.679999999991,220,17,95324.49999999999,105685.17999999998
3865,U8877,237,-14313.069999999989,200,37,122757.96000000002,108444.89000000003
3866,U12553,237,109088.71999999991,208,29,1926908.1299999997,2035996.8499999996
3867,U17638,237,14682.049999999921,158,79,1657133.3900000001,1671815.44
3868,U24101,237,-3708.919999999995,224,13,35602.27,31893.350000000002
3869,U23208,237,-8620.800000000003,175,62,529050.7100000003,520429.9100000003
3870,U22082,237,5219.250000000011,202,35,190942.29000000004,196161.54000000004
3871,U33260,237,11863.550000000003,224,13,211312.0,223175.55
3872,U29348,237,17207.600000000006,218,19,59896.640000000014,77104.24000000002
3873,U15986,237,-59280.26999999996,193,44,714341.9099999998,655061.6399999999
3874,U27496,237,-73322.13999999993,184,53,2056233.8199999998,1982911.68
3875,U14031,237,-40404.819999999934,152,85,621520.33,581115.51
3876,U13316,237,65527.1999999998,201,36,738437.2300000001,803964.4299999999
3877,U36771,237,10457.570000000002,224,13,142606.62000000002,153064.19000000003
3878,U9316,237,107450.40999999999,156,81,747177.3699999999,854627.7799999999
3879,U12004,237,23498.5,212,25,121612.45999999999,145110.96
3880,U1325084,237,0.07999999999272404,123,114,144225.72,144225.8
3881,U41759,237,1412196.5599999996,229,8,146427.86,1558624.4199999995
3882,U31991,237,-5949.730000000005,213,24,31260.529999999948,25310.799999999945
3883,U24157,236,57664.66,156,80,1020664.69,1078329.3499999999
3884,U21632,236,-232524.93000000002,220,16,416932.5699999999,184407.63999999987
3885,U12647,236,-15901.740000000202,200,36,1082543.5700000003,1066641.83
3886,U27200,236,72243.29000000002,227,9,45699.96000000001,117943.25000000003
3887,U16120,236,-96497.42999999992,176,60,4790918.99,4694421.5600000005
3888,U14644,236,74271.23999999995,206,30,400520.61999999953,474791.85999999946
3889,U22946,236,-4496.499999999985,147,89,1254984.63,1250488.13
3890,U15369,236,-34955.63999999998,205,31,570110.53,535154.89
3891,U23216,236,-17094.97000000001,210,26,282922.4399999999,265827.46999999986
3892,U8292,236,-143.35000000000645,219,17,129088.71999999996,128945.36999999995
3893,U33922,236,667647.6199999996,225,11,436462.2300000001,1104109.8499999996
3894,U40737,236,-4883.409999999998,180,56,32984.50000000001,28101.09000000001
3895,U19141,236,-12748.200000000019,200,36,175693.83999999997,162945.63999999996
3896,U16629,236,-2454.119999999977,189,47,213835.29,211381.17000000004
3897,U29209,236,501.64999999978625,213,23,2164346.3800000045,2164848.0300000045
3898,U15896,236,-752267.1200000007,222,14,918759.3100000006,166492.18999999994
3899,U28187,236,-2611.3599999999983,225,11,38854.149999999994,36242.78999999999
3900,U15038,236,-4978.050000000004,187,49,488778.1900000001,483800.14000000013
3901,U9360,236,-12372.14999999999,199,37,249524.86000000002,237152.71000000002
3902,U26249,236,-226323.21000000005,217,19,273435.29000000004,47112.07999999999
3903,U19979,236,79853.75999999998,212,24,105503.90999999996,185357.66999999993
3904,U38788,236,-6181.809999999983,182,54,362183.51,356001.7
3905,U12609,236,-137601.36999999994,214,22,866875.6000000003,729274.2300000004
3906,U14106,236,933.0399999999936,204,32,301332.90999999986,302265.94999999984
3907,U34801,236,50162.400000000016,210,26,140211.61000000004,190374.01000000007
3908,U41646,236,-251.88999999995394,209,27,225285.03,225033.14000000004
3909,U30901,236,-4140.660000000018,172,64,605415.3899999999,601274.7299999999
3910,U29882,236,15827.720000000081,208,28,649288.02,665115.7400000001
3911,U30123,236,79420.00000000001,183,53,3724947.2300000004,3804367.2300000004
3912,U31932,236,151.49000000000024,189,47,72116.81000000003,72268.30000000003
3913,U33009,236,3092.559999999999,183,53,36972.22000000001,40064.780000000006
3914,U12024,236,-3377.1500000000005,174,62,71536.55000000003,68159.40000000004
3915,U16217,236,-1012.6299999999464,175,61,7702028.579999999,7701015.949999999
3916,U40583,236,-141.96999999999227,211,25,31135.499999999993,30993.53
3917,U15531,236,15901.800000000017,206,30,430138.6599999999,446040.45999999996
3918,U32705,236,-26494.76000000001,213,23,121023.03999999998,94528.27999999997
3919,U24836,236,613.6299999999975,176,60,155501.78,156115.41
3920,U13624,236,-50867.29000000002,196,40,164753.4899999999,113886.19999999988
3921,U42090,236,-8060.180000000001,201,35,107430.67000000001,99370.49
3922,U32125,235,2619.8200000000143,215,20,478275.3400000001,480895.1600000001
3923,U18881,235,9663.650000000001,220,15,67802.68,77466.32999999999
3924,U10695,235,501681.98,124,111,8652184.51,9153866.49
3925,U34630,235,45577.09000000001,164,71,4626103.53,4671680.62
3926,U33855,235,-8373.340000000007,194,41,388218.79000000004,379845.45
3927,U22565,235,-4906.630000000001,228,7,64629.0,59722.369999999995
3928,U43438,235,23476.36,208,27,435699.78,459176.14
3929,U10869,235,-3105.170000000013,206,29,248888.9,245783.72999999998
3930,U8659,235,115151.89000000001,179,56,239659.62000000002,354811.51
3931,U43520,235,117589.29999999993,198,37,594402.4000000001,711991.7000000001
3932,U44030,235,955.3300000000045,213,22,41098.25,42053.58
3933,U37680,235,13609.649999999981,206,29,318499.5,332109.14999999997
3934,U35628,235,3878.2000000000016,199,36,26916.93,30795.13
3935,U43822,235,-509215.56000000006,213,22,2248487.8,1739272.2399999998
3936,U17051,235,-18127.069999999978,207,28,265845.2,247718.13000000003
3937,U32294,235,48994.69,166,69,102052.52000000002,151047.21000000002
3938,U32211,235,25706.840000000004,194,41,265004.49,290711.33
3939,U22527,235,65256.19,214,21,189363.07999999993,254619.26999999993
3940,U23799,235,-1690.2399999999998,208,27,96493.26000000001,94803.02
3941,U20565,235,-58.74999999999272,200,35,172058.56999999992,171999.81999999992
3942,U27137,235,151613.44000000003,199,36,823188.4500000003,974801.8900000004
3943,U37180,235,7870.1500000000115,214,21,96887.67,104757.82
3944,U33210,235,-27615.140000000014,215,20,1396350.4000000008,1368735.2600000007
3945,U798818,235,20069.050000000003,150,85,109748.44999999998,129817.49999999999
3946,U13713,235,8885.989999999989,204,31,159972.78999999998,168858.77999999997
3947,U28732,235,-624.8299999999958,204,31,34958.13000000001,34333.30000000002
3948,U20966,235,21862.35,207,28,405921.6500000001,427784.00000000006
3949,U33789,235,8394.06,217,18,18263.189999999995,26657.249999999993
3950,U976433,235,-506.1499999999571,129,106,660469.36,659963.2100000001
3951,U28850,235,362171.95000000007,196,39,453704.27,815876.2200000001
3952,U13625,235,1746.1199999999785,128,107,355853.99,357600.11
3953,U15458,235,-7503.439999999977,179,56,777758.6000000001,770255.1600000001
3954,U32541,235,3258.74999999999,162,73,329525.1400000001,332783.8900000001
3955,U25931,235,-85779.85,213,22,183055.06999999998,97275.21999999997
3956,U40744,235,-64297.27000000002,208,27,275225.67999999993,210928.40999999992
3957,U22911,235,-4173.350000000001,221,14,24690.669999999995,20517.319999999992
3958,U26611,234,-47347.590000000004,204,30,1018371.1900000003,971023.6000000003
3959,U41839,234,4572.100000000001,204,30,202375.40000000002,206947.50000000003
3960,U39206,234,22340.21,218,16,32433.200000000004,54773.41
3961,U10060,234,1162.8900000000503,204,30,603297.2600000001,604460.1500000001
3962,U37590,234,-9132.879999999965,193,41,504785.79,495652.91000000003
3963,U16276,234,141581.80000000002,214,20,304360.07,445941.87
3964,U21544,234,43522.44000000025,196,38,3903955.9400000004,3947478.380000001
3965,U14557,234,22930.770000000055,194,40,495621.48000000004,518552.2500000001
3966,U42190,234,283204.55000000005,186,48,1940339.6300000001,2223544.18
3967,U15811,234,-25771.190000000006,199,35,468529.65999999986,442758.46999999986
3968,U32399,234,27983.90000000001,102,132,1100525.1600000001,1128509.06
3969,U32725,234,2855.770000000007,69,165,208778.9799999999,211634.7499999999
3970,U22142,234,106657.8399999999,214,20,1730529.9499999997,1837187.7899999996
3971,U33503,234,-10199.169999999998,210,24,128676.23000000001,118477.06000000001
3972,U10339,234,-9734.870000000003,139,95,199090.84,189355.97
3973,U16088,234,-268243.7399999997,225,9,390419.1599999998,122175.4200000001
3974,U28274,234,-47393.64000000002,183,51,206037.03000000003,158643.39
3975,U18830,234,-8004.360000000004,203,31,66566.31,58561.95
3976,U33641,234,-4391.240000000002,218,16,144501.34000000003,140110.10000000003
3977,U32352,234,-22175.64999999998,112,122,1013193.6599999997,991018.0099999997
3978,U39895,234,-15778.810000000016,187,47,390139.1500000001,374360.3400000001
3979,U23190,234,8205.730000000001,204,30,76461.61,84667.34
3980,U37953,234,-13955.709999999997,219,15,67368.92000000003,53413.21000000003
3981,U42028,234,-12293.409999999994,197,37,94684.26000000002,82390.85000000003
3982,U10635,234,-8627.489999999998,229,5,13816.399999999994,5188.909999999996
3983,U17732,234,-48971.24999999995,181,53,974296.1500000001,925324.9000000001
3984,U24932,234,41430.80999999997,207,27,482208.11999999994,523638.92999999993
3985,U39098,234,-24677.460000000006,222,12,225982.03999999992,201304.5799999999
3986,U14216,234,976456.6699999999,208,26,2664512.21,3640968.88
3987,U16496,234,-38137.71,186,48,918548.2700000003,880410.5600000003
3988,U22085,234,-37279.00000000004,217,17,95455.35000000003,58176.35
3989,U43375,234,-27424.51999999999,203,31,652146.5299999999,624722.0099999999
3990,U41857,234,-39783.16000000001,214,20,135727.40999999997,95944.24999999997
3991,U26158,234,-562.3200000000008,194,40,238478.77000000002,237916.45
3992,U32372,234,1705203.98,178,56,7963722.399999999,9668926.379999999
3993,U21117,234,-95750.59000000003,144,90,1057439.3199999996,961688.7299999995
3994,U39621,234,-1956.5099999999875,195,39,316284.16000000003,314327.65
3995,U9967,234,85995.24000000009,190,44,1130351.0699999998,1216346.3099999998
3996,U33794,234,7370.36999999998,170,64,258615.00999999995,265985.37999999995
3997,U40733,234,1279.1399999999983,210,24,28904.950000000015,30184.090000000015
3998,U10462,234,476.88999999999976,226,8,12111.310000000001,12588.2
3999,U43524,234,-464.719999999998,196,38,37724.36000000002,37259.64000000002
4000,U8611,234,-20261.570000000072,159,75,2174479.2899999996,2154217.7199999993
4001,U41200,233,-56105.49999999997,197,36,1359548.38,1303442.88
4002,U626496,233,965.0300000000307,125,108,299446.12999999995,300411.16
4003,U29595,233,2961.87999999999,196,37,450128.13,453090.01
4004,U25426,233,-5227.900000000012,193,40,209195.06000000003,203967.16
4005,U31681,233,-12446.94,229,4,21823.94000000001,9377.00000000001
4006,U34872,233,-386.70000000000294,214,19,32707.699999999986,32320.99999999998
4007,U36066,233,106059.42000000003,207,26,210845.85,316905.27
4008,U33867,233,-4361.060000000001,209,24,50239.2,45878.14
4009,U28328,233,-89975.94000000028,163,70,8872907.049999999,8782931.11
4010,U15737,233,3749.85,204,29,51686.439999999995,55436.28999999999
4011,U10265,233,-186852.45,183,50,471403.00000000006,284550.55000000005
4012,U26165,233,2561.3199999994767,189,44,1293269.5099999998,1295830.8299999991
4013,U42425,233,-3442.7299999999955,215,18,30444.09999999999,27001.369999999995
4014,U26489,233,104462.05999999997,183,50,710258.1500000003,814720.2100000002
4015,U12742,233,-36505.95000000001,189,44,108850.84000000001,72344.89
4016,U19284,233,-4272.829999999999,222,11,13533.849999999997,9261.019999999997
4017,U36306,233,8916.07999999997,209,24,82569.22000000003,91485.3
4018,U26807,233,-35098.01000000001,179,54,281455.61999999994,246357.60999999993
4019,U31366,233,2654.9700000000007,218,15,37622.11000000002,40277.08000000002
4020,U24266,233,2124.0900000000047,205,28,83804.56000000003,85928.65000000004
4021,U14268,233,-8581.750000000002,218,15,157802.94999999992,149221.19999999992
4022,U30320,233,1678715.0300000003,188,45,2832637.1200000006,4511352.15
4023,U17071,233,32359.74999999997,206,27,1130980.15,1163339.9
4024,U30297,233,334973.01999999996,214,19,3641065.7799999984,3976038.7999999984
4025,U39606,233,-16791.929999999986,195,38,744153.6499999999,727361.72
4026,U33507,233,-7751.170000000004,192,41,341998.8900000001,334247.7200000001
4027,U723969,233,-11143.079999999998,169,64,502733.65,491590.57
4028,U35099,233,274.33999999999946,210,23,29042.420000000006,29316.760000000006
4029,U34233,233,-3796.789999999999,226,7,9158.4,5361.610000000001
4030,U16997,233,8656.499999999935,205,28,1603059.3299999998,1611715.8299999998
4031,U39590,233,51091.92999999997,197,36,710188.1399999999,761280.0699999998
4032,U33829,233,-3451.969999999985,174,59,785514.04,782062.0700000001
4033,U40691,233,710.4800000000016,157,76,23513.38999999999,24223.86999999999
4034,U1149939,233,16427.83999999999,138,95,271584.17,288012.00999999995
4035,U9963,233,33549.72,167,66,367598.65,401148.37
4036,U15153,233,30672.129999999997,207,26,73940.17,104612.29999999999
4037,U35093,233,-17603.790000000008,216,17,73792.82,56189.03
4038,U22025,233,-12980.089999999997,211,22,25098.500000000007,12118.41000000001
4039,U23350,233,118.14999999999955,181,52,56029.63000000003,56147.78000000003
4040,U41948,233,149.35000000000582,103,130,1196867.85,1197017.2000000002
4041,U18965,233,-51221.79,165,68,924799.9399999998,873578.1499999998
4042,U12195,233,-3932.8199999999997,209,24,102411.51,98478.69
4043,U35384,232,7513.709999999999,219,13,155551.93,163065.63999999998
4044,U19750,232,-180112.20999999993,204,28,517063.69000000006,336951.4800000001
4045,U14366,232,-35554.33000000003,209,23,284884.81999999995,249330.48999999993
4046,U24323,232,19626.360000000073,177,55,2261192.3,2280818.6599999997
4047,U23085,232,-2214.2499999999973,190,42,49821.58,47607.33
4048,U26981,232,48807.540000000066,185,47,1127183.3899999997,1175990.9299999997
4049,U22913,232,-156.21999999998934,175,57,361743.89,361587.67000000004
4050,U13046,232,-125078.59999999986,177,55,2751310.54,2626231.9400000004
4051,U37900,232,37023.20999999999,191,41,195630.68000000002,232653.89
4052,U37159,232,3662.12000000001,190,42,429455.9,433118.02
4053,U26957,232,47418.52000000003,165,67,290426.24,337844.76
4054,U43761,232,-17392.47999999999,190,42,271173.42999999993,253780.94999999995
4055,U15541,232,-4110.359999999998,218,14,74892.03999999996,70781.67999999996
4056,U41790,232,-8784.629999999997,220,12,41936.31000000001,33151.680000000015
4057,U14383,232,-400.76999999999896,225,7,26898.149999999998,26497.379999999997
4058,U22840,232,3615.1500000000005,212,20,48504.700000000004,52119.850000000006
4059,U31283,232,-2429.9799999997995,219,13,324055.04999999976,321625.06999999995
4060,U22780,232,10493.330000000024,217,15,90567.35999999997,101060.69
4061,U12656,232,-64199.07000000002,192,40,1139701.53,1075502.46
4062,U34249,232,-2554.1500000000015,211,21,95035.86,92481.70999999999
4063,U26282,232,-49400.68000000002,217,15,308303.59,258902.91
4064,U8708,232,-3508.9900000000075,215,17,62592.860000000015,59083.87000000001
4065,U23404,232,1561.5400000000009,210,22,88698.90000000004,90260.44000000003
4066,U12023,232,-26678.570000000036,178,54,266995.61999999994,240317.0499999999
4067,U12354,232,8553.449999999997,181,51,207420.9799999999,215974.42999999988
4068,U11891,232,6817.939999999996,179,53,235545.88999999998,242363.83
4069,U28473,232,32735.999999999993,197,35,360095.27999999997,392831.27999999997
4070,U41905,232,-625.3599999999805,190,42,1155428.1199999999,1154802.76
4071,U37908,232,18538.59000000012,204,28,592918.5400000004,611457.1300000005
4072,U28510,232,-12687.769999999999,206,26,35819.61,23131.840000000004
4073,U27098,232,1755.2000000000014,218,14,33007.21999999999,34762.41999999999
4074,U965989,232,-5508.500000000016,146,86,245054.12000000002,239545.62
4075,U9149,232,-16677.770000000004,209,23,105982.59,89304.81999999999
4076,U41740,232,-182903.52000000022,202,30,5167342.01,4984438.489999999
4077,U24475,232,-1595.21,209,23,57768.759999999995,56173.549999999996
4078,U40316,232,-353.4299999999948,208,24,87136.29000000002,86782.86000000003
4079,U17165,232,21783.420000001002,212,20,1478294.3099999987,1500077.7299999997
4080,U12424,232,32561.64000000001,162,70,417027.4799999999,449589.11999999994
4081,U10387,232,-1818.899999999987,208,24,87842.87000000001,86023.97000000003
4082,U9871,232,-127.79000000001724,146,86,335545.85000000003,335418.06
4083,U11616,232,38158.410000000025,199,33,367730.7699999999,405889.17999999993
4084,U41119,232,-3699.850000000013,158,74,1732019.76,1728319.91
4085,U13118,232,-25821.52000000001,222,10,144213.23000000004,118391.71000000002
4086,U35807,232,21128.979999999974,153,79,384274.86,405403.83999999997
4087,U8236,232,-2901796.5300000003,217,15,4708406.42,1806609.8899999997
4088,U12090,231,3707.4100000000108,192,39,149130.88999999998,152838.3
4089,U26876,231,-29878.560000000005,220,11,103750.52,73871.95999999999
4090,U25974,231,-5656.059999999995,221,10,50072.659999999996,44416.6
4091,U25943,231,-9163.11,199,32,169493.50999999998,160330.39999999997
4092,U37645,231,12364.689999999995,164,67,193520.74999999994,205885.43999999994
4093,U24375,231,-5672.699999999966,179,52,592142.2599999999,586469.5599999999
4094,U28589,231,-330746.33999999997,195,36,716653.37,385907.03
4095,U615067,231,-10054.689999999997,183,48,21844.91999999999,11790.229999999994
4096,U10484,231,-971203.6299999999,159,72,15173943.0,14202739.370000001
4097,U15639,231,-518745.65,212,19,741528.6100000001,222782.96000000008
4098,U17790,231,888.8599999999609,185,46,382922.03000000014,383810.89000000013
4099,U30215,231,-9467.430000000002,171,60,102807.90000000001,93340.47
4100,U12977,231,-114226.88999999998,207,24,458225.98,343999.08999999997
4101,U42729,231,3087.2999999999947,161,70,245978.72000000006,249066.02000000005
4102,U13307,231,-480519.2200000003,217,14,3343697.5199999986,2863178.2999999984
4103,U10124,231,-3106.050000000002,168,63,108311.09000000003,105205.04000000002
4104,U31357,231,-5511.620000000012,213,18,65571.56000000001,60059.94
4105,U10840,231,-13529.200000000004,221,10,56168.96,42639.759999999995
4106,U15074,231,-93724.46999999994,221,10,194833.54000000007,101109.07000000012
4107,U9182,231,81447.13999999996,197,34,722334.1499999999,803781.2899999998
4108,U27487,231,9560.989999999998,183,48,75699.97,85260.95999999999
4109,U39163,231,14477.080000000009,155,76,908456.6000000002,922933.6800000002
4110,U35518,231,-18200.450000000004,206,25,184933.78999999998,166733.33999999997
4111,U16608,231,-14771.830000000024,219,12,634076.0800000005,619304.2500000005
4112,U40261,231,66009.84999999998,201,30,61010.52000000001,127020.37
4113,U18903,231,-44393.20999999999,185,46,654196.53,609803.3200000001
4114,U18859,231,107680.69,93,138,170182.45000000004,277863.14
4115,U25570,231,7041.760000000005,193,38,39722.30000000002,46764.06000000002
4116,U597161,231,487.6799999999994,145,86,42309.7,42797.38
4117,U23618,231,888350.8099999999,198,33,288188.08999999997,1176538.9
4118,U36368,231,-3460.3900000000012,219,12,7732.660000000002,4272.27
4119,U43358,231,7188.710000000005,190,41,111094.03,118282.74
4120,U27085,231,-41221.08,209,22,275491.20999999996,234270.12999999995
4121,U14643,231,-2771.199999999997,215,16,167687.27999999982,164916.07999999984
4122,U29609,231,0.220000000028449,207,24,172932.0799999999,172932.29999999993
4123,U41812,231,-9647.669999999998,148,83,131189.8899999999,121542.2199999999
4124,U16973,231,-44447.360000000015,144,87,913335.12,868887.76
4125,U41360,231,12398.85999999999,163,68,655966.7,668365.5599999999
4126,U22330,231,7256.350000000002,193,38,95365.62,102621.97
4127,U31910,231,-51602.84999999999,201,30,181780.81999999998,130177.96999999999
4128,U11644,230,-6720.690000000017,183,47,1256809.6699999995,1250088.9799999995
4129,U39592,230,-25777.710000000003,219,11,53895.87,28118.16
4130,U30788,230,877.7699999999895,174,56,142793.71000000002,143671.48
4131,U33090,230,191993.57,187,43,139450.31,331443.88
4132,U8454,230,-179219.25000000006,172,58,3759104.18,3579884.93
4133,U15618,230,-195669.32,184,46,3768509.59,3572840.27
4134,U36999,230,11371.57000000002,170,60,290499.05,301870.62
4135,U38699,230,89515.90000000002,159,71,441520.17999999993,531036.08
4136,U42366,230,-403.1700000000038,228,2,6452.15000000001,6048.980000000006
4137,U39371,230,8790.26,208,22,39547.520000000004,48337.780000000006
4138,U42115,230,-28551.86999999987,179,51,833706.5399999999,805154.67
4139,U20232,230,1213.0799999999797,223,7,56948.869999999995,58161.949999999975
4140,U17473,230,-19170.519999999982,202,28,272343.5699999998,253173.04999999978
4141,U35751,230,29268.120000000014,209,21,193819.07,223087.19000000003
4142,U32965,230,-252.00999999999888,217,13,22591.799999999996,22339.789999999997
4143,U14344,230,614.5800000000013,206,24,88716.89999999992,89331.47999999992
4144,U37170,230,4315.900000000003,142,88,1075250.8099999996,1079566.7099999995
4145,U41236,230,651.8700000000244,137,93,434041.87,434693.74
4146,U29953,230,19045.05000000009,199,31,661694.6600000001,680739.7100000002
4147,U38502,230,16338.269999999988,205,25,82606.47999999995,98944.74999999994
4148,U22063,230,-119039.56000000007,206,24,1632454.3199999994,1513414.7599999993
4149,U10372,230,13295.040000000008,125,105,1319799.6199999999,1333094.66
4150,U27462,230,-18590.980000000003,227,3,22176.850000000002,3585.869999999999
4151,U12767,230,-3165.8800000000138,197,33,210860.70999999993,207694.82999999993
4152,U9991,230,-36860.600000000006,212,18,134574.99999999994,97714.39999999994
4153,U42392,230,-1429.7999999999993,218,12,26467.360000000004,25037.560000000005
4154,U24432,230,-22397.069999999985,176,54,217012.85,194615.78000000003
4155,U21340,230,-20722.430000000022,172,58,1917129.5199999998,1896407.0899999999
4156,U23592,230,-16259.279999999984,196,34,250332.42000000007,234073.14000000007
4157,U16417,230,-103419.41000000003,188,42,878664.1000000001,775244.6900000001
4158,U620328,230,-2235.190000000006,128,102,100524.98,98289.79
4159,U34933,230,-11551.769999999995,212,18,33647.310000000005,22095.540000000008
4160,U1097807,230,-627.3300000000021,148,82,68178.17000000001,67550.84000000001
4161,U29756,230,27452.240000000078,202,28,384474.33,411926.57000000007
4162,U14348,230,-14396.700000000006,214,16,67274.68000000002,52877.98000000002
4163,U14493,230,1982.1899999998886,211,19,967691.5300000005,969673.7200000004
4164,U33374,230,-534.5800000000011,192,38,164561.34999999995,164026.76999999996
4165,U23301,230,206114.12000000002,202,28,264743.2799999999,470857.3999999999
4166,U11674,230,-1139.550000000021,166,64,699735.0600000002,698595.5100000001
4167,U27138,230,156535.83000000002,209,21,653056.2900000003,809592.1200000003
4168,U753650,230,1243.1500000000042,134,96,169057.58999999997,170300.73999999996
4169,U33959,230,-699.2099999999979,218,12,12101.210000000001,11402.000000000004
4170,U9277,230,-575336.0899999993,198,32,24484921.1,23909585.01
4171,U30809,230,828.1100000000915,187,43,1590378.81,1591206.9200000002
4172,U24502,230,10903.7,211,19,68258.17000000003,79161.87000000002
4173,U8079,230,-55575.649999999994,215,15,165051.66,109476.01000000001
4174,U16299,230,397001.33999999997,209,21,836041.25,1233042.5899999999
4175,U33280,230,-64266.47000000001,180,50,720577.7,656311.23
4176,U10382,230,-14017.549999999992,209,21,128862.73,114845.18000000001
4177,U30554,230,-126751.88000000018,185,45,10288126.820000006,10161374.940000005
4178,U28585,230,65526.79000000001,144,86,975179.45,1040706.24
4179,U20515,230,-5937.390000000036,183,47,291752.5,285815.11
4180,U12381,230,6441.300000000025,216,14,127568.58000000002,134009.88000000003
4181,U15698,229,-12448.349999999995,213,16,125034.24999999996,112585.89999999997
4182,U15700,229,324996.50999999995,211,18,41750.38,366746.88999999996
4183,U43183,229,-41031.41,202,27,196354.51,155323.1
4184,U19363,229,-594.2200000000045,191,38,643833.8300000001,643239.6100000001
4185,U21911,229,16758.95000000001,206,23,377386.51,394145.46
4186,U23804,229,9978.939999999944,213,16,525500.53,535479.47
4187,U29497,229,-217436.69999999995,184,45,316152.89999999997,98716.20000000001
4188,U10592,229,-10.000000000021828,112,117,802721.4599999998,802711.4599999998
4189,U13393,229,-51450.74999999997,193,36,421126.5300000002,369675.78000000026
4190,U12854,229,-5314.740000000027,173,56,890799.1699999999,885484.4299999999
4191,U18239,229,-155440.27999999994,185,44,483966.25000000023,328525.9700000003
4192,U10801,229,-49665.68999999997,192,37,769045.9,719380.2100000001
4193,U16984,229,-6266.030000000001,200,29,53942.97000000002,47676.940000000024
4194,U43958,229,-18432.789999999997,216,13,68651.99,50219.20000000001
4195,U15579,229,6090.320000000043,179,50,1133674.93,1139765.25
4196,U17569,229,-54556.32000000004,162,67,1296981.1,1242424.78
4197,U30866,229,-44271.02000000006,150,79,1159818.79,1115547.77
4198,U37042,229,80.03000000000009,215,14,8693.010000000002,8773.040000000003
4199,U11919,229,1543.3299999999708,158,71,1210678.0899999999,1212221.42
4200,U39885,229,-6245.9,211,18,42138.66999999999,35892.76999999999
4201,U13178,229,46465.38,213,16,207847.35,254312.73
4202,U8036,229,-15973.759999999951,172,57,1585734.49,1569760.73
4203,U16311,229,-9733.47999999999,208,21,226255.31999999986,216521.83999999988
4204,U26362,229,-2608.5800000000013,218,11,6809.95,4201.369999999999
4205,U34210,229,2185.359999999977,214,15,899357.8500000002,901543.2100000002
4206,U26006,229,49.53999999999944,213,16,10640.54,10690.08
4207,U25646,229,-5078.340000000011,189,40,376465.23000000004,371386.89
4208,U13176,229,4532.480000000007,123,106,1500153.4000000001,1504685.8800000001
4209,U22096,229,-1756.2300000000025,145,84,21439.370000000003,19683.14
4210,U13464,229,-4033.210000000012,186,43,311110.13999999996,307076.92999999993
4211,U16001,229,-611486.9499999997,217,12,650238.4899999998,38751.54000000004
4212,U12480,229,-128180.93000000008,203,26,1070372.2300000002,942191.3000000002
4213,U33232,229,1901.4399999999732,210,19,419416.56,421318.0
4214,U12405,229,-66594.80000000002,198,31,351354.5399999998,284759.73999999976
4215,U8148,229,-62957.63999999997,185,44,569586.84,506629.2
4216,U16866,229,-1551.0300000000045,208,21,57167.62999999999,55616.599999999984
4217,U28615,229,-7070.560000000034,220,9,293723.51999999996,286652.9599999999
4218,U34054,229,-44193.270000000004,208,21,202951.56999999992,158758.29999999993
4219,U9977,229,-44764.479999999974,209,20,166485.03,121720.55000000002
4220,U30931,228,-20393.11,205,23,66420.57,46027.46000000001
4221,U17846,228,-99622.12999999998,169,59,1454811.0700000003,1355188.9400000004
4222,U13159,228,-2946.650000000001,191,37,136923.58000000005,133976.93000000005
4223,U14567,228,-412329.69000000006,190,38,1252660.59,840330.9
4224,U12192,228,-128494.11999999998,185,43,430860.41999999987,302366.2999999999
4225,U17799,228,18307.859999999997,195,33,196836.76999999984,215144.62999999983
4226,U39647,228,-42770.240000000005,200,28,230280.67,187510.43
4227,U10579,228,-3538.2500000001087,166,62,1702754.9500000007,1699216.7000000007
4228,U20672,228,34082.90000000001,131,97,1246799.7399999998,1280882.6399999997
4229,U13034,228,10358.430000000004,195,33,150780.33,161138.75999999998
4230,U13566,228,-632.029999999992,158,70,48754.49999999991,48122.46999999992
4231,U43593,228,-22420.770000000015,183,45,230104.61999999997,207683.84999999995
4232,U28080,228,-13610.920000000027,200,28,272126.12999999995,258515.2099999999
4233,U42378,228,-17055.420000000013,170,58,135624.17000000004,118568.75000000003
4234,U29816,228,185274.63000000012,210,18,461110.8600000003,646385.4900000005
4235,U15092,228,-575.3000000000873,122,106,1514358.54,1513783.24
4236,U32123,228,1606.280000000002,190,38,51102.10000000001,52708.38000000001
4237,U36119,228,-5630.559999999998,173,55,636636.0499999999,631005.49
4238,U43421,228,-1819.240000000003,189,39,141429.83999999994,139610.59999999995
4239,U795773,228,-912.4400000000078,156,72,78138.37,77225.93
4240,U16468,228,-81895.24,208,20,761274.9899999999,679379.7499999999
4241,U36714,228,-55137.32000000005,205,23,671753.13,616615.8099999999
4242,U35069,228,-730062.3300000001,185,43,7878667.990000001,7148605.660000001
4243,U29175,228,-25993.040000000186,183,45,1717218.8599999999,1691225.8199999996
4244,U29695,228,-195.22000000000298,203,25,16357.919999999991,16162.699999999988
4245,U20669,228,34145.1,200,28,132977.12999999995,167122.22999999995
4246,U43384,228,-30092.690000000002,219,9,84130.32,54037.630000000005
4247,U19822,228,-7081.279999999984,137,91,409907.59000000014,402826.3100000002
4248,U20223,228,16674.549999999967,148,80,533380.04,550054.59
4249,U16045,228,8930.29999999999,156,72,618587.7000000001,627518.0000000001
4250,U41421,228,-56785.810000000005,206,22,379254.03,322468.22000000003
4251,U13998,228,187959.56999999995,211,17,389407.98000000004,577367.55
4252,U40275,228,1357.3800000000035,203,25,29384.709999999995,30742.09
4253,U40206,228,22788.84999999999,192,36,499829.08,522617.93
4254,U42694,228,13669.75999999998,185,43,255371.1,269040.86
4255,U22967,228,-118928.2000000002,178,50,2599286.5900000003,2480358.39
4256,U40557,228,-5599.259999999997,216,12,63024.87,57425.61000000001
4257,U13282,228,73197.51000000001,214,14,1004093.2200000003,1077290.7300000004
4258,U34988,228,11619.370000000003,195,33,93980.69,105600.06
4259,U14278,228,-224605.92999999993,218,10,293835.7200000001,69229.79000000015
4260,U11848,228,14804.96,198,30,136612.41,151417.37
4261,U8507,228,-9238.25,193,35,141026.40999999997,131788.15999999997
4262,U30310,228,-16354.819999999996,221,7,42825.70000000001,26470.880000000016
4263,U39736,228,-2055.7800000000198,167,61,519361.17000000004,517305.39
4264,U27813,228,19484.36999999999,217,11,26367.36,45851.729999999996
4265,U14277,228,-16728.060000000016,150,78,274683.55000000005,257955.49000000002
4266,U27689,227,-6739.32,173,54,134346.36999999994,127607.04999999993
4267,U20054,227,-41790.62000000001,131,96,976248.33,934457.71
4268,U35152,227,39710.57999999995,160,67,1286306.5799999998,1326017.1599999997
4269,U21051,227,560.969999999998,191,36,72540.13,73101.1
4270,U16048,227,575.2199999999875,170,57,522278.3,522853.51999999996
4271,U11479,227,33158.27000000006,192,35,636704.14,669862.41
4272,U16700,227,-152023.34999999995,184,43,2620447.6699999995,2468424.3199999994
4273,U29660,227,-16282.789999999959,180,47,480977.1199999998,464694.32999999984
4274,U17097,227,4210.470000000417,190,37,4011254.6199999996,4015465.09
4275,U21650,227,-7411.790000000007,210,17,159523.91999999993,152112.12999999992
4276,U26528,227,-255748.79,205,22,990977.2399999998,735228.4499999997
4277,U17552,227,105842.52999999998,198,29,96141.69000000005,201984.22000000003
4278,U34272,227,-3718.3099999999395,169,58,2205326.5600000005,2201608.2500000005
4279,U15323,227,5630.4099999999935,207,20,669502.4199999999,675132.83
4280,U41910,227,12039.490000000009,145,82,74977.16,87016.65000000001
4281,U29548,227,-1636.6200000000233,125,102,5462085.950000001,5460449.330000001
4282,U33047,227,-8208.989999999987,168,59,403635.81000000006,395426.82000000007
4283,U14645,227,19344.910000000044,181,46,4070347.809999998,4089692.7199999983
4284,U12529,227,53136.17000000005,207,20,995877.05,1049013.2200000002
4285,U29867,227,118445.11999999998,158,69,1783747.4300000002,1902192.55
4286,U10509,227,-90332.96,202,25,520049.1599999999,429716.1999999999
4287,U11606,227,-2964.0600000001427,211,16,673134.3900000002,670170.3300000001
4288,U16478,227,-9675.219999999732,189,38,5244577.940000002,5234902.7200000025
4289,U40453,227,-21571.34000000002,209,18,373082.23,351510.88999999996
4290,U37780,227,-1975.420000000002,171,56,150942.48,148967.06
4291,U19715,227,-174542.99000000002,210,17,571839.98,397296.99
4292,U8767,227,-54882.53999999998,208,19,160440.55,105558.01000000001
4293,U9915,227,-2649.559999999665,187,40,4338283.929999999,4335634.369999999
4294,U32447,227,-7269.37000000001,189,38,345058.30999999994,337788.93999999994
4295,U27639,227,79.5399999999554,183,44,207330.54999999996,207410.0899999999
4296,U20182,227,1509.1900000000028,202,25,35920.219999999994,37429.409999999996
4297,U9369,227,1332.8999999999623,209,18,79973.67000000001,81306.56999999998
4298,U16391,227,4281.179999999822,149,78,15020752.960000005,15025034.140000004
4299,U8433,227,3200.7600000000057,204,23,261342.62,264543.38
4300,U36116,226,-10103.129999999997,212,14,22123.18,12020.050000000003
4301,U31648,226,-19030.730000000018,93,133,536189.92,517159.19
4302,U19652,226,-22863.92,199,27,67845.64000000001,44981.720000000016
4303,U40980,226,-33992.97,177,49,498180.78,464187.81000000006
4304,U41863,226,84118.55999999994,192,34,864031.1699999998,948149.7299999997
4305,U13218,226,43539.41,124,102,102633.45000000006,146172.86000000004
4306,U11744,226,-19387.82,213,13,41370.26,21982.440000000002
4307,U11517,226,-2942.7999999999965,211,15,454140.67999999976,451197.8799999998
4308,U27195,226,4485.01999999996,166,60,2649374.719999996,2653859.739999996
4309,U34355,226,-36473.43000000032,150,76,633414.2899999997,596940.8599999994
4310,U21732,226,-185405.71999999994,204,22,480747.48,295341.76
4311,U19211,226,117600.78999999983,200,26,296961.18,414561.96999999986
4312,U23008,226,-688529.8499999999,170,56,1516340.6400000004,827810.7900000005
4313,U40945,226,25665.20999999989,205,21,2631700.640000001,2657365.850000001
4314,U14197,226,49823.13000000001,194,32,415243.0500000001,465066.1800000001
4315,U16354,226,-11439.999999999996,200,26,737102.4099999999,725662.4099999999
4316,U1084026,226,64.86000000000274,156,70,25188.199999999997,25253.06
4317,U11373,226,-16189.089999999991,215,11,93030.06999999998,76840.97999999998
4318,U36203,226,-3775.2400000000002,209,17,21541.83,17766.59
4319,U37702,226,-13215.310000000025,195,31,181457.46999999997,168242.15999999995
4320,U28275,226,160.04000000000107,203,23,51933.38999999998,52093.42999999998
4321,U41423,226,342631.4299999999,203,23,849270.7700000004,1191902.2000000002
4322,U32240,226,126902.95999999988,137,89,1406486.4800000002,1533389.4400000002
4323,U8284,226,467563.22,144,82,4053074.48,4520637.7
4324,U37648,226,-649418.99,194,32,1026195.93,376776.94000000006
4325,U12561,226,-21639.090000000037,161,65,1364331.9299999997,1342692.8399999996
4326,U26145,226,-47416.71000000001,182,44,164698.2,117281.49
4327,U31868,226,-14514.859999999991,166,60,116653.35999999999,102138.5
4328,U10415,226,-24355.820000000007,220,6,37814.16,13458.339999999997
4329,U39962,226,-10598.169999999842,134,92,6480207.5200000005,6469609.350000001
4330,U11720,226,2011.5699999999993,188,38,98601.44999999998,100613.01999999997
4331,U20032,226,30358.789999999994,209,17,198205.19,228563.97999999998
4332,U38350,226,4119.78,216,10,49311.99000000002,53431.77000000002
4333,U38185,226,-45616.31999999999,204,22,174814.57,129198.25000000001
4334,U16693,226,13646.42999999995,192,34,137553.43,151199.85999999993
4335,U15171,226,-42266.530000000006,162,64,189345.20000000004,147078.67000000004
4336,U21304,226,-530257.5499999981,164,62,8883063.809999999,8352806.260000001
4337,U27782,226,-305309.02,217,9,1008415.8300000007,703106.8100000006
4338,U15242,226,317590.92000000016,157,69,1255157.75,1572748.6700000002
4339,U28230,226,96332.51000000017,202,24,1382500.9599999997,1478833.47
4340,U31568,226,-4395.589999999998,210,16,23388.48000000001,18992.890000000014
4341,U32344,226,-786.2700000000004,154,72,496436.26999999996,495649.99999999994
4342,U22623,226,-637.3300000000004,221,5,46156.14000000002,45518.81000000002
4343,U13377,226,-990.5900000000024,201,25,130892.12999999998,129901.53999999998
4344,U10894,225,-11322.040000000135,189,36,784740.989999999,773418.9499999988
4345,U16605,225,219951.52,202,23,345035.85,564987.37
4346,U30722,225,-1931.0100000000266,86,139,263005.92,261074.90999999995
4347,U23943,225,22375.939999999933,155,70,1097642.2199999997,1120018.1599999997
4348,U30679,225,-262.5100000000002,121,104,267180.95999999996,266918.44999999995
4349,U11488,225,-9562.669999999986,176,49,171896.56,162333.89
4350,U33954,225,-117.11000000002123,198,27,213359.89999999994,213242.78999999992
4351,U39949,225,-20335.98999999998,112,113,657482.8499999999,637146.8599999999
4352,U8784,225,-49094.32000000002,190,35,133706.86000000002,84612.54
4353,U15111,225,13972.820000000014,170,55,260259.58,274232.4
4354,U1375814,225,-5197.349999999999,165,60,285522.05000000005,280324.70000000007
4355,U32180,225,290837.42000000016,185,40,986718.1600000003,1277555.5800000005
4356,U11245,225,2388.3700000000003,206,19,72566.14,74954.51
4357,U34432,225,34712.380000000005,213,12,138431.38000000003,173143.76000000004
4358,U21514,225,527.1200000000971,195,30,2110504.449999999,2111031.569999999
4359,U41304,225,-20170.569999999996,212,13,37742.71000000003,17572.140000000032
4360,U26003,225,-105123.13999999998,189,36,489868.29,384745.15
4361,U22824,225,32761.120000000003,164,61,578237.34,610998.46
4362,U21572,225,13484.359999999997,201,24,30731.21,44215.56999999999
4363,U20254,225,-5438.9400000000105,211,14,95003.64,89564.69999999998
4364,U30133,225,212808.72999999998,156,69,8112434.97,8325243.699999999
4365,U23276,225,38665.58000000015,200,25,361648.9099999996,400314.48999999976
4366,U16980,225,-590649.03,206,19,1661538.76,1070889.73
4367,U37033,225,-7482.78,188,37,323878.8399999999,316396.0599999999
4368,U17497,225,-131250.8,197,28,1185637.57,1054386.77
4369,U22868,225,-2662.4000000000233,183,42,98143.41000000002,95481.01
4370,U8495,225,114273.03999999998,168,57,286277.63,400550.67
4371,U26126,225,-9195.5,219,6,14693.09,5497.59
4372,U25689,225,-2282.7499999999964,182,43,279382.04000000004,277099.29000000004
4373,U14068,225,12521.709999999985,198,27,240760.69,253282.4
4374,U9522,225,-50478.540000000015,198,27,103826.84999999996,53348.30999999995
4375,U39328,225,-125517.89999999978,185,40,1301562.4099999995,1176044.5099999998
4376,U39567,225,-50179.19,208,17,193407.81999999998,143228.62999999998
4377,U1118320,225,-22144.890000000003,137,88,178718.21999999997,156573.32999999996
4378,U20276,225,-13800.590000000007,212,13,71238.98999999999,57438.39999999998
4379,U17714,225,-2622.3499999999767,184,41,1215036.7999999998,1212414.4499999997
4380,U9727,225,32548.280000000042,212,13,205501.60999999987,238049.8899999999
4381,U39025,225,-68477.80999999992,179,46,3795496.9700000007,3727019.1600000006
4382,U32859,224,4685.109999999986,205,19,110793.71000000002,115478.82
4383,U12740,224,2911.37,139,85,369348.91000000003,372260.28
4384,U14452,224,27615.069999999985,201,23,19027.959999999992,46643.02999999998
4385,U42815,224,-36842.509999999995,166,58,350345.99999999994,313503.48999999993
4386,U13735,224,1778.5800000000036,204,20,29847.610000000008,31626.19000000001
4387,U18976,224,-42988.060000000005,173,51,366101.22999999986,323113.16999999987
4388,U15415,224,950.419999999991,118,106,801920.4,802870.8200000001
4389,U15578,224,-11804.859999999993,196,28,93823.5,82018.64000000001
4390,U39723,224,6138.769999999994,206,18,80656.64,86795.40999999999
4391,U32720,224,249295.7399999999,204,20,386636.63000000006,635932.37
4392,U8794,224,-1440.8099999999936,180,44,162350.23999999996,160909.42999999996
4393,U18757,224,118074.30999999998,185,39,187499.44,305573.75
4394,U24048,224,489.4299999999919,208,16,119806.01999999997,120295.44999999997
4395,U29046,224,1218.820000000007,109,115,9351427.43,9352646.25
4396,U14770,224,18017.600000000002,203,21,145306.96999999997,163324.56999999998
4397,U37838,224,-5200.340000000003,192,32,86759.47000000006,81559.13000000006
4398,U23357,224,15300.030000000008,210,14,328129.2700000001,343429.3000000001
4399,U38847,224,-51748.36000000003,210,14,238183.86000000002,186435.5
4400,U41843,224,-9393.260000000002,197,27,265864.79,256471.52999999997
4401,U25154,224,195.77999999999997,171,53,19136.45,19332.23
4402,U34461,224,-1409.6300000000028,189,35,64602.250000000015,63192.62000000001
4403,U22783,224,83046.95,196,28,528707.24,611754.19
4404,U36795,224,-912.7500000000091,207,17,64967.01000000001,64054.26
4405,U40326,224,-13729.339999999991,211,13,55997.42000000001,42268.08000000002
4406,U23693,224,601.6000000000131,131,93,564030.63,564632.23
4407,U37625,224,186.8900000000126,189,35,205996.83999999997,206183.72999999998
4408,U9074,224,43977.15999999999,215,9,23063.16,67040.31999999999
4409,U29005,224,-62444.430000000066,211,13,456910.2800000001,394465.85000000003
4410,U24887,224,1747.8699999999974,179,45,427789.32999999984,429537.19999999984
4411,U30398,224,5181.750000000036,134,90,1072925.9100000001,1078107.6600000001
4412,U11136,224,-20825.28,141,83,987136.06,966310.78
4413,U34096,224,102638.94000000009,127,97,234295.33999999997,336934.28
4414,U41399,223,-34242.57000000004,204,19,542748.0900000002,508505.52000000014
4415,U36710,223,-33702.50000000001,218,5,50573.06000000001,16870.560000000005
4416,U31973,223,1507.290000000002,197,26,32143.590000000004,33650.880000000005
4417,U15265,223,-6286.839999999999,213,10,41464.19,35177.350000000006
4418,U8349,223,-50665.83000000001,209,14,170083.1,119417.26999999999
4419,U20369,223,31869.68999999998,209,14,103397.93,135267.61999999997
4420,U30687,223,12243.910000000033,166,57,1198791.3399999999,1211035.25
4421,U20085,223,67875.38999999998,190,33,108092.74000000002,175968.13
4422,U39155,223,110769.14999999994,191,32,1018253.0200000001,1129022.1700000002
4423,U9990,223,-13709.709999999992,197,26,72265.68,58555.97
4424,U15401,223,1195.049999999974,198,25,220142.72999999998,221337.77999999997
4425,U43460,223,199280.33000000002,139,84,1500451.3099999998,1699731.64
4426,U14320,223,-4304.550000000003,167,56,281350.5900000002,277046.0400000002
4427,U40908,223,16337.30999999994,171,52,3826383.15,3842720.46
4428,U23590,223,-1408895.6000000006,159,64,10929900.39,9521004.79
4429,U27995,223,-1560.6900000000478,111,112,806262.14,804701.45
4430,U9730,223,1494.7000000000137,177,46,99049.29000000001,100543.99000000002
4431,U34812,223,-6272.620000000019,183,40,111803.48000000003,105530.86
4432,U22441,223,3474.529999999999,210,13,22415.599999999995,25890.129999999994
4433,U1338026,223,2129.7900000000022,134,89,77724.68,79854.47
4434,U17900,223,27461.179999999986,199,24,229805.61000000002,257266.79
4435,U27194,223,157836.64999999967,141,82,6093323.81,6251160.459999999
4436,U32091,223,-5542.699999999997,204,19,58272.12000000002,52729.42000000002
4437,U28434,223,3351.8100000000004,165,58,483304.9000000001,486656.7100000001
4438,U32256,223,8556.740000000009,111,112,482955.3400000002,491512.0800000002
4439,U30868,223,-95477.96999999999,201,22,141761.84,46283.87000000001
4440,U22678,223,-2891.4400000000023,175,48,107076.05,104184.61
4441,U15634,223,-9612.789999999852,162,61,1578764.1300000004,1569151.3400000005
4442,U23267,223,-3028.880000000013,210,13,1676901.8199999996,1673872.9399999995
4443,U837533,223,-3670.5499999999993,119,104,36519.39,32848.84
4444,U11054,223,-5028.339999999991,209,14,77574.46,72546.12000000001
4445,U14263,223,-93262.08999999879,207,16,1834704.3499999992,1741442.2600000005
4446,U39090,223,22855.079999999998,184,39,173481.54999999996,196336.62999999995
4447,U26622,223,-119471.72,211,12,221486.34999999995,102014.62999999995
4448,U31086,223,70210.0999999998,199,24,497205.85999999987,567415.9599999997
4449,U41791,223,9376.839999999998,214,9,71684.76000000001,81061.6
4450,U14000,223,11591.94000000001,188,35,510982.04999999993,522573.98999999993
4451,U28061,223,-49410.819999999985,133,90,706312.51,656901.6900000001
4452,U24806,223,-62936.830000000016,199,24,361699.63,298762.8
4453,U27122,223,-4983.31999999999,162,61,50616.25999999998,45632.93999999999
4454,U41198,223,477.11000000000513,157,66,85053.6,85530.71
4455,U9691,222,59798.16,199,23,108899.75,168697.91
4456,U43640,222,5518.77999999997,203,19,510618.4100000001,516137.19000000006
4457,U18745,222,-7272.1700000001,176,46,1163543.2900000003,1156271.12
4458,U18229,222,-58122.10000000002,208,14,113508.84999999999,55386.74999999997
4459,U31395,222,958.8899999999926,197,25,41487.36000000001,42446.25
4460,U15133,222,-84850.85999999999,170,52,539232.56,454381.70000000007
4461,U23889,222,-145357.8,135,87,774256.9199999999,628899.1199999999
4462,U11330,222,-23944.270000000084,157,65,899287.5699999998,875343.2999999997
4463,U12035,222,20105.41999999998,169,53,578348.4500000003,598453.8700000002
4464,U28701,222,34944.059999999976,127,95,1291773.0699999998,1326717.13
4465,U9898,222,14112.659999999994,204,18,44612.28999999997,58724.94999999997
4466,U38277,222,-11360.829999999938,167,55,1902640.7600000002,1891279.9300000004
4467,U17546,222,49517.75,204,18,209691.8200000001,259209.5700000001
4468,U32582,222,-15714.109999999982,197,25,189587.65000000005,173873.54000000007
4469,U30942,222,-37732.339999999975,208,14,278290.80000000016,240558.4600000002
4470,U37534,222,5013.59,219,3,5671.470000000001,10685.060000000001
4471,U43893,222,-4228.049999999998,176,46,102313.13,98085.08
4472,U24396,222,-12879.939999999988,198,24,198955.16999999998,186075.22999999998
4473,U23924,222,15219.649999999996,211,11,25208.019999999997,40427.66999999999
4474,U15439,222,9070.05,202,20,114161.51000000002,123231.56000000003
4475,U29762,222,-120386.15999999989,152,70,468510.30999999936,348124.14999999944
4476,U24315,222,-39551.47999999992,199,23,266804.5099999998,227253.02999999985
4477,U39381,222,-1961.7800000000382,150,72,2599787.8600000003,2597826.08
4478,U41141,222,-10905.860000000004,197,25,69547.60999999999,58641.749999999985
4479,U22717,222,-5223.910000000013,173,49,293233.48,288009.56999999995
4480,U22681,222,6834.070000000007,205,17,264836.30999999994,271670.37999999995
4481,U9628,222,-55773.31000000003,208,14,156370.76999999996,100597.45999999993
4482,U13492,222,-16203.969999999998,170,52,220841.55000000002,204637.58000000002
4483,U20713,222,-559151.55,213,9,659608.05,100456.5
4484,U20393,222,-63746.56999999997,155,67,755457.0700000005,691710.5000000006
4485,U40090,222,-60414.38,204,18,262983.1400000001,202568.76000000007
4486,U34766,222,84634.59999999999,197,25,50113.99,134748.59
4487,U18544,222,-13942.900000000012,178,44,269592.88,255649.97999999998
4488,U15333,222,7640.3099999999995,208,14,122269.22999999997,129909.53999999996
4489,U20744,222,-931684.0000000002,206,16,5713549.850000001,4781865.850000001
4490,U35957,222,297.97999999999865,213,9,14489.16,14787.14
4491,U11508,222,6005.039999999994,179,43,166636.33999999994,172641.37999999995
4492,U9578,222,-121449.58000000002,161,61,2076418.1799999997,1954968.5999999996
4493,U29824,222,-17507.320000000007,211,11,186362.52999999985,168855.20999999985
4494,U26097,221,70193.22999999998,204,17,318797.49999999994,388990.7299999999
4495,U17384,221,19401.86999999998,159,62,465762.07999999984,485163.94999999984
4496,U8640,221,236902.24999999988,173,48,2800331.34,3037233.59
4497,U15922,221,-34240.120000000024,173,48,104959.40000000005,70719.28000000003
4498,U14801,221,-5545.399999999956,142,79,863018.7300000008,857473.3300000009
4499,U14257,221,4720.299999999998,171,50,119677.11,124397.41
4500,U8436,221,-14524.139999999996,165,56,296340.66,281816.51999999996
4501,U29293,221,49812.31000000001,199,22,246972.98999999996,296785.3
4502,U8991,221,-39490.16000000002,83,138,370404.64999999985,330914.4899999998
4503,U21420,221,14.639999999959173,178,43,1397930.8499999996,1397945.4899999995
4504,U22755,221,-2954.0999999999967,210,11,35822.55000000001,32868.45000000001
4505,U29788,221,-308.39999999999964,126,95,20622.819999999996,20314.42
4506,U25272,221,1371.9500000000116,174,47,502220.19,503592.14
4507,U41819,221,-9134.37000000002,166,55,2568324.199999998,2559189.8299999977
4508,U42122,221,1678.7300000000014,202,19,31791.62,33470.35
4509,U18415,221,20130.45000000014,202,19,41237.329999999856,61367.78
4510,U29500,221,894.8500000000004,211,10,16807.79,17702.64
4511,U30113,221,-16502.110000000022,198,23,282738.6400000001,266236.53
4512,U26204,221,12971.509999999998,188,33,52456.18,65427.69
4513,U11583,221,-7533.560000000001,191,30,167087.71999999997,159554.15999999997
4514,U1184632,221,-447.5399999999996,122,99,25543.069999999996,25095.529999999995
4515,U26005,221,-24844.169999999995,204,17,83628.26000000001,58784.09000000001
4516,U16290,221,-31179.500000000007,177,44,363450.29999999993,332270.79999999993
4517,U21844,221,-20907.14999999999,168,53,298321.6100000001,277414.46000000014
4518,U16015,221,-1699.8199999995904,187,34,5968442.569999999,5966742.75
4519,U13639,221,-150327.61,174,47,1093335.2200000002,943007.6100000002
4520,U25816,221,78211.20999999999,204,17,140806.12999999998,219017.33999999997
4521,U38992,221,-319.23000000001116,199,22,101726.73999999999,101407.50999999998
4522,U25010,221,59804.62000000002,211,10,527759.5,587564.12
4523,U16308,221,-40131.530000000115,206,15,454987.4400000001,414855.91000000003
4524,U15556,221,32552.920000000006,124,97,437800.12000000005,470353.04000000004
4525,U12386,221,9275.090000000011,174,47,185337.87,194612.96000000002
4526,U24022,221,6789.330000000014,109,112,3702038.040000001,3708827.370000001
4527,U24014,221,7052.230000000156,164,57,4234544.73,4241596.960000001
4528,U12930,221,-4554.070000000036,178,43,344017.31999999995,339463.2499999999
4529,U11503,221,-20818.190000000002,184,37,277848.29,257030.09999999998
4530,U19576,221,6307.800000000013,187,34,183400.46000000002,189708.26000000004
4531,U11018,221,23641.589999999993,207,14,63805.18000000001,87446.77
4532,U12955,221,3147.1699999999746,177,44,2676740.5599999996,2679887.7299999995
4533,U34744,221,-35847.31999999998,192,29,1329326.2600000002,1293478.9400000002
4534,U22182,221,7527.610000000002,197,24,222303.22,229830.83000000002
4535,U13051,221,700.5700000000031,202,19,66317.65000000002,67018.22000000003
4536,U27499,221,-26742.950000000004,185,36,282454.82999999996,255711.87999999995
4537,U25205,221,-1804.5000000000036,170,51,16364.81,14560.309999999996
4538,U39126,221,89858.22,204,17,364489.50999999995,454347.73
4539,U15284,220,-150722.86999999994,194,26,675946.9100000004,525224.0400000005
4540,U28045,220,141861.76,205,15,1450160.2000000007,1592021.9600000007
4541,U35629,220,415.83999999999907,194,26,39201.28999999999,39617.12999999999
4542,U38630,220,15781.84,209,11,12284.290000000005,28066.130000000005
4543,U24510,220,-28729.870000000006,194,26,96393.41,67663.54
4544,U37988,220,3786.6899999999982,206,14,36129.600000000006,39916.29
4545,U27276,220,-7168.0400000000045,200,20,36995.890000000014,29827.85000000001
4546,U40596,220,-68339.31000000003,204,16,345260.42000000016,276921.1100000001
4547,U34532,220,-65856.04999999999,165,55,668276.28,602420.23
4548,U20105,220,1347.1899999999987,177,43,196337.86000000002,197685.05000000002
4549,U17045,220,256321.85,186,34,589456.5800000003,845778.4300000003
4550,U40955,220,-177287.53000000006,140,80,1749874.57,1572587.04
4551,U37441,220,-12899.090000000064,197,23,763650.2100000001,750751.12
4552,U26289,220,347525.5300000014,191,29,20424519.789999995,20772045.319999997
4553,U11685,220,20072.430000000026,175,45,729011.55,749083.9800000001
4554,U23571,220,-5437.339999999995,169,51,308199.39000000013,302762.05000000016
4555,U26545,220,-125117.37999999875,124,96,15611680.290000001,15486562.910000002
4556,U34242,220,15020.340000000022,188,32,576842.6500000001,591862.9900000001
4557,U28769,220,23028.570000000007,185,35,122639.26000000004,145667.83000000005
4558,U19972,220,-15944.149999999987,159,61,481322.98,465378.83
4559,U12414,220,904.7999999999985,213,7,8635.019999999999,9539.819999999998
4560,U42156,220,-133810.82000000007,172,48,619199.8699999999,485389.0499999998
4561,U17393,220,-14356.929999999953,142,78,7310334.399999999,7295977.47
4562,U36601,220,69285.87000000002,184,36,451025.44999999995,520311.31999999995
4563,U9822,220,-4524.960000000002,210,10,24156.079999999998,19631.119999999995
4564,U1208301,220,0.029999999998835847,124,96,247080.74,247080.77
4565,U17362,220,60935.20000000005,188,32,1245491.4899999995,1306426.6899999995
4566,U24855,220,41794.270000000004,206,14,8806.620000000003,50600.89000000001
4567,U14692,220,68416.42000000001,208,12,33064.23000000001,101480.65000000002
4568,U34162,220,3452.290000000001,209,11,19577.75,23030.04
4569,U34433,220,8302.949999999977,155,65,566417.71,574720.6599999999
4570,U11737,220,499.98999999999853,180,40,183891.08000000002,184391.07
4571,U34482,220,-5963.209999999996,194,26,37723.80000000001,31760.590000000015
4572,U17850,220,-1461.6000000000058,189,31,504905.65,503444.05000000005
4573,U14338,220,28129.03,173,47,144395.98999999996,172525.01999999996
4574,U38457,220,-7569.820000000007,205,15,41926.56999999997,34356.74999999996
4575,U43582,220,79818.41,203,17,167237.15,247055.56
4576,U41004,220,-35921.61000000007,209,11,140232.65000000005,104311.03999999998
4577,U8872,220,6674.390000000009,206,14,58287.85000000001,64962.24000000002
4578,U607341,220,-8202.999999999989,158,62,142917.79000000004,134714.79000000004
4579,U33491,220,3406.1599999999858,211,9,74295.77,77701.93
4580,U1171532,220,-2577.5499999999843,137,83,512466.57,509889.02
4581,U17101,220,14643.750000000095,200,20,443549.6500000002,458193.4000000003
4582,U1096473,220,0.2499999999997567,114,106,4354.51,4354.76
4583,U29769,220,7184.820000000025,122,98,1183488.0400000003,1190672.8600000003
4584,U41515,219,-67100.64999999998,210,9,582203.63,515102.98000000004
4585,U21168,219,13069.63999999997,172,47,339259.68000000005,352329.32
4586,U17464,219,-1313.0499999999902,193,26,460393.59,459080.54000000004
4587,U13481,219,18068.249999999996,203,16,59487.770000000004,77556.02
4588,U28916,219,-75260.46000000002,205,14,320036.32999999984,244775.86999999982
4589,U30519,219,-14921.67999999999,195,24,469564.15,454642.47000000003
4590,U1212579,219,-0.11000000000017734,124,95,5026.650000000001,5026.54
4591,U27141,219,22583.679999999946,177,42,7315287.090000001,7337870.7700000005
4592,U25545,219,-15891.190000000011,202,17,225218.2499999999,209327.0599999999
4593,U43377,219,-26872.749999999996,197,22,301213.22,274340.47
4594,U17261,219,22115.97999999995,148,71,961706.4999999999,983822.4799999999
4595,U14222,219,-24572.25999999996,142,77,647368.2200000001,622795.9600000001
4596,U19536,219,-134.67000000000067,207,12,15748.569999999994,15613.899999999994
4597,U36625,219,-13673.840000000007,198,21,103623.23,89949.38999999998
4598,U31829,219,-4257.319999999971,149,70,171170.85000000003,166913.53000000006
4599,U36701,219,5710.160000000002,199,20,80807.01000000001,86517.17000000001
4600,U21091,219,-820783.06,201,18,2444853.64,1624070.58
4601,U11892,219,122891.94999999994,156,63,583943.3499999996,706835.2999999996
4602,U13186,219,168039.53000000003,192,27,291744.1099999998,459783.63999999984
4603,U30489,219,-4066.2399999999993,198,21,156209.00999999995,152142.76999999996
4604,U29344,219,12528.96,206,13,53607.92000000003,66136.88000000003
4605,U9539,219,-131726.56,185,34,564655.84,432929.27999999997
4606,U30871,219,-108774.98,188,31,582896.9900000002,474122.01000000024
4607,U30789,219,-50072.350000000006,209,10,138775.41,88703.06
4608,U39094,219,36020.03,124,95,500748.16000000003,536768.1900000001
4609,U34144,219,-4551.569999999995,180,39,54595.42,50043.850000000006
4610,U14024,219,1019.279999999987,202,17,24546.990000000013,25566.27
4611,U24498,219,-1994.9500000000207,191,28,423065.35000000003,421070.4
4612,U27289,219,-276.77999999999884,183,36,288322.45,288045.67000000004
4613,U31443,219,17301.02999999997,185,34,227177.28000000003,244478.31
4614,U13445,219,236871.64999999997,185,34,1078970.3099999998,1315841.9599999997
4615,U15436,219,18974.190000000002,175,44,262334.66,281308.85
4616,U23343,219,-10359.099999999982,201,18,386645.15,376286.05000000005
4617,U9702,219,-25723.23999999998,134,85,102524.8199999999,76801.57999999993
4618,U32171,219,-983.2599999999989,170,49,45554.500000000015,44571.24000000001
4619,U8152,219,-7673.6399999999985,211,8,33795.31,26121.67
4620,U22427,219,6034.680000000002,191,28,55943.62000000001,61978.30000000001
4621,U28584,219,-11011.459999999988,86,133,793731.2000000001,782719.7400000001
4622,U33104,219,-1705.5999999999976,205,14,27090.219999999998,25384.62
4623,U16522,219,132777.6499999999,175,44,4889980.01,5022757.66
4624,U43428,219,-265.220000000002,165,54,76030.59,75765.37
4625,U11458,219,-5340.629999999976,154,65,413260.65,407920.02
4626,U36696,219,-16945.54999999999,182,37,689515.77,672570.22
4627,U21248,219,-82.72000000000031,208,11,29111.620000000003,29028.9
4628,U8388,219,11967.129999999997,193,26,98104.01000000001,110071.14000000001
4629,U38628,219,13466.000000000005,199,20,100516.86000000002,113982.86000000002
4630,U39261,219,-42482.089999999975,193,26,185819.40999999997,143337.32
4631,U40645,219,-2638.61,147,72,36451.26,33812.65
4632,U37220,219,-67724.08999999998,184,35,1376413.41,1308689.3199999998
4633,U37788,219,171205.0399999999,150,69,1699642.47,1870847.5099999998
4634,U15678,219,19543.280000000006,194,25,791436.7900000002,810980.0700000002
4635,U40966,219,3891.420000000002,213,6,40957.73999999999,44849.15999999999
4636,U31833,219,3223.119999999999,70,149,74240.04000000001,77463.16
4637,U29275,219,6569.619999999999,156,63,126115.41,132685.03
4638,U11516,219,-719210.45,183,36,4708765.0200000005,3989554.5700000003
4639,U19608,219,19578.17,204,15,14939.439999999995,34517.60999999999
4640,U1073784,218,-5845.060000000005,151,67,48179.52999999997,42334.469999999965
4641,U17710,218,-231295.44999999998,158,60,825250.1000000002,593954.6500000003
4642,U15675,218,166860.23000000068,181,37,7536223.300000001,7703083.530000001
4643,U38475,218,1027.5500000000038,207,11,13615.099999999997,14642.650000000001
4644,U20462,218,-6092.549999999949,155,63,804878.0899999997,798785.5399999998
4645,U11250,218,-117415.13000000006,206,12,173636.14,56221.00999999995
4646,U20270,218,8061.59999999998,205,13,179842.09000000005,187903.69000000003
4647,U39934,218,-5972.229999999975,115,103,725376.7100000001,719404.4800000001
4648,U31387,218,-289.73999999999876,196,22,49635.55,49345.810000000005
4649,U43633,218,-2134.6999999999957,201,17,46521.330000000016,44386.63000000002
4650,U619324,218,-17883.27,152,66,170340.05,152456.78
4651,U42758,218,-3303.790000000001,141,77,433398.70000000007,430094.9100000001
4652,U12502,218,-1405.2699999999977,170,48,189831.65000000002,188426.38000000003
4653,U13162,218,-387.8799999999969,201,17,59093.74000000001,58705.860000000015
4654,U8713,218,-56206.56,192,26,260669.81,204463.25
4655,U26562,218,1722.3900000000026,181,37,290346.5500000001,292068.9400000001
4656,U17345,218,238278.1999999999,194,24,468907.8499999999,707186.0499999998
4657,U14845,218,-49074.539999999746,189,29,1330781.6100000006,1281707.0700000008
4658,U35878,218,7033.760000000003,156,62,520497.0999999999,527530.8599999999
4659,U23660,218,18999.420000000013,200,18,374822.5999999996,393822.01999999967
4660,U39724,218,-125095.03000000003,207,11,285927.46,160832.43
4661,U23940,218,-13840.489999999985,155,63,282232.6399999999,268392.1499999999
4662,U41957,218,-305.98999999999955,183,35,40801.31999999999,40495.329999999994
4663,U10889,218,8254.309999999994,147,71,699029.83,707284.1399999999
4664,U40385,218,-9035.289999999995,204,14,50588.35,41553.060000000005
4665,U14440,218,-102934.33000000003,154,64,1667073.29,1564138.96
4666,U17915,218,3396.4800000000105,155,63,286345.52,289742.0
4667,U24516,218,-99649.83,206,12,383275.11000000016,283625.28000000014
4668,U973396,218,18329.260000000002,136,82,48116.84000000001,66446.1
4669,U41659,218,142922.6900000002,191,27,2323540.299999999,2466462.9899999993
4670,U20795,218,20913.24999999983,192,26,2289097.47,2310010.72
4671,U40296,218,34990.159999999996,202,16,193347.15,228337.31
4672,U10083,218,36544.03999999999,210,8,27982.669999999995,64526.70999999999
4673,U21158,218,5001.150000000009,196,22,47380.520000000004,52381.67000000001
4674,U15597,218,-76261.12,165,53,489571.83,413310.71
4675,U39488,218,-20850.180000000008,207,11,72633.66999999997,51783.48999999996
4676,U10259,218,-28698.659999999996,152,66,306579.51,277880.85000000003
4677,U16537,218,1074.6899999999978,206,12,139868.13999999998,140942.83
4678,U42229,218,-3699.4300000000076,197,21,1162500.1300000001,1158800.7000000002
4679,U30247,218,-4063.710000000001,202,16,217361.84999999998,213298.13999999998
4680,U42760,218,-1660.9600000000012,178,40,189357.86999999997,187696.90999999997
4681,U27336,218,-18392.359999999997,190,28,127349.46,108957.1
4682,U13404,218,7744.320000000006,186,32,48483.32999999997,56227.64999999998
4683,U25464,218,-10414.400000000009,205,13,96415.95000000003,86001.55000000002
4684,U20476,218,286827.18999999994,158,60,3963509.31,4250336.5
4685,U16971,218,42472.15000000001,144,74,158669.45,201141.60000000003
4686,U29774,217,-15847.569999999978,156,61,461184.3000000001,445336.7300000001
4687,U12058,217,-4679.469999999997,200,17,54637.99,49958.520000000004
4688,U15996,217,1043.4500000000044,191,26,615614.06,616657.51
4689,U24491,217,-32344.750000000113,155,62,1418967.45,1386622.7
4690,U27735,217,115173.1,173,44,434648.1300000002,549821.2300000002
4691,U14380,217,-8188.670000000347,184,33,3922704.8000000003,3914516.13
4692,U32058,217,154338.85000000018,144,73,4148871.76,4303210.61
4693,U20087,217,33930.05999999997,191,26,382737.29999999946,416667.3599999994
4694,U26326,217,125198.0399999999,151,66,471261.6699999999,596459.7099999998
4695,U1219173,217,-5799.079999999999,138,79,50471.01999999999,44671.93999999999
4696,U13589,217,-105621.95000000004,189,28,591044.94,485422.9899999999
4697,U28478,217,41572.58,108,109,1371099.490000001,1412672.070000001
4698,U29696,217,-7393.239999999999,210,7,23325.379999999994,15932.139999999996
4699,U32862,217,3936.8999999999974,174,43,109669.36999999997,113606.26999999996
4700,U27461,217,17726.07,150,67,40504.22000000001,58230.29000000001
4701,U43799,217,-2986.8000000000034,188,29,91119.38999999997,88132.58999999997
4702,U43752,217,12752.720000000001,194,23,330466.54,343219.26
4703,U36974,217,14307.609999999997,158,59,106630.82999999999,120938.43999999999
4704,U20177,217,-38996.139999999956,169,48,305504.5800000001,266508.4400000001
4705,U32536,217,-15403.89999999999,140,77,290517.14999999997,275113.25
4706,U34716,217,-10833.89,194,23,270421.72,259587.82999999996
4707,U29210,217,-49498.22000000001,112,105,1619426.5699999998,1569928.3499999999
4708,U756326,217,-1856.3300000000008,176,41,7184.6900000000005,5328.36
4709,U18088,217,65666.91000000002,155,62,1165650.4299999997,1231317.3399999996
4710,U26725,217,-3035.61000000022,189,28,1966513.0200000003,1963477.41
4711,U38767,217,38498.07,179,38,127666.15,166164.22
4712,U12201,217,32013.779999999977,142,75,624528.1300000002,656541.9100000003
4713,U16039,217,1329920.0700000008,201,16,306812.0999999999,1636732.1700000006
4714,U9530,217,31751.650000000056,187,30,506346.7400000001,538098.3900000001
4715,U41380,217,-260.6500000000815,208,9,596389.2599999999,596128.6099999999
4716,U1103247,217,-4836.33,127,90,14974.619999999999,10138.289999999999
4717,U18483,217,-10752.659999999993,211,6,91974.04000000001,81221.38000000002
4718,U38775,217,-2893.4699999999957,197,20,195771.15000000005,192877.68000000005
4719,U28608,217,-101025.57999999999,203,14,109004.73999999998,7979.159999999989
4720,U30006,217,59191.98999999999,173,44,198053.06,257245.05
4721,U35063,217,-12078.649999999943,196,21,617741.7000000001,605663.0500000002
4722,U9797,217,11453.77000000004,86,131,1678694.48,1690148.25
4723,U26723,217,-35002.78,188,29,175338.84,140336.06
4724,U10292,217,31489.359999999986,203,14,42789.79000000001,74279.15
4725,U20524,217,-38012.85000000002,193,24,176861.78999999995,138848.93999999994
4726,U32865,217,19108.239999999987,191,26,108649.69999999997,127757.93999999996
4727,U21761,217,-30075.23999999999,163,54,2006039.5099999998,1975964.2699999998
4728,U20465,217,-138352.71999999997,209,8,270818.68999999994,132465.96999999997
4729,U947243,217,-166.8099999999997,113,104,20228.67,20061.859999999997
4730,U8034,216,-5841.419999999998,196,20,43145.08000000001,37303.66000000001
4731,U33853,216,255646.58999999997,149,67,1396854.66,1652501.25
4732,U34492,216,-35054.22000000002,207,9,98883.49999999994,63829.27999999992
4733,U29311,216,3244590.790000003,171,45,18536612.929999996,21781203.72
4734,U13538,216,48918.56999999999,156,60,1993219.4899999998,2042138.0599999998
4735,U10902,216,3975.79,206,10,15146.079999999993,19121.86999999999
4736,U17310,216,118237.24999999994,169,47,3403105.9,3521343.15
4737,U14405,216,-1116.1700000000183,101,115,2676300.5599999996,2675184.3899999997
4738,U985303,216,39.730000000009596,123,93,150494.39999999997,150534.12999999998
4739,U38443,216,1494.3099999999974,197,19,72076.62999999995,73570.93999999994
4740,U21705,216,11029.760000000017,169,47,310502.13999999996,321531.89999999997
4741,U33309,216,386095.91000000003,66,150,1676916.3699999999,2063012.2799999998
4742,U10506,216,12050.790000000003,142,74,1366489.85,1378540.6400000001
4743,U30696,216,38676.85999999997,195,21,437841.50000000035,476518.36000000034
4744,U25580,216,8219.870000000037,110,106,1943484.3199999998,1951704.19
4745,U21949,216,-83718.45,138,78,1007205.5300000003,923487.0800000003
4746,U40008,216,-17145.119999999988,176,40,73296.78000000004,56151.660000000054
4747,U38753,216,6711.890000000094,181,35,861983.2800000001,868695.1700000003
4748,U12463,216,9617.12000000001,181,35,140601.8799999998,150218.99999999983
4749,U12760,216,40920.060000000005,185,31,137603.72,178523.78
4750,U37371,216,3813.120000000001,209,7,11961.72,15774.84
4751,U20489,216,138.55999999999977,184,32,34601.329999999994,34739.88999999999
4752,U17140,216,-102731.44999999998,166,50,1023094.7799999999,920363.33
4753,U10340,216,-1315.6600000000053,140,76,168157.04999999996,166841.38999999996
4754,U8597,216,-47207.06000000002,153,63,521138.1900000003,473931.1300000003
4755,U14569,216,-103565.73999999999,200,16,411167.68999999994,307601.94999999995
4756,U13411,216,3560.8399999999992,104,112,102196.90000000001,105757.74
4757,U14224,216,-119284.72000000002,206,10,266490.3,147205.57999999996
4758,U39341,216,1453.8799999999983,214,2,17343.340000000004,18797.22
4759,U33476,216,-14606.699999999997,181,35,91928.37,77321.67
4760,U33939,216,-1269.1899999999994,210,6,14624.709999999995,13355.519999999997
4761,U933609,216,-2.730000000001951,129,87,78239.76000000001,78237.03000000001
4762,U1171288,216,5.069999999999254,125,91,18430.56000000001,18435.63000000001
4763,U36667,216,-7657.089999999996,200,16,57285.08999999999,49627.99999999999
4764,U10682,216,10341.839999999997,193,23,120642.20000000001,130984.04000000001
4765,U12029,216,-19135.899999999998,200,16,94952.33000000003,75816.43000000004
4766,U33907,216,3502.720000000002,188,28,31992.800000000003,35495.520000000004
4767,U31215,216,384965.4000000001,170,46,1863710.0999999999,2248675.5
4768,U30794,216,15838.23,192,24,86823.19,102661.42
4769,U1180799,216,299.9999999999999,111,105,6757.070000000001,7057.070000000001
4770,U41549,216,-1995.490000000002,207,9,79958.50000000001,77963.01000000001
4771,U10933,216,-4645.970000000012,198,18,259704.82000000004,255058.85000000003
4772,U28678,216,69029.19,168,48,3187959.0799999996,3256988.2699999996
4773,U36425,216,1961.0400000000116,172,44,374534.1799999999,376495.2199999999
4774,U35219,216,-35349.950000000346,190,26,2251848.08,2216498.13
4775,U18129,216,2174.6499999999996,188,28,56158.68,58333.33
4776,U26176,216,14512.470000000041,152,64,620607.6399999999,635120.11
4777,U14873,216,13139.400000000012,187,29,480632.3100000001,493771.71000000014
4778,U37698,216,-24632.27000000006,163,53,967630.5200000001,942998.2500000001
4779,U16706,216,77041.4,164,52,2997598.44,3074639.84
4780,U26911,216,7796.960000000026,172,44,211790.63,219587.59000000003
4781,U15219,215,-11749.110000000057,172,43,811140.8100000009,799391.7000000008
4782,U22821,215,16016.780000000002,188,27,302174.1100000004,318190.8900000004
4783,U12092,215,-14951.869999999995,205,10,35149.38,20197.510000000002
4784,U15565,215,7923.220000000007,184,31,115915.33,123838.55
4785,U33182,215,-650.949999999997,186,29,34327.330000000016,33676.38000000002
4786,U31790,215,-108620.70000000006,179,36,152894.47999999998,44273.779999999926
4787,U34649,215,-423.98000000005413,106,109,4822296.2,4821872.22
4788,U24864,215,2747.359999999999,178,37,137490.03000000003,140237.39
4789,U29712,215,6207.410000000002,205,10,47992.54,54199.950000000004
4790,U20296,215,1346.5799999999936,195,20,161389.59999999998,162736.17999999996
4791,U13252,215,-8860.640000000005,202,13,54228.600000000006,45367.96
4792,U9251,215,-35866.729999999996,193,22,243823.35999999993,207956.62999999995
4793,U39079,215,56244.270000000186,163,52,3755617.5599999996,3811861.8299999996
4794,U43695,215,1247.04,199,16,34650.759999999995,35897.799999999996
4795,U24036,215,-125643.59999999998,202,13,235197.25000000003,109553.65000000005
4796,U16697,215,-47025.0699999999,199,16,242942.21,195917.1400000001
4797,U15467,215,42925.659999999996,206,9,25865.929999999997,68791.59
4798,U31721,215,-2759.77,162,53,30221.239999999998,27461.469999999998
4799,U31167,215,-44772.88000000013,147,68,5282456.580000001,5237683.700000001
4800,U40026,215,-19328.820000000014,192,23,358129.4500000002,338800.6300000002
4801,U26355,215,3600.0699999999983,210,5,68766.89999999998,72366.96999999997
4802,U11886,215,-4365.540000000001,181,34,32317.410000000018,27951.870000000017
4803,U18905,215,-183288.38999999984,169,46,1074301.27,891012.8800000001
4804,U16445,215,-18258.69999999999,191,24,353166.6899999999,334907.9899999999
4805,U43604,215,-5051.340000000025,181,34,365834.52999999985,360783.1899999998
4806,U12710,215,81574.98999999987,147,68,3797019.88,3878594.8699999996
4807,U17089,215,-14614.12999999999,169,46,349109.73000000004,334495.60000000003
4808,U29562,215,1878.6100000000115,166,49,143282.70999999996,145161.31999999998
4809,U19167,215,417.61000000000143,201,14,12895.950000000004,13313.560000000005
4810,U18886,215,-9301.180000000031,198,17,164265.37000000005,154964.19000000003
4811,U11180,215,-53718.43000000002,195,20,330383.76999999984,276665.33999999985
4812,U25511,215,8278.409999999998,175,40,1732094.5799999996,1740372.9899999995
4813,U33272,215,-102463.10999999997,134,81,1178409.4300000004,1075946.3200000005
4814,U34071,215,20.359999999999133,209,6,21859.019999999997,21879.379999999997
4815,U29130,214,-121126.17999999993,203,11,418111.88,296985.70000000007
4816,U12465,214,4808.140000000001,154,60,105574.08000000002,110382.22000000002
4817,U25486,214,-8753.949999999997,200,14,31856.57,23102.620000000003
4818,U9617,214,124595.36000000006,178,36,1274730.35,1399325.7100000002
4819,U27288,214,-30876.63,169,45,56645.72,25769.09
4820,U30193,214,8945.520000000002,189,25,21888.199999999997,30833.72
4821,U27566,214,-9970.819999999992,185,29,75134.93000000001,65164.110000000015
4822,U26816,214,-81803.32999999999,170,44,220768.22999999992,138964.89999999994
4823,U16404,214,207398.85999999996,150,64,776387.8000000003,983786.6600000003
4824,U21159,214,44075.19000000002,171,43,1358143.6700000002,1402218.86
4825,U15489,214,-176437.31999999992,203,11,239198.84999999992,62761.53
4826,U42889,214,6612.5000000000055,145,69,63791.13,70403.63
4827,U29448,214,11654.489999999994,195,19,43425.19999999999,55079.68999999999
4828,U37414,214,23393.7499999998,170,44,290438.39999999997,313832.1499999998
4829,U24436,214,-1985333.7900000084,135,79,91819664.17,89834330.38
4830,U12711,214,-3181.629999999931,93,121,1231133.3399999999,1227951.71
4831,U10655,214,-97723.20000000003,205,9,154532.30000000002,56809.09999999999
4832,U32636,214,-202046.37000000002,203,11,247570.11,45523.73999999996
4833,U43284,214,-5097.109999999995,199,15,46675.69000000001,41578.580000000016
4834,U29628,214,-5738.410000000002,196,18,46084.59,40346.17999999999
4835,U8939,214,331502.76,194,20,356206.31999999995,687709.08
4836,U13246,214,7559.89,195,19,114403.44000000003,121963.33000000003
4837,U1144283,214,-11959.060000000003,153,61,343234.4400000001,331275.3800000001
4838,U42102,214,23042.89,192,22,167854.39999999997,190897.28999999998
4839,U32538,214,-254517.21000000005,142,72,2594776.67,2340259.46
4840,U39698,214,57434.19000000001,188,26,197363.16999999998,254797.36
4841,U22902,214,-1710.6300000000024,197,17,80853.75999999998,79143.12999999998
4842,U1194204,214,-13412.410000000007,161,53,264383.12,250970.71
4843,U10103,214,-10299.329999999994,156,58,478696.35,468397.01999999996
4844,U35385,214,1706.2699999999988,173,41,73862.69000000002,75568.96000000002
4845,U12486,214,13302.400000000023,152,62,1183124.3599999999,1196426.7599999998
4846,U9385,214,141999.30999999988,139,75,445514.95999999996,587514.2699999998
4847,U26935,214,-11507.73,200,14,109878.62,98370.89
4848,U32343,214,7474.310000000001,192,22,88007.20999999996,95481.51999999996
4849,U30843,214,57437.310000000005,195,19,67367.38,124804.69
4850,U10224,214,-7084.899999999998,198,16,47700.219999999994,40615.31999999999
4851,U24894,214,3755.449999999985,159,55,224900.82000000004,228656.27000000002
4852,U17179,214,34659.849999999984,178,36,3602704.5800000005,3637364.4300000006
4853,U36211,214,-4500.219999999986,189,25,146186.18,141685.96000000002
4854,U13937,214,7622.989999999957,134,80,819546.7899999998,827169.7799999998
4855,U20251,214,52393.11999999977,138,76,2763516.400000001,2815909.5200000005
4856,U29469,214,-4322.669999999997,195,19,27183.16,22860.49
4857,U35858,214,18051.11999999999,132,82,360525.37000000005,378576.49000000005
4858,U21875,214,1000.8800000002213,174,40,123500.73999999969,124501.61999999991
4859,U9260,214,3251.350000000022,182,32,624195.0799999998,627446.4299999998
4860,U29932,214,-209382.02000000005,169,45,1542546.02,1333164.0
4861,U17401,214,135099.71000000008,170,44,8456291.810000002,8591391.520000003
4862,U39574,214,104.52999999999969,192,22,17490.359999999993,17594.889999999992
4863,U12252,214,33847.31000000002,151,63,451941.24000000005,485788.55000000005
4864,U34030,214,14592.980000000003,191,23,101364.87,115957.85
4865,U30733,214,7803.089999999989,74,140,361581.68999999994,369384.7799999999
4866,U38892,214,1133.6900000000003,207,7,9137.41999999999,10271.10999999999
4867,U27588,214,-7967.330000000011,178,36,473046.43999999994,465079.1099999999
4868,U32874,213,-23986.64999999999,158,55,1017848.6999999998,993862.0499999998
4869,U13993,213,-323733.6500000001,102,111,1006893.5600000002,683159.9100000001
4870,U35006,213,-10986.07000000001,201,12,80548.94,69562.87
4871,U35971,213,3251.08,204,9,6329.44,9580.52
4872,U1354320,213,203.98999999999842,117,96,138779.33000000002,138983.32
4873,U17607,213,59704.850000000064,165,48,3800447.9799999986,3860152.8299999987
4874,U43557,213,4676.400000000006,201,12,13163.859999999997,17840.260000000002
4875,U26610,213,-6810.2099999999955,177,36,67434.77,60624.56000000001
4876,U19463,213,-4730.459999999995,171,42,328275.77,323545.31
4877,U33785,213,26813.28999999999,197,16,43215.42,70028.70999999999
4878,U8740,213,19694.140000000003,170,43,56541.759999999995,76235.9
4879,U12925,213,3790.1299999999937,199,14,173531.6800000001,177321.8100000001
4880,U15147,213,-3133.6200000000067,195,18,480178.75,477045.13
4881,U26924,213,463292.6499999999,114,99,2999623.8599999994,3462916.5099999993
4882,U13310,213,6930.919999999967,125,88,79611.55999999998,86542.47999999995
4883,U20133,213,-7974.630000000007,196,17,67798.94,59824.31
4884,U15682,213,9352.230000000016,138,75,157519.34999999998,166871.58
4885,U15860,213,771.9800000000305,130,83,695804.9999999999,696576.9799999999
4886,U15300,213,20258.589999999997,188,25,187810.79,208069.38
4887,U22089,213,-2515.0200000000254,184,29,460055.26999999996,457540.24999999994
4888,U24188,213,63039.33999999998,161,52,520687.79000000004,583727.13
4889,U28892,213,-25871.83999999999,165,48,300700.2099999999,274828.36999999994
4890,U10166,213,229028.03,191,22,4096641.469999999,4325669.499999999
4891,U42419,213,-6286.509999999991,191,22,128891.82999999996,122605.31999999996
4892,U32274,213,3108.1299999999865,191,22,194406.15000000002,197514.28
4893,U22861,213,5287.699999999997,200,13,94224.91,99512.61
4894,U9126,213,-4511.489999999985,181,32,1253859.2900000005,1249347.8000000005
4895,U38551,213,11311.45000000003,114,99,504666.82999999996,515978.27999999997
4896,U12772,213,-22272.059999999976,112,101,1549490.8600000006,1527218.8000000005
4897,U16005,213,35494.31000000001,96,117,3004466.640000001,3039960.950000001
4898,U17017,213,-547.4200000000458,169,44,3082899.9600000004,3082352.5400000005
4899,U42375,213,-3551.240000000001,196,17,39394.41000000001,35843.17000000001
4900,U25268,213,14012.9099999998,171,42,4605758.089999996,4619770.999999996
4901,U21176,213,-2770.4799999999996,192,21,23293.550000000007,20523.070000000007
4902,U12428,213,7629.520000000003,184,29,59075.69000000003,66705.21000000004
4903,U26701,212,-4930.03,207,5,8504.329999999998,3574.2999999999984
4904,U22316,212,-10642.089999999997,156,56,407622.29000000004,396980.20000000007
4905,U877351,212,-9970.61,130,82,163741.09,153770.47999999998
4906,U29115,212,-16708.220000000016,138,74,1544516.37,1527808.1500000001
4907,U17050,212,26903.45000000002,197,15,159165.6799999999,186069.12999999992
4908,U34036,212,1469.3700000000003,200,12,27058.670000000002,28528.04
4909,U41772,212,4514.610000000022,180,32,3361519.34,3366033.9499999997
4910,U37226,212,-11261.710000000036,163,49,101671.30999999995,90409.59999999992
4911,U18465,212,-23112.899999999998,141,71,607078.94,583966.0399999999
4912,U26116,212,-5707.490000000005,188,24,129417.56,123710.06999999999
4913,U43490,212,20395.929999999964,179,33,528641.64,549037.57
4914,U27579,212,4093.2900000000154,190,22,77696.27999999998,81789.57
4915,U38602,212,-798.1199999999917,195,17,129007.56000000003,128209.44000000003
4916,U42395,212,-1128.3299999999626,190,22,196121.6100000002,194993.28000000023
4917,U18945,212,-7740.699999999994,178,34,417022.37999999995,409281.67999999993
4918,U27156,212,37205.509999999966,198,14,66811.75,104017.25999999997
4919,U39506,212,-20198.94,196,16,44394.89999999998,24195.95999999998
4920,U20143,212,-463188.51,166,46,1856836.8199999998,1393648.3099999998
4921,U21437,212,-80514.28000000006,140,72,4610088.61,4529574.33
4922,U41064,212,5020.889999999979,189,23,172911.96,177932.84999999998
4923,U24871,212,8900.109999999986,141,71,631427.6100000001,640327.7200000001
4924,U10360,212,18825.69000000002,175,37,781138.38,799964.0700000001
4925,U35305,212,-20314.489999999994,198,14,102577.29000000004,82262.80000000005
4926,U42268,212,9509.120000000004,194,18,45012.82,54521.94
4927,U27910,212,583.3699999999919,189,23,26472.459999999985,27055.829999999976
4928,U43115,212,694.0899999999988,161,51,33118.52,33812.60999999999
4929,U15491,212,-290429.70999999996,192,20,2025570.11,1735140.4000000001
4930,U8125,212,-45787.17000000001,180,32,2100663.84,2054876.67
4931,U35956,212,-278942.16000000003,189,23,1770565.1,1491622.94
4932,U19571,212,125.25999999999294,122,90,664000.5499999999,664125.8099999999
4933,U13233,212,63209.06000000002,189,23,232236.8799999999,295445.9399999999
4934,U8415,212,-7713.490000000002,132,80,105980.82000000002,98267.33000000002
4935,U30108,212,-905624.4100000001,203,9,1116332.47,210708.05999999982
4936,U10534,212,-7956.209999999997,199,13,35036.09999999999,27079.889999999992
4937,U28153,212,32831.87999999999,167,45,655744.31,688576.1900000001
4938,U40251,212,892.3399999999992,195,17,34455.35000000002,35347.69000000002
4939,U9049,212,-7564.27999999997,90,122,574093.4299999999,566529.1499999999
4940,U21890,212,-53220.83999999999,187,25,482928.1499999999,429707.30999999994
4941,U31101,212,-1027.0400000000009,203,9,17986.189999999988,16959.149999999987
4942,U24599,212,10645.779999999993,199,13,40337.069999999985,50982.84999999998
4943,U43470,212,-1614.449999999998,193,19,62263.96000000003,60649.51000000003
4944,U13089,212,20983.220000000016,190,22,176055.28999999998,197038.51
4945,U17083,212,4593.499999999998,173,39,275424.7400000001,280018.2400000001
4946,U25935,211,-27675.679999999997,187,24,349775.6499999999,322099.9699999999
4947,U37599,211,-61968.06000000003,158,53,727913.3699999996,665945.3099999996
4948,U10887,211,-8685.619999999995,194,17,80154.44999999998,71468.82999999999
4949,U44032,211,913.6599999999889,201,10,83757.70000000001,84671.36
4950,U34503,211,-124002.0100000001,110,101,675995.7899999999,551993.7799999998
4951,U27484,211,52933.169999999984,165,46,355247.9199999999,408181.0899999999
4952,U12305,211,6835.5599999999895,182,29,107338.84000000001,114174.4
4953,U30858,211,92426.26999999999,117,94,438545.3700000001,530971.6400000001
4954,U27342,211,-192.62000000000262,116,95,326709.94999999995,326517.32999999996
4955,U31748,211,9089.440000000004,193,18,39809.04000000001,48898.48000000001
4956,U23995,211,107282.84000000013,117,94,28072482.250000004,28179765.090000004
4957,U38022,211,-33183.65,194,17,100827.93999999999,67644.28999999998
4958,U31264,211,78544.98,194,17,164252.93999999997,242797.91999999998
4959,U24219,211,-91978.49,201,10,509164.28999999986,417185.7999999999
4960,U42026,211,-11669.159999999996,184,27,151445.07,139775.91
4961,U8188,211,-35055.46999999999,179,32,108905.81,73850.34000000001
4962,U30960,211,-1012.4599999999939,192,19,56982.70999999999,55970.25
4963,U26288,211,-8475.97,195,16,200001.91000000003,191525.94000000003
4964,U24078,211,-136210.91000000003,198,13,356722.79000000004,220511.88
4965,U11224,211,62849.22999999998,184,27,6307953.83,6370803.0600000005
4966,U11801,211,10837.31999999999,189,22,62540.72999999998,73378.04999999997
4967,U11086,211,-2299.2400000000007,203,8,16392.120000000006,14092.880000000005
4968,U8458,211,51496.43999999997,196,15,91878.73000000001,143375.16999999998
4969,U1044107,211,-10.569999999998458,126,85,98079.87,98069.3
4970,U33894,211,10419.280000000006,192,19,72466.70000000001,82885.98000000001
4971,U1125056,211,-13772.080000000018,120,91,247498.16999999998,233726.08999999997
4972,U36752,211,15374.579999999998,188,23,77560.67,92935.25
4973,U31106,211,17506.54,144,67,130692.66,148199.2
4974,U22818,211,14845.329999999965,177,34,203830.2099999999,218675.53999999986
4975,U18840,211,3487.0899999999874,176,35,304367.99,307855.07999999996
4976,U23739,211,8166.869999999928,145,66,1416236.5900000003,1424403.4600000002
4977,U15599,211,270665.64,194,17,234483.68999999997,505149.32999999996
4978,U34691,211,15859.0,171,40,139797.2,155656.2
4979,U8668,211,-3726.5200000000104,165,46,184050.47999999998,180323.95999999996
4980,U31242,211,-5677.86999999998,110,101,123788.16000000002,118110.29000000004
4981,U11098,211,-26473.45999999996,187,24,842938.3799999999,816464.9199999999
4982,U24560,211,11046.95999999999,198,13,260317.29,271364.25
4983,U39474,211,33209.45999999995,146,65,1072085.1199999999,1105294.5799999998
4984,U12079,211,7680.910000000001,195,16,83277.11,90958.02
4985,U1374086,211,-790.3499999999981,147,64,59041.22,58250.87
4986,U18446,211,-2790.3699999999953,157,54,340695.99999999994,337905.62999999995
4987,U37582,211,14790.600000000008,176,35,176274.23999999993,191064.83999999994
4988,U36762,211,-12762.790000000003,182,29,86267.82000000002,73505.03000000001
4989,U8195,211,-65467.129999999976,170,41,394463.7499999999,328996.6199999999
4990,U42601,211,-56.30999999999989,197,14,77666.91000000002,77610.60000000002
4991,U14239,211,7293.02000000007,185,26,838317.3500000001,845610.3700000001
4992,U39548,210,-26662.969999999983,174,36,200305.61999999997,173642.65
4993,U36735,210,-7726.140000000021,182,28,190942.50999999998,183216.36999999997
4994,U1207839,210,-13418.51,156,54,157848.66,144430.15
4995,U14337,210,1913.7800000000002,195,15,33490.96,35404.74
4996,U42032,210,-20394.190000000017,194,16,428379.8199999999,407985.6299999999
4997,U31845,210,-751.3699999999953,168,42,70228.51999999999,69477.15
4998,U31608,210,-10601.980000000014,197,13,78366.50999999997,67764.52999999996
4999,U33119,210,6490.250000000002,198,12,13608.369999999997,20098.62
5000,U33754,210,-738.3499999999993,144,66,150698.79000000007,149960.44000000006
5001,U14749,210,81298.27000000005,186,24,269636.43,350934.70000000007
5002,U12630,210,-795.8099999999522,143,67,808800.02,808004.2100000001
5003,U25453,210,11292.709999999988,187,23,161035.87999999998,172328.58999999997
5004,U25355,210,4652.020000000011,167,43,477485.26999999996,482137.29
5005,U16193,210,268694.24,186,24,234737.10999999993,503431.3499999999
5006,U20168,210,33198.269999999844,161,49,1633043.0299999998,1666241.2999999996
5007,U31630,210,-2627.5600000000068,203,7,46433.45000000001,43805.89000000001
5008,U21320,210,9351.059999999998,195,15,62238.77000000004,71589.83000000005
5009,U41788,210,-14124.14000000004,180,30,428384.8099999999,414260.66999999987
5010,U16755,210,-398.28999999990685,156,54,10273621.46,10273223.170000002
5011,U12551,210,-148596.43,186,24,506963.55999999994,358367.12999999995
5012,U8624,210,-38261.01000000003,174,36,489665.04,451404.02999999997
5013,U8215,210,5235.73000000003,164,46,1857272.0700000003,1862507.8000000003
5014,U42024,210,-6804.580000000002,199,11,34765.75000000001,27961.170000000006
5015,U23298,210,20784.160000000033,162,48,2440324.4,2461108.56
5016,U12916,210,29746.429999999997,185,25,81297.96,111044.39
5017,U1156302,210,-3699.6399999999994,109,101,188009.1,184309.46000000002
5018,U35936,210,1029.439999999995,187,23,43548.44000000001,44577.880000000005
5019,U33873,210,-1019.3200000000111,193,17,165023.61000000002,164004.29
5020,U30562,210,-12755.12999999941,188,22,781993.5899999999,769238.4600000004
5021,U44022,210,-25859.87999999999,175,35,272541.9,246682.02000000002
5022,U8164,210,46896.97000000002,189,21,67922.31000000003,114819.28000000006
5023,U18003,210,-35407.310000000216,176,34,1834891.5799999998,1799484.2699999996
5024,U35321,210,-79984.15999999999,199,11,204312.87000000002,124328.71000000004
5025,U22566,210,4831.4000000000215,171,39,398926.6099999999,403758.00999999995
5026,U25948,210,5794.010000000002,183,27,272002.74,277796.75
5027,U42505,210,-4283.650000000043,188,22,203993.91999999998,199710.26999999993
5028,U40988,210,-3905.5499999999965,173,37,59481.24000000001,55575.69000000002
5029,U1191879,210,-14639.220000000021,116,94,753672.1900000001,739032.9700000001
5030,U33969,210,-17568.100000000002,192,18,81510.98,63942.87999999999
5031,U11239,210,-6743.490000000002,157,53,221469.09,214725.6
5032,U15078,210,602950.9800000002,189,21,549140.19,1152091.1700000002
5033,U42112,210,-38823.409999999996,119,91,98590.79999999999,59767.38999999999
5034,U42078,210,-90.27999999999838,173,37,28838.79,28748.510000000002
5035,U14020,210,-15056.190000000019,190,20,117133.09,102076.89999999998
5036,U39108,210,-108983.51999999997,173,37,261860.58,152877.06
5037,U24394,210,-218950.44,187,23,381055.73999999993,162105.29999999993
5038,U34068,210,-42168.549999999996,199,11,83323.11,41154.560000000005
5039,U13771,210,80850.63,193,17,78512.47,159363.1
5040,U40011,210,-19136.94000000001,198,12,34933.07000000002,15796.130000000012
5041,U17305,210,-14461.64,150,60,340636.70999999996,326175.06999999995
5042,U30128,210,-2781.6099999999387,184,26,185380.09000000032,182598.4800000004
5043,U13359,210,-8871.669999999987,174,36,274699.75,265828.08
5044,U34022,210,-195.12000000000154,205,5,9918.85,9723.73
5045,U15613,210,-41471.97999999985,161,49,896819.6399999999,855347.66
5046,U16238,210,7501.620000000041,194,16,1068071.7199999995,1075573.3399999996
5047,U17507,210,26410.380000000012,181,29,524254.1799999999,550664.5599999999
5048,U25225,210,-9483.450000000003,200,10,30644.54999999998,21161.099999999977
5049,U11912,210,1740.1100000000004,183,27,40606.640000000014,42346.750000000015
5050,U25543,210,-762.7500000000022,186,24,14626.109999999993,13863.359999999991
5051,U28042,210,30868.00000000001,195,15,50120.670000000006,80988.67000000001
5052,U29691,210,-16985.629999999994,181,29,90596.07,73610.44000000002
5053,U18423,210,2113.9700000000034,196,14,26426.739999999998,28540.710000000003
5054,U39529,210,-2408.599999999997,195,15,125680.32999999997,123271.72999999998
5055,U42320,210,669.3500000000012,192,18,90393.49,91062.84000000001
5056,U8925,210,-63692.32000000017,168,42,321457.8600000004,257765.5400000002
5057,U12765,210,234536.30999999994,182,28,590245.76,824782.07
5058,U18225,210,35798.66000000003,179,31,228277.25999999998,264075.92000000004
5059,U21629,209,-261750.46999999997,185,24,649329.1699999997,387578.6999999997
5060,U21480,209,14.109999999999047,203,6,41676.530000000006,41690.64000000001
5061,U23828,209,-303186.47999999975,155,54,1226403.4999999995,923217.0199999998
5062,U15362,209,65007.71000000001,200,9,12735.06,77742.77
5063,U1159883,209,1788.4400000000005,135,74,24065.79000000001,25854.23000000001
5064,U13058,209,-8167.97,172,37,216270.0699999999,208102.0999999999
5065,U13571,209,33035.939999999995,167,42,667726.0300000001,700761.9700000001
5066,U14509,209,-235430.30999999997,175,34,832353.7300000001,596923.4200000002
5067,U30416,209,-28482.570000000007,184,25,474341.41,445858.83999999997
5068,U14225,209,-9540.459999999981,134,75,2182281.3300000015,2172740.8700000015
5069,U32890,209,5630.440000000004,191,18,62993.54999999999,68623.98999999999
5070,U25644,209,-23113.539999999997,187,22,138820.09999999998,115706.55999999998
5071,U8516,209,-5768.499999999997,197,12,45695.42999999999,39926.92999999999
5072,U36031,209,10915.820000000007,195,14,32710.49000000002,43626.31000000003
5073,U36455,209,-1618.8400000000001,182,27,34675.020000000004,33056.18000000001
5074,U12155,209,3450.6900000000023,169,40,346456.8800000003,349907.5700000003
5075,U14953,209,-41868.23000000002,188,21,213019.27,171151.03999999998
5076,U17049,209,17826.42,128,81,318989.93000000005,336816.35000000003
5077,U25495,209,926.100000000004,180,29,91204.91999999997,92131.01999999997
5078,U11810,209,-27605.569999999996,168,41,100071.95999999999,72466.39
5079,U29068,209,-2699.2000000000007,197,12,32426.059999999994,29726.859999999993
5080,U30523,209,-13389.089999999982,185,24,100656.11999999998,87267.03
5081,U36345,209,-11718.500000000004,197,12,24601.109999999997,12882.609999999993
5082,U33133,209,8957.719999999988,163,46,137977.00999999998,146934.72999999998
5083,U15304,209,4818.460000000014,193,16,126948.06000000004,131766.52000000005
5084,U22597,209,-64226.140000000014,188,21,212628.22999999992,148402.0899999999
5085,U39467,209,-35144.89000000005,160,49,2481451.389999998,2446306.4999999977
5086,U14581,209,101168.23000000004,193,16,1750374.5999999996,1851542.8299999996
5087,U23039,209,-29727.899999999972,166,43,453489.12,423761.22000000003
5088,U15595,209,-9742581.179999996,186,23,10049388.919999998,306807.7400000021
5089,U37750,209,-763.8299999998835,183,26,733638.4800000002,732874.6500000004
5090,U26209,209,-17885.969999999943,161,48,792837.05,774951.0800000001
5091,U20946,209,54855.12999999996,192,17,363339.85,418194.9799999999
5092,U43495,209,37324.410000000025,199,10,47167.75999999998,84492.17000000001
5093,U18308,209,171245.65999999997,194,15,625365.46,796611.1199999999
5094,U43964,209,-511.20000000000135,197,12,41287.55000000001,40776.350000000006
5095,U28873,209,42881.99,194,15,95612.14000000001,138494.13
5096,U38683,209,2575.7700000000004,189,20,18131.93,20707.7
5097,U33820,209,22093.829999999994,164,45,652822.5199999999,674916.3499999999
5098,U17196,209,2597.9900000000207,184,25,266979.30000000005,269577.2900000001
5099,U28539,209,-5864.329999999998,186,23,29607.229999999996,23742.899999999998
5100,U27491,209,-9451.11000000003,113,96,934767.3899999999,925316.2799999999
5101,U15925,209,2604.5800000000036,186,23,30222.32000000001,32826.900000000016
5102,U11535,209,-10925.880000000023,133,76,618938.1699999997,608012.2899999997
5103,U25518,209,-7618.05,190,19,132485.46000000002,124867.41000000002
5104,U25954,209,-357175.6799999988,182,27,4449977.220000001,4092801.540000002
5105,U38638,209,-269.73999999999796,172,37,87302.82999999999,87033.09
5106,U43327,209,-14836.930000000015,127,82,1168499.2,1153662.27
5107,U25282,209,-30955.54,174,35,104345.65000000002,73390.11000000002
5108,U11704,209,-28266.060000000005,192,17,145945.71,117679.65
5109,U39359,209,-5958.250000000007,174,35,286734.79000000004,280776.54000000004
5110,U38604,209,-1607.2000000000342,183,26,217906.69999999998,216299.49999999994
5111,U762021,209,-16294.13,143,66,78478.53999999998,62184.40999999998
5112,U8765,209,-8815.169999999993,192,17,81306.06,72490.89
5113,U16834,209,-12333.750000000058,133,76,964519.02,952185.27
5114,U18858,209,5412.429999999935,131,78,1160023.06,1165435.49
5115,U17430,208,-799.1899999999987,115,93,513488.56,512689.37
5116,U14948,208,51264.64000000083,179,29,3648337.88,3699602.5200000005
5117,U15049,208,-53036.539999999935,167,41,873093.1300000006,820056.5900000007
5118,U8169,208,-11912.81,186,22,119126.67,107213.86
5119,U27332,208,-42991.60999999998,146,62,995968.2300000001,952976.6200000001
5120,U989117,208,1.3999999999996362,104,104,37172.0,37173.4
5121,U19059,208,12878.039999999999,185,23,133445.21,146323.25
5122,U11126,208,-2130.8099999999963,108,100,164954.97,162824.16
5123,U22061,208,-13055.119999999999,189,19,68563.29999999999,55508.17999999999
5124,U14816,208,74075.69999999997,170,38,512429.35,586505.0499999999
5125,U19779,208,50661.62999999999,174,34,111281.1,161942.72999999998
5126,U11676,208,-523018.17,171,37,948313.5099999999,425295.3399999999
5127,U41451,208,-9620.439999999999,196,12,104779.70999999999,95159.26999999999
5128,U39204,208,11110.889999999987,192,16,140533.2400000001,151644.1300000001
5129,U38979,208,54833.850000000006,186,22,1345993.43,1400827.28
5130,U29994,208,-18358.350000000002,189,19,445622.32999999996,427263.98
5131,U16958,208,-132096.48000000004,156,52,1541320.71,1409224.23
5132,U24343,208,76801.21000000104,113,95,13693895.89,13770697.100000001
5133,U19629,208,-44464.56,116,92,874866.4099999999,830401.8499999999
5134,U39792,208,430.5200000000152,169,39,132502.8,132933.32
5135,U31358,208,7657.3200000000015,195,13,43225.94,50883.26
5136,U22289,208,141613.64000000004,166,42,246692.93,388306.57000000007
5137,U35351,208,6802.480000000021,166,42,956209.8400000003,963012.3200000003
5138,U39641,208,2446.6699999999973,121,87,129902.60999999994,132349.27999999994
5139,U11492,208,186842.9100000001,176,32,1854663.34,2041506.2500000002
5140,U41804,208,5853.180000000004,115,93,98248.2,104101.38
5141,U36897,208,-3044.420000000001,176,32,93944.39000000001,90899.97000000002
5142,U22450,208,213983.13000000012,164,44,1662813.6399999994,1876796.7699999996
5143,U23163,208,5932.609999999942,149,59,487261.26999999996,493193.8799999999
5144,U15666,208,7591.4600000000155,182,26,83322.70000000006,90914.16000000008
5145,U39627,208,2201.000000000003,172,36,42843.29000000001,45044.29000000001
5146,U25164,208,-581.0900000000009,163,45,29808.179999999986,29227.089999999986
5147,U14906,208,-5261.04000000007,165,43,1362903.4700000002,1357642.4300000002
5148,U15455,208,-236834.76,183,25,599992.01,363157.25
5149,U27428,208,-4043.78999999999,163,45,704240.33,700196.5399999999
5150,U668381,208,1.3400000000001455,177,31,16391.93,16393.27
5151,U26865,208,29412.510000000002,182,26,166472.33999999997,195884.84999999998
5152,U18469,208,311557.82999999996,144,64,8655864.490000006,8967422.320000006
5153,U15851,208,-63942.54999999999,174,34,168077.08000000005,104134.53000000006
5154,U27381,208,-905.9299999999993,186,22,30152.280000000006,29246.350000000006
5155,U27634,208,-6782.92,193,15,53108.44000000002,46325.52000000002
5156,U41273,208,-27802.35,198,10,110197.8,82395.45000000001
5157,U25530,208,-129191.81999999999,191,17,258311.54999999996,129119.72999999997
5158,U32252,208,15109.640000000067,176,32,2294091.76,2309201.4
5159,U16352,208,756.1300000000067,168,40,56259.04999999999,57015.17999999999
5160,U10139,208,105886.95999999986,119,89,2538179.529999999,2644066.489999999
5161,U21266,208,200.70999999999913,119,89,28404.660000000003,28605.370000000003
5162,U29583,208,-26545.55999999999,159,49,429576.38,403030.82
5163,U37142,208,13703.450000000006,202,6,37682.280000000006,51385.73000000001
5164,U20694,208,513.6499999999935,159,49,153665.39000000004,154179.04000000004
5165,U29350,207,-9740.760000000097,145,62,917896.56,908155.7999999999
5166,U22567,207,28232.83999999999,179,28,785197.45,813430.2899999999
5167,U23568,207,-5450.250000000011,181,26,483598.98999999993,478148.73999999993
5168,U32932,207,34827.569999999985,192,15,106723.22000000002,141550.79
5169,U25262,207,-561.0699999999993,185,22,13899.550000000003,13338.480000000003
5170,U1251238,207,-10883.319999999994,140,67,140909.37,130026.05
5171,U22569,207,13655.040000000006,193,14,104452.90000000005,118107.94000000006
5172,U17943,207,218411.48000000016,185,22,46224.62000000001,264636.10000000015
5173,U8698,207,6187.079999999987,160,47,178095.09000000003,184282.17
5174,U28362,207,9475.569999999996,186,21,183902.02,193377.59
5175,U24401,207,-12312.990000000002,168,39,46139.71,33826.72
5176,U25696,207,114577.88999999984,106,101,2410624.3699999996,2525202.2599999993
5177,U18507,207,-2528.3000000000047,180,27,174476.1600000001,171947.86000000007
5178,U16835,207,-122480.46999999997,185,22,259100.91999999995,136620.44999999998
5179,U8120,207,-36856.36,198,9,99412.25000000001,62555.890000000014
5180,U43030,207,3485.700000000001,176,31,32109.10000000002,35594.800000000025
5181,U13459,207,-1928.7300000002258,176,31,2165264.7800000003,2163336.05
5182,U8757,207,-760.460000000008,186,21,212270.05000000002,211509.59
5183,U36228,207,1091.4500000000007,190,17,43699.27,44790.72
5184,U24850,207,-20054.77,178,29,226299.57,206244.80000000002
5185,U35179,207,2023763.5699999994,161,46,1281246.4400000004,3305010.01
5186,U26844,207,-87614.0000000002,184,23,1676396.9500000004,1588782.9500000002
5187,U23670,207,-558.4799999999946,150,57,202618.90999999997,202060.43
5188,U27948,207,-8658.189999999988,134,73,615440.3300000001,606782.1400000001
5189,U25882,207,-5254.630000000002,185,22,190333.35000000003,185078.72000000003
5190,U33655,207,-94826.04999999996,190,17,876184.0299999999,781357.98
5191,U23586,207,-33298.149999999994,186,21,94844.48999999999,61546.34
5192,U13430,207,9638.01999999993,123,84,1229257.16,1238895.18
5193,U12229,207,15429.969999999994,185,22,115037.29,130467.25999999998
5194,U26675,207,-8286.85,201,6,15184.68,6897.83
5195,U14495,207,-95124.93000000005,195,12,576452.2,481327.2699999999
5196,U39632,207,4387.119999999986,175,32,192593.62000000002,196980.74000000002
5197,U17044,207,3918.7599999999984,161,46,338731.55,342650.31
5198,U34626,207,-35942.61000000006,194,13,299835.36,263892.74999999994
5199,U11865,207,1456.3599999999997,195,12,11219.400000000003,12675.760000000002
5200,U41088,207,24194.89999999974,111,96,1103126.3800000001,1127321.2799999998
5201,U15341,207,-21668.029999999737,152,55,13356743.629999999,13335075.6
5202,U9378,207,2364.470000000005,192,15,69952.46999999999,72316.93999999999
5203,U32026,207,-7069.159999999982,196,11,340394.80000000016,333325.6400000002
5204,U14902,207,-7953.0899999999965,171,36,354442.51,346489.42000000004
5205,U8983,207,29850.61999999979,188,19,20785562.269999996,20815412.889999997
5206,U11659,207,5581.960000000004,199,8,48470.630000000005,54052.59000000001
5207,U26164,207,9625.620000000008,188,19,38398.580000000016,48024.200000000026
5208,U29930,206,-48649.92000000001,194,12,180217.64999999997,131567.72999999995
5209,U29066,206,23362.309999999976,116,90,1220841.55,1244203.86
5210,U40632,206,-12905.499999999982,182,24,104558.61,91653.11000000002
5211,U37420,206,2299.55000000001,190,16,302740.75999999995,305040.30999999994
5212,U33586,206,-35490.39000000001,189,17,120100.34,84609.94999999998
5213,U40603,206,-17127.35,188,18,167965.27000000002,150837.92
5214,U32609,206,-1087.5300000000059,176,30,75429.92,74342.39
5215,U21520,206,9339.380000000003,187,19,88583.97000000002,97923.35000000002
5216,U41193,206,134283.66999999998,174,32,1570633.9199999997,1704917.5899999996
5217,U22331,206,56988.27999999999,152,54,359710.33999999997,416698.61999999994
5218,U32524,206,13898.630000000052,166,40,905410.08,919308.71
5219,U9266,206,6728.449999999998,187,19,107884.34000000001,114612.79000000001
5220,U12907,206,-40622.79999999996,99,107,1803120.41,1762497.6099999999
5221,U12991,206,-2107.529999999996,192,14,49183.689999999995,47076.159999999996
5222,U25184,206,3983.2800000000116,183,23,281054.62,285037.9
5223,U43619,206,1427.2600000000457,172,34,119012.85,120440.11000000004
5224,U32167,206,-4362.160000000001,147,59,46176.22000000002,41814.06000000002
5225,U18342,206,67346.24999999999,171,35,264198.1,331544.35
5226,U35021,206,67252.29000000001,151,55,263880.85000000003,331133.14
5227,U11318,206,70120.73000000001,175,31,480456.21,550576.9400000001
5228,U893245,206,-40753.729999999996,127,79,203304.78000000006,162551.05000000005
5229,U31897,206,21704.579999999994,171,35,252076.29,273780.87
5230,U31818,206,638.5400000000012,121,85,44218.63,44857.17
5231,U39439,206,40369.68000000001,185,21,1358306.8299999994,1398676.5099999993
5232,U13556,206,21036.01000000019,184,22,3139007.139999999,3160043.1499999994
5233,U8863,206,-24622.07000000001,135,71,280332.43,255710.36
5234,U39873,206,-4566.990000000007,179,27,138687.34000000003,134120.35
5235,U15417,206,-5276.869999999995,181,25,154289.64999999997,149012.77999999997
5236,U37939,206,2150.629999999999,188,18,7142.239999999997,9292.869999999995
5237,U33029,206,-29816.110000000004,193,13,58396.43,28580.319999999996
5238,U38891,206,440.1399999999999,195,11,33905.34000000001,34345.48000000001
5239,U22563,206,-3911.4199999999964,194,12,58861.06000000002,54949.64000000002
5240,U8408,206,19693.179999999997,188,18,109121.10999999997,128814.28999999996
5241,U11286,206,31856.229999999985,199,7,47077.40000000002,78933.63
5242,U32004,206,-1562.2899999998772,144,62,6491857.53,6490295.24
5243,U42066,206,182.9300000000293,82,124,614566.2100000001,614749.1400000001
5244,U38106,206,37348.64,174,32,113388.34999999998,150736.99
5245,U10972,206,41352.759999999995,156,50,263911.39,305264.15
5246,U40071,206,4328.419999999989,133,73,563434.4599999998,567762.8799999999
5247,U16674,206,106243.05999999995,179,27,107443.95,213687.00999999995
5248,U25557,206,-11520.109999999899,185,21,1415534.7399999998,1404014.63
5249,U27515,206,333.8599999999965,199,7,49894.19,50228.049999999996
5250,U595669,206,-253.41000000000258,128,78,102633.27999999997,102379.86999999997
5251,U16111,206,2858600.25,181,25,1604610.1299999997,4463210.38
5252,U31388,206,7427.519999999996,195,11,958442.5700000001,965870.0900000001
5253,U19923,206,-9325.589999999997,187,19,47553.04000000001,38227.45000000001
5254,U17647,206,-607.6099999999967,167,39,77662.45000000004,77054.84000000004
5255,U13979,206,-6623.4999999999545,186,20,445783.37,439159.87000000005
5256,U32404,206,37935.319999999985,185,21,124137.06999999999,162072.38999999998
5257,U37546,206,3007.9900000000016,187,19,66496.77000000002,69504.76000000002
5258,U26995,206,-20467.19000000001,164,42,102816.47999999997,82349.28999999995
5259,U31856,206,-31588.710000000017,199,7,61231.240000000005,29642.529999999988
5260,U19659,206,384851.13999999996,155,51,1548673.4199999997,1933524.5599999996
5261,U13011,206,348554.19000000006,180,26,133667.88000000003,482222.07000000007
5262,U30201,206,18275.420000000016,149,57,209200.03000000012,227475.45000000013
5263,U41809,206,27447.439999999955,184,22,733746.6500000001,761194.0900000001
5264,U26188,206,31162.039999999994,152,54,130892.18000000004,162054.22000000003
5265,U18839,206,-19679.89999999986,155,51,1664777.89,1645097.99
5266,U25147,206,85103.70000000001,179,27,720380.6600000001,805484.3600000001
5267,U30221,206,-24235.859999999982,198,8,116394.38,92158.52000000002
5268,U41077,206,-13829.599999999997,179,27,141869.87,128040.27
5269,U33675,206,-7599.530000000001,193,13,30546.56,22947.03
5270,U33387,206,52021.42999999996,173,33,315992.3599999999,368013.78999999986
5271,U26300,205,60465.28999999999,184,21,633471.6000000001,693936.8900000001
5272,U11767,205,436814.9199999999,176,29,1069871.28,1506686.2
5273,U13222,205,-12081.270000000022,156,49,917465.57,905384.2999999999
5274,U40561,205,-57012.17999999999,200,5,97013.04,40000.86
5275,U12881,205,312564.54000000004,157,48,993035.0400000002,1305599.58
5276,U37369,205,-27993.12999999999,182,23,1042381.7100000001,1014388.5800000001
5277,U43584,205,5338.370000000003,173,32,198403.52,203741.88999999998
5278,U32121,205,-2382.0199999999986,186,19,72040.39,69658.37
5279,U35249,205,1528.9600000000028,181,24,52993.58000000002,54522.54000000002
5280,U26364,205,937.8400000000017,132,73,36859.829999999994,37797.67
5281,U41408,205,-22584.02000000001,136,69,238923.45999999993,216339.43999999992
5282,U14350,205,21851.710000000036,178,27,292590.94000000006,314442.6500000001
5283,U43361,205,16236.650000000003,183,22,141141.55000000013,157378.20000000013
5284,U31826,205,52822.78999999998,141,64,55476.02999999999,108298.81999999998
5285,U33012,205,-248901.07999999996,180,25,710706.3099999999,461805.23
5286,U32449,205,2280.2700000000023,180,25,71965.72000000002,74245.99000000002
5287,U17166,205,-338981.74000000005,183,22,471007.27,132025.52999999997
5288,U23567,205,-5751.359999999992,139,66,554311.28,548559.92
5289,U14579,205,11049.270000000004,187,18,21086.350000000002,32135.620000000006
5290,U23791,205,18506.65,158,47,177934.10999999987,196440.75999999986
5291,U9204,205,-40777.95999999999,130,75,1632599.96,1591822.0
5292,U41165,205,-7254.589999999999,190,15,36115.32000000002,28860.73000000002
5293,U10218,205,-705.8599999998969,105,100,573711.27,573005.4100000001
5294,U33365,205,-1468.8999999999999,194,11,11392.19,9923.29
5295,U18892,205,-25083.18,179,26,89692.74,64609.560000000005
5296,U13935,205,24183.649999999987,160,45,295188.2399999999,319371.88999999984
5297,U17388,205,-93542.38000000015,128,77,1517965.1900000002,1424422.81
5298,U33904,205,22642.00999999998,183,22,378873.72,401515.73
5299,U35625,205,70016.43999999997,180,25,507387.3900000001,577403.8300000001
5300,U25221,205,1869.0399999999681,171,34,415002.89,416871.93
5301,U32721,205,-39992.96,188,17,143682.56,103689.6
5302,U23038,205,-6951.440000000004,167,38,42852.009999999995,35900.56999999999
5303,U36475,205,3564.1300000000037,181,24,65383.4,68947.53
5304,U999976,205,2993.0700000000006,140,65,31444.159999999996,34437.229999999996
5305,U34557,205,-399.80999999999824,196,9,10853.339999999998,10453.53
5306,U36391,205,-11806.73,187,18,38268.46000000001,26461.730000000007
5307,U10040,205,-1212.8899999999958,113,92,436992.17000000004,435779.28
5308,U31321,205,-118460.9,193,12,206187.21999999997,87726.31999999998
5309,U23594,205,26674.850000000006,188,17,173787.59,200462.44
5310,U39244,205,52134.049999999974,188,17,323985.7599999999,376119.8099999999
5311,U18939,205,-47236.060000000005,194,11,51384.200000000004,4148.139999999999
5312,U8370,205,144976.06999999998,177,28,491240.7200000001,636216.79
5313,U23872,205,-88078.99000000005,173,32,909027.59,820948.5999999999
5314,U35160,205,-20088.05,108,97,260245.41999999995,240157.36999999997
5315,U9061,205,723.3099999999963,185,20,92061.11,92784.42
5316,U35141,205,-148379.84,184,21,740035.37,591655.53
5317,U29705,205,917.4700000000049,173,32,82768.5,83685.97
5318,U30915,205,2228.7999999999984,183,22,28202.020000000004,30430.820000000003
5319,U22267,205,2653.2600000000043,184,21,46745.94000000001,49399.20000000001
5320,U13862,205,-7326.379999999998,176,29,168103.46999999997,160777.08999999997
5321,U33903,205,5048.209999999875,175,30,574765.2,579813.4099999998
5322,U24074,205,4497.640000000006,184,21,27932.969999999998,32430.610000000004
5323,U33866,205,-11392.429999999998,187,18,110487.15,99094.72
5324,U16083,205,-360613.20000000007,142,63,2800906.0399999996,2440292.8399999994
5325,U8459,205,2655.799999999993,167,38,158039.42000000004,160695.22000000003
5326,U30709,205,4666.239999999991,159,46,2044751.3,2049417.54
5327,U13127,205,-366848.30000000005,191,14,443619.13,76770.82999999996
5328,U18052,204,-9978.010000000011,181,23,380444.82,370466.81
5329,U37977,204,36966.18,178,26,99325.87000000001,136292.05000000002
5330,U24438,204,7366.170000000012,176,28,130158.68,137524.85
5331,U20181,204,-115.34999999999434,173,31,81302.65999999999,81187.31
5332,U13927,204,10350.76999999999,134,70,705390.0400000002,715740.8100000002
5333,U12254,204,-2574.4300000000003,190,14,86179.56999999999,83605.13999999998
5334,U1238850,204,6840.279999999996,112,92,128341.54,135181.81999999998
5335,U37643,204,-88455.56999999992,165,39,574213.9500000002,485758.38000000024
5336,U14710,204,4720.680000000352,148,56,3201951.3699999996,3206672.05
5337,U26820,204,-44939.37000000002,186,18,389631.4000000001,344692.0300000001
5338,U10532,204,14911.160000000002,190,14,10792.989999999998,25704.15
5339,U38862,204,39453.39999999997,158,46,102827.95999999996,142281.35999999993
5340,U26542,204,9505.74999999997,191,13,315533.19999999984,325038.94999999984
5341,U42564,204,1911.1799999999946,146,58,207018.67000000004,208929.85000000003
5342,U34603,204,21096.719999999976,176,28,216873.8,237970.51999999996
5343,U24148,204,265307.59999999974,167,37,381473.4400000002,646781.0399999999
5344,U21999,204,-8147.330000000002,186,18,74061.3,65913.97
5345,U18430,204,-116409.0,193,11,417193.89999999997,300784.89999999997
5346,U20373,204,542.740000000002,192,12,142193.40000000002,142736.14
5347,U18662,204,-5550.680000000004,181,23,103072.21,97521.53
5348,U10773,204,-64448.4200000062,141,63,116993672.29000008,116929223.87000008
5349,U33373,204,-15689.429999999986,123,81,163313.09,147623.66
5350,U20781,204,222606.22000000003,167,37,675352.9199999999,897959.1399999999
5351,U25120,204,1974.510000000003,176,28,116876.70999999999,118851.22
5352,U20673,204,-3265.2000000000116,173,31,405165.52999999997,401900.32999999996
5353,U38617,204,138.8599999999767,166,38,495482.9900000001,495621.8500000001
5354,U16055,204,150.0299999999924,183,21,65301.14000000005,65451.17000000004
5355,U33739,204,-16019.969999999996,190,14,52227.189999999995,36207.22
5356,U22092,204,-35261.31999999999,115,89,1828153.2899999998,1792891.9699999997
5357,U14690,204,-52502.53,194,10,76960.03000000001,24457.500000000015
5358,U13374,204,400.24999999999875,186,18,100893.17000000003,101293.42000000003
5359,U30517,204,23467.989999999987,162,42,367000.12,390468.11
5360,U42861,204,-1357.6100000000017,148,56,28251.72,26894.11
5361,U9751,204,22875.859999999997,183,21,32255.4,55131.259999999995
5362,U9072,204,29815.75,171,33,1495334.08,1525149.83
5363,U38938,204,-99050.83000000005,192,12,352606.47999999986,253555.64999999982
5364,U13424,204,-2591.1900000000023,158,46,720766.1100000001,718174.9200000002
5365,U40055,204,-32004.960000000006,186,18,122155.25000000003,90150.29000000002
5366,U34291,204,13904.04999999998,190,14,233682.65999999997,247586.70999999996
5367,U23526,204,-22270.500000000015,175,29,206733.99,184463.49
5368,U8813,204,59026.59999999997,167,37,274059.9500000002,333086.55000000016
5369,U42196,204,-40306.34,185,19,246331.13999999996,206024.79999999996
5370,U28547,204,-37650.86000000003,195,9,112958.76999999997,75307.90999999995
5371,U37083,204,66059.87000000007,170,34,590547.42,656607.2900000002
5372,U9839,204,10710.259999999995,159,45,295851.71,306561.97000000003
5373,U27151,204,-2948717.84,179,25,7846496.68,4897778.84
5374,U42490,204,842.4699999999991,183,21,58920.369999999995,59762.84
5375,U17780,204,-17850.30999999988,132,72,4935420.360000001,4917570.050000002
5376,U12007,204,-21325.230000000003,191,13,88374.94000000009,67049.71000000008
5377,U17581,203,-14338.420000000007,185,18,64958.04000000003,50619.620000000024
5378,U41162,203,27295.560000000194,189,14,1599671.3299999991,1626966.8899999994
5379,U609103,203,13283.460000000021,139,64,167377.18000000002,180660.64000000004
5380,U32184,203,-283638.63,177,26,693379.8600000001,409741.2300000001
5381,U36521,203,-472.80000000000774,165,38,141004.25999999995,140531.45999999993
5382,U33003,203,2363.1699999999996,187,16,31475.709999999995,33838.88
5383,U29755,203,-2008385.7799999998,195,8,2033331.7999999998,24946.02000000002
5384,U30841,203,4739.830000000005,130,73,186365.82000000007,191105.65000000008
5385,U12186,203,-3807.5400000000004,180,23,35554.139999999985,31746.599999999984
5386,U751423,203,2772.8400000000065,108,95,428645.18,431418.02
5387,U26010,203,6252.510000000035,165,38,245302.71999999994,251555.22999999998
5388,U17105,203,16360.339999999991,187,16,144945.11999999997,161305.45999999996
5389,U25477,203,4537.729999999999,177,26,61477.249999999985,66014.97999999998
5390,U13241,203,4266.089999999998,189,14,26001.52,30267.61
5391,U42730,203,956.5699999999947,172,31,58585.1,59541.66999999999
5392,U36151,203,14808.109999999999,171,32,140480.06999999998,155288.17999999996
5393,U32215,203,-32727.489999999998,199,4,36868.659999999996,4141.169999999998
5394,U17351,203,-388992.9699999999,192,11,396446.53999999986,7453.569999999949
5395,U43009,203,-2851.3800000000015,189,14,46989.749999999985,44138.36999999998
5396,U26888,203,-4777.070000000007,191,12,185103.8,180326.72999999998
5397,U21512,203,222218.70999999996,181,22,389107.29000000004,611326.0
5398,U22568,203,171862.69,178,25,1193934.7399999988,1365797.4299999988
5399,U36683,203,-38435.10000000001,138,65,1109845.8199999998,1071410.7199999997
5400,U10941,203,-9958.929999999995,181,22,101726.65000000004,91767.72000000004
5401,U36359,203,-9770.040000002948,116,87,51747284.98,51737514.93999999
5402,U37122,203,-19726.990000000005,187,16,117400.48000000004,97673.49000000003
5403,U38532,203,4040.760000000002,197,6,43465.67,47506.43
5404,U8957,203,-204500.3899999999,195,8,1146186.0899999985,941685.6999999986
5405,U42813,203,-174584.78,190,13,296283.5800000001,121698.80000000008
5406,U24397,203,1264089.7499999998,172,31,3933837.33,5197927.08
5407,U10065,203,84008.71000000005,181,22,282868.43999999994,366877.15
5408,U23016,203,-77741.06000000001,192,11,239920.78000000003,162179.72000000003
5409,U17592,203,8467.070000000009,164,39,106657.00999999998,115124.07999999999
5410,U16230,203,10826.519999999882,161,42,6582110.659999997,6592937.179999997
5411,U24546,203,-11513.34,181,22,66551.74000000002,55038.40000000002
5412,U25933,203,-54127.62000000009,163,40,792411.0100000005,738283.3900000004
5413,U33236,203,-1841.16,192,11,23165.249999999996,21324.089999999997
5414,U19772,203,12977.08,183,20,108342.24,121319.32
5415,U11955,203,-141995.7900000001,184,19,1700646.8199999994,1558651.0299999993
5416,U11170,203,-26140.83000000001,102,101,565718.8300000001,539578.0000000001
5417,U29707,203,-3758.9499999999907,133,70,224262.28999999986,220503.33999999988
5418,U27961,203,27220.43,179,24,39732.689999999995,66953.12
5419,U31524,203,120931.24999999999,72,131,158902.46000000002,279833.71
5420,U13242,203,1012.7200000000012,171,32,40551.75,41564.47
5421,U31666,203,-809.0399999999426,126,77,2110212.799999999,2109403.759999999
5422,U18269,203,-3317.8600000000115,178,25,347645.78,344327.92000000004
5423,U35989,203,-10773.73,190,13,168543.44000000003,157769.71000000002
5424,U21080,203,-4158.7200000000885,153,50,4764324.58,4760165.86
5425,U16267,203,4072.9000000000015,172,31,105711.83999999998,109784.73999999999
5426,U16277,203,-133997.62000000034,159,44,6516624.849999999,6382627.229999999
5427,U17726,203,-1239.29,195,8,32381.06999999999,31141.779999999988
5428,U16157,203,184897.37,144,59,1956812.4500000002,2141709.8200000003
5429,U39375,203,-20773.920000000002,135,68,366874.1000000001,346100.1800000001
5430,U12839,203,4308.490000000002,172,31,52926.67000000001,57235.16000000002
5431,U14435,203,1260.2400000000016,185,18,49964.74,51224.979999999996
5432,U901645,203,-8374.119999999999,124,79,87992.09000000001,79617.97000000002
5433,U23895,203,12025.400000000023,170,33,815452.5699999998,827477.9699999999
5434,U14772,203,3774.9099999999953,166,37,84462.47,88237.37999999999
5435,U10661,203,-147591.73000000004,175,28,565735.9099999999,418144.1799999999
5436,U30646,203,-17150.950000000008,147,56,309347.63000000006,292196.68000000005
5437,U12123,203,-615605.32,179,24,2178710.82,1563105.5
5438,U27993,203,-192367.07,176,27,642412.2699999999,450045.1999999999
5439,U14667,203,-12290.090000000002,137,66,216025.7499999999,203735.65999999992
5440,U37885,203,6143.209999999998,188,15,204369.74999999994,210512.95999999993
5441,U42723,203,9632.42000000001,176,27,110390.51,120022.93000000001
5442,U19220,203,776.760000000002,121,82,336496.4600000001,337273.2200000001
5443,U34495,203,-12322.690000000002,165,38,811484.6600000003,799161.9700000002
5444,U14258,203,-171230.11000000004,105,98,1357366.8399999999,1186136.7299999997
5445,U23969,203,-38951.80000000016,181,22,1106048.3900000001,1067096.5899999999
5446,U38746,203,-55099.64999999996,189,14,266678.4399999999,211578.78999999992
5447,U9194,203,194610.66999999998,187,16,338740.02999999997,533350.7
5448,U30775,203,-1754.3299999999144,111,92,1375347.52,1373593.1900000002
5449,U41561,203,1995.4799999999982,128,75,465448.7399999998,467444.2199999998
5450,U28868,203,2506.4900000000016,181,22,113910.31999999998,116416.80999999998
5451,U38460,203,13445.440000000004,173,30,49537.78,62983.22
5452,U29741,203,48283.770000000004,165,38,119255.65,167539.41999999998
5453,U28548,202,-13280.269999999995,168,34,48823.10999999999,35542.84
5454,U902796,202,-4877.519999999995,152,50,81930.34,77052.82
5455,U22121,202,5368.020000000004,174,28,103156.13,108524.15000000001
5456,U30262,202,-267377.82999999996,125,77,688481.4299999997,421103.59999999974
5457,U43398,202,-1752.720000000034,141,61,338350.12,336597.39999999997
5458,U40213,202,20659.36000000001,170,32,419036.69999999995,439696.05999999994
5459,U21551,202,-5471.509999999999,166,36,61698.54999999998,56227.03999999998
5460,U15311,202,-7270.659999999991,185,17,116710.89,109440.23000000001
5461,U36655,202,3099.2200000000007,199,3,4623.000000000001,7722.220000000001
5462,U34208,202,966.6600000000167,187,15,145524.03,146490.69
5463,U11948,202,918.1599999999999,191,11,15704.780000000006,16622.940000000006
5464,U35168,202,24492.809999999823,124,78,5987171.540000001,6011664.350000001
5465,U13452,202,39842.409999999894,158,44,2431134.859999999,2470977.2699999986
5466,U13036,202,865224.6100000001,165,37,3765674.34,4630898.95
5467,U17748,202,-5484.849999999977,168,34,1039787.7500000001,1034302.9000000001
5468,U27023,202,-6717.190000000002,188,14,16407.19,9689.999999999996
5469,U1208507,202,-530.6000000000076,146,56,100185.23999999998,99654.63999999997
5470,U14354,202,-1612238.0699999998,175,27,3997621.4499999997,2385383.38
5471,U33245,202,-10485.68,196,6,18564.89,8079.209999999999
5472,U1323939,202,-253.6400000000001,162,40,4205.589999999999,3951.949999999999
5473,U34382,202,-7920.040000000002,198,4,20844.419999999995,12924.379999999994
5474,U26319,202,-3457.189999999988,180,22,576695.4200000009,573238.2300000009
5475,U28202,202,47993.25000000002,169,33,713928.1699999999,761921.4199999999
5476,U38226,202,-42374.48,193,9,95547.87000000002,53173.39000000002
5477,U42018,202,-196.089999999964,184,18,44546.46999999996,44350.37999999999
5478,U25785,202,60459.62999999999,161,41,133218.79,193678.41999999998
5479,U33454,202,4316.260000000001,167,35,70499.81000000003,74816.07000000002
5480,U42879,202,-59362.189999999995,179,23,89227.69000000002,29865.500000000022
5481,U11548,202,1986.9200000000023,184,18,37018.280000000006,39005.20000000001
5482,U29685,202,-13.850000000001964,179,23,27162.6,27148.749999999996
5483,U8569,202,3817.060000000006,179,23,131584.95,135402.01
5484,U20821,202,39542.860000000015,169,33,449669.1000000001,489211.9600000001
5485,U41596,202,30145.76999999997,180,22,68653.65999999997,98799.42999999995
5486,U15728,202,174189.65999999997,182,20,1014460.6599999996,1188650.3199999996
5487,U39361,202,-94176.02000000128,143,59,7944685.060000002,7850509.040000001
5488,U1210089,202,484.65000000000066,145,57,16898.789999999997,17383.44
5489,U33961,202,-5809.319999999999,196,6,90918.74999999996,85109.42999999996
5490,U16654,202,-3134.639999999995,152,50,145224.67,142090.03000000003
5491,U25773,202,15372.85,175,27,104754.79000000001,120127.64000000001
5492,U10712,202,526.5500000000101,152,50,179288.95999999988,179815.5099999999
5493,U23651,202,-10573.40999999999,183,19,238583.71000000002,228010.30000000002
5494,U14499,202,1740.8400000000038,185,17,84378.48,86119.32
5495,U34281,202,-46139.24999999996,170,32,717555.5200000001,671416.2700000001
5496,U20083,202,90562.38000000003,132,70,206387.68999999994,296950.06999999995
5497,U14275,202,21124.249999999975,155,47,535292.57,556416.82
5498,U26557,202,-2338.69999999997,167,35,423214.79000000004,420876.0900000001
5499,U34285,202,4472.469999999999,197,5,9284.330000000002,13756.800000000001
5500,U40918,202,-33621.869999999995,180,22,1817777.08,1784155.21
5501,U24902,202,-8455.380000000001,168,34,62383.45,53928.06999999999
5502,U10732,202,-14037.469999999972,124,78,1427085.29,1413047.82
5503,U24790,202,74108.10000000002,159,43,934559.6700000002,1008667.7700000001
5504,U16575,202,33693.61000000001,186,16,270943.61,304637.22
5505,U8845,202,2085.3700000000026,184,18,90430.59000000001,92515.96000000002
5506,U18878,202,-134759.13,127,75,1923498.65,1788739.52
5507,U34576,201,-3788.849999999987,170,31,454187.13,450398.28
5508,U23757,201,-2506.5699999999943,177,24,90084.17000000003,87577.60000000003
5509,U42368,201,15716.140000000001,190,11,93783.96999999993,109500.10999999993
5510,U9275,201,3828.9799999999886,182,19,194557.29000000004,198386.27000000002
5511,U577699,201,-4487.799999999999,116,85,94145.41,89657.61
5512,U12208,201,1871.4300000000005,191,10,17177.369999999974,19048.799999999974
5513,U19391,201,-76.68999999999994,175,26,20359.630000000012,20282.940000000013
5514,U21598,201,-48177.30999999999,171,30,765630.4599999998,717453.1499999999
5515,U9709,201,6362.510000000004,177,24,62949.42999999999,69311.94
5516,U33695,201,-6816.869999999997,168,33,73080.59,66263.72
5517,U8374,201,-20338.36999999998,189,12,95928.44999999997,75590.07999999999
5518,U14166,201,-85205.44000000003,173,28,5031133.32,4945927.88
5519,U30952,201,-22301.62,175,26,94948.36000000002,72646.74000000002
5520,U27858,201,15952.389999999996,172,29,923701.4400000003,939653.8300000003
5521,U9670,201,737.530000000063,141,60,1954403.48,1955141.01
5522,U12271,201,-7074.29,197,4,10100.869999999999,3026.579999999999
5523,U23836,201,57781.71999999999,116,85,1325820.59,1383602.31
5524,U33581,201,1588.4999999999718,176,25,208319.75999999995,209908.25999999992
5525,U13881,201,34375.45000000002,161,40,574916.8999999999,609292.35
5526,U39280,201,-44823.39000000001,191,10,64705.73000000001,19882.340000000004
5527,U33398,201,-2642.4500000000044,111,90,668256.98,665614.53
5528,U1251840,201,-1950.0599999999965,98,103,76524.48999999999,74574.43
5529,U29637,201,2816.1600000000003,184,17,40191.63000000003,43007.79000000003
5530,U11281,201,119002.51000000005,174,27,457382.2100000001,576384.7200000001
5531,U16845,201,-31491.149999999994,138,63,161916.87000000014,130425.72000000015
5532,U29279,201,-11520.910000000009,186,15,55642.280000000006,44121.369999999995
5533,U31118,201,-22745.439999999828,161,40,4312314.870000003,4289569.430000003
5534,U8641,201,228.43999999999943,188,13,47551.45000000002,47779.89000000002
5535,U28695,201,3297.4299999999985,158,43,190497.53999999998,193794.96999999997
5536,U38035,201,41079.07000000003,167,34,251513.41999999995,292592.49
5537,U39775,201,-582.6099999999933,184,17,189393.49999999997,188810.88999999998
5538,U30586,201,1202.0999999999985,139,62,33037.71,34239.81
5539,U18675,201,-1783.0200000000004,182,19,23850.160000000003,22067.140000000003
5540,U9284,201,2459.8199999999983,177,24,43784.04000000001,46243.86000000001
5541,U19157,201,-3208.939999999986,161,40,268409.44999999995,265200.50999999995
5542,U13770,201,11755.289999999994,159,42,112387.84999999999,124143.13999999998
5543,U27208,201,-928.1800000000023,180,21,140961.07,140032.89
5544,U30946,201,68673.97000000002,168,33,75698.92999999998,144372.9
5545,U23905,201,-3270.8399999999983,150,51,115805.0,112534.16
5546,U17087,201,-10334.249999999996,154,47,159429.51,149095.26
5547,U36888,201,-885.5900000000009,176,25,20210.149999999998,19324.559999999998
5548,U1206946,201,-3213.0400000000013,146,55,140285.98,137072.94
5549,U12876,201,3565.829999999996,168,33,178830.71,182396.53999999998
5550,U23014,201,-11853.020000000004,179,22,378056.23,366203.20999999996
5551,U40692,201,-34570.53999999999,185,16,278843.66,244273.12
5552,U21276,201,35142.530000000006,130,71,1874096.24,1909238.77
5553,U18768,201,-98628.79000000004,163,38,1316382.5799999998,1217753.7899999998
5554,U27207,201,28363.949999999983,178,23,580819.22,609183.1699999999
5555,U42475,201,30660.01000000002,168,33,54900.420000000006,85560.43000000002
5556,U22814,201,21719.679999999993,175,26,98306.5,120026.18
5557,U24311,201,-1692.4099999999366,175,26,707204.9799999999,705512.57
5558,U14363,201,-13784.450000000003,182,19,89095.01000000002,75310.56000000003
5559,U27437,201,-7115.960000000005,146,55,278661.11,271545.14999999997
5560,U25842,201,-30441.969999999994,185,16,109971.06000000001,79529.09000000003
5561,U13767,201,-3377.6599999999976,191,10,51228.470000000016,47850.81000000002
5562,U32206,201,-7994.469999999988,122,79,458092.61999999994,450098.14999999997
5563,U37891,201,-4104.989999999993,159,42,108698.79,104593.8
5564,U27080,201,-115781.19,183,18,245980.99,130199.79999999999
5565,U19760,201,20364.209999999963,141,60,1032880.53,1053244.74
5566,U10412,201,559084.3100000003,181,20,1832272.220000001,2391356.530000001
5567,U19825,201,23594.26000000001,105,96,5845018.0,5868612.26
5568,U22341,201,-2274.619999999997,144,57,404127.59999999986,401852.97999999986
5569,U38321,200,-101037.54,185,15,119139.89,18102.350000000006
5570,U1375345,200,-2906.3800000000024,117,83,231573.97999999992,228667.59999999992
5571,U34810,200,-31144.320000000003,167,33,99117.77999999998,67973.45999999998
5572,U14805,200,25427.070000000003,178,22,94179.70999999999,119606.78
5573,U22110,200,-6517.76,189,11,25697.460000000003,19179.700000000004
5574,U11469,200,-8517.29999999993,72,128,3753400.94,3744883.64
5575,U12611,200,439.6800000000003,185,15,14780.500000000002,15220.180000000002
5576,U9584,200,27303.920000000013,150,50,385337.5000000001,412641.42000000016
5577,U14875,200,4499.290000000037,131,69,846575.0700000001,851074.3600000001
5578,U16549,200,-20072.29999999995,172,28,754043.98,733971.68
5579,U19570,200,46869.739999999976,122,78,214266.00000000012,261135.7400000001
5580,U41548,200,22984.979999999985,175,25,201920.63999999996,224905.61999999994
5581,U9441,200,-42562.59,174,26,109847.83,67285.24
5582,U37307,200,1184.340000000002,182,18,18755.369999999995,19939.71
5583,U16122,200,8862.549999999954,184,16,1602084.78,1610947.33
5584,U39491,200,207619.67,162,38,223378.33000000002,430998.0
5585,U33897,200,-546258.8299999991,108,92,17863759.49,17317500.66
5586,U31795,200,-5343.369999999966,173,27,854837.7999999998,849494.4299999998
5587,U8443,200,40088.670000000006,124,76,396880.25000000006,436968.92000000004
5588,U14376,200,-8698.980000000018,169,31,917120.9699999999,908421.9899999999
5589,U10454,200,45458.31,184,16,190187.39,235645.7
5590,U8030,200,-50880.450000000084,181,19,482785.34,431904.88999999996
5591,U11697,200,-218168.36,193,7,253928.9599999999,35760.59999999992
5592,U19568,200,163604.58000000002,151,49,377156.8299999999,540761.4099999999
5593,U32050,200,-480.1799999999955,177,23,34293.66,33813.48000000001
5594,U21401,200,-99846.0400000001,119,81,1245473.5799999998,1145627.5399999998
5595,U15155,200,2424.969999999998,183,17,67365.55,69790.52
5596,U19443,200,11150.149999999992,173,27,488329.85,499479.99999999994
5597,U32047,200,-31089.009999999995,171,29,235311.30999999997,204222.3
5598,U32529,200,-18597.520000000004,151,49,140376.46,121778.93999999999
5599,U28143,200,-44340.91000000001,120,80,435983.62000000017,391642.71000000014
5600,U29195,200,5544.180000000001,148,52,56584.51000000001,62128.69000000001
5601,U43698,200,-15282.760000000011,184,16,202114.54999999996,186831.78999999995
5602,U17027,200,50453.10999999998,153,47,449881.54000000004,500334.65
5603,U25035,200,-97428.81000000017,142,58,2068021.35,1970592.54
5604,U14438,200,10675.149999999983,168,32,202094.52,212769.66999999998
5605,U15567,200,12851.18,174,26,247475.03000000003,260326.21000000002
5606,U17914,200,-148045.67000000013,143,57,2821284.919999999,2673239.249999999
5607,U10944,200,-5960.540000000021,188,12,129607.01999999996,123646.47999999994
5608,U12568,200,54795.97999999999,151,49,687946.3500000001,742742.3300000001
5609,U12008,200,-224369.15999999995,181,19,1172729.34,948360.1800000002
5610,U11462,200,-129218.32999999999,171,29,1627653.5499999998,1498435.2199999997
5611,U9289,200,-23757.70000000002,150,50,369697.4100000002,345939.7100000002
5612,U43132,200,8480.609999999999,123,77,492870.45,501351.06
5613,U758164,200,1031.4300000000019,126,74,21348.409999999996,22379.839999999997
5614,U29536,200,-2869.5000000000027,166,34,35903.19,33033.69
5615,U22649,200,24888.030000000002,179,21,348772.76,373660.79000000004
5616,U39081,200,38042.840000000055,116,84,793419.4099999999,831462.25
5617,U21150,200,-9402.57000000004,140,60,664801.7499999999,655399.1799999998
5618,U13136,200,11164.79,183,17,46217.19,57381.98
5619,U10334,200,99735.53,178,22,191190.15999999995,290925.68999999994
5620,U12592,200,-1400.0699999999918,165,35,88357.81999999999,86957.75
5621,U31879,200,-8153.6799999999985,190,10,24644.149999999998,16490.47
5622,U13296,200,-20451.469999999994,176,24,48899.57000000004,28448.10000000005
5623,U19555,200,1499.979999999985,158,42,571782.26,573282.24
5624,U37533,200,-25647.009999999995,171,29,450246.46,424599.45
5625,U21659,200,-79165.74,177,23,167872.55999999997,88706.81999999996
5626,U9757,200,-8446.239999999996,143,57,129283.36000000003,120837.12000000004
5627,U11059,200,78546.30000000002,163,37,139048.91999999995,217595.21999999997
5628,U33456,200,11125.089999999993,131,69,550600.9800000002,561726.0700000002
5629,U33808,200,-38649.119999999944,183,17,432362.9200000001,393713.80000000016
5630,U22175,200,-9142.449999999993,189,11,73583.82,64441.37000000001
5631,U18433,200,-212.34000000000015,186,14,177909.06999999998,177696.72999999998
5632,U12450,200,1810.21,170,30,50209.16999999999,52019.37999999999
5633,U32374,200,-591436.270000001,129,71,9117715.75,8526279.479999999
5634,U36146,200,27244.81000000015,165,35,1726916.8000000003,1754161.6100000003
5635,U33777,199,392.01999999999424,169,30,148513.25999999998,148905.27999999997
5636,U44047,199,49791.0,119,80,188006.22000000003,237797.22000000003
5637,U20285,199,-285.70000000000346,168,31,108410.80000000003,108125.10000000003
5638,U32729,199,2523.139999999995,168,31,120701.01000000002,123224.15000000002
5639,U33366,199,-510645.9399999998,186,13,5074517.720000001,4563871.780000001
5640,U824643,199,814.7999999999693,180,19,345326.52,346141.32
5641,U19082,199,-2156.4900000000002,193,6,11210.46,9053.97
5642,U14993,199,-120046.41999999998,174,25,949648.67,829602.25
5643,U36692,199,24514.05,166,33,243627.11,268141.16
5644,U13677,199,25269.30999999959,116,83,21248584.529999997,21273853.839999996
5645,U13249,199,-30337.300000000017,177,22,251376.1499999999,221038.8499999999
5646,U27018,199,-38406.41000000003,152,47,670676.66,632270.25
5647,U19036,199,-5112.3999999999905,148,51,1590640.3800000001,1585527.9800000002
5648,U12175,199,-15222.149999999994,171,28,115351.70000000001,100129.55000000002
5649,U32807,199,-966.0699999999997,136,63,254812.84999999998,253846.77999999997
5650,U18458,199,8873.980000000023,167,32,333603.70999999996,342477.69
5651,U40984,199,-15763.370000000017,161,38,76689.96,60926.58999999999
5652,U40024,199,57492.91999999982,120,79,2808068.95,2865561.87
5653,U38330,199,16832.16,121,78,69377.03,86209.19
5654,U11274,199,-16445.070000000043,156,43,1169240.0700000003,1152795.0000000002
5655,U15571,199,167104.77999999997,174,25,6244716.880000001,6411821.660000001
5656,U27759,199,-3602.6399999999994,180,19,114770.4,111167.76
5657,U13184,199,-3597.4999999999927,156,43,551784.0900000001,548186.5900000001
5658,U40534,199,61536.29000000001,194,5,39619.29,101155.58000000002
5659,U29605,199,1517.549999999998,142,57,47339.979999999996,48857.52999999999
5660,U21444,199,-13819.769999999999,128,71,498616.17999999976,484796.40999999974
5661,U37394,199,-21890.15,152,47,131559.36999999994,109669.21999999994
5662,U39140,199,-159124.99000000002,184,15,199027.88,39902.889999999985
5663,U38156,199,10809.040000000003,188,11,541904.5200000001,552713.5600000002
5664,U26770,199,-14511.470000000021,132,67,571361.72,556850.25
5665,U21032,199,2383.5000000000005,117,82,248599.84,250983.34
5666,U15696,199,-10389.970000000003,166,33,302254.94,291864.97
5667,U8520,199,49048.02,178,21,329686.75,378734.77
5668,U36783,199,-30445.560000000056,147,52,693699.6699999999,663254.1099999999
5669,U31230,199,-345.09000000000106,179,20,34138.149999999994,33793.05999999999
5670,U33127,199,91819.6,157,42,531528.8,623348.4
5671,U39948,199,-1647.659999999989,158,41,403734.62,402086.96
5672,U11708,199,-95747.6300000001,139,60,854380.7999999999,758633.1699999998
5673,U25158,199,19670.61,182,17,70018.11,89688.72
5674,U22149,199,97.63999999999821,181,18,44204.84000000003,44302.48000000003
5675,U33149,199,-17433.0,184,15,206080.03999999998,188647.03999999998
5676,U32339,199,3868.980000000036,112,87,767403.46,771272.44
5677,U37094,199,3731.1799999999985,165,34,77622.95999999999,81354.13999999998
5678,U30738,199,-46488.759999999995,132,67,380861.6,334372.83999999997
5679,U27243,199,4077.8800000000015,153,46,83110.37,87188.25
5680,U32272,199,-356.19999999999857,108,91,29524.089999999993,29167.889999999996
5681,U1377733,199,3153.9400000000032,168,31,75194.64000000001,78348.58000000002
5682,U37883,198,-5848.139999999998,185,13,73161.21,67313.07
5683,U39798,198,14701.069999999963,129,69,752037.1299999999,766738.1999999998
5684,U17174,198,-228.76999999996042,156,42,3204333.6799999997,3204104.9099999997
5685,U26968,198,2357.010000000013,175,23,145168.14,147525.15000000002
5686,U19283,198,4065.4699999999575,158,40,853269.3400000001,857334.81
5687,U29553,198,-9370.279999999995,173,25,66017.50999999998,56647.22999999998
5688,U15162,198,-42669.590000000026,163,35,97023.98,54354.38999999997
5689,U42159,198,148882.27000000002,86,112,550141.68,699023.9500000001
5690,U677098,198,15921.049999999996,141,57,277563.43999999994,293484.48999999993
5691,U15564,198,16633.590000000007,166,32,92736.86999999997,109370.45999999998
5692,U12716,198,-4183.719999999985,139,59,681921.6200000001,677737.9000000001
5693,U24238,198,1852.9300000000003,158,40,153416.89,155269.82
5694,U29132,198,-1007499.52,177,21,1174485.0,166985.47999999998
5695,U38662,198,15092.610000000013,178,20,318132.5799999997,333225.1899999997
5696,U37389,198,4882.820000000007,155,43,415705.36,420588.18
5697,U18473,198,70927.69000000003,155,43,443977.62,514905.31000000006
5698,U36875,198,2867.0999999999995,154,44,102028.77,104895.87000000001
5699,U16447,198,5221.810000000009,179,19,118683.87999999999,123905.69
5700,U13952,198,32507.649999999987,179,19,159581.08000000002,192088.73
5701,U43626,198,4031.3400000000065,172,26,52882.649999999994,56913.99
5702,U9364,198,-6267.050000000014,185,13,145227.07,138960.02
5703,U688538,198,-4680.409999999993,136,62,93910.73,89230.32
5704,U22009,198,176731.77,163,35,305358.19,482089.95999999996
5705,U23772,198,22102.289999999968,129,69,291890.54,313992.82999999996
5706,U41576,198,4222.009999999981,169,29,393328.7399999999,397550.7499999999
5707,U34003,198,2836.6200000000013,180,18,221299.80999999985,224136.42999999985
5708,U36998,198,24709.639999999992,159,39,68420.55000000003,93130.19000000003
5709,U33877,198,-239.62000000000262,168,30,119848.88,119609.26000000001
5710,U12441,198,-548.8899999999983,175,23,38746.44,38197.55
5711,U32019,198,18244.570000000014,188,10,88348.54000000002,106593.11000000004
5712,U28175,198,-59312.920000000144,174,24,1347485.9100000001,1288172.99
5713,U27665,198,-31374.999999999996,176,22,110191.06000000004,78816.06000000004
5714,U37717,198,-8146.000000000014,180,18,270600.93,262454.93
5715,U27075,198,105624.9200000011,168,30,2850424.8600000003,2956049.7800000017
5716,U43877,198,775773.22,64,134,1261655.1600000001,2037428.3800000001
5717,U30958,198,107475.46,89,109,549872.2500000001,657347.7100000001
5718,U43093,198,-132718.17,187,11,177557.22,44839.04999999999
5719,U39257,198,-8946.71,180,18,151876.76000000004,142930.05000000005
5720,U20258,198,-16118.78000000001,186,12,136430.81,120312.02999999998
5721,U39425,198,-97249.38000000006,136,62,1007619.7800000003,910370.4000000001
5722,U11934,198,-48245.25000000001,175,23,142100.87000000005,93855.62000000005
5723,U35421,198,43316.55999999999,180,18,63228.08000000001,106544.64
5724,U29524,198,-953.9099999999996,175,23,12477.279999999993,11523.369999999994
5725,U26226,198,17313.749999999975,146,52,665945.67,683259.42
5726,U19748,198,-732.8000000001412,177,21,1828896.6600000001,1828163.86
5727,U30488,198,-16697.30999999999,120,78,1338695.5,1321998.19
5728,U21395,198,52829.24999999999,156,42,776598.7000000002,829427.9500000002
5729,U24569,198,-3747.860000000004,178,20,306990.3,303242.44
5730,U8328,198,3142.3899999999844,168,30,169218.54,172360.93
5731,U17489,198,51426.100000000006,144,54,358906.06000000006,410332.16000000003
5732,U11099,198,44760.220000000016,179,19,30421.32,75181.54000000001
5733,U30532,198,11274.880000000136,133,65,1313232.6100000003,1324507.4900000005
5734,U13107,198,15927.78999999999,184,14,75941.80999999998,91869.59999999998
5735,U8552,198,-14264.909999999978,151,47,2050916.33,2036651.4200000002
5736,U14316,198,197.92999999999893,182,16,42879.439999999995,43077.369999999995
5737,U25407,198,18315.02000000002,110,88,758732.29,777047.31
5738,U26108,198,1496.050000000001,160,38,49968.689999999995,51464.74
5739,U18427,197,-79691.29999999999,175,22,424926.27999999997,345234.98
5740,U19457,197,-82256.9,159,38,366632.6,284375.69999999995
5741,U19294,197,-6616.039999999999,189,8,41255.97,34639.93
5742,U20687,197,588.4299999999785,178,19,643792.78,644381.21
5743,U22581,197,-7232.2399999999925,157,40,473259.7299999999,466027.48999999993
5744,U28762,197,6040.579999999976,157,40,274098.29999999993,280138.8799999999
5745,U14677,197,-68899.76999999999,180,17,232873.12,163973.35
5746,U11477,197,-75936.23,175,22,214824.00000000006,138887.77000000008
5747,U31431,197,-114031.92000000004,160,37,1454067.9500000002,1340036.0300000003
5748,U799143,197,-12173.919999999993,56,141,170087.12,157913.2
5749,U36489,197,28722.859999999993,184,13,54707.48000000001,83430.34
5750,U28901,197,26561.859999999986,160,37,324208.89999999997,350770.75999999995
5751,U13490,197,23442.119999999853,107,90,2070912.6900000004,2094354.8100000003
5752,U43657,197,-78179.27999999998,173,24,200081.58000000002,121902.30000000003
5753,U12391,197,42311.829999999034,135,62,28996872.8,29039184.63
5754,U17820,197,-131.2199999999939,151,46,175128.55999999997,174997.33999999997
5755,U17500,197,54239.05999999999,168,29,81061.20000000004,135300.26000000004
5756,U28474,197,-5873.77,162,35,53241.76000000003,47367.990000000034
5757,U30351,197,-1781.0299999999993,186,11,14454.340000000007,12673.310000000009
5758,U32854,197,-258704.81999999995,183,14,691355.3899999999,432650.56999999995
5759,U17335,197,319548.9600000001,173,24,908924.54,1228473.5
5760,U14892,197,13489.279999999997,171,26,207023.74000000002,220513.02000000002
5761,U35755,197,71.35999999999572,190,7,55748.87000000002,55820.23000000001
5762,U37929,197,-232.71999999999753,156,41,144878.21999999997,144645.49999999997
5763,U37462,197,-142245.2799999999,122,75,1634099.36,1491854.08
5764,U38747,197,16428.53,173,24,99675.78000000003,116104.31000000003
5765,U15179,197,45259.16999999998,165,32,121039.06000000001,166298.22999999998
5766,U24408,197,-9581.090000000042,80,117,485276.44,475695.35
5767,U37852,197,42605.090000000004,95,102,148060.46,190665.55
5768,U28563,197,5883.04,173,24,59177.78999999994,65060.82999999994
5769,U14721,197,-99955.50999999992,185,12,162317.44999999995,62361.94000000003
5770,U41867,197,-1445.8699999997916,112,85,2641533.46,2640087.5900000003
5771,U28191,197,33.52999999996973,108,89,1148063.3599999999,1148096.89
5772,U16586,197,10956.649999999976,107,90,450162.09,461118.74
5773,U14026,197,-2232.6200000000017,173,24,48868.45000000001,46635.83000000001
5774,U21439,197,-47080.130000000005,178,19,251216.14000000007,204136.01000000007
5775,U20717,197,819.4200000000008,186,11,31716.34000000001,32535.760000000013
5776,U26838,197,-5188.720000000005,120,77,98051.03999999985,92862.31999999985
5777,U33636,197,14295.5,128,69,648491.49,662786.99
5778,U36844,197,-101435.54000000004,145,52,1003475.9000000001,902040.3600000001
5779,U11666,197,-16900.909999999993,183,14,102587.53,85686.62000000001
5780,U10751,197,-284221.63000000006,185,12,1170121.04,885899.4099999999
5781,U31692,197,-1223.5400000000002,180,17,38501.01000000001,37277.47000000001
5782,U37092,197,-1564.1800000000048,185,12,122444.36,120880.18
5783,U15694,197,-2813.0400000000072,180,17,192531.46999999997,189718.42999999996
5784,U10544,197,27827.67,110,87,409419.69,437247.36
5785,U39801,197,-16948.100000000006,168,29,183292.8999999999,166344.7999999999
5786,U22715,197,141348.38,157,40,369383.26,510731.64
5787,U27242,197,-53539.41,158,39,378863.97,325324.55999999994
5788,U16035,197,9047.36,170,27,101884.72000000003,110932.08000000003
5789,U43476,197,-2189.5999999999976,163,34,79558.05,77368.45000000001
5790,U27563,197,1629.5599999999986,180,17,35629.42,37258.979999999996
5791,U23159,197,10077.16999999994,153,44,711595.4,721672.57
5792,U8434,197,-5330.950000000001,184,13,31207.47,25876.52
5793,U18399,197,-50254.54999999999,146,51,790386.37,740131.8200000001
5794,U9752,197,-10405.850000000024,178,19,543044.74,532638.89
5795,U13588,197,8265.25999999996,169,28,832188.12,840453.38
5796,U1153874,197,-5460.839999999997,108,89,83369.62999999996,77908.78999999996
5797,U850445,197,-4684.030000000003,151,46,39169.05,34485.02
5798,U40891,197,3125.5200000000045,185,12,44062.99000000004,47188.510000000046
5799,U29094,197,340.9400000000021,178,19,36850.15,37191.090000000004
5800,U21292,197,55922.44000000001,128,69,546185.3299999998,602107.7699999999
5801,U38050,197,-70287.97000000002,168,29,437203.26000000007,366915.29000000004
5802,U33144,197,35892.04,187,10,27804.6,63696.64
5803,U27376,197,64598.98999999999,185,12,72144.45000000001,136743.44
5804,U22641,197,2395911.930000001,147,50,3762991.699999999,6158903.63
5805,U29911,197,-468.58000000000044,182,15,7387.270000000001,6918.6900000000005
5806,U25678,197,-680093.8099999999,184,13,1216769.1099999999,536675.2999999999
5807,U22867,197,589.5600000000009,159,38,51349.10000000001,51938.66000000001
5808,U27097,197,14048.270000000004,188,9,51237.16,65285.43000000001
5809,U10643,197,-18865.67,169,28,198428.19000000003,179562.52000000002
5810,U30752,197,18366.61000000001,154,43,471846.4599999999,490213.0699999999
5811,U25423,197,-2000.119999999981,118,79,610472.1900000002,608472.0700000002
5812,U33450,196,-11171.599999999999,171,25,155384.03000000003,144212.43000000002
5813,U20739,196,-5587.320000000001,138,58,52873.65999999998,47286.33999999998
5814,U22682,196,1782.1299999999992,117,79,189753.48,191535.61000000002
5815,U41823,196,-32597.17,174,22,180143.07000000007,147545.90000000008
5816,U10357,196,34791.470000000016,172,24,689852.4000000001,724643.8700000001
5817,U17812,196,6186.260000000009,179,17,147003.47,153189.73
5818,U27523,196,-26921.81,187,9,42476.09,15554.279999999995
5819,U29679,196,109.40000000000921,157,39,584273.4500000001,584382.8500000001
5820,U17985,196,1453.659999999988,138,58,413295.5999999999,414749.2599999999
5821,U11520,196,11633.94999999994,138,58,612005.79,623639.74
5822,U18216,196,-1033.8899999999976,162,34,113473.41000000003,112439.52000000003
5823,U30182,196,-51277.399999999994,173,23,220749.07999999993,169471.67999999993
5824,U12707,196,-34984.45999999999,115,81,281349.17,246364.71
5825,U12199,196,-7460.769999999997,184,12,42570.119999999995,35109.35
5826,U29822,196,-34622.19000000002,171,25,288579.89999999997,253957.70999999996
5827,U14098,196,-598174.9300000002,164,32,4452758.949999998,3854584.019999998
5828,U19888,196,4197.680000000003,177,19,178512.87999999998,182710.55999999997
5829,U14936,196,-41286.010000000046,173,23,861151.7300000001,819865.7200000001
5830,U41317,196,-8586.079999999998,167,29,136351.65000000002,127765.57000000002
5831,U38401,196,-138.97999999999956,177,19,23302.33,23163.350000000002
5832,U41222,196,-18570.300000000017,187,9,135471.07,116900.76999999999
5833,U18346,196,-86774.46,184,12,459702.61999999994,372928.1599999999
5834,U8280,196,-86304.05,129,67,540929.69,454625.63999999996
5835,U31765,196,-36167.750000000095,111,85,1051303.03,1015135.2799999999
5836,U36896,196,17809.720000000005,192,4,31598.49,49408.21000000001
5837,U39604,196,-2620.430000000003,124,72,181269.7499999999,178649.31999999992
5838,U32834,196,3447.279999999955,168,28,1075933.94,1079381.22
5839,U8606,196,-3050.8600000000006,174,22,23474.219999999994,20423.359999999993
5840,U28067,196,-1145.0200000000004,182,14,456954.42,455809.39999999997
5841,U36725,196,-14778.520000000004,151,45,60128.94000000006,45350.42000000006
5842,U20132,196,135408.06000000465,171,25,51503266.410000026,51638674.47000003
5843,U906815,196,19.569999999997208,113,83,88424.07999999999,88443.64999999998
5844,U8310,196,37964.74,182,14,125308.66999999998,163273.40999999997
5845,U9455,196,-82137.67999999995,183,13,181331.77,99194.09000000004
5846,U43590,196,79034.91,170,26,354053.53,433088.44000000006
5847,U30563,196,17920.02999999999,145,51,880632.9299999999,898552.96
5848,U33420,196,-54229.06000000005,176,20,276425.6,222196.53999999992
5849,U11539,196,983.5699999999988,150,46,28519.989999999998,29503.559999999998
5850,U10690,196,46974.37999999998,172,24,57656.76000000002,104631.14
5851,U31869,196,-8832.160000000009,174,22,94792.96,85960.8
5852,U12819,196,28330.589999999967,152,44,149467.43000000002,177798.02
5853,U14760,196,-1454.849999999994,134,62,156414.1199999999,154959.2699999999
5854,U11414,196,388.5299999999967,175,21,75231.49999999999,75620.02999999998
5855,U21958,196,-1409.8900000000012,178,18,41225.810000000005,39815.920000000006
5856,U12692,196,122159.25000000001,169,27,459144.7400000001,581303.9900000001
5857,U29295,196,-3081.4900000000043,162,34,486030.9699999997,482949.4799999997
5858,U9460,196,2425.5700000000033,170,26,110802.64000000001,113228.21000000002
5859,U31605,196,-2404.6700000000005,192,4,14407.969999999996,12003.299999999996
5860,U22318,196,245664.3900000002,176,20,966933.2400000001,1212597.6300000004
5861,U18874,196,7926.640000000006,132,64,765193.8299999998,773120.4699999999
5862,U34625,196,-277.70999999999367,181,15,175569.08000000002,175291.37000000002
5863,U11020,196,167182.72,139,57,145550.46000000002,312733.18000000005
5864,U14894,196,10604.26999999999,160,36,303766.56,314370.82999999996
5865,U25844,196,-83099.38999999996,162,34,1390598.0099999998,1307498.6199999999
5866,U12533,196,-12105.610000000002,163,33,279768.60999999987,267662.9999999999
5867,U13634,196,4753.95999999981,119,77,2341908.74,2346662.7
5868,U27507,196,-1654.8500000000001,168,28,17350.66999999998,15695.81999999998
5869,U10346,196,43636.56,185,11,41294.64999999998,84931.20999999998
5870,U1378280,196,-7498.159999999999,139,57,41194.62,33696.46000000001
5871,U36681,196,15365.84999999999,189,7,5792.300000000002,21158.14999999999
5872,U38656,196,-19253229.390000015,153,43,41038114.73000001,21784885.339999996
5873,U14903,196,-29878.029999999984,173,23,1394012.76,1364134.73
5874,U42658,196,72258.47999999979,152,44,1858052.96,1930311.4399999997
5875,U41589,196,-115160.53000000001,160,36,288196.1,173035.56999999995
5876,U22738,196,-90028.39000000007,185,11,127541.82999999977,37513.4399999997
5877,U11798,196,88773.90000000001,180,16,61983.04000000001,150756.94
5878,U33033,196,2202.179999999997,164,32,752313.4100000003,754515.5900000003
5879,U36004,196,100755.60000000006,163,33,764560.5099999998,865316.1099999999
5880,U37679,196,-9556.64,188,8,20581.840000000004,11025.200000000004
5881,U26544,196,-14069.080000000004,174,22,136238.05000000002,122168.97000000002
5882,U37285,196,-2655.190000000003,171,25,107128.27999999994,104473.08999999994
5883,U37934,196,1193854.0299999998,171,25,519523.97000000003,1713377.9999999998
5884,U33079,195,57695.31999999997,156,39,200596.73999999985,258292.05999999982
5885,U13554,195,-12484.48999999999,177,18,63739.82000000004,51255.33000000005
5886,U29269,195,-33136.28,137,58,1547376.34,1514240.06
5887,U859087,195,-17948.580000000005,137,58,155909.61000000002,137961.03
5888,U30573,195,-5978.38,124,71,40902.939999999995,34924.56
5889,U33593,195,12057.859999999986,178,17,917757.88,929815.74
5890,U9701,195,25.19000000000267,174,21,42498.19,42523.380000000005
5891,U18226,195,-951.4399999999987,139,56,69251.15999999999,68299.71999999999
5892,U12913,195,84499.76000000205,131,64,10767674.530000001,10852174.290000003
5893,U22515,195,7363.040000000007,172,23,81921.81,89284.85
5894,U24265,195,-37683.00000000003,177,18,180566.59999999995,142883.59999999992
5895,U32498,195,-22196.12000000015,168,27,5048468.100000001,5026271.98
5896,U9873,195,-18657.58,115,80,1352012.77,1333355.19
5897,U42707,195,-23171.609999999997,157,38,412259.19000000006,389087.5800000001
5898,U35929,195,-3173.43,157,38,39935.77999999999,36762.34999999999
5899,U20888,195,-14927.809999999994,181,14,53899.740000000056,38971.930000000066
5900,U35781,195,-27138.530000000024,170,25,458434.93,431296.39999999997
5901,U16965,195,6853.979999999972,160,35,107186.45,114040.42999999996
5902,U10235,195,240781.0299999999,148,47,11642063.08,11882844.11
5903,U22476,195,-11342.690000000024,102,93,431083.26,419740.57
5904,U10311,195,12991.679999999998,173,22,45025.98000000001,58017.66000000001
5905,U15063,195,-10875.249999999978,130,65,326230.19,315354.94
5906,U8511,195,121128.46000000004,142,53,467634.38999999996,588762.85
5907,U36759,195,-479.85000000000036,186,9,21005.120000000003,20525.270000000004
5908,U40616,195,50896.33999999995,166,29,1576269.55,1627165.89
5909,U24407,195,-3500.5000000000146,136,59,635692.29,632191.79
5910,U31697,195,-300828.3999999997,168,27,738596.3500000003,437767.95000000065
5911,U39753,195,-10643.929999999977,154,41,558484.9700000002,547841.0400000003
5912,U14814,195,-126412.47999999925,168,27,16423183.180000002,16296770.700000003
5913,U22795,195,95304.76000000005,143,52,761844.23,857148.99
5914,U25865,195,-29096.489999999874,161,34,793957.9800000001,764861.4900000002
5915,U16587,195,245181.15000000002,169,26,531354.62,776535.77
5916,U31777,195,-4938.450000000047,133,62,442298.37000000005,437359.92
5917,U42697,195,-173800.85999999996,174,21,478898.6600000001,305097.80000000016
5918,U41189,195,62098.45000000001,163,32,65430.539999999986,127528.98999999999
5919,U35627,195,-198628.6699999997,149,46,6723204.0,6524575.33
5920,U30854,195,-4.129999999998981,142,53,708857.2200000001,708853.0900000001
5921,U19264,195,519.9100000000149,163,32,159686.46,160206.37
5922,U22803,195,-2970.9099999999435,87,108,1855532.8300000003,1852561.9200000004
5923,U37693,195,-9710.889999999998,157,38,222122.40999999997,212411.52
5924,U27653,195,389680.1,168,27,1285468.87,1675148.9700000002
5925,U21184,195,371.6999999999989,168,27,24487.059999999994,24858.759999999995
5926,U17000,195,-615160.6100000003,131,64,15233514.989999996,14618354.379999995
5927,U576136,195,-5907.270000000002,129,66,155425.84,149518.57
5928,U9989,195,-60825.18999999999,172,23,205818.55000000002,144993.36000000004
5929,U13673,195,-269263.60000000003,164,31,390653.56000000006,121389.96000000002
5930,U20970,195,-45832.25999999996,180,15,856026.9200000002,810194.6600000001
5931,U12256,195,-57882.50999999998,114,81,679553.4299999999,621670.9199999999
5932,U14202,195,-890.62000000033,148,47,698816.9299999968,697926.3099999964
5933,U863791,194,-17785.48,120,74,477477.11,459691.63
5934,U20360,194,-18751.610000000004,185,9,48316.04000000001,29564.430000000004
5935,U17623,194,823465.0100000002,127,67,1126724.4200000009,1950189.430000001
5936,U36697,194,106.30999999999966,172,22,14774.319999999998,14880.629999999997
5937,U28239,194,-6077.899999999925,185,9,246717.49,240639.59000000005
5938,U14817,194,1027.139999999989,148,46,893381.33,894408.47
5939,U10282,194,-98382.11999999994,172,22,631230.7999999998,532848.6799999999
5940,U25848,194,-10764.01,175,19,53784.20999999999,43020.19999999999
5941,U9944,194,-12780.119999999999,162,32,603448.6699999997,590668.5499999997
5942,U39513,194,-72461.57999999999,168,26,313860.08,241398.50000000003
5943,U10930,194,-978.0399999999988,176,18,175287.46999999997,174309.42999999996
5944,U14803,194,-6030269.470000001,137,57,29663493.220000003,23633223.75
5945,U31144,194,5120.640000000003,110,84,191719.69,196840.33000000002
5946,U43776,194,-191.01999999999953,168,26,28747.72,28556.7
5947,U24770,194,1527.2499999999995,183,11,58720.45000000002,60247.70000000002
5948,U23753,194,-26908.26000000001,152,42,830066.9800000002,803158.7200000002
5949,U34709,194,4368.210000000006,158,36,134298.9,138667.11
5950,U33423,194,25965.79,167,27,178354.05000000002,204319.84000000003
5951,U43299,194,7626.199999999999,162,32,95005.15,102631.34999999999
5952,U8553,194,-31161.60000000002,163,31,213705.96999999997,182544.36999999994
5953,U11528,194,2885.529999999983,158,36,410724.11000000004,413609.64
5954,U20545,194,36562.41,177,17,148694.33000000002,185256.74000000002
5955,U28706,194,4406.419999999993,169,25,771827.17,776233.5900000001
5956,U18901,194,-56687.98999999999,177,17,176588.71000000002,119900.72000000003
5957,U42837,194,-3071.069999999989,181,13,67940.45,64869.380000000005
5958,U34817,194,2981.560000000005,149,45,142021.52,145003.08
5959,U29318,194,15816.07,142,52,265868.68000000005,281684.75000000006
5960,U40175,194,166298.61999999997,169,25,431631.48,597930.1
5961,U35227,194,-41124.120000000024,172,22,394089.7899999999,352965.6699999999
5962,U795044,194,-8033.660000000007,107,87,299409.24000000005,291375.58
5963,U41070,194,-141050.46000000002,178,16,175292.44,34241.97999999998
5964,U10953,194,-7424.779999999814,161,33,2610780.1800000006,2603355.400000001
5965,U25593,194,-6829.969999999987,172,22,162711.65999999997,155881.69
5966,U23291,194,-104946.57000000007,151,43,762506.8400000002,657560.2700000001
5967,U32595,194,-1413.9299999999994,180,14,11929.070000000003,10515.140000000003
5968,U27692,194,-383274.64999999997,126,68,1409030.0200000003,1025755.3700000003
5969,U37733,194,-23847.18,172,22,111391.51,87544.32999999999
5970,U34480,194,69480.26,166,28,292630.20999999996,362110.47
5971,U27976,194,1599.550000000003,111,83,385468.03000000014,387067.58000000013
5972,U21660,194,2404.4500000000116,97,97,753867.33,756271.78
5973,U643296,194,-4210.469999999983,169,25,140238.08000000002,136027.61000000004
5974,U23194,194,-3033.5000000000023,168,26,57429.34000000002,54395.84000000002
5975,U10708,194,469132.66000000003,115,79,756204.63,1225337.29
5976,U10722,194,67725.63999999997,158,36,369147.01,436872.64999999997
5977,U41940,194,-2080.890000000003,170,24,41956.5,39875.61
5978,U37690,194,43705.479999999996,148,46,983176.1200000001,1026881.6000000001
5979,U13703,194,-2177.4200000000037,151,43,100516.67000000003,98339.25000000003
5980,U32818,194,4234.390000000005,131,63,1227360.79,1231595.18
5981,U31189,194,-76293.10000000002,146,48,162624.69999999995,86331.59999999993
5982,U32214,194,-18742.459999999992,188,6,22056.999999999993,3314.540000000001
5983,U25900,194,17201.62999999997,127,67,595012.19,612213.82
5984,U28256,194,2763.350000000054,161,33,623220.5400000002,625983.8900000002
5985,U29640,194,235.44000000000696,179,15,56165.249999999985,56400.689999999995
5986,U8970,194,-29837.39999999999,161,33,198122.47,168285.07
5987,U22225,194,-20217.89,188,6,25607.019999999997,5389.129999999997
5988,U10797,194,9721.770000000017,146,48,450782.51999999984,460504.28999999986
5989,U32357,194,57691.350000000006,169,25,88441.73999999999,146133.09
5990,U35693,194,-2534.940000000004,142,52,207569.78999999998,205034.84999999998
5991,U20330,194,54493.95,177,17,84945.70999999999,139439.65999999997
5992,U15779,194,-15209.25000000001,182,12,43666.94000000001,28457.690000000002
5993,U20191,194,-27765.900000000005,179,15,82058.47,54292.56999999999
5994,U25880,194,813.4200000000029,181,13,26076.18,26889.600000000002
5995,U12078,193,-396.95999999999947,172,21,36524.99999999999,36128.03999999999
5996,U11890,193,6589.980000000011,94,99,437241.04000000004,443831.0200000001
5997,U31623,193,-174101.77999999994,159,34,793046.03,618944.2500000001
5998,U27399,193,-33420.44999999998,153,40,1472922.8499999996,1439502.3999999997
5999,U42035,193,-368.2100000000171,152,41,123931.84000000004,123563.63000000002
6000,U38182,193,188924.45000000016,177,16,185085.5099999999,374009.9600000001
6001,U38615,193,-137811.77000000005,157,36,1767847.87,1630036.1
6002,U30652,193,1291.3200000000015,170,23,75965.95000000001,77257.27000000002
6003,U43267,193,694.5799999999999,177,16,12737.89,13432.47
6004,U10047,193,196191.33,186,7,23779.090000000004,219970.41999999998
6005,U28686,193,18774.52,149,44,169796.94,188571.46
6006,U40502,193,-3655.8700000000013,185,8,25429.569999999992,21773.69999999999
6007,U34412,193,-31636.14000000002,183,10,67695.44,36059.29999999998
6008,U15419,193,-12337.59000000001,142,51,527339.8900000001,515002.3000000001
6009,U33588,193,-3830.5799999999977,184,9,15174.399999999994,11343.819999999996
6010,U8069,193,-11468.560000000001,166,27,104648.89999999995,93180.33999999995
6011,U25837,193,174077.55999999994,120,73,1270251.26,1444328.8199999998
6012,U39503,193,-143678.04000000007,172,21,603190.7199999995,459512.67999999947
6013,U11033,193,-48814.92,171,22,336648.74999999994,287833.82999999996
6014,U9005,193,7320.789999999975,124,69,325052.17000000004,332372.96
6015,U31797,193,4660.380000000003,186,7,45525.09,50185.47
6016,U11083,193,-9828.699999999992,173,20,110007.86000000006,100179.16000000006
6017,U15633,193,35123.609999999986,164,29,215307.45999999993,250431.06999999992
6018,U16098,193,-4672.369999999976,166,27,838248.65,833576.28
6019,U36817,193,1787.610000000649,63,130,565169.7,566957.3100000006
6020,U31610,193,-30895.44000000001,189,4,48208.649999999994,17313.209999999985
6021,U19925,193,3780.2399999999952,174,19,92638.69000000002,96418.93000000001
6022,U36789,193,-8625.279999999999,165,28,42196.28000000001,33571.000000000015
6023,U31504,193,495.77000000000044,126,67,58432.39,58928.16
6024,U19902,193,-15956.360000000004,186,7,20935.309999999987,4978.9499999999825
6025,U14208,193,4695.620000000008,173,20,33692.649999999994,38388.270000000004
6026,U1309604,193,135.68999999999977,107,86,7651.790000000001,7787.4800000000005
6027,U16488,193,10637.81,101,92,131889.44999999998,142527.25999999998
6028,U42129,193,-34.689999999998236,141,52,40635.55,40600.86000000001
6029,U28621,193,-32144.02000000002,177,16,52713.720000000016,20569.699999999997
6030,U11859,193,-35872.95000000001,138,55,892817.9699999999,856945.0199999998
6031,U26572,193,4156.14,182,11,14341.269999999999,18497.41
6032,U27939,193,2332.8999999999965,152,41,108566.75000000001,110899.65000000001
6033,U917672,193,1593.7499999999982,105,88,68359.66,69953.41
6034,U42133,193,-12805.63000000002,157,36,205094.79,192289.15999999997
6035,U16431,193,6670.219999999914,168,25,2141276.819999998,2147947.0399999977
6036,U13999,193,-11874.349999999933,137,56,1414016.2299999997,1402141.88
6037,U28952,193,63663.61000000004,160,33,1080636.8700000003,1144300.4800000004
6038,U738047,193,53.13999999999942,98,95,21752.0,21805.14
6039,U38479,193,-14769.139999999998,137,56,105164.37,90395.23
6040,U8396,193,-1084.900000000001,174,19,87879.38,86794.48000000001
6041,U25491,193,-909.6599999999855,168,25,130357.64999999998,129447.98999999999
6042,U16991,193,71312.78,182,11,734505.1499999999,805817.9299999999
6043,U38366,193,-1013.789999999999,188,5,4914.979999999999,3901.1899999999996
6044,U38085,192,4913.0800000000745,172,20,1378659.26,1383572.34
6045,U30151,192,4505.480000000013,142,50,1205191.22,1209696.7
6046,U18046,192,-15769.780000000013,148,44,764331.3099999999,748561.5299999999
6047,U22374,192,1967.539999999838,146,46,2044626.6800000002,2046594.22
6048,U24267,192,1490.809999999999,109,83,90618.0,92108.81
6049,U33355,192,-40111.96999999999,119,73,1462686.5599999998,1422574.5899999999
6050,U34293,192,208434.6200000001,139,53,6896403.35,7104837.97
6051,U30823,192,-10635.309999999987,157,35,101421.63999999998,90786.33
6052,U35840,192,8824.170000000026,171,21,566402.5600000002,575226.7300000002
6053,U25064,192,-15126.659999999989,121,71,1572484.78,1557358.12
6054,U43811,192,-1051210.4599999997,114,78,3520230.7799999993,2469020.3199999994
6055,U17854,192,974393.5800000003,90,102,974376.11,1948769.6900000004
6056,U43966,192,-5410.760000000002,185,7,40734.58,35323.82
6057,U12200,192,-36014.4,159,33,186590.5,150576.1
6058,U9436,192,453794.5499999999,154,38,5765611.950000001,6219406.500000001
6059,U13230,192,-159604.89000000004,170,22,4701915.8999999985,4542311.009999999
6060,U25951,192,14124.240000000113,159,33,805452.14,819576.3800000001
6061,U27774,192,-40740.79999999996,133,59,500812.33999999997,460071.54000000004
6062,U18013,192,-82408.65999999997,132,60,1346866.4599999995,1264457.7999999996
6063,U16338,192,-4978.64000000002,174,18,120941.56000000001,115962.92
6064,U30499,192,3281.050000000008,123,69,18737.59,22018.640000000007
6065,U40785,192,-4664.950000000017,149,43,97008.09999999996,92343.14999999995
6066,U13382,192,2112.7000000000044,176,16,41791.27000000001,43903.970000000016
6067,U40238,192,-738.1799999999994,178,14,60526.770000000004,59788.590000000004
6068,U37954,192,-1874.270000000001,177,15,71340.0,69465.73
6069,U40117,192,-20515.14,173,19,71510.88,50995.740000000005
6070,U40787,192,5550.229999999994,105,87,293960.1199999999,299510.34999999986
6071,U38285,192,44526.05999999999,161,31,150630.08000000005,195156.14000000004
6072,U22754,192,-167063.59000000005,169,23,1261654.7200000002,1094591.1300000001
6073,U36130,192,-12064.670000000002,169,23,197293.82999999993,185229.15999999992
6074,U10846,192,579715.8300000001,128,64,1842864.8200000003,2422580.6500000004
6075,U27762,192,-4082.950000000006,172,20,125178.13,121095.18
6076,U20587,192,1024.8900000000049,174,18,110503.87000000001,111528.76000000001
6077,U21730,192,161839.22,162,30,398419.67000000004,560258.89
6078,U37261,192,91413.36000000002,174,18,211517.31,302930.67000000004
6079,U15414,192,1458.0600000000186,175,17,238970.26,240428.32000000004
6080,U33753,192,-47111.49999999998,178,14,242085.83000000013,194974.33000000016
6081,U17908,192,-12834.539999999994,185,7,47745.500000000015,34910.96000000002
6082,U18079,192,-14799.079999999944,155,37,1364890.61,1350091.5300000003
6083,U33358,192,-3826.4999999999845,167,25,161726.24,157899.74000000002
6084,U33879,192,-3402.7100000000005,185,7,13066.859999999999,9664.149999999998
6085,U14866,192,-10218.029999999897,178,14,494252.83,484034.8000000001
6086,U14253,192,-79174.40000000021,157,35,736073.57,656899.1699999997
6087,U14064,192,-39105.71000000003,135,57,326394.1600000001,287288.45000000007
6088,U9009,192,39035.48000000001,179,13,106595.51000000002,145630.99000000005
6089,U1132758,192,-52.75999999999959,109,83,33653.33,33600.57
6090,U33512,192,-5647.620000000001,184,8,26739.819999999992,21092.19999999999
6091,U14293,191,-6349.699999999993,176,15,398847.67999999993,392497.9799999999
6092,U34579,191,-737961.3799999999,127,64,935150.5800000002,197189.2000000003
6093,U18161,191,1131.0099999999961,181,10,94928.8,96059.81
6094,U20304,191,-153267.68999999994,173,18,983269.6399999999,830001.95
6095,U40831,191,11923.490000000002,67,124,16161.26,28084.75
6096,U23602,191,7021.459999999999,186,5,23311.36,30332.82
6097,U13281,191,8595.779999999999,173,18,599840.69,608436.47
6098,U25296,191,-396221.3000000001,111,80,5305983.740000001,4909762.440000001
6099,U27967,191,-108.86000000001513,174,17,196673.57999999996,196564.71999999994
6100,U31104,191,362355.59,171,20,718449.3600000001,1080804.9500000002
6101,U17479,191,28750.20000000082,170,21,3977522.929999999,4006273.1299999994
6102,U10375,191,-24612.440000000017,144,47,508762.16000000015,484149.72000000015
6103,U8917,191,458.4600000000037,165,26,310630.37000000005,311088.8300000001
6104,U29619,191,2893.3399999999965,164,27,279035.68,281929.02
6105,U26531,191,65915.46999999997,160,31,372730.7999999998,438646.2699999998
6106,U39953,191,1124.2499999999802,163,28,541361.7799999999,542486.0299999999
6107,U22079,191,6569.700000000001,166,25,29538.38000000001,36108.08000000001
6108,U15800,191,-173894.22999999992,175,16,551374.9000000004,377480.67000000045
6109,U26088,191,69779.58000000007,173,18,555827.71,625607.29
6110,U14039,191,9266.690000000013,134,57,210315.44999999998,219582.13999999998
6111,U9342,191,-10876.779999999955,180,11,366135.73,355258.95
6112,U16477,191,-2559.2699999999973,170,21,88081.56000000001,85522.29000000001
6113,U24774,191,-911.6900000000096,153,38,206030.93,205119.24
6114,U33400,191,27381.399999999976,158,33,78969.33000000003,106350.73000000001
6115,U24792,191,97700.04000000002,153,38,594249.0199999999,691949.0599999999
6116,U14196,191,-1512.0,174,17,131943.21000000002,130431.21000000002
6117,U18280,191,739.3000000000069,143,48,86356.85,87096.15000000001
6118,U28565,191,7527.86,162,29,104040.12,111567.98
6119,U22537,191,-825040.1299999998,156,35,3522711.9699999993,2697671.8399999994
6120,U11115,191,944.1699999999983,169,22,227813.37000000002,228757.54000000004
6121,U21046,191,352152.17,181,10,162750.51,514902.68
6122,U8778,191,17182.620000000003,176,15,65613.33000000002,82795.95000000001
6123,U17301,191,-112116.85999999997,166,25,400779.95000000007,288663.0900000001
6124,U43805,191,1534.0,175,16,31609.52,33143.520000000004
6125,U1128341,191,1444.75,164,27,17213.230000000007,18657.980000000007
6126,U37896,191,-10407.470000000008,185,6,87600.82,77193.35
6127,U757382,191,-1.8599999999760257,97,94,248064.32,248062.46000000002
6128,U23491,191,43353.149999999994,179,12,159173.5199999999,202526.6699999999
6129,U32095,191,30525.959999999995,160,31,114475.77000000002,145001.73
6130,U39412,191,221776.00000000003,174,17,23300.870000000003,245076.87000000002
6131,U42713,191,91595.0399999999,166,25,417192.4199999999,508787.45999999985
6132,U39007,191,398779.7700000002,174,17,2095760.3900000006,2494540.1600000006
6133,U38569,191,10856.600000000013,153,38,669095.1000000002,679951.7000000002
6134,U13837,191,176787.79999999993,161,30,966120.5500000003,1142908.35
6135,U43293,191,4560.889999999999,162,29,21517.480000000003,26078.370000000003
6136,U30332,191,1602630.0699999996,145,46,5071944.100000001,6674574.17
6137,U25139,191,-22159.22,183,8,81245.04,59085.81999999999
6138,U26403,191,-116267.31999999999,168,23,768856.3300000001,652589.0100000001
6139,U31311,191,-13330.120000000003,133,58,236698.15999999997,223368.03999999998
6140,U13599,191,-227.73999999996158,128,63,2001904.4800000002,2001676.7400000002
6141,U11306,191,5215.59,163,28,11894.26,17109.85
6142,U22727,191,53602.76999999997,103,88,417537.0099999998,471139.77999999974
6143,U35211,191,1247.7499999999854,178,13,224255.15000000008,225502.90000000008
6144,U31746,191,-26484.82,168,23,138167.57,111682.75
6145,U758224,191,-0.7300000000000004,167,24,76970.71000000002,76969.98000000003
6146,U1195977,191,-4299.380000000011,127,64,177392.76,173093.38
6147,U25191,191,10751.669999999998,151,40,138525.86999999997,149277.53999999998
6148,U15550,191,-15038.839999999887,155,36,1013031.3,997992.4600000002
6149,U15688,191,-14201.819999999998,170,21,125124.79000000002,110922.97000000003
6150,U16000,191,456875.4,168,23,1440615.64,1897491.04
6151,U12299,191,5978.219999999942,164,27,287268.76,293246.9799999999
6152,U32453,191,-2036.7700000000036,183,8,57196.83,55160.06
6153,U28842,191,-8701.29,167,24,131258.8,122557.50999999998
6154,U25887,191,-2130.250000000029,135,56,822465.1499999999,820334.8999999999
6155,U41329,191,396.9199999999837,141,50,1415074.3599999999,1415471.2799999998
6156,U23627,191,-87484.98999999999,171,20,184838.38,97353.39000000001
6157,U34962,191,11671.91,176,15,38442.1,50114.009999999995
6158,U24848,191,-42473.66000000001,153,38,181797.66999999998,139324.00999999998
6159,U32899,191,-2775.6699999999873,146,45,204364.16000000003,201588.49000000005
6160,U34128,190,-31.14000000000292,168,22,46581.77000000001,46550.63000000001
6161,U32461,190,-104395.17000000007,178,12,213997.94999999987,109602.7799999998
6162,U37999,190,-3292.6799999999976,173,17,50858.76000000001,47566.08000000001
6163,U16527,190,-38705.549999999814,166,24,1183708.51,1145002.9600000002
6164,U21108,190,10155.88,154,36,27940.629999999986,38096.50999999999
6165,U19182,190,976.9800000000032,141,49,274850.29000000004,275827.27
6166,U41560,190,-6123.860000000004,92,98,199499.22,193375.36
6167,U26737,190,-401.6499999999942,163,27,69477.68000000002,69076.03000000003
6168,U22164,190,-162606.28000000006,145,45,1005659.46,843053.1799999999
6169,U31323,190,2622.51,179,11,11720.25,14342.76
6170,U34668,190,-4406.550000000001,121,69,256331.52,251924.97
6171,U12351,190,12124.910000000003,160,30,242723.92999999996,254848.83999999997
6172,U40446,190,12062.550000000008,115,75,273967.86999999994,286030.4199999999
6173,U21251,190,-2441.6799999998984,170,20,431891.4899999999,429449.81
6174,U8463,190,-955.3299999999867,177,13,119200.67999999998,118245.34999999999
6175,U13505,190,-72657.26999999993,131,59,1651402.8800000001,1578745.61
6176,U42810,190,7268.279999999999,174,16,281345.94,288614.22
6177,U43687,190,-3807.6899999999987,148,42,170797.15999999997,166989.46999999997
6178,U29322,190,-18981.74999999998,155,35,693249.5900000001,674267.8400000001
6179,U10280,190,74951.78000000007,170,20,74854.25,149806.0300000001
6180,U37925,190,-1394.4299999999982,165,25,7497.829999999998,6103.4
6181,U20165,190,498708.6799999998,174,16,912155.1000000001,1410863.7799999998
6182,U8929,190,174134.8,132,58,840583.2800000001,1014718.0800000001
6183,U12402,190,1743.3200000002316,41,149,6492408.09,6494151.41
6184,U12488,190,-42863.27000000002,172,18,231770.6,188907.33
6185,U28118,190,-6222.480000000003,175,15,216345.63000000003,210123.15000000002
6186,U22170,190,23549.97999999959,131,59,4757104.66,4780654.64
6187,U43580,190,-2284.479999999994,185,5,14984.549999999994,12700.07
6188,U36730,190,-100.00000000000392,103,87,42729.49000000001,42629.490000000005
6189,U1165125,190,-1492.86,159,31,12364.81,10871.949999999999
6190,U17025,190,30242.19000000014,143,47,2386016.139999999,2416258.329999999
6191,U33980,190,-144088.3700000001,157,33,2578234.0499999993,2434145.6799999992
6192,U10726,190,4155.190000000002,153,37,291462.05000000005,295617.24000000005
6193,U10954,190,-2303.3599999999856,137,53,463158.10999999987,460854.7499999999
6194,U8976,190,-2802.6299999999956,141,49,72533.41999999998,69730.79
6195,U30075,190,-22900.730000000003,156,34,402222.79,379322.06
6196,U1379835,190,3709.39,139,51,26174.360000000008,29883.750000000007
6197,U16060,190,-7116.679999999917,162,28,492942.70999999996,485826.03
6198,U39829,190,21521.99000000001,161,29,89085.29000000004,110607.28000000004
6199,U39044,190,-29673.83000000001,161,29,480693.54000000004,451019.71
6200,U41308,190,5238.8399999999965,164,26,90739.60000000003,95978.44000000003
6201,U39903,190,-35136.610000000015,172,18,116425.94999999994,81289.33999999992
6202,U29489,190,-5670.719999999979,83,107,1406444.6300000001,1400773.9100000001
6203,U37384,190,1792.9799999999932,160,30,54898.11000000006,56691.090000000055
6204,U41013,190,93324.36,171,19,263172.31000000006,356496.67000000004
6205,U28572,190,165203.56999999998,177,13,451648.3300000001,616851.9
6206,U41230,190,1992.3299999999995,179,11,73627.61000000003,75619.94000000003
6207,U39906,190,3633.949999999996,156,34,120892.53999999998,124526.48999999998
6208,U33938,190,-33181.15000000002,142,48,452932.68,419751.52999999997
6209,U40871,189,-380.3100000000122,115,74,325272.3,324891.99
6210,U21000,189,-33227.70000000002,154,35,459239.48,426011.77999999997
6211,U33246,189,250458.6899999999,153,36,6019190.25,6269648.9399999995
6212,U26240,189,245402.95,171,18,294389.02,539791.97
6213,U35610,189,542.8799999999997,170,19,29163.160000000003,29706.040000000005
6214,U16817,189,106772.7400000001,158,31,1081708.9800000002,1188481.7200000002
6215,U33022,189,12981.830000000004,98,91,482984.8300000001,495966.6600000001
6216,U14056,189,-32873.30000000002,129,60,517986.07,485112.77
6217,U18734,189,-66126.23,171,18,395944.41000000003,329818.18000000005
6218,U18459,189,-155354.78,149,40,331761.16,176406.37999999998
6219,U39325,189,-24793.01,178,11,42841.02000000002,18048.01000000002
6220,U20685,189,-1501.9000000000087,113,76,229779.2,228277.3
6221,U37016,189,-53331.18000000001,181,8,117114.38000000003,63783.200000000026
6222,U42509,189,-9515.179999999997,151,38,276416.08,266900.9
6223,U39284,189,2966.1400000000003,171,18,71803.08999999998,74769.22999999998
6224,U23892,189,12670.919999999991,174,15,72544.48,85215.4
6225,U42410,189,-12556.450000000012,122,67,365613.57999999996,353057.12999999995
6226,U922464,189,-33859.54000000003,110,79,242294.65000000002,208435.11
6227,U10836,189,4628.079999999998,176,13,63492.739999999976,68120.81999999998
6228,U31914,189,107853.97999999998,171,18,85689.30000000002,193543.28
6229,U34496,189,2101.0799999999995,155,34,63672.680000000015,65773.76000000001
6230,U27407,189,9901.689999999997,170,19,24772.530000000002,34674.22
6231,U27877,189,-1297.079999999998,159,30,39232.12000000001,37935.04000000001
6232,U12749,189,35040.13000000001,95,94,1157099.16,1192139.29
6233,U28284,189,11686.580000000002,168,21,60301.06000000001,71987.64000000001
6234,U20401,189,17901.200000000008,121,68,317933.86999999994,335835.06999999995
6235,U15755,189,-116254.91999999998,180,9,228417.15999999997,112162.23999999999
6236,U30018,189,-1950.419999999911,128,61,898672.94,896722.52
6237,U14296,189,-14772.660000000382,109,80,8098243.6000000015,8083470.940000001
6238,U11075,189,44464.380000000165,132,57,12100208.800000004,12144673.180000005
6239,U28666,189,1194.1900000000005,178,11,28754.150000000005,29948.340000000004
6240,U39228,189,5249.259999999999,179,10,66626.49,71875.75
6241,U25492,189,18270.460000000006,171,18,121628.11999999998,139898.58
6242,U16227,189,-4660.079999999962,147,42,10299372.920000007,10294712.840000007
6243,U27109,189,6111.039999999979,133,56,718891.49,725002.53
6244,U16974,189,44467.1,162,27,627228.9699999999,671696.0699999998
6245,U25077,189,11130.380000000005,135,54,1351840.2199999997,1362970.5999999996
6246,U12648,189,-43462.91,166,23,419488.26,376025.35
6247,U11832,189,8139.040000000031,150,39,921882.2499999999,930021.2899999999
6248,U15638,189,-2320.550000000014,172,17,357392.8200000001,355072.27000000014
6249,U19952,189,-2304.9000000000015,115,74,543601.9199999999,541297.0199999999
6250,U9283,189,6006.329999999993,160,29,285059.58999999997,291065.92
6251,U21011,189,-175541.34000000017,153,36,2113449.0199999996,1937907.6799999995
6252,U24969,189,-12024.669999999904,138,51,4867553.9799999995,4855529.31
6253,U18588,189,-3934.3100000000177,143,46,226042.12000000002,222107.81
6254,U8406,189,-1196.0099999999939,161,28,54621.57,53425.560000000005
6255,U30550,189,-13522.739999999985,142,47,605784.1900000001,592261.4500000001
6256,U40959,189,-48.34000000002561,93,96,1284853.36,1284805.02
6257,U14834,189,36789.59999999999,169,20,338658.13000000006,375447.73000000004
6258,U13968,189,17798.489999999998,144,45,631757.1300000004,649555.6200000003
6259,U30950,189,61.43000000000211,113,76,76276.35999999999,76337.79
6260,U23497,189,-148830.14,146,43,863128.7199999997,714298.5799999997
6261,U30821,189,-1232.9800000000098,132,57,341241.42000000016,340008.4400000002
6262,U39422,189,7980.5399999999845,149,40,231586.5999999999,239567.13999999987
6263,U20909,189,-175832.82,136,53,1269217.64,1093384.8199999998
6264,U28794,189,941.8999999999933,160,29,167998.11,168940.00999999998
6265,U17040,189,-8156.550000000221,100,89,3417691.74,3409535.19
6266,U24415,189,3212.7000000000407,175,14,243739.15000000005,246951.8500000001
6267,U32468,189,6849.520000000003,177,12,124562.93999999997,131412.45999999996
6268,U42264,189,5993.069999999992,172,17,69167.15000000002,75160.22000000002
6269,U32493,189,20834.98,169,20,286950.79,307785.76999999996
6270,U25934,189,3962.7400000000002,178,11,27615.13,31577.870000000003
6271,U43029,189,69687.90000000002,160,29,144313.59999999998,214001.5
6272,U13325,189,152916.17000000007,136,53,1809620.8499999996,1962537.0199999998
6273,U30343,189,3526.470000000005,117,72,80018.56999999998,83545.03999999998
6274,U24492,188,4604.410000000007,170,18,135580.53,140184.94
6275,U34736,188,6446.740000000011,164,24,576576.31,583023.05
6276,U36790,188,19038.740000000005,92,96,69261.73999999999,88300.48
6277,U13967,188,12292.219999999998,62,126,194750.03999999998,207042.25999999998
6278,U9064,188,-7204.309999999992,155,33,1233448.43,1226244.1199999999
6279,U29656,188,-4266.279999999999,179,9,26375.319999999996,22109.039999999997
6280,U43191,188,8653.910000000003,181,7,68964.3,77618.21
6281,U11314,188,-4134.269999999999,173,15,91537.51000000001,87403.24
6282,U43350,188,303.6499999999983,176,12,57760.57000000001,58064.22000000001
6283,U33973,188,81408.22,177,11,121439.19000000002,202847.41000000003
6284,U21621,188,21259.72,169,19,20511.34,41771.06
6285,U9648,188,53067.15999999999,155,33,445873.74000000005,498940.9
6286,U21284,188,46368.47,149,39,236392.74999999997,282761.22
6287,U32855,188,-52112.17999999996,173,15,273180.64999999997,221068.47
6288,U1369486,188,-287.94999999999663,114,74,66359.81999999999,66071.87
6289,U23445,188,14903.0,148,40,822068.7300000001,836971.7300000001
6290,U10727,188,17309.259999999973,167,21,380149.48,397458.73999999993
6291,U9770,188,-3079.929999999993,122,66,176973.96,173894.03
6292,U16194,188,-1396.159999999989,133,55,221865.97999999984,220469.81999999983
6293,U20986,188,-30209.24,163,25,79661.79000000001,49452.55
6294,U19272,188,18381.329999999998,167,21,28353.649999999998,46734.979999999996
6295,U29343,188,78860.01000000002,171,17,451048.2,529908.2100000001
6296,U8580,188,-29816.600000000006,167,21,73155.61,43339.009999999995
6297,U12586,188,101563.84000000001,155,33,159481.83999999997,261045.68
6298,U21991,188,21935.610000000004,170,18,154175.47,176111.08000000002
6299,U11133,188,-48.5600000000433,124,64,471530.20999999996,471481.6499999999
6300,U18222,188,-27354.94999999999,160,28,459191.32,431836.37
6301,U12500,188,-36.06000000000313,176,12,29861.29,29825.229999999996
6302,U13483,188,11811.86,164,24,69983.22,81795.08
6303,U10995,188,-822.1300000000067,165,23,119046.69999999998,118224.56999999998
6304,U41980,188,4097.789999999979,133,55,456277.68,460375.47
6305,U25275,188,13189.43999999998,177,11,184373.78000000035,197563.22000000032
6306,U9901,188,-10527.990000000009,163,25,399672.2000000001,389144.21000000014
6307,U40730,188,258510.68999999994,102,86,1973093.4599999997,2231604.1499999994
6308,U13375,188,16465.470000000016,156,32,990778.85,1007244.32
6309,U43429,188,-9418.590000000004,177,11,56467.189999999995,47048.59999999999
6310,U17570,188,-108916.87999999996,168,20,442225.17000000004,333308.2900000001
6311,U13211,188,-3410.829999999929,138,50,668502.7899999999,665091.96
6312,U18872,188,-818.7799999999972,165,23,44316.119999999995,43497.34
6313,U25271,188,-2641.8199999999965,134,54,153581.89000000004,150940.07000000004
6314,U33377,188,668.3599999999951,157,31,208829.11,209497.46999999997
6315,U34111,188,-1174.74,171,17,7915.699999999999,6740.959999999999
6316,U22705,188,3461.959999999991,165,23,391751.14,395213.1
6317,U17713,188,-1148.3500000000076,117,71,505622.25999999995,504473.9099999999
6318,U15184,188,8947.750000000107,145,43,823148.45,832096.2000000001
6319,U41726,188,1047.199999999997,123,65,232087.97999999998,233135.18
6320,U22022,188,-45245.47999999998,152,36,2106964.3000000003,2061718.8200000003
6321,U31519,188,1004.0600000000004,176,12,38965.93,39969.99
6322,U28297,188,1232.009999999982,139,49,466921.01000000007,468153.0200000001
6323,U34566,188,5679.010000000002,169,19,26753.64,32432.65
6324,U15823,188,-626034.4800000001,168,20,2798544.5899999994,2172510.1099999994
6325,U21260,188,-12770.050000000001,150,38,62030.15000000001,49260.100000000006
6326,U41713,188,-17384.050000000003,177,11,51208.029999999984,33823.97999999998
6327,U23496,188,16695.090000000007,173,15,160515.64999999997,177210.73999999996
6328,U39680,188,-3556.1499999999983,180,8,50551.200000000004,46995.05
6329,U12336,188,-223934.71999999997,156,32,910034.8800000001,686100.1600000001
6330,U37525,188,-28997.850000000013,168,20,124085.64000000006,95087.79000000004
6331,U26429,188,11305.450000000006,155,33,496432.3099999999,507737.7599999999
6332,U42424,188,-30771.010000000002,152,36,100041.48,69270.47
6333,U20827,188,13801.629999999986,119,69,318303.04000000004,332104.67000000004
6334,U16342,188,-51537.33000000054,136,52,6166899.390000001,6115362.0600000005
6335,U19037,188,-1067.1199999999894,139,49,285962.97,284895.85
6336,U38501,187,-1801.6500000000078,161,26,164936.13999999996,163134.48999999996
6337,U29165,187,-148825.75999999995,172,15,297360.2899999999,148534.52999999997
6338,U24180,187,-213144.9500000001,143,44,1042668.6200000001,829523.67
6339,U33306,187,-2158.269999999999,176,11,19622.309999999987,17464.039999999986
6340,U15193,187,-49055.149999999994,174,13,140841.36,91786.20999999999
6341,U30363,187,-1573.6899999999837,137,50,1399636.0500000003,1398062.3600000003
6342,U14042,187,3091.3700000000063,169,18,59785.1,62876.47
6343,U29160,187,-30896.46,163,24,273688.15,242791.69000000003
6344,U28522,187,500.9400000000014,148,39,40962.89000000001,41463.83000000001
6345,U15399,187,-198633.5299999999,155,32,417149.52,218515.9900000001
6346,U29992,187,3595.9000000000174,95,92,2399253.59,2402849.4899999998
6347,U43556,187,-10389.540000000005,136,51,530358.6599999999,519969.11999999994
6348,U38875,187,-14218.509999999987,175,12,37823.46,23604.95000000001
6349,U28214,187,-3429.189999999993,175,12,37208.00000000001,33778.81000000001
6350,U17666,187,-51349.72000000003,119,68,330156.7199999999,278806.9999999999
6351,U16066,187,270862.49,141,46,397466.4,668328.89
6352,U39373,187,-103628.04999999997,174,13,169735.44999999998,66107.40000000001
6353,U36392,187,-2034.4700000000012,175,12,18463.199999999997,16428.729999999996
6354,U12148,187,11235.219999999998,147,40,173829.17,185064.39
6355,U33995,187,-16568.750000000007,174,13,66474.03,49905.27999999999
6356,U8481,187,336.8000000000243,134,53,575495.6400000001,575832.4400000002
6357,U19610,187,6223.55000000001,180,7,47148.82,53372.37000000001
6358,U15526,187,38600.939999999995,157,30,361329.66,399930.6
6359,U39619,187,1862.489999999998,168,19,44485.61,46348.1
6360,U39666,187,129344.86999999992,122,65,603912.6799999999,733257.5499999998
6361,U36944,187,-8663.779999999992,79,108,787426.9199999999,778763.1399999999
6362,U13108,187,-4037.0199999999995,173,14,26447.120000000006,22410.100000000006
6363,U43537,187,517.9199999999884,165,22,185436.62000000034,185954.54000000033
6364,U22128,187,5826.720000000001,155,32,355337.29,361164.01
6365,U40578,187,-216.88999999999942,129,58,590007.2199999999,589790.3299999998
6366,U9704,187,91374.51999999996,165,22,54222.869999999995,145597.38999999996
6367,U34808,187,5743.239999999954,124,63,1736060.5400000005,1741803.7800000005
6368,U39017,187,-74087.83000000007,104,83,1465761.5300000003,1391673.7000000002
6369,U30266,187,-792.0199999999986,171,16,16488.579999999998,15696.56
6370,U15658,187,919444.0300000005,171,16,1205924.2400000005,2125368.270000001
6371,U9881,187,-932.3599999999986,173,14,22448.899999999998,21516.54
6372,U16782,187,21786.94999999997,152,35,551957.1000000001,573744.05
6373,U20148,187,37.55000000000004,153,34,5436.539999999999,5474.089999999999
6374,U28352,187,-26421.879999999997,159,28,80254.62,53832.74
6375,U26335,187,2816.700000000119,168,19,7756447.03,7759263.73
6376,U24825,187,-101097.18000000005,163,24,216108.74,115011.55999999994
6377,U20040,187,-11496.859999999988,177,10,77304.18,65807.32
6378,U41037,187,-26639.32999999998,173,14,204979.05999999997,178339.72999999998
6379,U38110,187,-121.92000000000189,140,47,118105.70999999999,117983.79
6380,U35105,187,124998.6800000002,91,96,952580.4999999999,1077579.1800000002
6381,U40601,187,-20243.310000000005,180,7,43281.54,23038.229999999996
6382,U36744,187,-24592.469999999998,139,48,233158.78000000003,208566.31000000003
6383,U36277,187,23.649999999996652,161,26,48653.82,48677.469999999994
6384,U39497,187,-414438.2000000002,127,60,4102654.1,3688215.9
6385,U26254,187,1489.8899999999992,167,20,134969.49000000002,136459.38
6386,U10951,187,187472.28,164,23,218031.99999999997,405504.27999999997
6387,U17127,187,41278.20999999999,151,36,346215.30999999994,387493.5199999999
6388,U614657,187,-4009.850000000001,120,67,56686.58,52676.73
6389,U12448,187,24.0600000000004,101,86,68084.47,68108.53
6390,U30690,187,-59178.51999999999,139,48,154740.1,95561.58000000002
6391,U33208,187,-10300.290000000005,171,16,69698.48999999999,59398.19999999998
6392,U32412,187,19247.679999999993,110,77,1649483.28,1668730.96
6393,U43887,187,-279.0,142,45,127336.30000000002,127057.30000000002
6394,U10877,187,-18255.84999999999,169,18,107781.08,89525.23000000001
6395,U9267,187,-39530.759999999995,133,54,422757.62,383226.86
6396,U1119637,187,-1866.5600000000004,155,32,188024.68,186158.12
6397,U30060,187,-6091.379999999997,168,19,66531.15000000002,60439.770000000026
6398,U42755,187,-38285.25,175,12,131394.58000000002,93109.33000000002
6399,U8981,186,113134.35999999994,117,69,501857.68999999994,614992.0499999999
6400,U19826,186,6412.060000000009,117,69,400394.22,406806.27999999997
6401,U945162,186,0.030000000002146976,123,63,19453.919999999995,19453.949999999997
6402,U12830,186,541.779999999992,159,27,185581.66000000003,186123.44000000003
6403,U40463,186,-2112.7100000000173,153,33,346294.66,344181.94999999995
6404,U984439,186,-0.16000000000440195,125,61,44719.689999999995,44719.52999999999
6405,U28326,186,2293.7000000000044,161,25,215603.24000000005,217896.94000000006
6406,U30584,186,-8074.639999999999,173,13,24848.800000000003,16774.160000000003
6407,U38026,186,-917.2099999999973,172,14,91655.16999999995,90737.95999999996
6408,U11777,186,112.85999999999657,172,14,97946.76000000001,98059.62000000001
6409,U33750,186,645.4099999999999,172,14,30434.27,31079.68
6410,U12174,186,-5553.650000000009,179,7,127962.32000000002,122408.67000000001
6411,U9621,186,-22202.319999999985,145,41,213186.64999999985,190984.32999999987
6412,U36133,186,-47351.07000000002,142,44,402865.8300000002,355514.7600000002
6413,U43349,186,1183.6299999999994,127,59,12155.999999999996,13339.629999999996
6414,U9887,186,1255.890000000078,161,25,351779.2800000001,353035.17000000016
6415,U39924,186,-20328.709999999985,161,25,406380.80999999994,386052.1
6416,U42361,186,-65.11999999999915,163,23,28350.960000000003,28285.840000000004
6417,U23844,186,-3562.720000000016,120,66,573965.3999999999,570402.6799999999
6418,U26517,186,-278.73999999999955,139,47,39339.819999999985,39061.07999999999
6419,U23793,186,841.7999999999993,125,61,1899031.9300000004,1899873.7300000004
6420,U21056,186,4956.789999999957,145,41,2769402.4099999997,2774359.1999999997
6421,U39080,186,-9341.109999999993,159,27,188739.86999999997,179398.75999999998
6422,U41644,186,13900.489999999976,162,24,251171.02999999988,265071.51999999984
6423,U34745,186,-367.7800000000015,170,16,20300.81,19933.03
6424,U10006,186,694.6699999999993,178,8,11797.239999999996,12491.909999999996
6425,U11495,186,61908.360000000015,152,34,250023.4600000001,311931.8200000001
6426,U9069,186,4323.509999999996,162,24,40668.30000000001,44991.810000000005
6427,U39840,186,48041.960000000036,166,20,738669.5900000001,786711.5500000002
6428,U14516,186,-10338.459999999905,163,23,2208230.38,2197891.92
6429,U15364,186,-12944.620000000008,118,68,281110.2299999999,268165.6099999999
6430,U19386,186,3913.390000000005,162,24,52813.479999999996,56726.87
6431,U11577,186,26559.790000000026,147,39,361210.3300000001,387770.1200000001
6432,U34439,186,23496.399999999994,161,25,175342.34999999998,198838.74999999997
6433,U14724,186,5914.899999999909,139,47,734860.39,740775.2899999999
6434,U24619,186,66278.14000000004,164,22,1323302.0699999996,1389580.2099999997
6435,U33399,186,-1289.05,171,15,31302.12,30013.07
6436,U14457,186,21834.24999999997,126,60,335590.5200000001,357424.77
6437,U17493,186,-5739.6,167,19,39726.40000000001,33986.80000000001
6438,U12527,186,51722.310000000005,168,18,181427.78999999998,233150.09999999998
6439,U10878,186,51.2399999999659,110,76,470634.08,470685.32
6440,U14428,186,-14451.189999999982,124,62,273314.40000000026,258863.21000000028
6441,U37077,186,352.46000000000276,167,19,90769.82,91122.28000000001
6442,U12051,186,-68350.75,162,24,470203.79999999993,401853.04999999993
6443,U1244309,186,-15.079999999999586,136,50,28433.12,28418.04
6444,U8132,186,-28676.920000000006,170,16,110065.19,81388.26999999999
6445,U41660,186,19136.6,153,33,105697.95000000001,124834.55000000002
6446,U13790,186,108810.68000000002,152,34,586634.5900000001,695445.2700000001
6447,U19409,186,-832.010000000005,153,33,65357.56,64525.549999999996
6448,U12714,186,-25869.479999999956,165,21,502508.72999999986,476639.2499999999
6449,U16486,186,-2509848.6,165,21,7089444.859999999,4579596.26
6450,U26501,186,-37007.37,163,23,84991.61000000002,47984.24000000001
6451,U43944,186,-109712.92000000001,139,47,530093.18,420380.26
6452,U28303,186,-15642.849999999988,159,27,250013.78,234370.93000000002
6453,U39201,186,1556.4500000000044,179,7,73104.91,74661.36000000002
6454,U20346,186,-1990.65,170,16,46229.50000000001,44238.850000000006
6455,U24494,186,-55669.730000000454,129,57,8007144.5,7951474.77
6456,U594450,186,-8514.969999999998,161,25,31726.609999999993,23211.639999999996
6457,U27844,186,-23538.22,179,7,62494.44,38956.22
6458,U31006,186,130503.46999999986,163,23,2558601.6200000006,2689105.0900000003
6459,U37274,186,155172.30000000002,109,77,480183.80999999994,635356.11
6460,U18393,185,242799.66999999995,169,16,163141.59999999998,405941.2699999999
6461,U24260,185,-237572.22999999995,134,51,595984.01,358411.78
6462,U8525,185,41607.169999999955,141,44,702971.1200000001,744578.29
6463,U24867,185,-2689.840000000003,166,19,72808.37999999999,70118.54
6464,U30423,185,-1660.2599999999995,76,109,461745.53,460085.27
6465,U9031,185,1416.6000000000113,140,45,288100.61,289517.21
6466,U14821,185,-14008.390000000001,170,15,53387.69,39379.3
6467,U8176,185,-22335.72999999999,161,24,131083.87999999998,108748.15
6468,U16738,185,138456.75,143,42,302690.03,441146.78
6469,U40911,185,1442.0299999999977,168,17,29101.929999999997,30543.959999999995
6470,U41555,185,67.69999999999982,156,29,22710.98,22778.68
6471,U32658,185,22532.779999999944,147,38,720174.1000000002,742706.8800000001
6472,U34175,185,944840.8199999998,116,69,1820892.3399999996,2765733.159999999
6473,U32668,185,-94034.95,99,86,491816.0,397781.05
6474,U21663,185,46671.94,140,45,159754.60999999993,206426.54999999993
6475,U574672,185,-1381.6700000000012,132,53,79572.96,78191.29000000001
6476,U30319,185,-2211.9000000000015,167,18,111470.74999999997,109258.84999999998
6477,U8019,185,57662.05000000002,88,97,202345.08000000002,260007.13000000003
6478,U27120,185,-55645.79000000002,148,37,733971.61,678325.82
6479,U31457,185,20693.359999999993,143,42,115925.23999999992,136618.59999999992
6480,U10003,185,-6547.100000000053,157,28,106929.94999999994,100382.84999999989
6481,U29663,185,4637.0299999999925,164,21,92641.81999999995,97278.84999999995
6482,U17540,185,4807.370000000006,136,49,694976.0499999999,699783.4199999999
6483,U680686,185,-19559.549999999992,175,10,33939.539999999986,14379.989999999994
6484,U28921,185,-109759.14999999997,145,40,338139.50999999995,228380.36
6485,U32753,185,11787.240000000014,138,47,337501.3400000001,349288.5800000001
6486,U26208,185,7486.510000000001,166,19,31073.6,38560.11
6487,U8581,185,67.74999999999238,166,19,48417.77000000002,48485.52000000001
6488,U41784,185,2538.2600000000034,156,29,1103639.44,1106177.7
6489,U28689,185,4518.159999999998,170,15,45885.85999999999,50404.01999999999
6490,U24225,185,217.13999999999507,168,17,134372.32999999996,134589.46999999994
6491,U38204,185,3128.239999999998,176,9,47103.09000000001,50231.33000000001
6492,U14595,185,36545.44999999998,176,9,110247.47999999997,146792.92999999993
6493,U14911,185,-469483.2599999999,176,9,1625764.02,1156280.7600000002
6494,U31473,185,8093.839999999982,179,6,154418.90000000005,162512.74000000005
6495,U39690,185,21402.309999999998,164,21,69306.73999999996,90709.04999999996
6496,U41069,185,-96327.50999999995,149,36,351259.14999999997,254931.64
6497,U21252,185,-7132.869999999996,153,32,293923.58,286790.71
6498,U39032,185,-11942.669999999998,169,16,65319.21,53376.54
6499,U687017,185,5.120000000002165,105,80,265064.26,265069.38
6500,U10149,185,229.58000000001277,174,11,85911.24999999955,86140.82999999957
6501,U40242,185,97201.69000000002,163,22,255661.14999999994,352862.83999999997
6502,U9078,185,25.599999999939428,162,23,1448458.28,1448483.88
6503,U25439,185,-32431.05000000001,163,22,452043.86000000004,419612.81000000006
6504,U32162,185,-482620.23,173,12,2172962.9699999997,1690342.7399999998
6505,U30049,185,-3466.1800000000308,118,67,643528.1699999998,640061.9899999998
6506,U14304,185,-34217.12999999998,154,31,159139.75000000012,124922.62000000014
6507,U664384,185,308.28999999999814,120,65,77823.39000000003,78131.68000000002
6508,U757236,185,-105.55999999999585,101,84,147165.09999999998,147059.53999999998
6509,U29723,185,-34260.200000000004,120,65,738362.6299999998,704102.4299999998
6510,U16451,185,231120.69999999998,149,36,1096338.16,1327458.8599999999
6511,U18817,185,-1353.9800000000014,168,17,69909.31999999998,68555.33999999998
6512,U43151,185,-35674.04,178,7,67311.04,31636.999999999993
6513,U9097,185,25334.130000000932,171,14,3202793.129999999,3228127.26
6514,U38392,185,-921.7700000000009,179,6,6232.49,5310.719999999999
6515,U19024,185,-257077.02000000002,142,43,1226080.2199999997,969003.1999999997
6516,U18452,185,42875.819999999985,162,23,349737.11,392612.93
6517,U22748,185,-17528.120000000003,179,6,30566.37000000001,13038.250000000007
6518,U30638,185,131583.65,172,13,48915.96000000001,180499.61
6519,U18285,185,246.74999999997078,166,19,126514.11,126760.85999999997
6520,U32460,185,-603588.5599999999,143,42,1821454.7599999998,1217866.1999999997
6521,U18034,185,-7326.349999999997,170,15,42992.14,35665.79
6522,U10024,185,-23357.500000000004,174,11,100277.81999999999,76920.31999999999
6523,U38265,184,971.3700000000005,177,7,8529.199999999997,9500.569999999998
6524,U40589,184,-52767.229999999974,170,14,140018.2700000001,87251.04000000012
6525,U30982,184,-308115.21,102,82,3651874.92,3343759.71
6526,U31341,184,-14292.940000000006,102,82,297819.44,283526.5
6527,U41946,184,-4227.270000000008,118,66,521157.24000000005,516929.97000000003
6528,U1246812,184,14.850000000000364,97,87,129921.11000000002,129935.96000000002
6529,U30849,184,-11796.7,149,35,198480.96,186684.25999999998
6530,U20086,184,-5724.969999999988,153,31,127461.35000000003,121736.38000000005
6531,U14964,184,10897.779999999995,122,62,271122.14999999997,282019.92999999993
6532,U42274,184,-277.4799999999941,146,38,87895.49,87618.01000000001
6533,U9083,184,-10250.740000000014,134,50,367803.44,357552.7
6534,U15958,184,-1873.7299999999955,175,9,22975.670000000002,21101.940000000006
6535,U25141,184,-28908.089999999866,155,29,907791.4500000003,878883.3600000005
6536,U676560,184,1628.449999999999,105,79,66045.00000000001,67673.45000000001
6537,U30713,184,-86647.51,164,20,270320.44999999995,183672.93999999994
6538,U38152,184,41.320000000000164,161,23,4017.3299999999995,4058.6499999999996
6539,U13745,184,5928.819999999998,175,9,33100.61,39029.43
6540,U31723,184,-650342.2900000004,172,12,973331.5900000004,322989.30000000005
6541,U13802,184,-54464.91000000007,153,31,1942367.46,1887902.5499999998
6542,U9382,184,-1529.779999999999,169,15,48774.74,47244.96
6543,U32562,184,-10202.089999999998,153,31,45085.17,34883.08
6544,U16593,184,-31342.02000000005,172,12,71868.44000000006,40526.42000000001
6545,U958424,184,-806.3099999999973,89,95,196609.19,195802.88
6546,U18040,184,-953.2899999999992,172,12,13641.940000000002,12688.650000000003
6547,U37760,184,7585.560000000004,162,22,324813.7399999999,332399.2999999999
6548,U1360824,184,-4778.04,121,63,38167.26,33389.22
6549,U13154,184,-22464.469999999998,165,19,64001.54000000001,41537.07000000001
6550,U12780,184,-539116.31,159,25,1747461.0,1208344.69
6551,U14335,184,35531.75000000131,132,52,3358493.589999998,3394025.3399999994
6552,U976150,184,-123.45000000000073,116,68,101980.39,101856.94
6553,U34239,184,2685.8399999999674,153,31,1059859.02,1062544.8599999999
6554,U27449,184,14127.839999999978,174,10,845018.25,859146.09
6555,U1253066,184,-12986.810000000001,103,81,188768.32,175781.51
6556,U22259,184,20861.189999999704,144,40,1266947.52,1287808.7099999997
6557,U31260,184,11845.969999999996,176,8,11291.630000000005,23137.6
6558,U29761,184,-420883.9900000001,147,37,2661259.679999999,2240375.6899999985
6559,U12587,184,-26536.91,163,21,169288.3199999999,142751.4099999999
6560,U32451,184,-14186.290000000019,161,23,264006.85,249820.55999999997
6561,U34903,184,-1601.990000000143,139,45,2941728.8099999987,2940126.8199999984
6562,U23919,184,-9877.67000000002,119,65,331259.50999999995,321381.8399999999
6563,U15163,184,-16804.419999999976,97,87,2279542.929999999,2262738.509999999
6564,U11915,184,-3465.8499999999876,143,41,129696.37999999995,126230.52999999996
6565,U9410,184,-8603.220000000005,164,20,98295.10999999999,89691.88999999998
6566,U15981,184,4944.719999999997,162,22,20600.64999999999,25545.369999999988
6567,U28071,184,-2483216.3,153,31,6690138.85,4206922.55
6568,U9937,184,-286785.79999999976,173,11,793662.8300000001,506877.0300000003
6569,U10562,184,96491.66,155,29,383561.01000000007,480052.67000000004
6570,U39796,184,-524.4699999999502,92,92,642763.4600000001,642238.9900000001
6571,U40321,184,10385.530000000008,174,10,35516.00000000001,45901.53000000001
6572,U12558,184,698528.7999999999,133,51,2255074.3899999997,2953603.1899999995
6573,U1115726,184,-338.91000000000037,159,25,8277.679999999998,7938.769999999998
6574,U24634,184,-78264.40000000002,161,23,173798.52,95534.11999999997
6575,U33125,184,35861.53,175,9,23776.86,59638.39
6576,U12755,184,14.269999999997594,176,8,10860.61,10874.879999999997
6577,U17022,184,46918.23,151,33,725286.51,772204.74
6578,U35988,184,4664.019999999993,104,80,429946.86000000004,434610.88000000006
6579,U40539,184,-37917.379999999954,138,46,153710.97000000003,115793.59000000008
6580,U25475,184,7002.180000000007,162,22,62064.53999999999,69066.72
6581,U36464,184,20253.22000000001,166,18,18707.599999999995,38960.82000000001
6582,U33604,184,-2545.2400000000052,134,50,70776.09000000001,68230.85
6583,U8259,184,-40752.770000000004,139,45,426859.93000000005,386107.16000000003
6584,U23681,184,-14136.230000000061,146,38,1222051.95,1207915.72
6585,U9639,184,-18768.83,170,14,331537.50999999995,312768.67999999993
6586,U37488,184,-1507.6500000000033,172,12,31371.460000000003,29863.809999999998
6587,U12143,184,-7323.2199999999975,180,4,10625.579999999998,3302.3600000000006
6588,U25485,184,-23442.969999999987,141,43,497111.2399999999,473668.2699999999
6589,U10164,184,28838.270000000004,166,18,29459.139999999996,58297.41
6590,U39571,184,-13058.79999999997,163,21,521169.4700000001,508110.6700000001
6591,U15566,184,9253.420000000002,167,17,63626.63000000001,72880.05000000002
6592,U14242,184,-82081.34999999996,163,21,1922953.7600000012,1840872.4100000013
6593,U37803,184,-772295.1299999997,143,41,1537642.2499999998,765347.1200000001
6594,U8942,184,20734.750000000022,173,11,65816.31999999999,86551.07
6595,U15854,184,866110.9099999999,154,30,186344.26,1052455.17
6596,U16263,184,28736.029999999984,129,55,2819427.5000000005,2848163.5300000003
6597,U24350,184,7535.539999999986,125,59,260557.15,268092.69
6598,U31214,183,5.4569682106375694e-12,93,90,101073.8,101073.8
6599,U40355,183,-49650.65000000001,159,24,411553.8300000001,361903.18000000005
6600,U8219,183,-27186.110000000022,155,28,792064.39,764878.28
6601,U36924,183,20948.839999999993,137,46,191894.5,212843.34
6602,U11550,183,2641.5700000000033,143,40,182145.77,184787.34
6603,U32715,183,-44782.399999999994,166,17,272114.81000000006,227332.41000000006
6604,U14235,183,-25480.36999999997,95,88,805264.0800000001,779783.7100000001
6605,U28708,183,-157456.96999999997,136,47,855698.03,698241.06
6606,U1167699,183,242.14999999999884,110,73,63772.94,64015.090000000004
6607,U33830,183,3297.3300000000054,80,103,322276.63999999996,325573.97
6608,U603460,183,26683.809999999965,160,23,162817.88999999996,189501.69999999992
6609,U11175,183,81406.89999999986,142,41,208110.91999999987,289517.8199999997
6610,U25310,183,-743.2900000000045,130,53,426078.9600000001,425335.6700000001
6611,U28333,183,-1614.4499999999994,169,14,21838.150000000005,20223.700000000004
6612,U30248,183,-10588.710000000008,177,6,60030.71000000001,49442.0
6613,U26989,183,-317485.29,173,10,769932.69,452447.39999999997
6614,U14169,183,-5450.769999999998,173,10,35562.74999999999,30111.979999999996
6615,U966939,183,-2005.4900000000011,98,85,102183.67,100178.18
6616,U9004,183,-74874.58000000002,149,34,320295.9100000001,245421.33000000007
6617,U32526,183,-35040.209999999985,173,10,175390.58,140350.37
6618,U30801,183,-32771.11999999998,61,122,370192.85000000003,337421.73000000004
6619,U33177,183,12560.64999999997,166,17,181799.34000000003,194359.99
6620,U31727,183,-19242.249999999985,175,8,272197.88000000006,252955.63000000006
6621,U31947,183,-58271.31999999998,161,22,412273.2200000001,354001.90000000014
6622,U26999,183,-4639.599999999998,167,16,72675.87,68036.27
6623,U41254,183,39182.29999999999,140,43,1143112.6699999995,1182294.9699999995
6624,U15559,183,-7073.949999999997,172,11,67769.48,60695.53
6625,U34512,183,7171.820000000002,162,21,84736.12999999999,91907.95
6626,U11214,183,-2255.8400000000015,164,19,64993.84000000001,62738.00000000001
6627,U606273,183,-14412.900000000009,133,50,70099.39,55686.48999999999
6628,U27965,183,45296.36999999998,130,53,1080143.4800000004,1125439.8500000003
6629,U20417,183,-9399.57999999999,144,39,131716.14,122316.56000000003
6630,U30180,183,-58657.34999999999,174,9,87929.75,29272.40000000001
6631,U12815,183,-1017.2200000000157,155,28,152735.24000000005,151718.02000000002
6632,U32312,183,39340.439999999995,144,39,83341.38,122681.82
6633,U10866,183,-3840.070000000005,151,32,113115.83999999998,109275.76999999997
6634,U36705,183,1066.6200000000138,163,20,55206.96,56273.580000000016
6635,U41636,183,64497.13000000012,117,66,8820248.81,8884745.940000001
6636,U14980,183,-50710.430000000066,163,20,992101.13,941390.7
6637,U17472,183,-8216.580000000005,163,20,102356.94999999997,94140.36999999997
6638,U34620,183,34997.28999999992,150,33,594412.69,629409.9799999999
6639,U42042,183,-10904.01,146,37,142445.89000000013,131541.88000000012
6640,U41302,183,724126.5,162,21,2631433.7899999972,3355560.2899999972
6641,U12729,183,4556.529999999999,165,18,24935.07,29491.6
6642,U35659,183,7872.770000000044,147,36,589339.9400000001,597212.7100000001
6643,U29367,183,19699.329999999994,138,45,707472.66,727171.99
6644,U26196,183,-447656.51,161,22,785000.76,337344.25
6645,U31134,183,-426.7600000000023,132,51,192789.36,192362.59999999998
6646,U24024,183,52855.119999999995,165,18,258786.24999999997,311641.37
6647,U17633,183,147138.3,151,32,838931.6900000002,986069.9900000002
6648,U34676,183,2244.3600000000033,173,10,68862.16000000002,71106.52000000002
6649,U9981,183,-1312.0199999998865,125,58,1036873.49,1035561.4700000001
6650,U13635,183,449963.36999999953,152,31,3379690.3000000003,3829653.67
6651,U28613,183,-29823.420000000002,176,7,59649.090000000004,29825.670000000002
6652,U35723,183,27657.44999999999,154,29,205261.32,232918.77
6653,U8593,183,-41044.759999999995,163,20,339587.19,298542.43
6654,U42502,183,-10006.930000000011,133,50,470719.7299999999,460712.79999999993
6655,U582173,183,147.47000000000412,100,83,68718.62,68866.09
6656,U35250,183,66322.17999999996,80,103,1509311.66,1575633.8399999999
6657,U11885,183,-7953.430000000015,142,41,363017.19,355063.76
6658,U30909,183,-722.8499999999826,161,22,192114.85,191392.00000000003
6659,U10687,183,8071.279999999995,131,52,162654.33000000002,170725.61000000002
6660,U38261,183,-471678.91000000015,102,81,1318607.0599999996,846928.1499999994
6661,U18303,183,-6040.769999999999,161,22,48372.89,42332.12
6662,U23925,183,-4932.029999999999,162,21,40130.83,35198.8
6663,U20333,183,98750.45000000036,144,39,8307472.239999999,8406222.69
6664,U19914,183,-19267.750000000022,165,18,165110.51,145842.75999999998
6665,U31722,183,-4855.66,165,18,28872.670000000002,24017.010000000002
6666,U12211,183,-5378.979999999999,157,26,355584.50999999995,350205.52999999997
6667,U14389,183,-110072.6099999999,126,57,3546324.4899999998,3436251.88
6668,U31374,183,-10548.820000000002,176,7,62818.87999999999,52270.05999999999
6669,U27027,183,6658.409999999998,179,4,63500.12000000002,70158.53000000001
6670,U36115,183,119876.90000000001,162,21,69210.65000000001,189087.55000000002
6671,U40709,183,10045.300000000008,174,9,45790.78000000003,55836.08000000004
6672,U24170,183,-37020.200000000004,154,29,257336.79999999984,220316.59999999983
6673,U32628,183,-58770.19999999998,144,39,494351.76,435581.56000000006
6674,U18753,183,-1207.0300000000097,141,42,638287.7200000001,637080.6900000001
6675,U14653,183,31856.69000000002,152,31,228879.41000000012,260736.10000000015
6676,U33943,183,461.47000000000406,152,31,245668.62000000002,246130.09000000003
6677,U36957,183,-78.43999999999926,160,23,10128.51,10050.070000000002
6678,U22196,183,92065.60999999993,159,24,169117.47999999998,261183.0899999999
6679,U9372,183,951.5399999999987,163,20,24988.120000000003,25939.66
6680,U41899,183,11897.020000000013,167,16,17442.279999999984,29339.299999999996
6681,U28027,182,2604.1700000000037,160,22,38263.409999999996,40867.58
6682,U19402,182,3259.609999999999,120,62,108136.08,111395.69
6683,U14484,182,-79356.96999999999,110,72,716015.07,636658.1
6684,U1053310,182,5021.83,90,92,18798.12,23819.949999999997
6685,U36181,182,99849.24999999953,114,68,5358556.33,5458405.58
6686,U38669,182,6055.039999999999,132,50,359199.64999999997,365254.68999999994
6687,U11390,182,-165234.74999999994,149,33,1182398.6900000002,1017163.9400000002
6688,U19104,182,899087.5399999999,152,30,2633012.469999999,3532100.009999999
6689,U9724,182,320.0600000000386,130,52,459071.12,459391.18000000005
6690,U43700,182,-2945.3999999999946,136,46,297060.6400000001,294115.24000000005
6691,U26328,182,2405.400000000066,140,42,982087.6300000001,984493.0300000001
6692,U14863,182,4515.4099999999735,166,16,218970.33,223485.73999999996
6693,U23425,182,31724.18,162,20,121908.0,153632.18
6694,U16752,182,47618.740000000005,172,10,180073.19,227691.93
6695,U42749,182,8107.940000000007,171,11,76743.26000000001,84851.20000000001
6696,U32295,182,-489.4400000000005,140,42,42669.68,42180.24
6697,U38237,182,-45692.29,148,34,166837.84999999998,121145.55999999997
6698,U11313,182,6624.589999999999,162,20,40071.01000000001,46695.600000000006
6699,U41477,182,-14042.21,165,17,153993.34000000005,139951.13000000006
6700,U16223,182,-307462.32999999897,127,55,34570737.620000005,34263275.29000001
6701,U43039,182,-17054.270000000015,136,46,124724.78,107670.50999999998
6702,U13522,182,-4103.199999999999,169,13,135789.68999999997,131686.48999999996
6703,U21392,182,-22906.209999999995,159,23,50075.61000000001,27169.400000000012
6704,U40778,182,-149635.03000000006,161,21,1310286.3300000003,1160651.3000000003
6705,U24622,182,-11033.290000000019,147,35,287230.80999999994,276197.5199999999
6706,U10220,182,-12261.460000000036,106,76,765998.0399999999,753736.5799999998
6707,U31513,182,176201.9900000001,160,22,239119.95,415321.9400000001
6708,U17189,182,36739.55999999944,135,47,5426472.419999999,5463211.979999999
6709,U24638,182,30155.700000000063,125,57,1062975.3599999999,1093131.0599999998
6710,U1208961,182,-2994.0400000000027,92,90,64715.48000000001,61721.44000000001
6711,U12718,182,25403.39,161,21,392855.7599999999,418259.1499999999
6712,U25897,182,-284993.5000000001,142,40,6308955.58,6023962.08
6713,U11844,182,-47365.24000000002,157,25,259460.04,212094.8
6714,U9834,182,94996.70000000004,118,64,1749036.3000000005,1844033.0000000005
6715,U23376,182,1557.280000000001,173,9,17885.199999999997,19442.48
6716,U32116,182,38663.439999999755,141,41,3888519.03,3927182.4699999997
6717,U23128,182,-3467.010000000001,147,35,51379.850000000006,47912.840000000004
6718,U33706,182,5963.629999999999,171,11,15781.37,21745.0
6719,U42168,182,29759.92,168,14,42467.740000000005,72227.66
6720,U14122,182,48287.40000000001,163,19,159493.28000000003,207780.68000000005
6721,U15013,182,-1572.489999999997,155,27,170129.83000000002,168557.34000000003
6722,U27568,182,-8837.699999999953,137,45,2240810.2800000003,2231972.58
6723,U27575,182,23576.229999999974,119,63,1009897.4700000003,1033473.7000000003
6724,U14155,182,21542.760000000024,136,46,1109876.53,1131419.29
6725,U39884,182,691.7099999999975,150,32,56970.53999999999,57662.24999999999
6726,U11963,182,32018.590000000007,163,19,724479.7099999997,756498.2999999997
6727,U34330,182,-257.89999999999384,155,27,89563.11000000003,89305.21000000004
6728,U36851,182,104976.18,159,23,239543.14000000007,344519.32000000007
6729,U8943,182,-18390.799999999876,155,27,1133438.8899999994,1115048.0899999996
6730,U38324,182,-58937.01000000001,133,49,293489.37,234552.36
6731,U13839,182,6327.37,154,28,52865.75,59193.12
6732,U17295,182,3424.7299999999964,161,21,159676.56999999998,163101.3
6733,U14416,182,-39621.52999999985,143,39,1741051.63,1701430.1
6734,U8607,182,314.0499999999948,173,9,18453.139999999996,18767.18999999999
6735,U12378,182,-1680.3500000001586,129,53,730972.7800000001,729292.4299999999
6736,U32359,182,33282.86999999993,143,39,991607.5599999999,1024890.4299999998
6737,U20154,182,28109.139999999978,157,25,309262.7199999999,337371.85999999987
6738,U14623,182,-158646.91999999993,148,34,3313734.6700000013,3155087.7500000014
6739,U26585,182,10579.560000000012,166,16,111671.08,122250.64000000001
6740,U25450,182,15247.530000000002,155,27,58729.88,73977.41
6741,U41378,182,8359.690000000006,167,15,209194.72999999998,217554.41999999998
6742,U24888,182,33288.38000000003,167,15,147051.6,180339.98000000004
6743,U39124,182,5760.299999999999,161,21,37815.36999999998,43575.669999999984
6744,U938999,182,-7957.390000000001,122,60,88166.69000000002,80209.30000000002
6745,U8577,182,11841.200000000013,161,21,287649.49000000034,299490.69000000035
6746,U27169,182,-97618.44,142,40,526996.76,429378.32
6747,U763575,181,-22984.710000000003,108,73,61286.88000000003,38302.17000000003
6748,U21356,181,-9662.2,96,85,57430.100000000006,47767.90000000001
6749,U39634,181,302282.65,132,49,501763.95,804046.6000000001
6750,U42970,181,-43835.72000000001,165,16,150714.11,106878.38999999998
6751,U20280,181,-48322.92999999999,152,29,416930.04000000015,368607.11000000016
6752,U11377,181,4588.210000000004,176,5,40280.66000000001,44868.87000000002
6753,U43533,181,-10159.360000000015,161,20,408493.37999999995,398334.0199999999
6754,U16694,181,-36698.609999999986,161,20,449621.41,412922.8
6755,U22056,181,85455.09000000011,96,85,2110685.4899999998,2196140.58
6756,U39569,181,-7011.810000000002,120,61,315183.5400000001,308171.7300000001
6757,U31204,181,-52984.37,139,42,139434.08999999997,86449.71999999997
6758,U17530,181,-20135.220000000005,155,26,109784.62999999999,89649.40999999999
6759,U40394,181,-35387.17000000001,147,34,163276.95999999993,127889.78999999992
6760,U9402,181,-341441.4200000003,169,12,870485.2500000003,529043.8300000001
6761,U19086,181,11914.01000000006,132,49,380452.8599999999,392366.87
6762,U17584,181,20638.77000000002,144,37,716180.8399999999,736819.6099999999
6763,U16610,181,859.3999999996158,136,45,3983604.3099999987,3984463.709999998
6764,U15632,181,-11654.119999999999,107,74,390882.95,379228.83
6765,U17394,181,-35481.50000000004,147,34,380692.2,345210.69999999995
6766,U609718,181,402.7399999999991,100,81,54046.89,54449.63
6767,U10397,181,3222.070000000007,140,41,791853.4699999999,795075.5399999998
6768,U1210384,181,39913.98999999998,78,103,111268.97,151182.96
6769,U34848,181,-425.7499999999978,164,17,68543.37000000001,68117.62000000001
6770,U38676,181,47924.25999999996,139,42,787694.1000000002,835618.3600000002
6771,U21820,181,-3450.1299999999937,167,14,156145.41999999998,152695.28999999998
6772,U18540,181,47195.02999999998,153,28,30139.44999999999,77334.47999999997
6773,U33518,181,-639.3299999999998,136,45,17911.140000000003,17271.810000000005
6774,U37347,181,2390.859999999996,115,66,251164.1199999999,253554.9799999999
6775,U39927,181,-69198.62,107,74,4208128.21,4138929.59
6776,U11309,181,1815.7299999999982,172,9,28009.120000000003,29824.850000000002
6777,U13276,181,-95641.81000000011,118,63,3746203.37,3650561.56
6778,U1158772,181,1834.250000000009,117,64,237144.42000000004,238978.67000000004
6779,U20540,181,-5280.109999999986,140,41,355068.2999999999,349788.1899999999
6780,U31778,181,1986.04,160,21,78051.54999999992,80037.58999999991
6781,U20135,181,3157.3999999999987,167,14,32198.44,35355.84
6782,U17634,181,-73437.63999999998,147,34,6728133.2700000005,6654695.630000001
6783,U20522,181,-2488.199999999996,157,24,161656.31,159168.11000000002
6784,U16908,181,-65809.91000000002,166,15,183034.24000000005,117224.33000000003
6785,U36490,181,-2195.9699999999975,154,27,45086.80000000001,42890.830000000016
6786,U8854,181,-55045.31999999994,136,45,841015.7300000001,785970.4100000001
6787,U34718,181,3304.890000000019,162,19,157318.72000000003,160623.61000000004
6788,U11080,181,3453.4399999999914,157,24,189821.29,193274.73
6789,U22784,181,-25506.509999999995,138,43,200861.41,175354.90000000002
6790,U16064,181,52872.419999996164,143,38,27359372.360000003,27412244.779999997
6791,U28804,181,-2086.0199999999927,164,17,265346.8899999999,263260.8699999999
6792,U25025,181,21391.200000000303,158,23,221755.7,243146.9000000003
6793,U43772,181,3827.920000000002,164,17,51485.20999999999,55313.12999999999
6794,U16274,181,132101.70999999996,160,21,398929.51,531031.22
6795,U1127718,181,-9.350000000000861,105,76,60891.240000000005,60881.89000000001
6796,U41963,181,-7497.11,166,15,96783.17,89286.06
6797,U32592,181,-1671.7399999999989,146,35,374113.49000000017,372441.7500000002
6798,U32241,181,17232.76999999999,156,25,448728.81,465961.57999999996
6799,U18241,181,-5758.499999999978,141,40,165714.71,159956.21000000002
6800,U14351,181,4288.859999999993,137,44,163204.31,167493.16999999998
6801,U20207,181,42939.94000000008,102,79,658839.72,701779.66
6802,U16106,181,-2222.520000000007,129,52,138168.28999999998,135945.76999999996
6803,U21244,181,476.6699999999999,174,7,13417.449999999999,13894.119999999999
6804,U8171,181,763.7800000000025,169,12,106898.31999999998,107662.09999999998
6805,U18166,181,4015.4099999999944,129,52,43685.24,47700.649999999994
6806,U28379,181,-3916.469999999994,157,24,80832.01,76915.54000000001
6807,U24131,181,-570.0599999999996,167,14,67165.20000000001,66595.14000000001
6808,U29692,181,42035.37000000001,145,36,275881.23,317916.6
6809,U21408,181,-457.2299999999959,162,19,154741.33000000002,154284.10000000003
6810,U40151,181,-7044.859999999988,148,33,240902.90999999997,233858.05
6811,U10717,181,3811.5499999999984,132,49,236991.15,240802.69999999998
6812,U31757,181,-58113.75999999981,137,44,2469875.2399999993,2411761.4799999995
6813,U17327,181,-100273.47999999998,162,19,1468814.3600000017,1368540.8800000018
6814,U11029,181,14286.679999999977,134,47,721116.3899999995,735403.0699999995
6815,U36584,181,-188615.81999999998,131,50,667130.2899999999,478514.47
6816,U8439,180,-10781.399999999987,154,26,130961.20999999996,120179.80999999997
6817,U40312,180,-1985.3500000000095,137,43,105416.02000000002,103430.67000000001
6818,U14687,180,212155.8700000001,139,41,316974.88000000006,529130.7500000002
6819,U23632,180,-96357.5,147,33,356279.64,259922.14
6820,U20815,180,31351.069999999974,116,64,442840.13999999996,474191.2099999999
6821,U35590,180,1261.5400000000197,158,22,165595.70999999985,166857.24999999985
6822,U23429,180,-9601.299999999974,121,59,477979.7300000001,468378.4300000001
6823,U8504,180,757.0800000000067,163,17,54282.44000000002,55039.520000000026
6824,U960420,180,-138.94999999999996,139,41,12531.5,12392.55
6825,U33647,180,-22256.67,172,8,48588.35999999999,26331.689999999995
6826,U932906,180,-14221.800000000003,122,58,197304.25999999998,183082.45999999996
6827,U12813,180,12268.490000000005,171,9,26192.4,38460.89000000001
6828,U23157,180,15733.149999999994,131,49,603879.9800000001,619613.1300000001
6829,U9738,180,57491.67,123,57,577362.0100000001,634853.6800000002
6830,U25238,180,112270.10000000012,84,96,20053789.509999998,20166059.61
6831,U33780,180,-6594.129999999997,160,20,28453.020000000004,21858.890000000007
6832,U27494,180,46248.979999999996,163,17,325594.05,371843.02999999997
6833,U41511,180,39277.26999999999,140,40,882656.85,921934.12
6834,U15846,180,-1863.029999999971,136,44,609905.7199999999,608042.6899999998
6835,U26896,180,13148.069999999985,148,32,70166.25999999998,83314.32999999996
6836,U37364,180,-390.15999999998166,117,63,825771.3600000001,825381.2000000001
6837,U10876,180,-1574.6100000000251,162,18,115627.11000000003,114052.5
6838,U14673,180,843807.7999999997,167,13,266827.49999999994,1110635.2999999996
6839,U39854,180,-12989.439999999999,164,16,35593.47000000001,22604.03000000001
6840,U39253,180,-62291.340000000055,168,12,234664.95999999993,172373.61999999988
6841,U8600,180,262381.54,155,25,1107293.1500000001,1369674.6900000002
6842,U11911,180,-87558.91999999963,153,27,7473296.64,7385737.72
6843,U17889,180,-15859.790000000003,143,37,76491.04999999997,60631.25999999997
6844,U11448,180,58964.87000000001,130,50,2001276.1099999999,2060240.98
6845,U39393,180,76.10000000000457,120,60,133667.88000000003,133743.98000000004
6846,U22826,180,-22420.8,168,12,199437.24999999994,177016.44999999995
6847,U834985,180,-227.4200000000002,93,87,73456.85,73229.43000000001
6848,U12756,180,-87605.10000000003,154,26,708475.3900000001,620870.29
6849,U13342,180,181769.21999999974,151,29,2306073.85,2487843.07
6850,U32016,180,77677.99999999977,123,57,1535019.03,1612697.0299999998
6851,U39534,180,-241005.18,152,28,841019.9400000001,600014.76
6852,U9891,180,9779.989999999996,162,18,133946.43000000002,143726.42
6853,U22333,180,-5305620.9799999995,147,33,67302742.02999997,61997121.049999975
6854,U8138,180,-27133.590000000004,147,33,45098.95000000002,17965.360000000015
6855,U41503,180,113317.73999999999,157,23,1032926.0399999999,1146243.7799999998
6856,U31906,180,57543.14000000001,133,47,217010.16,274553.3
6857,U42272,180,-2474.2900000000154,109,71,916262.88,913788.59
6858,U8908,180,837.6100000000031,167,13,22277.589999999993,23115.199999999997
6859,U18397,180,6495.29000000004,167,13,651079.4500000001,657574.7400000001
6860,U20557,180,196808.55,141,39,173960.21999999997,370768.76999999996
6861,U31409,180,-8.620000000006485,159,21,65836.46,65827.84
6862,U32143,180,-16092.709999999988,153,27,41556.01000000001,25463.30000000002
6863,U12828,180,-17907.309999999998,119,61,178846.85999999996,160939.54999999996
6864,U33068,180,-4548.299999999992,154,26,51961.29000000001,47412.99000000002
6865,U42204,180,-15041.850000000004,166,14,152893.80999999994,137851.95999999993
6866,U39686,180,-8157.959999999991,122,58,238658.13999999998,230500.18
6867,U36331,180,186762.10000000012,146,34,2390854.1700000004,2577616.2700000005
6868,U15604,180,-71744.55,97,83,373271.81999999995,301527.26999999996
6869,U42709,180,-202.11999999999534,162,18,31499.699999999997,31297.58
6870,U16895,180,-13108.129999999997,150,30,68188.86999999997,55080.73999999997
6871,U20550,180,279573.3300000001,144,36,433895.92999999993,713469.26
6872,U21149,180,3405.450000000008,120,60,254112.68999999994,257518.13999999996
6873,U31356,180,-28767.050000000003,156,24,73370.69,44603.64
6874,U16442,180,15308.749999999998,170,10,36880.09999999999,52188.84999999999
6875,U17513,180,30995.300000000007,154,26,206764.33999999997,237759.63999999998
6876,U38897,180,-3209.4199999999496,135,45,500137.9,496928.4800000001
6877,U25168,180,4294.780000000011,167,13,56444.6099999999,60739.38999999991
6878,U38969,180,-1875.019999999991,148,32,283560.7,281685.68
6879,U20718,180,-1238.4300000000026,123,57,84412.45,83174.01999999999
6880,U12799,180,6912.869999999995,146,34,139383.30999999997,146296.17999999996
6881,U30286,180,-14758.970000000001,148,32,166065.05000000008,151306.08000000007
6882,U16771,180,-163813.05000000005,157,23,1974567.3900000001,1810754.34
6883,U21269,180,-2048.2399999999316,133,47,639308.6399999999,637260.4
6884,U13332,180,-105.88000000000025,169,11,36282.03000000001,36176.150000000016
6885,U43713,180,-2599.5299999999806,135,45,787647.4099999999,785047.8799999999
6886,U20536,180,-230.52000000000726,114,66,195323.96000000002,195093.44
6887,U13868,180,375562.9600000018,144,36,27538321.549999997,27913884.509999998
6888,U20187,180,3990.080000000007,169,11,79682.19,83672.27
6889,U13996,180,101288.45999999995,132,48,1625654.7400000028,1726943.2000000027
6890,U16283,180,102054.89000000001,142,38,1575003.3499999999,1677058.2399999998
6891,U15759,179,79768.27000000002,161,18,54510.26999999999,134278.54
6892,U16615,179,893212.3099999998,162,17,475523.70999999985,1368736.0199999996
6893,U34802,179,-165539.48,158,21,570501.81,404962.3300000001
6894,U14284,179,-0.36999999987892807,77,102,3697944.0,3697943.63
6895,U18176,179,-15301.259999999997,171,8,49661.69000000003,34360.43000000004
6896,U14545,179,-11658.980000000005,145,34,509996.8300000001,498337.8500000001
6897,U8550,179,7315.290000000008,147,32,557151.1199999999,564466.4099999999
6898,U13778,179,18592.049999999854,156,23,632695.86,651287.9099999998
6899,U25714,179,-220422.15000000002,168,11,327107.18,106685.02999999997
6900,U29022,179,-1817.9399999998348,158,21,234834.58000000002,233016.6400000002
6901,U31319,179,-72356.17999999998,168,11,110536.69,38180.510000000024
6902,U11160,179,-7404.959999999997,98,81,168774.40999999997,161369.44999999998
6903,U20766,179,-18704.170000000002,165,14,70784.62000000001,52080.45000000001
6904,U15056,179,9967.299999999985,162,17,278793.64,288760.94
6905,U26400,179,-327.96000000000555,140,39,540865.94,540537.98
6906,U9018,179,-6266.839999999992,170,9,122447.98000000001,116181.14000000001
6907,U25737,179,-1443.2400000000075,166,13,36328.78,34885.53999999999
6908,U39955,179,54647.30999999999,152,27,358339.93,412987.24
6909,U29148,179,-100955.39000000003,164,15,376233.7399999998,275278.3499999998
6910,U34807,179,4034.380000000001,164,15,51277.49000000001,55311.87000000001
6911,U38659,179,21154.42999999999,129,50,22395.949999999997,43550.37999999999
6912,U19069,179,26926.79000000003,138,41,631425.7800000004,658352.5700000004
6913,U19385,179,7574.950000000001,143,36,48346.21000000001,55921.16
6914,U25870,179,3674.9100000000035,168,11,106712.72000000002,110387.63000000002
6915,U22509,179,30116.3,150,29,211058.61,241174.90999999997
6916,U20505,179,125.57000000000005,155,24,14851.269999999999,14976.839999999998
6917,U24150,179,89877.6199999999,133,46,863701.48,953579.0999999999
6918,U10638,179,-69826.41999999998,152,27,326637.87999999995,256811.45999999996
6919,U20628,179,1323.4700000000005,146,33,176025.50999999995,177348.97999999995
6920,U24452,179,67031.41,159,20,280836.06,347867.47
6921,U35787,179,-17747.250000000022,153,26,502965.6199999999,485218.3699999999
6922,U21845,179,14968.650000000001,149,30,276782.48,291751.13
6923,U24358,179,88141.14000000017,102,77,2262479.18,2350620.3200000003
6924,U39993,179,-447425.81000000006,163,16,2603607.47,2156181.66
6925,U20424,179,-21077.679999999993,127,52,600650.73,579573.05
6926,U11079,179,436867.79,141,38,838258.0899999999,1275125.88
6927,U14922,179,-40341.88,153,26,168781.97999999992,128440.09999999992
6928,U25746,179,-77828.70999999985,164,15,987050.0700000002,909221.3600000003
6929,U26671,179,3168.2900000000163,130,49,474710.6300000001,477878.92000000016
6930,U8967,179,1962.4099999999808,163,16,172732.4599999999,174694.86999999988
6931,U29393,179,-17474.300000000014,106,73,291617.22000000003,274142.92000000004
6932,U33729,179,-70.78000000000029,160,19,22780.65,22709.870000000003
6933,U19501,179,-69271.35,153,26,179502.74000000005,110231.39000000004
6934,U23337,179,-8478.240000000005,167,12,84267.68000000004,75789.44000000003
6935,U22863,179,11577.039999999994,171,8,21117.930000000008,32694.97
6936,U18058,179,1161.409999999991,107,72,279182.54,280343.94999999995
6937,U29458,179,8686.19,174,5,11348.079999999998,20034.269999999997
6938,U43722,179,7059.279999999991,117,62,268140.75,275200.02999999997
6939,U35724,179,5975.789999999999,118,61,67592.14000000001,73567.93000000001
6940,U24103,179,184.45999999999694,100,79,15814.569999999998,15999.029999999995
6941,U12620,179,-1387.1499999999942,162,17,73743.87000000004,72356.72000000004
6942,U9198,179,15511.400000000001,152,27,113920.28999999992,129431.68999999992
6943,U28894,179,-1326.1300000000006,170,9,22024.18,20698.05
6944,U24503,179,-2023.5799999999406,129,50,1482278.67,1480255.09
6945,U23679,179,-57996.480000000025,157,22,364406.69,306410.20999999996
6946,U14471,179,5815.899999999995,158,21,258401.3199999999,264217.2199999999
6947,U14931,178,-7395.299999999977,146,32,863227.4100000003,855832.1100000003
6948,U18284,178,-84480.30999999997,136,42,1387789.1899999997,1303308.8799999997
6949,U18966,178,-2821.2399999999934,129,49,579468.3300000002,576647.0900000002
6950,U38993,178,-1511.150000000001,172,6,12842.070000000003,11330.920000000002
6951,U12168,178,1954.999999999999,154,24,179967.62,181922.62
6952,U9729,178,145136.19,168,10,23137.88,168274.07
6953,U23268,178,19318.449999999553,158,20,2108978.4399999995,2128296.889999999
6954,U39683,178,3232.779999999999,173,5,17075.04,20307.82
6955,U20563,178,769.9800000000002,165,13,12853.290000000003,13623.270000000002
6956,U33662,178,-6262.479999999998,165,13,45966.84000000001,39704.360000000015
6957,U1210062,178,-3342.139999999999,100,78,80442.33,77100.19
6958,U11524,178,9825.0,159,19,213536.3,223361.3
6959,U20079,178,-76344.59999999999,173,5,78974.63999999998,2630.0399999999936
6960,U22049,178,-733.6599999999976,150,28,98742.49999999999,98008.83999999998
6961,U13671,178,674499.6599999995,146,32,4424678.549999997,5099178.209999996
6962,U17195,178,-36385.46000000005,145,33,506456.98,470071.5199999999
6963,U12800,178,17826.559999999998,160,18,69826.83000000002,87653.39000000001
6964,U19336,178,18967.850000000006,162,16,82487.9,101455.75
6965,U41253,178,-2507.010000000003,139,39,34617.9,32110.89
6966,U14070,178,-19943.360000000004,159,19,340347.70000000007,320404.3400000001
6967,U11847,178,21985.55999999999,154,24,109860.12999999996,131845.68999999994
6968,U20368,178,30968.74999999994,142,36,349577.45,380546.19999999995
6969,U9669,178,-37977.920000000006,66,112,581758.9400000001,543781.02
6970,U36251,178,-75375.22,109,69,234248.14,158872.92
6971,U36820,178,-248.6099999999988,165,13,12551.51,12302.900000000001
6972,U25609,178,-17543.790000000005,125,53,216338.13999999993,198794.34999999992
6973,U40566,178,-397933.61,161,17,600552.8000000003,202619.1900000003
6974,U32840,178,-297.76999999998407,146,32,176245.44,175947.67
6975,U25011,178,568.8399999999958,102,76,229498.34000000014,230067.18000000014
6976,U28592,178,-6013.26,166,12,16838.429999999993,10825.169999999993
6977,U31857,178,-28962.830000000005,162,16,170342.77999999994,141379.94999999992
6978,U43881,178,31309.840000000004,128,50,637873.22,669183.0599999999
6979,U35794,178,-5079.210000000006,154,24,164635.41000000003,159556.2
6980,U26237,178,-1672.290000000001,155,23,13856.649999999992,12184.359999999991
6981,U28798,178,-101291.54999999997,140,38,1395270.8299999996,1293979.2799999996
6982,U17628,178,23503.63000000009,120,58,973500.1499999998,997003.7799999999
6983,U41830,178,-1000.0000000000073,127,51,379168.54,378168.54
6984,U23644,178,-15363.670000000004,150,28,45751.040000000015,30387.37000000001
6985,U22666,178,-95407.20999999992,139,39,229686.80999999985,134279.59999999992
6986,U33661,178,-3838.2000000000003,164,14,82491.95,78653.75
6987,U15207,178,-4047.5600000000004,158,20,122916.58000000002,118869.02000000002
6988,U19398,178,-5585.470000000017,161,17,72991.71,67406.23999999999
6989,U41429,178,-662.2400000000052,159,19,150367.52999999997,149705.28999999998
6990,U20702,178,-63332.480000000076,111,67,535496.45,472163.96999999986
6991,U17239,178,-75226.44999999998,169,9,181697.08999999994,106470.63999999996
6992,U19540,178,6368.529999999965,165,13,102278.45999999995,108646.98999999992
6993,U29359,178,2435.6399999998976,140,38,2817519.9699999993,2819955.6099999994
6994,U17061,178,14147.889999999992,156,22,74342.81,88490.69999999998
6995,U30200,178,14748.310000000003,171,7,25905.91000000001,40654.220000000016
6996,U8487,178,16518.160000000025,122,56,1516411.01,1532929.17
6997,U32291,178,91823.17000000017,111,67,4509573.49,4601396.66
6998,U42620,178,-317075.75999999995,155,23,1069279.9000000004,752204.1400000004
6999,U36479,178,37222.95000000001,115,63,1149737.8199999998,1186960.7699999998
7000,U22501,178,-3919.43,168,10,20900.339999999997,16980.909999999996
7001,U20634,178,-14330.370000000039,124,54,555958.22,541627.85
7002,U14800,178,-5596.939999999997,169,9,92864.78000000001,87267.84000000001
7003,U36287,178,455282.1900000004,154,24,1717133.8399999999,2172416.0300000003
7004,U27889,178,-20110.109999999993,137,41,287061.75000000006,266951.6400000001
7005,U40777,178,2152.0200000000073,143,35,35043.84999999999,37195.869999999995
7006,U28730,178,-114926.34999999999,164,14,141143.00999999998,26216.65999999999
7007,U28254,178,265668.0299999999,166,12,67001.72,332669.7499999999
7008,U17728,178,-66585.4,139,39,232750.52000000002,166165.12000000002
7009,U9224,178,-13548.059999999985,164,14,182787.62000000002,169239.56000000003
7010,U23355,178,4109.530000000009,166,12,80075.01999999999,84184.55
7011,U12543,178,-52340.24,161,17,83755.87,31415.629999999997
7012,U30255,178,73680.17999999995,163,15,475766.9599999999,549447.1399999999
7013,U9835,178,-6651.909999999994,165,13,47869.42000000001,41217.51000000002
7014,U33704,178,131506.16999999998,163,15,93072.06,224578.22999999998
7015,U32474,178,-12265.869999999988,116,62,741183.3200000001,728917.4500000001
7016,U11222,178,-8390.84,162,16,76783.87999999996,68393.03999999996
7017,U593721,178,-21955.610000000008,168,10,33210.15,11254.539999999994
7018,U21474,178,-3556.949999999997,156,22,70456.9,66899.95
7019,U19757,177,-9945.79000000001,154,23,351752.73000000004,341806.94
7020,U865759,177,-4541.219999999992,148,29,145287.55999999997,140746.33999999997
7021,U27238,177,-1271.820000000007,144,33,358420.55,357148.73
7022,U20985,177,-7194.570000000007,138,39,115228.38999999998,108033.81999999998
7023,U32444,177,-329.83999999999276,161,16,319091.08999999997,318761.25
7024,U11442,177,9658.54,158,19,67879.51999999996,77538.05999999997
7025,U23582,177,-741368.4,169,8,864702.07,123333.66999999993
7026,U25233,177,-901.5900000000001,166,11,15222.280000000002,14320.690000000002
7027,U32521,177,7036.220000000022,115,62,1195941.62,1202977.84
7028,U26195,177,-6038.689999999995,156,21,137160.80000000002,131122.11000000002
7029,U35861,177,-28567.35,157,20,676321.64,647754.29
7030,U25468,177,24511.329999999998,132,45,255278.41999999995,279789.74999999994
7031,U1180761,177,7.000000000007276,114,63,362081.74999999994,362088.74999999994
7032,U34159,177,-4051.000000000001,166,11,31678.800000000003,27627.800000000003
7033,U34029,177,-311117.19,170,7,327319.22,16202.02999999997
7034,U19406,177,4630.460000000036,108,69,845889.91,850520.3700000001
7035,U40380,177,-867.6599999999814,138,39,835717.28,834849.62
7036,U31971,177,-2267.92,148,29,132184.31000000003,129916.39000000003
7037,U37845,177,50910.84000000006,158,19,698468.09,749378.93
7038,U34393,177,5667.759999999991,159,18,166695.28,172363.03999999998
7039,U8423,177,-49260.73999999998,163,14,323742.58000000013,274481.84000000014
7040,U977519,177,-7457.439999999998,146,31,9148.840000000002,1691.4000000000042
7041,U28554,177,-8341.110000000004,152,25,47890.58000000002,39549.470000000016
7042,U15910,177,-100737.57,163,14,196495.95999999993,95758.38999999993
7043,U12952,177,300.6900000000044,168,9,29282.409999999996,29583.100000000002
7044,U11771,177,1297.850000000035,149,28,1306184.4700000002,1307482.3200000003
7045,U1166321,177,60.580000000001746,90,87,26606.170000000002,26666.750000000004
7046,U28247,177,1667.8199999999947,163,14,46912.270000000004,48580.09
7047,U17282,177,-1599.9600000000005,157,20,136806.74,135206.78
7048,U12588,177,61847.27999999999,152,25,12524.87,74372.15
7049,U33799,177,-215169.69999999995,161,16,361581.8299999999,146412.12999999995
7050,U19900,177,23745.95000000004,156,21,959042.9800000001,982788.9300000002
7051,U8084,177,-534.6199999999983,116,61,515897.6599999999,515363.0399999999
7052,U27017,177,-13078.150000000003,158,19,98178.82,85100.67
7053,U31098,177,-266.38999999993155,157,20,237725.11,237458.72000000006
7054,U42843,177,142.96999999999923,127,50,88150.46999999991,88293.43999999992
7055,U29984,177,-1221.3099999999984,147,30,93299.12000000001,92077.81000000001
7056,U21170,177,-10562.500000000386,140,37,2851129.67,2840567.1699999995
7057,U25283,177,19995.649999999958,157,20,85518.51000000007,105514.16000000003
7058,U27275,177,-1310.8499999999995,162,15,69411.48000000001,68100.63
7059,U34987,177,13996.039999999999,139,38,37635.270000000004,51631.310000000005
7060,U22539,177,2831.7700000000004,166,11,63903.56999999998,66735.33999999998
7061,U16362,177,-42896.16000000001,156,21,317703.43000000005,274807.27
7062,U39141,177,6435.249999999998,156,21,238252.25999999995,244687.50999999995
7063,U21962,177,3113.1299999999983,159,18,287728.58999999997,290841.72
7064,U42423,177,-1456.619999999999,163,14,85728.31,84271.69
7065,U25970,177,24.740000000000173,130,47,2720.29,2745.03
7066,U21229,177,-89274.77999999991,136,41,973327.7899999998,884053.0099999999
7067,U10991,177,-10956.479999999994,155,22,125200.68000000001,114244.20000000001
7068,U17993,177,-16878.870000000003,151,26,241854.0499999999,224975.1799999999
7069,U12346,177,151877.82,158,19,11978.739999999989,163856.56
7070,U36797,177,4098.129999999987,154,23,304973.62999999983,309071.75999999983
7071,U38962,177,-67581.38,110,67,446394.93000000005,378813.55000000005
7072,U24786,177,291.7199999999998,144,33,49589.21000000001,49880.93000000001
7073,U20250,177,-22886.9,161,16,53852.160000000025,30965.260000000024
7074,U42086,177,-3159.360000000002,163,14,22443.71,19284.35
7075,U24200,177,7153.609999999997,131,46,429240.6,436394.20999999996
7076,U25436,177,-186485.4699999999,133,44,1781261.86,1594776.3900000001
7077,U34847,177,25168.199999999997,167,10,32376.190000000002,57544.39
7078,U28496,177,30209.609999999997,153,24,34163.97,64373.58
7079,U29651,177,-71963.70999999998,165,12,1101209.6700000006,1029245.9600000007
7080,U42413,177,-49596.14999999999,122,55,118318.45,68722.30000000002
7081,U21211,177,-5883.000000000005,156,21,127742.06000000001,121859.06000000001
7082,U12505,176,123033.49999999991,167,9,162303.2400000001,285336.74
7083,U28212,176,-36464.020000000026,122,54,771536.12,735072.1
7084,U14218,176,3283.7599999999966,171,5,6862.620000000002,10146.379999999997
7085,U8528,176,-640.0600000000055,106,70,190101.00000000003,189460.94000000003
7086,U28991,176,75.02000000000226,134,42,118369.19,118444.21
7087,U17668,176,15150.60999999999,158,18,83150.80999999997,98301.41999999995
7088,U13666,176,-13762.139999999998,115,61,127961.93999999997,114199.79999999997
7089,U28489,176,-19813.350000000002,153,23,166279.24999999997,146465.89999999997
7090,U17808,176,8045.640000000005,92,84,140680.01,148725.65000000002
7091,U23716,176,-37223.250000000124,125,51,1581029.59,1543806.3399999999
7092,U13912,176,-7473.029999999988,140,36,252863.76,245390.73
7093,U40052,176,-4386.639999999999,162,14,28768.73,24382.09
7094,U38926,176,6669.84,151,25,48512.20000000003,55182.04000000004
7095,U16688,176,-8897.259999999998,167,9,26486.02000000001,17588.760000000013
7096,U17856,176,-50496.520000000004,164,12,189174.21000000002,138677.69
7097,U16216,176,-109054.51999999999,163,13,435608.84,326554.32000000007
7098,U23868,176,-26297.61,137,39,274678.60000000003,248380.99000000005
7099,U30287,176,-84778.82999999999,143,33,1000060.0399999999,915281.21
7100,U685409,176,-3429.489999999996,117,59,200855.14999999997,197425.65999999997
7101,U20441,176,5103.580000000004,159,17,66261.83000000002,71365.41000000002
7102,U42812,176,21536.369999999966,153,23,232563.36999999997,254099.73999999993
7103,U13409,176,154666.33,149,27,1439187.17,1593853.5
7104,U8105,176,44887.99999999999,159,17,177066.18999999994,221954.18999999994
7105,U36290,176,-55624.08000000001,136,40,132049.08,76424.99999999997
7106,U18845,176,-5270.620000000002,159,17,39131.880000000005,33861.26
7107,U10585,176,-296753.55,164,12,416645.59,119892.04000000004
7108,U971720,176,-1197.010000000003,119,57,216312.04999999996,215115.03999999995
7109,U12330,176,1170.2799999999988,153,23,245265.19999999995,246435.47999999995
7110,U21511,176,-41906.55000000005,95,81,3362769.68,3320863.13
7111,U43668,176,22775.34999999999,161,15,352588.88,375364.23
7112,U30583,176,-13495.659999999998,160,16,66043.67999999998,52548.01999999998
7113,U29611,176,-4977.48,168,8,105942.74,100965.26000000001
7114,U16280,176,6935.3299999999945,141,35,102687.88,109623.20999999999
7115,U26706,176,81316.88000000012,140,36,20971680.099999998,21052996.979999997
7116,U24700,176,-50941.36999999999,97,79,273177.23999999993,222235.86999999994
7117,U39649,176,-2835.9200000000346,146,30,677822.0800000001,674986.16
7118,U1116202,176,995.6199999999994,99,77,32138.769999999997,33134.39
7119,U28988,176,45034.090000000004,90,86,452735.49999999994,497769.58999999997
7120,U24381,176,38762.56,162,14,147765.79,186528.35
7121,U38771,176,17981.309999999998,152,24,65757.07,83738.38
7122,U30792,176,47861.37000000001,140,36,276474.5700000001,324335.9400000001
7123,U20915,176,-23331.560000000012,165,11,75127.33000000006,51795.77000000005
7124,U969918,176,1709.4299999999962,98,78,24117.27,25826.699999999997
7125,U18691,176,-9665.210000000032,172,4,24906.249999999945,15241.039999999914
7126,U39122,176,55363.37999999994,135,41,551240.4500000001,606603.83
7127,U36385,176,-18962.499999999996,139,37,266535.1000000002,247572.6000000002
7128,U24425,176,-3871.2000000000094,151,25,796486.0000000001,792614.8000000002
7129,U20116,176,3138.6799999999994,163,13,120218.17000000003,123356.85000000002
7130,U9114,176,-69284.39999999995,150,26,903596.9100000003,834312.5100000004
7131,U41815,176,-317.7500000000109,135,41,54412.85000000001,54095.100000000006
7132,U31258,176,1814.5199999999882,154,22,152204.63,154019.15
7133,U29870,176,5578.570000000003,148,28,13629.759999999995,19208.329999999998
7134,U13972,176,-35568.28000000003,164,12,96612.57999999987,61044.29999999984
7135,U36537,176,-22554.45,127,49,278487.24999999994,255932.79999999993
7136,U37794,176,848.4100000000035,107,69,115583.29999999999,116431.70999999999
7137,U40378,176,111067.44,162,14,39520.700000000004,150588.14
7138,U35269,176,-14410.179999999995,167,9,47359.65999999999,32949.479999999996
7139,U25550,176,28775.110000000568,141,35,11754284.290000001,11783059.400000002
7140,U25869,176,-621.5599999999986,137,39,298532.4200000001,297910.8600000001
7141,U8657,176,3375.5800000000017,160,16,80225.84000000001,83601.42000000001
7142,U38873,176,-5200.270000000001,149,27,856129.2899999999,850929.0199999999
7143,U43934,176,-7487.440000000001,149,27,98513.26999999997,91025.82999999997
7144,U35460,175,578341.1899999996,156,19,157823.66999999993,736164.8599999995
7145,U32761,175,-34484.62000000001,161,14,80024.67,45540.04999999999
7146,U39896,175,189809.11000000007,155,20,111830.67000000001,301639.7800000001
7147,U12947,175,48256.05,165,10,68148.84999999999,116404.9
7148,U13857,175,-55125.37000000016,129,46,952142.5699999996,897017.1999999995
7149,U17782,175,6246.749999999989,133,42,130531.51,136778.25999999998
7150,U25538,175,11188.059999999996,110,65,266140.69999999995,277328.75999999995
7151,U30144,175,-25633.920000000016,117,58,291920.76999999996,266286.8499999999
7152,U9711,175,825.9599999999994,95,80,38898.02999999999,39723.98999999999
7153,U23675,175,-19392.079999999987,126,49,484077.95000000007,464685.8700000001
7154,U41651,175,-13242.330000000002,154,21,305478.6,292236.26999999996
7155,U35207,175,-105980.54000000004,167,8,226405.52999999994,120424.9899999999
7156,U23933,175,-109924.94000000003,135,40,1318942.83,1209017.8900000001
7157,U23941,175,761.4000000000015,169,6,33238.74,34000.14
7158,U10617,175,4358.779999999995,135,40,171695.53999999998,176054.31999999998
7159,U11840,175,-1801136.210000001,140,35,2048074.0700000005,246937.85999999964
7160,U1256422,175,-19.950000000000024,97,78,4443.990000000001,4424.040000000001
7161,U42210,175,280.59999999999854,152,23,32280.979999999985,32561.579999999984
7162,U30937,175,5160.630000000001,154,21,28591.940000000002,33752.57000000001
7163,U17673,175,-19285.540000000015,148,27,105396.99000000002,86111.45000000001
7164,U962650,175,10237.67,132,43,61716.310000000005,71953.98000000001
7165,U19718,175,-6022.590000000002,145,30,30153.329999999998,24130.739999999998
7166,U8279,175,1561.2700000000018,165,10,26104.55999999999,27665.82999999999
7167,U28398,175,-19909.77,166,9,33171.16,13261.390000000003
7168,U41982,175,-1351.8600000000051,154,21,20869.65999999999,19517.799999999985
7169,U24826,175,1757.3199999999997,145,30,12549.229999999996,14306.549999999996
7170,U19863,175,-2347.6599999999967,157,18,38269.51,35921.850000000006
7171,U17119,175,18594.03000000001,155,20,637289.7,655883.73
7172,U32223,175,2615.400000000058,128,47,359336.36,361951.76000000007
7173,U15855,175,11442.78999999995,111,64,147879.51999999993,159322.30999999988
7174,U26161,175,37541.85999999992,110,65,953722.75,991264.6099999999
7175,U43936,175,597.1499999999994,165,10,14270.66,14867.81
7176,U33931,175,12080.750000000007,154,21,158962.46,171043.21
7177,U30357,175,-108256.07999999994,123,52,560483.23,452227.15
7178,U37971,175,156.70000000000056,163,12,10748.490000000003,10905.190000000004
7179,U8836,175,1024.3899999999994,160,15,77730.16,78754.55
7180,U29985,175,-1087.1299999999937,159,16,60351.68000000002,59264.55000000003
7181,U14489,175,997.4500000000129,132,43,210866.13000000006,211863.58000000007
7182,U11972,175,-16423.289999999997,165,10,60447.35,44024.06
7183,U1149170,175,-10141.690000000008,139,36,52025.619999999995,41883.929999999986
7184,U9653,175,6361.459999999977,153,22,330790.1099999999,337151.5699999999
7185,U28664,175,-103126.67,156,19,127265.64,24138.97
7186,U41674,175,-1604.1799999999894,150,25,339799.72999999986,338195.5499999999
7187,U36545,175,20195.79,166,9,35287.21000000001,55483.00000000001
7188,U35297,175,-9113.95,172,3,12130.52,3016.5699999999997
7189,U25273,175,4241.58,158,17,20280.040000000005,24521.620000000003
7190,U34332,175,89.95999999999756,153,22,26724.210000000003,26814.170000000002
7191,U34421,175,-437804.1599999999,138,37,1093477.17,655673.01
7192,U19154,175,79713.76999999999,79,96,358177.05999999994,437890.82999999996
7193,U13575,175,87312.56999999998,121,54,804454.46,891767.0299999999
7194,U43551,175,19630.660000000003,137,38,248056.97999999998,267687.64
7195,U42987,175,99.30999999963231,105,70,13446985.939999998,13447085.249999998
7196,U18389,175,-235236.34000000003,158,17,914724.0800000001,679487.74
7197,U35389,175,-102351.55000000003,158,17,321963.63,219612.07999999996
7198,U41718,175,31673.009999999995,156,19,216438.43999999994,248111.44999999995
7199,U32575,175,-2390.4900000000002,150,25,21434.97,19044.48
7200,U40714,175,-74486.98000000001,147,28,244132.63000000003,169645.65000000002
7201,U36855,175,67006.57999999997,122,53,267527.83999999997,334534.4199999999
7202,U17537,175,527108.2100000002,162,13,951785.8099999999,1478894.02
7203,U28391,175,-3355.0799999999995,169,6,16381.429999999998,13026.349999999999
7204,U27746,175,26220.29999999999,139,36,168120.82,194341.12
7205,U31108,175,-3536.2799999999984,158,17,41350.29000000001,37814.01000000001
7206,U13319,175,-99773.18999999999,148,27,366272.72,266499.52999999997
7207,U19221,175,4476.770000000024,105,70,2268304.589999999,2272781.359999999
7208,U20991,175,18306.949999999986,127,48,98129.59,116436.53999999998
7209,U40495,175,116395.29,149,26,154689.81,271085.1
7210,U39676,175,91577.57999999997,136,39,244309.29,335886.87
7211,U14798,175,43609.22,152,23,342814.62000000005,386423.8400000001
7212,U1249109,175,53.54999999999927,104,71,98556.57,98610.12000000001
7213,U20069,175,66258.63,135,40,486638.03,552896.66
7214,U9579,175,-995.6400000000003,172,3,5186.0,4190.36
7215,U22547,175,-16449.970000000005,167,8,49962.15000000001,33512.18000000001
7216,U41711,175,-1817.9100000000042,156,19,88556.06999999998,86738.15999999997
7217,U16235,175,-67402.33000000002,162,13,205495.8,138093.46999999997
7218,U23178,175,13484.84,153,22,122757.61000000002,136242.45
7219,U33371,175,-12960.689999999997,130,45,410280.58,397319.89
7220,U32450,174,1080.6999999999998,156,18,38024.07,39104.77
7221,U32115,174,-36547.47,159,15,94250.33000000003,57702.86000000003
7222,U26732,174,-4706.900000000001,161,13,31313.679999999993,26606.77999999999
7223,U42233,174,-5555.46,141,33,97027.56999999999,91472.10999999999
7224,U43567,174,-6783.679999999991,124,50,237335.63,230551.95
7225,U30822,174,-25995.96,114,60,111759.09999999999,85763.13999999998
7226,U15783,174,-20883.449999999917,106,68,1170716.1700000002,1149832.7200000002
7227,U11914,174,-78905.74000000002,93,81,303567.13999999996,224661.39999999994
7228,U31922,174,-44998.62,138,36,678173.04,633174.42
7229,U42711,174,25652.109999999993,154,20,169449.38000000003,195101.49000000002
7230,U36433,174,-10015.210000000001,165,9,43214.73000000001,33199.52000000001
7231,U821141,174,-249.16000000000022,143,31,4530.579999999999,4281.419999999999
7232,U38575,174,-5180.1999999999825,160,14,70402.89999999998,65222.7
7233,U22930,174,-9747.75,161,13,82312.44,72564.69
7234,U15492,174,-209285.96999999997,129,45,2064874.61,1855588.6400000001
7235,U38150,174,27775.620000000108,152,22,126571.98000000048,154347.6000000006
7236,U13814,174,-19868.77,168,6,20159.09,290.3199999999997
7237,U36987,174,-99636.48999999999,130,44,1533602.29,1433965.8
7238,U19053,174,1694.0099999999973,156,18,46356.84999999999,48050.859999999986
7239,U18424,174,15190.969999999994,147,27,174153.55999999997,189344.52999999997
7240,U42638,174,-50138.85000000002,165,9,583545.3500000002,533406.5000000002
7241,U38491,174,1638.9600000000023,160,14,23124.840000000004,24763.800000000007
7242,U29452,174,-1002564.5699999998,145,29,2040406.9999999995,1037842.4299999997
7243,U37547,174,79571.30000000002,164,10,41402.0,120973.30000000002
7244,U11953,174,-4329.000000000009,122,52,356743.99000000005,352414.99000000005
7245,U16094,174,-63549.369999999995,152,22,481631.86,418082.49
7246,U30234,174,-8655.730000000001,146,28,91666.31999999999,83010.59
7247,U684349,174,-1392.1099999999965,124,50,74647.95,73255.84
7248,U33941,174,-3742.47,142,32,118120.54,114378.06999999999
7249,U26102,174,-381.2699999999981,168,6,50388.41,50007.14000000001
7250,U25758,174,4560.169999999996,147,27,106373.49,110933.66
7251,U36042,174,9187.00000000003,157,17,773235.7300000003,782422.7300000003
7252,U29118,174,7800.680000000015,159,15,491486.33,499287.01
7253,U41176,174,18824.49000000001,154,20,175929.14,194753.63000000003
7254,U31208,174,-13339.04,170,4,22704.62,9365.579999999998
7255,U10934,174,-44616.03999999998,139,35,520884.67000000004,476268.63000000006
7256,U27308,174,15846.609999999968,154,20,190571.3,206417.90999999995
7257,U15822,174,35122.979999999974,91,83,772289.17,807412.15
7258,U17181,174,-7847.579999999995,153,21,160604.93,152757.35
7259,U16850,174,-2005.020000000035,79,95,1217588.57,1215583.55
7260,U31788,174,-27423.349999999995,151,23,233401.51,205978.16
7261,U1290307,174,-221.83000000000015,151,23,27689.530000000002,27467.7
7262,U43374,174,51458.99999999999,158,16,78450.36999999998,129909.36999999997
7263,U38704,174,-220292.86000000002,158,16,262015.21,41722.34999999998
7264,U28872,174,1010.3299999999872,145,29,1050404.16,1051414.49
7265,U23144,174,30255.98000000001,152,22,385978.68999999994,416234.6699999999
7266,U14965,174,-42020.07000000002,152,22,186597.12,144577.05
7267,U11408,174,-11891.650000000003,165,9,32227.390000000003,20335.739999999998
7268,U18292,174,-457.3299999999997,161,13,16724.139999999996,16266.809999999996
7269,U31209,174,72804.34999999999,154,20,29356.449999999993,102160.79999999999
7270,U18661,174,27313.100000000028,144,30,325944.8699999999,353257.9699999999
7271,U23135,174,17343.390000000003,151,23,253925.24999999985,271268.63999999984
7272,U37558,174,-57859.74999999997,127,47,773838.2000000001,715978.4500000001
7273,U15611,174,4214.0,166,8,14385.25,18599.25
7274,U13266,174,-35549.790000000015,145,29,239398.37000000008,203848.58000000007
7275,U33648,174,-50220.200000000004,153,21,146280.78,96060.57999999999
7276,U19514,174,-5906.029999999988,104,70,435126.08,429220.05000000005
7277,U36954,174,12292.910000000062,127,47,918138.3200000001,930431.2300000001
7278,U13579,174,431473.42999999993,96,78,3296915.71,3728389.1399999997
7279,U20394,174,7279.030000000001,154,20,25129.530000000006,32408.560000000005
7280,U16119,174,-169628.7300000001,125,49,759020.43,589391.7
7281,U37766,174,-8293.719999999998,171,3,18337.1,10043.380000000001
7282,U16388,174,30617.33999999999,163,11,61239.53000000003,91856.87000000002
7283,U18260,174,-4347.1600000000035,137,37,45551.46,41204.299999999996
7284,U14824,174,19891.87999999999,139,35,345116.1000000001,365007.9800000001
7285,U21339,174,8.050000000025875,116,58,297933.86000000004,297941.9100000001
7286,U26454,174,-47.210000000000036,149,25,21748.85,21701.64
7287,U17550,174,252997.21000000008,118,56,5001880.710000001,5254877.920000001
7288,U16811,174,13360.510000000007,158,16,68639.88999999998,82000.4
7289,U31237,174,-80224.67,155,19,172247.8499999999,92023.17999999989
7290,U31033,173,490.29000000001645,139,34,110176.71999999996,110667.00999999998
7291,U11796,173,-17872.880000000005,156,17,1997611.38,1979738.5
7292,U34659,173,-12854.439999999999,160,13,82444.9,69590.45999999999
7293,U9560,173,20637.41,157,16,111199.55999999998,131836.96999999997
7294,U32958,173,24718.360000000004,166,7,68091.6,92809.96
7295,U30261,173,4503.739999999998,146,27,16125.160000000002,20628.9
7296,U26794,173,-73019.9700000001,114,59,2458083.5100000007,2385063.5400000005
7297,U28595,173,12909.770000000175,155,18,3235208.9800000004,3248118.7500000005
7298,U15904,173,31085.92000000005,125,48,495892.32000000007,526978.2400000001
7299,U37149,173,20743.110000000022,143,30,241606.4299999999,262349.5399999999
7300,U39756,173,402.37000000000523,150,23,183997.74,184400.11
7301,U22923,173,-12955.940000000002,137,36,456127.7100000001,443171.7700000001
7302,U8245,173,41750.779999999955,69,104,257986.22999999995,299737.0099999999
7303,U10126,173,-11443.280000000004,133,40,298305.7999999999,286862.51999999984
7304,U35469,173,-5825.990000000003,163,10,16320.720000000005,10494.730000000001
7305,U13033,173,-1145725.03,162,11,1307754.01,162028.97999999998
7306,U16979,173,-7792.189999999995,118,55,88431.42999999995,80639.23999999996
7307,U11569,173,-104165.0799999999,80,93,2476113.59,2371948.51
7308,U39336,173,-404175.01000000007,155,18,594450.71,190275.6999999999
7309,U33081,173,7281.559999999999,155,18,106582.59,113864.15
7310,U24276,173,1090.8000000000027,149,24,373772.98,374863.77999999997
7311,U33542,173,-1171.2699999999995,146,27,39406.68,38235.41
7312,U26244,173,5579.350000000002,147,26,37032.789999999986,42612.139999999985
7313,U17614,173,-182.11000000017157,146,27,813614.4500000001,813432.3399999999
7314,U18275,173,-2063.389999999998,148,25,35107.090000000004,33043.700000000004
7315,U11359,173,48491.319999999985,147,26,581519.5600000002,630010.8800000001
7316,U27825,173,-7625.159999999988,127,46,180097.11,172471.95
7317,U34051,173,-1613.589999999996,142,31,49823.0,48209.41
7318,U1345974,173,-9461.049999999994,145,28,33296.52,23835.47
7319,U25832,173,1075.040000000008,140,33,108345.01,109420.05
7320,U13070,173,-114.79999999999018,131,42,226568.19,226453.39
7321,U40487,173,-48718.82999999997,149,24,261465.50999999995,212746.68
7322,U17065,173,63451.20999999993,161,12,96288.68000000001,159739.88999999993
7323,U37096,173,4592.370000000015,153,20,297355.38,301947.75
7324,U29551,173,5849.5700000000015,106,67,97337.37,103186.94
7325,U13244,173,7950.399999999965,153,20,504179.21,512129.61
7326,U25889,173,464852.04,146,27,5634010.72,6098862.76
7327,U9890,173,-19400.219999999998,160,13,89404.28000000001,70004.06000000001
7328,U26887,173,-2145.8099999999995,162,11,60647.16000000002,58501.35000000002
7329,U15844,173,6572.440000000704,143,30,7693201.730000002,7699774.170000003
7330,U13301,173,-214545.13,138,35,771292.95,556747.82
7331,U31025,173,-56201.40000000002,157,16,130945.7399999999,74744.33999999988
7332,U17297,173,-971003.3400000001,156,17,1211476.1100000003,240472.77000000025
7333,U16081,173,4821.7300000000105,158,15,648213.7800000003,653035.5100000002
7334,U17532,173,-17857.660000000003,143,30,118430.46000000005,100572.80000000005
7335,U13650,173,-114140.26999999996,135,38,920073.7200000001,805933.4500000002
7336,U42825,173,741.5300000000375,112,61,193539.7900000001,194281.32000000012
7337,U25173,173,37.749999999999616,156,17,26786.840000000004,26824.590000000004
7338,U18699,173,-30691.15,110,63,611531.0,580839.85
7339,U31930,173,-4050.0900000000065,111,62,98391.69,94341.59999999999
7340,U17632,173,47759.37999999998,150,23,1281829.5099999998,1329588.8899999997
7341,U12547,173,-6886.280000000001,146,27,162400.53999999998,155514.25999999998
7342,U32227,173,-5696.279999999999,95,78,77323.2,71626.92
7343,U30967,173,40843.27000000001,122,51,640415.4999999999,681258.7699999999
7344,U8452,173,208.000000000025,152,21,331497.79,331705.79
7345,U23172,173,-12218.75999999998,133,40,945367.6900000001,933148.93
7346,U12814,173,-67642.04999999999,109,64,270528.65,202886.60000000003
7347,U1105450,173,-192.76999999999953,97,76,33515.57,33322.8
7348,U17841,173,1670.3300000000027,164,9,55604.7,57275.03
7349,U23353,173,11166.380000000077,141,32,490170.47,501336.85000000003
7350,U12001,173,-7391.769999999992,158,15,223346.19999999978,215954.4299999998
7351,U19872,173,1559.989999999998,99,74,529459.4299999999,531019.4199999999
7352,U19564,173,-1728.0899999999867,104,69,1241757.8900000001,1240029.8
7353,U42449,173,20822.77999999997,132,41,288362.28999999986,309185.06999999983
7354,U25146,173,9873.899999999998,126,47,172724.25999999998,182598.15999999997
7355,U15995,173,4110.489999999996,167,6,39909.34999999999,44019.83999999999
7356,U21747,173,-8270.160000000007,110,63,1415526.71,1407256.55
7357,U24083,173,-59244.71000000002,124,49,897677.3299999995,838432.6199999994
7358,U37139,173,6854.360000000004,163,10,13103.909999999998,19958.270000000004
7359,U43235,173,2127.1899999999996,150,23,14350.269999999997,16477.459999999995
7360,U8654,172,-25438.64,165,7,43124.23,17685.590000000004
7361,U12423,172,85643.65999999999,129,43,593422.44,679066.1
7362,U19441,172,-23069.54000000001,153,19,84698.67,61629.12999999999
7363,U35077,172,33200.18999999999,141,31,269166.77,302366.96
7364,U41762,172,-6130.730000000021,134,38,205468.51000000004,199337.78000000003
7365,U39097,172,-7667.039999999999,140,32,119949.88000000002,112282.84000000003
7366,U36562,172,37434.609999999986,127,45,1001909.12,1039343.73
7367,U33269,172,1324.1999999999907,159,13,46785.64000000001,48109.84
7368,U11351,172,-13016.070000000002,152,20,36554.100000000006,23538.030000000006
7369,U41055,172,-10721.509999999995,113,59,311119.69999999995,300398.18999999994
7370,U11724,172,-17503.509999999995,144,28,428158.98000000004,410655.47000000003
7371,U37924,172,-18002.28999999998,123,49,754980.13,736977.8400000001
7372,U15241,172,45698.219999999885,146,26,2476167.3499999996,2521865.5699999994
7373,U14622,172,31812.34000000007,148,24,650481.4700000002,682293.8100000003
7374,U33666,172,-326938.42000000004,143,29,554208.2700000003,227269.8500000002
7375,U20681,172,-477.04000000000065,147,25,41331.83000000006,40854.79000000006
7376,U29600,172,16388.55,82,90,58640.14,75028.69
7377,U35529,172,11260.790000000034,118,54,357761.07000000007,369021.8600000001
7378,U34250,172,1371.0300000000007,157,15,84074.36000000002,85445.39000000001
7379,U14963,172,-518549.98,157,15,575279.15,56729.17000000004
7380,U16722,172,-17510.180000000008,157,15,587977.02,570466.84
7381,U11658,172,-2992.540000000008,141,31,359238.29,356245.75
7382,U36013,172,-174506.92999999993,158,14,199481.71,24974.780000000057
7383,U35445,172,-4996.46,157,15,65983.25,60986.79
7384,U33101,172,-4779.279999999993,149,23,651675.6,646896.32
7385,U27456,172,-7744.990000000007,153,19,136610.09999999998,128865.10999999997
7386,U29392,172,-34280.49,130,42,256173.63999999998,221893.15
7387,U17765,172,-3994.9799999999977,166,6,31939.220000000012,27944.240000000013
7388,U27268,172,-16527.069999999992,140,32,373823.14,357296.07
7389,U1366287,172,-69286.84,127,45,242548.32,173261.48
7390,U12936,172,1344.4599999999955,106,66,409620.25,410964.71
7391,U13174,172,3811.459999999992,152,20,96147.58999999998,99959.04999999997
7392,U42599,172,-14854.989999999994,141,31,235681.90999999995,220826.91999999995
7393,U25695,172,307982.0399999999,153,19,1043948.3699999999,1351930.4099999997
7394,U21190,172,173887.94000000012,121,51,602704.2300000003,776592.1700000004
7395,U10005,172,124728.76000000011,150,22,297799.2099999999,422527.97000000003
7396,U40448,172,-1939.3400000000183,139,33,1197461.4600000002,1195522.12
7397,U37847,172,-1816.8499999999904,131,41,467529.07,465712.22000000003
7398,U41719,172,516.610000000043,145,27,181504.44,182021.05000000005
7399,U12290,172,-2635.4099999999985,154,18,68001.86,65366.450000000004
7400,U15058,172,1096348.8099999994,143,29,2975568.9399999995,4071917.749999999
7401,U13929,172,-10277.860000000006,127,45,164130.0700000001,153852.21000000008
7402,U25249,172,-62193.97999999999,166,6,102634.52999999998,40440.549999999996
7403,U42309,172,26817.339999999997,156,16,69138.55000000002,95955.89000000001
7404,U9707,172,-98777.46999999987,120,52,1895664.18,1796886.71
7405,U8547,172,2367.999999999912,149,23,1229800.2399999998,1232168.2399999998
7406,U22731,172,-50618.770000000004,160,12,75818.43,25199.65999999999
7407,U38661,172,-95493.93,157,15,209795.84999999998,114301.91999999998
7408,U14019,172,-123453.04999999994,148,24,223593.88000000003,100140.83000000009
7409,U23800,172,-50741.94,125,47,709402.85,658660.9099999999
7410,U42351,172,-1569.6599999999999,146,26,9584.819999999998,8015.159999999998
7411,U40204,172,18832.740000000005,154,18,150578.2,169410.94
7412,U20512,172,-4788.790000000001,144,28,80348.50999999997,75559.71999999997
7413,U18972,172,-6468.900000000016,149,23,129923.62,123454.71999999997
7414,U40954,172,10181.059999999994,92,80,197500.0,207681.06
7415,U37231,172,-2291.360000000002,158,14,48539.44999999998,46248.08999999998
7416,U39733,172,5219.749999999994,149,23,257648.73999999996,262868.48999999993
7417,U21615,172,-21909.800000000032,107,65,806997.9199999999,785088.1199999999
7418,U39068,172,224669.77000000008,154,18,283394.7399999999,508064.50999999995
7419,U13349,172,-4626.900000000002,154,18,81248.20999999999,76621.30999999998
7420,U29157,172,-45784.12999999996,158,14,168645.9,122861.77000000003
7421,U9265,172,92176.40999999999,112,60,229661.59,321838.0
7422,U36140,172,5771.09,154,18,19909.09,25680.18
7423,U43483,172,-11180.319999999998,128,44,89457.47000000002,78277.15000000002
7424,U14974,172,-184861.42999999996,141,31,764909.0099999999,580047.58
7425,U41342,172,-1206.9199999999905,150,22,107263.27,106056.35000000002
7426,U17694,172,1086.8499999999995,158,14,32019.699999999997,33106.549999999996
7427,U873931,172,4702.730000000001,96,76,153846.34,158549.07
7428,U17512,172,-5437.819999999989,149,23,153232.86999999997,147795.05
7429,U22282,172,1690.8000000000036,114,58,25389.670000000002,27080.470000000005
7430,U33064,172,9856.029999999999,153,19,30502.649999999994,40358.67999999999
7431,U35941,172,-42639.75000000001,79,93,755631.8,712992.05
7432,U759291,172,-224783.78999999998,101,71,780141.2,555357.4099999999
7433,U27262,171,15142.950000000077,124,47,244704.18,259847.13000000006
7434,U17578,171,65910.46999999994,142,29,649471.73,715382.2
7435,U32373,171,34034.34,114,57,463691.04,497725.38
7436,U31968,171,-10945.429999999998,160,11,37288.83000000002,26343.400000000023
7437,U22662,171,11741.029999999997,159,12,196844.13,208585.16
7438,U25055,171,19626.860000000004,151,20,129576.72,149203.58000000002
7439,U23081,171,-36408.66,161,10,111713.66999999998,75305.00999999998
7440,U37890,171,-10015.85,156,15,46946.08,36930.23
7441,U32817,171,-3512.279999999999,143,28,252521.55,249009.27
7442,U27421,171,1044.6599999999987,164,7,3629.6400000000012,4674.3
7443,U9942,171,39155.99,149,22,51689.229999999996,90845.22
7444,U16149,171,-166771.49000000002,131,40,1947817.4899999998,1781045.9999999998
7445,U38437,171,-173282.7099999999,161,10,578031.0900000003,404748.3800000004
7446,U10211,171,-89811.42999999996,112,59,787828.9499999998,698017.5199999999
7447,U17755,171,-577.0299999999993,150,21,21167.399999999998,20590.37
7448,U20560,171,5717.720000000001,116,55,955300.5,961018.22
7449,U1063206,171,-1.6199999999952692,169,2,3619.649999999983,3618.0299999999875
7450,U578430,171,-4061.8899999999994,120,51,69423.74999999999,65361.859999999986
7451,U14768,171,-5210.059999999992,158,13,71019.13999999998,65809.07999999999
7452,U16408,171,573734.1199999999,160,11,86315.21,660049.3299999998
7453,U37626,171,-11.429999999996653,163,8,31645.190000000017,31633.76000000002
7454,U38037,171,-13020.589999999995,123,48,58917.1,45896.51
7455,U41808,171,-17925.810000000143,119,52,1156150.0700000005,1138224.2600000005
7456,U40098,171,-15558.71000000035,151,20,11367399.2,11351840.489999998
7457,U22194,171,-12.919999999998538,147,24,50291.88999999999,50278.969999999994
7458,U16842,171,666.2700000000067,138,33,2446072.72,2446738.99
7459,U34730,171,-13866.110000000006,115,56,198762.23,184896.12
7460,U10965,171,28017.370000000006,128,43,1347260.64,1375278.01
7461,U34983,171,-25543.219999999994,144,27,89340.52000000002,63797.300000000025
7462,U38207,171,10870.019999999959,153,18,297940.0500000001,308810.07000000007
7463,U35557,171,35434.85000000002,163,8,175472.33,210907.18
7464,U11163,171,-7219.040000000008,120,51,267925.51,260706.47
7465,U39610,171,-13500.130000000003,161,10,63042.99,49542.85999999999
7466,U27677,171,-3789.259999999997,158,13,43936.020000000004,40146.76000000001
7467,U43707,171,18833.48,139,32,268525.6599999999,287359.1399999999
7468,U35435,171,-5973.030000000007,110,61,226964.43,220991.4
7469,U23522,171,-62173.020000000135,155,16,6537515.15,6475342.13
7470,U36317,171,13884.530000000002,101,70,221572.60999999996,235457.13999999996
7471,U37069,171,-3885.40999999999,141,30,463802.59,459917.18000000005
7472,U39547,171,-176483.86999999994,122,49,942241.0,765757.1300000001
7473,U22668,171,3705.9900000000075,146,25,43223.13000000003,46929.12000000003
7474,U17125,171,-7161.180000000013,143,28,114665.85999999999,107504.67999999998
7475,U37604,171,9307.82,162,9,33785.69,43093.51
7476,U43075,171,-7281.409999999994,140,31,115674.38000000002,108392.97000000003
7477,U22816,171,-11355.040000000023,138,33,1917634.31,1906279.27
7478,U13878,171,2260.46,155,16,283499.63,285760.09
7479,U14519,171,13113.969999999974,127,44,692003.5800000001,705117.55
7480,U36163,171,-65075.33000000003,152,19,1285003.0900000003,1219927.7600000002
7481,U27400,171,3521.180000000004,146,25,70513.62000000001,74034.80000000002
7482,U15929,171,-63308.200000000004,149,22,467327.51999999996,404019.31999999995
7483,U20185,171,-9514.849999999875,114,57,1402500.87,1392986.0200000003
7484,U39525,171,6851.809999999983,131,40,299920.07,306771.88
7485,U30862,171,445.500000000005,122,49,477239.20000000007,477684.70000000007
7486,U42947,171,133778.68000000002,126,45,491794.13,625572.81
7487,U12768,171,2594.5299999999943,129,42,46012.60000000001,48607.130000000005
7488,U15931,171,10533.420000000042,116,55,9285716.07,9296249.49
7489,U42787,171,-14909.740000000003,156,15,283957.47000000003,269047.73000000004
7490,U44013,171,836.5299999999988,153,18,83370.45,84206.98
7491,U15714,171,-15662.65000000001,101,70,627204.5000000001,611541.8500000001
7492,U16715,171,15975.710000000008,152,19,146501.54,162477.25000000003
7493,U40361,171,-2087.429999999999,166,5,23122.750000000007,21035.320000000007
7494,U15025,171,-5053.359999999997,119,52,184276.13000000003,179222.77000000005
7495,U38527,171,462684.6099999998,139,32,1908675.2799999996,2371359.889999999
7496,U31377,171,-7622.960000000001,166,5,13944.039999999997,6321.079999999996
7497,U17426,171,-24630.23999999893,136,35,11494498.630000006,11469868.390000008
7498,U28415,171,34320.54000000014,88,83,1053448.56,1087769.1
7499,U40185,171,198762.15999999992,96,75,1777872.8100000003,1976634.9700000002
7500,U984365,170,16.61,88,82,128722.0,128738.61
7501,U800635,170,-5.649999999997817,130,40,442746.51,442740.86
7502,U21807,170,24140.939999999897,133,37,3285927.149999998,3310068.089999998
7503,U27131,170,-45058.70000000001,143,27,417476.17999999993,372417.4799999999
7504,U16566,170,-22172.730000000087,132,38,833211.55,811038.82
7505,U34928,170,-8670.270000000011,149,21,139098.71000000002,130428.44
7506,U14168,170,-36390.32999999999,111,59,534161.6000000001,497771.27000000014
7507,U10593,170,4584.750000000029,133,37,1176581.09,1181165.84
7508,U21265,170,-17486.70000000001,142,28,50146.22,32659.51999999999
7509,U25095,170,-450123.73,145,25,1113497.1999999997,663373.4699999997
7510,U31582,170,106384.77999999998,138,32,1052508.3000000003,1158893.0800000003
7511,U26030,170,-45744.920000000006,159,11,50125.27,4380.349999999991
7512,U12940,170,14486.34000000001,155,15,26985.359999999997,41471.700000000004
7513,U36824,170,7233.69000000001,164,6,134777.73,142011.42
7514,U27718,170,-14331.819999999998,154,16,64071.369999999995,49739.549999999996
7515,U1148440,170,26.679999999999936,104,66,411.27000000000004,437.95
7516,U36373,170,-9645.990000000005,154,16,743983.8699999994,734337.8799999994
7517,U30259,170,1952.1500000000215,133,37,165097.96000000005,167050.11000000007
7518,U18667,170,-715.7700000000023,145,25,151832.19,151116.42
7519,U19627,170,-19494.139999999992,113,57,770914.2,751420.0599999999
7520,U41941,170,-1620.4200000000023,127,43,20272.089999999982,18651.66999999998
7521,U43140,170,3685.0999999999767,156,14,573484.34,577169.44
7522,U23949,170,47998.16999999989,123,47,1728850.7799999998,1776848.9499999997
7523,U30036,170,7331.810000000005,101,69,18120.1,25451.910000000003
7524,U19934,170,33438.34000000003,93,77,951976.95,985415.29
7525,U25753,170,24864.20000000001,70,100,421288.98,446153.18
7526,U42114,170,-16666.57,149,21,243256.95999999993,226590.38999999993
7527,U27723,170,-3231.689999999999,157,13,32690.910000000007,29459.22000000001
7528,U12508,170,-118179.01,139,31,365471.39999999997,247292.38999999996
7529,U15246,170,-2314.659999999996,137,33,508835.88,506521.22000000003
7530,U20840,170,-8982.459999999995,112,58,231804.10000000003,222821.64000000004
7531,U39822,170,-2263.649999999998,135,35,225971.93999999992,223708.28999999992
7532,U29662,170,-127697.40000000002,143,27,1564279.4699999997,1436582.0699999998
7533,U37513,170,4776.980000000007,142,28,468340.3600000002,473117.3400000002
7534,U35575,170,16923.40000000001,143,27,156426.09,173349.49
7535,U32046,170,-34358.950000000026,125,45,1531207.3399999999,1496848.39
7536,U42059,170,-21515.560000000027,146,24,564772.49,543256.9299999999
7537,U24538,170,22582.30000000001,112,58,427210.57999999996,449792.87999999995
7538,U22622,170,-4652.240000000023,157,13,337325.72000000003,332673.48
7539,U33708,170,19299.62000000003,85,85,189205.82999999996,208505.44999999998
7540,U42144,170,3671.250000000001,152,18,13922.150000000001,17593.4
7541,U8501,170,4873.880000000005,144,26,61450.229999999996,66324.11
7542,U19535,170,680.8299999999581,148,22,416880.4,417561.23
7543,U39640,170,-9094.760000000002,144,26,488608.51000000007,479513.75000000006
7544,U31229,170,-5154.239999999993,153,17,242509.3,237355.06
7545,U31700,170,12001.399999999989,167,3,68905.29000000004,80906.69000000003
7546,U17130,170,51165.74999999994,135,35,643164.99,694330.74
7547,U9361,170,-30843.679999999957,138,32,454785.9800000001,423942.30000000016
7548,U1315146,170,504.7800000000001,113,57,13778.869999999999,14283.65
7549,U41831,170,-502500.3800000002,127,43,3792976.2799999993,3290475.899999999
7550,U41810,170,7149.689999999996,129,41,59279.05000000001,66428.74
7551,U10107,170,-12192.829999999996,148,22,458927.08000000013,446734.2500000001
7552,U27252,170,9211.519999999997,134,36,198499.05,207710.56999999998
7553,U23861,170,-463312.0799999996,58,112,2981647.07,2518334.99
7554,U39356,170,-16894.74,140,30,266691.73,249796.99
7555,U12890,170,25584.659999999898,160,10,13889.989999999972,39474.64999999987
7556,U33313,170,-9063.88,149,21,38888.69,29824.810000000005
7557,U16495,170,1386.3699999999808,157,13,228378.35000000003,229764.72000000003
7558,U24892,170,-32320.700000000008,154,16,3323066.0499999993,3290745.349999999
7559,U14638,170,-198331.45999999993,151,19,304897.38,106565.92000000007
7560,U8492,170,-31599.46000000003,156,14,218434.32,186834.86
7561,U10658,169,11111.620000000024,155,14,729941.4900000002,741053.1100000002
7562,U41932,169,1831.0600000000086,72,97,1830770.95,1832602.01
7563,U29453,169,443.45999999999987,145,24,3576.52,4019.98
7564,U966360,169,-4427.539999999994,115,54,149605.72999999995,145178.18999999994
7565,U14407,169,55154.08999999996,148,21,343304.60000000003,398458.69
7566,U15664,169,-76634.28000000003,165,4,77858.40000000002,1224.1199999999953
7567,U15029,169,19480.75000000005,111,58,832220.65,851701.4
7568,U34540,169,-12442.27,140,29,76612.49,64170.22
7569,U24978,169,-9047.75,160,9,29868.91,20821.16
7570,U9363,169,-46015.83000000001,123,46,603055.16,557039.3300000001
7571,U12204,169,-2145.600000000002,156,13,41761.36,39615.759999999995
7572,U15008,169,218231.43999999997,134,35,214447.98,432679.42
7573,U39626,169,22688.759999999995,151,18,37983.060000000005,60671.82
7574,U37684,169,-856.3799999999983,159,10,28816.839999999997,27960.46
7575,U12820,169,-10619.87,159,10,79576.87000000002,68957.00000000003
7576,U37058,169,139199.53000000003,150,19,127899.16,267098.69000000006
7577,U21089,169,4216.359999999957,139,30,265924.94999999995,270141.30999999994
7578,U23160,169,30020.580000000013,151,18,246627.03999999995,276647.61999999994
7579,U15034,169,-87600.06,159,10,202469.61,114869.54999999999
7580,U43960,169,8064.440000000004,158,11,53011.29999999999,61075.73999999999
7581,U41395,169,5370.959999999998,157,12,91346.04999999999,96717.00999999998
7582,U42898,169,-19545.449999999997,146,23,37664.4,18118.950000000004
7583,U36527,169,44484.98999999997,99,70,624473.0899999997,668958.0799999997
7584,U14997,169,-32578.940000000006,148,21,110957.94,78379.0
7585,U22575,169,-11836.9,126,43,153766.65,141929.75
7586,U13285,169,-270858.6099999999,154,15,606440.98,335582.37000000005
7587,U32476,169,-37797.47,120,49,228845.1,191047.63
7588,U9842,169,230854.73999999996,139,30,202766.05000000005,433620.79000000004
7589,U14203,169,-8195.189999999999,137,32,87015.75999999998,78820.56999999998
7590,U28129,169,2384.4299999999967,152,17,129899.09000000003,132283.52000000002
7591,U28654,169,-44241.11,143,26,109961.85,65720.74
7592,U37633,169,-26293.840000000084,114,55,2094562.8199999998,2068268.9799999997
7593,U31717,169,-1102.0699999995804,122,47,4901571.1899999995,4900469.12
7594,U16851,169,-38084.88000000003,148,21,770714.8200000002,732629.9400000002
7595,U17456,169,-14482.849999999973,156,13,152015.2,137532.35000000003
7596,U8660,169,-31524.720000000245,158,11,1735777.4800000002,1704252.76
7597,U15668,169,4811897.000000001,136,33,4914290.88,9726187.88
7598,U27874,169,-19400.21999999999,160,9,325269.3399999999,305869.11999999994
7599,U18123,169,27868.67,160,9,22407.809999999998,50276.479999999996
7600,U11646,169,-70147.5,139,30,877024.03,806876.53
7601,U29146,169,-9810.679999999995,135,34,104033.98000000001,94223.30000000002
7602,U26210,169,-4937.12,135,34,1066066.84,1061129.72
7603,U24591,169,7465.060000000003,133,36,705654.24,713119.3
7604,U8686,169,27985.379999999946,132,37,1727868.2699999998,1755853.6499999997
7605,U17434,169,15432.69999999996,145,24,301434.1599999999,316866.85999999987
7606,U15880,169,441082.93000000005,101,68,802191.7999999997,1243274.7299999997
7607,U37095,169,-59.06999999995605,126,43,381788.91000000003,381729.8400000001
7608,U32844,169,2019.1399999999903,116,53,409092.71,411111.85000000003
7609,U30837,169,-134.31999999999243,119,50,166010.78999999998,165876.46999999997
7610,U40202,169,-4468.440000000002,149,20,44261.04999999999,39792.609999999986
7611,U24284,169,-3170.179999999999,147,22,24634.67,21464.489999999998
7612,U26357,169,-121394.79000000002,135,34,572493.4199999999,451098.6299999999
7613,U1191648,169,222.64000000000868,106,63,201677.96000000002,201900.60000000003
7614,U18442,169,-4117.479999999993,153,16,42557.330000000016,38439.85000000002
7615,U20808,169,-9930.17999999998,136,33,309157.80999999994,299227.62999999995
7616,U30719,169,63328.97000000003,95,74,174610.97000000003,237939.94000000006
7617,U14050,169,-23798.77000000001,130,39,344585.75,320786.98
7618,U35823,169,1813.1500000000021,140,29,28587.069999999996,30400.219999999998
7619,U18023,169,-23433.240000000005,129,40,131100.13,107666.89
7620,U20398,169,385.67000000000087,135,34,38456.880000000005,38842.55
7621,U29179,169,12846.239999999985,131,38,546045.64,558891.88
7622,U15945,169,3990.179999999964,114,55,455593.9199999998,459584.09999999974
7623,U27476,169,-65084.45999999999,148,21,85475.95999999999,20391.5
7624,U21440,169,-12127.150000000001,154,15,59647.90999999999,47520.75999999999
7625,U37962,169,163238.68000000008,135,34,1009846.5399999998,1173085.22
7626,U39019,169,-129050.48000000021,134,35,6520199.0,6391148.52
7627,U12357,169,-83289.69,163,6,221799.55,138509.86
7628,U15803,169,-374482.7200000001,151,18,1378917.2700000003,1004434.5500000002
7629,U13025,168,-14868.24999999997,144,24,648550.2999999999,633682.0499999999
7630,U15863,168,-513.6399999999937,141,27,105180.19,104666.55
7631,U41652,168,-741.6800000000014,161,7,45036.65,44294.97
7632,U43127,168,4120.549999999996,138,30,113694.01000000002,117814.56000000003
7633,U40882,168,9366.810000000009,156,12,37799.25,47166.06000000001
7634,U43780,168,-3885.149999999999,159,9,11594.22,7709.07
7635,U14080,168,-20780.17999999999,132,36,269023.33999999997,248243.15999999997
7636,U35041,168,336105.9399999999,87,81,1507990.9000000001,1844096.84
7637,U838164,168,-935.2800000000007,148,20,15790.169999999996,14854.889999999996
7638,U25787,168,18261.890000000385,132,36,3551108.44,3569370.3300000005
7639,U27514,168,-22197.709999999992,126,42,416278.9,394081.19000000006
7640,U42160,168,-6647.229999999986,150,18,450409.38000000006,443762.1500000001
7641,U36375,168,-54093.29,148,20,124127.40999999995,70034.11999999994
7642,U30099,168,775.3700000000009,152,16,21894.239999999998,22669.61
7643,U11242,168,-10417.370000000083,150,18,499181.5,488764.1299999999
7644,U17944,168,-1787.1200000000026,152,16,16049.939999999993,14262.81999999999
7645,U31696,168,207387.51000000004,149,19,153841.38000000003,361228.8900000001
7646,U16200,168,-2631.999999999998,128,40,43763.110000000015,41131.110000000015
7647,U33324,168,-1102.9300000000017,149,19,41599.46000000001,40496.530000000006
7648,U43709,168,-13113.779999999997,139,29,150278.42999999996,137164.64999999997
7649,U37539,168,251.44999999999928,151,17,27477.52999999999,27728.979999999992
7650,U39650,168,-43905.770000000004,156,12,142478.25000000003,98572.48000000003
7651,U10899,168,-22717.70000000004,97,71,655341.3600000002,632623.6600000001
7652,U20616,168,-17478.50000000001,147,21,318797.9699999999,301319.4699999999
7653,U16382,168,70115.34,149,19,199786.80999999994,269902.1499999999
7654,U34430,168,-14467.679999999993,145,23,124671.66,110203.98000000001
7655,U36907,168,-2537.019999999996,161,7,53440.07999999999,50903.05999999999
7656,U1237129,168,-2432.749999999999,131,37,8258.81,5826.06
7657,U27664,168,105524.06999999999,147,21,132081.93000000002,237606.0
7658,U36579,168,-1922.7100000000028,137,31,62675.95,60753.23999999999
7659,U39063,168,-4279.859999999997,146,22,79565.03999999998,75285.17999999998
7660,U26543,168,1044.1899999999996,153,15,57062.18999999999,58106.37999999999
7661,U8390,168,-8310.720000000547,127,41,1653756.8000000005,1645446.08
7662,U39608,168,6190.220000000007,160,8,25063.79,31254.01000000001
7663,U11232,168,-856.2499999999851,96,72,329776.54999999993,328920.29999999993
7664,U8067,168,-3971.1300000000037,154,14,41373.30000000006,37402.17000000006
7665,U21061,168,-381161.31999999995,150,18,451035.69,69874.37000000005
7666,U17153,168,122345.23999999894,110,58,5629354.499999997,5751699.7399999965
7667,U39322,168,-4681.879999999999,155,13,33202.44,28520.560000000005
7668,U8508,168,-75175.07000000002,144,24,688179.57,613004.4999999999
7669,U21127,168,42798.01999999998,145,23,165764.81000000006,208562.83000000005
7670,U27091,168,10198.669999999993,136,32,167354.65,177553.31999999998
7671,U16040,168,-509722.72000000003,138,30,1448509.91,938787.19
7672,U26008,168,31819.940000000002,120,48,391813.58,423633.52
7673,U34571,168,4485.969999999998,147,21,70335.09,74821.06
7674,U20195,168,-19245.37999999999,155,13,24626.09,5380.71000000001
7675,U23261,168,174350.2299999999,128,40,1000772.1500000003,1175122.3800000001
7676,U11519,168,-19.76999999999549,114,54,137237.95,137218.18000000002
7677,U19985,168,-2872.819999999999,157,11,19732.32,16859.5
7678,U40652,168,-28716.66000000004,130,38,775965.7700000001,747249.1100000001
7679,U8610,168,-31498.990000000224,131,37,5647737.3,5616238.31
7680,U19961,168,-20730.79999999999,142,26,379378.73000000004,358647.93000000005
7681,U9689,168,-141215.07000000033,134,34,1664723.6400000001,1523508.5699999998
7682,U12943,168,2897.219999999997,110,58,59329.7,62226.91999999999
7683,U13786,168,18388.9,157,11,66641.44,85030.34
7684,U39912,168,-52820.96999999999,160,8,91595.64999999998,38774.67999999999
7685,U36641,168,-4561.820000000003,159,9,26363.23,21801.409999999996
7686,U41585,168,-1357141.140000001,138,30,2869697.2699999986,1512556.1299999976
7687,U40600,168,-5256.489999999998,156,12,234338.40999999997,229081.91999999998
7688,U41915,168,-3622.1300000000047,141,27,633675.66,630053.53
7689,U9826,168,9409.790000000005,155,13,35261.09999999999,44670.89
7690,U41862,168,-86631.52999999997,143,25,379936.3200000001,293304.79000000015
7691,U35084,168,-914.1199999999994,153,15,34387.34,33473.219999999994
7692,U15068,168,-3949.2399999999775,117,51,181980.56,178031.32
7693,U32900,167,189.89000000000146,157,10,30386.909999999996,30576.8
7694,U676280,167,-21022.699999999997,156,11,54026.350000000006,33003.65000000001
7695,U19736,167,2323.159999999996,122,45,410593.47,412916.62999999995
7696,U12992,167,-10628.739999999998,124,43,98039.38,87410.64000000001
7697,U12026,167,-19335.239999999994,94,73,204706.20999999993,185370.96999999994
7698,U34069,167,-118965.51999999999,151,16,159162.14,40196.620000000024
7699,U24331,167,8525.129999999994,144,23,172801.1199999998,181326.2499999998
7700,U11547,167,-2588.0200000000186,147,20,347896.74,345308.72
7701,U36230,167,22343.789999999994,118,49,425779.93,448123.72
7702,U30301,167,207160.36000000002,156,11,56952.400000000016,264112.76
7703,U26484,167,-113165.7900000001,146,21,990487.29,877321.5
7704,U37653,167,-14205.030000000008,145,22,137062.13999999996,122857.10999999994
7705,U28373,167,6866.290000000003,154,13,25616.059999999994,32482.35
7706,U26961,167,-23804.30999999994,146,21,559632.9400000001,535828.6300000001
7707,U12178,167,-4046.6600000000003,126,41,173872.40999999995,169825.74999999994
7708,U14674,167,-2193.259999999998,153,14,40828.85000000002,38635.590000000026
7709,U30676,167,-7993.0,162,5,8718.29,725.2900000000009
7710,U31752,167,19522.22999999998,130,37,450711.93,470234.16
7711,U23221,167,16310.899999999987,150,17,336455.7600000002,352766.66000000015
7712,U41889,167,-7264.749999999992,156,11,94710.84999999999,87446.1
7713,U12038,167,-161241.36999999994,134,33,696783.82,535542.45
7714,U11384,167,-1288.5800000000036,158,9,79587.02999999998,78298.44999999998
7715,U11935,167,29446.09000000001,142,25,358195.29,387641.38
7716,U16414,167,17279.510000000002,145,22,117489.55999999994,134769.06999999995
7717,U11120,167,-1410.920000000002,139,28,280409.08999999997,278998.17
7718,U42876,167,-1725.8700000000017,138,29,82487.58000000002,80761.71000000002
7719,U8288,167,-508.6999999999989,157,10,37244.49999999999,36735.799999999996
7720,U12113,167,1995.9399999999978,145,22,81004.00000000001,82999.94000000002
7721,U33259,167,221.05,154,13,21416.369999999977,21637.419999999976
7722,U38514,167,4039.889999999996,154,13,224427.85,228467.74
7723,U12082,167,-4148.669999999984,150,17,269085.39,264936.72000000003
7724,U17205,167,-32726.35999999997,149,18,322659.79999999993,289933.43999999994
7725,U40187,167,-18627.17000000001,147,20,663129.19,644502.0199999999
7726,U27059,167,-39285.43,148,19,75614.45999999999,36329.02999999999
7727,U25777,167,82848.56,145,22,166534.63999999998,249383.19999999998
7728,U15752,167,11258.600000000013,150,17,480759.6999999999,492018.29999999993
7729,U15214,167,-1345746.4199999997,128,39,3617510.13,2271763.71
7730,U29340,167,-4320.190000000002,135,32,88809.95999999999,84489.76999999999
7731,U878362,167,-101.88000000000466,122,45,165086.21999999994,164984.33999999994
7732,U12235,167,-1039.2499999999964,139,28,370340.77,369301.52
7733,U43202,167,3930.1100000000015,156,11,29126.170000000002,33056.280000000006
7734,U35288,167,-7033.62999999999,140,27,103737.82,96704.19000000002
7735,U16140,167,73824.12,130,37,138101.59,211925.71
7736,U15649,167,21349.299999999894,110,57,8741824.13,8763173.430000002
7737,U15295,167,-4225.809999999954,133,34,261901.56,257675.75000000006
7738,U32993,167,-54041.090000000004,150,17,135011.71,80970.62
7739,U20460,167,-4888.410000000002,151,16,43671.44,38783.03
7740,U38114,167,59810.840000000026,106,61,1099477.2999999998,1159288.14
7741,U35180,167,5046.760000000024,153,14,273912.78,278959.54000000004
7742,U40565,167,-2521.4999999999973,146,21,15755.53,13234.030000000002
7743,U29021,167,963.8999999999972,151,16,102387.83000000038,103351.73000000037
7744,U12682,167,-49281.56,144,23,247905.75999999998,198624.19999999998
7745,U32875,167,-668.76,141,26,15164.509999999998,14495.749999999998
7746,U26239,167,652.4200000000011,161,6,29122.64,29775.06
7747,U43456,167,-2147.1300000000024,157,10,40558.36999999993,38411.239999999925
7748,U23574,167,206005.38000000018,157,10,220213.5399999998,426218.92
7749,U37460,167,99880.75999999997,156,11,47799.58000000001,147680.33999999997
7750,U32792,167,542165.5700000002,153,14,673713.53,1215879.1
7751,U23532,167,42245.37999999998,155,12,96133.52999999998,138378.90999999997
7752,U29563,167,6960.420000000005,157,10,16607.70999999999,23568.129999999994
7753,U18128,167,-210.2000000000262,113,54,427266.32,427056.12
7754,U22852,167,63585.729999999974,137,30,1137986.07,1201571.8
7755,U22984,167,-15015.610000000013,106,61,444276.87,429261.26
7756,U33601,167,13272.960000000021,99,68,1223763.18,1237036.14
7757,U32133,167,-938.6800000000001,150,17,54037.55,53098.87
7758,U16472,167,-508542.26999999996,154,13,637471.7300000004,128929.46000000049
7759,U757144,167,-6960.449999999999,132,35,42808.39,35847.94
7760,U17386,167,51560.35999999996,131,36,406108.45999999996,457668.81999999995
7761,U14046,167,-1054.800000000003,153,14,36897.01,35842.21
7762,U26061,167,-11716.989999999976,104,63,459994.33,448277.34
7763,U13510,167,131180.35,128,39,1598209.6300000001,1729389.9800000002
7764,U1243612,166,-3542.499999999998,140,26,110487.87,106945.37
7765,U14043,166,-2484.470000000014,134,32,910697.1300000006,908212.6600000006
7766,U29974,166,12935.200000000003,141,25,86711.49999999999,99646.69999999998
7767,U11714,166,-329.0399999999894,121,45,214263.01999999996,213933.97999999998
7768,U41493,166,-2044.9000000000028,148,18,144670.50000000003,142625.60000000003
7769,U36179,166,-57.36000000000786,144,22,96428.97000000002,96371.61000000002
7770,U35292,166,-131228.41000000003,143,23,537831.4,406602.99
7771,U8430,166,-4291.519999999993,155,11,42975.03,38683.51000000001
7772,U18642,166,-13.459999999999127,113,53,262149.54,262136.08
7773,U14291,166,-48555.39999999997,138,28,584513.4699999997,535958.0699999997
7774,U15365,166,-191578.4200000002,126,40,3445480.610000001,3253902.1900000004
7775,U11632,166,133450.11,124,42,270781.24999999994,404231.3599999999
7776,U30592,166,66.3000000000009,147,19,12746.339999999997,12812.639999999998
7777,U20798,166,18800.350000000006,146,20,87109.36999999998,105909.71999999999
7778,U24839,166,-13618.319999999996,65,101,307168.85000000003,293550.53
7779,U25802,166,8449.700000000003,156,10,35127.86999999999,43577.56999999999
7780,U34309,166,49256.21000000001,159,7,61168.48999999999,110424.7
7781,U19134,166,10539.579999999994,137,29,578848.5700000001,589388.15
7782,U11182,166,-14232.059999999996,126,40,753994.2100000003,739762.1500000004
7783,U29256,166,28108.28999999998,116,50,629580.4,657688.69
7784,U801959,166,1542.0000000000082,89,77,72873.85000000002,74415.85000000003
7785,U31632,166,-0.4900000001147191,78,88,2765273.0,2765272.51
7786,U12696,166,4716.699999999953,142,24,252660.26999999993,257376.96999999988
7787,U33575,166,30782.960000000014,138,28,257705.17999999996,288488.13999999996
7788,U13528,166,14852.05000000001,117,49,8500851.919999998,8515703.969999999
7789,U15314,166,62684.66999999991,94,72,1697860.4100000001,1760545.08
7790,U26897,166,-214021.31000000006,139,27,1371653.0099999995,1157631.6999999995
7791,U38075,166,-26784.799999999985,127,39,231277.57999999996,204492.77999999997
7792,U10796,166,2186.570000000001,158,8,56919.93999999997,59106.50999999997
7793,U31669,166,-14080.039999999997,130,36,162178.03000000006,148097.99000000005
7794,U36205,166,-95459.73999999999,148,18,113386.74999999999,17927.009999999995
7795,U13401,166,-1000.0700000000038,139,27,231730.57,230730.5
7796,U39976,166,-25005.479999999996,150,16,100104.01999999999,75098.54
7797,U41546,166,474.47000000000116,150,16,371134.19000000006,371608.66000000003
7798,U24695,166,85808.68,139,27,373035.39,458844.07
7799,U15016,166,-5628.330000000003,133,33,140397.28999999998,134768.95999999996
7800,U18341,166,-22462.119999999937,117,49,705964.09,683501.97
7801,U31018,166,-9102.949999999997,141,25,225053.08,215950.13
7802,U33453,166,-79363.56,148,18,97403.13999999998,18039.579999999987
7803,U14360,166,49806.769999999866,140,26,1882912.96,1932719.7299999997
7804,U16785,166,127941.33999999994,150,16,603360.5399999999,731301.8799999999
7805,U28448,166,7303.8499999999985,140,26,56106.14000000003,63409.99000000003
7806,U24854,166,7014.97999999996,140,26,265224.58999999997,272239.56999999995
7807,U16494,166,6518.950000000024,146,20,928283.6,934802.55
7808,U14103,166,-122.67999999999756,146,20,94068.02999999998,93945.34999999999
7809,U19525,166,-6531.8299999999945,101,65,351970.8800000004,345439.0500000004
7810,U9252,166,-17656.279999999995,161,5,61079.3,43423.020000000004
7811,U25046,166,6525.620000000013,109,57,290641.45999999996,297167.07999999996
7812,U33545,166,177837.96000000002,154,12,26756.729999999996,204594.69
7813,U23235,166,19164.229999999992,149,17,61109.87,80274.09999999999
7814,U21908,166,13624.609999999999,157,9,140621.47999999998,154246.08999999997
7815,U10820,166,-155255.33000000025,114,52,4331765.879999999,4176510.549999999
7816,U21501,166,-1702.2000000000191,135,31,285016.3299999999,283314.1299999999
7817,U16369,166,-213586.34000000005,127,39,3848105.6299999985,3634519.2899999986
7818,U31369,166,1937.190000000003,122,44,104543.11999999997,106480.30999999997
7819,U36434,166,-23237.870000000003,140,26,128247.36000000002,105009.49000000002
7820,U41238,166,8730.189999999984,100,66,330180.1399999999,338910.3299999999
7821,U20655,166,-8197.149999999961,87,79,884324.6000000001,876127.4500000002
7822,U30119,165,-52031.74000000092,105,60,7027618.129999999,6975586.389999998
7823,U1090046,165,-0.009999999999934062,119,46,10356.91,10356.9
7824,U43311,165,3276.849999999999,151,14,36040.57000000001,39317.420000000006
7825,U35828,165,13573.730000000005,139,26,13931.359999999993,27505.089999999997
7826,U28334,165,30895.950000000004,150,15,71078.37,101974.32
7827,U17220,165,437.2900000000009,85,80,120125.22000000003,120562.51000000004
7828,U38600,165,-5375.66,156,9,17424.809999999998,12049.149999999998
7829,U28387,165,1816.6200000000072,142,23,166691.50999999995,168508.12999999995
7830,U21241,165,-19149.20000000001,136,29,537630.67,518481.47000000003
7831,U14958,165,118527.47,149,16,382797.6100000003,501325.0800000003
7832,U33683,165,31982.259999999995,146,19,86888.65,118870.90999999999
7833,U26499,165,-345601.56,135,30,504068.85,158467.28999999998
7834,U32243,165,-14883.289999999979,118,47,1487817.0699999998,1472933.7799999998
7835,U10396,165,1430.4299999999998,151,14,78685.55999999998,80115.98999999998
7836,U41118,165,-452.83999999999946,155,10,14600.150000000001,14147.310000000001
7837,U43214,165,3461.030000000001,153,12,21960.49,25421.520000000004
7838,U27379,165,-9088.179999999995,141,24,55549.26000000001,46461.080000000016
7839,U38872,165,12262.519999999971,97,68,372324.26,384586.77999999997
7840,U11263,165,-3302.02,147,18,153153.67,149851.65000000002
7841,U9013,165,44.94999999999891,155,10,15034.950000000003,15079.900000000001
7842,U22339,165,-8960.929999999862,132,33,1420195.4000000004,1411234.4700000004
7843,U17397,165,-212663.66999999998,122,43,2632549.54,2419885.87
7844,U26857,165,-1877.459999999998,157,8,36210.560000000005,34333.100000000006
7845,U10464,165,-101.31999999998698,88,77,605871.6900000001,605770.3700000001
7846,U37866,165,8171.150000000001,115,50,541615.83,549786.98
7847,U35553,165,730.6400000000037,132,33,419487.53,420218.17000000004
7848,U642630,165,-368.89999999999986,134,31,20404.05,20035.149999999998
7849,U13871,165,-3361.640000000026,148,17,1095403.5000000005,1092041.8600000003
7850,U14668,165,4292.180000000007,140,25,342134.76,346426.94
7851,U16426,165,-1852.8199999999795,137,28,526153.4599999996,524300.6399999997
7852,U8940,165,67555.46000000005,112,53,384587.5499999999,452143.0099999999
7853,U939983,165,-87.6899999999996,97,68,41126.51,41038.82
7854,U10839,165,9348.290000000008,153,12,111140.83000000003,120489.12000000004
7855,U38989,165,-2618.659999999983,149,16,1236030.9800000007,1233412.3200000008
7856,U27248,165,6186.969999999981,143,22,257437.22999999998,263624.19999999995
7857,U20963,165,6906.719999999968,123,42,701253.23,708159.95
7858,U18111,165,30081.860000000204,153,12,89472.58000000005,119554.44000000025
7859,U23117,165,26563.679999999993,148,17,16766.330000000005,43330.009999999995
7860,U9656,165,323827.29000000004,139,26,725577.2400000003,1049404.5300000003
7861,U9756,165,-147989.62,156,9,400272.26,252282.64
7862,U25019,165,-1035.909999999998,149,16,28782.319999999996,27746.409999999996
7863,U40146,165,-7688.040000000009,124,41,365191.79000000004,357503.75
7864,U13199,165,-26609.00999999995,87,78,1174778.9400000002,1148169.9300000002
7865,U26845,165,-15.149999999998897,143,22,78614.71,78599.56000000001
7866,U14492,165,13500.570000000007,110,55,1164337.5899999999,1177838.16
7867,U26422,165,-81676.88000000002,101,64,282746.38,201069.5
7868,U33108,165,37230.71,127,38,93602.98,130833.69
7869,U24834,165,-62246.59,138,27,235756.91000000006,173510.32000000007
7870,U20062,165,501732.85000000003,152,13,101025.61000000003,602758.4600000001
7871,U30589,165,-360.8900000000011,98,67,126887.77000000002,126526.88000000002
7872,U10586,165,1933.1599999999962,142,23,56798.35,58731.509999999995
7873,U14149,165,35205.299999999996,136,29,130867.9,166073.19999999998
7874,U12136,165,8727.050000000005,116,49,98895.13000000002,107622.18000000002
7875,U19936,165,-30735.600000000013,119,46,419840.7599999999,389105.15999999986
7876,U42655,165,-5353.049999999994,147,18,135742.3,130389.25
7877,U43411,165,-37124.17999999999,144,21,80166.70999999999,43042.53
7878,U1240240,165,-2.700000000000344,94,71,6136.6900000000005,6133.99
7879,U22460,165,-288.2900000000001,135,30,29502.37000000001,29214.08000000001
7880,U12198,165,-165616.25999999986,134,31,1851015.4899999998,1685399.23
7881,U33028,165,23891.019999999993,155,10,81504.09999999998,105395.11999999997
7882,U11648,165,-34339.53,151,14,87977.46,53637.93000000001
7883,U33694,165,-12958.649999999996,147,18,131127.88,118169.23000000001
7884,U43830,165,25559.85000000001,145,20,55149.67999999999,80709.53
7885,U21713,165,22659.35,114,51,260730.69999999998,283390.05
7886,U23458,165,-149183.72,157,8,151353.63,2169.9100000000035
7887,U31958,165,2312.2299999999937,150,15,160283.36000000002,162595.59
7888,U9478,165,1903.2299999999996,141,24,46167.02000000002,48070.250000000015
7889,U43155,165,91301.66999999998,115,50,14189.279999999999,105490.94999999998
7890,U31440,165,126463.24999999996,143,22,89064.9,215528.14999999997
7891,U18902,165,6363.049999999983,124,41,261873.7099999999,268236.7599999999
7892,U43041,165,23692.739999999998,133,32,100331.94000000002,124024.68000000002
7893,U22186,165,25390.23999999999,85,80,182919.5,208309.74
7894,U16999,165,87484.12999999998,128,37,134974.43000000002,222458.56
7895,U22246,165,-44447.309999999896,130,35,5600245.089999999,5555797.779999999
7896,U37583,165,12786.829999999996,108,57,270400.97000000003,283187.80000000005
7897,U19696,165,-16759.25000000001,150,15,165245.73999999996,148486.48999999996
7898,U10439,165,-9039.719999999998,148,17,178491.13,169451.41
7899,U35083,165,115001.31000000001,153,12,200113.75,315115.06
7900,U26270,165,3265.680000000013,136,29,423260.76,426526.44
7901,U36832,165,-3678.3899999999994,140,25,28586.510000000002,24908.120000000003
7902,U16393,165,-5646.580000000166,123,42,4114912.1100000003,4109265.5300000003
7903,U37027,165,-18924.31000000002,115,50,321139.69,302215.38
7904,U20213,165,-545706.0900000002,141,24,1378519.19,832813.0999999997
7905,U23406,164,-7883.880000000019,96,68,779969.9,772086.02
7906,U27325,164,39919.95000000006,114,50,1186933.34,1226853.29
7907,U26720,164,-75083.85000000003,117,47,1468347.8500000003,1393264.0000000002
7908,U26179,164,11898.030000000002,155,9,115604.66999999997,127502.69999999997
7909,U34287,164,8819.679999999973,138,26,93552.20000000001,102371.87999999999
7910,U36992,164,9285.609999999997,134,30,171675.12999999998,180960.73999999996
7911,U32509,164,1844.0100000000093,124,40,523457.57999999996,525301.59
7912,U34895,164,3107.110000000001,113,51,58777.03,61884.14
7913,U33817,164,-6685.8099999999995,124,40,205781.05000000005,199095.24000000005
7914,U33441,164,-373.26000000000386,146,18,90253.33999999998,89880.07999999997
7915,U16056,164,-5209.420000000009,118,46,184856.15000000002,179646.73
7916,U20983,164,261044.54000000007,99,65,2359807.5800000005,2620852.1200000006
7917,U25155,164,1547.0500000000027,144,20,65662.36,67209.41
7918,U12052,164,-154480.40000000002,159,5,207819.54,53339.139999999985
7919,U20897,164,-2307.580000000001,156,8,12245.499999999995,9937.919999999995
7920,U35459,164,-85.21999999999727,148,16,33466.139999999985,33380.91999999999
7921,U43110,164,46452.03000000001,82,82,997902.27,1044354.3
7922,U22592,164,-903.3899999999999,143,21,49249.439999999995,48346.049999999996
7923,U41852,164,-53382.879999999954,131,33,370683.77999999997,317300.9
7924,U25223,164,-18956.559999998455,122,42,19039793.97,19020837.41
7925,U31200,164,25665.950000000008,117,47,57234.66999999999,82900.62
7926,U17248,164,3364.7399999999943,92,72,205111.38999999993,208476.12999999992
7927,U41234,164,6290.240000000003,138,26,55634.46000000003,61924.70000000003
7928,U20498,164,-7571.289999999996,150,14,41782.00000000001,34210.710000000014
7929,U16652,164,-19253.459999999995,149,15,373424.24,354170.77999999997
7930,U1319844,164,-2906.37,97,67,29029.040000000008,26122.67000000001
7931,U15703,164,-36860.45999999996,138,26,725267.11,688406.65
7932,U23228,164,-5955.539999999998,149,15,61697.21,55741.67
7933,U29891,164,1722.6000000000017,143,21,25968.58,27691.180000000004
7934,U17070,164,3481.610000000008,122,42,300541.5000000001,304023.1100000001
7935,U10278,164,-18035.98,139,25,42059.54000000001,24023.56000000001
7936,U914516,164,-3976.9400000000005,100,64,44570.09999999999,40593.15999999999
7937,U15086,164,-9358.64,149,15,31406.979999999996,22048.339999999997
7938,U25528,164,45449.24000000004,149,15,554849.8800000001,600299.1200000001
7939,U847353,164,3202.149999999999,120,44,23910.71,27112.859999999997
7940,U13213,164,2059.6299999999874,147,17,119525.16,121584.79
7941,U15445,164,-5665.099999999991,139,25,655831.9,650166.8
7942,U11025,164,-2901.7400000000002,148,16,27674.890000000003,24773.15
7943,U27611,164,50.529999999984284,99,65,75359.64000000001,75410.17
7944,U27126,164,3050.320000000017,121,43,371196.9799999999,374247.29999999993
7945,U21933,164,-41315.74999999998,141,23,132628.93999999997,91313.19
7946,U35943,164,5717.799999999999,152,12,27239.050000000003,32956.850000000006
7947,U43920,164,70822.45999999998,118,46,102589.57,173412.02999999997
7948,U27730,164,103089.05000000005,96,68,551200.93,654289.9800000001
7949,U8682,164,-85632.78000000003,115,49,705539.3999999999,619906.6199999999
7950,U8488,164,2335.5899999999983,114,50,361596.0,363931.59
7951,U10352,164,2163.580000000001,128,36,22526.61999999999,24690.199999999993
7952,U23847,164,-475.2199999928707,110,54,56469731.199999996,56469255.980000004
7953,U21547,164,-44610.92999999999,132,32,373320.8,328709.87
7954,U39364,164,-37100.650000000016,148,16,595495.9299999999,558395.2799999999
7955,U984389,164,-1185.8200000000002,108,56,69328.84000000001,68143.02
7956,U21817,164,577.3100000000022,94,70,454753.97000000003,455331.28
7957,U29033,164,-241.78000000000065,105,59,259339.24000000002,259097.46000000002
7958,U32400,164,4068.8600000000006,136,28,32661.20000000001,36730.06000000001
7959,U27198,164,-36817.31999999999,141,23,553708.83,516891.50999999995
7960,U32794,164,88825.51000000005,147,17,786292.7499999999,875118.2599999999
7961,U19889,164,48250.77,143,21,380048.61,428299.38
7962,U26758,164,6207.889999999989,139,25,130542.03000000006,136749.92000000004
7963,U30564,164,45646.88999999994,96,68,536663.2799999999,582310.1699999998
7964,U34352,164,-3332.1699999999983,157,7,48168.049999999996,44835.88
7965,U36510,164,-201510.85,101,63,1540185.4200000002,1338674.57
7966,U40193,164,-18573.20000000001,116,48,273318.20999999996,254745.00999999995
7967,U32634,164,12422.19000000006,119,45,1469276.51,1481698.7000000002
7968,U27271,164,-308.5499999999988,138,26,28376.039999999994,28067.489999999994
7969,U17960,164,-119259.92000000001,135,29,589001.5199999997,469741.5999999996
7970,U8697,164,-37621.36000000001,121,43,181101.78999999998,143480.42999999996
7971,U11669,164,-50165.65000000002,154,10,70117.08000000003,19951.430000000008
7972,U29948,164,26730.499999999993,139,25,58459.10000000002,85189.6
7973,U14606,164,19176.729999999992,141,23,62687.540000000015,81864.27
7974,U43909,164,27676.470000000005,130,34,334098.70999999996,361775.18
7975,U10345,164,4119.709999999999,150,14,87459.90999999999,91579.62
7976,U42877,164,107169.25,121,43,247575.65999999995,354744.9099999999
7977,U27659,164,-15751.630000000005,139,25,138522.61,122770.97999999998
7978,U42732,164,33029.86,156,8,29822.099999999995,62851.95999999999
7979,U26275,164,-7780.989999999976,110,54,338720.2699999999,330939.2799999999
7980,U33916,163,-90262.99999999994,135,28,628885.9699999999,538622.97
7981,U29231,163,65584.23000000004,145,18,1709934.61,1775518.84
7982,U19384,163,-7861.230000000023,114,49,395104.70000000007,387243.47000000003
7983,U8837,163,-12749.660000000003,139,24,124969.47999999998,112219.81999999998
7984,U39868,163,-21969.819999999996,119,44,198683.06999999995,176713.24999999994
7985,U39795,163,-20491.829999999954,116,47,1961550.5600000005,1941058.7300000007
7986,U26435,163,-14997.780000000012,147,16,61364.76000000002,46366.98
7987,U35855,163,-3824.899999999996,151,12,38249.33,34424.43000000001
7988,U24292,163,12419.820000000063,129,34,296067.7299999999,308487.55
7989,U11150,163,43302.50999999998,126,37,1077499.8000000003,1120802.3100000003
7990,U16174,163,-1106.6399999999974,92,71,73584.23,72477.59
7991,U41849,163,-585738.6100000001,141,22,929039.4800000002,343300.8700000001
7992,U35616,163,-1925.9500000000007,156,7,18852.93999999999,16926.98999999999
7993,U27064,163,16626.440000000533,111,52,4738953.59,4755580.03
7994,U32935,163,1498.6100000000008,155,8,28334.279999999995,29832.889999999996
7995,U30095,163,-6339.739999999997,122,41,26046.450000000008,19706.71000000001
7996,U9528,163,-7297.890000000041,139,24,370576.97999999975,363279.08999999973
7997,U32282,163,124108.23000000033,126,37,2959619.06,3083727.2900000005
7998,U11875,163,240694.35000000003,135,28,691058.5,931752.8500000001
7999,U25380,163,-983.909999999994,152,11,33083.06999999999,32099.16
8000,U33986,163,-530.5299999999952,141,22,41719.29,41188.76000000001
8001,U40227,163,687.0300000000009,151,12,117847.75000000001,118534.78000000001
8002,U37230,163,15129.31,142,21,51715.42999999999,66844.73999999999
8003,U11295,163,18510.549999999992,136,27,466660.55999999994,485171.1099999999
8004,U31290,163,-9199.550000000001,99,64,146458.98000000004,137259.43000000005
8005,U10882,163,-5236.129999999984,107,56,642771.96,637535.83
8006,U28135,163,-18770.060000000005,151,12,33909.350000000006,15139.29
8007,U34204,163,-7375.599999999984,146,17,177740.3,170364.7
8008,U1188619,163,13508.320000000005,75,88,160217.5,173725.82
8009,U30411,163,-6807.060000000001,139,24,15132.749999999998,8325.689999999997
8010,U20092,163,-288.12000000000353,127,36,28967.799999999992,28679.67999999999
8011,U39501,163,40839.929999999986,120,43,431565.14999999997,472405.07999999996
8012,U40676,163,-52434.45999999999,157,6,65086.49999999999,12652.04
8013,U40611,163,-423758.24999999994,147,16,1379218.8900000001,955460.6400000001
8014,U34593,163,-7778.859999999968,127,36,657839.34,650060.48
8015,U28760,163,-3004.3099999999977,136,27,455134.66,452130.35
8016,U16946,163,18733.639999999996,149,14,180891.54,199625.18
8017,U12941,163,11178.830000000044,128,35,335804.4099999999,346983.23999999993
8018,U30097,163,-308.41000000001077,138,25,111719.75,111411.34
8019,U32713,163,57541.3900000002,134,29,1949879.69,2007421.08
8020,U29478,163,-4754.909999999991,144,19,70024.76999999997,65269.859999999986
8021,U905412,163,-1251.0100000000004,114,49,16886.57,15635.56
8022,U29666,163,-1125761.9099999988,129,34,4332413.739999999,3206651.8300000005
8023,U38113,163,-152189.99999999997,137,26,194177.15999999997,41987.16
8024,U13182,163,-2339826.48,132,31,3883779.3,1543952.8199999998
8025,U41734,163,62338.770000000004,151,12,27065.31,89404.08
8026,U36117,163,-22559.339999999993,149,14,67522.77,44963.43000000001
8027,U1271687,163,16.290000000000425,99,64,18317.699999999997,18333.989999999998
8028,U32073,163,-78880.69000000002,124,39,303630.28,224749.59000000003
8029,U36712,163,13034.960000000006,148,15,61319.510000000024,74354.47000000003
8030,U31872,163,-25563.19,139,24,198642.66999999998,173079.47999999998
8031,U43996,163,25480.809999999998,154,9,150658.7,176139.51
8032,U31297,163,498.20000000001164,72,91,1089362.42,1089860.6199999999
8033,U42323,163,3080.3900000000012,120,43,40092.06,43172.45
8034,U26702,163,-6168.479999999996,148,15,335768.79,329600.31
8035,U1204486,163,-717.939999999995,94,69,59630.65000000001,58912.710000000014
8036,U17509,163,4256.979999999999,159,4,11745.58,16002.559999999998
8037,U20486,163,79759.51000000001,102,61,196322.61000000007,276082.1200000001
8038,U41482,163,-88102.47000000002,154,9,124020.79,35918.31999999998
8039,U24440,163,-9573.449999999999,129,34,111108.1,101534.65000000001
8040,U41417,163,29733.52,152,11,44215.28000000001,73948.80000000002
8041,U14908,163,-58201.009999999995,154,9,101717.31000000003,43516.30000000003
8042,U27309,163,-8742.700000000004,145,18,124884.0,116141.29999999999
8043,U9219,163,-13270.049999999996,147,16,84460.02,71189.97
8044,U14992,163,602560.54,85,78,564326.65,1166887.19
8045,U23515,163,-16709.610000000008,145,18,241427.18999999983,224717.5799999998
8046,U17762,163,-751.1699999999946,119,44,185596.06000000003,184844.89000000004
8047,U43930,163,-35239.35000000004,129,34,421347.6899999998,386108.3399999998
8048,U11574,163,6921.96999999999,139,24,418521.12000000005,425443.09
8049,U24943,163,-36346.24000000003,81,82,74934.31000000007,38588.07000000004
8050,U18351,163,-21354.949999999993,124,39,369023.21,347668.26
8051,U9310,163,63292.24999999997,134,29,291855.01000000007,355147.26
8052,U11382,163,4175.82,131,32,320618.81,324794.63
8053,U15326,163,-945.0300000000134,109,54,133559.65,132614.62
8054,U19958,163,-32676.710000000006,138,25,252812.99000000002,220136.28000000003
8055,U16476,163,-5583.870000000018,79,84,1093157.6500000001,1087573.78
8056,U15220,163,248591.51000000004,95,68,1105494.2400000002,1354085.7500000002
8057,U42453,163,-82141.88999999998,139,24,634970.4500000001,552828.56
8058,U12545,162,-1008.410000000003,143,19,54174.44000000001,53166.030000000006
8059,U18252,162,-320754.67000000004,136,26,807457.44,486702.7699999999
8060,U30685,162,-1838.7700000000027,133,29,59029.26000000004,57190.490000000034
8061,U30282,162,41450.629999999976,133,29,107678.34,149128.96999999997
8062,U43630,162,-1900.7599999999984,138,24,19392.91000000001,17492.150000000012
8063,U11028,162,15123.47000000011,85,77,1153862.0400000003,1168985.5100000005
8064,U30768,162,35910.96999999996,85,77,1568177.56,1604088.53
8065,U35314,162,-310.78000000000407,124,38,366399.51999999996,366088.73999999993
8066,U21616,162,28106.840000000047,149,13,294123.30000000034,322230.14000000036
8067,U1040544,162,173.3300000000254,117,45,602389.63,602562.9600000001
8068,U36417,162,-8049.369999999998,146,16,46443.33,38393.96000000001
8069,U33250,162,-56.36999999999898,133,29,105699.22000000002,105642.85000000002
8070,U36544,162,-43293.23000000002,144,18,141104.27999999997,97811.04999999996
8071,U27645,162,12490.239999999998,123,39,224339.96,236830.19999999998
8072,U43943,162,8146.329999999978,76,86,1218401.0499999998,1226547.38
8073,U27722,162,-20627.99000000001,153,9,35065.520000000004,14437.529999999995
8074,U10262,162,15423.439999999991,150,12,106031.71,121455.15
8075,U36118,162,-3028.0699999999997,143,19,41951.700000000004,38923.630000000005
8076,U17942,162,-84294.87000000002,111,51,629209.7899999999,544914.9199999999
8077,U34577,162,46318.12000000002,115,47,310200.24,356518.36
8078,U20075,162,338.3600000000197,153,9,51102.33999999998,51440.700000000004
8079,U17562,162,16741.790000000037,125,37,6283604.060000001,6300345.8500000015
8080,U21199,162,-20396.46000000003,121,41,883189.29,862792.83
8081,U11768,162,130.6900000000096,132,30,380028.52,380159.21
8082,U14315,162,9925.390000000003,138,24,104609.64,114535.03
8083,U40644,162,-26349.509999999776,102,60,31089405.11,31063055.6
8084,U9010,162,79513.06999999998,155,7,208247.26000000004,287760.33
8085,U11944,162,-4346.500000000524,122,40,7381383.0699999975,7377036.569999997
8086,U42391,162,39637.799999999996,106,56,507110.22000000003,546748.02
8087,U12735,162,28552.78999999995,124,38,932104.9600000001,960657.75
8088,U11928,162,16091.439999999997,156,6,8238.45,24329.89
8089,U777544,162,1508.3300000000334,100,62,474675.73000000004,476184.06000000006
8090,U34469,162,-23579.469999999998,149,13,36251.8,12672.330000000005
8091,U28459,162,56794.28000000015,106,56,839198.3900000004,895992.6700000005
8092,U9298,162,-20341.700000000026,128,34,623452.85,603111.1499999999
8093,U34356,162,-26355.240000000005,125,37,342350.1,315994.86
8094,U27125,162,619.0999999999739,120,42,1081170.85,1081789.95
8095,U8560,162,-17668.760000000017,121,41,838938.8099999998,821270.0499999998
8096,U8198,162,-349507.55999999866,153,9,455099.2099999986,105591.64999999997
8097,U28540,162,-6576.439999999994,150,12,42206.59999999999,35630.159999999996
8098,U37411,162,-32237.309999999998,118,44,450733.05000000005,418495.74000000005
8099,U33620,162,-20333.509999999995,152,10,68635.7,48302.19
8100,U9368,162,-8886.090000000002,124,38,171479.66000000006,162593.57000000007
8101,U15951,162,45198.90000000001,126,36,197319.31000000003,242518.21000000002
8102,U1107089,162,74.81000000000085,117,45,107476.46999999999,107551.27999999998
8103,U30400,162,-19250.820000000014,109,53,180357.34999999998,161106.52999999997
8104,U8690,162,-81993.00000000023,145,17,842405.2600000001,760412.2599999999
8105,U10640,162,8276.809999999998,140,22,26568.16,34844.97
8106,U22957,162,-6300.419999999998,140,22,44829.46000000001,38529.04000000001
8107,U38971,162,967.8800000000101,134,28,71698.77000000003,72666.65000000004
8108,U22238,162,-15969.56999999997,97,65,526809.1299999999,510839.55999999994
8109,U11122,162,-26673.589999999993,145,17,122031.74999999999,95358.15999999999
8110,U1190534,162,-12988.839999999995,101,61,57535.94999999999,44547.10999999999
8111,U33217,162,423.2499999999982,142,20,239035.92999999996,239459.17999999996
8112,U18320,162,29541.050000000007,141,21,150819.26999999996,180360.31999999998
8113,U17233,162,56760.37999999999,107,55,1733221.2699999998,1789981.6499999997
8114,U35182,162,-3609.200000000001,152,10,247857.28,244248.08
8115,U26923,162,-673.9099999999162,137,25,1143990.2500000002,1143316.3400000003
8116,U43508,162,572.0599999999995,114,48,52841.17999999999,53413.23999999999
8117,U26321,162,-184966.97999999998,113,49,2920926.4400000004,2735959.4600000004
8118,U12107,162,-141586.66999999998,154,8,221249.69,79663.02000000002
8119,U10414,162,948.0199999999977,146,16,63943.69000000001,64891.71000000001
8120,U14990,162,24161.83,133,29,201218.40000000002,225380.23000000004
8121,U16511,162,-17230.209999999995,147,15,162089.96999999997,144859.75999999998
8122,U23867,162,-156.7200000000202,144,18,88973.72999999998,88817.00999999997
8123,U41405,162,-164.29000000002782,112,50,731674.6100000002,731510.3200000002
8124,U35876,162,-28551.97999999998,154,8,315129.43999999994,286577.45999999996
8125,U13429,162,1376115.9399999992,136,26,1487523.300000001,2863639.24
8126,U29211,162,-347.0100000000043,120,42,122677.93,122330.91999999998
8127,U15316,162,-97505.30000000005,146,16,704778.1500000001,607272.8500000001
8128,U1074723,162,-12200.009999999995,115,47,43145.18000000002,30945.170000000027
8129,U38682,162,-215566.52000000002,147,15,245175.79000000004,29609.27000000002
8130,U22943,162,17154.47999999988,143,19,1206955.29,1224109.77
8131,U38553,162,-51078.62999999985,125,37,3025633.8000000003,2974555.1700000004
8132,U13112,161,-116985.23999999966,138,23,5662614.390000001,5545629.150000001
8133,U43655,161,850.2900000001804,114,47,1878156.01,1879006.3000000003
8134,U8673,161,-38581.40000000001,145,16,88217.34000000001,49635.94
8135,U25018,161,309.9200000000029,127,34,706051.88,706361.8
8136,U28940,161,5245.399999999998,122,39,65841.07000000002,71086.47000000002
8137,U616346,161,1989.1100000000033,97,64,92459.62999999998,94448.73999999998
8138,U32277,161,85130.42999999998,93,68,411689.2599999999,496819.6899999999
8139,U28094,161,-701.4999999999998,142,19,13552.32,12850.82
8140,U29484,161,13181.909999999998,144,17,66656.03000000001,79837.94000000002
8141,U748846,161,-19951.530000000006,126,35,146231.47,126279.94
8142,U18004,161,-77362.84000000004,94,67,754965.08,677602.2399999999
8143,U29677,161,4698.229999999996,132,29,208363.75999999998,213061.99
8144,U18117,161,-29009.86000000001,140,21,541927.2299999996,512917.36999999965
8145,U11441,161,-60613.04999999999,145,16,133654.47999999998,73041.43
8146,U10715,161,626.4000000000015,112,49,988906.5499999997,989532.9499999997
8147,U1255566,161,6612.850000000004,83,78,26749.62,33362.47
8148,U16415,161,-329.3199999999594,132,29,341912.36,341583.04000000004
8149,U9699,161,-156382.49,130,31,294742.22,138359.72999999998
8150,U25502,161,10690.050000000001,96,65,504211.2799999999,514901.3299999999
8151,U25820,161,15506.249999999998,138,23,81307.95000000003,96814.20000000003
8152,U19388,161,-10168.989999999989,147,14,49458.59000000001,39289.60000000002
8153,U22558,161,9632.270000000011,136,25,1012666.4400000001,1022298.7100000001
8154,U36612,161,-52385.70999999999,152,9,169796.52000000002,117410.81000000003
8155,U22178,161,-42597.78000000001,137,24,80020.05,37422.26999999999
8156,U37205,161,158076.00999999995,143,18,191412.04000000004,349488.05
8157,U17176,161,-4215.340000000004,147,14,92186.87999999999,87971.53999999998
8158,U9787,161,-1230.4999999999848,104,57,662624.1799999999,661393.6799999999
8159,U22195,161,1134.2599999999939,141,20,104129.43,105263.68999999999
8160,U21745,161,10728.150000000005,119,42,3278.9600000000005,14007.110000000006
8161,U33475,161,383.7000000000014,116,45,17018.440000000002,17402.140000000003
8162,U9662,161,-18442.55,144,17,79754.59000000003,61312.04000000002
8163,U41773,161,-45251.950000000004,143,18,113600.99000000002,68349.04000000001
8164,U33139,161,2789.870000000002,137,24,39329.58,42119.450000000004
8165,U8773,161,-13244.57,135,26,61394.78999999998,48150.21999999998
8166,U25560,161,-7818.150000000003,126,35,273017.03,265198.88
8167,U26082,161,1381.6000000000013,152,9,12478.939999999997,13860.539999999997
8168,U13723,161,7131.779999999997,155,6,17674.620000000003,24806.4
8169,U13403,161,113637.21000000011,144,17,581069.91,694707.1200000001
8170,U38201,161,68407.46999999999,145,16,74137.97,142545.44
8171,U43664,161,9952.600000000004,148,13,3863893.5199999996,3873846.1199999996
8172,U36953,161,2167.0799999999995,143,18,29118.339999999997,31285.419999999995
8173,U28218,161,-4645.640000000015,120,41,932976.4900000001,928330.8500000001
8174,U595154,161,-25770.049999999992,122,39,282257.1099999998,256487.05999999982
8175,U846201,161,-6615.280000000005,95,66,154821.65,148206.37
8176,U32075,161,-1009.9999999999945,135,26,43608.87000000002,42598.870000000024
8177,U10312,161,42021.599999999984,121,40,159005.54,201027.13999999998
8178,U27686,161,-32202.019999999993,142,19,111322.84,79120.82
8179,U14765,161,11344.529999999992,95,66,1163016.9499999997,1174361.4799999997
8180,U31385,161,40600.26000000026,125,36,1577832.4500000004,1618432.7100000007
8181,U11015,161,-1151.5400000000154,147,14,272645.66000000003,271494.12
8182,U39859,161,-11865.089999999951,133,28,512910.3800000002,501045.2900000002
8183,U13523,161,-969617.3600000001,128,33,3784140.249999999,2814522.8899999987
8184,U37266,161,-5589.449999999953,137,24,2032549.35,2026959.9000000001
8185,U8568,161,5761.639999999985,141,20,249709.21999999997,255470.85999999996
8186,U17658,161,4451.75,142,19,25325.65,29777.4
8187,U19951,161,5960.860000000016,133,28,409275.14999999973,415236.0099999998
8188,U20043,161,57944.42000000003,98,63,941709.0599999999,999653.48
8189,U27032,161,-2870.1900000000005,143,18,214781.8,211911.61
8190,U15356,161,392400.7100000002,114,47,5959256.730000002,6351657.440000002
8191,U15317,161,-9824.39000000001,136,25,118035.49000000002,108211.1
8192,U10095,161,4509.259999999998,115,46,145047.78000000003,149557.04000000004
8193,U43869,161,-29304.849999999995,148,13,146901.86000000004,117597.01000000005
8194,U41516,161,17490.290000000023,95,66,1355224.0399999998,1372714.3299999998
8195,U28553,161,-15693.530000000013,127,34,255482.94999999998,239789.41999999998
8196,U29826,161,-33170.67,122,39,212746.18999999994,179575.51999999996
8197,U23534,161,-83072.79,156,5,136719.63,53646.84000000001
8198,U29434,161,16227.839999999982,141,20,310929.2100000001,327157.05000000005
8199,U8282,161,17512.470000000005,127,34,224347.68000000008,241860.15000000008
8200,U12259,161,3145.1499999999264,144,17,999973.2699999999,1003118.4199999998
8201,U15176,161,119520.17000000003,137,24,631277.1099999999,750797.2799999999
8202,U40196,161,-112844.32999999996,141,20,462790.5099999999,349946.17999999993
8203,U37700,161,-82721.08000000041,109,52,4143432.1799999997,4060711.099999999
8204,U13840,160,26620.66,146,14,81695.32000000002,108315.98000000003
8205,U21667,160,114186.26000000004,152,8,135250.03999999995,249436.3
8206,U10145,160,14859.260000000007,139,21,107164.31000000001,122023.57000000002
8207,U34041,160,-3015.290000000001,155,5,14826.189999999999,11810.899999999998
8208,U13718,160,-11038.24999999984,84,76,10702751.499999998,10691713.249999998
8209,U20000,160,59392.880000000005,111,49,458717.37999999995,518110.25999999995
8210,U21959,160,-110252.32999999997,142,18,239874.22999999995,129621.89999999998
8211,U1165949,160,304.7199999999978,101,59,66453.31999999999,66758.04
8212,U43733,160,-3097.46,145,15,25387.11,22289.65
8213,U27441,160,-28537.290000000095,93,67,898025.8300000002,869488.54
8214,U30617,160,-20.880000000000564,103,57,44428.659999999996,44407.78
8215,U31305,160,-4355.129999999998,150,10,33389.189999999995,29034.059999999998
8216,U10276,160,3304435.3899999987,123,37,2080616.429999999,5385051.8199999975
8217,U9997,160,98198.07,139,21,134094.95,232293.02000000002
8218,U1350403,160,3774.24,142,18,16820.1,20594.339999999997
8219,U8565,160,334755.48,133,27,257726.96,592482.44
8220,U44059,160,-3588.789999999949,126,34,374728.30000000016,371139.51000000024
8221,U15340,160,12144.81,84,76,380187.56,392332.37
8222,U36796,160,12615.470000000001,147,13,23835.809999999998,36451.28
8223,U33326,160,2398.2400000000052,134,26,231992.52000000002,234390.76
8224,U43342,160,-5087.869999999999,151,9,31145.019999999997,26057.149999999998
8225,U18204,160,23411.040000000008,145,15,129164.95,152575.99
8226,U43645,160,36712.38000000001,128,32,52240.600000000006,88952.98000000001
8227,U33865,160,-398571.36000000016,146,14,1108590.24,710018.8799999999
8228,U41328,160,30953.929999999986,144,16,293437.55999999994,324391.48999999993
8229,U10560,160,-10367.140000000029,148,12,592562.73,582195.59
8230,U18135,160,33196.88999999996,89,71,87306.14999999998,120503.03999999995
8231,U20642,160,1793.449999999998,154,6,27203.499999999993,28996.94999999999
8232,U23241,160,-4401.319999999991,150,10,35257.88,30856.560000000005
8233,U8225,160,104581.46000000002,28,132,734330.0,838911.46
8234,U36731,160,-7759.929999999962,117,43,1927739.57,1919979.6400000001
8235,U25763,160,-23555.23000000001,147,13,96836.56000000001,73281.33
8236,U38549,160,8415.170000000006,142,18,67375.20000000003,75790.37000000002
8237,U39390,160,3628.5900000000056,128,32,71941.42000000001,75570.01000000002
8238,U15141,160,18449.39999999999,135,25,151041.91999999995,169491.31999999995
8239,U27725,160,-5399.73,117,43,63188.07000000001,57788.34000000001
8240,U39045,160,-15729.35000000002,134,26,403199.5,387470.14999999997
8241,U27472,160,810.130000000001,150,10,30726.370000000003,31536.500000000004
8242,U41724,160,4621.57,128,32,37981.15000000001,42602.72000000001
8243,U35975,160,7149.26,150,10,10029.890000000001,17179.15
8244,U1159804,160,3.599999999994543,84,76,63835.0,63838.59999999999
8245,U8202,160,2907.5300000000093,123,37,120365.42000000001,123272.95000000003
8246,U12015,160,5290.1700000000055,92,68,792540.74,797830.91
8247,U29109,160,-17032.96,150,10,59400.93,42367.97
8248,U31769,160,20413.390000000007,117,43,445112.2600000001,465525.65000000014
8249,U43021,160,-77834.08,123,37,493444.88999999984,415610.8099999998
8250,U36153,160,3153.379999999999,144,16,48346.78999999998,51500.16999999998
8251,U25435,160,5944.349999999991,99,61,932190.3999999999,938134.7499999999
8252,U39639,160,-43260.27999999998,144,16,289641.45999999996,246381.18
8253,U34844,160,686.0200000000026,145,15,61042.909999999996,61728.93
8254,U12858,160,81429.84,142,18,46489.02,127918.85999999999
8255,U25181,160,-2755.480000000015,123,37,1575405.1900000004,1572649.7100000004
8256,U17272,160,172.74000000000117,111,49,539283.5899999999,539456.3299999998
8257,U42673,160,2930.200000000006,148,12,22768.910000000007,25699.110000000015
8258,U1221794,160,5609.41,108,52,216865.64,222475.05000000002
8259,U22629,160,-22654.11,151,9,276709.74000000005,254055.63000000006
8260,U27196,160,-39004.33999999999,151,9,82167.01999999999,43162.68
8261,U42435,160,-135.18000000000006,116,44,34248.56,34113.38
8262,U29644,160,21484.629999999976,139,21,269609.65,291094.28
8263,U26859,160,22079.459999998293,109,51,14255834.259999998,14277913.719999997
8264,U28381,160,-22773.11000000001,140,20,114442.69999999998,91669.58999999997
8265,U9698,160,23447.92,146,14,85803.81999999998,109251.73999999998
8266,U23136,160,-17474.000000000007,94,66,33828.329999999994,16354.329999999987
8267,U15917,160,-82614.21000000002,126,34,784902.0299999999,702287.8199999998
8268,U37543,160,-77172.34999999999,141,19,231566.08000000005,154393.73000000004
8269,U23542,160,-1912.88,155,5,15488.97,13576.09
8270,U21600,160,-977888.4900000014,83,77,42482892.44,41505003.949999996
8271,U23851,160,-47702.82000000001,147,13,144228.12,96525.29999999999
8272,U12129,160,-9616.929999999998,133,27,125116.95000000001,115500.02000000002
8273,U13163,160,-17059.93999999996,140,20,1627976.5500000005,1610916.6100000006
8274,U27548,160,1883.87000000001,95,65,220747.61000000002,222631.48000000004
8275,U37561,160,14352.319999999992,129,31,49195.12000000003,63547.440000000024
8276,U17631,160,-34288.41000000006,138,22,523281.0499999999,488992.6399999998
8277,U23342,160,-21717.719999999998,153,7,35378.44999999999,13660.729999999992
8278,U14819,160,13642.900000000023,91,69,1107383.8399999999,1121026.7399999998
8279,U23413,160,1551.9099999999928,141,19,222050.98999999996,223602.89999999997
8280,U13640,160,36264.359999999986,142,18,178855.60000000003,215119.96000000002
8281,U41138,160,4148.8399999999965,148,12,39713.69,43862.53
8282,U15483,160,-32535.84000000001,129,31,166108.86999999997,133573.02999999997
8283,U12795,159,40962.300000000076,126,33,243541.82000000033,284504.1200000004
8284,U20277,159,12978.52999999963,122,37,7029877.610000001,7042856.140000001
8285,U24458,159,-1607.069999999999,149,10,15126.919999999996,13519.849999999997
8286,U36158,159,-156363.07,147,12,397715.4099999999,241352.3399999999
8287,U39742,159,-6005.590000000007,137,22,138959.99999999994,132954.40999999995
8288,U28601,159,-12935.92999999999,105,54,603503.47,590567.54
8289,U9883,159,-669.5499999999884,75,84,620124.33,619454.78
8290,U40508,159,-12248.869999999997,146,13,21068.280000000002,8819.410000000005
8291,U34705,159,12703.819999999994,146,13,47469.749999999985,60173.56999999998
8292,U16009,159,-5731.030000000021,134,25,157196.46000000002,151465.43
8293,U30115,159,2572482.9199999995,136,23,469320.37,3041803.2899999996
8294,U20690,159,-59321.470000000016,95,64,745632.71,686311.24
8295,U1075742,159,4.3699999999999,87,72,21404.640000000003,21409.010000000002
8296,U9120,159,-17875.100000000013,143,16,56909.37,39034.26999999999
8297,U29702,159,-29383.900000000016,113,46,388550.48,359166.57999999996
8298,U13925,159,8177.149999999997,134,25,85644.69999999995,93821.84999999995
8299,U16598,159,-55284.70000000002,140,19,110610.84,55326.13999999998
8300,U18802,159,-27926.16999999998,103,56,494445.79000000004,466519.62000000005
8301,U27680,159,-9773.85000000002,136,23,83088.46,73314.60999999999
8302,U33267,159,-18558.129999999983,145,14,314822.7300000001,296264.6000000001
8303,U16925,159,-1871.0,117,42,849703.3300000001,847832.3300000001
8304,U30323,159,-2274.5399999999936,147,12,83400.26000000001,81125.72000000002
8305,U10870,159,2505.390000000001,120,39,68691.22000000002,71196.61000000002
8306,U13026,159,82223.16999999998,146,13,185648.24000000002,267871.41000000003
8307,U26386,159,-2129.9300000000007,131,28,82375.11999999997,80245.18999999996
8308,U1181679,159,-13227.080000000002,108,51,93730.93999999997,80503.85999999997
8309,U11034,159,-2735.6800000000003,147,12,85018.32,82282.64000000001
8310,U26628,159,2266.079999999998,143,16,23490.679999999993,25756.75999999999
8311,U20648,159,7576.25000000002,137,22,522439.8500000001,530016.1000000001
8312,U15256,159,-2310.8999999999996,144,15,94460.69,92149.79000000001
8313,U28756,159,-23849.780000000002,138,21,46684.93000000001,22835.150000000005
8314,U28638,159,6348.219999999996,138,21,103660.47999999997,110008.69999999997
8315,U15790,159,-142698.99999999983,121,38,1018303.0300000004,875604.0300000005
8316,U11344,159,-58643.43000000004,138,21,1003334.42,944690.99
8317,U38605,159,4805.370000000006,133,26,65415.70999999999,70221.08
8318,U23947,159,-2192.589999999996,128,31,421268.33999999973,419075.74999999977
8319,U26157,159,9899.780000000002,138,21,150460.59,160360.37
8320,U8519,159,-22980.459999999835,99,60,640020.3800000002,617039.9200000004
8321,U41911,159,-3469.290000000001,153,6,3469.890000000001,0.599999999999909
8322,U41544,159,-1393.719999999996,129,30,139158.26000000007,137764.54000000007
8323,U16510,159,-12313.779999999995,142,17,150382.82999999993,138069.04999999993
8324,U43031,159,-0.5599999999825656,85,74,156900.15,156899.59000000003
8325,U22835,159,-459.61000000001343,104,55,652510.6000000002,652050.9900000002
8326,U28815,159,-1400.970000000007,119,40,111609.38000000003,110208.41000000003
8327,U38250,159,71628.20999999999,145,14,267824.11000000004,339452.32000000007
8328,U38919,159,6597.729999999987,140,19,115965.69000000002,122563.42
8329,U11205,159,2324.7099999999928,132,27,93280.01999999997,95604.72999999997
8330,U32144,159,-615.4899999999907,140,19,1730481.95,1729866.46
8331,U16084,159,69576.79000000002,121,38,89790.16999999997,159366.96
8332,U21410,159,8148.160000000029,143,16,172407.7200000001,180555.88000000012
8333,U11425,159,26298.37999999999,148,11,56434.94000000001,82733.32
8334,U22033,159,-3787.179999999993,150,9,134585.45,130798.27000000002
8335,U36432,159,1100.829999999999,136,23,119331.42,120432.25
8336,U25354,159,3253.3899999999994,145,14,15279.419999999998,18532.809999999998
8337,U24600,159,30555.659999999996,145,14,58431.37000000001,88987.03
8338,U39709,159,-61508.560000000005,139,20,203086.42,141577.86000000002
8339,U31414,159,-44144.37000000001,153,6,54360.200000000004,10215.829999999994
8340,U33405,159,-15109.630000000001,138,21,56122.270000000004,41012.64
8341,U13086,159,59938.42000000001,124,35,438215.2999999998,498153.71999999986
8342,U619585,159,-886.9799999999996,90,69,251204.35,250317.37
8343,U13974,159,-89512.41999999997,152,7,362193.44,272681.02
8344,U1175178,159,14648.840000000098,128,31,2217282.77,2231931.6100000003
8345,U22051,159,6038.9,153,6,25862.940000000017,31901.84000000002
8346,U19254,159,245075.77000000002,118,41,27786.5,272862.27
8347,U30252,159,-190033.75,144,15,360976.30999999994,170942.55999999994
8348,U1329454,159,-12.580000000003196,92,67,38820.099999999984,38807.51999999998
8349,U31772,159,-19836.460000000003,135,24,139114.72,119278.26
8350,U29793,159,42341.72999999998,147,12,140512.16000000003,182853.89
8351,U43188,159,-53786.08,119,40,705535.6799999998,651749.5999999999
8352,U641702,159,61.91000000000713,116,43,390020.29,390082.2
8353,U21367,159,5488.890000000043,114,45,1017243.7700000001,1022732.6600000001
8354,U14621,159,48687.060000000005,123,36,1093368.33,1142055.3900000001
8355,U15073,158,5249.480000000098,80,78,5427383.21,5432632.69
8356,U34307,158,-23947.970000000092,128,30,1043288.67,1019340.7
8357,U18978,158,-69409.54999999997,123,35,1413240.62,1343831.07
8358,U24877,158,-7943.289999999997,130,28,76056.63,68113.34000000001
8359,U898016,158,14.879999999999114,78,80,56434.03,56448.909999999996
8360,U730434,158,20.390000000000327,84,74,33240.84999999999,33261.23999999999
8361,U18669,158,-391.74999999997317,98,60,769715.0000000001,769323.2500000001
8362,U32907,158,-1876.3300000000015,151,7,30268.809999999994,28392.479999999992
8363,U8914,158,-5821.669999999999,107,51,145367.57,139545.9
8364,U28688,158,-446.1200000000001,144,14,10595.900000000001,10149.78
8365,U17298,158,-131086.44,103,55,697328.6599999999,566242.22
8366,U29356,158,-29215.24000000001,136,22,372145.8399999999,342930.5999999999
8367,U42337,158,-17657.049999999985,103,55,519263.04000000015,501605.99000000017
8368,U26812,158,-10874.919999999998,143,15,57300.169999999984,46425.249999999985
8369,U39099,158,4598.630000000037,142,16,515533.56,520132.19000000006
8370,U10277,158,-14956.590000000007,141,17,77577.21000000002,62620.62000000001
8371,U27346,158,-7102.180000000017,65,93,323301.31,316199.13
8372,U17534,158,-1742.179999999996,135,23,266706.15,264963.97000000003
8373,U22498,158,-6585.249999999705,110,48,4652918.289999999,4646333.039999999
8374,U24402,158,-10259.870000000003,134,24,307336.73000000004,297076.86000000004
8375,U40403,158,-25057.010000000006,143,15,160650.75999999998,135593.74999999997
8376,U27320,158,-301032.37999999995,123,35,406322.16000000003,105289.78000000009
8377,U32918,158,-416.3700000000017,137,21,34526.78,34110.409999999996
8378,U41517,158,-2000.8899999999999,152,6,10001.869999999999,8000.98
8379,U41239,158,-105659.9399999999,122,36,895834.3999999999,790174.46
8380,U36585,158,-126190.98,149,9,155686.55,29495.569999999992
8381,U8752,158,14329.51999999999,134,24,439841.97,454171.49
8382,U37823,158,-40223.590000000004,128,30,363056.4,322832.81
8383,U28389,158,-155.89999999999847,135,23,141221.6699999999,141065.7699999999
8384,U40619,158,-15109.439999999997,144,14,95069.70999999999,79960.26999999999
8385,U32810,158,-27423.3,115,43,123162.54000000001,95739.24
8386,U30643,158,-4416.950000000003,128,30,72367.83000000002,67950.88000000002
8387,U21973,158,-154536.16,124,34,353360.25,198824.09
8388,U12176,158,6826.529999999955,104,54,5544587.910000001,5551414.440000001
8389,U10999,158,1720.0800000000024,131,27,13973.760000000004,15693.840000000006
8390,U28304,158,-2003.0799999999995,136,22,189440.1,187437.02000000002
8391,U31296,158,4131.619999999995,120,38,157883.75,162015.37
8392,U43644,158,-1250.539999999999,136,22,32925.37999999999,31674.83999999999
8393,U26826,158,-3435.7199999999957,116,42,364500.9400000001,361065.22000000015
8394,U1142053,158,225.38000000000224,85,73,17493.39,17718.77
8395,U9860,158,-82537.3200000001,96,62,1256791.2200000002,1174253.9000000001
8396,U14008,158,20355.070000000072,138,20,62253.99999999988,82609.06999999995
8397,U28161,158,-65265.80000000002,97,61,550726.24,485460.43999999994
8398,U14336,158,-30696.96000000002,127,31,173473.22999999998,142776.26999999996
8399,U26615,158,-9247.989999999998,127,31,78911.33999999997,69663.34999999998
8400,U956853,158,256.46000000000095,126,32,15557.31,15813.77
8401,U32858,158,3280.169999999944,115,43,2828988.0199999996,2832268.1899999995
8402,U16022,158,46518.45000000001,80,78,3487435.0299999993,3533953.4799999995
8403,U20205,158,77899.59000000001,142,16,292340.75999999983,370240.34999999986
8404,U41571,158,-138834.11,114,44,1818948.44,1680114.33
8405,U41201,158,84398.77,135,23,78884.08,163282.85
8406,U16135,158,75705.23999999998,121,37,708874.1699999999,784579.4099999999
8407,U35355,158,-6481.419999999999,148,10,16290.259999999986,9808.839999999986
8408,U33619,158,-22750.549999999996,98,60,261063.29,238312.74000000002
8409,U40159,158,14978.089999999984,131,27,447045.00999999995,462023.0999999999
8410,U580473,158,-11926.47,146,12,29848.24000000001,17921.77000000001
8411,U10766,158,-58785.51000000001,139,19,407823.9299999999,349038.41999999987
8412,U26399,158,-8568.55999999999,50,108,481955.01,473386.45
8413,U26684,158,-5718.2399999999925,140,18,88791.52000000003,83073.28000000004
8414,U25208,158,10781.68,148,10,25727.679999999997,36509.36
8415,U31373,158,-541.9800000000008,153,5,13256.549999999997,12714.569999999996
8416,U43969,158,14395.840000000026,98,60,701557.22,715953.06
8417,U9271,158,-10491.869999999997,140,18,27867.989999999998,17376.120000000003
8418,U21387,158,-540.7700000000038,140,18,83182.84999999999,82642.07999999999
8419,U8954,158,18292.499999999993,147,11,23780.62,42073.119999999995
8420,U39849,158,17255.21,145,13,90876.43000000001,108131.64000000001
8421,U26444,158,-1032.660000000004,86,72,313942.4700000001,312909.81000000006
8422,U1167391,158,-536.3899999999999,84,74,65240.51,64704.12
8423,U32337,158,19527.580000000053,109,49,1093174.7200000002,1112702.3000000003
8424,U28832,158,-15551.400000000016,125,33,186852.61999999997,171301.21999999994
8425,U15464,158,25462.730000000003,135,23,67898.04999999999,93360.78
8426,U34887,158,6152.989999999994,118,40,534607.05,540760.04
8427,U14486,157,2904.0399999999972,138,19,108169.78000000004,111073.82000000004
8428,U40114,157,-52842.020000000026,135,22,162010.88000000003,109168.86000000002
8429,U35394,157,575.36,149,8,3542.5800000000004,4117.9400000000005
8430,U39842,157,-11696.710000000008,90,67,209037.43000000002,197340.72
8431,U8107,157,-45.05999999999983,138,19,5649.230000000003,5604.170000000004
8432,U26128,157,1908.4800000000068,115,42,394444.85,396353.32999999996
8433,U36002,157,15828.910000000002,145,12,88457.52999999998,104286.43999999999
8434,U39633,157,-450.80000000000143,148,9,12885.689999999999,12434.889999999998
8435,U11518,157,15677.960000000008,127,30,155317.67999999996,170995.63999999998
8436,U39922,157,-10643.119999999994,139,18,50019.66,39376.54000000001
8437,U13594,157,508025.82999999996,140,17,289677.42,797703.25
8438,U33965,157,-8218.88,131,26,121720.45,113501.56999999999
8439,U41645,157,-26006.08000000001,121,36,78019.18999999994,52013.109999999935
8440,U1117888,157,108.0,85,72,100376.76999999999,100484.76999999999
8441,U41540,157,2938786.910000001,76,81,2966678.3999999994,5905465.3100000005
8442,U24281,157,-13515.529999999872,141,16,2403966.2900000005,2390450.7600000007
8443,U19939,157,-1039.1100000000001,150,7,18933.229999999996,17894.119999999995
8444,U26379,157,-3985.7599999999998,147,10,11170.14,7184.379999999999
8445,U8843,157,278363.43999999994,134,23,633286.0300000004,911649.4700000003
8446,U26518,157,-174.69999999999823,142,15,88452.34000000003,88277.64000000003
8447,U17702,157,70065.07,116,41,165054.40000000002,235119.47000000003
8448,U29791,157,133.1899999999987,134,23,59310.649999999994,59443.84
8449,U17495,157,16334.279999999957,136,21,147421.82,163756.09999999998
8450,U15082,157,9106.980000000092,117,40,3363680.829999999,3372787.809999999
8451,U10378,157,-21340.729999999956,93,64,1850816.93,1829476.2
8452,U9816,157,-901560.9800000001,135,22,1441949.49,540388.5099999999
8453,U24703,157,3290.339999999993,124,33,136351.78,139642.12
8454,U13392,157,-1877.4699999999175,143,14,1813960.7000000002,1812083.2300000002
8455,U20293,157,2452.9200000000023,135,22,109443.40999999997,111896.32999999997
8456,U32973,157,-86.35000000000036,147,10,19421.309999999998,19334.96
8457,U23403,157,6330.869999999998,146,11,51332.98999999998,57663.85999999998
8458,U16461,157,-14321.96,135,22,131905.08000000002,117583.12000000002
8459,U35320,157,-2049.230000000037,110,47,1250643.88,1248594.65
8460,U18974,157,1102.7900000000081,74,83,1479309.15,1480411.94
8461,U42330,157,11204.960000000006,106,51,133898.33000000005,145103.29000000004
8462,U12187,157,8646.019999999999,132,25,73994.81,82640.83
8463,U21851,157,-58942.10000000001,114,43,529296.8400000002,470354.74000000017
8464,U19452,157,-197641.54,131,26,604899.4100000001,407257.8700000001
8465,U35371,157,312334.35,104,53,892584.6100000001,1204918.96
8466,U9433,157,-1379.5600000000031,101,56,104872.37999999999,103492.81999999999
8467,U27124,157,38312.79,138,19,278387.12,316699.91
8468,U8042,157,-41104.909999999996,146,11,49739.909999999996,8635.0
8469,U13219,157,-1012749.18,137,20,1103047.0800000003,90297.90000000026
8470,U39087,157,-51726.910000000025,132,25,891739.3999999998,840012.4899999998
8471,U30020,157,11061.950000000004,130,27,257204.18999999994,268266.13999999996
8472,U21121,157,-6855.030000000028,137,20,1544847.09,1537992.06
8473,U32008,157,-1386.6599999999992,121,36,35685.05,34298.39000000001
8474,U33501,157,-1259.1199999999717,124,33,469016.85999999987,467757.7399999999
8475,U20651,157,-49141.429999999964,127,30,571712.3400000001,522570.91000000015
8476,U27095,157,-35170.52999999997,130,27,495173.7900000001,460003.2600000001
8477,U11395,157,287926.1799999998,116,41,684814.93,972741.1099999999
8478,U960608,157,-86.09000000000015,128,29,44339.3,44253.21000000001
8479,U19238,157,-29238.179999999986,138,19,466206.43,436968.25
8480,U16020,157,35226.61,101,56,238994.60000000006,274221.2100000001
8481,U44027,157,323.9899999999016,126,31,1531599.9299999992,1531923.9199999992
8482,U8732,157,66130.25999999998,114,43,681332.8400000002,747463.1000000002
8483,U27274,157,-15010.350000000004,110,47,201508.42999999996,186498.07999999996
8484,U22860,157,20628.049999999996,148,9,38790.579999999994,59418.62999999999
8485,U13216,157,-10949.240000000023,112,45,404368.54000000004,393419.3
8486,U30993,157,-49080.29000000002,127,30,99307.26,50226.96999999997
8487,U13485,157,-128.12999999996273,144,13,549278.9600000002,549150.8300000002
8488,U15140,157,21281.530000000002,145,12,68603.38,89884.91
8489,U32914,157,-314124.99999999977,139,18,917178.6699999998,603053.67
8490,U8614,157,16301.079999999994,141,16,78732.65000000001,95033.73000000001
8491,U10897,157,-2043.7099999999812,55,102,427050.92000000004,425007.2100000001
8492,U41603,157,-8196.35999999999,139,18,41675.670000000035,33479.31000000004
8493,U15825,157,-104076.54999999999,140,17,340365.19999999995,236288.64999999997
8494,U24927,157,12298.860000000004,140,17,91432.78000000001,103731.64000000001
8495,U42070,157,524091.1699999998,131,26,683264.6200000001,1207355.79
8496,U19039,157,-23491.079999999994,131,26,164472.61,140981.53
8497,U8246,157,-98645.20000000001,135,22,1229269.4800000002,1130624.2800000003
8498,U20384,157,-1822.5699999999997,154,3,12385.88,10563.31
8499,U28625,157,14956.100000000004,141,16,69847.57999999999,84803.68
8500,U29566,157,-8726.950000000017,124,33,798878.2600000001,790151.31
8501,U24868,157,6542.480000000021,150,7,53760.74000000001,60303.22000000003
8502,U17092,157,-116838.87000000001,92,65,840529.4599999997,723690.5899999997
8503,U26875,157,98687.96000000002,133,24,129490.92999999998,228178.89
8504,U27170,157,9388.020000000019,129,28,987241.28,996629.3
8505,U16957,156,-38623.61000000012,135,21,1502199.48,1463575.8699999999
8506,U21846,156,256251.82999999932,107,49,14781594.8,15037846.63
8507,U13390,156,1160.4999999999986,135,21,26103.989999999998,27264.489999999998
8508,U33361,156,-67671.84,118,38,1437628.9800000002,1369957.1400000001
8509,U30426,156,23670.949999999993,142,14,105783.42,129454.37
8510,U42841,156,4728.330000000004,114,42,158282.57,163010.90000000002
8511,U29233,156,-3296.5099999999907,146,10,26538.929999999862,23242.41999999987
8512,U1302911,156,-537.4500000000003,91,65,35240.66000000002,34703.21000000002
8513,U14184,156,12471.730000000003,125,31,286775.51,299247.24
8514,U40521,156,8317.840000000002,102,54,314207.05999999994,322524.89999999997
8515,U16456,156,-584.7399999999999,136,20,7944.380000000001,7359.640000000001
8516,U14139,156,-363010.1999999999,110,46,1030403.4499999998,667393.25
8517,U38153,156,-357.130000000021,116,40,438746.37999999995,438389.24999999994
8518,U36630,156,1451.8500000000004,135,21,17841.819999999992,19293.66999999999
8519,U38385,156,-2780.5900000000056,137,19,1316387.5699999996,1313606.9799999995
8520,U10215,156,-50545.37000000005,129,27,308321.61999999994,257776.24999999988
8521,U36145,156,-2713.709999999998,149,7,12363.459999999997,9649.75
8522,U34570,156,21832.809999999998,103,53,480893.96,502726.77
8523,U33409,156,3393.370000000001,142,14,54816.48000000001,58209.85000000001
8524,U19666,156,-21225.21000000002,102,54,889931.6399999999,868706.4299999999
8525,U30816,156,-986.0799999999991,138,18,18330.11999999999,17344.039999999994
8526,U38132,156,431.38999999999305,147,9,52915.75000000001,53347.14
8527,U40212,156,8115.8699999999935,106,50,179645.51999999996,187761.38999999996
8528,U31773,156,-30178.170000000002,129,27,117680.93,87502.76
8529,U18177,156,8187.710000000008,63,93,359628.83,367816.54000000004
8530,U33231,156,-20492.169999999987,137,19,124963.87,104471.70000000001
8531,U14670,156,-1764.5600000000113,125,31,40377.21000000001,38612.649999999994
8532,U17697,156,-432.5499999999996,125,31,3968.2000000000007,3535.650000000001
8533,U41065,156,-5051.329999999994,120,36,83441.33999999995,78390.00999999997
8534,U10363,156,-1180113.54,129,27,1804095.19,623981.6499999999
8535,U14467,156,-176724.69,141,15,341246.64,164521.95
8536,U14806,156,47684.79000000001,124,32,154821.36999999997,202506.15999999997
8537,U20751,156,12325.599999999995,145,11,35274.39,47599.98999999999
8538,U18596,156,-1308.3099999999984,130,26,69274.14,67965.83
8539,U39433,156,-18168.639999999992,121,35,171006.6,152837.96000000002
8540,U11289,156,-57000.03,112,44,1159829.4600000002,1102829.4300000002
8541,U24264,156,6726.029999999984,141,15,394252.36000000004,400978.39
8542,U41166,156,-156977.83,122,34,1131329.29,974351.4600000001
8543,U30703,156,2711.7300000003215,111,45,2305479.9099999997,2308191.64
8544,U31786,156,-14483.910000000022,129,27,289109.74000000017,274625.83000000013
8545,U23871,156,22954.619999999995,90,66,296540.56999999983,319495.1899999998
8546,U27321,156,-41716.53999999999,134,22,162113.13000000006,120396.59000000007
8547,U1108294,156,2874.1,80,76,103763.0,106637.1
8548,U34392,156,52919.91000000004,116,40,580284.9699999999,633204.8799999999
8549,U32763,156,38506.639999999985,147,9,32600.130000000005,71106.76999999999
8550,U42219,156,8378.339999999998,132,24,349795.33999999997,358173.68
8551,U11223,156,-487626.97,124,32,1052250.8,564623.8300000001
8552,U26885,156,16399.6,139,17,73018.29,89417.88999999998
8553,U26150,156,-37151.42,125,31,90368.74000000002,53217.32000000002
8554,U30533,156,159.08000000000112,90,66,60877.39000000001,61036.47000000001
8555,U42607,156,15777.120000000014,102,54,264055.14,279832.26
8556,U40368,156,-100472.97000000006,92,64,243883.71000000002,143410.73999999996
8557,U32806,156,143.7100000000966,86,70,974343.52,974487.2300000001
8558,U36671,156,5933.419999999996,142,14,26249.94999999999,32183.369999999988
8559,U36531,156,-100.44000000000051,95,61,60470.77,60370.329999999994
8560,U41783,156,6841.150000000005,137,19,205915.00999999998,212756.15999999997
8561,U13831,156,-55074.850000000006,142,14,203800.15999999997,148725.30999999997
8562,U14580,156,1076.3999999999942,93,63,420255.05000000005,421331.45000000007
8563,U22693,156,-50823.14000000004,121,35,1994934.72,1944111.5799999998
8564,U37262,156,-21117.49999999997,128,28,604250.9599999998,583133.4599999998
8565,U19122,156,-193.64999999999986,146,10,13756.52,13562.87
8566,U14289,156,2268.329999999856,97,59,545919.72,548188.0499999998
8567,U14480,156,3095.75,129,27,229635.82000000004,232731.57000000004
8568,U42858,156,26763.649999999994,131,25,188093.37000000002,214857.02000000002
8569,U30898,156,1441.180000000005,122,34,113878.29000000001,115319.47000000002
8570,U21702,156,-8829.069999999996,131,25,114470.87000000001,105641.80000000002
8571,U27477,156,-206833.74999999953,117,39,1331075.1899999992,1124241.4399999997
8572,U41154,156,-85228.95999999999,132,24,184252.65,99023.69
8573,U41305,156,-38403.920000000006,140,16,159097.52000000002,120693.6
8574,U38142,156,-27311.100000000013,140,16,141895.21999999997,114584.11999999997
8575,U41321,156,-19174.129999999997,148,8,47287.409999999996,28113.28
8576,U30341,156,39264.990000000034,114,42,1601717.6600000004,1640982.6500000004
8577,U20608,156,286.41000000000054,145,11,27301.879999999997,27588.289999999997
8578,U25991,156,-6771.179999999999,151,5,94841.62000000004,88070.44000000005
8579,U23531,156,-9411.229999999978,145,11,41000.3099999999,31589.079999999925
8580,U28651,156,2442.0499999999984,129,27,48226.95999999999,50669.00999999999
8581,U9100,156,184.19000000003143,135,21,288373.48,288557.67000000004
8582,U18208,156,-4456.769999999995,128,28,134227.31999999998,129770.54999999999
8583,U21375,156,-3896.0499999998865,132,24,2631706.89,2627810.8400000003
8584,U35440,156,120.14000000000055,106,50,8764.310000000001,8884.450000000003
8585,U28479,156,92548.77999999997,117,39,672874.8999999999,765423.6799999999
8586,U34799,156,-702.5099999999984,145,11,79490.87999999999,78788.37
8587,U19582,156,-122327.94999999998,106,50,360649.5600000001,238321.61000000013
8588,U8996,156,-169807.62000000002,134,22,402708.89999999997,232901.27999999994
8589,U22014,156,222.97000000004476,71,85,870888.57,871111.54
8590,U8782,156,817159.4199999993,137,19,1563351.3300000005,2380510.75
8591,U12746,155,5012.810000000089,112,43,1082958.9699999997,1087971.7799999998
8592,U15110,155,8141.270000000006,130,25,66043.66000000002,74184.93000000002
8593,U29481,155,12988.270000000011,126,29,391706.88999999996,404695.16
8594,U8561,155,-39462.19000000002,130,25,190744.73999999996,151282.54999999993
8595,U12300,155,2110.8999999999896,131,24,531463.08,533573.98
8596,U13148,155,79710.90000000004,106,49,867298.41,947009.31
8597,U29224,155,-6542.869999999992,119,36,168096.21000000005,161553.34000000005
8598,U21073,155,3868.580000000003,128,27,76509.00000000001,80377.58000000002
8599,U26481,155,-475.0200000000046,125,30,321111.08,320636.06
8600,U13198,155,-24068.389999999898,99,56,1728433.76,1704365.37
8601,U13978,155,4059.060000000002,134,21,51768.67,55827.73
8602,U23346,155,15905.959999999992,134,21,737710.0,753615.96
8603,U30700,155,-6747.170000000002,149,6,21584.510000000002,14837.34
8604,U14774,155,-343014.35000000003,136,19,493078.5900000001,150064.24000000005
8605,U14954,155,-85044.55999999998,143,12,158270.91999999998,73226.36
8606,U33464,155,6215.659999999997,146,9,41695.52,47911.17999999999
8607,U22407,155,-7763.1799999999985,145,10,45269.92,37506.74
8608,U25405,155,1136.0100000000004,134,21,35875.160000000025,37011.17000000003
8609,U704435,155,-9.209999999999882,146,9,5448.210000000002,5439.000000000002
8610,U31084,155,342370.87000000005,86,69,12732321.190000001,13074692.06
8611,U26915,155,217330.15000000014,132,23,4573714.050000001,4791044.200000001
8612,U29813,155,-1818.1399999998102,144,11,973407.06,971588.9200000003
8613,U40391,155,4462.609999999997,128,27,199340.4,203803.00999999998
8614,U23245,155,7918.779999999933,140,15,139963.8200000004,147882.60000000036
8615,U25915,155,247.61000000000195,123,32,74978.53,75226.14
8616,U37461,155,19424.57000000018,117,38,4119085.709999999,4138510.2799999993
8617,U592600,155,-6534.670000000013,94,61,411009.81000000006,404475.14
8618,U8529,155,9936.78,139,16,23913.199999999997,33849.979999999996
8619,U34923,155,-2676.0899999999874,80,75,224901.95000000004,222225.86000000004
8620,U28999,155,16386.51000000001,140,15,191156.92,207543.43000000002
8621,U28337,155,-505.17999999999233,126,29,90646.16,90140.98000000001
8622,U33607,155,-306.7800000000001,149,6,9138.26,8831.48
8623,U31599,155,21006.239999999998,135,20,163348.89999999994,184355.13999999993
8624,U24424,155,-5380.239999999999,148,7,40230.45000000002,34850.21000000002
8625,U25293,155,-1608.529999999994,107,48,477594.64,475986.11000000004
8626,U24466,155,-1909.3699999999535,122,33,295565.7799999999,293656.41
8627,U41794,155,-10287.410000000003,114,41,122616.38999999998,112328.97999999998
8628,U21101,155,-243284.29999999996,134,21,444928.1099999999,201643.80999999997
8629,U34224,155,-572063.34,144,11,879128.34,307065.0
8630,U24642,155,308289.61000000016,122,33,264511.29000000004,572800.9000000001
8631,U26284,155,76342.14999999992,41,114,461041.0,537383.1499999999
8632,U40598,155,-15569.7,142,13,37257.4,21687.7
8633,U27099,155,-18663.329999999667,139,16,752021.1299999998,733357.8
8634,U25618,155,-12948.739999999998,138,17,201775.0,188826.26
8635,U23396,155,15115.719999999988,145,10,60352.37000000001,75468.09
8636,U10253,155,-17309.49,131,24,66893.06000000001,49583.57000000001
8637,U20328,155,2521.5100000000093,121,34,1062761.12,1065282.6300000001
8638,U14045,155,-7839.580000000016,114,41,123249.09000000003,115409.51000000001
8639,U34818,155,-10324.909999999996,139,16,344976.58999999997,334651.68
8640,U39625,155,-22130.339999999993,142,13,82213.40000000001,60083.06000000001
8641,U26560,155,34024.29,132,23,120334.18,154358.47
8642,U13746,155,561.6500000000003,148,7,4007.329999999998,4568.979999999999
8643,U30734,155,37608.25999999999,147,8,86350.58,123958.84
8644,U39171,155,-3971.7,145,10,44873.97,40902.270000000004
8645,U20006,155,5510.15,150,5,4917.980000000001,10428.130000000001
8646,U11701,155,-5671.900000000007,137,18,47863.61000000002,42191.710000000014
8647,U10754,155,-1251.1500000000035,137,18,802333.8,801082.65
8648,U26147,155,8858.200000000012,118,37,206287.28999999995,215145.48999999996
8649,U14307,155,-71225.59000000013,138,17,1308260.09,1237034.5
8650,U10530,155,-24511.489999999998,133,22,57447.650000000016,32936.16000000002
8651,U34634,155,-30005.960000000006,150,5,35104.920000000006,5098.959999999999
8652,U40392,155,9490.43,144,11,55770.39000000001,65260.82000000001
8653,U19215,155,-27089.78000000006,131,24,129901.27000000014,102811.49000000008
8654,U15081,155,-1288.3200000000072,136,19,82527.98000000008,81239.66000000008
8655,U20544,155,-14979.629999999994,143,12,51676.64000000002,36697.010000000024
8656,U17343,155,-7023.420000000286,127,28,241876.18000000023,234852.75999999995
8657,U18114,155,-74551.34,118,37,292221.64,217670.30000000002
8658,U34943,155,315.990000000006,128,27,73543.48999999996,73859.47999999997
8659,U11794,155,366.8299999999922,136,19,172844.56999999992,173211.3999999999
8660,U37711,155,10359.680000000022,147,8,163179.09,173538.77000000002
8661,U9739,155,5231.110000000001,113,42,141842.69999999998,147073.81
8662,U36528,155,39699.83999999996,65,90,55753.85000000001,95453.68999999997
8663,U43314,155,15424.180000000002,126,29,34427.15,49851.33
8664,U13226,155,-4144.500000000001,148,7,13017.17,8872.669999999998
8665,U30330,155,1510.3200000000006,130,25,53292.31000000001,54802.63000000001
8666,U22478,155,14059.550000000148,100,55,2532522.12,2546581.6700000004
8667,U38703,155,-159778.92000000013,127,28,4769966.980000001,4610188.060000001
8668,U17152,155,13366.020000000008,133,22,10040.760000000004,23406.780000000013
8669,U23923,155,-1618.0400000000152,99,56,1283733.3800000001,1282115.34
8670,U36039,155,481117.66000000003,144,11,157962.25000000003,639079.91
8671,U41566,155,231741.87000000005,146,9,21458.52,253200.39000000004
8672,U26056,155,8087.609999999997,117,38,30164.12,38251.729999999996
8673,U14807,154,8333.859999999873,72,82,495906.3999999999,504240.2599999998
8674,U38691,154,511.79000000012456,96,58,1076737.2599999998,1077249.0499999998
8675,U40868,154,-34266.19,113,41,386235.1900000002,351969.0000000002
8676,U22952,154,-15270.939999999984,107,47,778460.2399999999,763189.2999999999
8677,U15590,154,378650.88999999996,124,30,3102837.25,3481488.14
8678,U36264,154,81684.54999999999,140,14,214759.82,296444.37
8679,U39188,154,988.5200000000004,136,18,51820.32000000001,52808.84000000001
8680,U17008,154,-34268.93999999997,90,64,479904.17,445635.23
8681,U15076,154,-724.789999999994,107,47,174238.30999999997,173513.51999999996
8682,U32645,154,-6293.580000000022,131,23,193278.85999999996,186985.27999999994
8683,U17949,154,-29505.37999999998,123,31,438738.6500000001,409233.2700000001
8684,U35198,154,12009.649999999958,56,98,1048240.85,1060250.5
8685,U10603,154,136525.66999999998,97,57,373620.29999999976,510145.96999999974
8686,U39144,154,-13501.13,129,25,200069.08000000005,186567.95000000004
8687,U9473,154,-228274.93999999983,132,22,936850.5700000002,708575.6300000004
8688,U19297,154,-52151.79999999998,118,36,190376.05,138224.25
8689,U28162,154,11160.499999999998,139,15,32636.85999999999,43797.359999999986
8690,U1111280,154,-2191.1300000000006,125,29,12673.58,10482.449999999999
8691,U37855,154,59952.039999999986,118,36,337350.4099999999,397302.4499999999
8692,U985120,154,-12416.479999999994,92,62,72936.66999999998,60520.18999999999
8693,U15044,154,947.5499999999984,145,9,41133.489999999976,42081.03999999997
8694,U39447,154,54809.910000000025,123,31,1565464.6300000001,1620274.54
8695,U39437,154,-72456.48000000001,112,42,850063.1200000001,777606.6400000001
8696,U22903,154,2226.7600000000057,143,11,60730.909999999996,62957.67
8697,U15794,154,7886.009999999975,123,31,260596.69999999998,268482.70999999996
8698,U24555,154,-6240.36,135,19,85939.72,79699.36
8699,U10261,154,387.92999999999984,127,27,17679.5,18067.43
8700,U19125,154,-13602.140000000007,140,14,39552.700000000004,25950.559999999998
8701,U21382,154,695.9699999999998,126,28,46069.860000000015,46765.830000000016
8702,U18630,154,19559.120000000003,133,21,67029.81999999999,86588.94
8703,U9165,154,532.4699999999975,136,18,52146.41000000001,52678.880000000005
8704,U38058,154,-31784.850000000002,135,19,1146824.4000000006,1115039.5500000005
8705,U1108845,154,2635.5,94,60,58834.58000000001,61470.08000000001
8706,U38091,154,41441.87999999999,143,11,43090.24000000003,84532.12000000002
8707,U22071,154,61662.119999999995,131,23,120814.57999999999,182476.69999999998
8708,U30764,154,-65730.33999999998,125,29,698334.7600000002,632604.4200000003
8709,U38245,154,2003.0399999999947,117,37,101037.30999999998,103040.34999999998
8710,U27947,154,-443.5500000000004,138,16,77075.31000000003,76631.76000000002
8711,U12203,154,-5163.249999999998,128,26,75248.75000000001,70085.50000000001
8712,U28451,154,-141800.25999999998,134,20,362883.8000000001,221083.54000000012
8713,U37314,154,-1026940.0199999985,136,18,8505447.279999997,7478507.259999999
8714,U25327,154,-27932.980000000018,128,26,262764.26,234831.28
8715,U16515,154,39694.91,130,24,275926.03,315620.94000000006
8716,U39290,154,-18908.82,83,71,33850.81999999999,14941.999999999993
8717,U19314,154,8330.439999999988,123,31,139231.97000000003,147562.41000000003
8718,U16102,154,35475.910000000105,130,24,2201923.9399999995,2237399.8499999996
8719,U33485,154,10272.260000000007,146,8,38374.56999999999,48646.83
8720,U19158,154,9712.269999999997,137,17,57520.58999999997,67232.85999999996
8721,U16097,154,15576.24999999999,147,7,78095.48999999999,93671.73999999998
8722,U37850,154,-1260.2200000000034,144,10,77629.25,76369.03
8723,U8720,154,-1713.0499999999938,141,13,49175.86000000001,47462.81000000001
8724,U15528,154,-418.570000000007,132,22,164088.26999999996,163669.69999999995
8725,U22475,154,27070.22000000001,137,17,111990.20999999999,139060.43
8726,U8472,154,-77078.04000000002,116,38,1326904.2399999998,1249826.1999999997
8727,U30771,154,341.33000000000067,137,17,34746.97,35088.3
8728,U12748,154,21279.019999999982,123,31,117905.03000000001,139184.05
8729,U31760,154,-4484.070000000006,115,39,1201029.82,1196545.75
8730,U23680,154,4212.460000000003,125,29,551752.5400000006,555965.0000000006
8731,U42132,154,-58363.88999999999,145,9,112198.59000000003,53834.70000000003
8732,U34688,154,31054.680000000073,133,21,1345977.75,1377032.4300000002
8733,U26274,154,9389.160000000009,142,12,59053.37000000002,68442.53000000003
8734,U9370,154,3604.330000000009,145,9,80192.29,83796.62
8735,U35812,154,-991.5599999999977,141,13,112660.48999999999,111668.93
8736,U11007,154,4128.700000000002,149,5,26850.410000000003,30979.110000000004
8737,U34759,154,687.4500000000057,122,32,144795.4,145482.85
8738,U9913,154,-15194.549999999988,105,49,3233732.43,3218537.8800000004
8739,U11089,154,-1531.3099999999993,124,30,46056.95,44525.64
8740,U43200,154,14395.460000000005,100,54,614689.3300000001,629084.79
8741,U27873,154,-12985.979999999996,146,8,50689.479999999996,37703.5
8742,U43157,154,1876.0099999999948,139,15,32946.009999999995,34822.01999999999
8743,U8596,154,27565.03999999998,136,18,82694.42000000004,110259.46000000002
8744,U12089,154,-8426.75,141,13,41501.320000000014,33074.570000000014
8745,U797979,154,353.94999999999845,79,75,74214.90000000001,74568.85
8746,U28209,154,-103535.12,136,18,829051.7099999997,725516.5899999997
8747,U29063,154,-11699.400000000058,135,19,353145.2100000001,341445.81
8748,U31400,154,13135.710000000001,147,7,17668.079999999994,30803.789999999994
8749,U25743,154,-3841.5900000000056,117,37,252448.45,248606.86000000002
8750,U11184,154,4288.229999999998,131,23,141847.27,146135.5
8751,U32752,154,4803.669999999998,139,15,93754.1,98557.77
8752,U15020,154,-4234.059999999997,137,17,42619.68999999999,38385.62999999999
8753,U29084,154,-116939.88999999984,105,49,4421795.56,4304855.67
8754,U11260,154,-878.1300000000083,118,36,456963.92999999993,456085.79999999993
8755,U18380,153,-2824.970000000001,136,17,22473.969999999998,19648.999999999996
8756,U39018,153,-5505.570000000058,130,23,582417.61,576912.0399999999
8757,U18439,153,46815.26000000001,132,21,328584.07,375399.33
8758,U32202,153,-6757.0099999999975,137,16,26791.269999999993,20034.259999999995
8759,U27350,153,-15699.55,126,27,46790.090000000004,31090.540000000005
8760,U18707,153,-218841.46000000005,96,57,848952.3100000002,630110.8500000001
8761,U18906,153,-63834.98,129,24,252775.38999999996,188940.40999999995
8762,U13215,153,-3543.9199999999255,111,42,1151348.1300000001,1147804.2100000002
8763,U35331,153,-14030.970000000001,137,16,84517.70999999999,70486.73999999999
8764,U13570,153,-43202.979999999945,128,25,336920.24,293717.26000000007
8765,U30712,153,13086.029999999886,93,60,1223765.1600000001,1236851.19
8766,U30054,153,-18113.21,125,28,487380.72,469267.50999999995
8767,U37938,153,105787.26999999996,105,48,2108230.7499999995,2214018.0199999996
8768,U10321,153,-2680.9000000000233,111,42,593975.3,591294.4
8769,U36943,153,-39592.419999999984,123,30,417669.61,378077.19
8770,U11046,153,-840.7900000000004,143,10,19419.350000000002,18578.56
8771,U30291,153,13757.789999999994,136,17,399197.27,412955.06
8772,U43823,153,4044.349999999999,140,13,28295.859999999982,32340.20999999998
8773,U12618,153,-2071934.53,143,10,2166326.1999999997,94391.66999999969
8774,U14302,153,-6241.430000000002,147,6,41545.29,35303.86
8775,U32908,153,6692.820000000007,106,47,721691.9299999999,728384.75
8776,U29534,153,922148.2100000001,143,10,594371.2699999999,1516519.48
8777,U32361,153,-19157.170000000006,132,21,104470.25,85313.07999999999
8778,U34824,153,38117.44999999999,137,16,333399.05,371516.5
8779,U42961,153,-25145.720000000045,129,24,673707.0700000003,648561.3500000002
8780,U43116,153,-3543.7099999999978,151,2,40238.46999999999,36694.75999999999
8781,U27266,153,-19074.170000000006,134,19,85551.45999999999,66477.28999999998
8782,U37236,153,5558.670000000003,119,34,100892.25,106450.92
8783,U22790,153,-97629.81999999989,97,56,771115.2500000001,673485.4300000002
8784,U23361,153,-2228.240000000015,129,24,98410.30000000002,96182.06
8785,U11802,153,-3503.4200000000087,136,17,142401.88999999996,138898.46999999994
8786,U38610,153,-620077.8000000004,123,30,1979445.96,1359368.1599999997
8787,U8851,153,178.83000000000038,116,37,28416.15,28594.980000000003
8788,U21261,153,-14902.280000000012,138,15,251193.97,236291.69
8789,U611193,153,431.13999999999476,83,70,514557.80000000005,514988.94000000006
8790,U26219,153,-3259516.0599999977,137,16,3477689.919999998,218173.86000000034
8791,U17368,153,98471.58,99,54,993736.8,1092208.3800000001
8792,U17955,153,-151.83999999999983,136,17,17178.640000000003,17026.800000000003
8793,U25563,153,3278.149999999994,124,29,37672.13,40950.27999999999
8794,U33115,153,8468.190000000006,139,14,26199.620000000006,34667.81000000001
8795,U43426,153,20213.58,138,15,91535.76000000001,111749.34000000001
8796,U19926,153,-397730.3700000001,67,86,17340724.34,16942993.97
8797,U9856,153,636.1799999999987,142,11,59321.08999999998,59957.26999999998
8798,U28949,153,-56110.54999999999,136,17,177235.22,121124.67000000001
8799,U41471,153,-2995.999999997103,121,32,1455351.0299999928,1452355.0299999956
8800,U40738,153,3596.5500000000047,132,21,97552.76999999996,101149.31999999996
8801,U21247,153,-15589.719999999994,114,39,777536.2699999998,761946.5499999998
8802,U12902,153,-3335.249999999989,135,18,287086.39999999997,283751.14999999997
8803,U26963,153,-34716.89000000007,120,33,1845967.46,1811250.5699999998
8804,U15325,153,13325.700000000084,118,35,6578098.03,6591423.73
8805,U34746,153,-102678.05,118,35,1331364.98,1228686.93
8806,U25404,153,-537.9399999999969,146,7,11713.169999999998,11175.230000000001
8807,U39173,153,-259208.17000000007,112,41,1771596.7499999998,1512388.5799999996
8808,U41465,153,-5069.480000000012,133,20,474709.41000000003,469639.93
8809,U12751,153,-194944.47999999992,123,30,1866722.11,1671777.6300000001
8810,U37021,153,-11905.580000000005,106,47,317818.45,305912.87
8811,U33605,153,-7329.19,123,30,103775.93,96446.73999999999
8812,U43415,153,-30968.23000000001,112,41,423129.95000000007,392161.7200000001
8813,U22165,153,937.5400000000121,90,63,171027.31,171964.85
8814,U26592,153,-152620.74999999997,121,32,810865.8200000001,658245.0700000001
8815,U23524,153,11543.73,97,56,120528.85000000002,132072.58000000002
8816,U42170,153,7676.450000000006,112,41,100181.17,107857.62000000001
8817,U26257,153,173973.03999999998,124,29,440362.31000000006,614335.3500000001
8818,U16545,153,-67917.38,134,19,595815.35,527897.97
8819,U9167,153,24746.46,128,25,87048.14,111794.6
8820,U40685,153,-1597.2899999999956,146,7,12726.619999999992,11129.329999999996
8821,U34879,153,-13976.049999999996,116,37,171134.87,157158.82
8822,U9798,153,-34486.789999999986,98,55,777706.46,743219.6699999999
8823,U27128,153,5686.929999999943,130,23,195957.88999999998,201644.81999999992
8824,U29019,153,4376.290000000001,124,29,220246.28999999986,224622.57999999987
8825,U44061,153,2592.4900000000493,117,36,389720.98,392313.47000000003
8826,U16257,153,-98050.21999999991,125,28,867733.0199999999,769682.8
8827,U15363,153,161945.98000000024,128,25,219547.63999999978,381493.62
8828,U14792,153,-21321.12,86,67,520070.04999999993,498748.92999999993
8829,U12557,153,146.8500000000031,110,43,94579.62,94726.47
8830,U21760,153,-30233.26000000001,103,50,2064593.79,2034360.53
8831,U42266,153,-20547.500000000007,139,14,114243.82,93696.32
8832,U17917,153,7317.120000000001,135,18,73423.62,80740.73999999999
8833,U12607,153,39936.73999999999,120,33,48417.869999999995,88354.60999999999
8834,U37156,153,-7016.719999999996,140,13,17154.139999999996,10137.42
8835,U26153,153,571.5300000000097,88,65,1032046.2900000002,1032617.8200000002
8836,U14199,153,6099.1799999999985,139,14,25523.249999999996,31622.429999999993
8837,U10190,153,-39205.860000000044,140,13,321998.35000000003,282792.49
8838,U15676,153,2580673.1899999985,125,28,1310803.03,3891476.219999999
8839,U20893,153,-404.6200000000025,143,10,112357.79999999996,111953.17999999996
8840,U36951,153,-1534.1000000000054,143,10,120649.72,119115.62
8841,U21022,153,-2245.829999999988,136,17,128656.42999999998,126410.59999999999
8842,U24069,153,-579.4099999999962,108,45,196884.67000000004,196305.26000000004
8843,U16073,153,-8301.19000000001,92,61,150521.53,142220.34
8844,U40083,153,11883.289999999999,101,52,150767.25999999998,162650.55
8845,U44048,152,97228.22,120,32,106201.73000000003,203429.95
8846,U979395,152,3123.840000000001,94,58,52340.17,55464.01
8847,U34853,152,-6102.079999999998,147,5,24528.0,18425.920000000002
8848,U41780,152,334785.27999999985,129,23,228020.74999999994,562806.0299999998
8849,U29451,152,676.3000000000011,131,21,70399.48,71075.78
8850,U28101,152,-3702.2800000000025,136,16,32135.78,28433.499999999996
8851,U14349,152,5045.3700000000035,137,15,27018.519999999997,32063.89
8852,U23608,152,686174.5799999997,94,58,2795823.0499999993,3481997.629999999
8853,U17241,152,-316620.01999999996,108,44,3336340.6100000003,3019720.5900000003
8854,U12288,152,14642.659999999989,148,4,13953.680000000015,28596.340000000004
8855,U39710,152,-4131.4800000000005,128,24,90805.7,86674.22
8856,U27247,152,94111.26999999999,120,32,46946.40000000001,141057.66999999998
8857,U36895,152,7914.709999999988,116,36,226399.02000000005,234313.73000000004
8858,U14143,152,72004.03999999994,104,48,772396.7999999999,844400.8399999999
8859,U23562,152,3674.970000000003,123,29,121963.05000000005,125638.02000000005
8860,U9949,152,-398296.38999999984,97,55,977779.32,579482.9300000002
8861,U40510,152,-2880.070000000009,123,29,273672.35,270792.27999999997
8862,U24626,152,72582.66,101,51,310821.53,383404.19000000006
8863,U26719,152,-67070.09000000016,129,23,3084024.1100000003,3016954.02
8864,U10892,152,-55659.87999999989,115,37,3252509.59,3196849.71
8865,U30686,152,-27767.19,89,63,225779.68999999997,198012.49999999997
8866,U33528,152,-4168.26,139,13,18412.409999999996,14244.149999999996
8867,U12810,152,2762.780000000027,125,27,575127.2300000002,577890.0100000002
8868,U16764,152,-80938.70999999996,89,63,1119813.75,1038875.04
8869,U22616,152,20284.07,143,9,56423.58,76707.65
8870,U42484,152,-415.1899999999914,105,47,410346.08999999985,409930.89999999985
8871,U27757,152,-8864.649999999994,138,14,53151.549999999996,44286.9
8872,U39477,152,5700.7100000000055,139,13,59365.60999999999,65066.32
8873,U9524,152,97242.56000000001,121,31,236602.2899999999,333844.8499999999
8874,U32530,152,6999.249999999994,141,11,70777.42,77776.67
8875,U27800,152,-86698.07000000002,106,46,734032.7599999997,647334.6899999996
8876,U20989,152,-9841.579999999996,117,35,45334.23,35492.65000000001
8877,U11603,152,-306.3700000000006,102,50,58914.92,58608.549999999996
8878,U42637,152,6301.189999999968,130,22,459478.26,465779.44999999995
8879,U34684,152,-15368.499999999993,73,79,562118.96,546750.46
8880,U16523,152,-7981.110000000059,115,37,1288123.63,1280142.5199999998
8881,U31716,152,6138.829999999983,99,53,186103.27,192242.09999999998
8882,U13236,152,-58898.819999999934,120,32,330080.31,271181.49000000005
8883,U18386,152,139377.16999999995,134,18,590659.35,730036.5199999999
8884,U24849,152,-20015.159999999993,129,23,162354.62999999998,142339.46999999997
8885,U39687,152,-2998.3700000000003,148,4,8814.220000000003,5815.850000000002
8886,U36952,152,-38129.68,121,31,129316.65999999997,91186.97999999998
8887,U13048,152,10376.719999999943,116,36,1929562.3399999999,1939939.0599999998
8888,U9279,152,364.62000000014814,95,57,5664297.24,5664661.86
8889,U11873,152,26009.64,114,38,208631.89,234641.53000000003
8890,U32369,152,64337.78,104,48,500836.36000000004,565174.14
8891,U1361704,152,-49.52000000000044,84,68,51369.76999999999,51320.249999999985
8892,U34724,152,217834.02000000002,122,30,615238.8200000001,833072.8400000001
8893,U43459,152,22858.599999999988,77,75,342065.58,364924.18
8894,U30842,152,267.16999999999825,140,12,79100.31,79367.48
8895,U17734,152,98677.40999999999,67,85,187485.27000000002,286162.68
8896,U16917,152,-17450.079999999998,127,25,62746.58,45296.5
8897,U9483,152,-40737.92,131,21,152039.11999999997,111301.19999999997
8898,U32085,152,-8078.829999999995,129,23,266188.35,258109.52
8899,U25633,152,-6403.870000000015,133,19,249932.14999999994,243528.2799999999
8900,U32579,152,2932.500000000004,140,12,115480.93000000002,118413.43000000002
8901,U15987,152,-958.210000000021,92,60,1005722.07,1004763.8599999999
8902,U29446,152,-49003.540000000015,140,12,72773.69000000002,23770.15
8903,U32009,152,7224.670000000003,137,15,86320.72000000002,93545.39000000001
8904,U8543,152,-678.3400000000001,110,42,92758.86000000003,92080.52000000003
8905,U43992,152,-57943.42000000002,146,6,144614.21000000005,86670.79000000004
8906,U18096,152,-23151.44,138,14,77369.85000000002,54218.41000000002
8907,U40277,152,54454.05999999998,89,63,254529.49,308983.55
8908,U20002,152,-34737.70999999997,95,57,1587723.93,1552986.22
8909,U38101,152,5757.020000000014,126,26,249175.03,254932.05000000002
8910,U637968,152,-0.22999999999865395,110,42,27324.53,27324.3
8911,U11496,152,-2156.219999999921,136,16,368715.00000000006,366558.78000000014
8912,U9848,152,-11470.810000000003,125,27,103766.18999999994,92295.37999999995
8913,U23704,152,5932.540000000037,116,36,775128.9799999999,781061.5199999999
8914,U20743,152,-59785.59000000001,99,53,1575778.2200000004,1515992.6300000004
8915,U35361,152,3628.600000000007,90,62,693914.8900000002,697543.4900000002
8916,U42182,152,-16606.629999999997,142,10,37079.329999999994,20472.699999999997
8917,U9769,152,-5193.280000000001,105,47,145714.05999999997,140520.77999999997
8918,U16712,152,-10776.909999999993,117,35,84100.07999999997,73323.16999999998
8919,U14387,152,-434.35000000000036,99,53,125510.61999999998,125076.26999999997
8920,U985974,152,0.0,76,76,71884.0,71884.0
8921,U738966,152,-1907.7699999999988,115,37,75302.23000000003,73394.46000000002
8922,U26688,152,-7939.850000000115,74,78,1298379.0299999998,1290439.1799999997
8923,U9137,152,4332.42000000001,108,44,451297.83999999985,455630.25999999983
8924,U30677,152,-15750.719999999996,131,21,83176.34,67425.62
8925,U24230,152,1072.080000000008,127,25,90792.25,91864.33
8926,U33408,152,87208.48000000004,123,29,162532.83999999997,249741.32
8927,U22204,152,15205.070000000007,109,43,402705.69999999995,417910.76999999996
8928,U24481,152,4549.159999999995,140,12,262875.16,267424.31999999995
8929,U8751,152,1659.4100000000008,120,32,16697.629999999997,18357.039999999997
8930,U27133,152,4567.609999999996,126,26,77792.23999999999,82359.84999999999
8931,U14966,152,-5228.589999999987,90,62,323836.88000000024,318608.29000000027
8932,U35967,152,525278.0800000003,115,37,310897.2799999996,836175.3599999999
8933,U26250,152,9330.900000000023,92,60,743767.1100000001,753098.0100000001
8934,U32358,152,-17262.09,108,44,156469.61999999997,139207.52999999997
8935,U21399,152,1653.189999999995,97,55,219904.2,221557.39
8936,U914528,152,-5396.4400000000005,134,18,23646.83000000001,18250.390000000007
8937,U21485,152,-13258.210000000025,123,29,740411.7800000004,727153.5700000003
8938,U35025,152,-1935977.4900000002,136,16,4434451.66,2498474.17
8939,U11965,152,-10970.300000000001,140,12,117301.9,106331.59999999999
8940,U42040,152,11782.669999999998,129,23,51212.99,62995.659999999996
8941,U8916,152,1678.9000000000055,130,22,87006.58,88685.48000000001
8942,U20807,151,-625120.6299999993,136,15,1092690.3299999994,467569.70000000007
8943,U36466,151,1638.3000000000038,144,7,37495.00999999999,39133.30999999999
8944,U24237,151,426.8899999999527,84,67,8286222.699999998,8286649.589999998
8945,U23333,151,11571.420000000002,142,9,33931.86000000001,45503.28000000001
8946,U35368,151,36294.149999999994,139,12,31650.600000000002,67944.75
8947,U20036,151,13624.65000000001,108,43,319582.29,333206.94
8948,U37154,151,-13504.259999999995,101,50,481414.81,467910.55
8949,U30606,151,17828.379999999986,126,25,114224.33000000005,132052.71000000002
8950,U37242,151,-36824.509999999944,137,14,284728.74,247904.23000000004
8951,U14727,151,2145519.4499999997,133,18,2075006.5,4220525.949999999
8952,U25070,151,3983.3199999999815,111,40,250945.62,254928.93999999997
8953,U18140,151,-6792.35999999999,105,46,122318.79000000001,115526.43000000002
8954,U13489,151,4647.749999999998,142,9,31993.700000000004,36641.450000000004
8955,U32873,151,3268.1299999999756,65,86,1801275.35,1804543.48
8956,U28568,151,-15419.050000000003,124,27,74286.78999999998,58867.739999999976
8957,U25549,151,35563.56000000001,127,24,448393.77,483957.33
8958,U22144,151,-164040.04000000007,96,55,809770.8999999997,645730.8599999996
8959,U16360,151,565.2400000000338,115,36,1293380.6300000004,1293945.8700000003
8960,U37467,151,-7217.100000000002,100,51,521856.79,514639.69
8961,U24317,151,-7972.160000000002,130,21,62690.09000000003,54717.93000000003
8962,U23454,151,7095.530000000009,110,41,119808.66000000002,126904.19000000003
8963,U41028,151,107982.96999999988,61,90,1286066.95,1394049.92
8964,U24696,151,54724.31999999999,93,58,162837.27,217561.58999999997
8965,U39572,151,-14565.789999999994,99,52,771845.2499999999,757279.4599999998
8966,U15067,151,454.67999999994817,132,19,690540.49,690995.1699999999
8967,U18131,151,30050.350000000002,143,8,72744.4,102794.75
8968,U29518,151,13544.790000000008,133,18,216745.37999999998,230290.16999999998
8969,U20633,151,-17246.700000000008,92,59,77414.16,60167.45999999999
8970,U20969,151,-5180.049999999999,122,29,131467.27999999997,126287.22999999997
8971,U14431,151,-23855.76999999999,120,31,225488.04,201632.27000000002
8972,U42553,151,-1923.3099999999965,139,12,52599.29000000001,50675.98000000001
8973,U38940,151,-3501.9300000000003,122,29,112603.97000000003,109102.04000000004
8974,U14054,151,1712.1600000000021,97,54,691101.41,692813.5700000001
8975,U20344,151,-76695.28000000004,128,23,417202.11999999976,340506.83999999973
8976,U39726,151,-4278.110000000001,127,24,33567.28999999999,29289.179999999993
8977,U39333,151,5885.570000000002,134,17,28522.720000000005,34408.29000000001
8978,U39107,151,-614210.06,109,42,658835.74,44625.679999999935
8979,U23242,151,-5935.640000000021,125,26,681828.4199999999,675892.7799999999
8980,U15871,151,-123622.27000000003,123,28,1538575.7100000004,1414953.4400000004
8981,U13203,151,-81498.23,132,19,183712.97999999995,102214.74999999996
8982,U22973,151,-13067.790000000003,141,10,183137.68,170069.88999999998
8983,U926105,151,1673.7199999999984,114,37,22923.68,24597.399999999998
8984,U18271,151,16417.019999999997,129,22,450726.50000000006,467143.5200000001
8985,U24349,151,3185.2000000000867,99,52,1569782.6600000006,1572967.8600000008
8986,U41936,151,-11582.119999999988,122,29,109328.95999999992,97746.83999999994
8987,U26236,151,79268.32000000004,119,32,494769.15,574037.4700000001
8988,U905272,151,292.65000000000146,65,86,23890.300000000003,24182.950000000004
8989,U12490,151,-32545.180000000008,139,12,64069.669999999984,31524.489999999976
8990,U20656,151,-35.47999999999934,108,43,54915.09,54879.61
8991,U26253,151,-133807.2099999999,122,29,2980874.7100000004,2847067.5000000005
8992,U40546,151,-6048.870000000001,137,14,28640.370000000006,22591.500000000007
8993,U25581,151,-18081.309999999998,143,8,58291.340000000004,40210.030000000006
8994,U42098,151,22356.559999999998,132,19,266156.25,288512.81
8995,U11537,151,238.95999999998457,112,39,189782.21,190021.16999999998
8996,U15614,151,-158832.5299999999,127,24,1420349.020000001,1261516.4900000012
8997,U12101,151,-163019.80999999997,83,68,1454362.5300000003,1291342.7200000002
8998,U11591,151,-19926.730000000003,144,7,38206.88000000001,18280.15000000001
8999,U33920,151,383579.67,135,16,111550.46000000002,495130.13
9000,U28037,151,11966.600000000002,135,16,176924.11000000002,188890.71000000002
9001,U13542,151,24446.90000000001,134,17,98268.76,122715.66
9002,U31432,151,764207.9999999993,128,23,1570149.0800000008,2334357.08
9003,U36543,151,3070.2099999999964,135,16,111416.66,114486.87
9004,U16558,151,28432.55,122,29,280259.67000000004,308692.22000000003
9005,U8073,151,3112.6899999999932,100,51,170966.04,174078.73
9006,U1294740,151,761.0799999999996,118,33,31094.61999999999,31855.69999999999
9007,U33802,151,-58146.020000000026,132,19,158165.29,100019.26999999999
9008,U33779,151,-156169.93,125,26,376922.94,220753.01
9009,U15739,151,35066.61000000008,112,39,5012634.24,5047700.850000001
9010,U38158,151,-101257.92,131,20,215985.32000000004,114727.40000000004
9011,U16572,151,-1530.3000000000138,138,13,308750.57,307220.27
9012,U31302,151,-7.519999999999982,145,6,4910.97,4903.450000000001
9013,U38748,151,2922.4599999999996,112,39,35970.0,38892.46
9014,U30283,151,14088.399999999972,137,14,191302.50000000006,205390.90000000002
9015,U35892,151,-1858.5600000000004,134,17,155803.19999999998,153944.63999999998
9016,U12525,151,-26909.890000000007,101,50,512113.10000000003,485203.21
9017,U41996,151,9944.519999999982,105,46,774937.2800000003,784881.8000000003
9018,U31194,151,-10808.730000000023,95,56,301932.43,291123.69999999995
9019,U12565,151,3582.2399999999993,119,32,157499.46999999997,161081.70999999996
9020,U11396,151,42200.799999999996,135,16,105232.37000000001,147433.17
9021,U31798,151,137078.86000000002,121,30,244790.49000000002,381869.35000000003
9022,U8165,151,-2762.899999999998,139,12,55006.7,52243.8
9023,U18867,151,-7208.920000000005,128,23,78586.5,71377.58
9024,U27929,151,-3003.6500000000015,132,19,34753.4,31749.75
9025,U26904,150,24327.47000000001,106,44,75743.40999999999,100070.88
9026,U13405,150,9272.770000000013,148,2,382441.80999999994,391714.57999999996
9027,U10677,150,-8621.239999999998,117,33,78012.1299999999,69390.8899999999
9028,U982741,150,15059.810000000003,86,64,57778.64999999999,72838.45999999999
9029,U23883,150,266409.31999999983,138,12,230589.60999999996,496998.9299999998
9030,U21396,150,5872.540000000004,114,36,326963.5199999999,332836.0599999999
9031,U26742,150,-641.0199999999459,102,48,1506283.53,1505642.51
9032,U32667,150,-140785.69999999998,138,12,200522.07000000004,59736.37000000005
9033,U28734,150,5617.9400000000005,122,28,40570.98999999998,46188.929999999986
9034,U39603,150,-16449.839999999997,126,24,87588.18999999993,71138.34999999993
9035,U8224,150,565.7800000000097,125,25,248262.5,248828.28
9036,U40258,150,4204.559999999984,123,27,369887.6500000001,374092.2100000001
9037,U33640,150,12410.100000000008,102,48,461238.09,473648.19000000006
9038,U8243,150,2890.2900000000045,137,13,19059.37,21949.660000000003
9039,U36800,150,24490.109999999993,108,42,152745.54000000007,177235.65000000005
9040,U27853,150,-6149.229999999995,128,22,49751.72,43602.490000000005
9041,U29328,150,-30222.620000000003,98,52,177484.62,147262.0
9042,U9453,150,-199977.18999999992,133,17,582076.8100000002,382099.6200000002
9043,U40647,150,-22525.289999999997,131,19,136405.91999999984,113880.62999999984
9044,U40418,150,-255479.08000000002,130,20,643327.36,387848.27999999997
9045,U1319278,150,134.4599999999998,79,71,53150.24,53284.7
9046,U30199,150,2248.7700000000023,129,21,37227.369999999995,39476.14
9047,U30198,150,4461.960000000001,116,34,1061489.59,1065951.55
9048,U36860,150,-5026.71000000004,128,22,228364.6,223337.88999999996
9049,U9652,150,3864.8900000000017,140,10,75328.29999999999,79193.18999999999
9050,U19806,150,11526.95999999997,115,35,3615612.650000001,3627139.610000001
9051,U25975,150,66679.2,129,21,132516.65000000002,199195.85000000003
9052,U32006,150,-3621.60000000001,102,48,370437.07999999996,366815.4799999999
9053,U29083,150,-40085.23000000001,117,33,347075.32999999996,306990.1
9054,U20491,150,82.24999999999761,136,14,64152.439999999995,64234.689999999995
9055,U20019,150,-12130.499999999996,127,23,244913.95,232783.45
9056,U15028,150,952.8200000000588,91,59,1757712.4500000002,1758665.2700000003
9057,U10050,150,5358.390000000003,83,67,566189.88,571548.27
9058,U23990,150,-1448.3499999999904,108,42,100190.47000000003,98742.12000000004
9059,U40192,150,-356643.61999999994,127,23,409417.3099999999,52773.689999999944
9060,U19749,150,-5849.479999999865,128,22,341578.6500000001,335729.1700000002
9061,U33350,150,-216716.20999999996,93,57,682314.2200000001,465598.0100000001
9062,U34329,150,-1707.6399999999994,135,15,36393.31,34685.67
9063,U8201,150,30786.389999999992,130,20,38385.0,69171.38999999998
9064,U22735,150,-48067.50999999998,127,23,531692.31,483624.80000000005
9065,U18577,150,-4717.740000000016,106,44,160200.4,155482.65999999997
9066,U9166,150,820353.42,138,12,243759.11000000002,1064112.53
9067,U11747,150,-9192.760000000004,141,9,45097.51000000001,35904.75000000001
9068,U12903,150,-143.58999999999278,135,15,85751.64000000001,85608.05000000002
9069,U23616,150,29447.14,127,23,93701.45,123148.59
9070,U25480,150,-66476.36000000002,141,9,108705.10000000002,42228.740000000005
9071,U33131,150,3835.899999999907,109,41,842304.88,846140.7799999999
9072,U37610,150,10209.029999999988,94,56,648682.91,658891.9400000001
9073,U8699,150,90660.15000000001,115,35,487194.11,577854.26
9074,U30581,150,-7299.950000000003,107,43,349785.88999999996,342485.93999999994
9075,U9945,150,-3902.58,143,7,17169.800000000003,13267.220000000003
9076,U31001,150,13251.06000000002,122,28,167171.39,180422.45000000004
9077,U40986,150,-15969.49000000003,113,37,845440.02,829470.53
9078,U38845,150,940.9099999999889,83,67,1092501.2000000002,1093442.11
9079,U24239,150,-37132.13999999999,128,22,128745.95999999999,91613.82
9080,U8573,150,28647.829999999987,125,25,157668.44999999998,186316.27999999997
9081,U8558,150,1918.1100000000006,135,15,41790.18000000001,43708.29000000001
9082,U10791,150,-44285.06000000002,126,24,168199.56000000003,123914.5
9083,U10798,150,-7476.5400000000045,124,26,102280.50000000001,94803.96
9084,U23564,150,8658.079999998883,81,69,10107325.619999997,10115983.699999996
9085,U25473,150,2756.1899999999987,118,32,51484.75,54240.94
9086,U17585,150,2345.969999999996,114,36,160902.14000000004,163248.11000000004
9087,U18868,150,13784.23,136,14,40453.51000000001,54237.740000000005
9088,U31159,150,-23537.890000000018,124,26,50011.37000000003,26473.480000000014
9089,U41803,150,-21812.129999999986,109,41,252665.48000000004,230853.35000000006
9090,U28889,150,11585.379999999994,119,31,364019.16,375604.54
9091,U1105536,150,-2929.710000000001,140,10,11739.810000000001,8810.1
9092,U23426,150,26374.27999999999,102,48,600470.6599999998,626844.9399999998
9093,U23466,150,18727.02,132,18,94575.46999999997,113302.48999999998
9094,U20987,150,3856.0999999999926,141,9,830074.5800000001,833930.68
9095,U40035,150,39820.71000000003,92,58,1356810.2099999995,1396630.9199999995
9096,U23084,150,-1215.5400000000081,133,17,154338.76999999993,153123.22999999992
9097,U33738,150,-144116.65000000002,113,37,4595473.36,4451356.71
9098,U42756,150,7196.200000000002,120,30,32320.160000000003,39516.36000000001
9099,U20155,150,-8391.91,136,14,41118.549999999996,32726.639999999996
9100,U30137,150,1326801.3600000006,101,49,6417090.45,7743891.8100000005
9101,U21976,150,724151.98,115,35,1230799.5300000003,1954951.5100000002
9102,U36232,150,7536.3400000000065,134,16,168439.96999999997,175976.30999999997
9103,U16530,150,-42372.01999999998,96,54,402643.32,360271.30000000005
9104,U15002,150,-43093.94000000002,137,13,309358.55000000005,266264.61000000004
9105,U13477,150,-77915.01999999995,125,25,415368.56,337453.54000000004
9106,U23217,150,69855.29999999999,121,29,344671.83000000013,414527.1300000001
9107,U19379,150,211.71999999996842,83,67,1566305.32,1566517.04
9108,U34306,150,-15615.129999999981,117,33,465664.12000000005,450048.99000000005
9109,U42964,150,10041.700000000004,134,16,847726.3200000001,857768.02
9110,U43504,150,-50839.09999999999,110,40,481641.54,430802.44
9111,U35679,150,-966.8500000000007,124,26,25662.6,24695.749999999996
9112,U25325,150,-98009.01999999999,137,13,257111.83000000002,159102.81000000003
9113,U44031,150,15699.290000000012,113,37,1098890.5299999993,1114589.8199999994
9114,U10389,149,4027246.020000002,128,21,8583596.130000005,12610842.150000006
9115,U35344,149,-8845.759999999998,141,8,31124.67,22278.91
9116,U15561,149,-12751.06,128,21,123635.31,110884.25
9117,U598187,149,7839.009999999998,92,57,168886.59999999998,176725.61
9118,U42827,149,-9511.920000000002,102,47,66342.55000000002,56830.63000000002
9119,U17263,149,-519443.5199999999,101,48,2011711.4400000002,1492267.9200000004
9120,U38067,149,-34701.94999999999,112,37,99920.19,65218.24000000001
9121,U30918,149,227128.18999999992,114,35,308294.64,535422.83
9122,U30959,149,-44989.409999999974,98,51,517380.73000000004,472391.32000000007
9123,U29581,149,10037.890000000014,139,10,274902.47,284940.36
9124,U43876,149,-5589.399999999998,134,15,32059.519999999993,26470.119999999995
9125,U20433,149,1269.3199999999983,135,14,54805.390000000014,56074.710000000014
9126,U26850,149,99627.53000000007,140,9,270684.2600000002,370311.79000000027
9127,U38739,149,-13113.96,135,14,14752.880000000001,1638.920000000002
9128,U37940,149,-3344.2600000000016,131,18,26764.439999999995,23420.179999999993
9129,U22745,149,-4053.8799999999865,124,25,248294.54,244240.66000000003
9130,U8205,149,29408.420000000002,134,15,55416.759999999995,84825.18
9131,U27520,149,-4515.350000000046,115,34,359907.86,355392.50999999995
9132,U37235,149,-2086.1100000000024,131,18,105429.44000000003,103343.33000000003
9133,U37186,149,224.72000000000014,136,13,7684.9,7909.62
9134,U1196379,149,-65561.2,89,60,212779.6,147218.40000000002
9135,U40684,149,-12945.86,122,27,211783.53999999998,198837.68
9136,U27631,149,9684.120000000006,132,17,100509.50999999997,110193.62999999998
9137,U17996,149,-5762.810000000002,141,8,51850.92999999998,46088.11999999997
9138,U33772,149,2502.4999999999936,36,113,115350.45,117852.95
9139,U12109,149,-1203.080000000002,137,12,33005.790000000015,31802.710000000014
9140,U32326,149,138576.52999999997,105,44,584738.61,723315.1399999999
9141,U17440,149,39199.02000000002,81,68,721599.6499999999,760798.6699999999
9142,U35517,149,-2390.7500000000073,134,15,258807.43,256416.68
9143,U43979,149,-51894.52000000002,114,35,266488.55999999994,214594.03999999992
9144,U14230,149,-94131.1,133,16,184867.34999999998,90736.24999999997
9145,U20551,149,1108.1799999999998,138,11,9589.99,10698.17
9146,U20141,149,24125.98,131,18,33844.97000000001,57970.95000000001
9147,U10923,149,-15924.700000000006,124,25,580132.18,564207.4800000001
9148,U38197,149,-7801.080000000005,132,17,73413.41000000002,65612.33000000002
9149,U23996,149,-1017.5300000000019,83,66,417372.66000000015,416355.1300000001
9150,U34105,149,4324.119999999999,119,30,292494.99,296819.11
9151,U22920,149,-4978.629999999998,142,7,22390.450000000004,17411.820000000007
9152,U26651,149,153.54999999997017,128,21,348817.82,348971.37
9153,U32279,149,-35668.100000000006,132,17,415120.87999999995,379452.7799999999
9154,U9246,149,6599.32,103,46,305662.03,312261.35000000003
9155,U10895,149,20364.939999999995,137,12,100227.09000000001,120592.03
9156,U40230,149,-103345.96999999891,116,33,19477104.230000004,19373758.260000005
9157,U32843,149,-31111.15999999999,143,6,61470.18000000004,30359.020000000048
9158,U41584,149,7126.190000000004,138,11,10604.699999999999,17730.890000000003
9159,U33195,149,-166.25000000000068,140,9,13822.120000000003,13655.870000000003
9160,U13012,149,-13628.819999999982,146,3,13852.959999999981,224.13999999999942
9161,U30697,149,1823.21,130,19,39745.799999999996,41569.009999999995
9162,U13670,149,120630.98999999999,105,44,370039.3,490670.29
9163,U26774,149,544116.3599999999,114,35,380588.24000000005,924704.5999999999
9164,U10045,149,-40.36000000000107,136,13,31117.38,31077.02
9165,U33498,149,598862.9100000004,131,18,1362322.8199999998,1961185.7300000002
9166,U906740,149,-2802.9100000000035,72,77,248552.84999999998,245749.93999999997
9167,U26821,149,-7282.130000000002,139,10,63398.07000000002,56115.94000000002
9168,U29636,149,-26037.739999999998,101,48,620947.7599999999,594910.0199999999
9169,U36273,149,-9.000000000000227,118,31,59749.35999999999,59740.35999999999
9170,U11134,149,22366.140000000007,81,68,539093.4,561459.54
9171,U1298150,149,7132.929999999999,81,68,76628.11000000002,83761.04000000001
9172,U29780,149,-30390.849999999988,136,13,150387.8999999999,119997.04999999992
9173,U1360248,149,-95268.84999999995,120,29,406428.06000000006,311159.2100000001
9174,U1113384,149,0.21999999999974307,85,64,6669.520000000001,6669.740000000001
9175,U11065,149,20.019999999999946,140,9,6890.089999999999,6910.109999999999
9176,U43617,149,-14153.789999999992,108,41,236760.49,222606.7
9177,U26372,149,-41736.71999999999,108,41,795918.03,754181.31
9178,U40574,149,-870271.2200000001,97,52,2264266.879999999,1393995.6599999988
9179,U42634,149,-145.59000000000128,124,25,25479.900000000005,25334.310000000005
9180,U41682,149,7124.170000000008,114,35,216571.09,223695.26
9181,U22105,149,-3026.119999999995,125,24,440886.64999999997,437860.52999999997
9182,U11300,149,27383.36000000003,125,24,948749.8099999999,976133.1699999999
9183,U41114,149,19688.850000000002,129,20,280979.24999999994,300668.0999999999
9184,U43743,149,-5224.400000000003,122,27,46556.04,41331.64
9185,U10390,149,-2102.78,119,30,51201.47000000002,49098.690000000024
9186,U33328,149,-4054.8599999999983,74,75,75915.08,71860.22
9187,U39517,149,-187954.95,123,26,450733.5,262778.55
9188,U43488,149,64687.760000000024,121,28,285678.5500000001,350366.3100000001
9189,U13828,149,59.42999999999418,88,61,309670.38,309729.81
9190,U24862,149,-15840.280000000002,128,21,78335.63999999998,62495.359999999986
9191,U26111,149,284342.80000000005,107,42,579486.5500000002,863829.3500000002
9192,U12075,149,-433777.20999999996,125,24,921590.71,487813.5
9193,U15607,149,-447192.87999999995,129,20,1342235.42,895042.54
9194,U38816,149,45265.030000000086,125,24,1747873.4400000006,1793138.4700000007
9195,U9324,149,7869.429999999966,99,50,940797.31,948666.74
9196,U39923,149,-11062.76,110,39,190361.21,179298.44999999998
9197,U28835,149,-15742.899999999998,83,66,143551.11000000004,127808.21000000005
9198,U21234,149,-4196.569999999992,119,30,397436.82,393240.25
9199,U12222,148,-4062.7500000000146,138,10,100114.43,96051.67999999998
9200,U42247,148,1782.0600000000006,126,22,44422.200000000004,46204.26
9201,U12787,148,16339.930000000022,129,19,242397.47999999998,258737.41
9202,U14884,148,-87992.08,127,21,575146.72,487154.63999999996
9203,U17031,148,-69828.04000000001,110,38,442452.82,372624.78
9204,U8988,148,9834.68,119,29,311387.49,321222.17
9205,U11654,148,-1018.2700000000036,106,42,113334.45999999999,112316.18999999999
9206,U24635,148,-39586.510000000024,101,47,827281.5800000001,787695.0700000001
9207,U28091,148,-15648.920000000015,136,12,87660.46,72011.54
9208,U31301,148,-4091.1500000000015,139,9,21773.719999999998,17682.569999999996
9209,U22163,148,47145.74000000002,122,26,293354.65,340500.39
9210,U43532,148,4828.05,130,18,104590.76999999999,109418.81999999999
9211,U13286,148,-23277.429999999964,96,52,5015011.06,4991733.63
9212,U11769,148,-78070.20000000003,122,26,423548.67,345478.47
9213,U22370,148,6378.939999999999,130,18,61572.54000000001,67951.48000000001
9214,U9321,148,15632.860000000013,107,41,182091.33999999994,197724.19999999995
9215,U21768,148,526.3900000000094,126,22,36987.040000000015,37513.43000000002
9216,U20527,148,-64497.440000000024,121,27,291968.32,227470.87999999998
9217,U748601,148,-469.72999999999996,89,59,9041.49,8571.76
9218,U16316,148,2116475.11,108,40,24812916.36,26929391.47
9219,U24636,148,-1222.5599999999977,137,11,81252.23000000001,80029.67000000001
9220,U25179,148,-43970.280000000006,131,17,71232.39,27262.109999999993
9221,U11837,148,15173.019999999997,127,21,210858.69,226031.71
9222,U10947,148,-1504.069999999998,136,12,18785.169999999995,17281.1
9223,U8763,148,-54176.15000000003,92,56,175706.7400000002,121530.59000000017
9224,U9352,148,-11895.56999999997,107,41,539740.5900000001,527845.0200000001
9225,U33835,148,-25059.2,138,10,64986.06999999999,39926.869999999995
9226,U20917,148,9085.350000000035,98,50,782923.5599999998,792008.9099999999
9227,U34440,148,-755.9699999999903,85,63,385510.86,384754.89
9228,U43347,148,4883.910000000007,117,31,133505.57,138389.48
9229,U17410,148,-5087.989999999999,132,16,99025.95000000001,93937.96
9230,U37517,148,330.2899999999904,128,20,129668.33000000002,129998.62000000001
9231,U14228,148,-4014.369999999969,111,37,1399132.2199999997,1395117.8499999999
9232,U16377,148,31915.22000000001,85,63,340098.74,372013.96
9233,U10510,148,-3219.0000000000036,131,17,66050.58,62831.58
9234,U29771,148,20616.390000000007,128,20,136772.95,157389.34000000003
9235,U32087,148,-599638.0900000002,126,22,1977884.1100000003,1378246.02
9236,U13480,148,-11366.67000000001,137,11,154295.02000000002,142928.35
9237,U9059,148,72963.23000000007,126,22,1718078.6399999997,1791041.8699999996
9238,U27670,148,2109.4900000000016,131,17,23281.949999999997,25391.44
9239,U35513,148,7783.450000000001,134,14,42494.490000000005,50277.94
9240,U1238786,148,-807.9399999999993,113,35,17577.11,16769.170000000002
9241,U17869,148,11636.970000000005,96,52,128532.87,140169.84
9242,U16833,148,195979.94999999995,137,11,1859286.99,2055266.94
9243,U43505,148,-297.0799999999999,141,7,15679.849999999999,15382.769999999999
9244,U34852,148,-680.2200000000021,129,19,50848.68000000001,50168.46000000001
9245,U42690,148,7343.71000000002,84,64,695490.9,702834.61
9246,U38911,148,2709.220000000001,131,17,104128.06000000001,106837.28000000001
9247,U43548,148,-45178.7,139,9,48104.579999999994,2925.8799999999974
9248,U17016,148,-57154.670000000006,126,22,413798.82000000007,356644.1500000001
9249,U12664,148,234528.96,138,10,388281.42,622810.38
9250,U22078,148,-4145.990000000003,105,43,185646.58,181500.59
9251,U36446,148,-1777.4999999999975,139,9,22805.480000000007,21027.98000000001
9252,U14893,148,-4628.0599999998885,133,15,269509.07,264881.0100000001
9253,U38631,148,-8774.609999999999,132,16,72274.99000000003,63500.380000000034
9254,U43061,148,5733.66,138,10,21152.02,26885.68
9255,U12011,148,11288.630000000001,132,16,28088.260000000002,39376.89
9256,U38137,148,663.7400000000005,140,8,31086.379999999997,31750.12
9257,U8833,148,-1819.469999999999,122,26,62903.490000000005,61084.020000000004
9258,U34043,148,7300.379999999979,105,43,570292.8400000001,577593.2200000001
9259,U24534,148,21178.86999999998,139,9,51305.03999999999,72483.90999999997
9260,U32054,148,1073.9800000000214,132,16,159961.24999999997,161035.22999999998
9261,U41281,148,-17281.4,132,16,54559.130000000034,37277.73000000003
9262,U25270,148,-1017.9499999999998,128,20,39635.46000000002,38617.510000000024
9263,U12847,148,658.549999999999,124,24,91147.57999999999,91806.12999999999
9264,U34070,148,4643.810000000003,129,19,29191.10000000001,33834.91000000001
9265,U29265,148,-18981.790000000055,108,40,2427187.04,2408205.25
9266,U8947,148,4848.389999999999,133,15,6204.56,11052.95
9267,U26457,148,-226953.40999999997,122,26,1098166.43,871213.02
9268,U42242,148,315.0599999999995,132,16,25646.129999999994,25961.189999999995
9269,U686245,148,2554.739999999997,94,54,98969.43999999999,101524.17999999998
9270,U31771,148,1794.499999999999,115,33,71930.22,73724.72
9271,U28034,148,5027.650000000011,118,30,442559.12999999995,447586.77999999997
9272,U11413,148,-65832.78000000003,119,29,647666.6999999997,581833.9199999997
9273,U15010,148,-34529.65999999991,132,16,99453.1799999999,64923.52
9274,U1163438,148,-1473.5799999999972,95,53,21857.399999999994,20383.819999999996
9275,U27445,148,-94211.38999999993,121,27,503840.95000000007,409629.5600000002
9276,U12968,148,152.5699999999888,121,27,91472.64999999998,91625.21999999997
9277,U31353,148,-72746.36000000003,126,22,436633.25999999995,363886.8999999999
9278,U27395,148,-7005.889999999947,100,48,743089.2799999997,736083.3899999998
9279,U11487,148,47117.509999999995,125,23,103036.34999999999,150153.86
9280,U17929,148,7762.88,126,22,120072.65000000001,127835.53000000001
9281,U26582,148,12111.610000000084,101,47,934540.3100000002,946651.9200000003
9282,U35438,148,-8466.520000000099,105,43,612599.03,604132.5099999999
9283,U9620,148,629.379999999994,130,18,104896.55000000003,105525.93000000002
9284,U9596,148,-1785.0900000000634,98,50,1567008.96,1565223.8699999999
9285,U15580,148,11987.219999999998,89,59,1294612.29,1306599.51
9286,U15225,148,-2108.5700000000024,133,15,30753.730000000003,28645.16
9287,U38243,148,39476.159999999996,118,30,100321.12,139797.28
9288,U27079,148,55027.60000000004,114,34,715098.2799999998,770125.8799999999
9289,U40618,148,5569.58,93,55,92157.13,97726.71
9290,U10511,148,14483.609999999999,133,15,28054.879999999997,42538.49
9291,U20003,148,-92103.57999999996,87,61,2678152.0,2586048.42
9292,U28542,147,5004.920000000002,138,9,10940.919999999998,15945.84
9293,U43570,147,52465.08000000001,107,40,611220.55,663685.63
9294,U14848,147,-54096.33,99,48,392094.2699999999,337997.9399999999
9295,U30188,147,20509.650000000052,124,23,973448.0800000001,993957.7300000001
9296,U14955,147,-53483.69000000002,131,16,405129.38000000006,351645.69000000006
9297,U41883,147,131178.42,129,18,236202.34999999995,367380.76999999996
9298,U14213,147,13479.899999999932,122,25,1489700.039999999,1503179.939999999
9299,U20455,147,3531.7300000000014,129,18,69846.28,73378.01
9300,U29617,147,-12174.450000000015,130,17,144154.96,131980.50999999998
9301,U40072,147,-2857.2999999999884,131,16,744287.1599999999,741429.8599999999
9302,U8393,147,1066.1700000000005,92,55,174931.23,175997.40000000002
9303,U22261,147,8338.509999999998,136,11,111867.35,120205.86
9304,U41728,147,65.34999999999985,132,15,19879.98,19945.329999999998
9305,U20119,147,-11738.74,117,30,310322.53,298583.79000000004
9306,U15889,147,53475.770000000004,118,29,105365.12000000001,158840.89
9307,U18648,147,-45143.53999999999,128,19,127872.73000000003,82729.19000000003
9308,U42840,147,131838.63,93,54,88438.79000000002,220277.42000000004
9309,U18947,147,-21265.699999999983,116,31,1167363.2899999993,1146097.5899999994
9310,U9858,147,-12726.220000000001,97,50,718618.4899999999,705892.2699999999
9311,U13679,147,66555.25000000006,138,9,932321.21,998876.46
9312,U40610,147,-50081.80000000002,79,68,1710171.1300000001,1660089.33
9313,U1376901,147,2145.67,115,32,53867.12,56012.79
9314,U41643,147,4064487.2,29,118,2565704.7699999996,6630191.97
9315,U35621,147,44135.659999999996,134,13,226383.33000000005,270518.99000000005
9316,U35898,147,3538.2700000000004,90,57,469291.62999999995,472829.89999999997
9317,U27143,147,7465.169999999913,109,38,624937.5800000001,632402.75
9318,U31815,147,27904.510000000006,98,49,77401.53000000003,105306.04000000004
9319,U16659,147,117364.76000000007,130,17,3024033.63,3141398.39
9320,U21527,147,50031.619999999995,108,39,164827.72,214859.34
9321,U32502,147,-710.7999999999997,110,37,383811.2,383100.4
9322,U17443,147,-947618.1199999996,114,33,2753855.4900000007,1806237.370000001
9323,U38109,147,11629.859999999997,85,62,169011.95999999996,180641.81999999995
9324,U41046,147,160311.40000000002,123,24,227403.26,387714.66000000003
9325,U27307,147,16924.829999999998,132,15,31780.540000000005,48705.37
9326,U30482,147,-37026.21000000001,94,53,107039.10999999997,70012.89999999997
9327,U36329,147,1143.9300000000035,133,14,182113.33999999997,183257.26999999996
9328,U41120,147,-2611.459999999997,137,10,51778.88000000001,49167.42000000001
9329,U14167,147,-113451.76999999999,118,29,312312.1699999999,198860.39999999994
9330,U42575,147,-4414.779999999999,114,33,41090.54000000001,36675.76000000001
9331,U8619,147,1167.0200000000068,112,35,138476.51000000004,139643.53000000006
9332,U18529,147,-2323.9600000000005,143,4,15296.369999999999,12972.409999999998
9333,U34984,147,1672.559999999994,127,20,163524.90999999997,165197.46999999997
9334,U30886,147,61097.37000000002,124,23,1746027.7499999998,1807125.1199999999
9335,U27848,147,25443.27999999991,97,50,9685654.14,9711097.42
9336,U20675,147,-18871.679999999997,135,12,193306.36999999997,174434.68999999997
9337,U9016,147,233531.11000000002,113,34,1506889.1199999992,1740420.2299999993
9338,U12959,147,-611761.1199999999,135,12,986556.9099999999,374795.79000000004
9339,U42511,147,-3642.739999999997,120,27,51309.95,47667.21
9340,U32593,147,30631.840000000004,108,39,367313.0999999999,397944.93999999994
9341,U10634,147,147166.62,124,23,562404.27,709570.89
9342,U39177,147,52452.429999999855,103,44,1232311.8900000001,1284764.32
9343,U32608,147,-3349.7000000000116,78,69,797208.4999999999,793858.7999999998
9344,U13714,147,-7644.509999999999,105,42,73849.85,66205.34000000001
9345,U37946,147,-310352.42999999993,112,35,5616726.859999999,5306374.43
9346,U16978,147,221592.31000000006,132,15,134897.50999999998,356489.82000000007
9347,U35454,147,1243.130000000005,109,38,105735.65,106978.78
9348,U27946,147,48237.20999999999,110,37,275707.91000000003,323945.12
9349,U21619,147,124909.41,134,13,385614.1,510523.51
9350,U15423,147,22825.700000000015,119,28,66148.45,88974.15000000001
9351,U36997,147,-442403.05000000005,117,30,1848718.62,1406315.57
9352,U1275782,147,5692.380000000003,87,60,239330.75000000003,245023.13000000003
9353,U22655,147,-2629.6199999999985,133,14,41875.73000000001,39246.110000000015
9354,U28426,147,-62612.560000000034,116,31,1114708.3800000001,1052095.82
9355,U27186,147,-43072.73000000001,115,32,488592.5000000001,445519.77000000014
9356,U24172,147,725493.62,106,41,12971907.820000002,13697401.440000001
9357,U13129,147,91043.94999999998,119,28,264836.17000000004,355880.12
9358,U15236,147,246469.93000000002,118,29,728310.5499999998,974780.4799999999
9359,U14404,147,4834.3499999999985,134,13,160477.09000000003,165311.44000000003
9360,U25681,147,-1579.080000000004,136,11,8263.090000000002,6684.009999999998
9361,U26997,147,-10452.90000000001,126,21,68121.54000000001,57668.64
9362,U14719,147,42213.6,137,10,128341.87999999998,170555.47999999998
9363,U20179,147,2500.4999999999854,126,21,186124.18999999997,188624.68999999994
9364,U32766,147,70956.70000000004,131,16,136678.24999999997,207634.95
9365,U12376,147,-267031.27999999997,69,78,1820716.9499999997,1553685.6699999997
9366,U40617,147,42251.59000000001,133,14,173689.83000000007,215941.4200000001
9367,U12183,147,-4913.29,98,49,436208.47999999986,431295.1899999999
9368,U32292,147,793.1899999999995,126,21,15844.519999999995,16637.709999999995
9369,U32231,147,-1310.9900000000198,104,43,896926.35,895615.36
9370,U31424,147,-36894.770000000004,141,6,79664.67,42769.899999999994
9371,U20464,147,7054.190000000003,137,10,74200.34000000001,81254.53000000001
9372,U28972,147,-472781.93,132,15,549656.9400000001,76875.01000000007
9373,U11637,147,6571.409999999996,137,10,43434.990000000005,50006.4
9374,U33153,147,-71717.39,122,25,152289.72999999998,80572.33999999998
9375,U28741,147,15834.449999999895,125,22,562082.9199999999,577917.3699999999
9376,U24263,147,19361.65999999999,129,18,105938.98000000001,125300.64
9377,U32323,147,19143.110000000048,93,54,430578.51000000007,449721.6200000001
9378,U42495,147,191.85000000000082,120,27,35893.83,36085.68
9379,U28419,147,-7474.199999999993,126,21,200152.01,192677.81000000003
9380,U38234,147,-10724.110000000004,125,22,118644.52999999994,107920.41999999994
9381,U33665,147,1634.1600000000017,131,16,239960.58000000002,241594.74000000002
9382,U41307,147,5632.28,114,33,165545.49000000002,171177.77000000002
9383,U41956,147,865.0400000000081,120,27,117560.45000000003,118425.49000000003
9384,U41102,147,-3501.8499999999913,117,30,423080.19999999995,419578.35
9385,U22896,147,1953.7599999999993,143,4,3146.640000000001,5100.4
9386,U30549,147,24635.780000000002,128,19,221090.28000000006,245726.06000000006
9387,U32248,147,-14427.929999999998,127,20,40302.23999999998,25874.309999999983
9388,U10053,147,-31541.709999999985,122,25,371951.12000000005,340409.4100000001
9389,U10406,147,-67758.04999999945,110,37,5104558.889999999,5036800.839999999
9390,U34452,147,62218.049999999974,115,32,200157.01,262375.06
9391,U40718,147,8122.959999999998,123,24,124046.27000000002,132169.23
9392,U41433,146,-2849.3599999999906,121,25,124287.47,121438.11000000002
9393,U38415,146,-1124.0500000000034,126,20,41736.7,40612.649999999994
9394,U26754,146,-4191.300000000038,133,13,221480.87,217289.56999999995
9395,U38799,146,-5015.349999999992,130,16,705943.2300000001,700927.8800000001
9396,U23747,146,29654.749999999953,125,21,405106.07,434760.81999999995
9397,U40651,146,-5954.99,134,12,22148.569999999996,16193.579999999996
9398,U37245,146,-28153.929999999993,80,66,320684.7900000001,292530.8600000001
9399,U28248,146,-35661.909999999945,130,16,394242.30999999994,358580.4
9400,U18996,146,93892.31000000004,111,35,1287852.6000000006,1381744.9100000006
9401,U28821,146,-33251.289999999964,98,48,1532391.3699999999,1499140.0799999998
9402,U9622,146,48260.129999999976,124,22,119706.51000000001,167966.63999999998
9403,U19279,146,40059.17999999996,116,30,665647.8800000001,705707.06
9404,U28711,146,-2114.020000000002,135,11,41840.14000000002,39726.12000000002
9405,U8412,146,31068.900000000016,86,60,313395.75,344464.65
9406,U15101,146,-106.64999999998145,80,66,1105917.4800000002,1105810.8300000003
9407,U42137,146,-15148.569999999962,115,31,463859.66999999987,448711.0999999999
9408,U25576,146,-848.7500000000036,93,53,155126.40999999992,154277.65999999992
9409,U30139,146,118904.66999999997,121,25,508987.3099999999,627891.9799999999
9410,U39980,146,-47785.700000000266,114,32,13732858.900000002,13685073.200000001
9411,U13592,146,27015.31000000041,103,43,24334690.609999996,24361705.919999994
9412,U41856,146,-32690.399999999987,94,52,719096.2899999997,686405.8899999997
9413,U22431,146,-130647.44999999998,135,11,443301.61,312654.16000000003
9414,U36322,146,6587.040000000074,102,44,2604807.06,2611394.1
9415,U1247234,146,1164.5299999999986,98,48,111472.54,112637.06999999999
9416,U13530,146,-96330.51,121,25,505178.83999999997,408848.32999999996
9417,U20227,146,951.5799999999992,116,30,53179.159999999974,54130.739999999976
9418,U37893,146,-26128.919999999976,114,32,768901.8100000002,742772.8900000002
9419,U28583,146,-2525.35,120,26,42903.46000000001,40378.11000000001
9420,U10022,146,284528.8400000001,126,20,2411533.3899999997,2696062.2299999995
9421,U39077,146,-4732.290000000008,77,69,591360.7099999998,586628.4199999998
9422,U21210,146,-41494.19000000002,135,11,571517.6900000002,530023.5000000001
9423,U30941,146,-15482.399999999994,141,5,48611.139999999985,33128.73999999999
9424,U24272,146,-13024.97,141,5,40665.560000000005,27640.590000000004
9425,U38885,146,-35651.240000000005,83,63,691762.0199999998,656110.7799999998
9426,U16436,146,-40448.94000000001,131,15,186925.15999999997,146476.21999999997
9427,U25395,146,1499.160000000013,111,35,200568.83,202067.99
9428,U24347,146,1967379.5500000003,131,15,1908792.9999999998,3876172.55
9429,U13582,146,43428.3,123,23,578978.62,622406.92
9430,U33229,146,14898.65,125,21,74967.85,89866.5
9431,U32809,146,-1330.2000000000014,107,39,48716.04,47385.84
9432,U8643,146,-13944.980000000252,108,38,4038655.3600000013,4024710.380000001
9433,U28165,146,-84817.85000000003,116,30,4721206.5600000005,4636388.710000001
9434,U43291,146,7555.209999999985,87,59,666283.8200000001,673839.03
9435,U33497,146,5398.96999999999,107,39,171472.64000000004,176871.61000000004
9436,U19734,146,4811.150000000003,133,13,131643.41999999998,136454.56999999998
9437,U35532,146,-7555.049999999977,118,28,1173561.7499999984,1166006.6999999983
9438,U34044,146,3956.37,111,35,141782.61000000004,145738.98000000004
9439,U17860,146,-21182.850000000006,134,12,95288.84,74105.98999999999
9440,U578932,146,148.50999999999976,138,8,5475.7699999999995,5624.279999999999
9441,U22617,146,-121047.31000000003,121,25,642983.7600000001,521936.45000000007
9442,U903302,146,-20348.03,77,69,52092.52000000001,31744.490000000013
9443,U8932,146,-3307.07,111,35,46125.380000000034,42818.310000000034
9444,U12979,146,-4319.069999999993,97,49,247272.03,242952.96
9445,U29272,146,530894.38,103,43,533825.86,1064720.24
9446,U28652,146,-10424.880000000003,135,11,75331.11999999998,64906.239999999976
9447,U27366,146,-11969.970000000016,124,22,80710.99000000002,68741.02
9448,U34896,146,-44492.939999999995,130,16,104094.94999999998,59602.00999999999
9449,U20682,146,1038.900000000031,103,43,230608.19999999998,231647.1
9450,U30948,146,-145285.55,91,55,917825.22,772539.6699999999
9451,U12796,146,-12699.380000000003,125,21,160842.08000000005,148142.70000000004
9452,U11588,146,-9385.269999999993,126,20,98834.23,89448.96
9453,U23508,146,-9981.980000000003,129,17,77457.93000000001,67475.95000000001
9454,U42639,146,18020.49,126,20,70919.66000000003,88940.15000000004
9455,U27446,146,-2279.9199999999864,106,40,244948.63000000003,242668.71000000005
9456,U40998,146,14516.939999999997,101,45,353381.9199999999,367898.8599999999
9457,U43467,146,753.1899999999996,129,17,13934.220000000003,14687.410000000003
9458,U11021,146,-7135.180000000069,130,16,2424668.150000001,2417532.9700000007
9459,U10514,146,-67472.48999999995,124,22,207294.63,139822.14000000007
9460,U18031,146,-10897.819999999998,135,11,26384.399999999998,15486.58
9461,U36397,146,23204.230000000003,115,31,271202.3,294406.52999999997
9462,U8904,146,-16266.139999999998,125,21,252965.24000000002,236699.10000000003
9463,U17753,146,-8362.250000000002,136,10,80476.09,72113.84
9464,U42259,146,25319.95,85,61,346809.69000000006,372129.6400000001
9465,U41676,146,-9804.45,121,25,561330.7500000003,551526.3000000004
9466,U36629,146,-2816.2499999999986,124,22,54362.439999999995,51546.189999999995
9467,U20671,146,-23711.19000000001,131,15,106932.85999999999,83221.66999999998
9468,U13920,146,-45962.530000000006,105,41,308883.51000000007,262920.98000000004
9469,U30755,146,7001.240000000004,117,29,65150.689999999995,72151.93
9470,U16054,146,-14397.960000000003,90,56,423715.53,409317.57
9471,U13297,146,-35285.21000000003,128,18,71786.85000000003,36501.64000000001
9472,U779817,145,1965.9299999999998,132,13,13197.300000000003,15163.230000000003
9473,U9919,145,9593.069999999996,126,19,135465.19,145058.26
9474,U14960,145,2477.3799999999555,122,23,299073.43,301550.80999999994
9475,U16871,145,-119407.7199999999,124,21,825046.63,705638.9100000001
9476,U33502,145,-3357.9899999999993,124,21,12582.189999999997,9224.199999999997
9477,U9253,145,-9595.280000000008,130,15,149281.98,139686.7
9478,U10996,145,-31020.929999999993,135,10,105703.35000000002,74682.42000000003
9479,U34711,145,2308.9500000000553,106,39,947032.54,949341.4900000001
9480,U8199,145,16061.229999999952,98,47,1324384.0799999996,1340445.3099999996
9481,U26101,145,-21164.3,130,15,28004.980000000003,6840.680000000004
9482,U39277,145,1932.4500000000016,126,19,23166.109999999993,25098.559999999994
9483,U12569,145,-3717.2400000000007,121,24,43612.81000000001,39895.570000000014
9484,U24500,145,3911.040000000002,121,24,137222.11000000002,141133.15000000002
9485,U37840,145,61534.29999999997,131,14,24399.359999999997,85933.65999999996
9486,U38020,145,-172.24000000000058,135,10,13172.730000000001,13000.490000000002
9487,U16815,145,17817.969999999994,106,39,160720.88999999996,178538.85999999996
9488,U19353,145,50929.32999999999,77,68,723729.9600000001,774659.29
9489,U8400,145,62139.35999999977,110,35,4670520.6899999995,4732660.049999999
9490,U31197,145,-6547.979999999991,131,14,123145.68000000001,116597.70000000001
9491,U614541,145,-25541.160000000003,94,51,88252.46000000002,62711.30000000002
9492,U20265,145,149233.87000000002,75,70,746054.5700000001,895288.4400000001
9493,U853435,145,818.3500000000009,98,47,28084.429999999997,28902.78
9494,U9154,145,-1253.5200000000295,94,51,349512.56999999995,348259.04999999993
9495,U9374,145,-35608.35999999998,120,25,306259.93999999994,270651.57999999996
9496,U39776,145,-36684.68000000001,125,20,77980.84999999995,41296.16999999994
9497,U16150,145,1325.4199999999926,110,35,216451.11000000004,217776.53000000003
9498,U36316,145,-9138.52999999996,113,32,605358.05,596219.5200000001
9499,U10601,145,-4212.330000000001,106,39,39345.420000000006,35133.090000000004
9500,U14391,145,-134.02999999997843,97,48,1286921.85,1286787.82
9501,U37661,145,12336.159999999998,135,10,22178.81999999999,34514.97999999999
9502,U39740,145,-2562.499999999998,112,33,49011.719999999994,46449.219999999994
9503,U13801,145,20317.02,111,34,376067.38000000006,396384.4000000001
9504,U40806,145,-16552.95,136,9,43190.89999999999,26637.949999999986
9505,U25082,145,-30712.329999999925,114,31,283212.65,252500.3200000001
9506,U22511,145,-483.15999999999116,119,26,270941.7199999999,270458.55999999994
9507,U25822,145,-65387.57,126,19,136615.22,71227.65
9508,U21656,145,-19751.14000000013,87,58,3887726.6899999995,3867975.5499999993
9509,U43330,145,-5340.719999999993,75,70,386176.68999999994,380835.97
9510,U26279,145,-7029.560000000001,131,14,182439.32,175409.76
9511,U11399,145,-217528.85,128,17,1211840.3100000003,994311.4600000003
9512,U11874,145,-3951.930000000003,130,15,26202.49000000001,22250.560000000005
9513,U18989,145,-29456.850000000024,123,22,168768.9,139312.04999999996
9514,U37229,145,-1490.9900000000043,126,19,315492.17,314001.18
9515,U1184974,145,-10324.309999999998,77,68,78004.62,67680.31
9516,U21637,145,1.1400000001513035,103,42,3550048.85,3550049.99
9517,U25031,145,-1761.2699999999952,119,26,38463.89,36702.62
9518,U26721,145,-14606.429999999988,131,14,297287.26,282680.83
9519,U30724,145,5043.629999999999,135,10,12511.220000000001,17554.85
9520,U37620,145,-7183.639999999996,140,5,13379.669999999996,6196.030000000001
9521,U41452,145,121784.89999999998,108,37,102653.64000000001,224438.53999999998
9522,U15144,145,-14210.15999999998,116,29,533289.71,519079.55
9523,U34416,145,-2614.64,128,17,13267.520000000002,10652.880000000003
9524,U15273,145,1387.3999999999958,108,37,84890.68999999997,86278.08999999997
9525,U42778,145,5804.030000000002,120,25,26242.960000000006,32046.99000000001
9526,U10228,145,-40752.63,114,31,701767.3,661014.67
9527,U23692,145,36941.619999999995,92,53,185914.50000000003,222856.12000000002
9528,U43070,145,9713.609999999991,104,41,234357.55000000002,244071.16
9529,U745106,145,-91252.91999999998,119,26,902712.87,811459.95
9530,U40113,145,-19626.83999999999,125,20,492181.29000000004,472554.45000000007
9531,U40180,145,-27932.760000000006,129,16,193726.04000000004,165793.28000000003
9532,U10141,145,7970.840000000001,138,7,77289.50999999998,85260.34999999998
9533,U12891,145,2873.879999999999,127,18,60055.60999999999,62929.48999999999
9534,U35237,145,2458.310000000006,125,20,127381.47999999998,129839.79
9535,U15799,145,15904.990000000005,129,16,75612.95999999999,91517.95
9536,U30186,145,-386.13000000000284,122,23,74051.13,73665.0
9537,U27632,145,385.39000000000846,87,58,246855.57999999996,247240.96999999997
9538,U36400,145,-2359.890000000004,124,21,76380.32,74020.43000000001
9539,U22583,145,-157850.5299999999,130,15,811212.97,653362.4400000001
9540,U36289,145,7081.349999999998,128,17,140776.9,147858.25
9541,U10200,145,29626.65999999993,105,40,694378.4899999999,724005.1499999998
9542,U13905,145,-180683.39,104,41,1522217.9800000002,1341534.5900000003
9543,U22777,145,-18227.670000000006,67,78,506689.23999999993,488461.56999999995
9544,U43636,145,3780.0000000000055,127,18,16849.36000000002,20629.360000000022
9545,U25971,145,1356.5500000000002,136,9,19875.75,21232.3
9546,U9508,145,-127301.10000000011,121,24,1654898.1699999995,1527597.0699999994
9547,U36726,145,19566.499999999996,132,13,63744.47000000001,83310.97
9548,U24950,145,-28179.120000000003,97,48,157479.06,129299.94
9549,U43931,145,1624.770000000004,135,10,20066.189999999995,21690.96
9550,U14735,145,55221.769999997545,82,63,38158538.37,38213760.13999999
9551,U11566,145,-26153.16999999999,128,17,235889.72999999998,209736.56
9552,U29517,145,-161597.44999999995,120,25,407987.2100000001,246389.76000000013
9553,U15656,145,-24109.500000000084,128,17,1280354.56,1256245.06
9554,U8437,145,2796.579999999998,111,34,52982.68999999998,55779.269999999975
9555,U13442,145,17266.719999999998,104,41,244214.21999999994,261480.93999999994
9556,U15626,145,-20151.539999999997,134,11,32513.87,12362.330000000002
9557,U33854,145,-395.93999999999994,141,4,5119.38,4723.4400000000005
9558,U16826,145,-1870.2800000000088,112,33,195607.7900000003,193737.5100000003
9559,U30190,145,37.540000000005875,64,81,76088.45000000001,76125.99000000002
9560,U31957,145,-82663.32999999999,133,12,697272.54,614609.2100000001
9561,U11085,145,-5373.91,138,7,16981.889999999996,11607.979999999996
9562,U14146,145,-18848.939999999995,104,41,342052.36000000004,323203.42000000004
9563,U19775,145,72.77000000006501,116,29,2260660.5300000003,2260733.3000000003
9564,U36326,145,5425.070000000003,93,52,96714.33999999998,102139.40999999999
9565,U17007,145,1639.7000000000007,135,10,49152.409999999996,50792.11
9566,U27488,145,15944.249999999995,129,16,69151.09,85095.34
9567,U18175,145,-5179.149999999994,133,12,186983.14,181803.99000000002
9568,U42871,144,5608.360000000003,130,14,32427.079999999998,38035.44
9569,U22415,144,-156992.72000000012,116,28,397534.9100000002,240542.1900000001
9570,U15524,144,22349.56000000029,127,17,9166194.530000001,9188544.090000002
9571,U32503,144,1227.1200000000063,110,34,397000.2899999999,398227.4099999999
9572,U21772,144,20349.99999999987,121,23,2648467.5200000005,2668817.5200000005
9573,U10758,144,-2417.3599999999924,45,99,239486.7,237069.34000000003
9574,U12537,144,1621.5399999999936,117,27,184238.71,185860.25
9575,U42131,144,45217.96999999998,115,29,106705.33000000002,151923.3
9576,U31111,144,-11687.399999999998,129,15,72598.06,60910.66
9577,U17219,144,-73858.75000000003,132,12,170984.75,97125.99999999997
9578,U41694,144,-18897.530000000002,137,7,56577.75000000002,37680.220000000016
9579,U38194,144,-200217.37999999995,124,20,1355546.81,1155329.4300000002
9580,U30080,144,-7654.46,80,64,276412.38,268757.92
9581,U33339,144,-10668.779999999997,124,20,86349.36,75680.58
9582,U18009,144,-5853.280000000002,115,29,213874.40000000002,208021.12000000002
9583,U25363,144,-2274225.2,114,30,4673300.28,2399075.08
9584,U9678,144,-1140.1400000000222,78,66,321562.19999999995,320422.05999999994
9585,U27432,144,3803.5300000000057,130,14,28464.579999999987,32268.109999999993
9586,U17109,144,-46800.85999999999,115,29,342129.22000000003,295328.36000000004
9587,U9496,144,1958.7900000000016,129,15,19139.690000000006,21098.480000000007
9588,U41858,144,-17837.410000000003,128,16,181582.37999999998,163744.96999999997
9589,U13540,144,6579.530000000006,137,7,98091.98999999999,104671.51999999999
9590,U14147,144,-4322.53,138,6,19334.450000000004,15011.920000000006
9591,U23012,144,160367.37999999998,121,23,335032.77,495400.15
9592,U34592,144,-11478.689999999993,133,11,46087.76999999999,34609.079999999994
9593,U26680,144,-14350.080000000002,133,11,77863.51000000001,63513.43000000001
9594,U41898,144,23632.499999999916,96,48,1214194.3299999998,1237826.8299999998
9595,U21469,144,-43185.35,105,39,258293.82,215108.47
9596,U24843,144,30475.72999999985,121,23,1567236.9399999997,1597712.6699999995
9597,U22295,144,-11663.040000000006,120,24,608359.2100000001,596696.17
9598,U37551,144,-86499.48000000003,105,39,443222.98,356723.49999999994
9599,U15001,144,-316422.1600000001,120,24,1291976.6500000001,975554.49
9600,U34694,144,1043948.35,117,27,1125961.45,2169909.8
9601,U19458,144,-35000.69000000001,120,24,107003.84000000001,72003.15
9602,U11060,144,3291.4000000000024,96,48,207634.32999999996,210925.72999999995
9603,U38292,144,37922.799999999916,133,11,596213.3,634136.1
9604,U35801,144,-20110.329999999998,98,46,242462.43000000002,222352.10000000003
9605,U8964,144,-3026.9000000000087,127,17,226942.66,223915.76
9606,U26470,144,4307.420000000002,130,14,37048.469999999994,41355.89
9607,U16810,144,-36273.6,114,30,48171.52999999999,11897.929999999993
9608,U28368,144,-3109.020000000008,128,16,146588.87000000005,143479.85000000003
9609,U35243,144,-1720.6699999999898,120,24,144741.30999999997,143020.63999999998
9610,U37114,144,97687.49,122,22,215315.5,313002.99
9611,U39158,144,4141.649999999984,111,33,175395.85999999996,179537.50999999995
9612,U25091,144,-6227.580000000008,111,33,82571.97999999997,76344.39999999997
9613,U19068,144,-85212.06999999996,119,25,512599.67,427387.60000000003
9614,U24034,144,15538.569999999994,138,6,20597.399999999994,36135.96999999999
9615,U31246,144,-22523.200000000004,95,49,171170.88999999998,148647.68999999997
9616,U38363,144,-46634.11000000002,76,68,641986.63,595352.52
9617,U23552,144,24307.880000000005,96,48,936539.95,960847.83
9618,U25340,144,76591.51000000002,135,9,213213.86,289805.37
9619,U38984,144,-8744.509999999997,131,13,44679.8,35935.29000000001
9620,U19572,144,-6671.45,100,44,122242.07000000002,115570.62000000002
9621,U43641,144,-4195.2,117,27,33030.69,28835.49
9622,U15921,144,-60246.72999999993,126,18,522508.5499999999,462261.81999999995
9623,U8233,144,-18778.620000000028,135,9,279155.70000000007,260377.08000000005
9624,U25968,144,-2724.0999999999963,113,31,77848.79000000001,75124.69000000002
9625,U14093,144,-15694.969999999994,103,41,389881.89999999997,374186.93
9626,U20976,144,-9711.700000000015,132,12,354065.41000000003,344353.71
9627,U24804,144,-1604.409999999999,134,10,15798.89,14194.48
9628,U26733,144,-3170.5700000000093,123,21,271529.46,268358.89
9629,U43143,144,1026.3500000000017,116,28,28228.569999999996,29254.92
9630,U32315,144,-1378.4699999999866,108,36,397738.30000000005,396359.8300000001
9631,U36743,144,-4667.250000000003,124,20,164995.49999999994,160328.24999999994
9632,U37742,144,-104.98000000000047,129,15,13750.349999999991,13645.369999999992
9633,U29820,144,-532.7399999998161,122,22,2220741.8799999985,2220209.1399999987
9634,U17483,144,-280446.72000000003,113,31,836269.4100000001,555822.6900000002
9635,U40542,144,-36397.93999999999,133,11,53986.330000000016,17588.39000000003
9636,U34335,144,-7742.12,130,14,52279.92000000001,44537.80000000001
9637,U44057,144,-18217.72999999998,126,18,74766.34999999999,56548.62000000001
9638,U14914,144,-5607.8099999999795,60,84,152451.15999999997,146843.35
9639,U39332,144,-1970.8600000000042,115,29,90391.92000000001,88421.06000000001
9640,U40668,144,-13626.109999999982,129,15,245271.91999999998,231645.81
9641,U19516,144,32800.64999999998,117,27,1003186.05,1035986.7000000001
9642,U26510,144,3551.709999999998,126,18,14064.499999999998,17616.209999999995
9643,U12196,144,-618.7700000000004,127,17,44150.37,43531.600000000006
9644,U27475,144,43642.150000000096,135,9,1275422.25,1319064.4000000001
9645,U41754,144,4542.909999999997,125,19,97619.09000000001,102162.00000000001
9646,U14590,144,29724.049999999992,80,64,59225.32,88949.37
9647,U37132,144,-6037.530000000001,132,12,36209.54,30172.010000000002
9648,U22426,144,12682.359999999993,126,18,133452.58,146134.93999999997
9649,U42150,144,19527.38,134,10,31861.399999999998,51388.78
9650,U14356,144,-48821.999999999985,116,28,482705.98000000004,433883.98000000004
9651,U38736,144,1058.490000000048,73,71,951124.1300000002,952182.6200000002
9652,U39747,144,192297.19999999992,113,31,3053054.3999999994,3245351.599999999
9653,U12223,144,275047.52000000025,88,56,7856541.6,8131589.12
9654,U30721,144,8290.019999999997,127,17,64922.82,73212.84
9655,U28077,144,-245.1999999999989,119,25,42347.75,42102.55
9656,U1188206,144,-307.2199999999998,85,59,30453.559999999998,30146.339999999997
9657,U21634,144,12863.320000000043,116,28,752477.4000000004,765340.7200000004
9658,U42753,144,1106.9199999999814,117,27,988260.6,989367.5199999999
9659,U30560,144,-1085830.19,75,69,20818683.3,19732853.11
9660,U27431,144,-9401.029999999999,133,11,25940.149999999998,16539.12
9661,U34720,143,-32284.06999999999,133,10,219407.20999999996,187123.13999999998
9662,U20286,143,-180503.45999999993,105,38,928518.2899999998,748014.8299999998
9663,U31619,143,49513.30999999998,113,30,500459.91000000003,549973.22
9664,U17446,143,5134.869999999999,119,24,256813.66999999993,261948.53999999992
9665,U38352,143,-33881.95000000004,86,57,628061.4600000001,594179.51
9666,U15342,143,-324.31999999999954,67,76,18579.010000000006,18254.690000000006
9667,U31390,143,-342006.13,116,27,1016466.5199999999,674460.3899999999
9668,U24359,143,-89550.62999999999,98,45,633569.9700000001,544019.3400000001
9669,U11203,143,-4728.449999999999,125,18,52019.200000000004,47290.75000000001
9670,U42073,143,4067.8,126,17,55087.369999999995,59155.17
9671,U28345,143,6477.400000000007,130,13,29004.480000000003,35481.88000000001
9672,U41542,143,50898.47,123,20,133580.1499999999,184478.6199999999
9673,U28900,143,-9549.179999999997,120,23,160691.86,151142.68
9674,U33407,143,-23050.9,119,24,180142.07,157091.17
9675,U21024,143,-10511.649999999998,127,16,59954.40999999999,49442.759999999995
9676,U37509,143,-2531.1900000000005,91,52,12866.329999999996,10335.139999999996
9677,U33686,143,12588.76000000001,95,48,755266.5700000001,767855.3300000001
9678,U37665,143,159829.94000000003,133,10,112811.62999999999,272641.57
9679,U18735,143,45479.600000000035,112,31,167935.15000000002,213414.75000000006
9680,U22980,143,-8569.849999999511,134,9,8131319.889999999,8122750.039999999
9681,U37504,143,43654.040000000045,105,38,639813.3300000001,683467.3700000001
9682,U14847,143,-8335.339999999998,130,13,89177.87000000004,80842.53000000004
9683,U24328,143,27592.210000000025,98,45,272958.45,300550.66000000003
9684,U41795,143,-681.4599999999978,136,7,37491.45,36809.99
9685,U42586,143,-4914.529999999985,90,53,143017.22,138102.69
9686,U28163,143,-18568.499999999985,120,23,121720.84000000004,103152.34000000005
9687,U19791,143,309234.4999999999,126,17,222091.61999999968,531326.1199999995
9688,U12514,143,-4021.03,126,17,29657.719999999994,25636.689999999995
9689,U32542,143,17409.629999999997,92,51,267225.73,284635.36
9690,U1314499,143,81.69000000000233,89,54,27310.6,27392.29
9691,U24483,143,-403697.22999999975,106,37,962254.13,558556.9000000003
9692,U29778,143,6450.390000000005,133,10,46507.27,52957.66
9693,U24629,143,-4522.079999999972,124,19,915473.78,910951.7000000001
9694,U38310,143,-30599.07999999999,130,13,151758.67,121159.59000000003
9695,U8274,143,-32927.58,116,27,141063.81,108136.23
9696,U24961,143,-106384.74000000009,128,15,1436588.1699999997,1330203.4299999997
9697,U29074,143,-2666.419999999998,113,30,37956.78000000001,35290.360000000015
9698,U13606,143,71978.32000000059,120,23,11647115.030000001,11719093.350000001
9699,U25248,143,15441.130000000003,134,9,36312.000000000015,51753.13000000002
9700,U19974,143,-15805.539999999995,130,13,179329.76999999984,163524.22999999984
9701,U40875,143,42156.92000000001,109,34,76539.84999999999,118696.77
9702,U30375,143,-1624.7700000000004,123,20,60636.000000000015,59011.23000000001
9703,U28956,143,13230.840000000002,134,9,23407.96,36638.8
9704,U12600,143,-4841.769999999998,118,25,155971.37000000002,151129.60000000003
9705,U37535,143,4296.009999999996,130,13,28711.929999999982,33007.93999999998
9706,U40977,143,-24199.200000000004,107,36,270334.64999999997,246135.44999999995
9707,U31980,143,-8749.410000000007,112,31,73588.45000000001,64839.04000000001
9708,U18406,143,9807.300000000005,105,38,80482.51000000001,90289.81000000001
9709,U20058,143,336630.56999999995,127,16,314246.12000000005,650876.69
9710,U23123,143,-16365.51999999999,126,17,270890.8,254525.28
9711,U26792,143,-428.44,134,9,5812.029999999999,5383.589999999999
9712,U16641,143,-7944.679999999995,94,49,574621.8300000001,566677.15
9713,U26064,143,4368.719999999986,120,23,205479.38,209848.09999999998
9714,U17470,143,-56729.21000000021,113,30,6505322.300000001,6448593.090000001
9715,U22133,143,97641.15999999992,132,11,203190.61000000004,300831.76999999996
9716,U33998,143,7100.2699999999995,101,42,778195.8000000003,785296.0700000003
9717,U25134,143,-145110.16999999998,113,30,555016.44,409906.26999999996
9718,U25176,143,-4595.930000000002,80,63,596307.05,591711.12
9719,U13990,143,63888.51999999996,87,56,1000866.7799999999,1064755.2999999998
9720,U13346,143,32283.7800000001,127,16,287137.219999999,319420.99999999907
9721,U30089,143,-9196.319999999994,124,19,120211.47,111015.15000000001
9722,U26913,143,-106057.49999999999,117,26,393783.65,287726.15
9723,U43011,143,-11615.839999999998,127,16,65141.24999999999,53525.409999999996
9724,U22660,143,-34337.810000000005,133,10,45332.860000000015,10995.05000000001
9725,U34266,143,-6269.880000000012,128,15,323647.35999999987,317377.47999999986
9726,U42245,143,-33108.07000000002,103,40,927612.6100000001,894504.54
9727,U12995,143,-53492.43999999997,94,49,1588530.34,1535037.9000000001
9728,U10086,143,23426.80000000006,92,51,2548578.589999998,2572005.3899999983
9729,U40106,143,160437.43,113,30,201887.83999999997,362325.26999999996
9730,U14028,143,1209.149999999987,35,108,246267.14000000004,247476.29000000004
9731,U39470,143,742836.0299999998,115,28,3753475.6800000006,4496311.710000001
9732,U10386,143,-16881.849999999995,121,22,806920.93,790039.0800000001
9733,U40686,143,-5275.069999999997,128,15,41059.95000000001,35784.88000000001
9734,U20866,143,4700.129999999999,101,42,247884.91000000003,252585.04000000004
9735,U11288,143,154370.63999999998,75,68,399075.0,553445.64
9736,U25197,143,-2430.510000000001,129,14,42066.78,39636.27
9737,U21836,143,7557.179999999986,100,43,316259.44000000006,323816.62000000005
9738,U16681,142,7711.830000000003,132,10,33308.67,41020.5
9739,U14648,142,700.00999999999,123,19,329824.09000000014,330524.10000000015
9740,U39319,142,12311.779999999992,124,18,120315.92000000001,132627.7
9741,U26052,142,2709.780000000009,69,73,51465.439999999995,54175.22
9742,U19046,142,16966.140000000003,131,11,52467.83000000003,69433.97000000003
9743,U28166,142,-462.7099999999991,117,25,54495.36,54032.65
9744,U33769,142,14378.439999999995,112,30,67743.68000000001,82122.12
9745,U13471,142,144752.31999999972,106,36,2553242.910000001,2697995.230000001
9746,U19664,142,-331.0999999999999,138,4,9276.49,8945.39
9747,U22250,142,-4097.58999999999,113,29,124425.95,120328.36
9748,U1168129,142,-19764.339999999993,86,56,69816.93,50052.59
9749,U22889,142,-709.6800000000059,127,15,21251.16000000001,20541.480000000003
9750,U28784,142,78766.6,122,20,324722.25000000006,403488.8500000001
9751,U11194,142,-17986.529999999984,124,18,234919.34000000003,216932.81000000006
9752,U35924,142,-20520.090000000004,85,57,383210.26,362690.17
9753,U19063,142,36524.29999999991,118,24,2464367.43,2500891.73
9754,U42708,142,-855.5,139,3,5542.2,4686.7
9755,U16030,142,-2613.5800000000163,109,33,341592.7400000001,338979.1600000001
9756,U31135,142,47740.03,133,9,33929.29,81669.32
9757,U42325,142,19522.52,71,71,660446.46,679968.98
9758,U16490,142,133.2000000000004,115,27,29932.489999999998,30065.69
9759,U22201,142,9911.760000000017,112,30,257269.39,267181.15
9760,U25377,142,17639.43999999959,95,47,3696109.0199999996,3713748.459999999
9761,U10422,142,28898.479999999985,130,12,64271.09000000002,93169.57
9762,U20023,142,207.1199999999999,109,33,25247.839999999997,25454.959999999995
9763,U9614,142,-430637.77,129,13,1691310.0600000005,1260672.2900000005
9764,U32064,142,1533.5500000000004,121,21,18088.62,19622.17
9765,U39914,142,675.7099999999987,126,16,19903.790000000005,20579.500000000004
9766,U20820,142,-15759.510000000002,72,70,706480.3,690720.79
9767,U18549,142,453.78000000000975,106,36,122374.64,122828.42000000001
9768,U608180,142,6716.32,101,41,34487.92999999999,41204.24999999999
9769,U12374,142,-620.1799999999998,122,20,33595.59,32975.409999999996
9770,U8500,142,-11632.470000000008,103,39,785631.67,773999.2000000001
9771,U40471,142,-5782.960000000001,116,26,64225.799999999996,58442.84
9772,U35690,142,-28660.89000000001,130,12,78692.69,50031.79999999999
9773,U40080,142,-171168.53000000035,120,22,2286292.289999999,2115123.759999999
9774,U26423,142,137524.91999999998,116,26,365922.51,503447.43
9775,U43540,142,903.78,136,6,1647.1799999999998,2550.96
9776,U16894,142,-23328.170000000013,65,77,2622528.2200000007,2599200.0500000007
9777,U25605,142,6641.740000000003,119,23,201099.86,207741.59999999998
9778,U25702,142,2495.399999999999,117,25,111539.33,114034.73
9779,U24580,142,32113.62000000011,120,22,281953.01,314066.6300000001
9780,U24420,142,76.7100000000064,87,55,66856.46,66933.17000000001
9781,U883769,142,-17518.13,104,38,25772.65,8254.52
9782,U29051,142,-3449.869999999981,77,65,956197.5300000003,952747.6600000003
9783,U9587,142,-46001.4,83,59,518490.5800000001,472489.18000000005
9784,U43437,142,4920.6399999999985,136,6,16865.41,21786.05
9785,U1166131,142,-938.8299999999983,103,39,31861.490000000005,30922.660000000007
9786,U35729,142,1588.6200000000003,135,7,13735.529999999999,15324.15
9787,U9409,142,-9327.35000000001,136,6,40000.97,30673.61999999999
9788,U42369,142,-17694.87,133,9,46306.310000000005,28611.440000000006
9789,U10753,142,22404.960000000043,95,47,885569.7300000001,907974.6900000002
9790,U28267,142,-5747.240000000009,88,54,629500.2699999998,623753.0299999998
9791,U22029,142,-322.40000000000725,126,16,63888.19000000001,63565.79
9792,U28984,142,-149.35000000000025,136,6,16998.7,16849.350000000002
9793,U17407,142,-426199.9799999999,129,13,523799.7299999999,97599.75
9794,U42406,142,-9815.76,123,19,119278.34,109462.58
9795,U24900,142,3291.4599999999746,111,31,168180.71000000002,171472.16999999998
9796,U11381,142,-11620.070000000032,95,47,2444131.7500000005,2432511.6800000006
9797,U25907,142,687.8200000000227,119,23,303794.50000000006,304482.32000000007
9798,U32316,142,-209309.82999999975,78,64,3522110.9700000016,3312801.140000002
9799,U15907,142,49017.11000000001,130,12,42174.36000000001,91191.47000000002
9800,U21212,142,-10545.140000000007,123,19,125782.02,115236.88
9801,U24177,142,-60860.289999999986,87,55,159805.57,98945.28000000003
9802,U21712,142,-18937.370000000003,121,21,60337.439999999995,41400.06999999999
9803,U797279,142,-55.229999999995016,97,45,98062.20999999999,98006.98
9804,U30271,142,23364.5,121,21,335363.31,358727.81
9805,U34687,142,-21975.030000000013,88,54,709520.02,687544.99
9806,U30300,142,-33969.03,43,99,257915.03,223946.0
9807,U27292,142,43464.870000000024,122,20,243569.20999999993,287034.07999999996
9808,U19754,142,-618.6400000000049,114,28,109539.11999999995,108920.47999999995
9809,U22772,142,-1395733.119999999,115,27,3154822.6499999994,1759089.5300000005
9810,U9718,142,-9792.079999999998,56,86,463566.56,453774.48
9811,U43635,142,2234.669999999991,115,27,127315.74000000002,129550.41
9812,U21672,142,-1180.88,138,4,10759.8,9578.919999999998
9813,U23314,142,-46732.559999998935,101,41,9845003.930000003,9798271.370000005
9814,U11084,142,591.7499999999974,40,102,220190.0,220781.75
9815,U34574,142,18805.850000000013,122,20,227580.66999999998,246386.52
9816,U34749,142,80.12000000000148,100,42,70878.58,70958.7
9817,U20049,142,75556.43000000002,128,14,179588.02999999994,255144.45999999996
9818,U33216,142,32275.040000000037,129,13,374911.5299999999,407186.56999999995
9819,U28748,142,-799.4699999999939,131,11,96792.20999999999,95992.73999999999
9820,U21423,142,9239.999999999998,129,13,15731.71,24971.71
9821,U31036,141,-1025.2099999999991,122,19,67029.71000000005,66004.50000000006
9822,U24399,141,-18172.05999999992,91,50,567001.4,548829.3400000001
9823,U40727,141,137564.04,113,28,566887.5499999998,704451.5899999999
9824,U30055,141,41004.350000000006,121,20,192547.06,233551.41
9825,U38640,141,-548.2600000000011,131,10,84676.08999999997,84127.82999999997
9826,U16861,141,-31145.839999999993,128,13,96961.08000000002,65815.24000000002
9827,U23059,141,11451.729999999978,126,15,149793.65999999997,161245.38999999996
9828,U1235721,141,836.380000000001,127,14,15530.669999999998,16367.05
9829,U24709,141,0.4400000000023283,88,53,187212.12,187212.56
9830,U24193,141,-84123.24,130,11,180604.94999999995,96481.70999999995
9831,U31306,141,1489.4100000000162,114,27,155633.11000000002,157122.52000000002
9832,U19454,141,1009.9099999999909,86,55,2711618.2200000007,2712628.130000001
9833,U40089,141,28736.499999999913,118,23,1568712.6099999999,1597449.1099999999
9834,U16501,141,10855.610000000002,93,48,78126.28000000001,88981.89000000001
9835,U13003,141,51458.03999999998,67,74,874715.76,926173.8
9836,U32365,141,-108775.52999999998,109,32,405644.61000000004,296869.0800000001
9837,U31370,141,-17492.54999999999,124,17,302289.0899999999,284796.5399999999
9838,U43783,141,-7657.939999999991,109,32,64261.14000000007,56603.200000000084
9839,U27714,141,-7989.650000000009,117,24,406376.32000000007,398386.67000000004
9840,U28457,141,2062.100000000003,112,29,97601.09000000003,99663.19000000003
9841,U24928,141,-1161609.7999999998,107,34,1997225.9799999997,835616.1799999999
9842,U14299,141,99230.56000000001,131,10,18462.610000000004,117693.17000000001
9843,U10217,141,75093.71000000008,125,16,772016.7400000001,847110.4500000002
9844,U27618,141,12482.859999999993,128,13,103803.14000000001,116286.0
9845,U29760,141,12893.240000000003,129,12,69591.31000000003,82484.55000000003
9846,U23452,141,8998.110000000004,130,11,43171.36,52169.47
9847,U23831,141,-17988.129999999997,123,18,44760.969999999994,26772.839999999997
9848,U20126,141,-969.4399999999929,120,21,50108.6,49139.16
9849,U12861,141,104.7499999999784,113,28,159556.80000000002,159661.55
9850,U26218,141,70552.34,134,7,98218.78999999998,168771.12999999998
9851,U13370,141,826717.13,130,11,107792.93,934510.06
9852,U11299,141,-50196.950000000026,130,11,79233.43000000001,29036.47999999998
9853,U27212,141,-199854.63999999972,120,21,3764525.8899999964,3564671.2499999967
9854,U17037,141,118072.67999999993,91,50,1534971.4200000002,1653044.1
9855,U8229,141,-6930.59000000001,121,20,132280.25,125349.65999999999
9856,U42203,141,3270.0800000000017,100,41,255576.7,258846.78000000003
9857,U24274,141,846.440000000001,124,17,18958.13,19804.570000000003
9858,U37341,141,-3653.4500000000003,127,14,17926.89,14273.439999999999
9859,U36077,141,1178.900000000047,121,20,143212.97999999995,144391.88
9860,U1090928,141,-375.43999999999943,104,37,16953.31,16577.870000000003
9861,U25878,141,2622422.3599999994,101,40,5401714.85,8024137.209999999
9862,U43108,141,-78526.95000000003,96,45,849463.9999999999,770937.0499999998
9863,U39864,141,-95866.29999999999,132,9,124757.27,28890.970000000016
9864,U26679,141,-9234.57,132,9,46910.29,37675.72
9865,U33038,141,46850.42999999998,103,38,314821.91,361672.33999999997
9866,U14159,141,-659.8000000000006,120,21,11369.580000000002,10709.78
9867,U10489,141,-93511.58,118,23,749934.7200000001,656423.1400000001
9868,U26235,141,23487.07,134,7,29014.310000000005,52501.380000000005
9869,U15211,141,249245.82000000004,108,33,1285138.8399999996,1534384.6599999997
9870,U11061,141,29882.069999999996,119,22,108482.08000000002,138364.15000000002
9871,U29642,141,-526.3099999999981,113,28,33700.19000000002,33173.88000000002
9872,U41093,141,15571.300000000007,125,16,65001.150000000016,80572.45000000003
9873,U11745,141,4150.699999999967,104,37,860866.43,865017.13
9874,U15643,141,-52560.960000000014,109,32,1534239.1900000002,1481678.2300000002
9875,U40398,141,304348.12000000005,109,32,3673763.66,3978111.7800000003
9876,U21272,141,-2282.7199999999993,64,77,263139.14999999997,260856.42999999996
9877,U8768,141,-1729.4100000000021,123,18,101695.44000000002,99966.03000000001
9878,U39561,141,-226057.47999999998,129,12,231498.57,5441.090000000026
9879,U30497,141,12030.109999999991,120,21,376726.8599999999,388756.9699999999
9880,U12426,141,-4452.829999999996,133,8,28025.82,23572.990000000005
9881,U43401,141,8873.820000000003,115,26,188278.15999999995,197151.97999999995
9882,U10735,141,-1741.5299999999813,115,26,443353.9100000001,441612.3800000001
9883,U29416,141,2935.4699999999975,126,15,63599.25999999999,66534.72999999998
9884,U18749,141,-2953.1499999999987,110,31,121079.91000000002,118126.76000000002
9885,U43400,141,-46721.710000000036,118,23,199677.17999999993,152955.4699999999
9886,U38290,141,272419.57,124,17,78287.61000000002,350707.18000000005
9887,U15801,141,-6944.190000000103,125,16,1030807.4300000004,1023863.2400000003
9888,U42938,141,-577.2999999999994,114,27,23736.159999999996,23158.859999999997
9889,U28472,141,29330.259999999955,99,42,864915.6900000002,894245.9500000002
9890,U16858,141,-8208.96999999996,95,46,1894160.1200000008,1885951.1500000008
9891,U36430,141,-31044.350000000002,111,30,64118.590000000004,33074.240000000005
9892,U19538,141,3154.1600000000053,124,17,100429.91,103584.07
9893,U11334,141,8642.590000000433,94,47,4721997.84,4730640.430000001
9894,U41126,141,2615.5699999999997,120,21,55279.990000000005,57895.560000000005
9895,U25265,141,23014.920000000013,90,51,1432685.18,1455700.0999999999
9896,U26346,141,10963.089999999991,119,22,101832.01999999999,112795.10999999999
9897,U15228,141,-27668.67,137,4,40485.57,12816.900000000001
9898,U34622,141,27279.360000000026,118,23,356566.55999999994,383845.92
9899,U8167,141,44992.04999999999,129,12,62910.59000000001,107902.64
9900,U19588,141,-10099.619999999903,87,54,8440051.829999998,8429952.209999999
9901,U1161174,141,-182.50999999998749,102,39,62792.43999999999,62609.93
9902,U33505,141,23211.96999999998,113,28,620481.9800000002,643693.9500000002
9903,U14182,141,-13719.789999999975,125,16,117880.31,104160.52000000002
9904,U8887,141,62518.20000000004,123,18,1204899.6700000002,1267417.87
9905,U13043,141,4282.860000000008,91,50,135788.94000000003,140071.80000000005
9906,U35555,141,16961.36999999998,97,44,346433.81000000006,363395.18000000005
9907,U9102,141,-20162.040000000005,91,50,298108.9,277946.86000000004
9908,U36087,141,-8755.12000000021,111,30,2933089.64,2924334.52
9909,U42625,141,2314.0799999999986,127,14,25551.560000000005,27865.640000000003
9910,U41497,140,-36931.63999999999,58,82,448903.14999999997,411971.50999999995
9911,U12137,140,-78969.16999999897,99,41,7053332.479999998,6974363.309999999
9912,U19045,140,-1322.5000000000005,135,5,8462.2,7139.700000000001
9913,U19367,140,65887.64999999988,94,46,1471719.55,1537607.2
9914,U42577,140,1143.840000000007,113,27,254947.44999999995,256091.28999999995
9915,U26434,140,4275.620000000002,133,7,42794.5,47070.12
9916,U35204,140,-11939.059999999998,124,16,180862.01,168922.95
9917,U24231,140,-12925.609999999999,93,47,286806.92,273881.31
9918,U745475,140,179.26999999999924,95,45,29130.390000000003,29309.660000000003
9919,U589440,140,1379.2900000000038,95,45,44630.520000000004,46009.810000000005
9920,U14113,140,5290.2400000000025,111,29,179554.30000000002,184844.54
9921,U14324,140,22507.910000000003,133,7,53647.229999999996,76155.14
9922,U39442,140,-266701.64,107,33,725431.94,458730.29999999993
9923,U43984,140,788.6599999999999,70,70,59659.659999999996,60448.31999999999
9924,U31234,140,3320.4399999999937,132,8,51257.61,54578.049999999996
9925,U32774,140,-101478.46,116,24,228430.41999999995,126951.95999999995
9926,U34837,140,-2710.2299999999987,130,10,19751.65,17041.420000000002
9927,U24559,140,37947.06999999997,113,27,124336.13000000003,162283.2
9928,U641235,140,-555.8700000000078,83,57,128234.61,127678.73999999999
9929,U29100,140,131240.24999999985,110,30,945036.13,1076276.38
9930,U18391,140,-21026.07,133,7,52368.509999999995,31342.439999999995
9931,U16498,140,7932.419999999997,129,11,76151.98999999999,84084.40999999999
9932,U30210,140,27990.89000000001,125,15,304142.94000000006,332133.8300000001
9933,U41974,140,1727.4800000000005,125,15,22779.739999999998,24507.219999999998
9934,U15366,140,-6461.370000000002,82,58,136465.23,130003.86000000002
9935,U20559,140,-232.57999999999774,97,43,224807.48000000007,224574.90000000008
9936,U39784,140,-19906.04999999999,88,52,467455.0,447548.95
9937,U8121,140,-5012.560000000001,131,9,16712.66999999999,11700.10999999999
9938,U25529,140,11258.32000000001,122,18,167681.27000000005,178939.59000000005
9939,U10795,140,-11883.969999999976,98,42,287456.42,275572.45
9940,U8250,140,-15362.739999999996,118,22,119468.01000000001,104105.27000000002
9941,U40873,140,7652.4499999999825,119,21,85662.33000000002,93314.78
9942,U34294,140,18940.339999999986,130,10,204913.52,223853.86
9943,U15413,140,-16194.950000000008,105,35,411883.7299999999,395688.7799999999
9944,U31966,140,-10552.670000000002,124,16,71842.40999999997,61289.739999999976
9945,U39825,140,4664.990000000002,122,18,16856.76,21521.75
9946,U26674,140,-2024.8300000000006,129,11,14141.079999999998,12116.249999999998
9947,U13173,140,-475525.5000000002,98,42,2987165.62,2511640.12
9948,U36975,140,-8462.039999999997,138,2,9468.189999999997,1006.1499999999996
9949,U27019,140,7885.859999999986,110,30,90763.93999999999,98649.79999999997
9950,U40586,140,44756.840000000004,111,29,926418.9599999998,971175.7999999998
9951,U12897,140,-10566.49999999999,100,40,635483.4200000005,624916.9200000005
9952,U17590,140,-175882.27000000005,100,40,905599.5800000003,729717.3100000003
9953,U12387,140,-2114.2299999999996,123,17,14701.999999999998,12587.769999999999
9954,U39274,140,47530.43999999996,91,49,154588.69,202119.12999999995
9955,U18506,140,14825.810000000001,126,14,19116.08,33941.89
9956,U21603,140,-7950.549999999998,130,10,60343.29000000001,52392.74000000001
9957,U37523,140,2143.620000000003,125,15,15781.910000000002,17925.530000000006
9958,U25912,140,-397.3000000000004,127,13,25920.170000000002,25522.870000000003
9959,U25430,140,-821.9199999999994,128,12,26020.45,25198.530000000002
9960,U15335,140,12711.120000000003,105,35,112336.83999999998,125047.95999999999
9961,U16857,140,-28419.030000000017,119,21,429795.42000000016,401376.39000000013
9962,U37585,140,-147.86000000000132,105,35,389062.2800000001,388914.4200000001
9963,U9821,140,-5727.129999999993,127,13,33325.71000000001,27598.580000000013
9964,U29751,140,2750.8299999999967,119,21,1863663.2399999998,1866414.0699999998
9965,U30530,140,-22511.63,128,12,96138.24999999999,73626.61999999998
9966,U8446,140,-7511.030000000003,121,19,91016.93,83505.9
9967,U43937,140,65131.51000000002,91,49,434326.36999999994,499457.87999999995
9968,U22974,140,-30399.61999999998,120,20,1191838.6000000006,1161438.9800000007
9969,U21378,140,-98.43000000000362,102,38,325298.52999999997,325200.1
9970,U28586,140,1568.5000000000043,70,70,210299.91999999998,211868.41999999998
9971,U38391,140,-34601.53,126,14,62911.98,28310.450000000004
9972,U12274,140,183.12000000001973,118,22,61640.74,61823.860000000015
9973,U32348,140,24450.86999999998,115,25,133946.79,158397.65999999997
9974,U19138,140,-10168.300000000001,134,6,34171.600000000006,24003.300000000003
9975,U42105,140,-1882.279999999807,121,19,2684368.679999998,2682486.399999998
9976,U30165,140,3222.6300000000006,129,11,36140.95999999999,39363.58999999999
9977,U34227,140,18779.920000000006,118,22,65893.43,84673.35
9978,U20666,140,-150722.76,114,26,1258056.9800000004,1107334.2200000004
9979,U39721,140,169047.57,117,23,443047.83999999997,612095.4099999999
9980,U15930,140,-112844.31999999999,121,19,382354.8200000001,269510.5000000001
9981,U1094013,140,1.239999999999668,80,60,5337.5,5338.74
9982,U29105,140,-38304.92,126,14,329432.0,291127.08
9983,U10459,140,28214.760000000002,126,14,455789.02999999997,484003.79
9984,U32974,140,689.5400000000003,132,8,16109.19,16798.73
9985,U37134,140,991307.7999999997,131,9,646329.2500000002,1637637.0499999998
9986,U19960,140,-1431.1299999999972,120,20,50401.15,48970.020000000004
9987,U17259,140,-33837.43000000001,126,14,142507.26,108669.83
9988,U37522,140,-2867.060000000001,126,14,11325.319999999998,8458.259999999997
9989,U33493,140,4109.230000000005,127,13,44075.28,48184.51
9990,U16830,140,-186613.52,120,20,940704.5700000001,754091.05
9991,U14179,140,45388.49000000001,76,64,231316.89,276705.38
9992,U35363,140,-50367.89,104,36,481150.17999999993,430782.2899999999
9993,U37815,139,4234.93000000001,116,23,234441.4,238676.33000000002
9994,U15299,139,53803.08000000049,92,47,7831161.790000001,7884964.870000001
9995,U24543,139,-6506.760000000012,118,21,434366.4300000001,427859.6700000001
9996,U40042,139,-103.33999999961816,69,70,5972711.300000001,5972607.960000001
9997,U32132,139,9943.310000000001,102,37,108566.94,118510.25
9998,U16859,139,9944.740000000003,117,22,152301.15000000005,162245.89000000004
9999,U33089,139,-710.85,132,7,23997.090000000007,23286.24000000001
10000,U8922,139,-9466.419999999991,120,19,69068.04000000001,59601.62000000002
10001,U9247,139,101105.34999999996,80,59,3336085.85,3437191.2
10002,U39169,139,-7072.369999999994,124,15,31385.480000000007,24313.11000000001
10003,U11845,139,-2568.07999999998,87,52,444924.58,442356.50000000006
10004,U25496,139,4477.080000000002,130,9,42532.470000000016,47009.55000000002
10005,U43121,139,-206542.1299999997,131,8,1054328.9599999995,847786.8299999998
10006,U26882,139,11772.149999999994,122,17,85736.88,97509.03
10007,U14317,139,18601.190000000002,125,14,60215.180000000015,78816.37000000002
10008,U33857,139,16870.5,129,10,730.7,17601.2
10009,U22235,139,878.1799999999994,127,12,40935.17999999999,41813.35999999999
10010,U12661,139,4879.03999999998,81,58,418701.64,423580.68
10011,U41312,139,-7912.360000000021,108,31,481988.96999999986,474076.6099999998
10012,U32346,139,-36151.62999999995,82,57,861503.59,825351.96
10013,U22387,139,-53899.75,100,39,334831.88999999996,280932.13999999996
10014,U894789,139,-0.03999999999913939,89,50,21450.7,21450.66
10015,U17796,139,-319287.0600000001,115,24,1252743.51,933456.45
10016,U16876,139,-2402.660000000003,131,8,27939.699999999997,25537.039999999994
10017,U43676,139,-8657.209999999934,80,59,1262957.7,1254300.49
10018,U36718,139,-1416.8700000000015,119,20,62029.840000000004,60612.97
10019,U12149,139,5096.9599999999955,122,17,116705.07000000002,121802.03000000001
10020,U30027,139,-28161.95,119,20,137848.28,109686.33
10021,U36787,139,-5340.690000000024,86,53,473680.27,468339.58
10022,U37055,139,-16557.059999999998,124,15,41357.27000000001,24800.210000000014
10023,U9982,139,684.870000000009,99,40,162198.61,162883.47999999998
10024,U15035,139,-5837.120000000004,81,58,112427.04999999999,106589.92999999998
10025,U13120,139,-185471.65000000005,128,11,1302068.6199999999,1116596.9699999997
10026,U40330,139,1373.5500000000177,115,24,107688.14000000001,109061.69000000003
10027,U23068,139,-3685.3200000000247,120,19,138070.3,134384.97999999995
10028,U30770,139,27036.659999999996,119,20,168086.97999999998,195123.63999999998
10029,U23763,139,21392.77999999998,104,35,2494662.4400000004,2516055.22
10030,U11386,139,4358.100000000003,121,18,39331.94999999998,43690.04999999999
10031,U16241,139,50534.64,124,15,119817.13,170351.77000000002
10032,U19743,139,-1773.5400000000004,99,40,34717.729999999996,32944.189999999995
10033,U40883,139,-5761.560000000002,95,44,61449.44,55687.88
10034,U41972,139,-73634.65000000001,108,31,7508089.940000001,7434455.290000001
10035,U41029,139,-17838.690000000002,124,15,84649.64,66810.95
10036,U31626,139,1903.6500000000387,68,71,94964.50000000001,96868.15000000005
10037,U31689,139,-381083.37999999983,123,16,7433671.919999999,7052588.539999999
10038,U41043,139,-2817.700000000363,100,39,5540582.029999999,5537764.329999999
10039,U42104,139,271.6999999999995,131,8,19359.08,19630.780000000002
10040,U21803,139,15158.09999999989,98,41,1671864.2400000002,1687022.34
10041,U34897,139,-1176.4799999999987,124,15,53178.03,52001.55
10042,U13853,139,-2960.559999999994,115,24,30740.86000000002,27780.300000000025
10043,U23206,139,9644.09999999999,126,13,69589.33999999997,79233.43999999996
10044,U34704,139,-21907.120000000003,105,34,395222.1399999999,373315.0199999999
10045,U20447,139,15253.050000000005,115,24,71682.16999999997,86935.21999999997
10046,U41828,139,11687.930000000017,112,27,398896.9800000001,410584.9100000001
10047,U15534,139,41335.32000000002,109,30,229400.78999999998,270736.11
10048,U35602,139,-1646.1,135,4,14538.080000000002,12891.980000000001
10049,U38335,139,31422.35999999999,88,51,200784.74000000005,232207.10000000003
10050,U36925,139,-89603.78000000001,125,14,186942.91,97339.12999999999
10051,U14032,139,18432.66999999999,123,16,313245.4700000001,331678.1400000001
10052,U37821,139,-5128.120000000004,116,23,490977.96000000014,485849.84000000014
10053,U31232,139,-3008.7199999999993,126,13,72109.12999999999,69100.40999999999
10054,U9412,139,-772328.4599999988,115,24,1893960.2399999988,1121631.78
10055,U35449,139,69387.93,128,11,471180.89999999997,540568.83
10056,U35818,139,-9684.630000000005,125,14,28148.22000000001,18463.590000000004
10057,U15398,139,7219.550000000003,89,50,996223.5800000001,1003443.1300000001
10058,U41605,139,5876.700000000008,118,21,230262.73,236139.43000000002
10059,U22577,139,132.30000000000018,126,13,19646.6,19778.899999999998
10060,U19225,139,-702.8300000000006,133,6,24804.19,24101.359999999997
10061,U37049,139,27776.20999999998,119,20,333565.8500000001,361342.06000000006
10062,U25012,139,291.1499999999985,72,67,275680.88999999996,275972.04
10063,U33944,139,-678.7100000000064,120,19,106229.20000000004,105550.49000000003
10064,U23659,139,733.5200000000225,74,65,2340660.87,2341394.39
10065,U43392,139,98950.55000000002,123,16,118517.76999999999,217468.32
10066,U39306,139,-5684.360000000002,123,16,121992.09999999999,116307.73999999999
10067,U19451,139,-27073.020000000022,100,39,312275.88,285202.86
10068,U576376,139,30958.440000000013,98,41,120704.28999999998,151662.72999999998
10069,U40866,139,161404.99999999997,107,32,460504.14999999997,621909.1499999999
10070,U37550,139,2643.6499999999955,78,61,286558.73000000004,289202.38000000006
10071,U40134,139,-81043.14000000004,69,70,1183970.01,1102926.8699999999
10072,U28504,139,-10557.130000000001,73,66,372912.99,362355.86
10073,U41041,139,-1071.9999999999964,89,50,150261.27999999997,149189.27999999997
10074,U16401,139,82086.54,115,24,11843.909999999998,93930.45
10075,U17225,139,601028.8200000004,97,42,8069196.290000001,8670225.110000001
10076,U30872,139,-16486.03999999999,122,17,760933.2199999999,744447.1799999998
10077,U17136,139,64882.31,98,41,175410.86,240293.16999999998
10078,U30633,138,620.6000000000065,126,12,40496.210000000014,41116.81000000002
10079,U37087,138,538.6100000000079,92,46,239884.1199999999,240422.72999999992
10080,U17157,138,8652.660000000003,127,11,36623.81,45276.47
10081,U28380,138,-7182.019999999989,86,52,266569.93000000005,259387.91000000006
10082,U836455,138,23346.769999999997,90,48,195528.96000000002,218875.73
10083,U13061,138,-662.7299999999989,133,5,13164.660000000003,12501.930000000004
10084,U27528,138,227514.67000000007,126,12,429961.20999999996,657475.88
10085,U955039,138,659.8999999999967,86,52,94912.84000000003,95572.74000000002
10086,U25914,138,18461.130000000005,87,51,241540.95,260002.08000000002
10087,U13667,138,-525464.0499999999,108,30,1261074.51,735610.4600000001
10088,U23158,138,117839.11999999991,113,25,575679.8699999998,693518.9899999996
10089,U33625,138,-393.0999999999999,123,15,76098.26000000001,75705.16
10090,U37152,138,-171951.97000000003,115,23,2807247.51,2635295.5399999996
10091,U18740,138,2025.6000000000017,129,9,73281.19999999998,75306.79999999999
10092,U9145,138,80238.42,128,10,261128.37,341366.79
10093,U15543,138,-54832.42999999998,85,53,783228.4800000001,728396.0500000002
10094,U31617,138,-34288.42,131,7,74770.79000000002,40482.370000000024
10095,U16544,138,-12149.510000000344,114,24,2172596.2399999993,2160446.729999999
10096,U8257,138,21747.050000000003,117,21,74961.36000000002,96708.41000000002
10097,U12595,138,4726.139999999983,115,23,187786.95999999996,192513.09999999995
10098,U8471,138,-9610.42,127,11,30877.02,21266.6
10099,U30179,138,-48570.61,129,9,106398.82999999999,57828.21999999999
10100,U15165,138,1190.300000000001,128,10,57472.26000000001,58662.56000000001
10101,U42696,138,-2062.209999999998,129,9,6739.480000000005,4677.270000000007
10102,U25490,138,3314.8700000000017,100,38,47875.34,51190.21
10103,U26879,138,329.1399999999994,116,22,105296.90999999999,105626.04999999999
10104,U20588,138,29563.560000000012,83,55,238571.52,268135.08
10105,U33380,138,652.5300000000002,128,10,27096.789999999997,27749.319999999996
10106,U25573,138,-40699.71000000002,99,39,196256.47000000003,155556.76
10107,U22879,138,8214.760000000031,119,19,202359.4599999999,210574.21999999994
10108,U33930,138,6054.100000000002,117,21,13731.319999999998,19785.42
10109,U1348074,138,-4554.719999999998,84,54,22410.52000000001,17855.800000000014
10110,U31168,138,4769.629999999999,129,9,24396.7,29166.33
10111,U24522,138,6995.96,112,26,54574.46,61570.42
10112,U40426,138,59847.36999999996,83,55,2026762.3199999998,2086609.6899999997
10113,U34395,138,-3930.5800000000013,123,15,37693.86,33763.28
10114,U25350,138,348239.33,126,12,92703.54000000004,440942.87000000005
10115,U10108,138,1210.0999999999985,122,16,90521.53000000001,91731.63
10116,U15583,138,3979.930000000032,96,42,945057.4099999999,949037.34
10117,U39718,138,-33213.65000000001,105,33,401888.5,368674.85
10118,U24746,138,-5954.210000000001,96,42,307409.07999999996,301454.86999999994
10119,U17863,138,4945.63,122,16,33076.009999999995,38021.63999999999
10120,U39663,138,3326.0600000000018,120,18,39527.14,42853.200000000004
10121,U43331,138,-5427.6500000000015,130,8,19733.430000000004,14305.780000000002
10122,U20854,138,5203.6600000000035,123,15,183906.09,189109.75
10123,U35427,138,-14945.989999999998,119,19,75658.51000000001,60712.52000000001
10124,U34569,138,-7824.450000000001,128,10,64524.24,56699.78999999999
10125,U13227,138,40.7599999999843,133,5,69366.09999999998,69406.85999999996
10126,U38170,138,32757.670000000006,111,27,129428.21,162185.88
10127,U33776,138,103349.90000000002,129,9,669791.89,773141.79
10128,U22239,138,1927.4200000000228,129,9,59163.540000000015,61090.960000000036
10129,U11942,138,-513800.82000000007,91,47,852702.6300000002,338901.8100000002
10130,U28207,138,3296.159999999996,90,48,205050.55999999997,208346.71999999997
10131,U24318,138,5910.980000000015,119,19,87765.13,93676.11000000002
10132,U8960,138,28762.120000000003,116,22,37948.259999999995,66710.38
10133,U8059,138,-16655.16,121,17,28016.88,11361.720000000001
10134,U20192,138,-18725.999999999993,114,24,151193.20999999996,132467.20999999996
10135,U24885,138,5006.559999999682,112,26,1401293.4,1406299.9599999995
10136,U39101,138,20181.2,125,13,14237.119999999997,34418.32
10137,U13772,138,297916.9400000002,131,7,2323729.6500000004,2621646.590000001
10138,U8321,138,-1717.7199999999916,118,20,208112.24,206394.52
10139,U33410,138,-125.17000000000553,130,8,38426.68,38301.509999999995
10140,U24181,138,94563.66000000003,75,63,5507409.269999999,5601972.929999999
10141,U14420,138,577755.8499999999,102,36,3691480.6399999997,4269236.489999999
10142,U36365,138,4068.3699999999826,121,17,254121.63,258190.0
10143,U19080,138,-43363.630000000005,105,33,473499.45000000007,430135.82000000007
10144,U25379,138,12571.229999999989,85,53,588035.7,600606.9299999999
10145,U29296,138,-740.7400000000052,100,38,279269.33,278528.59
10146,U1191609,138,613.5200000000024,111,27,56388.57,57002.090000000004
10147,U13368,138,-979.5600000000013,115,23,111541.83000000003,110562.27000000003
10148,U38463,138,2201.119999999981,109,29,184284.77999999997,186485.89999999997
10149,U8639,138,125158.30000000008,105,33,383318.7299999999,508477.03
10150,U30436,138,-105.78999999996813,111,27,450592.22,450486.43
10151,U15839,138,-90978.12999999998,125,13,244652.52999999997,153674.4
10152,U41838,138,77.39000000000283,116,22,139875.18999999997,139952.58
10153,U13508,138,7100.30999999998,103,35,358657.5299999998,365757.8399999998
10154,U33757,138,6993.229999999998,113,25,50435.11999999998,57428.34999999998
10155,U26306,138,17716.179999999993,105,33,417742.05000000005,435458.23000000004
10156,U23120,138,-117076.87999999995,102,36,402238.70000000007,285161.8200000001
10157,U1243060,138,-357.3000000000095,76,62,167894.36000000004,167537.06000000003
10158,U29455,138,24530.36,111,27,91167.86000000003,115698.22000000003
10159,U27385,138,652835.02,112,26,3699775.5199999996,4352610.539999999
10160,U38347,138,885.3099999999977,80,58,49893.979999999996,50779.28999999999
10161,U39893,138,20912.939999999973,82,56,73752.97,94665.90999999997
10162,U14439,138,-6614.690000000014,113,25,148014.51999999993,141399.82999999993
10163,U20073,138,-4116.380000000003,122,16,72528.89000000001,68412.51000000001
10164,U14226,138,10007.479999999994,130,8,5436.46,15443.939999999995
10165,U34331,138,90583.98000000004,120,18,3548381.4899999993,3638965.4699999993
10166,U12867,138,7725.639999999985,111,27,98188.32,105913.95999999999
10167,U43980,138,-84865.10000000002,73,65,795900.71,711035.61
10168,U14899,138,525859.0299999999,111,27,290931.38999999996,816790.4199999999
10169,U23005,138,939.6500000000005,119,19,29665.38,30605.030000000002
10170,U21605,138,1654.069999999996,119,19,86032.12000000002,87686.19000000002
10171,U17074,138,-55.060000000010405,116,22,175227.61,175172.55
10172,U34165,138,-210903.61999999988,126,12,225471.8799999999,14568.26000000001
10173,U25448,138,-133448.35,133,5,183010.56,49562.20999999999
10174,U39759,138,43938.720000000074,111,27,844219.0499999999,888157.77
10175,U25982,137,-129433.07000000007,94,43,4718227.65,4588794.58
10176,U19699,137,3032.5899999999992,129,8,2079.98,5112.57
10177,U35104,137,-2423.6199999999985,123,14,24328.629999999997,21905.01
10178,U39502,137,11320.970000000001,119,18,23673.18,34994.15
10179,U30094,137,4420.17,89,48,630530.4900000001,634950.6600000001
10180,U37748,137,-79060.07999999996,123,14,284325.98000000033,205265.90000000037
10181,U17894,137,134132.46999999997,117,20,455906.37000000005,590038.8400000001
10182,U18503,137,39851.749999999985,115,22,19218.629999999997,59070.37999999998
10183,U15536,137,-52.12999999999374,90,47,200728.10999999993,200675.97999999992
10184,U34373,137,-1553.0200000000032,129,8,43658.88000000002,42105.860000000015
10185,U17952,137,3543.8999999999924,119,18,34821.63999999999,38365.539999999986
10186,U23420,137,-3615.949999999998,128,9,38636.579999999994,35020.63
10187,U18200,137,-17859.95,125,12,47406.82000000001,29546.870000000006
10188,U12635,137,-113.03999999999971,117,20,20325.56,20212.52
10189,U33740,137,-2460.5999999999985,97,40,238375.09,235914.49
10190,U41890,137,-87643.25,118,19,282845.9799999999,195202.72999999992
10191,U39577,137,79444.93000000001,100,37,200378.0099999998,279822.9399999998
10192,U682753,137,12182.420000000002,73,64,88103.32,100285.74
10193,U33138,137,92430.04999999987,114,23,1031276.8700000001,1123706.92
10194,U36097,137,177.10999999999535,106,31,79446.89000000001,79624.00000000001
10195,U34764,137,-39708.94000000001,118,19,256346.18999999997,216637.24999999997
10196,U40102,137,70263.88000000043,118,19,9835315.379999999,9905579.26
10197,U35669,137,16807.819999999992,128,9,98053.54,114861.35999999999
10198,U19677,137,-487.23000000000076,123,14,34251.630000000005,33764.4
10199,U30413,137,4979.569999999998,126,11,14046.050000000001,19025.62
10200,U11153,137,8023.299999999999,114,23,54167.41000000001,62190.71000000001
10201,U32587,137,-12745.219999999985,120,17,171131.23999999996,158386.02
10202,U16881,137,-31711.589999999967,118,19,907939.6,876228.01
10203,U12757,137,-1810.4600000000012,89,48,23989.300000000007,22178.840000000004
10204,U38178,137,837.2800000000013,130,7,18906.97,19744.250000000004
10205,U40802,137,102094.45,123,14,285422.50000000006,387516.95000000007
10206,U16671,137,2635.530000000002,126,11,45436.27000000002,48071.80000000002
10207,U10986,137,18337.759999999987,126,11,66519.2,84856.95999999999
10208,U13629,137,129583.32999999996,89,48,14727764.7,14857348.03
10209,U33633,137,-8567.43,125,12,23653.37999999999,15085.94999999999
10210,U29475,137,-21626.450000000004,130,7,42866.57000000001,21240.120000000003
10211,U30526,137,-843.4099999999962,79,58,111621.59,110778.18
10212,U18015,137,-205285.5099999999,113,24,1697957.28,1492671.77
10213,U1151554,137,-8108.520000000001,117,20,36080.56,27972.039999999997
10214,U26613,137,34892.65999999984,96,41,9152126.45,9187019.11
10215,U39464,137,-185256.49999999997,128,9,321137.06,135880.56000000003
10216,U33906,137,406.3099999999995,128,9,7831.15,8237.46
10217,U19352,137,-1054.069999999997,96,41,164356.01999999996,163301.94999999995
10218,U23769,137,183676.15000000005,112,25,594655.89,778332.04
10219,U33199,137,-110469.86,131,6,129364.06,18894.199999999997
10220,U14944,137,-1954.9899999999977,133,4,3043.6299999999974,1088.6399999999996
10221,U15446,137,-55509.67000000009,112,25,977573.5000000005,922063.8300000004
10222,U23711,137,-1659.8500000000101,115,22,344793.81000000023,343133.9600000002
10223,U16618,137,-2209.3899999999962,130,7,24012.570000000003,21803.180000000008
10224,U26853,137,6410.580000000001,119,18,3142.53,9553.11
10225,U18448,137,-13831.039999999995,120,17,87954.98,74123.94
10226,U839382,137,51.40999999999455,83,54,108475.93000000001,108527.34
10227,U31510,137,70.94999999999709,94,43,27956.380000000005,28027.33
10228,U15477,137,-5216.039999999972,107,30,1210540.6100000003,1205324.5700000003
10229,U32963,137,-4104.5700000000015,134,3,6342.43,2237.8599999999988
10230,U28340,137,-24.179999999994834,115,22,21231.159999999993,21206.979999999996
10231,U18024,137,-2585.2400000000007,109,28,155101.52000000005,152516.28000000006
10232,U32673,137,23390.43,118,19,295592.09,318982.52
10233,U25533,137,-3420.150000000001,119,18,39232.68000000003,35812.53000000003
10234,U32878,137,7160.969999999997,119,18,38867.810000000005,46028.78
10235,U21865,137,-97660.92000000003,106,31,438090.75000000006,340429.83
10236,U42715,137,533.6699999999984,110,27,408395.11,408928.77999999997
10237,U33723,137,-7430.94000000001,119,18,146262.57000000004,138831.63000000003
10238,U42317,137,15963.159999999993,109,28,59914.340000000004,75877.5
10239,U10243,137,-26659.479999999996,127,10,56968.13000000003,30308.65000000003
10240,U20109,137,8478.36,111,26,46704.410000000105,55182.770000000106
10241,U40880,137,-5735.039999999994,120,17,163472.1,157737.06
10242,U28470,137,-46.69999999999709,129,8,11397.399999999998,11350.7
10243,U41614,137,-30184.73,85,52,51838.600000000006,21653.870000000006
10244,U16553,137,92799.17000000003,114,23,167137.62,259936.79000000004
10245,U34701,137,-8340.030000000008,119,18,88511.49999999999,80171.46999999997
10246,U25664,137,-5844.339999999999,105,32,31688.319999999996,25843.979999999996
10247,U42731,137,-97343.81000000006,110,27,378606.45,281262.63999999996
10248,U18074,137,-1062.740000000004,98,39,60630.78,59568.03999999999
10249,U15840,137,2108.9800000000023,132,5,29649.089999999997,31758.07
10250,U11101,137,3561.7400000000016,120,17,31421.01,34982.75
10251,U18384,137,-3363.1399999999967,124,13,147193.51,143830.37000000002
10252,U23518,137,-6233.759999999991,122,15,120287.20999999998,114053.44999999998
10253,U22115,137,-12843.960000000021,103,34,474865.1400000001,462021.18000000005
10254,U19890,137,-6845.600000000006,99,38,205986.03,199140.43
10255,U39562,137,-2789.340000000004,90,47,357901.47,355112.12999999995
10256,U16539,137,9609.650000000001,114,23,98897.49999999999,108507.15
10257,U18598,137,-7697.139999999992,97,40,176249.80000000002,168552.66000000003
10258,U14587,137,-2394.809999999999,92,45,97477.84,95083.03
10259,U19911,137,34434.39,100,37,132575.36,167009.75
10260,U11543,137,-4883.19,116,21,50778.670000000006,45895.48
10261,U42512,137,-700.879999999999,130,7,19394.929999999993,18694.049999999996
10262,U38143,137,11859.19,116,21,92040.49999999999,103899.68999999999
10263,U31327,137,19305.849999999984,122,15,137683.24,156989.08999999997
10264,U17797,136,329.90999999999985,105,31,12225.279999999995,12555.189999999995
10265,U27319,136,-3421.8200000000056,109,27,133841.14,130419.32
10266,U21816,136,57370.37999999896,107,29,14357354.690000001,14414725.07
10267,U23994,136,984.0200000000107,97,39,284978.12000000005,285962.1400000001
10268,U12811,136,-27935.810000000005,121,15,202752.5,174816.69
10269,U41681,136,-88580.31000000001,120,16,416241.13000000006,327660.82000000007
10270,U37892,136,461.4899999999989,122,14,23967.73999999999,24429.22999999999
10271,U896217,136,-472.70000000000084,106,30,28952.74,28480.04
10272,U22798,136,7398.020000000005,114,22,101764.48000000001,109162.50000000001
10273,U21697,136,-3531.1999999999975,83,53,81030.11000000002,77498.91000000002
10274,U36603,136,-8483.8,127,9,18585.749999999996,10101.949999999997
10275,U21450,136,16374.959999999995,110,26,977128.4999999998,993503.4599999997
10276,U35241,136,-1505.2700000000004,107,29,30219.020000000008,28713.750000000007
10277,U14160,136,-15247.05,123,13,47085.12,31838.070000000003
10278,U20913,136,89.14999999999964,129,7,13858.099999999997,13947.249999999996
10279,U17542,136,-168203.87000000002,97,39,384549.58,216345.71
10280,U18863,136,-3475.350000000006,68,68,2077228.3700000003,2073753.0200000003
10281,U26180,136,13510.529999999997,128,8,33947.61000000001,47458.14000000001
10282,U15672,136,-282449.07,108,28,586037.54,303588.47000000003
10283,U29508,136,440283.6300000001,105,31,2037218.42,2477502.05
10284,U41167,136,1355.7199999999757,99,37,218519.52000000002,219875.24
10285,U21274,136,-3739.140000000001,94,42,67090.28,63351.14
10286,U26564,136,19913.659999999996,110,26,51495.84000000002,71409.50000000001
10287,U33460,136,-3222.0999999999985,127,9,29412.93,26190.83
10288,U20972,136,-54648.83999999999,125,11,187820.39000000007,133171.55000000008
10289,U29991,136,-11443.080000000009,99,37,171293.92,159850.84
10290,U20319,136,7800.159999999988,70,66,263580.31999999995,271380.4799999999
10291,U15609,136,-4422.730000000002,109,27,102184.31000000004,97761.58000000005
10292,U43225,136,7694.290000000001,100,36,74073.25,81767.54000000001
10293,U30455,136,-3948.179999999999,112,24,33426.97000000001,29478.790000000008
10294,U32631,136,47555.27,63,73,282863.13000000006,330418.4000000001
10295,U23183,136,-374357.8799999993,105,31,5661933.72,5287575.840000001
10296,U21496,136,2184.519999999985,78,58,541225.12,543409.64
10297,U30653,136,6282.630000000003,86,50,205404.71000000002,211687.34000000003
10298,U9658,136,1497.8299999999963,99,37,124311.58,125809.41
10299,U39732,136,1242.3099999999977,103,33,303726.53,304968.84
10300,U23292,136,566.5900000000051,128,8,41542.61,42109.200000000004
10301,U8037,136,-13218.959999999983,88,48,449089.0400000001,435870.08000000013
10302,U10784,136,-3178.5900000000142,108,28,541419.1500000001,538240.5600000002
10303,U25909,136,1140.8299999999995,88,48,36970.88,38111.71
10304,U24439,136,-1531583.3299999996,111,25,10092424.06,8560840.73
10305,U12364,136,-18264.610000000008,120,16,447116.8899999999,428852.2799999999
10306,U18358,136,-50375.08999999999,86,50,465825.4600000001,415450.3700000001
10307,U26625,136,-60572.67999999999,122,14,193096.18999999997,132523.50999999998
10308,U10177,136,5228.359999999998,128,8,46946.71,52175.07
10309,U26392,136,-56298.660000000615,111,25,11876093.510000011,11819794.85000001
10310,U37843,136,-55767.299999999996,99,37,196345.58,140578.28
10311,U12984,136,-31984.439999999984,95,41,2174021.4299999997,2142036.9899999998
10312,U40657,136,-7554.809999999993,128,8,11759.709999999994,4204.900000000001
10313,U19566,136,-109023.07000000002,98,38,348809.12,239786.05
10314,U14209,136,-47191.31,118,18,154254.8,107063.48999999999
10315,U30114,136,-18633.47,127,9,40460.350000000006,21826.880000000005
10316,U9309,136,-56344.19000000001,121,15,671978.61,615634.4199999999
10317,U40181,136,-27790.359999999986,72,64,1126607.1700000002,1098816.81
10318,U23066,136,-5118.349999999952,114,22,371976.54000000004,366858.19000000006
10319,U15587,136,2890.999999999998,115,21,83548.80000000002,86439.80000000002
10320,U33896,136,-28761.30999999999,111,25,102263.03,73501.72
10321,U18647,136,4175.640000000001,122,14,37138.37000000001,41314.01000000001
10322,U11411,136,1947.8700000000022,132,4,33178.62,35126.490000000005
10323,U33241,136,601.039999999999,127,9,18950.009999999995,19551.049999999996
10324,U21481,136,-6638.689999999988,87,49,531533.32,524894.63
10325,U8745,136,-186634.13000000003,124,12,578006.8399999999,391372.70999999985
10326,U31420,136,-7079.169999999999,107,29,43201.540000000045,36122.370000000046
10327,U15393,136,-3225.9199999999983,59,77,337881.58,334655.66000000003
10328,U38609,136,-223575.25000000003,103,33,590291.52,366716.27
10329,U15287,136,-8716.910000000018,97,39,1569957.3900000001,1561240.4800000002
10330,U20626,136,18782.019999999993,118,18,44243.439999999995,63025.45999999999
10331,U8795,136,-10023.18,131,5,22110.53,12087.349999999999
10332,U12367,136,1002077.8499999996,113,23,2205880.9000000004,3207958.75
10333,U1092342,136,2463.4300000000003,75,61,4521.860000000001,6985.290000000001
10334,U650496,136,-5590.899999999999,127,9,5930.2699999999995,339.3700000000008
10335,U18255,136,-7694.85999999999,113,23,278730.78,271035.92000000004
10336,U26310,136,-3997.710000000001,100,36,54170.390000000014,50172.680000000015
10337,U38578,136,-1379.63,127,9,11124.430000000002,9744.800000000003
10338,U10318,136,-26191.300000000003,85,51,226129.66999999998,199938.37
10339,U17688,136,-107861.73000000001,102,34,292151.50000000006,184289.77000000005
10340,U28012,136,-4680.8499999999985,129,7,9549.349999999999,4868.5
10341,U793919,136,-2401.690000000004,86,50,113337.87,110936.18
10342,U12604,136,89674.30999999998,104,32,495215.14,584889.45
10343,U28671,136,-29932.459999999963,103,33,476935.75,447003.29000000004
10344,U32863,136,-66108.95000000001,117,19,185681.72999999998,119572.77999999997
10345,U16351,136,-132146.12,80,56,337424.80999999994,205278.68999999994
10346,U29763,136,3146.2499999999986,131,5,42955.57000000002,46101.82000000002
10347,U24329,136,-312904.0300000003,106,30,5096392.24,4783488.21
10348,U40750,136,-21831.189999999944,114,22,1902966.15,1881134.96
10349,U41551,136,47596.72000000001,96,40,270541.43999999994,318138.16
10350,U16400,136,-10713.939999999982,109,27,414320.52999999985,403606.58999999985
10351,U11862,136,-24703.770000000113,116,20,765640.4400000003,740936.6700000002
10352,U34275,136,27741.99999999998,115,21,68137.73000000001,95879.73
10353,U13172,136,-15197.969999999998,125,11,103390.16999999998,88192.19999999998
10354,U11466,136,6528.4699999999975,99,37,114418.01,120946.48
10355,U40353,136,119081.47999999998,102,34,770692.1400000001,889773.6200000001
10356,U27343,136,-5314.090000000001,122,14,14766.04000000001,9451.950000000008
10357,U25685,135,-1976.4499999999962,101,34,134115.62,132139.17
10358,U42046,135,27605.67,109,26,45787.49000000001,73393.16
10359,U22352,135,1696.2000000000003,125,10,6793.939999999999,8490.14
10360,U35315,135,4389.290000000005,123,12,53186.469999999994,57575.76
10361,U38738,135,355534.54999999993,100,35,623162.73,978697.2799999999
10362,U13380,135,-6299.389999999995,115,20,216620.81999999977,210321.4299999998
10363,U8630,135,-4208.150000000003,104,31,294259.89999999997,290051.74999999994
10364,U23231,135,-46352.56000000009,93,42,462048.45000000007,415695.88999999996
10365,U22685,135,5222.760000000027,99,36,534011.5999999999,539234.3599999999
10366,U26522,135,23426.250000000004,121,14,61410.62999999999,84836.87999999999
10367,U8090,135,-1285.210000000001,121,14,9486.39,8201.179999999998
10368,U19378,135,-7025.040000000006,104,31,93371.43,86346.38999999998
10369,U13496,135,25346.090000000004,126,9,80909.98999999999,106256.07999999999
10370,U32950,135,-44109.05999999999,75,60,658341.1200000001,614232.0600000002
10371,U17685,135,-2618.5499999999956,92,43,625279.93,622661.38
10372,U34992,135,-157695.25000000003,111,24,527288.82,369593.56999999995
10373,U32896,135,-400444.86,111,24,1127419.53,726974.67
10374,U833658,135,-16254.799999999997,78,57,37355.92,21101.120000000003
10375,U14787,135,-34444.02000000003,101,34,530509.8,496065.78
10376,U21721,135,30153.84,109,26,111819.99999999997,141973.83999999997
10377,U8232,135,-1809.6900000000005,111,24,44589.06,42779.369999999995
10378,U8466,135,14899.330000000005,104,31,244045.86,258945.19
10379,U9933,135,152.46000000000004,127,8,8647.75,8800.21
10380,U21398,135,27770.33999999985,95,40,2337074.31,2364844.65
10381,U941369,135,-14466.95,83,52,74872.08,60405.130000000005
10382,U1225793,135,9.74,73,62,42974.9,42984.64
10383,U43892,135,-2806.8000000000065,123,12,111456.78999999998,108649.98999999998
10384,U40584,135,21887.03,121,14,73388.44,95275.47
10385,U18522,135,-43922.74,111,24,503136.6000000001,459213.8600000001
10386,U17212,135,28905.92,99,36,447857.30999999994,476763.2299999999
10387,U18564,135,-356.96000000003755,101,34,280620.15,280263.19
10388,U15180,135,-13140.850000000002,99,36,204643.41,191502.56
10389,U19444,135,-1933.260000000001,128,7,27133.439999999995,25200.179999999993
10390,U33114,135,11748.870000000006,125,10,26495.159999999993,38244.03
10391,U21337,135,724.1199999999717,84,51,427867.80999999994,428591.92999999993
10392,U39880,135,-1658.9399999999985,114,21,28904.850000000013,27245.910000000014
10393,U41449,135,16249.019999999999,130,5,41606.950000000026,57855.97000000002
10394,U25076,135,-248.15999999999985,77,58,225431.82,225183.66
10395,U18511,135,-8968.509999999998,111,24,11573.429999999993,2604.9199999999946
10396,U32685,135,-106.00999999998749,97,38,339638.29000000015,339532.28000000014
10397,U39229,135,13099.359999999993,109,26,158039.1,171138.46
10398,U27752,135,17880.950000000015,76,59,620494.04,638374.9900000001
10399,U35225,135,-9110.53000000003,88,47,1572948.6500000001,1563838.12
10400,U13113,135,2255.019999999994,106,29,136113.11000000025,138368.13000000024
10401,U8314,135,-10229.18,132,3,11829.58,1600.3999999999996
10402,U8799,135,9797.950000000003,97,38,5329.82,15127.770000000002
10403,U41679,135,-8359.169999999984,110,25,189342.6,180983.43000000002
10404,U9930,135,-40293.020000000004,84,51,958370.29,918077.27
10405,U34465,135,-198.6399999999876,99,36,310582.0600000001,310383.4200000001
10406,U12443,135,-10817.799999999996,110,25,371552.0,360734.2
10407,U36942,135,-38859.53000000002,113,22,121422.65999999999,82563.12999999998
10408,U25427,135,4674.59,88,47,62375.520000000004,67050.11
10409,U12345,135,7659.429999999964,120,15,527633.8,535293.23
10410,U36094,135,23964.1,127,8,483143.73,507107.82999999996
10411,U13614,135,-5211.919999999998,103,32,30644.46,25432.54
10412,U40517,135,-34920.140000000014,119,16,285439.8,250519.65999999997
10413,U43591,135,-31739.779999999988,109,26,1203527.44,1171787.66
10414,U11113,135,-401474.53,115,20,1456523.49,1055048.96
10415,U12461,135,-101919.79999999997,68,67,954077.3200000001,852157.5200000001
10416,U15710,135,1492204.4700000002,110,25,1499061.04,2991265.5100000002
10417,U23504,135,-12830.020000000008,98,37,93793.21999999999,80963.19999999998
10418,U9461,135,17488.71,115,20,182130.08,199618.78999999998
10419,U24165,135,27910.73999999999,121,14,159750.96000000002,187661.7
10420,U35431,135,9109.309999999996,121,14,97221.99,106331.3
10421,U13207,135,-116683.48000000003,121,14,566021.9500000002,449338.47000000015
10422,U23352,135,-159.6299999999992,75,60,88247.48,88087.84999999999
10423,U34703,135,487.019999999985,71,64,1128684.94,1129171.96
10424,U39258,135,-1430.6299999999605,111,24,574922.2700000003,573491.6400000002
10425,U27106,135,-5165.840000000001,124,11,30287.49,25121.65
10426,U21989,135,-7682.09,113,22,37968.2,30286.109999999997
10427,U41105,135,-11334.159999999998,120,15,40609.11000000003,29274.950000000033
10428,U38639,135,-401.86000000001627,72,63,738183.73,737781.87
10429,U32060,135,-7437.020000000003,110,25,33181.899999999994,25744.87999999999
10430,U40461,135,189775.91000000003,120,15,2485541.74,2675317.6500000004
10431,U40254,135,16015.210000000034,114,21,270825.36,286840.57
10432,U17587,135,-595033.7499999999,126,9,733102.22,138068.4700000001
10433,U26868,135,-4399.400000000003,114,21,152518.99,148119.59
10434,U25736,135,-4254.319999999991,75,60,278678.4799999999,274424.1599999999
10435,U9905,135,-15279.360000000004,125,10,74994.97,59715.61
10436,U1274212,135,-1.5200000000058935,75,60,87118.6,87117.08
10437,U11073,135,-18861.459999999963,108,27,1424263.34,1405401.8800000001
10438,U31028,135,-4178.090000000011,72,63,504636.9899999999,500458.89999999985
10439,U17134,135,-20353.040000000063,93,42,900655.4300000002,880302.3900000001
10440,U27377,135,37468.90999999998,90,45,602755.5000000005,640224.4100000005
10441,U26925,135,-36035.13999999999,123,12,71749.10000000002,35713.96000000003
10442,U25575,135,-143783.24,118,17,398749.98000000004,254966.74000000005
10443,U25999,135,-66297.59999999998,100,35,309791.79,243494.19
10444,U19586,135,43615.61999999999,94,41,459795.2300000001,503410.8500000001
10445,U8822,135,-51209.96,86,49,347290.31,296080.35
10446,U28813,135,-25026.08999999999,97,38,353470.48,328444.39
10447,U40541,135,-18209.249999999996,129,6,26922.290000000005,8713.040000000008
10448,U19191,135,605.8899999999994,106,29,35441.030000000006,36046.920000000006
10449,U36324,135,-93282.37000000001,109,26,440215.93,346933.56
10450,U35634,135,20749.209999999995,126,9,6161.87,26911.079999999994
10451,U40503,135,-37694.88999999999,121,14,96700.97999999998,59006.08999999999
10452,U12311,135,5014.020000000004,117,18,97418.81,102432.83
10453,U1369099,134,-2157.4499999999994,76,58,16636.46,14479.01
10454,U35079,134,40070.63,114,20,79650.52,119721.15
10455,U42928,134,5849.759999999987,123,11,168961.27000000002,174811.03
10456,U17077,134,-1.0899999998696148,64,70,3700475.91,3700474.8200000003
10457,U20211,134,-185964.62999999995,116,18,419393.69999999984,233429.0699999999
10458,U38766,134,-9532.170000000004,107,27,66288.11000000002,56755.94000000001
10459,U40482,134,-74013.63000000002,126,8,99258.51000000001,25244.87999999999
10460,U1254771,134,-34536.640000000014,98,36,612865.2900000002,578328.6500000001
10461,U21373,134,62933.17,122,12,21258.53,84191.7
10462,U9150,134,-6093.599999999997,97,37,105112.39999999995,99018.79999999996
10463,U25371,134,-56285.779999999984,115,19,1025098.5099999997,968812.7299999996
10464,U12834,134,288.0399999999954,88,46,183345.15999999997,183633.19999999998
10465,U13683,134,-50214.95000000001,124,10,164917.79999999996,114702.84999999995
10466,U36257,134,-13110.540000000037,104,30,701614.77,688504.23
10467,U29736,134,-30661.899999999936,92,42,596882.8199999998,566220.9199999999
10468,U23633,134,526183.4100000004,109,25,2902525.0900000003,3428708.500000001
10469,U37224,134,-115208.39000000001,122,12,186288.91999999998,71080.52999999997
10470,U9878,134,-12437.399999999998,107,27,112543.31999999999,100105.92
10471,U20720,134,7813.100000000004,121,13,20866.139999999992,28679.239999999998
10472,U41637,134,-24739.67,99,35,483337.95999999996,458598.29
10473,U14904,134,-380302.33999999915,98,36,10824722.19,10444419.85
10474,U24583,134,-6881.019999999988,111,23,253120.78999999992,246239.76999999993
10475,U21910,134,-1972.630000000001,116,18,107992.69999999997,106020.06999999996
10476,U16038,134,-6046.619999999995,103,31,161832.87000000002,155786.25000000003
10477,U24529,134,-2259.079999999997,126,8,16055.08999999999,13796.009999999991
10478,U10913,134,318.9700000000081,122,12,18697.2,19016.17000000001
10479,U19445,134,76016.49000000017,96,38,1586166.0599999994,1662182.5499999996
10480,U27828,134,-2028.5399999999981,108,26,30507.049999999996,28478.51
10481,U41023,134,51696.99000000001,120,14,129380.62999999998,181077.62
10482,U35056,134,-3657.3799999999974,114,20,34749.960000000014,31092.580000000016
10483,U41938,134,-10319.089999999997,92,42,77354.66000000002,67035.57000000002
10484,U14730,134,1838.0200000018117,113,21,13877847.540000001,13879685.560000002
10485,U11748,134,9533.070000000002,102,32,105161.32,114694.39000000001
10486,U697828,134,-657.8600000000001,85,49,3079.7100000000005,2421.8500000000004
10487,U38191,134,385494.46,107,27,64941.39000000003,450435.85000000003
10488,U14402,134,-2931.5399999999977,114,20,125985.07999999997,123053.53999999998
10489,U12534,134,-48417.4,83,51,288665.81,240248.41
10490,U14778,134,-403.7899999999999,116,18,53336.47,52932.68
10491,U33926,134,9491.130000000001,120,14,17130.21,26621.34
10492,U41767,134,-64783.390000000014,70,64,561631.63,496848.24
10493,U19657,134,-103.28999999999905,123,11,14919.099999999999,14815.81
10494,U43104,134,1052.5300000000598,81,53,738969.24,740021.77
10495,U30034,134,16792.67,124,10,83093.81999999996,99886.48999999996
10496,U39014,134,-43339.65000000008,114,20,444114.8800000001,400775.23000000004
10497,U1054363,134,8.1400000000001,84,50,23312.759999999995,23320.899999999994
10498,U8397,134,-1506830.6399999994,118,16,2340360.8500000006,833530.2100000011
10499,U30177,134,33095.06,95,39,374850.36,407945.42
10500,U22703,134,-3732.189999999987,119,15,289355.69000000006,285623.50000000006
10501,U35136,134,1072.9100000000046,99,35,431427.67000000004,432500.5800000001
10502,U31502,134,-6112.819999999992,119,15,92915.52999999998,86802.70999999999
10503,U34108,134,-3050.5800000000095,105,29,200015.77999999997,196965.19999999995
10504,U38651,134,-171.599999999998,117,17,46213.18000000001,46041.58000000001
10505,U42834,134,5234.55,99,35,43925.86,49160.41
10506,U13885,134,63970.7299999999,100,34,2899440.1600000006,2963410.8900000006
10507,U12918,134,11016.639999999996,127,7,66664.37000000001,77681.01000000001
10508,U16630,134,-34389.97,109,25,505322.41000000003,470932.44000000006
10509,U18497,134,-25432.340000000007,118,16,111869.38000000008,86437.04000000007
10510,U37662,134,-30137.390000000014,103,31,469816.3899999998,439678.99999999977
10511,U980059,134,-7486.0599999999995,118,16,74736.06,67250.0
10512,U986915,134,-37.05000000000291,87,47,162382.14000000004,162345.09000000003
10513,U15764,134,-1391291.7699999998,90,44,5627007.060000002,4235715.290000003
10514,U24949,134,5381.509999999995,97,37,634684.87,640066.38
10515,U24733,134,23700.51000000002,116,18,292735.7699999998,316436.2799999998
10516,U34675,134,-5227.059999999998,125,9,53043.550000000025,47816.49000000003
10517,U37982,134,-16904.989999999998,116,18,114995.46000000002,98090.47000000003
10518,U20609,134,-4445.669999999946,107,27,1299864.8099999987,1295419.1399999987
10519,U15240,134,50819.63000000003,103,31,260331.00999999998,311150.64
10520,U41507,134,-4769.6799999999985,122,12,78684.51,73914.83
10521,U10365,134,16875.73,125,9,75226.44,92102.17
10522,U22166,134,1236.6599999999983,124,10,16052.95,17289.61
10523,U17159,134,-1642.5799999999997,120,14,67997.61000000002,66355.03000000001
10524,U18133,134,86780.47,120,14,181360.1,268140.57
10525,U34976,134,154729.30000000005,121,13,51498.310000000005,206227.61000000004
10526,U13733,134,-16843.069999999934,117,17,734062.6399999999,717219.57
10527,U19612,134,2308.5200000000027,122,12,55308.99,57617.51
10528,U32482,134,-129.600000000024,113,21,235979.08,235849.47999999995
10529,U19828,134,-88772.00999999997,84,50,445880.2699999999,357108.25999999995
10530,U28468,134,-9244.820000000003,123,11,32699.03,23454.209999999995
10531,U13053,134,9480.159999999953,105,29,377696.79999999976,387176.95999999973
10532,U14900,134,-53354.83000000012,93,41,836565.6200000003,783210.7900000003
10533,U709457,134,121.5499999999908,74,60,69004.47,69126.01999999999
10534,U42836,134,4575.9000000000015,113,21,112706.74,117282.64000000001
10535,U26566,134,-13677.579999999994,99,35,97542.64000000001,83865.06000000003
10536,U18576,134,-8482.859999999997,112,22,88992.84,80509.98
10537,U8338,134,-1382.5400000000009,122,12,28231.14,26848.6
10538,U30107,134,10947.979999999998,123,11,21913.319999999996,32861.299999999996
10539,U14867,134,33122.34999999999,107,27,244001.45000000004,277123.80000000005
10540,U32263,134,34194.98999999998,92,42,534636.0700000002,568831.0600000002
10541,U40479,134,531.7899999999773,103,31,138904.65000000002,139436.44
10542,U28566,134,2337.920000000003,127,7,16752.979999999996,19090.899999999998
10543,U16884,134,24463.959999999995,95,39,315520.01,339983.97000000003
10544,U36088,134,78428.7,89,45,578016.0600000002,656444.7600000001
10545,U26601,134,-132454.01999999926,101,33,7311335.97,7178881.95
10546,U16903,134,31937.00999999998,107,27,502093.18,534030.19
10547,U14433,134,106512.66,108,26,551594.4700000001,658107.1300000001
10548,U29116,134,136.31999999999925,106,28,77674.78000000003,77811.10000000002
10549,U27050,134,46165.950000000055,95,39,5815383.36,5861549.3100000005
10550,U10448,134,-4221.74,124,10,28893.16,24671.42
10551,U23688,133,-4921.819999999996,107,26,103700.38,98778.56000000001
10552,U27413,133,-5718.910000000013,117,16,200551.93999999994,194833.02999999994
10553,U12466,133,768.5700000000005,124,9,17493.87,18262.44
10554,U21245,133,2929.709999999999,126,7,21873.83,24803.54
10555,U28722,133,-13097.75999999994,92,41,3365404.51,3352306.75
10556,U25612,133,-204052.74000000002,81,52,1443496.69,1239443.95
10557,U11624,133,-749.980000000025,94,39,590499.46,589749.48
10558,U18106,133,6808.02,115,18,1107862.8399999999,1114670.8599999999
10559,U25138,133,7691.549999999987,124,9,21641.710000000014,29333.260000000002
10560,U38697,133,3207.1300000000156,116,17,66498.83000000006,69705.96000000008
10561,U23437,133,-22812.420000000013,101,32,264530.89,241718.47
10562,U8589,133,-934.4300000000021,119,14,112519.23999999999,111584.80999999998
10563,U24812,133,-21064.949999999997,114,19,56687.770000000004,35622.82000000001
10564,U12293,133,-49633.89000000006,118,15,430376.81999999983,380742.92999999976
10565,U40073,133,-113504.18000000015,106,27,5735357.070000001,5621852.8900000015
10566,U8074,133,14933.970000000008,124,9,44641.5,59575.47000000001
10567,U21912,133,1305.3900000000049,113,20,207598.3,208903.69
10568,U26307,133,-130828.63000000003,61,72,586299.94,455471.30999999994
10569,U12560,133,-12512.910000000013,115,18,83983.41999999995,71470.50999999994
10570,U27140,133,137568.51,77,56,1014230.7700000001,1151799.2800000003
10571,U17308,133,-210849.29999999993,105,28,10270098.24,10059248.94
10572,U34013,133,-8168.549999999999,121,12,44817.88999999999,36649.34
10573,U9293,133,3259.9999999999927,106,27,110786.02999999998,114046.02999999997
10574,U37268,133,-158539.98000000004,99,34,441820.3699999999,283280.38999999984
10575,U9359,133,4072.5700000000134,68,65,415168.91,419241.48
10576,U22858,133,-30886.129999999976,86,47,614548.5800000001,583662.4500000001
10577,U26263,133,-27969.149999999998,111,22,186540.25999999998,158571.11
10578,U10883,133,-27450.64,130,3,43948.98,16498.340000000004
10579,U11337,133,-3290.88,121,12,16893.13,13602.25
10580,U19812,133,21325.16,88,45,147303.48999999996,168628.64999999997
10581,U13220,133,-423638.00999999995,95,38,1436335.98,1012697.97
10582,U38632,133,-1641.7900000000002,116,17,20580.699999999997,18938.909999999996
10583,U9296,133,260578.46,59,74,139484.09,400062.55
10584,U24523,133,1170.0199999999668,93,40,767783.33,768953.35
10585,U39054,133,-736082.22,97,36,1288196.52,552114.3
10586,U21181,133,-5076.439999999996,80,53,25832.459999999992,20756.019999999997
10587,U29375,133,-233704.81999999998,119,14,607811.9099999999,374107.08999999997
10588,U27077,133,-42308.279999999984,114,19,504539.22,462230.94
10589,U18524,133,-22408.089999999997,102,31,234857.68999999994,212449.59999999995
10590,U1177464,133,3120.4399999999996,111,22,23476.860000000008,26597.300000000007
10591,U703640,133,-3261.100000000001,84,49,56235.969999999994,52974.869999999995
10592,U36950,133,-33542.10000000001,123,10,58950.35000000002,25408.250000000007
10593,U17754,133,-9975.409999999998,125,8,19277.629999999997,9302.22
10594,U31982,133,-42811.64000000003,126,7,73085.26999999999,30273.62999999996
10595,U33984,133,3126.0200000001187,94,39,1855070.0399999998,1858196.0599999998
10596,U18210,133,191921.47999999998,119,14,1011196.9899999999,1203118.4699999997
10597,U28617,133,-8228.069999999994,109,24,83350.53000000006,75122.46000000006
10598,U34788,133,-61460.34999999999,88,45,691049.5099999999,629589.1599999999
10599,U10815,133,13132.079999999958,116,17,637506.2200000001,650638.3
10600,U18849,133,3143.9099999999985,111,22,93065.65000000002,96209.56000000003
10601,U16719,133,-281727.96000000014,111,22,577936.0600000002,296208.10000000003
10602,U28401,133,-8558.850000000017,110,23,296098.24000000005,287539.39
10603,U20134,133,21.630000000004074,127,6,76523.2,76544.83
10604,U42171,133,32259.200000000015,105,28,271170.54,303429.74
10605,U10827,133,-4885.74,121,12,24115.56000000001,19229.820000000007
10606,U9498,133,6797.289999999986,111,22,188462.97,195260.25999999998
10607,U15620,133,-54662.150000000045,127,6,255202.27999999988,200540.12999999983
10608,U14470,133,292478.27,98,35,423523.37,716001.64
10609,U10850,133,64356.98,75,58,280103.52999999997,344460.50999999995
10610,U12417,133,4346.710000000003,113,20,219773.85,224120.56
10611,U26304,133,910.1900000000046,106,27,87152.20999999999,88062.4
10612,U577475,133,-17.45999999999725,82,51,103128.06000000003,103110.60000000003
10613,U10620,133,17664.320000000058,119,14,512995.33,530659.65
10614,U13728,133,-39062.219999999994,122,11,80258.38,41196.16000000001
10615,U41227,133,-278347.31999999995,127,6,772374.0500000003,494026.73000000033
10616,U21268,133,-6807.55,119,14,41575.759999999995,34768.20999999999
10617,U19436,133,-18486.840000000022,109,24,277706.31,259219.46999999997
10618,U42859,133,-23771.64999999998,118,15,126538.23000000005,102766.58000000007
10619,U30996,133,485.2199999999996,124,9,4094.9100000000008,4580.13
10620,U12418,133,-16657.200000000008,83,50,135401.98,118744.78
10621,U40375,133,-4720.119999999994,113,20,74609.23999999999,69889.12
10622,U25449,133,-13211.139999999996,126,7,36903.84,23692.7
10623,U38511,133,15708.919999999998,78,55,387945.44,403654.36
10624,U1178549,133,694.7400000000002,87,46,15782.629999999997,16477.37
10625,U8570,133,-1261.3599999999963,83,50,447620.98000000016,446359.62000000017
10626,U22464,133,-13633.00000000004,77,56,1283922.32,1270289.32
10627,U23486,133,8759.480000000003,97,36,523488.33,532247.81
10628,U43785,133,-885.1899999999897,90,43,1350042.44,1349157.25
10629,U9110,133,-1311.919999999999,101,32,80464.66,79152.74
10630,U41525,133,179227.34999999998,100,33,167462.28,346689.63
10631,U1273462,133,-0.7099999999988995,66,67,53966.93,53966.22
10632,U35556,133,-2038.6400000000008,122,11,22539.530000000013,20500.890000000014
10633,U29767,133,85551.24000000009,84,49,1162658.38,1248209.6199999999
10634,U13565,133,2212.7300000000023,107,26,83213.48,85426.20999999999
10635,U13598,133,4923.819999999984,96,37,275061.35,279985.17
10636,U29398,132,-71367.98999999999,121,11,189583.87999999995,118215.88999999996
10637,U14010,132,-9586.240000000034,94,38,388804.45999999996,379218.2199999999
10638,U27620,132,-2318.6200000000026,113,19,55826.47,53507.85
10639,U24913,132,-678797.8100000002,55,77,4441353.530000001,3762555.720000001
10640,U23145,132,-15228.66000000001,114,18,223297.42,208068.76
10641,U40165,132,16309.979999999961,102,30,1856367.94,1872677.92
10642,U16901,132,3449.83,119,13,19046.06,22495.89
10643,U28295,132,-4609.519999999984,103,29,132726.29,128116.77000000002
10644,U31379,132,58224.52999999996,87,45,504138.18,562362.71
10645,U39070,132,101878.93999999997,105,27,206183.77000000002,308062.70999999996
10646,U36724,132,-2238.6300000000065,100,32,597034.2400000001,594795.6100000001
10647,U27176,132,2576.7000000000007,111,21,155584.44999999998,158161.15
10648,U25884,132,-7903.709999999998,108,24,60628.25000000003,52724.54000000003
10649,U41245,132,3311.230000000003,112,20,48809.390000000014,52120.62000000002
10650,U26656,132,-5542.849999999981,87,45,404935.33,399392.48000000004
10651,U10140,132,-19867.26,124,8,81057.06,61189.8
10652,U38296,132,-22731.170000000002,121,11,36725.719999999994,13994.549999999992
10653,U38833,132,-248841.59999999986,82,50,1540056.43,1291214.83
10654,U13803,132,-19571.730000000007,96,36,333221.14999999997,313649.42
10655,U14678,132,-90737.67000000001,119,13,118298.35000000002,27560.680000000008
10656,U39705,132,3352.9400000000287,114,18,463531.1100000001,466884.0500000001
10657,U19643,132,-171.50999999999993,87,45,7661.009999999999,7489.499999999999
10658,U21722,132,142.63999999999314,86,46,192917.55000000002,193060.19
10659,U42310,132,-3733.07,124,8,35240.07000000001,31507.000000000007
10660,U906559,132,-5342.530000000002,83,49,24486.890000000003,19144.36
10661,U13734,132,-10387.910000000003,94,38,775068.4099999999,764680.4999999999
10662,U25087,132,-533.9300000000005,120,12,29853.989999999998,29320.059999999998
10663,U11380,132,29851.999999999996,109,23,186016.70000000004,215868.70000000004
10664,U38054,132,8800.650000000014,112,20,166342.26000000004,175142.91000000006
10665,U27502,132,1000.6700000000037,77,55,699547.0,700547.67
10666,U23091,132,30869.280000000017,64,68,286603.00999999995,317472.29
10667,U38637,132,-219.35000000000207,91,41,32438.41999999999,32219.06999999999
10668,U14843,132,3338.4300000000003,116,16,16289.199999999999,19627.629999999997
10669,U14449,132,-3417.7699999999986,102,30,43186.84000000002,39769.07000000002
10670,U38966,132,265436.58999999997,116,16,710164.07,975600.6599999999
10671,U10001,132,-4981.040000000004,53,79,102558.14999999998,97577.10999999997
10672,U13406,132,-63889.81000000003,116,16,78512.35000000002,14622.539999999994
10673,U34299,132,2030.7600000000107,115,17,34232.509999999995,36263.270000000004
10674,U32099,132,-44026.51000000001,121,11,221369.92,177343.41
10675,U21620,132,-7730.949999999997,122,10,42049.600000000006,34318.65000000001
10676,U10653,132,1243.3600000000001,73,59,77050.82999999999,78294.18999999999
10677,U31593,132,-14190.659999999963,96,36,521756.44000000006,507565.7800000001
10678,U35279,132,193.4099999999887,118,14,113587.79999999999,113781.20999999998
10679,U35825,132,9168.400000000041,94,38,466722.04,475890.44
10680,U14540,132,-491.44000000020606,108,24,1803130.03,1802638.5899999999
10681,U33629,132,50775.03,105,27,213017.13,263792.16000000003
10682,U38913,132,-53312.929999999964,98,34,736595.3600000001,683282.4300000002
10683,U37072,132,8014.090000000015,78,54,356133.94,364148.03
10684,U19820,132,74062.37999999998,117,15,38224.84000000001,112287.21999999999
10685,U13944,132,-3611.9600000000487,59,73,177154.88999999998,173542.92999999993
10686,U38128,132,8753.070000000005,125,7,25200.220000000005,33953.29000000001
10687,U40293,132,1876.3599999999908,106,26,648684.9499999996,650561.3099999996
10688,U41931,132,-9698.64000000001,75,57,953772.4599999998,944073.8199999998
10689,U22997,132,3968.8400000000024,103,29,81117.16,85086.0
10690,U22900,132,67823.82999999999,105,27,196371.80999999994,264195.6399999999
10691,U16513,132,134988.41999999995,105,27,772952.0100000001,907940.43
10692,U21196,132,-88652.59999999999,125,7,255784.66999999995,167132.06999999995
10693,U711232,132,-3113.5399999999995,94,38,9003.71,5890.17
10694,U30178,132,-108811.86000000002,116,16,140864.06,32052.199999999983
10695,U32943,132,1057.3500000000033,124,8,46928.84000000003,47986.19000000004
10696,U23467,132,31524.840000000004,100,32,336711.06000000006,368235.9000000001
10697,U10998,132,705.849999999999,96,36,49727.42,50433.27
10698,U764912,132,-5917.95000000002,94,38,304245.83999999997,298327.88999999996
10699,U14578,132,-11633.819999999994,105,27,40915.49,29281.670000000006
10700,U17303,132,-37345.229999999996,118,14,64805.46000000001,27460.23000000001
10701,U35844,132,10699.949999999983,96,36,166964.38,177664.33
10702,U17428,132,49504.890000000014,71,61,3293209.36,3342714.25
10703,U1190681,132,5663.039999999998,95,37,95597.19,101260.23
10704,U20844,132,-12340.59,101,31,386113.3900000001,373772.80000000005
10705,U26734,132,-18114.829999999987,121,11,32578.67999999999,14463.850000000002
10706,U9119,132,3339.6900000000005,68,64,108572.23,111911.92
10707,U14961,132,-6181.940000000002,99,33,397617.99000000005,391436.05000000005
10708,U40769,132,-13017.649999999992,93,39,246143.85,233126.2
10709,U26966,132,-2097.079999999982,117,15,424786.55999999994,422689.48
10710,U38587,132,31370.6,104,28,17477.840000000004,48848.44
10711,U36384,132,16451.5,104,28,165595.10999999996,182046.60999999996
10712,U41799,132,2233.0200000000004,116,16,42492.249999999985,44725.26999999999
10713,U14497,132,42474.930000000015,111,21,82119.05000000002,124593.98000000004
10714,U42536,132,-53010.87999999999,125,7,67499.40000000002,14488.520000000033
10715,U25657,132,-4039.2800000000016,115,17,125155.97999999998,121116.69999999998
10716,U21905,132,14606.579999999994,109,23,1014295.22,1028901.7999999999
10717,U12539,132,-2359.400000000001,83,49,64670.52999999999,62311.12999999999
10718,U24589,132,13.599999999996726,115,17,62205.48,62219.08
10719,U9047,132,-233865.14,119,13,257122.84,23257.699999999983
10720,U30793,132,10108.640000000005,125,7,12735.079999999993,22843.719999999998
10721,U16042,132,77969.65,125,7,135206.43,213176.08
10722,U10956,132,1498.62999999999,92,40,153448.2,154946.83000000002
10723,U13751,132,-1232690.83,121,11,2358202.4000000004,1125511.5700000003
10724,U8671,132,-1153.7,124,8,35701.36,34547.66
10725,U34364,132,5847.449999999999,116,16,46173.72,52021.17
10726,U28531,132,-16.56999999997788,112,20,102915.76999999997,102899.2
10727,U8941,132,18631.32,119,13,48087.450000000026,66718.77000000002
10728,U11087,132,-9582.790000000015,115,17,641838.3099999999,632255.5199999999
10729,U13981,132,2208.279999999999,115,17,58008.45999999999,60216.73999999999
10730,U36062,131,-2418.0200000000023,101,30,58068.72999999999,55650.709999999985
10731,U42800,131,43101.200000000026,93,38,822846.85,865948.05
10732,U34552,131,-56641.18999999971,108,23,2272659.1699999995,2216017.9799999995
10733,U35863,131,27810.27000000002,100,31,661404.4299999998,689214.6999999998
10734,U17764,131,-12747.710000000003,101,30,58932.76000000002,46185.05000000002
10735,U43610,131,7931.52999999997,105,26,195082.38,203013.90999999997
10736,U35699,131,-12004.300000000003,124,7,24433.68,12429.379999999997
10737,U26938,131,68845.86000000003,84,47,323651.82999999996,392497.69
10738,U25793,131,19323.78,117,14,28584.26,47908.03999999999
10739,U30637,131,1420.0400000000002,111,20,13990.230000000001,15410.270000000002
10740,U16789,131,35054.94000000003,115,16,105217.12,140272.06000000003
10741,U20356,131,1059.5300000000016,98,33,76163.87000000001,77223.40000000001
10742,U10879,131,-21833.500000000007,114,17,128721.28999999998,106887.78999999998
10743,U19395,131,-1435.9100000000014,121,10,86929.16,85493.25
10744,U16322,131,146767.30000000008,70,61,1051996.15,1198763.45
10745,U24296,131,-3630.399999999968,104,27,124211.27,120580.87000000004
10746,U30141,131,9656.889999999941,69,62,1479450.9599999995,1489107.8499999994
10747,U13585,131,-3563.9400000000023,107,24,244974.86999999997,241410.92999999996
10748,U21163,131,5443.429999999997,105,26,61632.59,67076.01999999999
10749,U9634,131,7827.050000000009,123,8,42627.79,50454.84000000001
10750,U28945,131,-4419.190000000005,114,17,85001.8900000001,80582.7000000001
10751,U43130,131,-1057.8900000000103,112,19,175455.2,174397.31
10752,U43855,131,11400.250000000002,113,18,19393.350000000002,30793.600000000006
10753,U28311,131,-15746.380000000005,115,16,77282.73,61536.34999999999
10754,U13395,131,-547843.0899999997,107,24,4766114.75,4218271.66
10755,U33274,131,-24371.64,82,49,692927.73,668556.09
10756,U36470,131,-352.0499999999997,111,20,13045.09,12693.04
10757,U31674,131,13336.289999999992,99,32,406604.50999999995,419940.79999999993
10758,U14754,131,222810.58,101,30,75176.94,297987.52
10759,U20259,131,14793.57999999999,119,12,172984.27000000002,187777.85
10760,U13797,131,-82055.04000000001,96,35,305637.3,223582.25999999998
10761,U32335,131,103334.7300000001,106,25,568742.79,672077.5200000001
10762,U15873,131,-10855.889999999996,91,40,206706.92999999996,195851.03999999998
10763,U22272,131,-54236.63000000002,97,34,492324.08999999997,438087.45999999996
10764,U37735,131,-310.13000000000017,115,16,12673.579999999994,12363.449999999993
10765,U14060,131,-37933.219999999994,109,22,118282.81000000004,80349.59000000005
10766,U22652,131,-358745.31000000023,111,20,535595.4500000002,176850.13999999996
10767,U14340,131,5312.730000000001,70,61,317398.92999999993,322711.6599999999
10768,U37563,131,10442.96999999998,114,17,418139.57000000007,428582.54000000004
10769,U15911,131,10423.009999999995,123,8,70471.03000000001,80894.04000000001
10770,U35278,131,-22384.480000000018,119,12,724368.8299999998,701984.3499999999
10771,U43784,131,-5930.8099999999995,103,28,116865.79000000001,110934.98000000001
10772,U20129,131,21600.690000000002,120,11,30222.3,51822.990000000005
10773,U21795,131,19897.519999999993,99,32,266991.67,286889.19
10774,U27333,131,-49965.990000000005,101,30,101250.91,51284.92
10775,U30594,131,-4938.669999999984,120,11,661316.9099999999,656378.24
10776,U8161,131,10045.549999999954,100,31,764593.02,774638.57
10777,U19397,131,-49200.44,100,31,343280.89,294080.45
10778,U35930,131,21362.95,87,44,49247.04,70609.99
10779,U25108,131,1188.299999999999,123,8,15972.16999999999,17160.469999999987
10780,U10525,131,-242.8599999999933,122,9,144045.48,143802.62000000002
10781,U24670,131,-109199.76000000001,86,45,2261330.2899999996,2152130.5299999993
10782,U34408,131,2020.2599999999993,123,8,34046.969999999994,36067.229999999996
10783,U1337082,131,-304.3199999999947,99,32,141201.53999999995,140897.21999999994
10784,U43737,131,444.5700000000004,112,19,41173.53999999999,41618.10999999999
10785,U43386,131,-6816.160000000002,109,22,29024.250000000004,22208.090000000004
10786,U28178,131,13443.449999999997,113,18,87737.34,101180.79
10787,U25721,131,-49636.38999999995,82,49,947708.9099999999,898072.52
10788,U40798,131,2023.3700000000008,89,42,306879.58999999997,308902.95999999996
10789,U31927,131,-3739.4099999999944,116,15,79337.08,75597.67000000001
10790,U623266,131,-5067.59,75,56,52331.770000000004,47264.18000000001
10791,U18315,131,334.8099999999992,63,68,111419.68999999999,111754.49999999999
10792,U9212,131,-908.960000000007,92,39,266858.95000000007,265949.99000000005
10793,U16348,131,1752.1100000000297,106,25,171389.82000000004,173141.93000000005
10794,U43577,131,-5872.26,113,18,33311.46,27439.199999999997
10795,U31898,131,4277.75,94,37,132302.3,136580.05
10796,U16124,131,-31122.120000000054,92,39,1049570.11,1018447.99
10797,U22050,131,49570.400000000016,103,28,233423.14,282993.54000000004
10798,U35221,131,-8165.940000000003,103,28,84584.54,76418.59999999999
10799,U38092,131,-2799.599999999995,106,25,214081.68999999997,211282.08999999997
10800,U24674,131,5792.689999999995,92,39,188587.13999999996,194379.82999999996
10801,U1148158,131,1036.359999999999,70,61,34893.55,35929.91
10802,U1366021,131,1714.1100000000001,95,36,47612.74,49326.85
10803,U23652,131,1052906.66,96,35,624846.8200000001,1677753.48
10804,U29569,131,4098.5599999999995,111,20,24862.63,28961.190000000002
10805,U25281,131,-148308.56000000006,86,45,2073881.91,1925573.3499999999
10806,U28755,131,-3357.8299999999967,120,11,19495.730000000003,16137.900000000007
10807,U30692,131,9895.42,87,44,126118.20999999999,136013.63
10808,U15054,131,12125.649999999947,92,39,373770.5100000001,385896.1600000001
10809,U33884,131,55.26999999999862,113,18,94680.16,94735.43000000001
10810,U32469,131,399036.50999999983,117,14,413091.6700000001,812128.1799999999
10811,U1197581,131,3323.0399999999936,79,52,386708.44,390031.48
10812,U36293,131,4384.910000000007,62,69,509429.87,513814.78
10813,U10172,131,224.80999999993946,93,38,1420841.01,1421065.8199999998
10814,U29086,130,-7891.030000000002,91,39,63294.86999999999,55403.83999999999
10815,U35950,130,94806.81,117,13,185168.94999999998,279975.76
10816,U43595,130,3545.4399999999987,99,31,87042.34999999999,90587.79
10817,U38591,130,2492.879999999999,114,16,13961.369999999995,16454.249999999993
10818,U26747,130,1265.3399999999983,111,19,13380.059999999998,14645.399999999996
10819,U23902,130,266738.08999999997,103,27,103663.28,370401.37
10820,U13532,130,8360.490000000076,108,22,1517375.65,1525736.14
10821,U26629,130,17386.28000000002,106,24,161812.18000000002,179198.46000000005
10822,U15170,130,525.5499999999994,85,45,78898.48,79424.03
10823,U36229,130,957.3200000000015,111,19,49877.97,50835.29
10824,U20314,130,6020.39,115,15,46525.899999999994,52546.28999999999
10825,U27111,130,-15317.719999999994,105,25,162908.81,147591.09
10826,U22002,130,156045.34000000005,110,20,914852.99,1070898.33
10827,U35293,130,8650.139999999985,109,21,244989.27000000005,253639.41000000003
10828,U35721,130,9566.02,119,11,35260.28,44826.3
10829,U14221,130,8159.749999999996,97,33,654321.9,662481.65
10830,U13842,130,6285.550000000025,84,46,543330.5599999999,549616.11
10831,U37121,130,-1085.8799999999997,119,11,7685.339999999999,6599.459999999999
10832,U31892,130,22859.900000000012,96,34,455178.37000000005,478038.2700000001
10833,U19366,130,15870.600000000004,114,16,232983.15999999997,248853.75999999998
10834,U9238,130,21436.639999999974,90,40,556281.0499999999,577717.69
10835,U24108,130,-9848.099999999999,87,43,69484.94000000002,59636.84000000002
10836,U588528,130,9738.45,89,41,60944.87000000002,70683.32000000002
10837,U41991,130,-1058.3700000000006,100,30,22359.33,21300.960000000003
10838,U22003,130,170362.14000000004,110,20,171892.16999999995,342254.31
10839,U43368,130,442.4999999999982,103,27,49834.76000000001,50277.26000000001
10840,U32546,130,-16729.210000000003,117,13,120622.13,103892.92
10841,U33393,130,-150.3599999999974,106,24,19372.23,19221.870000000003
10842,U29122,130,14991.289999999995,120,10,118111.95,133103.24
10843,U41334,130,-39130.220000000016,117,13,137036.63999999996,97906.41999999994
10844,U28087,130,26106.93000000003,113,17,465110.91000000003,491217.8400000001
10845,U25452,130,-2240.990000000009,102,28,225609.10999999996,223368.11999999994
10846,U13820,130,-44416.47,118,12,331807.7099999999,287391.2399999999
10847,U26382,130,-1699.2799999999988,71,59,954587.8999999999,952888.6199999999
10848,U24154,130,-6669.559999999996,95,35,242469.74,235800.18
10849,U24899,130,253444.56999999998,124,6,75522.19000000003,328966.76
10850,U43826,130,11145.669999999998,118,12,28993.059999999998,40138.729999999996
10851,U41078,130,1800.819999999997,116,14,65745.15,67545.96999999999
10852,U20248,130,-8457.089999999993,77,53,506464.93,498007.84
10853,U24788,130,-56136.88,87,43,1049749.88,993612.9999999999
10854,U32695,130,-54142.07999999999,73,57,243706.54,189564.46000000002
10855,U23184,130,-100876.58000000012,88,42,2546443.039999998,2445566.459999998
10856,U38249,130,-19523.86999999999,97,33,289731.1900000001,270207.3200000001
10857,U9843,130,45446.13000000003,120,10,15971.530000000002,61417.66000000003
10858,U29676,130,22093.150000000016,82,48,467754.6100000001,489847.7600000001
10859,U23472,130,-104626.25,117,13,287754.55999999994,183128.30999999994
10860,U39001,130,7453.189999999997,122,8,22640.570000000007,30093.760000000002
10861,U43693,130,15261.949999997285,94,36,27234967.05,27250228.999999996
10862,U22788,130,173.8200000000181,75,55,284938.87,285112.69
10863,U1191451,130,-3711.9800000000005,110,20,25652.940000000028,21940.96000000003
10864,U12281,130,-31641.610000000004,96,34,158862.84999999998,127221.23999999998
10865,U8441,130,66637.18000000002,89,41,414764.9700000001,481402.15000000014
10866,U1263961,130,136.18999999999954,70,60,6101.869999999998,6238.059999999998
10867,U18950,130,6279.859999999987,97,33,250720.02,256999.87999999998
10868,U25097,130,-10353.039999999994,84,46,831316.64,820963.6
10869,U26287,130,-483232.70999999996,118,12,530802.6499999999,47569.939999999944
10870,U27033,130,95052.37000000002,56,74,393684.4,488736.77
10871,U36346,130,-11973.850000000004,84,46,334616.71,322642.86000000004
10872,U25741,130,21269.800000000043,101,29,1198827.25,1220097.05
10873,U33327,130,2110.8799999999997,123,7,10286.199999999999,12397.079999999998
10874,U15452,130,9659.919999999984,119,11,1401771.29,1411431.21
10875,U10765,130,12998.720000000016,73,57,377239.83999999997,390238.56
10876,U43650,130,-15606.840000000002,117,13,58582.71,42975.869999999995
10877,U20237,130,1417.7099999999996,112,18,68182.45,69600.16
10878,U42305,130,-4022.639999999998,113,17,34203.31,30180.67
10879,U38227,130,164160.02,111,19,215779.55999999988,379939.57999999984
10880,U33386,130,891.610000000002,110,20,61123.55,62015.16
10881,U11904,130,-4135.630000000004,110,20,191419.99000000002,187284.36000000002
10882,U15387,130,1868.8800000000037,111,19,117476.03000000003,119344.91000000003
10883,U1237179,130,-846.1900000000049,90,40,58007.80999999999,57161.61999999999
10884,U1357773,130,1.5400000000001057,74,56,10916.060000000001,10917.600000000002
10885,U35761,130,-7111.75,121,9,21238.79,14127.04
10886,U22337,130,8088.569999999999,111,19,27057.639999999996,35146.20999999999
10887,U14089,130,-32191.780000000053,98,32,635459.6499999999,603267.8699999999
10888,U33362,130,6724.350000000002,108,22,123511.08,130235.43000000001
10889,U40144,130,48390.51999999998,84,46,1296440.08,1344830.6
10890,U27430,130,-3716.99,116,14,13266.459999999995,9549.469999999996
10891,U8931,130,250206.2099999995,119,11,6353677.569999999,6603883.779999999
10892,U23371,130,2171.1500000000033,117,13,107914.70999999999,110085.86
10893,U40282,130,2034.6500000000115,112,18,404905.72,406940.37
10894,U8541,130,-14099.23,122,8,82232.08000000003,68132.85000000003
10895,U31277,130,109983.11000000034,95,35,1516588.7200000002,1626571.8300000005
10896,U829619,130,-0.8099999999998202,95,35,4003.1900000000005,4002.3800000000006
10897,U8348,130,-18415.72,108,22,73388.13,54972.41
10898,U25460,130,-3626.3999999999883,111,19,79403.98,75777.58
10899,U25700,130,5297.450000000008,119,11,130735.01,136032.46
10900,U40101,130,-31054.920000000067,108,22,342764.49000000005,311709.57
10901,U16839,130,665.0199999999877,112,18,116254.45,116919.46999999999
10902,U13343,129,-487.67999999997494,112,17,1817014.17,1816526.49
10903,U29682,129,-4142.83,122,7,30334.27,26191.440000000002
10904,U14176,129,-5564.649999999999,124,5,20353.200000000004,14788.550000000007
10905,U17163,129,-44549.78,94,35,745084.05,700534.27
10906,U609291,129,4245.209999999999,93,36,153076.12,157321.33
10907,U24860,129,44348.27,78,51,157526.36999999994,201874.63999999993
10908,U11653,129,559.7600000000291,84,45,287957.6599999999,288517.4199999999
10909,U29124,129,653.379999999981,104,25,1063578.7700000003,1064232.1500000001
10910,U11710,129,97349.23999999999,110,19,212990.82,310340.06
10911,U13486,129,-12012.429999999938,97,32,1500385.8200000003,1488373.3900000004
10912,U37059,129,4872.829999999991,111,18,192266.93999999994,197139.76999999993
10913,U26519,129,-2261.359999999989,107,22,151632.66999999995,149371.30999999997
10914,U36993,129,393.4699999999998,120,9,8014.84,8408.31
10915,U14142,129,27771.670000000024,105,24,572470.8300000001,600242.5000000001
10916,U27058,129,-27351.299999999814,110,19,7383457.71,7356106.41
10917,U8629,129,-6045.180000000004,99,30,80054.93999999999,74009.75999999998
10918,U21565,129,-207595.47000000003,115,14,361111.04999999993,153515.5799999999
10919,U38922,129,14263.440000000031,102,27,701808.6700000004,716072.1100000005
10920,U38195,129,4034.6300000000006,121,8,14483.77,18518.4
10921,U16886,129,-89914.05999999998,93,36,361921.21,272007.15
10922,U19227,129,-927.8500000000131,106,23,88246.69,87318.84
10923,U9432,129,-13807.37,103,26,19943.46,6136.089999999998
10924,U12353,129,3266.0299999999993,113,16,28913.19,32179.219999999998
10925,U36939,129,11779.189999999986,99,30,384247.42999999993,396026.61999999994
10926,U11091,129,349.8400000000099,109,20,99935.53000000001,100285.37000000002
10927,U33981,129,-4053.970000000001,114,15,22269.059999999998,18215.089999999997
10928,U42014,129,5284.4199999999955,123,6,18632.579999999998,23916.999999999993
10929,U38577,129,-639882.6300000002,115,14,767049.3200000003,127166.69000000006
10930,U595755,129,-5356.419999999998,102,27,85604.92,80248.5
10931,U28721,129,18345.469999999994,106,23,144263.67,162609.14
10932,U27498,129,-2535.8199999999915,111,18,223520.01000000004,220984.19000000006
10933,U26367,129,-8482.220000000005,83,46,463578.0900000001,455095.87000000005
10934,U20380,129,-1143.5100000000014,116,13,36258.17,35114.659999999996
10935,U23122,129,694.6100000000006,124,5,12929.909999999998,13624.519999999999
10936,U1251851,129,-15794.549999999996,88,41,383816.62,368022.07
10937,U1316020,129,15.14000000000101,70,59,12857.07,12872.210000000001
10938,U41392,129,-5438.719999999998,99,30,27640.129999999997,22201.41
10939,U10377,129,32801.85999999997,115,14,86867.66000000002,119669.51999999999
10940,U32515,129,-977.1699999999901,126,3,34977.58999999996,34000.41999999997
10941,U25476,129,-31568.829999999998,116,13,45639.71000000001,14070.880000000008
10942,U15802,129,-158622.00000000003,106,23,280325.6600000001,121703.66000000006
10943,U36468,129,-46929.13999999998,119,10,688869.7900000002,641940.6500000001
10944,U37233,129,1438.3499999999985,90,39,157019.81,158458.16
10945,U34431,129,2759.340000000001,120,9,11718.749999999998,14478.09
10946,U34146,129,4082.720000000003,121,8,22212.089999999997,26294.809999999998
10947,U38665,129,80319.33999999997,110,19,1347784.3,1428103.6400000001
10948,U9091,129,633.0300000000034,99,30,112185.74999999997,112818.77999999997
10949,U20974,129,-6843.779999999995,124,5,25102.94,18259.160000000003
10950,U37265,129,-13342.160000000009,107,22,190390.26,177048.1
10951,U20837,129,-176448.46,98,31,569789.3399999999,393340.8799999999
10952,U27313,129,-27456.410000000033,119,10,755964.75,728508.34
10953,U12415,129,9313.19,101,28,74109.26000000001,83422.45000000001
10954,U19821,129,57002.529999999984,89,40,288858.39,345860.92
10955,U24563,129,-47692.87999999999,103,26,185173.52000000002,137480.64
10956,U23699,129,14105.34999999997,99,30,638094.0199999997,652199.3699999996
10957,U13704,129,274138.73,103,26,413683.99,687822.72
10958,U23730,129,-2777.709999999999,99,30,23640.469999999994,20862.759999999995
10959,U31712,129,19833.719999999998,85,44,70333.18000000002,90166.90000000002
10960,U35725,129,-299958.9899999962,47,82,51075432.45,50775473.46000001
10961,U21391,129,2299.539999999989,100,29,65200.46999999999,67500.00999999998
10962,U27843,129,-1046.8400000000024,118,11,61243.069999999985,60196.22999999998
10963,U28341,129,955.3599999999999,114,15,35784.930000000015,36740.290000000015
10964,U21704,129,27384.76999999999,85,44,245005.06000000006,272389.8300000001
10965,U33935,129,-9033.189999999993,125,4,25371.03,16337.840000000006
10966,U33421,129,-32811.97,106,23,215801.17999999996,182989.20999999996
10967,U22771,129,-5582.700000000012,100,29,479566.37,473983.67
10968,U32349,129,20665.23999999999,113,16,341739.6499999999,362404.8899999999
10969,U25227,129,1282931.1099999999,92,37,576526.2199999999,1859457.3299999996
10970,U14789,129,-105048.39999999997,101,28,237563.68999999997,132515.29
10971,U24975,129,78088.36000000002,98,31,396708.60000000003,474796.9600000001
10972,U20931,129,-833.559999999998,110,19,40004.64,39171.08
10973,U20051,129,3499.710000000002,114,15,38668.2,42167.909999999996
10974,U13458,129,-54730.169999999925,116,13,703409.5900000001,648679.4200000002
10975,U16357,129,8060.110000000001,120,9,25642.969999999998,33703.08
10976,U22624,129,-20527.20999999984,86,43,4231575.89,4211048.68
10977,U26043,129,-11858.36,113,16,59336.100000000006,47477.740000000005
10978,U35944,129,-16828.189999999722,82,47,12805949.390000004,12789121.200000005
10979,U39947,129,-656.8999999998632,80,49,1806265.43,1805608.53
10980,U19032,129,13774.879999999994,113,16,47988.009999999995,61762.889999999985
10981,U33270,129,-11568.119999999997,121,8,22441.710000000003,10873.590000000006
10982,U31735,129,76.8200000000013,124,5,14256.149999999998,14332.97
10983,U43025,129,-2735.4600000001897,85,44,1786785.4799999995,1784050.0199999993
10984,U15267,129,2030.06,124,5,7452.220000000002,9482.280000000002
10985,U15107,129,1596.8599999999278,79,50,1501248.99,1502845.8499999999
10986,U42798,129,16652.630000000005,107,22,81515.83,98168.46
10987,U15396,129,-166967.84000000003,102,27,1967008.0400000005,1800040.2000000004
10988,U41261,129,-229245.62999999974,104,25,7669694.65,7440449.0200000005
10989,U41753,129,147376.54000000004,114,15,68615.15,215991.69000000003
10990,U8158,129,-4652.58999999988,62,67,873048.4600000001,868395.8700000002
10991,U18360,129,4142.140000000001,85,44,11325.549999999996,15467.689999999997
10992,U9869,129,6110.119999999903,62,67,4282106.46,4288216.58
10993,U25264,129,-27796.269999999902,87,42,1356928.42,1329132.15
10994,U34715,129,-29144.54999999999,83,46,258493.51000000004,229348.96000000005
10995,U39844,129,-28839.579999999994,101,28,240200.79000000004,211361.21000000005
10996,U22453,129,52863.049999999814,109,20,4785736.67,4838599.72
10997,U13407,129,-33498.729999999996,114,15,311907.2799999998,278408.5499999998
10998,U29887,129,189311.5000000002,104,25,4521809.4700000025,4711120.9700000025
10999,U18413,129,68510.17999999998,82,47,422154.07,490664.25
11000,U17038,129,761918.3799999998,58,71,2897037.49,3658955.87
11001,U42698,129,17358.210000000006,113,16,65767.51,83125.72
11002,U11950,129,-14164.0,122,7,29676.679999999997,15512.679999999997
11003,U16604,129,26016.320000000003,103,26,63607.19000000001,89623.51000000001
11004,U9191,129,-10291.380000000003,117,12,68036.25,57744.869999999995
11005,U27525,129,-17125.07000000001,112,17,73406.88999999998,56281.81999999998
11006,U31806,129,47871.78,102,27,190549.41000000003,238421.19000000003
11007,U9520,129,11534.409999999967,114,15,96879.26999999996,108413.67999999993
11008,U29669,129,-110.33999999999827,118,11,41346.869999999995,41236.53
11009,U13551,129,26394.82,109,20,423103.39999999997,449498.22
11010,U26360,128,12735.180000000002,117,11,52245.43000000001,64980.61000000001
11011,U1146128,128,-9829.84,94,34,28635.10999999999,18805.26999999999
11012,U8093,128,-6525.600000000231,104,24,774695.4899999999,768169.8899999997
11013,U15293,128,-246297.45999999996,95,33,2026493.1700000002,1780195.7100000002
11014,U15292,128,1006.1900000000005,94,34,208571.65000000002,209577.84000000003
11015,U15042,128,-77242.7,101,27,274853.7400000001,197611.0400000001
11016,U11243,128,-62484.48000000001,72,56,634669.94,572185.46
11017,U17237,128,-56483.11999999954,111,17,138530.55999999953,82047.44
11018,U25447,128,109892.97,108,20,45386.23,155279.2
11019,U28116,128,-12689.599999999991,108,20,154248.45,141558.85000000003
11020,U25237,128,-20664.870000000003,112,16,326402.43999999994,305737.56999999995
11021,U28285,128,4258.98,103,25,15662.949999999995,19921.929999999993
11022,U30207,128,-745.0300000000043,87,41,273698.07999999996,272953.04999999993
11023,U14995,128,444364.06000000006,105,23,1116265.06,1560629.12
11024,U983811,128,-12458.71,70,58,25150.61,12691.900000000001
11025,U8994,128,823.4400000000187,79,49,8596281.240000002,8597104.680000002
11026,U15405,128,1708.6100000000006,92,36,42033.38,43741.99
11027,U33982,128,1383.3100000000043,111,17,119534.29000000001,120917.6
11028,U9107,128,545912.3399999999,102,26,562139.77,1108052.1099999999
11029,U37259,128,-2302.8200000000006,122,6,11003.42,8700.599999999999
11030,U17375,128,-27023.890000000058,99,29,971358.9900000001,944335.1000000001
11031,U20506,128,-5248.860000000001,111,17,47213.23999999999,41964.37999999999
11032,U16159,128,-49093.12999999999,101,27,158486.94,109393.81000000001
11033,U26468,128,28863.810000000023,113,15,88421.74000000002,117285.55000000005
11034,U19387,128,16520.670000000013,99,29,38658.41000000003,55179.080000000045
11035,U12524,128,905.2900000000038,63,65,312142.58999999997,313047.87999999995
11036,U1099024,128,149.6799999999999,100,28,4524.01,4673.6900000000005
11037,U24061,128,-46582.42,119,9,197974.61999999997,151392.19999999995
11038,U37031,128,-56528.23999999999,108,20,327185.38000000006,270657.1400000001
11039,U21202,128,-138205.72999999998,92,36,338401.56999999995,200195.83999999997
11040,U13168,128,-9108.969999999998,99,29,331425.67,322316.7
11041,U20674,128,-54863.200000000026,102,26,1116074.61,1061211.4100000001
11042,U16439,128,-30665.209999999985,117,11,88008.14000000001,57342.93000000003
11043,U17334,128,-48697.959999999905,110,18,5893661.540000002,5844963.580000002
11044,U17912,128,-4403.8799999999965,70,58,67672.08,63268.200000000004
11045,U43685,128,2192.340000000001,109,19,73056.13,75248.47
11046,U960019,128,1819.9299999999996,90,38,31794.74,33614.67
11047,U35770,128,-28224.21,94,34,412210.02,383985.81
11048,U26676,128,-2298.5800000000045,101,27,70887.58,68589.0
11049,U29266,128,1068.6100000000074,118,10,48155.19000000001,49223.80000000002
11050,U39168,128,-25745.980000000003,105,23,201161.14999999997,175415.16999999995
11051,U27468,128,353134.02999999997,109,19,320650.78999999986,673784.8199999998
11052,U35525,128,-10651.200000000006,108,20,70209.46,59558.26
11053,U33936,128,-5522.109999999993,115,13,37666.55,32144.44000000001
11054,U20884,128,159.11999999999898,114,14,38404.61,38563.729999999996
11055,U37957,128,4722.159999999996,94,34,138640.16,143362.32
11056,U41600,128,54050.900000000016,88,40,259329.42,313380.32
11057,U16728,128,-20069.34999999999,118,10,44093.01000000001,24023.660000000018
11058,U15368,128,-7676.960000000015,109,19,286162.41000000003,278485.45
11059,U39401,128,54692.52999999999,112,16,137502.25,192194.78
11060,U12432,128,-121556.65000000001,116,12,299188.67000000004,177632.02000000002
11061,U43509,128,-40631.389999999956,76,52,614891.4400000001,574260.05
11062,U12251,128,2271.7600000000048,115,13,38054.92999999999,40326.689999999995
11063,U10742,128,7778.599999999997,119,9,26107.05,33885.649999999994
11064,U13816,128,-300.9599999999991,112,16,28272.89,27971.93
11065,U13899,128,25185.110000000044,61,67,1804248.17,1829433.28
11066,U13834,128,56222.13999999999,95,33,424149.83,480371.97000000003
11067,U16791,128,154261.24000000005,93,35,641046.7599999998,795307.9999999998
11068,U28628,128,48424.169999999984,94,34,856661.309999999,905085.479999999
11069,U41365,128,46200.93999999997,113,15,89624.81,135825.74999999997
11070,U32654,128,-9338.289999999986,100,28,472064.69,462726.4
11071,U26661,128,155445.05999999994,106,22,1456871.97,1612317.0299999998
11072,U43465,128,-27422.820000000003,75,53,94996.69,67573.87
11073,U16233,128,8275.830000000105,85,43,2403959.7699999996,2412235.5999999996
11074,U26791,128,-15471.219999999932,66,62,2935509.29,2920038.0700000003
11075,U10714,128,-2311.3699999999994,100,28,67241.93,64930.55999999999
11076,U42149,128,64642.01000000005,102,26,267084.54000000004,331726.5500000001
11077,U12258,128,280.03000000000077,103,25,39482.25,39762.28
11078,U43949,128,24997.85000000001,106,22,204910.58999999997,229908.43999999997
11079,U8115,128,4536.959999999999,108,20,31227.050000000003,35764.01
11080,U953788,128,226.06000000000006,104,24,1903.9500000000003,2130.01
11081,U27069,128,-4217.479999999984,75,53,329525.4,325307.92000000004
11082,U18605,128,-206580.8400000004,102,26,7552459.550000003,7345878.710000002
11083,U38049,128,511.8900000000003,118,10,6208.92,6720.81
11084,U25658,128,-213.72999999999593,85,43,350598.2800000001,350384.5500000001
11085,U30125,128,9078.929999999775,81,47,3360458.46,3369537.3899999997
11086,U43266,128,-62410.50000000001,116,12,169846.67000000004,107436.17000000004
11087,U27088,128,-94757.50999999998,114,14,248471.33000000002,153713.82000000004
11088,U28357,128,17896.769999999997,105,23,318015.5,335912.27
11089,U43210,128,24357.439999999995,67,61,132303.95,156661.39
11090,U40814,128,16041.460000000014,72,56,496255.9,512297.36000000004
11091,U27233,128,105480.98999999987,83,45,9664992.68,9770473.67
11092,U23326,128,-1744.1099999999988,115,13,147803.2699999999,146059.15999999992
11093,U30873,128,-111548.26000000001,123,5,132279.19999999998,20730.939999999973
11094,U17595,128,-214626.5299999999,72,56,775825.4200000002,561198.8900000002
11095,U19081,128,1421.16,114,14,23745.83,25166.99
11096,U8200,128,1497.5499999999997,112,16,23406.420000000002,24903.97
11097,U40621,128,-55071.73999999994,77,51,181070.72999999984,125998.9899999999
11098,U21916,128,-3871.2199999999975,113,15,55050.63,51179.41
11099,U31054,128,-2080.58,120,8,11471.679999999998,9391.099999999999
11100,U27007,128,439069.24,95,33,2846734.94,3285804.1799999997
11101,U28452,128,24643.540000000005,82,46,254727.94000000006,279371.48000000004
11102,U18291,128,-10319.250000000004,113,15,116738.38,106419.13
11103,U21926,128,508.72000000001657,112,16,46560.05,47068.77000000002
11104,U9956,128,6300.480000000003,75,53,53146.270000000004,59446.75000000001
11105,U13050,128,-2435.6499999999983,93,35,43640.14,41204.49
11106,U13577,127,-30921.37999999991,70,57,1185820.44,1154899.06
11107,U10810,127,-344.73999999999205,107,20,32532.099999999995,32187.360000000004
11108,U26917,127,-7700.099999999597,65,62,4228425.38,4220725.28
11109,U15172,127,24134.549999999985,114,13,108825.12999999999,132959.67999999996
11110,U12786,127,1344.4200000000205,84,43,925997.2300000001,927341.6500000001
11111,U15408,127,10645.799999999996,106,21,51272.24,61918.03999999999
11112,U39651,127,474.9300000000221,81,46,938267.53,938742.4600000001
11113,U38593,127,-66974.04999999999,107,20,160237.66,93263.61000000002
11114,U35978,127,20526.899999999998,70,57,1053247.69,1073774.5899999999
11115,U26133,127,-5961.439999999988,70,57,722380.42,716418.9800000001
11116,U43706,127,56775.86000000007,94,33,458270.36000000004,515046.2200000001
11117,U12456,127,200.56999999999277,112,15,96942.61999999998,97143.18999999997
11118,U22587,127,40350.23,66,61,4120760.79,4161111.02
11119,U8411,127,2695.3499999999913,118,9,171481.91,174177.26
11120,U13846,127,108.41999999999462,90,37,122697.2,122805.62
11121,U17698,127,-933.6100000000002,91,36,8685.190000000002,7751.580000000002
11122,U1342141,127,26239.540000000008,92,35,112500.49000000002,138740.03000000003
11123,U30943,127,74166.32999999997,97,30,561895.47,636061.7999999999
11124,U8891,127,-82.24000000000046,115,12,19906.93,19824.69
11125,U42167,127,12339.589999999991,44,83,61901.13,74240.71999999999
11126,U38087,127,34406.810000000005,100,27,91688.53000000001,126095.34000000003
11127,U36506,127,1904.3799999999987,116,11,24690.409999999993,26594.78999999999
11128,U10610,127,695.2199999999989,108,19,24321.190000000002,25016.41
11129,U27704,127,-924.5700000000115,94,33,188141.31,187216.74
11130,U23401,127,67091.58000000002,74,53,1154960.96,1222052.54
11131,U10616,127,-11772.75,106,21,44881.479999999996,33108.729999999996
11132,U30833,127,1433.989999999997,80,47,61407.94,62841.93
11133,U608488,127,-5422.4500000000035,76,51,114416.94000000005,108994.49000000005
11134,U18583,127,-91612.58000000002,111,16,288253.87999999995,196641.29999999993
11135,U37452,127,3550.22,124,3,4055.2600000000007,7605.4800000000005
11136,U24111,127,-18845.42999999998,111,16,140871.83999999997,122026.40999999999
11137,U19970,127,1013.5100000000039,78,49,292759.41000000003,293772.92000000004
11138,U20575,127,37989.99999999999,109,18,140191.57,178181.57
11139,U24338,127,4906.489999999889,83,44,1992281.2999999998,1997187.7899999998
11140,U43796,127,3635.750000000029,107,20,270299.53,273935.28
11141,U34939,127,1017.1199999999999,117,10,6682.130000000002,7699.250000000002
11142,U25105,127,580.0699999999999,117,10,8972.639999999996,9552.709999999995
11143,U26402,127,170423.35000000003,102,25,457840.08999999997,628263.44
11144,U12792,127,9137.829999999994,86,41,612351.01,621488.84
11145,U985087,127,-23244.639999999985,92,35,129330.49999999999,106085.86
11146,U33026,127,4263.120000000003,110,17,188566.25000000003,192829.37000000002
11147,U26344,127,-138373.32000000004,98,29,734394.6499999999,596021.3299999998
11148,U14029,127,-15992.889999999996,112,15,165220.58000000005,149227.69000000006
11149,U31685,127,-9776.610000000008,113,14,102366.62999999999,92590.01999999999
11150,U11743,127,-90991.4799999999,65,62,1157690.63,1066699.15
11151,U36894,127,7043.320000000001,67,60,404697.62000000005,411740.94000000006
11152,U21180,127,-59349.459999999985,109,18,207678.76,148329.30000000002
11153,U10624,127,-3620.0700000000024,69,58,236605.75999999998,232985.68999999997
11154,U17746,127,-238558.67000000004,88,39,922319.29,683760.62
11155,U10219,127,20111.699999999993,107,20,98784.3,118896.0
11156,U23712,127,-4443.689999999999,125,2,11568.939999999999,7125.25
11157,U10077,127,-50615.07999999999,107,20,257451.58000000002,206836.50000000003
11158,U20263,127,-957.5400000000004,119,8,19910.809999999994,18953.269999999993
11159,U37549,127,9304.53,111,16,18565.280000000002,27869.810000000005
11160,U12221,127,14763.739999999976,101,26,388741.76,403505.5
11161,U42565,127,179466.97000000003,70,57,379118.98000000004,558585.9500000001
11162,U38695,127,-6060.5699999999915,97,30,996803.9399999998,990743.3699999999
11163,U27503,127,-24459.86000000001,55,72,324085.91000000003,299626.05000000005
11164,U16318,127,-193.65999999997985,85,42,485455.29999999993,485261.63999999996
11165,U10136,127,8148.229999999997,110,17,42483.130000000005,50631.36
11166,U32137,127,796.4399999999997,46,81,17289.71,18086.149999999998
11167,U26740,127,4154.32,106,21,31797.820000000007,35952.14000000001
11168,U753754,127,133.58999999999995,73,54,36618.56,36752.149999999994
11169,U42546,127,28709.940000000006,97,30,173893.31999999992,202603.25999999992
11170,U10009,127,-293342.4400000001,114,13,895207.7600000006,601865.3200000005
11171,U41036,127,663.0299999999986,83,44,10450.210000000001,11113.24
11172,U27439,127,81571.68000000001,89,38,221448.07999999996,303019.75999999995
11173,U29786,127,2143.7800000000043,109,18,103318.28,105462.06
11174,U9499,127,-1136.9999999999923,108,19,105466.59000000004,104329.59000000005
11175,U14564,127,1874.0599999999995,120,7,20588.56,22462.620000000003
11176,U14401,127,8799.890000000005,110,17,139336.50999999995,148136.39999999997
11177,U22309,127,-23434.35000000001,104,23,195031.60000000012,171597.25000000012
11178,U34423,127,-10839.9,118,9,40635.32,29795.42
11179,U40675,127,-17831.110000000008,114,13,111515.84999999999,93684.73999999999
11180,U18324,127,94459.34999999998,96,31,789962.5800000001,884421.93
11181,U14192,127,-40465.13999999996,108,19,301520.6400000002,261055.50000000023
11182,U35504,127,27069.8,110,17,63886.19000000004,90955.99000000003
11183,U34460,127,4030.569999999998,92,35,264814.74,268845.31
11184,U17664,127,-3276.440000000004,104,23,114049.66999999998,110773.22999999998
11185,U30000,127,-209.3199999999996,84,43,28043.210000000006,27833.890000000007
11186,U38646,127,126268.13000000012,94,33,12879796.65,13006064.780000001
11187,U29556,127,103737.17,122,5,8519.57,112256.73999999999
11188,U16852,127,3433.3199999999492,88,39,1195069.0,1198502.32
11189,U40337,127,-279.9299999999985,85,42,554422.4000000001,554142.4700000001
11190,U36840,127,89835.85999999999,83,44,511742.95999999996,601578.82
11191,U38594,127,413058.81999999995,106,21,223229.67,636288.49
11192,U14699,127,32290.259999999944,115,12,18389.539999999994,50679.79999999994
11193,U41925,127,32290.249999999985,102,25,59746.310000000005,92036.56
11194,U20093,127,-95110.12,112,15,180809.52,85699.4
11195,U939095,127,-2889.8399999999997,78,49,111463.34,108573.5
11196,U29599,127,45656.930000000015,101,26,66885.57999999999,112542.51000000001
11197,U25001,127,12646.309999999994,103,24,138261.65000000002,150907.96000000002
11198,U25114,127,9511.959999999992,71,56,2049933.16,2059445.1199999999
11199,U13829,127,-9713.599999999999,103,24,66029.16,56315.560000000005
11200,U38534,127,-71589.48,119,8,216657.75999999998,145068.27999999997
11201,U8532,126,-7452.659999999983,91,35,573455.49,566002.83
11202,U20405,126,-4373.469999999996,86,40,73443.85000000002,69070.38000000002
11203,U39919,126,11963.93000000003,67,59,898802.3100000003,910766.2400000003
11204,U17250,126,-46295.219999999994,106,20,866280.4500000002,819985.2300000002
11205,U22601,126,17616.32,115,11,50671.56,68287.88
11206,U26478,126,66790.8,105,21,166114.58,232905.38
11207,U21179,126,-1457.7699999999968,114,12,13467.23,12009.460000000003
11208,U33765,126,17445.64999999998,37,89,367086.44,384532.08999999997
11209,U14957,126,4966.240000000007,116,10,114154.68000000001,119120.92000000001
11210,U24673,126,28582.090000000004,114,12,189474.67,218056.76
11211,U32565,126,-4607.529999999995,69,57,785832.4400000001,781224.91
11212,U32187,126,1420.4999999999968,85,41,340482.0100000002,341902.5100000002
11213,U21986,126,-3745.9800000000005,121,5,12562.709999999997,8816.729999999996
11214,U21128,126,21098.350000000013,113,13,239015.37999999998,260113.72999999998
11215,U43755,126,-1749.6699999999946,93,33,200196.36,198446.69
11216,U40623,126,48768.24000000004,107,19,699559.11,748327.35
11217,U31679,126,-38735.39000000002,107,19,678710.4900000001,639975.1000000001
11218,U42095,126,-77626.21000000002,88,38,593696.62,516070.41
11219,U32079,126,-6760.4499999999925,103,23,196561.97999999995,189801.52999999997
11220,U41826,126,-536.0000000000002,115,11,13891.81,13355.81
11221,U19655,126,22063.84000000001,77,49,526547.1699999999,548611.0099999999
11222,U900805,126,7473.130000000001,70,56,224126.11,231599.24
11223,U27034,126,31766.870000000003,107,19,67860.84999999999,99627.72
11224,U11757,126,14629.579999999998,81,45,78212.5,92842.08
11225,U31650,126,-21295.489999999998,87,39,98390.77,77095.28
11226,U15772,126,-8527.98,117,9,22561.870000000003,14033.890000000003
11227,U36481,126,5173.240000000001,107,19,28974.72999999999,34147.96999999999
11228,U850774,126,597.65,88,38,9770.65,10368.3
11229,U17347,126,-2888.899999999994,96,30,443993.52,441104.62
11230,U12835,126,134310.5600000001,113,13,937123.5999999999,1071434.16
11231,U31886,126,-2937.4399999999987,109,17,32654.219999999998,29716.78
11232,U1355735,126,1649.409999999999,104,22,35888.44,37537.85
11233,U15805,126,11863.510000000007,97,29,204286.27000000005,216149.78000000006
11234,U13715,126,208.63000000000102,90,36,129782.3,129990.93000000001
11235,U37320,126,2702.7100000000005,105,21,80480.40000000002,83183.11000000003
11236,U29391,126,-27005.360000000033,88,38,545888.5,518883.13999999996
11237,U42902,126,-2874.3499999999985,98,28,223220.32000000004,220345.97000000003
11238,U20598,126,-31523.52999999997,104,22,573865.46,542341.9299999999
11239,U17197,126,98442.77999999998,110,16,168901.44999999998,267344.23
11240,U19921,126,-16739.300000000003,122,4,138418.14,121678.84000000001
11241,U14615,126,-32522.24,112,14,179552.69000000003,147030.45000000004
11242,U23170,126,43837.54999999999,112,14,357994.39,401831.94
11243,U1114243,126,66.16000000000005,77,49,8564.179999999998,8630.339999999998
11244,U24987,126,-16638.48000000001,104,22,103795.38000000005,87156.90000000004
11245,U12042,126,9860.329999999998,114,12,23013.719999999994,32874.04999999999
11246,U41638,126,-48387.39999999994,83,43,953309.2300000002,904921.8300000003
11247,U27259,126,19712.84999999999,94,32,119729.29000000001,139442.14
11248,U21757,126,2281.960000000172,56,70,1769776.15,1772058.11
11249,U43484,126,-8020.180000000008,100,26,432136.68,424116.5
11250,U33646,126,-49813.509999999995,118,8,68657.32999999999,18843.819999999992
11251,U14613,126,8491.82,114,12,82780.82999999997,91272.64999999997
11252,U32696,126,-2864.120000000001,122,4,6532.2300000000005,3668.1099999999997
11253,U32746,126,-17599.220000000005,118,8,38168.68,20569.459999999995
11254,U43790,126,2341.640000000003,106,20,40568.68,42910.32000000001
11255,U14846,126,43359.110000000066,69,57,672124.9299999999,715484.04
11256,U15410,126,5448.420000000003,111,15,33189.020000000004,38637.44000000001
11257,U39598,126,2243.67,108,18,50941.100000000006,53184.770000000004
11258,U36770,126,299.72999999999956,117,9,43687.23,43986.96000000001
11259,U21193,126,-2544.4899999999952,117,9,77402.2,74857.71
11260,U43023,126,1221.32,111,15,20979.220000000005,22200.540000000005
11261,U34674,126,-57978.64,64,62,582263.3899999999,524284.7499999999
11262,U14552,126,712.8200000000024,67,59,33195.03,33907.85
11263,U28899,126,-16834.420000000002,67,59,303089.18,286254.76
11264,U39655,126,-20990.869999999988,71,55,1250223.99,1229233.12
11265,U30569,126,22707.42,96,30,224985.58,247693.0
11266,U18436,126,3753.6099999999974,107,19,25438.289999999994,29191.89999999999
11267,U10199,126,-1883.6299999999987,117,9,13680.619999999999,11796.99
11268,U37269,126,6713.549999999998,101,25,42827.46000000001,49541.01
11269,U25950,126,8382.039999999992,111,15,101818.24,110200.28
11270,U41945,126,-3833.68,122,4,4945.599999999999,1111.9199999999996
11271,U36502,126,41457.13000000009,98,28,1254001.1500000001,1295458.2800000003
11272,U29111,126,840.9200000000023,102,24,112391.06999999999,113231.98999999999
11273,U24244,126,39902.12000000005,110,16,486406.7,526308.8200000001
11274,U41338,126,-5705.149999999984,110,16,335078.55000000005,329373.4000000001
11275,U29846,126,37604.37000000011,105,21,1412620.78,1450225.1500000001
11276,U34455,126,225651.42000000004,55,71,291961.64,517613.06000000006
11277,U1175244,126,-3.5599999999999223,70,56,803.6399999999992,800.0799999999992
11278,U14327,126,-3288.779999999993,95,31,685190.83,681902.0499999999
11279,U8299,126,88.13000000000261,84,42,123129.94,123218.07
11280,U41005,126,20768.019999999997,105,21,159690.41999999995,180458.43999999994
11281,U29655,126,-8166.669999999996,118,8,51430.90000000001,43264.23000000001
11282,U23295,126,-105988.39000000004,110,16,414035.55999999994,308047.1699999999
11283,U36301,126,-23161.43999999999,112,14,166866.66000000003,143705.22000000003
11284,U32208,126,-3656.5499999999984,110,16,450278.0099999999,446621.4599999999
11285,U11615,126,-222612.63,117,9,363649.38,141036.75
11286,U41256,126,-25068.98,84,42,191662.29,166593.31
11287,U15350,126,-9741.16,118,8,13014.18,3273.0200000000004
11288,U32427,126,24503.159999999996,97,29,73591.10999999999,98094.26999999999
11289,U21842,126,-313413.65999999986,112,14,513550.0999999999,200136.44000000006
11290,U35178,126,101966.26,103,23,312336.91000000003,414303.17000000004
11291,U16735,126,10264.040000000146,85,41,1397548.2899999998,1407812.3299999998
11292,U40365,126,-6245.77,113,13,33315.31000000002,27069.54000000002
11293,U20444,126,-24822.06000000001,108,18,267232.12999999995,242410.06999999995
11294,U35042,126,-9776.200000000019,100,26,400219.9199999999,390443.7199999999
11295,U26137,126,-4482.739999999998,109,17,106057.61000000002,101574.87000000002
11296,U38077,126,-969.5300000000005,115,11,6984.470000000001,6014.9400000000005
11297,U38387,126,109.60000000000116,108,18,165325.84999999998,165435.44999999998
11298,U36202,126,6242.790000000002,109,17,103837.60999999999,110080.4
11299,U14141,126,147553.65000000008,97,29,623456.2100000001,771009.8600000001
11300,U17115,126,4533.049999999989,110,16,78160.63999999998,82693.68999999997
11301,U19910,125,4457.23,117,8,13136.339999999998,17593.57
11302,U39802,125,-2395.9699999999984,108,17,19676.150000000005,17280.180000000008
11303,U33547,125,12789.499999999995,90,35,147511.75000000003,160301.25000000003
11304,U27685,125,-23256.85,107,18,119154.21999999999,95897.37
11305,U30484,125,426038.2399999999,60,65,821238.7799999999,1247277.0199999998
11306,U19681,125,3323.9799999999886,74,51,242633.05000000002,245957.03
11307,U12601,125,92740.82000000004,98,27,783716.2200000001,876457.0400000002
11308,U19539,125,-10676.069999999994,115,10,21585.910000000003,10909.84000000001
11309,U9766,125,-4226.879999999998,113,12,46163.26,41936.380000000005
11310,U16300,125,-14981.110000000006,110,15,335168.4200000001,320187.3100000001
11311,U10080,125,106084.43000000001,98,27,755206.2499999999,861290.6799999999
11312,U36108,125,-600.0700000000452,94,31,1587856.2100000002,1587256.1400000001
11313,U1382481,125,-20389.770000000004,106,19,116072.52000000002,95682.75000000001
11314,U15376,125,-11239.329999999998,81,44,141464.27,130224.93999999999
11315,U11212,125,-19012.47,110,15,65257.600000000006,46245.130000000005
11316,U13255,125,102242.15000000017,69,56,336402.7399999998,438644.89
11317,U33000,125,-19931.259999999995,116,9,136997.27000000002,117066.01000000002
11318,U38718,125,-86163.91999999998,101,24,365708.91000000003,279544.99000000005
11319,U20413,125,-892.1199999999983,107,18,19812.349999999984,18920.229999999985
11320,U38264,125,10588.660000000005,111,14,19454.309999999994,30042.97
11321,U32663,125,18164.89,109,16,53236.72000000001,71401.61000000002
11322,U15437,125,-27234.969999999917,97,28,2302729.5999999996,2275494.63
11323,U35638,125,638913.4000000004,95,30,62842.24,701755.6400000004
11324,U37642,125,-12598.750000000004,120,5,45626.73999999999,33027.98999999999
11325,U26621,125,-631.7500000000036,106,19,62505.66000000001,61873.91
11326,U10822,125,-5496.230000000001,120,5,20987.350000000002,15491.12
11327,U9288,125,7123.840000000015,75,50,478449.35,485573.19
11328,U38955,125,20616.59000000004,61,64,360209.12,380825.71
11329,U17811,125,-61279.91000000004,100,25,204210.64999999997,142930.73999999993
11330,U34692,125,93240.26,59,66,210067.24,303307.5
11331,U13457,125,-10140.139999999998,118,7,15220.699999999995,5080.559999999998
11332,U13412,125,3944.7999999999847,111,14,39847.330000000016,43792.130000000005
11333,U28508,125,42497.52,89,36,186140.89999999994,228638.41999999993
11334,U31207,125,-6424.520000000002,119,6,7933.200000000002,1508.6799999999994
11335,U22667,125,40164.74000000004,78,47,137973.43999999997,178138.18000000002
11336,U25056,125,-2970.9699999999993,116,9,24126.410000000014,21155.440000000017
11337,U16067,125,237949.63,98,27,162085.74,400035.37
11338,U23270,125,2042.5100000000023,97,28,315834.39999999997,317876.91
11339,U16853,125,-278582.62,83,42,572916.7,294334.07999999996
11340,U861258,125,-4540.400000000002,100,25,33697.86999999997,29157.469999999972
11341,U13664,125,-13975.77000000006,114,11,641764.8300000001,627789.06
11342,U8544,125,985.9199999999946,112,13,129698.81,130684.73
11343,U39441,125,-45065.130000000005,114,11,84869.01,39803.87999999999
11344,U33388,125,-1128.8000000000006,111,14,42907.72,41778.92
11345,U24218,125,-515.3300000000028,115,10,22203.59999999999,21688.26999999999
11346,U19339,125,-45839.49,90,35,494506.05000000005,448666.56000000006
11347,U32813,125,-82721.53,49,76,685164.5799999998,602443.0499999998
11348,U28125,125,3817.1400000000017,83,42,130666.97000000006,134484.11000000007
11349,U9925,125,-29705.219999999998,115,10,57043.18000000001,27337.96000000001
11350,U23340,125,51363.049999999996,113,12,108209.85999999999,159572.90999999997
11351,U759935,125,6318.359999999996,76,49,96863.66000000002,103182.02000000002
11352,U29059,125,-8.810000000015634,76,49,301270.86,301262.05
11353,U28462,125,-4962.729999999999,92,33,126923.73999999998,121961.00999999998
11354,U36742,125,14969.780000000006,105,20,283629.36,298599.14
11355,U40037,125,21289.719999999943,86,39,1196292.5299999998,1217582.2499999998
11356,U38351,125,202139.62999999995,105,20,216147.61000000004,418287.24
11357,U15348,125,-110725.05999999997,96,29,1087286.2200000002,976561.1600000003
11358,U13957,125,-65715.52999999998,88,37,1109689.13,1043973.5999999999
11359,U41208,125,13363.399999999929,104,21,1050747.01,1064110.41
11360,U36565,125,-1941.6999999999987,99,26,83608.48999999999,81666.79
11361,U11095,125,-20578.849999999904,84,41,925067.76,904488.9100000001
11362,U19533,125,37126.20999999996,113,12,363013.62000000005,400139.83
11363,U29512,125,-39861.62000000001,88,37,964728.5499999998,924866.9299999998
11364,U30704,125,15102.440000000011,96,29,130608.26999999999,145710.71
11365,U18215,125,-17633.61999999999,113,12,106418.69999999998,88785.07999999999
11366,U10252,125,4579.509999999594,58,67,4126564.72,4131144.23
11367,U24730,125,-7809.939999999995,103,22,119474.39,111664.45000000001
11368,U8953,125,-6957.72,107,18,31363.54,24405.82
11369,U851554,125,7125.219999999998,101,24,45674.66,52799.880000000005
11370,U25893,125,49932.91000000003,82,43,1348827.74,1398760.65
11371,U42241,125,314.0599999999998,113,12,14399.220000000003,14713.280000000002
11372,U33892,125,-65821.95000000001,108,17,95091.92,29269.969999999987
11373,U9357,125,8679.43,111,14,4179.84,12859.27
11374,U32756,125,-8949.869999999999,104,21,40200.38,31250.51
11375,U22805,125,-7813.24000000001,96,29,218535.27000000016,210722.03000000014
11376,U31493,125,-8354.390000000014,92,33,502083.3999999998,493729.0099999998
11377,U20297,125,-3560.209999999948,83,42,1057281.3599999999,1053721.15
11378,U16099,125,12408.689999999944,90,35,1214361.8099999996,1226770.4999999995
11379,U25203,125,-44449.729999999996,100,25,139826.46000000002,95376.73000000003
11380,U38307,125,-35.09000000001379,96,29,122345.37000000001,122310.28
11381,U13827,125,-67265.76000000001,82,43,637176.8,569911.04
11382,U957927,125,144.06000000000017,67,58,17262.829999999998,17406.89
11383,U38232,125,-85266.98000000003,113,12,299677.06,214410.07999999996
11384,U9066,125,-5241.559999999997,99,26,357537.24,352295.68
11385,U43766,125,8333.719999999998,101,24,174682.8699999999,183016.5899999999
11386,U8343,125,6025.29999999997,73,52,256731.41,262756.70999999996
11387,U27384,125,-77541.35000000002,97,28,99687.23000000001,22145.87999999999
11388,U23051,125,-13382.689999999973,109,16,366890.14,353507.45000000007
11389,U42678,125,55618.709999999985,100,25,67818.92000000001,123437.63
11390,U687080,125,-12639.650000000001,76,49,113723.15000000001,101083.5
11391,U39492,125,103487.54999999997,103,22,1067044.8100000003,1170532.3600000003
11392,U11419,125,-79348.64000000003,102,23,731384.0299999999,652035.3899999999
11393,U37703,125,14022.550000000003,103,22,16777.099999999995,30799.649999999998
11394,U17091,124,-31169.980000000014,98,26,690353.4900000001,659183.5100000001
11395,U16760,124,204.16000000000034,111,13,13363.449999999992,13567.609999999991
11396,U21338,124,-6895.35,121,3,14972.409999999998,8077.059999999998
11397,U17475,124,58044.450000000004,93,31,174665.35999999996,232709.80999999997
11398,U33311,124,11614.640000000003,83,41,177777.49000000002,189392.13000000003
11399,U34273,124,-12663.619999999974,98,26,390667.4,378003.78
11400,U38014,124,587426.8099999998,114,10,24813.429999999993,612240.2399999998
11401,U32916,124,-68603.89000000013,75,49,2223700.6799999997,2155096.7899999996
11402,U40576,124,66339.58999999997,111,13,167980.1,234319.68999999997
11403,U36091,124,5088.139999999998,113,11,32416.34,37504.479999999996
11404,U37669,124,-22764.610000000004,87,37,260928.67,238164.06
11405,U24143,124,-4220.9900000000125,109,15,233631.28,229410.28999999998
11406,U9457,124,114.78999999999996,90,34,18025.01,18139.8
11407,U10584,124,517.0699999999995,110,14,89733.16,90250.23
11408,U15499,124,-3733294.0699999994,98,26,8382778.36,4649484.290000001
11409,U32605,124,-4769.999999999991,97,27,362744.4000000001,357974.4000000001
11410,U35332,124,2678.5600000000004,113,11,48299.159999999996,50977.719999999994
11411,U17608,124,-32198.33000000001,98,26,178013.93,145815.59999999998
11412,U19204,124,408.62000000000626,105,19,38386.67000000001,38795.29000000002
11413,U13817,124,-6197.3799999999965,115,9,63415.280000000035,57217.90000000004
11414,U18624,124,402.3600000000559,82,42,2190053.8299999996,2190456.1899999995
11415,U42767,124,17427.13000000001,91,33,106752.92,124180.05
11416,U18541,124,-3104.029999999998,93,31,92417.06,89313.03
11417,U11151,124,47808.710000000014,97,27,312470.38999999996,360279.1
11418,U20434,124,-361.42000000000024,104,20,13860.939999999999,13499.519999999999
11419,U30567,124,36409.20999999996,104,20,358754.7199999998,395163.92999999976
11420,U12771,124,16817.770000000004,77,47,356548.75,373366.52
11421,U36581,124,-100023.89000000004,105,19,221096.06,121072.16999999995
11422,U10038,124,43434.62000000001,100,24,257126.90999999997,300561.52999999997
11423,U13922,124,-1851.5100000000075,115,9,89244.98000000001,87393.47
11424,U43242,124,59981.30000000001,104,20,59681.22,119662.52000000002
11425,U37588,124,-13892.649999999998,110,14,99985.50000000003,86092.85000000003
11426,U31583,124,11674.700000000004,58,66,198972.62,210647.32
11427,U992884,124,-181.19000000000142,63,61,124000.0,123818.81
11428,U18050,124,-18803.330000000013,117,7,56206.98999999997,37403.65999999996
11429,U8474,124,63946.7,101,23,219343.94,283290.64
11430,U26832,124,6251.759999999989,79,45,193890.96000000008,200142.72000000006
11431,U21146,124,6403.34000000002,119,5,5029.660000000002,11433.000000000022
11432,U23916,124,909631.3900000001,102,22,2344369.52,3254000.91
11433,U9197,124,-10955.189999999997,106,18,154575.76999999996,143620.57999999996
11434,U26970,124,7637.250000000033,99,25,2179535.19,2187172.44
11435,U29703,124,-2336.3300000000013,109,15,59489.149999999994,57152.81999999999
11436,U1130113,124,-70.52000000000015,73,51,7551.780000000001,7481.26
11437,U22964,124,37143.5500000002,71,53,917642.31,954785.8600000002
11438,U13153,124,33408.31999999999,80,44,345233.9999999999,378642.3199999999
11439,U9037,124,5412.200000000012,99,25,574086.3900000001,579498.5900000001
11440,U41462,124,2881.479999999995,111,13,77493.48000000003,80374.96000000002
11441,U30699,124,-28.440000000001714,108,16,16369.309999999998,16340.869999999995
11442,U16862,124,1823.679999999996,118,6,20197.270000000004,22020.95
11443,U8623,124,11964.629999999994,104,20,376064.3399999999,388028.9699999999
11444,U40807,124,-34829.76000000005,49,75,1583246.44,1548416.68
11445,U42937,124,6436.530000000002,104,20,218316.94999999998,224753.47999999998
11446,U30424,124,79687.12,113,11,96661.42000000001,176348.54
11447,U17556,124,3295.6799999999967,108,16,46428.67,49724.34999999999
11448,U39743,124,39336.040000000015,111,13,128012.52,167348.56000000003
11449,U30311,124,-77.17,102,22,2314.8000000000006,2237.6300000000006
11450,U24608,124,-6242.66999999999,110,14,73421.3,67178.63000000002
11451,U27603,124,-12291.259999999997,114,10,49577.619999999995,37286.36
11452,U27279,124,-6098.509999999893,105,19,992425.31,986326.8000000002
11453,U34500,124,-8272.909999999996,113,11,282331.9899999999,274059.0799999999
11454,U26277,124,22189.870000000003,94,30,141953.66,164143.53
11455,U19329,124,7375.010000000009,95,29,20139.75,27514.76000000001
11456,U10076,124,-158.45,113,11,56810.969999999994,56652.52
11457,U14394,124,21255.010000000013,90,34,171950.72,193205.73
11458,U28498,124,29.81999999999971,119,5,6671.280000000001,6701.1
11459,U39672,124,295.0099999999959,78,46,265019.9199999999,265314.92999999993
11460,U38172,124,24423.530000000013,112,12,349669.31,374092.84
11461,U23493,124,16125.219999999987,101,23,2037097.9899999998,2053223.2099999997
11462,U31071,124,-1707.2299999999582,111,13,800218.85,798511.62
11463,U15868,124,-49047.59000000006,107,17,1292835.28,1243787.69
11464,U18809,124,-511639.8399999999,112,12,763060.3100000003,251420.47000000038
11465,U17548,124,4479.190000000004,109,15,77573.82999999999,82053.01999999999
11466,U14329,124,-6904.619999999989,101,23,206587.83,199683.21
11467,U13514,124,104169.04000000004,92,32,2909324.3399999994,3013493.3799999994
11468,U14756,124,107727.43999999999,73,51,190478.87,298206.31
11469,U34870,124,-37015.21000000001,121,3,37035.51,20.299999999995634
11470,U42443,124,-1676.3599999999983,66,58,591101.2199999999,589424.8599999999
11471,U8812,124,-244.44999999999823,112,12,26104.04,25859.590000000004
11472,U19515,124,162709.52,96,28,192665.06999999998,355374.58999999997
11473,U17123,124,9860.70999999998,97,27,809777.9800000001,819638.6900000001
11474,U24707,124,-4080.890000000001,121,3,15345.939999999997,11265.049999999996
11475,U26662,124,14274.689999999999,116,8,12866.809999999998,27141.499999999996
11476,U36524,124,-44035.77,81,43,201462.32999999996,157426.55999999997
11477,U1194928,124,1248.670000000002,85,39,24790.130000000005,26038.800000000007
11478,U1199735,124,3544.0199999999923,65,59,108003.23,111547.24999999999
11479,U20627,124,-27894.469999999972,66,58,594382.24,566487.77
11480,U35799,124,188.70999999999998,119,5,2528.51,2717.2200000000003
11481,U42781,124,94.82999999999585,86,38,61860.200000000004,61955.03
11482,U41263,124,-2193.6499999999974,108,16,26643.440000000006,24449.790000000008
11483,U41952,124,-505.73999999999705,67,57,305962.2100000001,305456.4700000001
11484,U28220,124,2232.0299999999997,117,7,9991.87,12223.900000000001
11485,U28631,124,-1217.1999999999925,101,23,49403.090000000004,48185.890000000014
11486,U27326,124,10702.66,64,60,114482.42,125185.08
11487,U27640,124,15897.829999999998,116,8,23540.88,39438.71
11488,U30914,124,-1145.2100000000025,110,14,95861.89,94716.68
11489,U9953,124,-46677.1899999999,110,14,394856.9599999998,348179.7699999999
11490,U27587,124,-11116.04,110,14,48143.28,37027.24
11491,U11995,124,-27476.840000000007,121,3,34850.39,7373.549999999992
11492,U41025,123,111547.70999999999,108,15,98458.64000000001,210006.35
11493,U37228,123,-38779.15000000002,70,53,1169600.9699999997,1130821.8199999998
11494,U28560,123,38659.879999999976,114,9,77798.64000000003,116458.52
11495,U13460,123,-4237.840000000002,101,22,57097.290000000045,52859.45000000004
11496,U20643,123,-2163.399999999936,72,51,5017988.630000001,5015825.23
11497,U9437,123,211099.74,98,25,622089.2200000003,833188.9600000003
11498,U29064,123,-14814.18,97,26,45320.62,30506.440000000002
11499,U19853,123,-132708.97999999998,74,49,923608.72,790899.74
11500,U17680,123,-4388.770000000004,115,8,37209.799999999996,32821.02999999999
11501,U35049,123,-334373.41000000027,115,8,1137066.0499999998,802692.6399999995
11502,U25650,123,4886.359999999986,112,11,172581.24999999997,177467.60999999996
11503,U20838,123,804288.1399999998,106,17,583817.0599999999,1388105.1999999997
11504,U17637,123,33832.76999999997,104,19,294382.49000000005,328215.26
11505,U14238,123,-46034.59999999998,98,25,186438.47000000003,140403.87000000005
11506,U27517,123,-33550.170000000006,109,14,330506.35,296956.18
11507,U22119,123,-5274.209999999985,74,49,381109.1,375834.89
11508,U16127,123,-2173.820000000028,75,48,1040678.6799999999,1038504.8599999999
11509,U9605,123,37403.43999999997,111,12,18646.789999999997,56050.22999999997
11510,U36822,123,21706.389999999996,104,19,30757.36,52463.75
11511,U28862,123,283311.6299999999,77,46,205575.42000000007,488887.04999999993
11512,U8401,123,41117.969999999994,116,7,74891.73000000001,116009.70000000001
11513,U728539,123,0.56999999999789,77,46,39663.34,39663.909999999996
11514,U36019,123,-3079.300000000002,114,9,26435.360000000004,23356.06
11515,U21935,123,-11019.090000000002,112,11,72223.85999999999,61204.76999999998
11516,U8903,123,-3073.47,109,14,51935.399999999994,48861.92999999999
11517,U9162,123,-4174.0099999999975,93,30,48545.06999999999,44371.06
11518,U8086,123,35846.950000000026,105,18,320716.80000000005,356563.75000000006
11519,U8726,123,-12413.479999999972,110,13,294119.4899999999,281706.0099999999
11520,U9904,123,-21554.050000000003,92,31,243499.21,221945.15999999997
11521,U10042,123,416034.1500000001,104,19,858080.41,1274114.56
11522,U43479,123,-57500.18000000002,108,15,233665.82000000004,176165.64
11523,U8835,123,-13788.310000000027,107,16,389851.73,376063.4199999999
11524,U40082,123,198246.36000000002,102,21,1389340.3399999999,1587586.7
11525,U10198,123,-102071.24000000037,94,29,2333378.289999999,2231307.049999999
11526,U21436,123,-84130.38000000009,79,44,1013463.7000000002,929333.3200000001
11527,U17725,123,-100967.07999999994,85,38,904409.9400000001,803442.8600000001
11528,U39243,123,-227.26000000000826,69,54,266048.72000000003,265821.46
11529,U28495,123,-8309.620000000003,106,17,96320.29999999999,88010.68
11530,U14528,123,-8831.29999999987,93,30,641322.21,632490.9100000001
11531,U8047,123,-7725.0400000000045,96,27,145129.68000000002,137404.64
11532,U12860,123,1002.300000000006,83,40,153167.1699999998,154169.46999999983
11533,U15402,123,13822.130000000003,105,18,83395.50000000001,97217.63000000002
11534,U13146,123,18873.549999999992,89,34,549185.56,568059.1100000001
11535,U20200,123,-53950.170000000006,103,20,260878.14000000004,206927.97000000003
11536,U8747,123,26580.910000000003,97,26,97003.51,123584.42
11537,U34467,123,426.1899999999987,108,15,15663.589999999998,16089.779999999997
11538,U40032,123,-4238.630000000005,102,21,79990.81999999999,75752.18999999999
11539,U11940,123,-198071.37,75,48,474264.1600000001,276192.7900000001
11540,U23817,123,14073.71000000004,62,61,2809621.55,2823695.26
11541,U17150,123,-128952.72000000067,77,46,35601617.97,35472665.25
11542,U29610,123,-34085.39000000001,112,11,127328.83999999997,93243.44999999995
11543,U27589,123,-3622.3600000000015,111,12,91362.07999999999,87739.71999999999
11544,U20453,123,1321.7399999999993,117,6,39646.09,40967.829999999994
11545,U18697,123,6572.5300000000025,104,19,19927.129999999997,26499.66
11546,U40425,123,79730.40999999999,109,14,303994.46,383724.87
11547,U28535,123,-1398.9199999999946,62,61,480642.49999999994,479243.57999999996
11548,U32534,123,-19738.630000000005,106,17,288492.47,268753.83999999997
11549,U14318,123,-7445.419999999999,112,11,218124.85000000003,210679.43000000002
11550,U29572,123,70340.87000000011,97,26,3456868.21,3527209.08
11551,U19507,123,30253.399999999998,106,17,117922.03000000001,148175.43000000002
11552,U28403,123,2393.190000000002,105,18,74126.95,76520.14
11553,U31138,123,-3247.5400000000036,107,16,27344.859999999993,24097.31999999999
11554,U35403,123,-5074.949999999999,90,33,28045.779999999995,22970.829999999994
11555,U16540,123,27397.759999999966,84,39,483709.08000000013,511106.8400000001
11556,U28370,123,-326.1000000000009,69,54,217366.34,217040.24
11557,U43933,123,25801.679999999993,77,46,294631.85,320433.52999999997
11558,U607403,123,-1041.5199999999966,82,41,59506.78,58465.26
11559,U39057,123,-2537.590000000012,63,60,755537.89,753000.3
11560,U41030,123,1058.340000000001,114,9,33597.300000000025,34655.64000000003
11561,U1186400,123,-6598.120000000008,93,30,89993.26000000001,83395.14
11562,U14462,123,-81289.93000000004,99,24,961098.5399999999,879808.6099999999
11563,U24429,123,1316.1999999999982,112,11,614489.3700000002,615805.5700000002
11564,U43233,123,-26635.500000000004,89,34,79429.89,52794.39
11565,U40363,123,5025.66,120,3,11474.349999999997,16500.009999999995
11566,U8817,123,-133472.35999999993,78,45,1473087.79,1339615.4300000002
11567,U28989,123,-1189.430000000014,81,42,155316.31000000006,154126.88000000003
11568,U35565,123,-163.7600000000009,119,4,8578.350000000002,8414.590000000002
11569,U29058,123,-43832.50000000003,94,29,397401.74000000005,353569.24
11570,U32257,123,-37137.67,98,25,244812.18,207674.51
11571,U30625,123,-12834.52,107,16,47778.549999999996,34944.03
11572,U20443,123,-482351.8200000003,108,15,19903979.98999999,19421628.16999999
11573,U34361,123,-572.3699999999995,83,40,30802.7,30230.33
11574,U23572,123,58337.000000000044,103,20,1100432.43,1158769.43
11575,U38743,123,15908.750000000007,88,35,386722.16000000003,402630.91000000003
11576,U782498,123,5737.04,83,40,109735.49000000002,115472.53000000001
11577,U39837,123,29344.86,104,19,108539.45999999999,137884.32
11578,U17598,123,-228351.5000000001,101,22,872757.23,644405.7299999999
11579,U9228,123,2808.550000000006,90,33,90472.65000000001,93281.20000000001
11580,U41850,123,584.6199999999953,108,15,121271.79999999999,121856.41999999998
11581,U30691,123,440.58999999999014,76,47,84885.14,85325.73
11582,U17879,123,3131.7299999999996,87,36,34528.96000000001,37660.69
11583,U33222,123,-1352.45,117,6,8357.109999999999,7004.659999999999
11584,U36283,123,496.02999999999065,103,20,129767.17,130263.19999999998
11585,U37325,123,-12291.630000000006,113,10,173988.35999999993,161696.72999999992
11586,U25978,123,-5013.250000000004,87,36,73206.73,68193.48
11587,U23262,123,-36721.74999999994,115,8,362060.23999999993,325338.49
11588,U37901,123,23622.880000000023,64,59,1404843.88,1428466.76
11589,U42919,123,-2592.5999999999767,89,34,1475429.79,1472837.19
11590,U623413,123,68.03000000000057,76,47,12749.730000000003,12817.760000000004
11591,U10185,123,-22784.5,116,7,30627.839999999993,7843.339999999993
11592,U32309,123,-6418.950000000002,109,14,26130.919999999995,19711.969999999994
11593,U28073,123,-412.3000000000029,118,5,7678.970000000008,7266.6700000000055
11594,U21850,123,39081.06,97,26,51557.659999999996,90638.72
11595,U18178,123,2250.0499999999965,115,8,64746.70999999999,66996.76
11596,U27909,123,11860.789999999968,117,6,2107.399999999994,13968.189999999962
11597,U39287,123,3644.160000000027,102,21,120671.31,124315.47000000003
11598,U26781,123,335302.45,91,32,1146684.74,1481987.19
11599,U29777,123,1779.0000000000014,62,61,1246837.58,1248616.58
11600,U22787,123,-80336.88999999994,100,23,1014879.67,934542.7800000001
11601,U43449,123,-1210.4299999999976,104,19,109035.33000000003,107824.90000000004
11602,U1137959,123,-0.3100000000003664,63,60,18093.909999999996,18093.599999999995
11603,U17402,123,-36826.45,98,25,101377.45999999999,64551.009999999995
11604,U24199,123,11467.509999999991,104,19,107042.09,118509.59999999999
11605,U13615,123,-10040.779999999999,111,12,96759.56999999999,86718.79
11606,U1134311,123,-198.84000000000015,86,37,22414.65,22215.81
11607,U28292,123,-16027.240000000002,85,38,201255.97,185228.73
11608,U38928,123,6387.149999999978,86,37,167291.21000000014,173678.3600000001
11609,U35162,122,7550.800000000003,94,28,445325.17,452875.97
11610,U10594,122,-14512.160000000016,110,12,92649.47999999998,78137.31999999996
11611,U11420,122,-854699.7400000003,111,11,872006.3500000003,17306.609999999986
11612,U33206,122,-38517.83,94,28,205199.63000000003,166681.80000000005
11613,U25938,122,37209.67,110,12,79933.76,117143.43
11614,U36141,122,-87332.94000000002,57,65,2839410.1100000003,2752077.1700000004
11615,U40558,122,-371.20000000000016,116,6,12371.75,12000.55
11616,U17701,122,-31119.59,97,25,86452.53000000001,55332.94000000002
11617,U32691,122,2843.0099999999784,98,24,431517.60000000015,434360.6100000001
11618,U17816,122,22370.190000000002,58,64,469076.26,491446.45
11619,U8057,122,15792.599999999999,107,15,34553.189999999995,50345.78999999999
11620,U8853,122,391.88999999999214,56,66,166532.96,166924.84999999998
11621,U797827,122,714.4699999999866,65,57,561207.4,561921.87
11622,U33334,122,-8294.760000000002,99,23,127488.26000000001,119193.5
11623,U28923,122,-573320.21,97,25,3287289.19,2713968.98
11624,U19973,122,8965.120000000039,95,27,541648.58,550613.7
11625,U21567,122,10282.539999999943,76,46,613263.3099999999,623545.8499999999
11626,U13694,122,156217.44999999998,106,16,254430.58,410648.02999999997
11627,U11345,122,28821.32000000008,94,28,149098.82000000033,177920.14000000042
11628,U21104,122,15521.45000000009,78,44,567800.0399999999,583321.49
11629,U19498,122,24774.710000000006,106,16,58292.009999999995,83066.72
11630,U8238,122,8912.330000000009,101,21,217427.45,226339.78000000003
11631,U32894,122,21294.100000000006,102,20,110115.34000000004,131409.44000000006
11632,U34607,122,-290864.27,104,18,618709.3400000001,327845.07000000007
11633,U31911,122,2513.709999999999,90,32,27686.399999999998,30200.109999999997
11634,U34205,122,-20536.94,103,19,163012.72999999998,142475.78999999998
11635,U32823,122,-150.14999999997673,109,13,178103.03,177952.88000000003
11636,U17575,122,79688.54999999999,102,20,531413.5699999998,611102.1199999999
11637,U14928,122,39436.42999999999,98,24,84396.48,123832.90999999999
11638,U42067,122,-4770.819999999961,76,46,1777668.8200000003,1772898.0000000002
11639,U27724,122,-4460.430000000006,109,13,120562.01999999999,116101.58999999998
11640,U23457,122,-229352.12999999998,106,16,359960.33000000025,130608.20000000027
11641,U43990,122,-8527.450000000004,82,40,109610.05,101082.6
11642,U34721,122,54855.65999999996,53,69,1005632.02,1060487.68
11643,U32548,122,-83958.34999999999,115,7,162177.72999999998,78219.37999999999
11644,U10404,122,2956.710000000004,101,21,124895.95999999993,127852.66999999994
11645,U29389,122,32540.049999999996,66,56,674482.34,707022.39
11646,U34534,122,67877.1,77,45,209931.62,277808.72
11647,U15468,122,-3652.4299999999494,99,23,835669.9,832017.4700000001
11648,U41536,122,-3126.540000000002,112,10,70332.12,67205.57999999999
11649,U11124,122,-109067.0,93,29,174818.91999999998,65751.91999999998
11650,U29527,122,64596.71000000002,101,21,262069.86000000004,326666.57000000007
11651,U967054,122,-155.89000000000033,79,43,28574.93,28419.04
11652,U23283,122,-101408.03000000003,104,18,300221.29,198813.25999999995
11653,U39968,122,-13424.05,90,32,130401.17000000001,116977.12000000001
11654,U15581,122,75504.64999999998,106,16,229247.59999999998,304752.24999999994
11655,U24809,122,6821.420000000003,98,24,45008.36000000002,51829.78000000003
11656,U39580,122,458.5600000000003,112,10,11446.349999999995,11904.909999999994
11657,U39565,122,5700.229999999999,111,11,27227.46,32927.689999999995
11658,U36675,122,-8907.119999999997,103,19,59136.500000000015,50229.38000000002
11659,U19389,122,-3645.8799999999974,108,14,111870.3999999999,108224.5199999999
11660,U29616,122,-788.3700000000008,118,4,11760.929999999997,10972.559999999996
11661,U11601,122,-16425.780000000002,91,31,149896.94000000003,133471.16000000003
11662,U25422,122,983.8000000000088,108,14,88279.85000000002,89263.65000000002
11663,U20147,122,-3738.100000000002,94,28,263376.36000000004,259638.26000000004
11664,U42657,122,6400.19999999999,98,24,96499.98,102900.18
11665,U14082,122,-26283.670000000013,89,33,155094.62999999998,128810.95999999996
11666,U32205,122,75.97000000000298,71,51,102996.5,103072.47
11667,U38724,122,-67.66999999996818,110,12,102790.66,102722.99000000003
11668,U19896,122,3747.4000000000055,97,25,105930.57,109677.97000000002
11669,U14464,122,55315.560000000056,88,34,267328.85,322644.41000000003
11670,U14285,122,-70547.61,107,15,350275.06000000006,279727.45000000007
11671,U42172,122,-728.09,92,30,3556.9999999999995,2828.9099999999994
11672,U30774,122,2480.890000000002,114,8,18644.14,21125.030000000002
11673,U23189,122,3193.060000000012,104,18,151014.56000000003,154207.62000000005
11674,U36240,122,1469.510000000005,116,6,17506.029999999995,18975.54
11675,U29283,122,3756171.119999999,94,28,6077441.75,9833612.87
11676,U38871,122,-17364.140000000007,89,33,1143145.19,1125781.05
11677,U29424,122,17154.499999999996,105,17,199391.6,216546.1
11678,U29902,122,6600.4299999999985,101,21,141217.39999999997,147817.82999999996
11679,U27656,122,-53811.26,99,23,187582.44,133771.18
11680,U32706,122,-64884.68999999999,104,18,393556.25,328671.56
11681,U14738,122,-22111.440000000006,98,24,357117.23999999993,335005.79999999993
11682,U29554,122,17624.72,112,10,125226.70000000003,142851.42000000004
11683,U9300,122,-30984.659999999974,92,30,734450.8999999999,703466.24
11684,U35952,122,-49157.550000000025,86,36,262699.1699999999,213541.6199999999
11685,U8864,122,-35884.81000000001,110,12,247073.13999999996,211188.32999999996
11686,U18559,122,-13882.389999999994,97,25,261950.4,248068.01
11687,U36651,122,-1348.4700000000005,107,15,15554.22,14205.749999999998
11688,U37616,122,130.60999999998103,60,62,128043.38,128173.98999999999
11689,U17541,122,27442.389999999985,109,13,264931.39,292373.78
11690,U42929,122,-702.2099999999996,113,9,13802.800000000001,13100.590000000002
11691,U14156,122,15938.959999999995,109,13,41810.0,57748.95999999999
11692,U17987,122,-6535.960000000003,100,22,84073.71999999999,77537.75999999998
11693,U1145768,122,6141.820000000001,70,52,116530.90999999999,122672.73
11694,U17730,122,-8543.900000000003,111,11,16754.909999999996,8211.009999999993
11695,U33517,122,-2921.9200000000055,99,23,127735.80000000003,124813.88000000003
11696,U11102,122,-16448.68,111,11,53499.100000000006,37050.420000000006
11697,U43145,122,11225.120000000004,109,13,56662.479999999996,67887.6
11698,U13608,122,15907.110000000004,113,9,69990.09,85897.2
11699,U13841,122,-12857.719999999996,112,10,125041.55000000002,112183.83000000002
11700,U40991,122,-4714.670000000005,111,11,83097.91,78383.24
11701,U38744,122,-21271.489999999998,99,23,64973.74,43702.25
11702,U10088,122,-62518.12,95,27,211979.52000000002,149461.40000000002
11703,U33037,122,6176.690000000003,56,66,60121.950000000004,66298.64000000001
11704,U9381,122,-400587.4800000003,111,11,1381241.9500000004,980654.4700000002
11705,U12043,122,-79981.28,86,36,225262.85,145281.57
11706,U43781,122,981.0600000000013,89,33,147360.54,148341.6
11707,U782760,122,-633.7000000000061,96,26,69633.45000000001,68999.75
11708,U8663,122,18111.37000000001,101,21,158782.13,176893.5
11709,U27334,121,-482.630000000001,97,24,157967.74,157485.11
11710,U12077,121,49321.47,66,55,2024524.1900000002,2073845.6600000001
11711,U20921,121,-88509.76000000001,89,32,586012.04,497502.28
11712,U10948,121,10931.560000000007,88,33,261415.99,272347.55
11713,U16345,121,-12258.5,103,18,767052.54,754794.04
11714,U18122,121,9200.790000000003,98,23,76523.54000000001,85724.33000000002
11715,U8048,121,-1181.2899999999986,95,26,46070.840000000004,44889.55
11716,U584472,121,1.3799999999990717,66,55,10912.349999999999,10913.729999999998
11717,U39330,121,-5061.069999999996,92,29,179319.38999999998,174258.31999999998
11718,U18960,121,-101871.22000000003,111,10,160069.53000000006,58198.31000000003
11719,U41692,121,-34889.73999999999,91,30,206467.22999999995,171577.48999999996
11720,U31813,121,-925.0199999999895,101,20,209657.02,208732.0
11721,U24662,121,-22425.22999999997,98,23,748970.1200000001,726544.8900000001
11722,U34889,121,-885.8599999999997,114,7,13729.25,12843.39
11723,U10443,121,12679.56,107,14,35197.71,47877.27
11724,U18982,121,-40725.36,65,56,1013148.53,972423.17
11725,U22479,121,56784.09000000001,20,101,711985.3300000001,768769.42
11726,U25797,121,-999.0200000000004,112,9,41651.42,40652.399999999994
11727,U19550,121,10249.320000000003,80,41,69672.92999999996,79922.24999999997
11728,U956649,121,16.57999999999953,110,11,8251.210000000001,8267.79
11729,U27914,121,5136.120000000007,94,27,135488.16999999998,140624.28999999998
11730,U9841,121,77674.29000000004,93,28,23947.75,101622.04000000004
11731,U16089,121,-3217.5800000000017,93,28,79913.83999999998,76696.25999999998
11732,U36372,121,21668.270000000004,109,12,80541.99000000002,102210.26000000002
11733,U35515,121,37558.99999999996,87,34,165043.33000000002,202602.33
11734,U21717,121,-26558.670000000002,114,7,61409.280000000006,34850.61
11735,U37137,121,47306.51000000001,87,34,332432.69,379739.2
11736,U34391,121,1878.1399999999953,105,16,232068.12000000008,233946.26000000007
11737,U27647,121,8119.069999999994,96,25,128781.57000000014,136900.64000000013
11738,U22448,121,44387.82000000003,94,27,316421.09000000014,360808.91000000015
11739,U15701,121,46240.609999999964,106,15,51431.070000000014,97671.67999999998
11740,U8066,121,-2541.5599999999977,94,27,73259.56,70718.0
11741,U11971,121,-131.4000000000051,69,52,216703.03,216571.63
11742,U40075,121,-8691.679999999993,101,20,335382.42000000004,326690.74000000005
11743,U29892,121,7833.219999999994,104,17,276987.31,284820.52999999997
11744,U31538,121,6226.040000000001,106,15,18120.23,24346.27
11745,U41474,121,8392.719999999972,77,44,1988305.93,1996698.65
11746,U26811,121,3347.999999999999,117,4,17639.059999999998,20987.059999999998
11747,U971926,121,-2915.4,76,45,13981.560000000001,11066.160000000002
11748,U36637,121,-9218.47,96,25,35518.34,26299.869999999995
11749,U42649,121,-14588.319999999992,87,34,97653.08000000002,83064.76000000002
11750,U30957,121,-7401.359999999999,104,17,44478.299999999996,37076.939999999995
11751,U39270,121,-17706.399999999998,107,14,56532.15000000001,38825.750000000015
11752,U13791,121,1962.2799999999997,107,14,60679.360000000015,62641.640000000014
11753,U31097,121,25178.090000000004,110,11,12828.529999999997,38006.62
11754,U37128,121,47931.00999999997,114,7,9014.029999999999,56945.03999999997
11755,U31398,121,-5200.570000000008,109,12,95451.03,90250.45999999999
11756,U751724,121,-7.769999999999754,73,48,16976.52,16968.75
11757,U25796,121,-51820.460000000014,109,12,152460.8,100640.33999999997
11758,U18451,121,55707.85999999997,83,38,199187.20000000004,254895.06
11759,U16767,121,8344.970000000008,92,29,251902.31999999998,260247.28999999998
11760,U9270,121,1194012.0199999998,103,18,704586.5899999999,1898598.6099999996
11761,U36870,121,-80629.76000000001,103,18,419290.29000000004,338660.53
11762,U16692,121,-51451.929999999586,90,31,5799582.680000001,5748130.750000001
11763,U29962,121,47039.3,66,55,326869.46,373908.76
11764,U29187,121,-42432.03999999997,119,2,42520.08999999997,88.04999999999563
11765,U30023,121,-1797.2699999999998,99,22,61247.920000000006,59450.65000000001
11766,U20160,121,362.41999999999734,109,12,44455.64,44818.06
11767,U13102,121,59570.149999999994,90,31,440532.36000000004,500102.51
11768,U20329,121,73190.02,75,46,338096.57000000007,411286.5900000001
11769,U13284,121,31665.46,77,44,368818.01999999996,400483.48
11770,U41700,121,1906.87999999999,87,34,172249.97,174156.84999999998
11771,U596913,121,-286.27999999999133,89,32,41295.28,41009.00000000001
11772,U18531,121,-316.9100000000153,62,59,438059.33,437742.42
11773,U13473,121,80315.58999999998,85,36,819620.7099999998,899936.2999999998
11774,U38129,121,940.619999999988,107,14,69623.06999999999,70563.68999999997
11775,U34318,121,-145691.63,109,12,406836.95,261145.32
11776,U36969,121,27677.460000000003,105,16,40929.56000000001,68607.02000000002
11777,U8112,121,-6703.0899999999965,107,14,147581.85000000003,140878.76000000004
11778,U13739,121,36896.14,85,36,385021.23000000004,421917.37000000005
11779,U13193,121,734.3399999999892,85,36,325519.7300000002,326254.0700000002
11780,U33657,121,3316.5299999999097,80,41,634695.6499999998,638012.1799999997
11781,U16559,121,407179.6699999999,99,22,2132002.1,2539181.77
11782,U24430,121,-2536.999999999942,87,34,1666505.2,1663968.2
11783,U26695,121,-393359.55000000005,102,19,3103419.0,2710059.45
11784,U36936,121,-530.9900000000007,104,17,20894.969999999998,20363.979999999996
11785,U1102006,121,-476.4299999999996,85,36,7469.139999999999,6992.71
11786,U11302,121,20453.490000000013,85,36,366713.7100000001,387167.20000000007
11787,U8040,121,8890.729999999974,96,25,221635.5,230526.22999999998
11788,U9396,121,-147.4600000000064,65,56,737702.05,737554.5900000001
11789,U31240,121,-9307.180000000002,87,34,134856.44,125549.26
11790,U30479,121,-5618.11,105,16,12712.930000000002,7094.820000000002
11791,U9346,121,187770.75999999992,85,36,676717.8299999996,864488.5899999995
11792,U32584,121,19251.450000000044,88,33,2759895.05,2779146.5
11793,U17490,121,-62950.98999999995,47,74,576473.4900000001,513522.5000000002
11794,U43394,121,-3216.0400000000022,113,8,14821.109999999993,11605.06999999999
11795,U37061,121,-65433.560000000005,60,61,410598.38999999996,345164.82999999996
11796,U29912,121,-1478.3399999999929,110,11,67211.13,65732.79000000001
11797,U23955,121,7477.439999999992,87,34,39158.26999999995,46635.70999999995
11798,U42867,121,-821.8100000000013,113,8,19800.94,18979.129999999997
11799,U20724,121,23882.75999999999,104,17,131019.52,154902.28
11800,U37660,121,3335.3100000000004,109,12,13879.33,17214.64
11801,U38883,121,89443.93000000002,69,52,684848.0899999999,774292.0199999999
11802,U13169,121,-8690.780000000004,109,12,55714.83,47024.049999999996
11803,U23553,121,30548.86999999998,46,75,308795.22,339344.08999999997
11804,U28855,121,54457.43999999999,111,10,35534.270000000004,89991.70999999999
11805,U26420,121,-70948.29000000001,107,14,130041.46,59093.17
11806,U25376,121,-1898.1000000000085,80,41,828824.4400000001,826926.3400000001
11807,U37922,121,71965.77999999998,62,59,1368658.79,1440624.57
11808,U16016,121,-114910.56999999999,111,10,140991.14,26080.57000000002
11809,U44000,121,4827.009999999998,107,14,126789.19,131616.2
11810,U14518,121,-18563.21000000002,109,12,177428.88999999996,158865.67999999993
11811,U8937,121,-69502.93999999996,101,20,302244.67,232741.73000000004
11812,U25029,121,3895.170000000013,91,30,194906.45999999996,198801.62999999998
11813,U32431,121,584.6499999999991,95,26,17847.53,18432.179999999997
11814,U44009,121,1980.129999999997,112,9,21394.229999999996,23374.359999999993
11815,U8145,121,176559.78,96,25,211883.05,388442.82999999996
11816,U37187,121,3270.400000000007,88,33,352954.81,356225.21
11817,U40628,121,-6224.299999999998,115,6,10183.61,3959.310000000002
11818,U21143,121,181607.00999999998,79,42,238753.2,420360.20999999996
11819,U36949,120,6826.99,104,16,46612.62,53439.61
11820,U39800,120,-12688.51,103,17,40754.5,28065.989999999998
11821,U8605,120,6327.4900000000125,87,33,1214312.69,1220640.18
11822,U843774,120,580.5200000000004,68,52,96421.51,97002.03
11823,U17377,120,-30211.86999999998,99,21,689425.0,659213.13
11824,U971670,120,-1.8189894035458565e-12,60,60,137834.79,137834.79
11825,U17344,120,-14622.129999999997,102,18,99582.69,84960.56
11826,U12783,120,-90246.59999999995,78,42,1783433.1,1693186.5000000002
11827,U34925,120,-7761.289999999999,110,10,37421.95,29660.659999999996
11828,U18530,120,-17934.64,116,4,34942.04,17007.4
11829,U38536,120,773.5800000000017,81,39,104814.43,105588.01
11830,U1336484,120,-6766.1399999999985,87,33,76659.43999999997,69893.29999999997
11831,U27643,120,9463.199999999988,103,17,155971.12,165434.31999999998
11832,U31803,120,-26521.060000000012,95,25,169057.65000000002,142536.59000000003
11833,U27482,120,397.919999999998,106,14,27863.860000000004,28261.780000000002
11834,U18336,120,-2369.0000000000014,102,18,28174.229999999996,25805.229999999996
11835,U23034,120,10077.580000000002,108,12,86788.59999999998,96866.17999999998
11836,U13137,120,4239.970000000001,76,44,82596.73000000001,86836.70000000001
11837,U34116,120,-915.8500000000004,108,12,15302.800000000001,14386.95
11838,U14808,120,105765.48000000003,93,27,486794.55000000005,592560.03
11839,U14987,120,17594.290000000005,111,9,60543.060000000005,78137.35
11840,U39566,120,3911.729999999999,83,37,15928.05,19839.78
11841,U16181,120,-977384.53,86,34,3730093.2099999995,2752708.6799999997
11842,U43423,120,-964.8800000000024,76,44,79365.85,78400.97
11843,U34596,120,7621.700000000006,109,11,16866.979999999996,24488.68
11844,U41469,120,20321.950000000008,79,41,303519.55,323841.5
11845,U40111,120,46033.15000000001,89,31,462142.9,508176.05000000005
11846,U28777,120,10910.369999999966,104,16,337135.0499999998,348045.4199999998
11847,U988679,120,7644.340000000002,70,50,70614.34999999998,78258.68999999997
11848,U24182,120,-8263.129999999997,109,11,33482.719999999994,25219.589999999997
11849,U8661,120,1470.5400000000013,106,14,33949.54000000003,35420.08000000003
11850,U30268,120,-18128.130000000136,67,53,2353125.84,2334997.7099999995
11851,U39061,120,-60441.79,108,12,150318.25000000003,89876.46000000002
11852,U13948,120,-49679.17000000002,101,19,99215.87999999998,49536.709999999955
11853,U35536,120,39268.12000000003,89,31,1791957.5899999999,1831225.71
11854,U19877,120,76249.34999999999,106,14,232414.86,308664.20999999996
11855,U30678,120,3332.279999999996,92,28,44532.13,47864.409999999996
11856,U35603,120,-7533.559999999947,91,29,3145434.520000001,3137900.960000001
11857,U11533,120,15378.479999999972,103,17,359573.36000000004,374951.84
11858,U14025,120,215419.14000000004,101,19,42835.34999999999,258254.49000000005
11859,U43862,120,-25772.54,105,15,158127.39,132354.85
11860,U9210,120,11056.62000000001,101,19,178090.21000000005,189146.83000000007
11861,U19637,120,5057.060000000001,62,58,217773.94000000003,222831.00000000003
11862,U39827,120,262347.96000000014,88,32,49129.15,311477.11000000016
11863,U13687,120,51963.63999999997,109,11,207796.56000000003,259760.2
11864,U764587,120,17008.08,73,47,24854.190000000002,41862.270000000004
11865,U1139811,120,-2855.0799999999995,96,24,15881.119999999995,13026.039999999995
11866,U17209,120,54363.56999999998,111,9,361289.72,415653.2899999999
11867,U29749,120,-4618.130000000001,107,13,27044.85999999999,22426.72999999999
11868,U15093,120,4563.909999999936,61,59,1247285.5199999998,1251849.4299999997
11869,U25584,120,181013.76,108,12,277923.63000000006,458937.3900000001
11870,U40257,120,-87520.33999999992,79,41,2064464.6300000001,1976944.2900000003
11871,U26278,120,460.2300000000005,110,10,37658.84000000002,38119.07000000002
11872,U10446,120,21677.41,88,32,159395.22,181072.63
11873,U11946,120,-8207.540000000012,69,51,680897.52,672689.98
11874,U35407,120,-1091.6299999999999,107,13,13129.600000000002,12037.970000000003
11875,U15792,120,-76004.67000000014,91,29,2506386.6400000006,2430381.9700000007
11876,U36152,120,-2538.9599999999996,108,12,58689.83000000001,56150.87000000001
11877,U34646,120,17254.809999999998,88,32,501466.58999999997,518721.39999999997
11878,U20722,120,-76219.03999999996,114,6,86789.72999999997,10570.690000000002
11879,U31703,120,1047.3300000000036,82,38,229552.43999999997,230599.77
11880,U819097,120,-3150.5,73,47,20499.57,17349.07
11881,U35953,120,12046.429999999975,92,28,576339.7200000001,588386.15
11882,U22404,120,2337.919999999995,80,40,403153.33999999997,405491.25999999995
11883,U31534,120,4727.009999999998,107,13,39039.670000000006,43766.68000000001
11884,U33664,120,-7434.600000000001,109,11,76969.97999999998,69535.37999999998
11885,U31180,120,-36686.84,105,15,71765.78,35078.94
11886,U31540,120,-20999.72000000001,102,18,239887.62000000005,218887.90000000005
11887,U21155,120,25954.239999999998,90,30,866628.7100000002,892582.9500000002
11888,U14700,120,6636.32000000001,106,14,538449.35,545085.67
11889,U16661,120,-53085.84999999999,98,22,328058.76,274972.91000000003
11890,U28438,120,8150.260000000002,84,36,55158.57000000001,63308.83000000001
11891,U34562,120,-700312.4400000001,105,15,834173.8,133861.36
11892,U38271,120,-26560.65000000001,97,23,232557.91999999995,205997.26999999996
11893,U18538,120,270429.37,86,34,59990.509999999995,330419.88
11894,U33187,120,-6577.440000000002,98,22,180254.41999999998,173676.97999999998
11895,U33985,120,7670.949999999995,65,55,394140.27,401811.22000000003
11896,U17890,120,665.3499999999992,112,8,4082.75,4748.099999999999
11897,U13621,120,-26398.660000000014,90,30,402688.5,376289.83999999997
11898,U19377,120,-89126.18000000002,107,13,140824.83,51698.649999999965
11899,U12622,120,-8919.02,115,5,28101.34,19182.32
11900,U27388,120,-7980.330000000002,103,17,48589.54999999999,40609.21999999999
11901,U32061,120,29313.890000000003,113,7,42619.829999999994,71933.72
11902,U23549,120,22627.010000000126,91,29,1055528.9100000001,1078155.9200000004
11903,U30737,120,11658.419999999978,80,40,1600356.38,1612014.7999999998
11904,U22654,120,36742.25999999999,88,32,294858.86000000004,331601.12000000005
11905,U1138306,120,322.55999999999983,95,25,15527.81,15850.369999999999
11906,U8058,120,-4645.59,112,8,28846.569999999996,24200.979999999996
11907,U27467,120,16694.509999999984,99,21,190694.02,207388.52999999997
11908,U37151,120,-150149.58000000007,105,15,773812.4599999998,623662.8799999998
11909,U26530,120,-5819.709999999995,80,40,181915.99000000002,176096.28000000003
11910,U26614,120,-900.0799999999981,74,46,198821.08999999994,197921.00999999995
11911,U10583,120,-72787.22000000003,115,5,186695.55999999988,113908.33999999985
11912,U16784,120,-31830.59999999996,100,20,298308.8500000001,266478.2500000001
11913,U41501,120,1723.4199999999983,92,28,296148.03,297871.45
11914,U39413,120,-139041.00999999998,99,21,569436.6099999999,430395.59999999986
11915,U9146,120,11444.930000000038,89,31,5767422.319999999,5778867.249999999
11916,U29307,120,-19384.139999999963,85,35,419158.44000000006,399774.3000000001
11917,U8197,120,20701.429999999986,106,14,163363.59,184065.02
11918,U17207,120,2481.619999999999,100,20,137825.52000000002,140307.14
11919,U16798,120,-8949.609999999986,107,13,820715.64,811766.03
11920,U10522,120,174123.86,103,17,141704.37,315828.23
11921,U19632,119,437.41000000000713,103,16,23879.199999999997,24316.610000000004
11922,U15050,119,-26436.239999999983,106,13,170575.28000000003,144139.04000000004
11923,U31332,119,-39298.17,109,10,121929.17000000003,82631.00000000003
11924,U28753,119,22069.019999999997,98,21,41790.420000000006,63859.44
11925,U11945,119,-455526.0299999999,111,8,622870.08,167344.05000000005
11926,U15033,119,-1562.6399999999567,87,32,741922.5900000001,740359.9500000001
11927,U27795,119,130.97999999999968,111,8,3343.9600000000005,3474.94
11928,U1273366,119,4703.2,66,53,64045.49999999999,68748.7
11929,U11707,119,12270.339999999847,100,19,1195171.0099999998,1207441.3499999996
11930,U19709,119,12083.22,100,19,30069.389999999996,42152.60999999999
11931,U10988,119,-3655.9899999999825,80,39,585517.0800000001,581861.0900000001
11932,U38483,119,813.3599999999993,114,5,8787.7,9601.06
11933,U8924,119,-10044.869999999995,89,30,210197.98,200153.11000000002
11934,U22909,119,-9922.590000000153,84,35,3057931.0199999996,3048008.4299999992
11935,U23377,119,30119.640000000196,103,16,5108497.37,5138617.010000001
11936,U27168,119,1913.6799999999869,71,48,159220.87999999998,161134.55999999997
11937,U12332,119,24914.01000000001,112,7,52551.81000000001,77465.82000000002
11938,U13965,119,-9398.970000000016,79,40,410674.17999999993,401275.2099999999
11939,U16443,119,-115007.64,95,24,366418.0899999999,251410.4499999999
11940,U30475,119,-865.7800000000016,100,19,40485.87,39620.090000000004
11941,U840410,119,2108.2599999999998,74,45,107330.6,109438.86
11942,U19375,119,21121.979999999996,88,31,192176.02,213298.0
11943,U16988,119,61129.97999999998,100,19,758202.78,819332.76
11944,U42626,119,-5251.790000000035,75,44,482624.83999999997,477373.04999999993
11945,U19212,119,8475.67000000001,85,34,402057.3599999999,410533.0299999999
11946,U23720,119,89004.24999999999,92,27,220133.16000000003,309137.41000000003
11947,U21348,119,-5390.669999999998,114,5,23073.73,17683.06
11948,U31651,119,-14616.64,113,6,31637.730000000003,17021.090000000004
11949,U34494,119,-7093.549999999997,111,8,28876.039999999997,21782.489999999998
11950,U37456,119,20579.950000000026,96,23,322305.37999999995,342885.32999999996
11951,U17588,119,-9166.560000000005,84,35,712379.79,703213.23
11952,U15748,119,13546.41999999997,94,25,455082.1,468628.51999999996
11953,U37881,119,3095.9100000000003,106,13,5693.38,8789.29
11954,U33091,119,219.3100000000063,93,26,20153.539999999997,20372.850000000002
11955,U37355,119,5555.630000000005,108,11,29438.39,34994.020000000004
11956,U19725,119,-13472.659999999976,78,41,585485.49,572012.83
11957,U13661,119,-197398.37,87,32,369945.44000000024,172547.07000000024
11958,U24679,119,-107635.04000000001,102,17,224320.68,116685.63999999998
11959,U8862,119,-4431.279999999999,98,21,49897.41,45466.130000000005
11960,U21743,119,4724.7700000000095,81,38,462904.62,467629.39
11961,U10079,119,-34174.02000000002,82,37,382402.95999999996,348228.93999999994
11962,U28820,119,-22386.20999999997,74,45,494035.00000000006,471648.7900000001
11963,U18742,119,117893.83,92,27,428270.92,546164.75
11964,U25694,119,-4463.360000000023,47,72,695735.12,691271.76
11965,U26086,119,1034.1200000000017,105,14,51072.770000000004,52106.89000000001
11966,U22892,119,4200.060000000016,88,31,213885.3,218085.36000000002
11967,U30910,119,360.26999999999725,101,18,26640.589999999997,27000.859999999993
11968,U37017,119,-4921.7599999999975,102,17,61370.439999999995,56448.68
11969,U39711,119,-11276.780000000022,94,25,275864.97000000003,264588.19
11970,U9712,119,-100931.56999999996,97,22,350175.13000000006,249243.5600000001
11971,U18593,119,-33410.62999999999,107,12,167208.21,133797.58000000002
11972,U8204,119,3759.2200000000257,101,18,50357.990000000005,54117.21000000003
11973,U16711,119,107719.67999999998,82,37,2394421.68,2502141.3600000003
11974,U22956,119,6369.309999999998,103,16,66333.05,72702.36
11975,U36451,119,-4748.42,64,55,77547.3,72798.88
11976,U1295723,119,3.6900000000005093,79,40,17667.879999999997,17671.57
11977,U22883,119,-393087.39999999997,78,41,1647801.9400000002,1254714.5400000003
11978,U16041,119,163243.84000000003,92,27,1255453.029999999,1418696.8699999992
11979,U30504,119,92653.1299999999,89,30,1144666.8699999999,1237319.9999999998
11980,U43105,119,7961.739999999998,77,42,316329.66000000003,324291.4
11981,U19895,119,-1477.199999999988,62,57,211083.94999999998,209606.75
11982,U13515,119,-5452.180000000002,93,26,75603.87999999998,70151.69999999997
11983,U42568,119,-6964.579999999996,110,9,77781.95999999998,70817.37999999998
11984,U9156,119,4146.819999999999,93,26,31891.859999999993,36038.67999999999
11985,U43303,119,143081.59,106,13,472237.6300000001,615319.2200000001
11986,U8647,119,-15256.16000000005,85,34,902233.5,886977.34
11987,U38874,119,-75084.17,95,24,187131.46999999997,112047.29999999997
11988,U16339,119,156672.71,106,13,47842.87000000001,204515.58000000002
11989,U28544,119,-3089.690000000002,108,11,16175.960000000001,13086.269999999999
11990,U883573,119,-1899.7499999999986,62,57,29888.000000000004,27988.250000000004
11991,U14504,119,-292395.60000000015,108,11,1468577.38,1176181.7799999998
11992,U35294,119,24468.460000000014,82,37,355044.08,379512.54000000004
11993,U38146,119,24174.170000000024,90,29,344956.98,369131.15
11994,U33376,119,-858.0600000000009,62,57,48587.06,47729.0
11995,U38688,119,-1516.8599999999988,105,14,28401.550000000003,26884.690000000002
11996,U22470,119,-48088.26000000001,89,30,99827.66999999998,51739.409999999974
11997,U20299,119,-49855.61000000002,111,8,203968.11000000002,154112.5
11998,U9607,119,14098.86999999999,107,12,125897.49999999999,139996.36999999997
11999,U13016,119,-527098.6400000001,89,30,1743410.55,1216311.91
12000,U10342,119,233083.78999999998,101,18,546862.82,779946.6099999999
12001,U11699,119,2124.0299999999997,109,10,5608.97,7733.0
12002,U28095,119,36035.79999999999,108,11,211599.42,247635.22
12003,U23880,119,-204.37,114,5,248.77,44.400000000000006
12004,U18306,119,73523.34,57,62,4056930.57,4130453.9099999997
12005,U10596,119,-10172.459999999988,96,23,143521.88999999998,133349.43
12006,U25251,119,-37066.86000000001,93,26,281571.95999999996,244505.09999999995
12007,U10744,119,50164.83999999998,107,12,324272.7100000001,374437.55000000005
12008,U37497,119,249915.58,88,31,59033.820000000014,308949.4
12009,U21107,119,-107940.47000000004,101,18,1772746.3900000001,1664805.9200000002
12010,U19164,119,376.4499999998079,107,12,437838.31999999954,438214.7699999993
12011,U20046,119,-1545.3299999999958,100,19,33192.3,31646.97000000001
12012,U38384,119,-20453.72000000001,85,34,123452.90999999999,102999.18999999997
12013,U20015,119,-46294.310000000005,95,24,109062.42000000001,62768.11000000001
12014,U17107,119,-26931.309999999943,80,39,726620.39,699689.0800000001
12015,U42060,119,11880.119999999999,95,24,18098.780000000002,29978.9
12016,U8669,119,33863.94000000002,101,18,943632.7600000001,977496.7000000002
12017,U38520,119,3765.580000000002,97,22,62980.25,66745.83
12018,U32391,119,-274839.8599999999,85,34,2190509.39,1915669.5300000003
12019,U15761,119,-13898.429999999984,68,51,2488433.2399999998,2474534.8099999996
12020,U13379,119,-10654.960000000057,96,23,1036020.3099999999,1025365.3499999999
12021,U20730,119,11250.2,84,35,115076.24000000002,126326.44000000002
12022,U41598,119,-4448.95,93,26,76116.40000000001,71667.45000000001
12023,U12324,119,4366.929999999994,87,32,284779.6500000001,289146.5800000001
12024,U34918,119,4195.189999999999,105,14,147681.95000000004,151877.14000000004
12025,U28192,119,15326.820000000009,95,24,62559.950000000004,77886.77000000002
12026,U35881,119,28108.750000000004,95,24,95849.87,123958.62
12027,U18804,119,1801.5000000000073,90,29,235933.75000000003,237735.25000000003
12028,U41757,119,106012.53,72,47,708594.2699999999,814606.7999999999
12029,U33957,119,-18223.83000000001,104,15,139956.72999999998,121732.89999999997
12030,U13268,119,-52523.530000000006,95,24,347706.7100000001,295183.18000000005
12031,U17494,119,-11387.319999999998,104,15,101696.19000000002,90308.87000000002
12032,U16937,119,-9645.490000000034,96,23,1300596.8600000003,1290951.3700000003
12033,U36887,119,-3538.7800000000043,101,18,139303.8,135765.02
12034,U35831,119,-41218.15,99,20,123872.64999999997,82654.49999999997
12035,U27984,119,43709.95000000001,108,11,135524.41,179234.36000000002
12036,U33714,119,-4034.559999999976,83,36,484556.00999999995,480521.44999999995
12037,U11538,119,-2717.2400000000184,94,25,217541.08000000005,214823.84000000003
12038,U34434,118,-5364.860000000001,101,17,19966.539999999986,14601.679999999986
12039,U14017,118,-40797.209999999934,103,15,84348.41999999993,43551.20999999999
12040,U12154,118,-4336.630000000028,83,35,333011.0500000001,328674.4200000001
12041,U19324,118,-15271.689999999995,84,34,113806.63999999997,98534.94999999998
12042,U40472,118,5798.090000000008,91,27,98314.14999999997,104112.23999999998
12043,U10113,118,-35016.89999999999,69,49,99533.30999999998,64516.409999999996
12044,U17118,118,22028.76999999999,92,26,186350.24999999997,208379.01999999996
12045,U1195238,118,-24276.669999999987,97,21,134964.89000000004,110688.22000000006
12046,U32920,118,7224.759999999998,109,9,39876.590000000004,47101.350000000006
12047,U12577,118,6522.21,112,6,42250.88,48773.09
12048,U37594,118,2307.94,112,6,6972.850000000001,9280.79
12049,U984660,118,-3316.6600000000003,91,27,9361.1,6044.4400000000005
12050,U18582,118,-10911.639999999992,94,24,81665.92,70754.28
12051,U9419,118,7898.8599999999915,62,56,84726.77,92625.62999999999
12052,U28935,118,57310.60999999998,51,67,5423477.760000001,5480788.370000001
12053,U29242,118,-4857.459999999988,111,7,164428.03999999998,159570.58
12054,U33063,118,3670.2800000000047,78,40,275166.03,278836.31000000006
12055,U39190,118,3898.75999999998,100,18,275504.72000000003,279403.48
12056,U13383,118,-32743.790000000037,89,29,9843560.81,9810817.02
12057,U29284,118,169793.04,85,33,316988.24,486781.28
12058,U11827,118,-25399.540000000005,110,8,52650.19999999998,27250.659999999978
12059,U30864,118,49995.850000000006,82,36,698497.4299999999,748493.2799999999
12060,U10928,118,-52253.94999999997,99,19,376315.70999999996,324061.76
12061,U40373,118,12881.8,101,17,41590.91,54472.71000000001
12062,U43883,118,7963.159999999994,106,12,56854.75999999999,64817.919999999984
12063,U34406,118,-69150.56,81,37,172698.09,103547.53
12064,U34631,118,-1531.6200000000017,112,6,10113.210000000001,8581.59
12065,U43809,118,-726.4800000003306,45,73,2793169.8899999997,2792443.409999999
12066,U36052,118,-19164.020000000008,102,16,123433.4,104269.37999999999
12067,U29288,118,207388.96999999968,93,25,2955124.5499999993,3162513.519999999
12068,U21258,118,12.040000000000987,97,21,31220.8,31232.84
12069,U14041,118,61.80999999998721,89,29,126365.21000000002,126427.02
12070,U41173,118,3743.9300000000067,76,42,248517.86999999997,252261.79999999996
12071,U18668,118,33300.019999999975,66,52,302567.59,335867.61
12072,U10964,118,-30188.850000000042,89,29,127518.71999999999,97329.86999999994
12073,U36429,118,48373.740000000005,111,7,22586.239999999998,70959.98000000001
12074,U26174,118,19708.180000000066,85,33,425592.5400000001,445300.72000000015
12075,U15727,118,-685.6000000000039,82,36,301585.64,300900.04000000004
12076,U13989,118,20067.50999999999,101,17,352073.18000000005,372140.69000000006
12077,U35313,118,-4700.01,101,17,407386.66000000003,402686.65
12078,U14703,118,16481.91,110,8,40712.759999999995,57194.67
12079,U39161,118,547.5799999999945,67,51,193668.71000000002,194216.29
12080,U20436,118,36963.44999999997,107,11,112454.23000000004,149417.68
12081,U10402,118,-2338.540000000004,104,14,124264.18,121925.63999999998
12082,U14234,118,1805.7599999999984,79,39,155936.74,157742.5
12083,U9615,118,-978.2100000000005,100,18,153674.16,152695.95
12084,U34025,118,345.1199999999985,52,66,104756.15999999999,105101.27999999998
12085,U26736,118,13451.5,105,13,20028.35999999999,33479.859999999986
12086,U28097,118,5279.929999999995,82,36,104990.37000000018,110270.30000000018
12087,U34172,118,-4744.91999999999,77,41,878204.1100000002,873459.1900000002
12088,U11585,118,-37029.63999999999,70,48,455112.88000000006,418083.24000000005
12089,U11723,118,251.07000000000517,92,26,357840.14999999997,358091.22
12090,U17619,118,-1425.4400000001078,97,21,385888.7100000001,384463.26999999996
12091,U12427,118,-2712.2899999999995,107,11,20684.340000000004,17972.050000000003
12092,U30611,118,9186.44,101,17,54350.810000000005,63537.25000000001
12093,U38111,118,11469.309999999998,80,38,124580.68,136049.99
12094,U26089,118,-114009.02,91,27,326547.31000000006,212538.29000000004
12095,U36610,118,7694.430000000008,75,43,152813.13999999998,160507.57
12096,U23884,118,-5778.780000000001,105,13,36839.45,31060.67
12097,U13475,118,3929.0300000000134,65,53,535577.9000000001,539506.9300000002
12098,U33778,118,93040.98000000001,91,27,404792.50999999995,497833.49
12099,U1187306,118,-2552.7899999999986,79,39,55849.36000000001,53296.57000000001
12100,U19088,118,143.0699999999988,100,18,19136.420000000002,19279.49
12101,U11355,118,-59611.06000000001,102,16,179022.38,119411.31999999999
12102,U25799,118,-53.86000000000422,103,15,141018.5,140964.63999999998
12103,U17111,118,22737.019999999997,104,14,46689.64000000001,69426.66
12104,U25825,118,6927.829999999998,108,10,26787.32000000001,33715.15000000001
12105,U27806,118,-18829.86999999991,83,35,1019352.41,1000522.5400000002
12106,U40994,118,52831.290000000154,92,26,839224.5099999999,892055.8
12107,U27693,118,-863.2399999999961,98,20,78393.56999999999,77530.33
12108,U38302,118,10826.11999999999,98,20,174800.75999999998,185626.87999999998
12109,U34881,118,7254.73,99,19,37757.619999999995,45012.34999999999
12110,U20716,118,-1304.5499999999936,82,36,242303.59000000003,240999.04000000004
12111,U39623,118,1732.919999999991,107,11,71767.09,73500.00999999998
12112,U34363,118,-7199.529999999996,60,58,241727.12,234527.59
12113,U41640,118,-368926.2000000005,103,15,2853525.4000000004,2484599.1999999997
12114,U29969,118,26576.670000000006,97,21,120845.57999999999,147422.25
12115,U18946,118,1022.5600000000047,66,52,107638.32999999999,108660.88999999998
12116,U9057,118,10792.630000000003,83,35,71140.89000000001,81933.52000000002
12117,U22055,118,-106476.8,73,45,274863.58,168386.78000000003
12118,U38063,118,-2940.0000000000036,105,13,70353.69,67413.69
12119,U28099,118,-43747.31000000006,90,28,670621.61,626874.2999999999
12120,U40253,118,-80425.27000000003,58,60,838385.39,757960.12
12121,U26412,118,-20666.90999999999,110,8,32762.29,12095.380000000012
12122,U15750,118,37121.65000000001,98,20,127468.92000000003,164590.57000000004
12123,U28691,118,2387.130000000003,109,9,12954.159999999994,15341.289999999997
12124,U8130,118,-40851.250000000044,84,34,49167.07000000003,8315.819999999985
12125,U17616,118,-67644.38,107,11,210704.66,143060.28
12126,U16131,118,-88100.45000000088,75,43,18749291.21,18661190.76
12127,U42333,118,3181.709999999999,109,9,10010.529999999999,13192.239999999998
12128,U583165,118,-502.0099999999991,74,44,28616.15,28114.140000000003
12129,U1242940,118,-287.8399999999989,64,54,128905.08000000002,128617.24000000002
12130,U22169,118,-46621.80000000001,68,50,372167.56,325545.76
12131,U12605,118,-125853.99999999996,106,12,544229.3800000002,418375.3800000003
12132,U14200,118,2240.39,103,15,81528.84,83769.23
12133,U17618,118,8396.89999999998,72,46,629122.8300000001,637519.7300000001
12134,U29588,118,-2516.6500000000015,103,15,31590.68,29074.03
12135,U33122,118,-1592.71,100,18,34125.41,32532.700000000004
12136,U29959,118,55919.14000000006,104,14,154575.21000000017,210494.3500000002
12137,U11511,118,-2167.1500000000015,97,21,273076.3,270909.14999999997
12138,U26059,118,166455.40000000002,75,43,1078314.91,1244770.31
12139,U16749,118,52.69000000001597,90,28,302519.69,302572.38
12140,U12949,118,31235.37000000009,37,81,1164820.58,1196055.9500000002
12141,U37201,118,50964.33999999998,97,21,111086.45999999996,162050.79999999993
12142,U27060,118,-2024.740000000013,73,45,498043.13,496018.39
12143,U22410,118,9725.890000000003,107,11,59378.929999999986,69104.81999999999
12144,U16435,118,1546.6699999999998,101,17,22823.88,24370.55
12145,U34942,118,-15375.87000000001,77,41,262543.98,247168.11
12146,U43927,118,1073398.9099999997,102,16,178683.2,1252082.1099999996
12147,U19092,118,4150.739999999661,101,17,287839.59999999986,291990.3399999995
12148,U43680,118,587.6800000000003,102,16,96824.40000000001,97412.08000000002
12149,U15659,118,2384.619999999978,78,40,2021559.1099999999,2023943.7299999997
12150,U38052,118,-1750.8799999999974,101,17,36688.67,34937.79
12151,U34934,118,-29746.000000000015,82,36,348734.16,318988.16
12152,U39828,118,23074.91999999965,46,72,13059724.2,13082799.12
12153,U9996,117,-200963.91,72,45,1369486.1199999999,1168522.21
12154,U26146,117,-3750.5199999999923,103,14,63861.78999999999,60111.270000000004
12155,U11722,117,-13329.48,108,9,40837.810000000034,27508.330000000034
12156,U8764,117,-10603.689999999997,94,23,65093.58,54489.89000000001
12157,U34279,117,60152.329999999994,104,13,82679.59000000003,142831.92
12158,U42975,117,-7540.560000000002,110,7,28085.779999999984,20545.219999999983
12159,U35574,117,15021.880000000006,73,44,258381.92999999996,273403.81
12160,U26092,117,307429.77,90,27,1130819.0,1438248.77
12161,U28229,117,-6691.910000000009,109,8,56861.48,50169.56999999999
12162,U17046,117,-191298.44999999998,97,20,1326432.0899999992,1135133.6399999992
12163,U36947,117,-30794.96,99,18,67205.29000000001,36410.33000000001
12164,U744725,117,-14597.839999999997,76,41,146773.72999999998,132175.88999999998
12165,U10943,117,1682.1600000000053,90,27,66299.33000000002,67981.49000000002
12166,U24187,117,102128.24,103,14,29088.98,131217.22
12167,U13499,117,60977.889999999956,80,37,552185.27,613163.1599999999
12168,U21246,117,70604.95999999999,107,10,80796.79,151401.75
12169,U21042,117,-19.699999999999932,108,9,8278.650000000001,8258.95
12170,U38541,117,385702.65,55,62,1159497.75,1545200.4
12171,U28145,117,-1646.6300000000126,97,20,159447.09,157800.46
12172,U41710,117,-8523.550000000001,98,19,41950.05,33426.5
12173,U11738,117,9373.319999999998,89,28,187280.58,196653.9
12174,U20106,117,-529.3799999999976,81,36,104905.14000000001,104375.76000000001
12175,U14680,117,103214.82999999996,38,79,5487098.95,5590313.78
12176,U26309,117,-104383.47999999952,102,15,8922647.98,8818264.5
12177,U26409,117,-925.1800000000039,100,17,90984.15999999999,90058.97999999998
12178,U42074,117,3002.350000000003,96,21,38752.969999999994,41755.32
12179,U39245,117,-5951.22999999998,73,44,421418.89,415467.66000000003
12180,U37822,117,-25801.140000000043,93,24,963492.7,937691.5599999999
12181,U10239,117,-43718.02999999997,87,30,950775.39,907057.3600000001
12182,U38358,117,-36341.72,110,7,59726.609999999986,23384.889999999985
12183,U40150,117,-33667.929999999986,91,26,171749.86,138081.93
12184,U36032,117,-5434.790000000026,70,47,248794.57999999993,243359.7899999999
12185,U1250421,117,2438.6999999999916,70,47,215694.81,218133.50999999998
12186,U18279,117,372.130000000001,75,42,68088.78,68460.91
12187,U13476,117,-53325.00000000001,95,22,84244.48000000001,30919.480000000003
12188,U18639,117,-22033.23999999999,104,13,79239.43,57206.19
12189,U39794,117,32666.259999999987,106,11,90334.84000000001,123001.1
12190,U596454,117,-3438.1000000000013,95,22,28648.579999999998,25210.479999999996
12191,U8391,117,11486.699999999997,111,6,28406.599999999955,39893.29999999995
12192,U29866,117,-12203.789999999994,91,26,114228.43000000001,102024.64000000001
12193,U30014,117,451.5099999999993,95,22,42061.54,42513.05
12194,U9413,117,3776.7099999997954,104,13,684340.35,688117.0599999998
12195,U42998,117,1170862.9500000002,107,10,2358399.1899999995,3529262.1399999997
12196,U36766,117,55588.29000000004,84,33,1359745.5799999998,1415333.8699999999
12197,U42641,117,82928.59999999998,100,17,304383.39,387311.99
12198,U30680,117,-291.8900000000034,105,12,44173.460000000014,43881.57000000001
12199,U42647,117,-1393.0300000000009,81,36,73781.48999999999,72388.45999999999
12200,U18244,117,757.1900000000031,89,28,26219.23,26976.420000000002
12201,U41798,117,45714.18000000001,89,28,92577.46999999999,138291.65
12202,U43873,117,5197.369999999995,70,47,412628.18,417825.55
12203,U17937,117,9814.440000000006,104,13,49988.890000000014,59803.330000000016
12204,U41489,117,43452.08999999999,108,9,132572.82,176024.91
12205,U15835,117,-35116.66,104,13,469123.97999999986,434007.31999999983
12206,U39347,117,35943.14000000003,61,56,1811154.89,1847098.03
12207,U28264,117,12238.859999999986,91,26,193148.2,205387.06
12208,U35047,117,-4262.370000000005,102,15,87235.50000000001,82973.13
12209,U24895,117,-2638.1299999999246,70,47,1473859.4600000002,1471221.3300000003
12210,U37865,117,-28885.279999999988,102,15,219620.49999999997,190735.21999999997
12211,U8473,117,839.4200000000001,106,11,14168.120000000006,15007.540000000006
12212,U604071,117,-5399.640000000011,64,53,184753.12,179353.47999999998
12213,U23164,117,-7803.449999999995,86,31,108762.64000000001,100959.19000000002
12214,U33631,117,-39022.94000000003,92,25,1046747.88,1007724.94
12215,U23115,117,-5915.309999999996,108,9,25840.120000000003,19924.810000000005
12216,U12296,117,-409944.21,105,12,655615.36,245671.14999999997
12217,U17267,117,-23477.26,101,16,90526.62000000001,67049.36000000002
12218,U29252,117,-1072.6899999999869,83,34,428750.3900000001,427677.70000000007
12219,U31588,117,-699.0099999999948,65,52,162903.46000000002,162204.45
12220,U18635,117,-11878.769999999993,99,18,38459.35000000001,26580.58000000002
12221,U34192,117,880.5900000000008,108,9,86382.27,87262.86
12222,U17142,117,-7619.6900000000005,106,11,38342.43,30722.739999999998
12223,U18491,117,-1071.4699999999991,110,7,14954.89,13883.42
12224,U10619,117,-8006.210000000001,111,6,38998.75,30992.54
12225,U10558,117,-19514.45,74,43,215341.10000000003,195826.65000000002
12226,U29249,117,41788.719999999994,93,24,145346.03,187134.75
12227,U969001,117,108.55000000000314,67,50,23102.23999999999,23210.789999999994
12228,U30435,117,4377.8699999999835,65,52,323267.9799999999,327645.8499999999
12229,U42077,117,22471.350000000006,102,15,26932.489999999998,49403.840000000004
12230,U42312,117,-16194.100000000011,109,8,36626.19000000001,20432.089999999997
12231,U35333,117,-204554.6199999998,96,21,2690334.43,2485779.8100000005
12232,U42418,117,-58525.58999999996,105,12,120025.89999999998,61500.31000000002
12233,U39033,117,-3671.2299999999987,87,30,143052.74,139381.50999999998
12234,U43471,117,-29703.880000000056,107,10,186829.99999999997,157126.1199999999
12235,U21018,117,-9495.19,89,28,45627.57,36132.38
12236,U15095,117,215864.3099999999,87,30,655889.79,871754.1
12237,U17184,117,-10087.92,91,26,169224.61000000002,159136.69
12238,U14241,117,265239.37000000005,105,12,135611.88,400851.25000000006
12239,U30226,117,21232.460000000003,105,12,133911.51,155143.97
12240,U21136,117,-6080.039999999999,111,6,23938.600000000002,17858.560000000005
12241,U30987,117,-2155.1800000000017,105,12,10161.389999999992,8006.20999999999
12242,U17652,117,24045.73,82,35,389662.96,413708.69
12243,U14180,117,-4226.69999999999,81,36,151357.04999999996,147130.34999999998
12244,U9356,117,27073.50999999998,94,23,1537732.71,1564806.22
12245,U39151,117,-13898.880000000061,106,11,2513910.3400000003,2500011.4600000004
12246,U39286,117,6364.890000000002,105,12,40905.770000000004,47270.66
12247,U12375,117,8296.67000000001,99,18,124964.06000000011,133260.73000000013
12248,U40028,117,21285.709999999985,91,26,181331.88999999998,202617.59999999998
12249,U24625,117,52326.04999999996,95,22,499433.3099999998,551759.3599999998
12250,U32921,117,-5960.05,105,12,40417.54,34457.49
12251,U27537,117,-10666.769999999999,106,11,23708.75,13041.980000000001
12252,U32679,117,-21106.930000000004,98,19,221653.29999999996,200546.36999999997
12253,U41277,117,-101.35999999998671,88,29,106119.21999999999,106017.86
12254,U31967,117,-451203.0299999999,109,8,460789.7699999999,9586.73999999999
12255,U39857,117,368276.81000000006,93,24,74952.53000000001,443229.3400000001
12256,U35395,117,-3667.7799999999943,104,13,105242.57,101574.79000000001
12257,U22928,117,520.4200000000019,62,55,2204063.4599999995,2204583.8799999994
12258,U38410,117,-41900.68000000006,97,20,440746.1699999995,398845.48999999947
12259,U27944,117,-10606.899999999998,103,14,66601.95999999999,55995.06
12260,U31885,117,39.12999999999738,89,28,35876.19,35915.32
12261,U29396,117,-8301.630000000023,80,37,691423.7999999999,683122.1699999999
12262,U26565,117,-5887.419999999997,104,13,55968.41000000002,50080.99000000002
12263,U38521,117,21123.710000000003,96,21,59027.549999999996,80151.26
12264,U39535,117,-992.7700000000012,103,14,26420.110000000004,25427.340000000004
12265,U28983,117,-55197.41,109,8,77032.52,21835.11
12266,U42794,117,59637.130000000005,99,18,261094.46000000002,320731.59
12267,U14769,117,-1353.5699999999997,79,38,44634.860000000015,43281.290000000015
12268,U32265,117,-12390.840000000007,111,6,96536.94,84146.09999999999
12269,U41309,117,-5277.719999999997,107,10,74490.33,69212.61
12270,U12140,117,8891.23,87,30,127810.87,136702.1
12271,U39771,117,-14772.849999999997,97,20,214274.3,199501.44999999998
12272,U21596,117,10616.499999999996,89,28,255443.17,266059.67
12273,U16765,117,-10013.469999999998,110,7,24416.12,14402.650000000001
12274,U32311,116,19356.13999999994,102,14,161165.00000000017,180521.14000000013
12275,U11068,116,-23479.350000000002,67,49,352512.4800000001,329033.1300000001
12276,U40341,116,-15503.719999999994,92,24,88003.99999999999,72500.28
12277,U31275,116,10188.809999999996,88,28,97444.51,107633.31999999999
12278,U15935,116,-2210.3000000000175,100,16,284703.13,282492.82999999996
12279,U28903,116,-18369.370000000166,63,53,631453.4000000003,613084.0300000001
12280,U20244,116,-16996.58,113,3,28336.98,11340.399999999998
12281,U11960,116,-2135.010000000002,109,7,8980.059999999996,6845.049999999994
12282,U40524,116,-1160.7500000000218,60,56,605973.6100000001,604812.8600000001
12283,U42721,116,-1002.8100000000013,104,12,47837.13999999997,46834.32999999997
12284,U19287,116,130147.05,86,30,348464.85000000003,478611.9
12285,U27163,116,26092.660000000003,88,28,378240.11999999994,404332.7799999999
12286,U28736,116,478.49999999999994,113,3,2522.090000000001,3000.590000000001
12287,U11031,116,1565.71,106,10,3843.779999999998,5409.489999999998
12288,U16232,116,-91857.5,97,19,164393.47999999995,72535.97999999995
12289,U25408,116,20602.87000000002,65,51,461963.14,482566.01
12290,U24010,116,-23403.310000000012,72,44,1081095.48,1057692.17
12291,U30739,116,-120822.72000000002,103,13,364842.94,244020.21999999997
12292,U40523,116,-483109.1200000001,97,19,1165734.48,682625.3599999999
12293,U18928,116,27629.640000000007,91,25,382807.25,410436.89
12294,U40066,116,-9131.919999999784,95,21,9923719.520000001,9914587.600000001
12295,U12073,116,-47894.84,101,15,156115.71000000002,108220.87000000002
12296,U14691,116,-6.809999999948559,99,17,647321.5400000005,647314.7300000006
12297,U27001,116,-199.26999999999967,111,5,10155.840000000002,9956.570000000002
12298,U21002,116,-76773.90999999992,80,36,1565056.7899999998,1488282.88
12299,U13214,116,42192.209999999934,66,50,466409.8,508602.0099999999
12300,U8062,116,-2381.709999999999,107,9,36730.22,34348.51
12301,U43870,116,-8023.969999999996,87,29,94391.98,86368.01
12302,U22734,116,1316.4800000000018,99,17,32056.23,33372.71
12303,U32688,116,75438.70999999996,102,14,488793.88000000006,564232.5900000001
12304,U18356,116,-38236.18,87,29,107541.75,69305.57
12305,U8154,116,29873.77000000002,77,39,492943.52000000014,522817.29000000015
12306,U1112546,116,-2265.4399999999996,105,11,10704.8,8439.36
12307,U23375,116,-113995.69000000002,96,20,330922.2299999999,216926.53999999992
12308,U35319,116,-4603.160000000029,77,39,821853.05,817249.89
12309,U18759,116,796.4200000000055,98,18,79836.57,80632.99000000002
12310,U26687,116,-1018.3699999999988,96,20,36746.219999999994,35727.85
12311,U27053,116,-31399.710000000017,107,9,63145.18000000001,31745.46999999999
12312,U35295,116,20338.899999999998,92,24,23269.38,43608.28
12313,U41124,116,3699.2900000000054,79,37,107040.44000000002,110739.73000000003
12314,U13357,116,10318.559999999961,85,31,2838558.2000000007,2848876.7600000007
12315,U19520,116,-4224.100000000004,108,8,58882.93,54658.829999999994
12316,U17062,116,-2557525.04,102,14,3509388.12,951863.0800000001
12317,U14481,116,17904.500000000015,87,29,122223.48999999998,140127.99
12318,U25467,116,5692.420000000004,105,11,50613.85999999999,56306.28
12319,U12518,116,-1121.85,110,6,2717.9900000000007,1596.1400000000008
12320,U15546,116,-155057.56000000003,87,29,304109.48999999976,149051.92999999973
12321,U40799,116,-8337.699999999993,102,14,102768.37,94430.67
12322,U18022,116,-11624.42,105,11,89873.13999999996,78248.71999999996
12323,U11000,116,37728.919999999984,88,28,221689.93999999997,259418.85999999996
12324,U22248,116,450.1699999999987,60,56,88133.05,88583.22
12325,U43068,116,41785.529999999984,100,16,32902.990000000005,74688.51999999999
12326,U9810,116,1250.3399999999997,104,12,41615.439999999995,42865.77999999999
12327,U36154,116,10919.499999999985,85,31,466255.24000000005,477174.74000000005
12328,U42341,116,-277686.97,92,24,621555.1900000001,343868.2200000001
12329,U33697,116,-190081.01000000013,90,26,1749869.3399999994,1559788.3299999991
12330,U27770,116,-144549.02999999997,50,66,1952496.9599999995,1807947.9299999995
12331,U21404,116,-1852.9099999999394,73,43,979040.0800000002,977187.1700000003
12332,U17871,116,2191.400000000052,77,39,1196394.3399999999,1198585.74
12333,U8222,116,-9659.96,73,43,248210.05999999997,238550.09999999998
12334,U8612,116,-8082.3600000000015,83,33,28042.549999999992,19960.18999999999
12335,U30295,116,-17854.32,99,17,921029.6,903175.28
12336,U21843,116,-115872.97999999998,80,36,2582378.4699999997,2466505.4899999998
12337,U8392,116,123837.31000000003,67,49,564464.46,688301.77
12338,U15451,116,2295.4700000000303,80,36,766064.96,768360.4299999999
12339,U24223,116,9520.10999999999,97,19,161237.93,170758.03999999998
12340,U8076,116,-13854.46,106,10,123370.06000000001,109515.6
12341,U26479,116,-601.7099999999989,91,25,46453.11999999999,45851.40999999999
12342,U15328,116,5753.91999999996,73,43,2271278.3000000003,2277032.22
12343,U41053,116,-4868.770000000001,107,9,44034.840000000004,39166.07
12344,U15303,116,1064.8300000000036,78,38,173852.83000000002,174917.66000000003
12345,U13534,116,363505.4100000001,80,36,1557214.29,1920719.7000000002
12346,U32581,116,899.3099999999977,105,11,38534.34999999999,39433.65999999999
12347,U19503,116,5254.45,82,34,25685.45,30939.9
12348,U40215,116,5627.370000000091,74,42,1537806.8100000003,1543434.1800000004
12349,U41835,116,-21112.989999999994,99,17,110439.3,89326.31000000001
12350,U585186,116,496.44000000000074,80,36,31299.94,31796.38
12351,U35489,116,19280.85999999997,109,7,40830.549999999916,60111.40999999989
12352,U39856,116,15189.590000000026,94,22,534422.06,549611.6500000001
12353,U1084925,116,0.2099999999998829,59,57,2418.81,2419.02
12354,U8330,116,11728.829999999994,107,9,39415.5,51144.329999999994
12355,U26129,116,34053.43000000001,102,14,105710.55000000003,139763.98000000004
12356,U14321,116,15691.660000000003,87,29,270869.51999999996,286561.17999999993
12357,U23989,116,-6841.4000000000015,95,21,142338.36000000002,135496.96000000002
12358,U1090167,116,3.9900000000009186,65,51,16875.190000000002,16879.180000000004
12359,U39463,116,42351.329999999994,97,19,174010.83000000002,216362.16
12360,U754521,116,-983.9200000000033,78,38,67959.14,66975.22
12361,U43840,116,-8186.310000000006,105,11,71955.48999999999,63769.179999999986
12362,U9819,116,-5895.6600000000035,107,9,102112.54999999999,96216.88999999998
12363,U15005,116,-166191.39999999997,91,25,544878.7400000003,378687.3400000004
12364,U9464,116,-8876.120000000014,76,40,442893.6799999999,434017.5599999999
12365,U20842,116,24057.75000000002,105,11,29222.90999999998,53280.66
12366,U21625,116,-3012.0899999999983,107,9,18323.119999999995,15311.029999999997
12367,U9722,116,-2874.139999999998,103,13,27382.160000000007,24508.020000000008
12368,U20982,116,-14890.239999999996,106,10,49615.89,34725.65
12369,U15319,116,512823.22000000003,58,58,1745016.87,2257840.0900000003
12370,U13453,116,-9036.160000000047,62,54,782678.2,773642.0399999999
12371,U8896,116,-11796.140000000001,100,16,32495.979999999996,20699.839999999997
12372,U16716,116,-104162.84999999963,98,18,6574436.59,6470273.74
12373,U16115,116,913.5299999999697,73,43,1215337.81,1216251.34
12374,U41607,116,291292.81,101,15,219928.28,511221.08999999997
12375,U30136,116,8770.530000000008,80,36,204763.91999999995,213534.44999999995
12376,U19679,116,-2376.2100000000005,106,10,11848.89,9472.679999999998
12377,U19476,116,3969.4799999999923,75,41,160511.69,164481.16999999998
12378,U39095,116,-33083.21,97,19,67843.1,34759.89000000001
12379,U9002,116,-19830.079999999973,85,31,379146.2399999998,359316.15999999986
12380,U18803,116,-9235.17,66,50,404499.68,395264.51
12381,U26332,116,-4933.240000000001,108,8,43469.22,38535.98
12382,U37927,116,3126.08,88,28,29122.560000000005,32248.640000000007
12383,U15192,116,12717.62999999998,99,17,193005.76999999987,205723.39999999985
12384,U24460,116,2640.4800000000005,107,9,20225.929999999997,22866.409999999996
12385,U41981,116,25164.24999999999,71,45,1447327.39,1472491.64
12386,U11804,116,-118.6600000000011,110,6,23470.000000000004,23351.340000000004
12387,U1141307,116,1854.5799999999988,88,28,23821.41999999999,25675.99999999999
12388,U13002,116,146.09000000000742,85,31,186631.95,186778.04
12389,U38796,116,4098.6900000000005,67,49,84301.82,88400.51000000001
12390,U1354135,116,2095.01,105,11,18238.239999999998,20333.25
12391,U39400,116,-441.3700000000008,97,19,54768.09,54326.719999999994
12392,U28681,116,10742.199999999995,71,45,163891.70999999993,174633.90999999992
12393,U12000,115,15074.2,100,15,49894.24000000001,64968.44000000002
12394,U629711,115,3.959999999999944,58,57,2378.04,2382.0
12395,U29889,115,39471.200000000004,108,7,16472.28,55943.48
12396,U43379,115,-13027.750000000002,93,22,78219.98000000001,65192.23000000001
12397,U27440,115,-1738.6700000000028,54,61,146687.67,144949.0
12398,U38853,115,1664.200000000002,103,12,26632.71,28296.91
12399,U30031,115,-3202.5899999999983,97,18,48320.31000000001,45117.720000000016
12400,U41709,115,18354.40000000001,98,17,65774.60000000002,84129.00000000003
12401,U14177,115,6213.480000000032,80,35,1132675.47,1138888.95
12402,U34873,115,2844.6200000005774,72,43,9296243.34,9299087.96
12403,U15826,115,-21033.77999999995,70,45,1084411.54,1063377.76
12404,U30232,115,30081.22000000003,91,24,379850.67,409931.89
12405,U15746,115,-21796.129999999794,79,36,4432673.580000001,4410877.450000001
12406,U38115,115,-4562.430000000007,101,14,44089.67999999999,39527.249999999985
12407,U38650,115,41950.10999999987,85,30,1505001.76,1546951.8699999999
12408,U40125,115,-20949.04000000002,98,17,194120.13,173171.09
12409,U17371,115,161793.01,94,21,669402.07,831195.08
12410,U15264,115,-276895.76999999996,77,38,960316.09,683420.3200000001
12411,U14112,115,126592.23000000004,89,26,898360.97,1024953.2
12412,U14672,115,94338.01,106,9,594391.53,688729.54
12413,U36443,115,-589.1200000000008,107,8,46725.53,46136.409999999996
12414,U19766,115,4254.459999999929,81,34,477417.45,481671.9099999999
12415,U15045,115,-3683.5499999999993,106,9,35132.6,31449.05
12416,U16893,115,-118731.70000000003,94,21,313861.65,195129.95
12417,U12460,115,12308.339999999998,104,11,45915.70999999999,58224.04999999999
12418,U40792,115,129.01999999999612,100,15,101035.6,101164.62
12419,U11312,115,14068.29,71,44,89295.21,103363.5
12420,U36959,115,5798.780000000009,94,21,136798.18,142596.96
12421,U41693,115,-70391.23999999996,96,19,160784.55,90393.31000000003
12422,U19171,115,-402.5300000000161,75,40,637580.99,637178.46
12423,U1049004,115,-0.2200000000102591,66,49,374207.81,374207.58999999997
12424,U37003,115,-25934.769999999997,100,15,472717.98000000004,446783.21
12425,U13975,115,-46240.85,95,20,349801.1700000001,303560.3200000001
12426,U31392,115,30541.849999999988,88,27,124388.96999999996,154930.81999999995
12427,U29204,115,-303485.63000000006,104,11,446952.25,143466.61999999994
12428,U28515,115,-8262.450000000186,46,69,33488111.44,33479848.990000002
12429,U26947,115,-68948.98999999996,91,24,210104.11,141155.12000000002
12430,U12481,115,-2860.85,108,7,6048.4800000000005,3187.6300000000006
12431,U11760,115,36.36999999997897,76,39,378824.57,378860.94
12432,U43818,115,-23477.96,84,31,80212.59999999999,56734.63999999999
12433,U32962,115,27406.799999999996,94,21,159084.24,186491.03999999998
12434,U35917,115,60082.579999999965,88,27,692419.61,752502.19
12435,U24310,115,3792.150000000003,91,24,105091.27000000002,108883.42000000003
12436,U31887,115,-1166.3999999999987,103,12,32297.249999999993,31130.849999999995
12437,U19917,115,21123.780000000002,97,18,24887.47,46011.25
12438,U39069,115,10640.49,100,15,44551.98,55192.47
12439,U43971,115,156.77999999999915,108,7,4923.19,5079.969999999998
12440,U12923,115,1033.42,99,16,43965.82999999999,44999.249999999985
12441,U10451,115,-8706.70999999997,82,33,912443.9200000002,903737.2100000002
12442,U24706,115,23777.35000000001,103,12,33633.979999999996,57411.33
12443,U13448,115,1767.910000000004,84,31,734778.07,736545.98
12444,U33781,115,183826.11000000002,80,35,200763.69999999998,384589.81
12445,U11731,115,1458.9799999999873,92,23,126519.62,127978.59999999998
12446,U11962,115,57109.000000000015,83,32,163711.59999999995,220820.59999999998
12447,U19468,115,-2178.6299999999974,99,16,62785.92,60607.29
12448,U40064,115,45326.349999999846,53,62,2863735.7,2909062.05
12449,U30168,115,32497.899999999983,94,21,341703.92000000004,374201.82
12450,U42608,115,-22673.27999999999,104,11,45784.880000000005,23111.600000000013
12451,U35032,115,-611.4700000000004,107,8,13804.980000000001,13193.51
12452,U29050,115,8359.890000000001,96,19,39297.59,47657.479999999996
12453,U41367,115,-12845.390000000007,97,18,511376.43,498531.04
12454,U17926,115,20481.660000000007,93,22,124035.18,144516.84
12455,U41782,115,29263.819999999992,92,23,852933.53,882197.35
12456,U27954,115,-25075.71,100,15,108888.21,83812.5
12457,U35584,115,-164.42999999999972,87,28,51336.02999999999,51171.59999999999
12458,U11183,115,195.36000000000024,92,23,29922.120000000006,30117.480000000007
12459,U25651,115,-10169.649999999996,102,13,16647.75999999999,6478.109999999995
12460,U33846,115,4013.2600000000007,91,24,37834.500000000015,41847.76000000002
12461,U35788,115,-170142.88999999998,81,34,345480.6,175337.71
12462,U21728,115,15119.739999999854,92,23,1089695.2100000002,1104814.95
12463,U31553,115,13438.96,97,18,62418.14,75857.1
12464,U18993,115,-19718.159999999996,102,13,62566.12000000002,42847.96000000002
12465,U18896,115,4848.350000000011,79,36,217655.59000000008,222503.9400000001
12466,U16052,115,-429026.19,91,24,2760126.41,2331100.22
12467,U28558,115,-12563.78999999999,79,36,300758.48000000004,288194.69000000006
12468,U16331,115,210182.7299999998,68,47,2629763.3999999994,2839946.1299999994
12469,U21071,115,-411704.05,67,48,954224.12,542520.0700000001
12470,U13682,115,52478.269999999975,98,17,350085.6300000002,402563.90000000014
12471,U27175,115,-21630.22000000001,96,19,393156.9,371526.68
12472,U41432,115,-2255.890000000001,108,7,40525.51,38269.62
12473,U29681,115,-406.4699999999968,84,31,44729.85000000003,44323.380000000034
12474,U34871,115,-49956.169999999984,96,19,454781.51,404825.34
12475,U12850,115,136178.95,94,21,607077.76,743256.71
12476,U11884,115,-6990.499999999999,111,4,13037.479999999998,6046.979999999999
12477,U14983,115,-80393.05,104,11,123156.81,42763.759999999995
12478,U39408,115,22224.460000000014,81,34,343328.2799999999,365552.73999999993
12479,U9485,115,5342.819999999987,71,44,577212.8999999999,582555.7199999999
12480,U31131,115,-12699.720000000018,88,27,124649.17000000001,111949.45
12481,U25513,115,78830.71999999997,88,27,148649.83000000005,227480.55000000002
12482,U22576,115,117628.12,90,25,487055.78,604683.9
12483,U23279,115,4316.059999999997,104,11,36426.61,40742.67
12484,U14515,115,606388.3,98,17,819399.55,1425787.85
12485,U9077,115,-40248.340000000004,75,40,386961.70000000007,346713.36000000004
12486,U19177,115,98949.94000000048,96,19,2800754.31,2899704.2500000005
12487,U1142734,115,294.9400000000005,61,54,12067.759999999998,12362.699999999999
12488,U10354,115,2677.3099999999995,106,9,9913.33,12590.64
12489,U18578,115,-2570.5699999999997,108,7,6488.370000000001,3917.800000000001
12490,U1288016,115,-1847.4399999999996,101,14,4662.719999999999,2815.2799999999997
12491,U37602,115,-7255.169999999998,101,14,21747.85,14492.68
12492,U20513,115,-13356.060000000009,70,45,495679.3,482323.24
12493,U30354,115,27929.070000000014,77,38,186079.96999999997,214009.03999999998
12494,U19001,115,3639.9699999999602,100,15,393827.08999999985,397467.0599999998
12495,U9773,115,1781.6300000000033,109,6,21926.98999999999,23708.619999999995
12496,U43981,115,-35651.840000000004,109,6,51687.87,16036.029999999999
12497,U33155,115,-31521.739999999998,78,37,128085.54000000001,96563.80000000002
12498,U34322,115,-117238.02000000002,98,17,675638.28,558400.26
12499,U33357,115,-11088.449999999999,99,16,42984.850000000006,31896.40000000001
12500,U17320,115,-486.2000000000049,86,29,245760.0,245273.8
12501,U29657,115,-63049.92999999965,69,46,3341257.87,3278207.9400000004
12502,U854160,115,181.89000000000075,88,27,13363.410000000003,13545.300000000005
12503,U32355,115,-5404.819999999998,77,38,134057.75,128652.93000000001
12504,U792869,115,43540.70000000002,73,42,133858.25,177398.95
12505,U25145,115,320.0399999999961,104,11,60962.28,61282.31999999999
12506,U33185,115,4361.6799999999985,107,8,65530.35,69892.03
12507,U1194576,115,-5873.009999999998,89,26,60375.13,54502.119999999995
12508,U41353,115,-38857.880000000005,91,24,146362.93,107505.04999999999
12509,U8743,115,61024.09999999999,108,7,181255.83000000002,242279.93
12510,U25418,115,14134.009999999998,73,42,412958.29,427092.3
12511,U36244,115,-2692.730000000001,99,16,59009.73000000002,56317.000000000015
12512,U33514,115,567.4300000000007,87,28,23875.050000000003,24442.480000000003
12513,U41410,115,-19318.729999999996,88,27,67578.23,48259.5
12514,U9318,115,-341533.2400000006,57,58,9667020.919999998,9325487.679999998
12515,U39275,115,-1496.4000000000015,101,14,12693.849999999991,11197.44999999999
12516,U33285,115,3853.250000000001,108,7,4908.550000000001,8761.800000000003
12517,U15897,115,-4379.720000000002,102,13,23679.719999999998,19299.999999999996
12518,U21103,115,-52792.36,107,8,134777.66,81985.3
12519,U40579,115,-2933.8300000000017,75,40,74812.05,71878.22
12520,U27629,115,-733.2000000000053,99,16,28341.480000000003,27608.28
12521,U42377,115,37509.48000000001,81,34,228329.26000000004,265838.74000000005
12522,U30425,115,3427.0499999999993,110,5,38348.96000000001,41776.01000000001
12523,U9777,115,-4746.100000000007,62,53,267599.55,262853.44999999995
12524,U19065,115,-21051.79000000003,78,37,485149.01,464097.22
12525,U32876,115,32766.940000000002,106,9,78245.77000000002,111012.71000000002
12526,U31794,115,5840.36999999991,64,51,1815077.2300000002,1820917.6
12527,U25749,114,4168.730000000002,106,8,17070.3,21239.030000000002
12528,U29632,114,551893.18,90,24,286707.3,838600.48
12529,U34099,114,-164878.73,90,24,337760.54,172881.80999999997
12530,U9638,114,24463.12,105,9,14029.849999999997,38492.969999999994
12531,U19817,114,-86101.5,102,12,647518.4199999999,561416.9199999999
12532,U28692,114,-11343.33,101,13,49446.94000000001,38103.61000000001
12533,U13776,114,1263.8799999999965,86,28,209719.13999999996,210983.01999999996
12534,U11478,114,5019.389999999956,84,30,297354.9899999999,302374.37999999983
12535,U26283,114,-3243.9499999994405,87,27,3637970.2500000005,3634726.300000001
12536,U29041,114,1988.0900000000017,93,21,193345.2,195333.29
12537,U41375,114,7187.849999999998,99,15,74208.59999999999,81396.44999999998
12538,U40093,114,477381.94,98,16,816157.94,1293539.88
12539,U32179,114,-112073.07000000007,76,38,8674726.21,8562653.14
12540,U23832,114,22558.440000000006,107,7,56246.729999999996,78805.17
12541,U1110634,114,-984.1100000000015,100,14,17711.25,16727.14
12542,U17724,114,196808.43000000002,67,47,907258.3900000001,1104066.82
12543,U19133,114,-383.87000000000376,94,20,46152.43000000001,45768.560000000005
12544,U14651,114,75662.9,72,42,2823411.2899999996,2899074.1899999995
12545,U14245,114,-12205.429999999986,88,26,171848.87999999998,159643.44999999998
12546,U10468,114,79994.84000000003,58,56,1070394.0,1150388.84
12547,U27767,114,-15665.339999999998,104,10,57591.78,41926.44
12548,U9972,114,-421.04000000000036,94,20,44606.26000000004,44185.22000000004
12549,U37247,114,-102287.34999999999,86,28,321269.83999999997,218982.49
12550,U42303,114,-45740.66000000002,101,13,89599.10999999994,43858.449999999924
12551,U29310,114,3017.1799999999394,98,16,547972.6399999999,550989.8199999998
12552,U28758,114,9853.34,98,16,8495.8,18349.14
12553,U21707,114,-3550.7699999999822,96,18,321181.68,317630.91000000003
12554,U25068,114,-7530.0999999999985,92,22,318406.91000000003,310876.81000000006
12555,U1370750,114,-105688.79000000001,93,21,125597.87000000001,19909.08
12556,U25827,114,1222.2100000000028,81,33,81391.90999999999,82614.12
12557,U37899,114,-296708.62,99,15,405391.27999999997,108682.65999999997
12558,U13780,114,3333.46,97,17,45312.92,48646.38
12559,U12452,114,-682.210000000001,85,29,61363.880000000005,60681.670000000006
12560,U31512,114,898.2200000000025,92,22,50010.27,50908.49
12561,U27159,114,-6894.540000000001,103,11,75354.84,68460.29999999999
12562,U32139,114,-22244.89000000001,68,46,227163.60999999993,204918.7199999999
12563,U33821,114,-408.0599999999977,105,9,51754.03,51345.97
12564,U26437,114,70225.09000000001,90,24,223607.61999999997,293832.70999999996
12565,U13078,114,674.8899999999994,87,27,391594.59,392269.48000000004
12566,U14157,114,12819.329999999987,97,17,190014.48999999993,202833.81999999992
12567,U38795,114,-17418.75000000003,77,37,195606.14999999994,178187.3999999999
12568,U28845,114,123801.27000000002,93,21,223118.39,346919.66000000003
12569,U14664,114,-171410.50999999998,87,27,421763.18,250352.67
12570,U1241205,114,186.0000000000009,82,32,21702.06,21888.06
12571,U41251,114,2690.3599999999997,107,7,10392.619999999999,13082.98
12572,U37076,114,3408.090000000031,70,44,1247339.2,1250747.29
12573,U37138,114,964.7400000000065,76,38,1006793.46,1007758.2
12574,U1326975,114,-171.4100000000028,84,30,70052.74999999999,69881.33999999998
12575,U35122,114,-4083.739999999945,95,19,437334.5600000001,433250.8200000002
12576,U30602,114,-27251.079999999998,74,40,394528.31,367277.23
12577,U27255,114,18748.359999999997,88,26,133663.91,152412.27
12578,U1373721,114,9.119999999996935,76,38,323079.79999999993,323088.9199999999
12579,U35195,114,29469.989999999994,95,19,274456.8499999999,303926.8399999999
12580,U21612,114,7348.049999999999,98,16,25714.800000000003,33062.850000000006
12581,U33207,114,-3540.759999999964,84,30,429124.31,425583.55000000005
12582,U13533,114,-44261.76000000004,63,51,1477370.15,1433108.39
12583,U24469,114,-1351.8500000000108,95,19,605359.1899999998,604007.3399999999
12584,U35977,114,-4314.12,105,9,15682.710000000003,11368.590000000004
12585,U15322,114,-20113.979999999996,101,13,31617.559999999998,11503.580000000002
12586,U1029556,114,19.430000000000014,59,55,3853.9700000000003,3873.4
12587,U42494,114,-173.3799999999983,96,18,34127.63999999999,33954.259999999995
12588,U32686,114,-3704.9800000000014,105,9,17817.079999999994,14112.099999999993
12589,U21994,114,-36.96999999997367,100,14,73999.78000000003,73962.81000000006
12590,U40407,114,5253.83000000002,107,7,222941.09000000023,228194.92000000025
12591,U19492,114,-714.0199999999999,102,12,11088.91,10374.89
12592,U27754,114,-7565.779999999999,101,13,82042.55000000005,74476.77000000005
12593,U18527,114,-16476.050000000003,102,12,59990.03999999999,43513.98999999999
12594,U38773,114,27658.229999999992,93,21,163755.22999999998,191413.45999999996
12595,U30572,114,-1297.3699999999985,96,18,25032.65,23735.280000000002
12596,U29782,114,-68927.25999999998,99,15,211009.33999999997,142082.08
12597,U26580,114,281871.76999999996,85,29,2395319.01,2677190.78
12598,U41089,114,17202.77000000005,87,27,285888.87999999995,303091.65
12599,U19634,114,-1084.8799999999956,82,32,61053.69,59968.810000000005
12600,U18627,114,1703.289999999999,75,39,72003.78,73707.06999999999
12601,U40477,114,69826.63000000002,104,10,25843.240000000005,95669.87000000002
12602,U43353,114,4600.870000000015,86,28,242206.2199999999,246807.08999999994
12603,U24478,114,-878.6199999999986,89,25,72755.31999999996,71876.69999999997
12604,U14967,114,3630.2399999999907,62,52,178749.7,182379.94
12605,U24880,114,-9924.37000000001,88,26,260293.09999999998,250368.72999999998
12606,U1182204,114,-2341.819999999999,94,20,39558.16000000008,37216.340000000084
12607,U25627,114,2422.300000000012,92,22,118207.95,120630.25000000001
12608,U38103,114,23421.050000000003,101,13,242783.58999999988,266204.6399999999
12609,U36442,114,7685.550000000001,104,10,16754.47,24440.020000000004
12610,U31270,114,-1807.4500000000003,100,14,14911.889999999998,13104.439999999997
12611,U19963,114,-188.61999999998844,95,19,36167.450000000004,35978.830000000016
12612,U30124,114,80483.69000000003,81,33,1684838.4399999997,1765322.1299999997
12613,U10931,114,814.1700000000018,108,6,14804.869999999995,15619.039999999997
12614,U9205,114,-12029.739999999998,85,29,186119.3,174089.56
12615,U903058,114,15971.880000000001,58,56,16871.13,32843.01
12616,U23088,114,60765.37999999999,85,29,295014.2,355779.58
12617,U39546,114,984.4699999999993,97,17,39429.62000000002,40414.09000000002
12618,U16596,114,-34062.03000000055,57,57,11042239.78,11008177.749999998
12619,U43681,114,-35557.169999999955,94,20,1406526.6100000006,1370969.4400000006
12620,U35564,114,15706.179999999982,102,12,118445.24,134151.41999999998
12621,U18557,114,49609.5,82,32,416443.9000000001,466053.4000000001
12622,U42207,114,9383.729999999987,84,30,229363.31,238747.03999999998
12623,U20289,114,26547.540000000008,87,27,285416.74,311964.28
12624,U12919,114,-14008.679999999995,106,8,43025.45999999999,29016.78
12625,U43106,114,-4998.3600000000015,58,56,46415.049999999996,41416.689999999995
12626,U14229,114,-4675.249999999476,68,46,7936569.640000001,7931894.3900000015
12627,U39959,114,-19509.600000000002,96,18,72206.96999999999,52697.36999999998
12628,U8995,114,-10679.910000000002,90,24,223650.6099999999,212970.6999999999
12629,U25967,114,-12136.89,104,10,151441.81999999995,139304.92999999993
12630,U38895,114,-19665.760000000013,98,16,182700.44000000003,163034.68000000002
12631,U20080,114,-21340.309999999976,80,34,116520.38999999998,95180.08000000002
12632,U39891,114,21055.930000000037,89,25,512549.25000000006,533605.18
12633,U9000,114,-6173.659999999999,104,10,15613.689999999997,9440.029999999999
12634,U14619,114,11574.039999999994,60,54,599597.59,611171.63
12635,U17405,114,28138.29999999999,90,24,187496.4299999999,215634.7299999999
12636,U28306,114,3862.6500000000005,103,11,18968.339999999956,22830.989999999958
12637,U27988,114,1194.7100000000005,107,7,12025.419999999996,13220.129999999997
12638,U13361,114,-1051.6999999999935,103,11,168130.76,167079.06000000003
12639,U15708,114,94821.05000000005,96,18,372847.3699999997,467668.41999999975
12640,U22324,114,65945.21,101,13,208294.18999999997,274239.39999999997
12641,U41038,114,-17347.340000000022,76,38,4560687.51,4543340.17
12642,U38016,114,-80.33000000000175,102,12,30620.75,30540.42
12643,U16289,114,51147.99,89,25,225145.75,276293.74
12644,U20218,114,-16351.419999999998,65,49,157684.56,141333.14
12645,U32249,114,8375.939999999999,109,5,13559.439999999999,21935.379999999997
12646,U17763,114,-35230.340000000004,101,13,91069.85,55839.51
12647,U41642,114,-5810.60000000001,92,22,635449.2799999999,629638.6799999999
12648,U24398,114,-6235.360000000001,97,17,67442.07,61206.71000000001
12649,U21441,114,29558.730000000007,87,27,45051.81,74610.54000000001
12650,U19992,114,-729.1799999999997,101,13,40048.17999999999,39318.99999999999
12651,U44039,114,2586.269999999902,85,29,894397.09,896983.3599999999
12652,U35617,114,1354.390000000003,65,49,383526.02999999997,384880.42
12653,U26140,114,484.1700000000003,99,15,58098.1,58582.27
12654,U21928,114,-5337.420000000013,85,29,884865.59,879528.1699999999
12655,U42370,114,-6569.470000000011,79,35,351415.74999999994,344846.2799999999
12656,U42725,114,639.9399999999991,107,7,14907.509999999998,15547.449999999997
12657,U27860,114,-7489.869999999997,110,4,14097.879999999996,6608.009999999998
12658,U16395,114,-17272.639999999956,93,21,1075430.8399999999,1058158.2
12659,U27227,114,-1892.1900000000014,95,19,28796.53,26904.339999999997
12660,U33702,114,2232.6199999999935,87,27,178955.94999999998,181188.56999999998
12661,U13095,113,-4350.990000000001,91,22,152693.95999999993,148342.96999999994
12662,U17277,113,2969.4099999999744,64,49,1915859.09,1918828.5
12663,U14151,113,-1170.5899999999997,91,22,113549.23999999999,112378.65
12664,U893113,113,-2901.390000000014,47,66,129959.78,127058.38999999998
12665,U36073,113,105809.77,89,24,66241.16,172050.93
12666,U42334,113,-176.87000000000057,98,15,18723.199999999997,18546.329999999998
12667,U37208,113,-4218.440000000001,107,6,11535.019999999999,7316.579999999997
12668,U38006,113,-5653.780000000001,104,9,27929.899999999994,22276.119999999995
12669,U25122,113,6934.289999999995,91,22,63050.84000000001,69985.13
12670,U16533,113,-742.7000000000003,108,5,12883.51,12140.81
12671,U21847,113,53327.10999999998,64,49,609084.1100000001,662411.2200000001
12672,U28731,113,1902.6899999999996,79,34,56234.4,58137.090000000004
12673,U8273,113,-7982.670000000129,96,17,846565.9500000002,838583.28
12674,U32547,113,29.45999999998513,64,49,149784.03,149813.49
12675,U38394,113,-3917.3700000000017,100,13,311841.3000000002,307923.9300000002
12676,U36921,113,-173.15999999999877,95,18,34359.45000000002,34186.29000000002
12677,U38660,113,3118.700000000008,63,50,970008.9400000002,973127.6400000001
12678,U23319,113,4688.389999999986,105,8,368893.99,373582.38
12679,U38395,113,4202.720000000012,94,19,191799.26999999993,196001.98999999993
12680,U16554,113,-7830.940000000002,81,32,69610.45,61779.509999999995
12681,U36589,113,4235.779999999997,95,18,110373.55,114609.33
12682,U27811,113,2646.110000000117,60,53,5467088.44,5469734.550000001
12683,U35582,113,-146708.88,82,31,594769.43,448060.55000000005
12684,U29970,113,1251.0999999999995,68,45,32290.92,33542.02
12685,U31955,113,4401.899999999992,73,40,672525.96,676927.86
12686,U24981,113,3765.14,85,28,75376.48000000001,79141.62000000001
12687,U29862,113,-18290.25,92,21,95315.31000000001,77025.06000000001
12688,U20661,113,-14815.210000000003,84,29,99097.21000000002,84282.00000000001
12689,U25634,113,4458.4700000000075,64,49,357821.94,362280.41000000003
12690,U21318,113,-498.19999999999584,99,14,65737.76999999999,65239.56999999999
12691,U26077,113,-54351.14999999988,77,36,3680321.71,3625970.56
12692,U38824,113,15092.389999999996,99,14,37579.47,52671.86
12693,U15886,113,8110.129999999999,97,16,116194.70999999996,124304.83999999997
12694,U24337,113,-15.519999999989523,53,60,645894.45,645878.9299999999
12695,U12434,113,23479.52999999997,97,16,371828.3400000001,395307.87000000005
12696,U13075,113,-4643.75000000022,91,22,1366458.8800000001,1361815.13
12697,U17928,113,-20165.939999999977,89,24,240568.4000000001,220402.46000000014
12698,U43462,113,-18711.959999999992,76,37,330334.56999999995,311622.61
12699,U12108,113,-1893.880000000001,88,25,29121.670000000002,27227.79
12700,U21466,113,730.8299999999799,77,36,227061.07,227791.9
12701,U20650,113,-20357.05000000001,93,20,134875.64999999997,114518.59999999995
12702,U19836,113,-2437.579999999999,81,32,38734.65,36297.07
12703,U34821,113,5999.979999999999,95,18,36761.85999999999,42761.83999999999
12704,U20016,113,-307.46000000000043,89,24,9453.319999999992,9145.859999999991
12705,U21809,113,3016.5700000000725,91,22,499930.13000000006,502946.7000000001
12706,U30501,113,2.530000000002701,102,11,27969.03000000001,27971.560000000012
12707,U44053,113,-49055.23,102,11,125760.13,76704.9
12708,U8719,113,-3417.4600000000014,107,6,13810.039999999999,10392.579999999998
12709,U24477,113,-5326.259999999998,93,20,35570.00999999999,30243.74999999999
12710,U30376,113,52849.82000000001,86,27,748145.5,800995.3200000001
12711,U42656,113,10160.72,96,17,90960.9,101121.62
12712,U16726,113,-989.7199999999939,108,5,112731.26,111741.54000000001
12713,U30385,113,30599.10000000007,105,8,184837.81999999998,215436.92000000004
12714,U15588,113,2585.5500000000006,106,7,17014.239999999998,19599.789999999997
12715,U17041,113,49.61000000001846,101,12,485301.49000000005,485351.1000000001
12716,U38943,113,22841.989999999983,78,35,467417.57999999996,490259.56999999995
12717,U28536,113,-9459.049999999996,93,20,89241.37000000001,79782.32
12718,U39217,113,-52838.979999999996,91,22,177423.59999999998,124584.61999999998
12719,U10786,113,-22255.76000000001,64,49,228750.21999999997,206494.45999999996
12720,U10679,113,4447.389999999999,94,19,26024.919999999995,30472.309999999994
12721,U43748,113,18399.9,101,12,86271.92,104671.82
12722,U42537,113,-102116.55999999972,77,36,9214751.72,9112635.16
12723,U13315,113,88823.16,65,48,1042543.92,1131367.08
12724,U36374,113,4562.5299999999825,39,74,267647.15,272209.68
12725,U25302,113,14529.240000000003,90,23,9180.970000000001,23710.210000000006
12726,U12880,113,-2630.280000000001,102,11,29518.649999999994,26888.36999999999
12727,U18118,113,-24622.36,93,20,171640.27,147017.90999999997
12728,U1095557,113,618.55,79,34,5270.71,5889.26
12729,U29126,113,-2742.3099999999977,71,42,200442.31999999998,197700.00999999998
12730,U24406,113,1473.4199999999998,105,8,1085.08,2558.5
12731,U20789,113,66860.78000000003,64,49,611839.14,678699.92
12732,U38627,113,-26096.760000000002,53,60,678469.3399999999,652372.5799999998
12733,U26570,113,24313.12000000001,100,13,57769.53999999999,82082.66
12734,U13467,113,-23036.75000000002,104,9,793700.3099999999,770663.5599999999
12735,U37806,113,-29620.969999999972,85,28,189950.91999999993,160329.94999999995
12736,U9796,113,3778.959999999999,100,13,60550.179999999986,64329.139999999985
12737,U20404,113,-7323.790000000004,96,17,78643.6,71319.81
12738,U24000,113,9547.440000000002,78,35,26186.66,35734.100000000006
12739,U41816,113,1793.800000000001,89,24,122960.41999999997,124754.21999999997
12740,U18445,113,-1527.7799999999993,106,7,21290.43999999999,19762.659999999993
12741,U38071,113,-4214.489999999994,102,11,48736.05999999999,44521.56999999999
12742,U11809,113,-5706.610000000001,98,15,136344.77,130638.15999999999
12743,U12151,113,4038.8499999999985,82,31,125002.59000000001,129041.44
12744,U10014,113,65981.12999999999,63,50,1321579.57,1387560.7
12745,U40599,113,44467.28999999998,103,10,80136.46000000002,124603.75
12746,U39089,113,4607.329999999994,82,31,489281.93000000005,493889.26000000007
12747,U22709,113,36630.69999999995,94,19,1088760.68,1125391.38
12748,U12933,113,32550.790000000005,78,35,297676.86,330227.64999999997
12749,U17903,113,-10349.630000000003,79,34,165049.03,154699.4
12750,U17421,113,-80012.98000000001,72,41,899027.31,819014.3300000001
12751,U31954,113,-4599.54,103,10,17659.599999999995,13060.059999999994
12752,U29575,113,13133.490000000003,103,10,46091.89000000001,59225.38000000001
12753,U28785,113,-283.969999999999,99,14,9912.769999999999,9628.8
12754,U13057,113,-18629.92,101,12,57639.01000000002,39009.09000000002
12755,U31989,113,134.42000000000016,99,14,32885.96,33020.38
12756,U43339,113,16598.869999999995,82,31,44017.36,60616.229999999996
12757,U20695,113,-8960.570000000014,79,34,254279.48000000007,245318.91000000006
12758,U22708,113,19966.02999999999,100,13,87689.04000000001,107655.07
12759,U35874,113,2186.1200000000013,104,9,8248.929999999997,10435.049999999997
12760,U1214596,113,-827.9500000000012,74,39,136410.16999999998,135582.21999999997
12761,U26796,113,48988.609999999986,104,9,108362.48000000005,157351.09000000003
12762,U25586,113,-219.14000000000124,74,39,54334.509999999995,54115.369999999995
12763,U24820,113,-14516.189999999977,83,30,573703.5600000002,559187.3700000002
12764,U41491,113,-3424.2899999999827,87,26,236171.44,232747.15000000002
12765,U21849,113,-476938.0,75,38,8173732.2,7696794.2
12766,U21929,113,249318.93,20,93,653371.86,902690.79
12767,U13529,113,43724.79999999999,88,25,163477.21,207202.00999999998
12768,U40885,113,110875.65999999997,88,25,401118.38,511994.04
12769,U23981,113,2916039.5499999993,75,38,10033121.739999996,12949161.289999995
12770,U35265,113,10570.01,103,10,23818.669999999995,34388.67999999999
12771,U9962,113,11552.009999999997,93,20,130206.21000000004,141758.22000000003
12772,U19285,113,-4690.270000000002,99,14,37383.240000000005,32692.97
12773,U28036,113,-5167.810000000028,93,20,158997.25999999992,153829.4499999999
12774,U28799,113,-31561.5,106,7,53559.469999999994,21997.969999999994
12775,U37430,113,-67035.59000000005,101,12,234492.81,167457.21999999994
12776,U965795,113,-11140.939999999999,84,29,28402.619999999995,17261.679999999997
12777,U24688,113,-37671.609999999986,38,75,174335.46000000002,136663.85000000003
12778,U28858,113,-8960.949999999995,88,25,67376.43000000001,58415.48000000001
12779,U19060,113,1899.0899999999983,101,12,62185.61000000004,64084.70000000003
12780,U14676,113,-159758.23999999996,99,14,1198040.1,1038281.8600000001
12781,U18774,113,12302.159999999989,101,12,254846.29,267148.45
12782,U16071,113,-68711.32999999997,99,14,317567.3999999999,248856.06999999995
12783,U30324,113,-29090.579999999994,93,20,113998.13,84907.55000000002
12784,U24364,113,-108792.73999999987,64,49,13262967.52,13154174.78
12785,U42187,112,12333.539999999997,62,50,330615.7,342949.24
12786,U19694,112,-4795.910000000047,86,26,461782.95,456987.04
12787,U32532,112,27184.490000000005,98,14,419668.4900000001,446852.9800000001
12788,U17508,112,-44715.62000000001,101,11,75592.87000000001,30877.25
12789,U19968,112,262516.5,83,29,961461.33,1223977.83
12790,U43304,112,-5912.490000000003,78,34,110374.41,104461.92
12791,U1184265,112,-1.8199999999999998,60,52,13493.789999999997,13491.969999999998
12792,U13765,112,52318.869999999966,62,50,281193.93,333512.79999999993
12793,U32959,112,-59811.54999999999,102,10,923247.4199999999,863435.8699999999
12794,U43315,112,-1120.960000000006,93,19,50704.9599999998,49583.999999999796
12795,U34648,112,29365.379999999983,77,35,439943.27,469308.65
12796,U41698,112,16331.459999999817,60,52,1589531.13,1605862.5899999996
12797,U13251,112,-13397.64,89,23,40858.29,27460.65
12798,U36467,112,-25537.850000000002,103,9,65719.57,40181.72
12799,U38210,112,-123541.18,89,23,248530.64999999997,124989.46999999997
12800,U13229,112,55456.16000000003,74,38,1312420.4,1367876.56
12801,U19759,112,-39608.899999999994,88,24,165832.09,126223.19
12802,U27246,112,6910.870000000003,97,15,27750.6,34661.47
12803,U15309,112,-2476.4100000000262,70,42,275079.64,272603.23
12804,U14120,112,1668.2700000000004,105,7,3975.3500000000004,5643.620000000001
12805,U8385,112,20821.140000000003,96,16,32998.009999999995,53819.149999999994
12806,U44049,112,-219040.70999999996,94,18,763669.97,544629.26
12807,U36831,112,-518.7499999999982,81,31,21416.070000000003,20897.320000000007
12808,U36717,112,7724.420000000002,104,8,65091.37999999999,72815.79999999999
12809,U14125,112,-693.4600000000071,101,11,67687.25000000001,66993.79000000001
12810,U27510,112,3193.2999999999984,89,23,62802.82000000003,65996.12000000002
12811,U37895,112,6914.619999999997,87,25,46151.4,53066.02
12812,U43131,112,16416.0400000001,98,14,1652363.88,1668779.92
12813,U29445,112,1717.9,68,44,6676.919999999999,8394.82
12814,U26154,112,-11224.31,100,12,37241.64000000001,26017.33000000001
12815,U10912,112,-9871.650000000009,71,41,621170.01,611298.36
12816,U8920,112,3726.1900000000023,98,14,75993.97,79720.16
12817,U8582,112,-5832.61,99,13,145941.82999999996,140109.21999999997
12818,U33006,112,-7949.2900000000045,87,25,88401.62999999998,80452.33999999997
12819,U42682,112,-29221.17,98,14,334138.76,304917.59
12820,U14126,112,8511.73,100,12,64314.38,72826.11
12821,U9779,112,-7899.820000000003,94,18,53650.81000000002,45750.99000000002
12822,U31294,112,-2400.3999999999796,73,39,135347.08,132946.68
12823,U25983,112,-2350.869999999998,91,21,350296.18000000005,347945.31000000006
12824,U31257,112,16874.990000000005,108,4,5537.2300000000005,22412.220000000005
12825,U35653,112,-40266.369999999995,90,22,185228.83000000002,144962.46000000002
12826,U10552,112,47942.889999999985,79,33,578352.2,626295.09
12827,U1247892,112,-4677.069999999991,79,33,62786.740000000034,58109.67000000004
12828,U43277,112,-8416.96,87,25,29155.399999999983,20738.439999999984
12829,U38122,112,-24825.81,89,23,82557.42000000001,57731.610000000015
12830,U16508,112,30316.89,85,27,95972.29000000001,126289.18000000001
12831,U24610,112,175.6800000000003,91,21,99750.62,99926.29999999999
12832,U33167,112,-609.0099999999923,61,51,207787.56999999998,207178.56
12833,U26848,112,182149.27999999997,82,30,736189.84,918339.1199999999
12834,U10403,112,-1907.0000000000002,96,16,87683.4099999998,85776.4099999998
12835,U35609,112,-1869.9300000000137,95,17,239224.29999999996,237354.36999999994
12836,U38623,112,6422.34,96,16,26307.450000000004,32729.790000000005
12837,U36929,112,-8689.5,99,13,41491.52,32802.02
12838,U24485,112,-327.4400000000055,73,39,659953.5300000001,659626.0900000001
12839,U13909,112,2145.3699999999994,106,6,25662.09000000001,27807.46000000001
12840,U32097,112,-7906.420000000013,59,53,479551.04999999993,471644.6299999999
12841,U8276,112,130716.03,69,43,217045.22999999995,347761.25999999995
12842,U12036,112,-22079.17999999999,107,5,44789.95000000001,22710.770000000022
12843,U27598,112,-2051.43,99,13,81624.26999999999,79572.84
12844,U8878,112,10569.489999999998,94,18,114131.31999999999,124700.81
12845,U23638,112,-1391.9800000000105,87,25,755842.8799999999,754450.8999999999
12846,U28607,112,-3461.590000000001,104,8,22950.08,19488.49
12847,U730797,112,183.34999999999957,59,53,75232.0,75415.35
12848,U31893,112,24105.560000000027,79,33,211990.03999999995,236095.59999999998
12849,U9376,112,-1419.7099999999991,22,90,204770.15,203350.44
12850,U40794,112,2803.8899999999994,106,6,4299.0,7102.889999999999
12851,U27846,112,78605.24000000002,84,28,162092.62,240697.86000000002
12852,U8576,112,-2601.030000000008,77,35,62010.69999999999,59409.669999999984
12853,U32314,112,4992.849999999991,85,27,230931.8,235924.64999999997
12854,U31817,112,-37922.86000000003,92,20,137051.75000000003,99128.89
12855,U16187,112,-4296.26,99,13,37059.57,32763.309999999998
12856,U38552,112,30109.27000000001,96,16,39366.090000000004,69475.36000000002
12857,U18055,112,1289.1900000000005,98,14,135622.28000000003,136911.47000000003
12858,U41139,112,-56623.27000000002,87,25,280037.1,223413.82999999996
12859,U30284,112,5568.0200000000195,59,53,256079.56999999998,261647.59
12860,U9482,112,-8562.319999999998,86,26,37567.8,29005.480000000003
12861,U33432,112,-736.4099999999997,89,23,36698.56000000002,35962.15000000002
12862,U42062,112,-1960.9499999999925,78,34,390108.83,388147.88
12863,U34698,112,-918.4500000000083,99,13,139945.81999999998,139027.36999999997
12864,U10196,112,9913.970000000003,89,23,98352.46000000002,108266.43000000002
12865,U8150,112,-460929.37000000046,90,22,2225231.129999992,1764301.7599999914
12866,U31466,112,44604.350000000006,48,64,6621056.02,6665660.369999999
12867,U9861,112,-4912.249999999985,86,26,462270.0100000001,457357.7600000001
12868,U19439,112,-1377198.67,44,68,3038739.85,1661541.1800000002
12869,U26396,112,-2786.9000000000215,99,13,339037.34,336250.44
12870,U8026,112,27573.15000000001,99,13,36539.0,64112.15000000001
12871,U42839,112,21866.179999999993,83,29,423152.43,445018.61
12872,U25517,112,262.95999999999185,80,32,129297.33,129560.29
12873,U17266,112,-5056.07,95,17,119326.62,114270.54999999999
12874,U19437,112,6468.990000000003,62,50,196146.42999999996,202615.41999999995
12875,U15857,112,-291324.58999999997,84,28,2471038.35,2179713.7600000002
12876,U10920,112,-229.6299999999992,88,24,21296.449999999997,21066.82
12877,U970276,112,-8774.199999999999,91,21,97133.06000000001,88358.86000000002
12878,U12758,112,-9076.41,91,21,55217.91000000002,46141.500000000015
12879,U28543,112,236278.17999999993,70,42,1251067.48,1487345.66
12880,U43963,112,57091.41,78,34,69918.41,127009.82
12881,U28422,112,17004.41,101,11,60552.51000000001,77556.92000000001
12882,U16514,112,-41765.59000000001,96,16,67792.57000000002,26026.98000000001
12883,U1106960,112,-545.4400000000005,96,16,8632.650000000001,8087.210000000001
12884,U13653,112,8645.109999999957,95,17,363981.63999999996,372626.7499999999
12885,U17965,112,486.1999999999957,50,62,122163.35,122649.55
12886,U26349,112,1093.5500000000002,101,11,23588.120000000003,24681.670000000002
12887,U27337,112,-105.76999999999498,88,24,75230.56,75124.79000000001
12888,U43220,112,-954.539999999979,51,61,731045.96,730091.4199999999
12889,U15390,112,-7530.160000000002,104,8,35109.35999999999,27579.19999999999
12890,U1331871,112,-1906.4999999999995,95,17,33052.94,31146.440000000002
12891,U10778,112,-191527.54000000004,93,19,360989.5400000002,169462.00000000017
12892,U12071,112,128206.43000000002,88,24,175523.90999999995,303730.33999999997
12893,U42012,112,3992.569999999999,95,17,19516.790000000005,23509.360000000004
12894,U27594,112,-116420.67000000001,105,7,128503.62,12082.949999999983
12895,U36363,112,19284.15999999999,63,49,670867.9099999999,690152.07
12896,U9274,112,-2945.4199999998964,51,61,1138251.4500000002,1135306.0300000003
12897,U15130,112,-5351.290000000022,84,28,264901.76,259550.47
12898,U22710,112,-623920.6199999998,91,21,3906891.610000001,3282970.990000001
12899,U24414,112,-10902.029999999999,107,5,17631.079999999998,6729.049999999999
12900,U18268,111,122685.53999999998,91,20,748556.7200000001,871242.26
12901,U42211,111,-3204.2299999999886,67,44,176087.25999999995,172883.02999999997
12902,U37617,111,1150.369999999998,92,19,38599.37000000001,39749.740000000005
12903,U13356,111,-5811.200000000009,79,32,147542.38,141731.18
12904,U41142,111,-1716.4900000000014,99,12,19145.859999999997,17429.369999999995
12905,U23002,111,6504.010000000001,100,11,7339.06,13843.070000000002
12906,U16581,111,-3480.169999999982,90,21,416133.85000000003,412653.68000000005
12907,U21026,111,3669.3999999999996,82,29,219731.4,223400.8
12908,U21947,111,13619.420000000002,102,9,15797.850000000002,29417.270000000004
12909,U12997,111,-580230.31,71,40,1942512.4500000002,1362282.1400000001
12910,U33511,111,-2422.209999999999,100,11,21351.66,18929.45
12911,U40941,111,-12679.130000000003,103,8,88921.79,76242.65999999999
12912,U30711,111,-477.979999999999,89,22,30195.34,29717.36
12913,U39883,111,-175.02000000001135,85,26,189304.17000000004,189129.15000000002
12914,U24173,111,4144.230000000003,98,13,60596.8,64741.030000000006
12915,U21655,111,-542.7199999999905,72,39,326714.35,326171.63
12916,U35089,111,-15348.189999999999,106,5,26074.430000000004,10726.240000000005
12917,U29016,111,-44370.21,97,14,99148.82999999999,54778.61999999999
12918,U14456,111,-23811.090000000004,67,44,344904.08,321092.99
12919,U23409,111,-52024.380000000005,75,36,181096.84000000003,129072.46000000002
12920,U23232,111,-53471.81000000001,96,15,1689686.1299999997,1636214.3199999996
12921,U28043,111,-99.24999999999955,101,10,50290.82000000001,50191.57000000001
12922,U19464,111,4999.559999999998,90,21,28025.479999999996,33025.03999999999
12923,U27117,111,-12151.64000000002,96,15,256997.74,244846.09999999998
12924,U8736,111,-16167.06,57,54,826805.9699999999,810638.9099999998
12925,U38579,111,3461.120000000026,62,49,290222.63000000006,293683.7500000001
12926,U34977,111,-1726.9599999999969,95,16,38466.990000000005,36740.030000000006
12927,U35687,111,441.93000000000177,83,28,18329.860000000004,18771.790000000005
12928,U26425,111,37286.729999999996,89,22,86148.65,123435.37999999999
12929,U18713,111,-1469.7699999999923,68,43,152477.75999999998,151007.99
12930,U12495,111,14676.45,88,23,235002.78999999998,249679.24
12931,U16737,111,81103.55000000002,74,37,608392.3000000002,689495.8500000002
12932,U28265,111,45078.989999999976,77,34,460281.43999999994,505360.42999999993
12933,U31317,111,-13443.579999999998,92,19,90973.96999999999,77530.38999999998
12934,U25610,111,1567.089999999991,88,23,84493.3,86060.39
12935,U20426,111,-14784.389999999989,96,15,212080.59,197296.2
12936,U41997,111,-1328.6300000000003,88,23,19741.89,18413.26
12937,U37065,111,-2662.7400000000007,104,7,28890.57,26227.829999999998
12938,U13029,111,42091.47999999998,76,35,755353.4200000002,797444.9000000001
12939,U18655,111,18665.480000000018,63,48,453974.6699999999,472640.14999999997
12940,U31015,111,-502.4100000000017,106,5,22227.85,21725.439999999995
12941,U39369,111,4257.670000000003,79,32,160651.45,164909.12000000002
12942,U15540,111,-1760.659999999989,75,36,376371.39,374610.73000000004
12943,U10521,111,3917.040000000008,92,19,152120.43,156037.47
12944,U43517,111,-871.7800000000016,85,26,41045.229999999996,40173.45
12945,U31347,111,-4357.99,78,33,54418.65000000001,50060.66000000001
12946,U27712,111,-93311.06000000001,98,13,229972.74000000005,136661.68000000005
12947,U9556,111,-657298.21,104,7,710404.9699999999,53106.75999999989
12948,U29964,111,-5997.26,91,20,53747.03999999999,47749.77999999999
12949,U32082,111,-5049.480000000057,72,39,538845.71,533796.2299999999
12950,U12485,111,176818.77999999997,72,39,435159.01,611977.79
12951,U8172,111,16038.939999999988,69,42,209599.62,225638.56
12952,U38924,111,-107771.23999999998,106,5,111760.11999999998,3988.8800000000047
12953,U1384372,111,300.00000000000364,59,52,45428.020000000004,45728.020000000004
12954,U25643,111,4847.479999999998,100,11,104105.55000000002,108953.03000000001
12955,U36520,111,-79649.86,98,13,101400.01999999999,21750.15999999999
12956,U10730,111,-10078.239999999996,73,38,290339.28,280261.04000000004
12957,U41569,111,11466.979999999998,91,20,65760.27,77227.25
12958,U26311,111,12372.51000000001,85,26,247335.2400000001,259707.75000000012
12959,U13327,111,-53557.96,96,15,216181.81999999995,162623.85999999996
12960,U14929,111,109919.11000000002,82,29,277859.89999999997,387779.01
12961,U37545,111,6127.89,94,17,33446.83,39574.72
12962,U28975,111,1199.9199999999983,26,85,156189.49,157389.40999999997
12963,U8350,111,151708.74000000002,94,17,847546.64,999255.38
12964,U24691,111,3843.7200000000003,104,7,16575.749999999996,20419.469999999998
12965,U35380,111,-1509.7,98,13,13465.119999999999,11955.419999999998
12966,U8534,111,9836.600000000002,90,21,168853.73,178690.33000000002
12967,U15385,111,5919.119999999996,90,21,282454.82000000007,288373.94000000006
12968,U24504,111,-20513.329999999994,88,23,396885.73,376372.39999999997
12969,U39521,111,965.3899999999982,96,15,96191.63000000002,97157.02000000002
12970,U14742,111,44424.86000000001,83,28,376985.86999999994,421410.7299999999
12971,U22296,111,-8418.81,92,19,150543.97,142125.16
12972,U22895,111,-1820.9399999999991,96,15,56306.77000000002,54485.830000000016
12973,U8337,111,9649.400000000001,102,9,61897.03999999999,71546.44
12974,U17520,111,-14081.07,98,13,68819.04,54737.969999999994
12975,U27100,111,-13987.750000000007,89,22,88419.13,74431.38
12976,U8548,111,93117.54999999999,88,23,236821.31,329938.86
12977,U14775,111,-2860.18,89,22,301476.8900000002,298616.7100000002
12978,U28941,111,-3262.729999999998,98,13,34821.17999999999,31558.449999999993
12979,U24353,111,290.1299999999983,96,15,49741.27,50031.399999999994
12980,U24275,111,2859.6599999999903,92,19,20052.05,22911.70999999999
12981,U15699,111,-40756.76999999997,79,32,662972.5499999998,622215.7799999998
12982,U22193,111,1010457.139999999,89,22,37896.550000000025,1048353.689999999
12983,U10391,111,66138.17999999998,80,31,167364.05,233502.22999999998
12984,U36082,111,12667.43,90,21,103482.9,116150.32999999999
12985,U40990,111,-694.7799999999999,98,13,14505.179999999995,13810.399999999994
12986,U18493,111,5319.379999999999,102,9,117756.18000000001,123075.56000000001
12987,U25715,111,-984.360000000001,70,41,151694.83000000002,150710.47
12988,U22344,111,-13239.73,104,7,106140.39000000003,92900.66000000003
12989,U19712,111,-24101.830000000005,102,9,112767.99999999999,88666.16999999998
12990,U41807,111,-2159.409999999989,68,43,781686.1699999999,779526.7599999999
12991,U29739,111,2574.21,84,27,361227.65,363801.86000000004
12992,U18371,111,-2973.9099999999944,90,21,72808.45999999999,69834.55
12993,U40491,111,5077.809999999999,104,7,15763.859999999997,20841.669999999995
12994,U33070,111,11159.060000000003,92,19,239701.33000000007,250860.39000000007
12995,U11063,111,12088.339999999997,88,23,104590.8,116679.14
12996,U12517,111,-9249.670000000002,83,28,199119.62,189869.94999999998
12997,U25945,111,8168.350000000002,90,21,17296.699999999997,25465.05
12998,U37998,111,-1234.0499999999993,90,21,598337.5199999999,597103.4699999999
12999,U8149,111,3506.7700000000227,106,5,30553.069999999992,34059.84000000002
13000,U23372,111,1024.710000000001,94,17,72712.58,73737.29000000001
13001,U34451,111,-2055.359999999996,95,16,47297.180000000015,45241.82000000002
13002,U31078,111,9441.089999999997,98,13,177662.84,187103.93
13003,U17099,111,-353994.21,84,27,1229344.52,875350.31
13004,U39780,111,58363.01000000001,88,23,80099.46999999999,138462.47999999998
13005,U34700,111,-23737.93999999999,92,19,86417.68000000001,62679.74000000002
13006,U36551,111,201241.99999999997,87,24,1133811.02,1335053.02
13007,U1273956,111,-356.0900000000013,85,26,9488.57,9132.479999999998
13008,U39195,111,94636.26000000001,98,13,574541.9199999999,669178.1799999999
13009,U1189711,111,-30440.13,73,38,224396.79,193956.66
13010,U33344,111,629.1400000000024,90,21,26748.569999999996,27377.71
13011,U26297,111,-1808.9,87,24,14607.399999999998,12798.499999999998
13012,U44017,111,-126988.74999999994,72,39,295076.22,168087.47000000003
13013,U31938,111,1060.4700000000066,70,41,140678.0,141738.47
13014,U37759,111,7660.17,82,29,63123.430000000015,70783.60000000002
13015,U24997,111,33645.72,83,28,111422.34999999998,145068.06999999998
13016,U15051,111,4560.4400000000105,82,29,480373.5399999998,484933.9799999998
13017,U28800,111,85574.13,74,37,1123258.1400000001,1208832.27
13018,U24062,111,-70648.56999999993,102,9,750022.05,679373.4800000001
13019,U35290,111,58511.45999999994,74,37,3419532.99,3478044.45
13020,U39175,111,-902.2999999999628,102,9,21048.669999999966,20146.370000000003
13021,U34493,111,-790.9400000000003,108,3,6792.619999999999,6001.6799999999985
13022,U32163,110,127.48999999999523,71,39,134179.7,134307.19
13023,U26928,110,-1016.6399999999965,76,34,66867.64,65851.0
13024,U30434,110,18929.40999999999,84,26,423942.95000000007,442872.36000000004
13025,U32951,110,1602.5999999999995,88,22,8806.470000000001,10409.07
13026,U28420,110,33714.40999999997,93,17,353658.53000000014,387372.9400000001
13027,U1353781,110,12008.420000000004,77,33,109044.75999999998,121053.17999999998
13028,U35663,110,-985.9499999999825,79,31,442051.2,441065.25
13029,U17132,110,-439012.66000000003,85,25,718520.78,279508.12
13030,U34785,110,-3056.510000000035,82,28,466259.95000000007,463203.44000000006
13031,U39512,110,12296.020000000002,82,28,55055.30999999999,67351.32999999999
13032,U11974,110,15468.930000000011,59,51,145604.04000000004,161072.97000000006
13033,U15697,110,-2186.269999999994,81,29,117767.53,115581.26000000001
13034,U15938,110,129475.72999999998,89,21,145721.29,275197.02
13035,U14836,110,-133668.03,98,12,344463.57999999996,210795.54999999996
13036,U18258,110,8308.129999999992,98,12,136170.85,144478.98
13037,U41206,110,-115416.60999999996,93,17,272204.36,156787.75000000003
13038,U24308,110,80632.60000000003,102,8,42601.62000000002,123234.22000000006
13039,U38931,110,15859.31,103,7,2984.2700000000004,18843.58
13040,U35480,110,356.80999999998676,60,50,257532.44999999992,257889.25999999992
13041,U29459,110,51101.259999999995,95,15,492830.22,543931.48
13042,U29298,110,2226.2200000000003,87,23,23592.19,25818.41
13043,U24155,110,91989.48,91,19,33115.64,125105.12
13044,U34302,110,7452.140000000008,87,23,88825.18999999999,96277.33
13045,U41468,110,41575.04000000001,78,32,665079.3299999996,706654.3699999996
13046,U9509,110,-83197.66000000002,104,6,110571.08,27373.419999999984
13047,U1151763,110,-1.4210854715202004e-14,55,55,4421.240000000001,4421.240000000001
13048,U41350,110,-10656.319999999998,88,22,102210.99999999997,91554.67999999998
13049,U43527,110,-38976.340000000004,103,7,76484.63000000002,37508.290000000015
13050,U1356270,110,542.0999999999995,83,27,7118.450000000001,7660.55
13051,U19682,110,-15064.849999999999,92,18,51957.73000000003,36892.880000000034
13052,U38064,110,50201.609999999986,87,23,113551.88999999998,163753.49999999997
13053,U39515,110,-440447.1499999999,76,34,2949284.0800000005,2508836.9300000006
13054,U1250531,110,617.9000000000015,97,13,38970.08,39587.98
13055,U28057,110,2639.6200000000026,101,9,84423.5,87063.12
13056,U14539,110,-3216.8499999999995,101,9,15503.239999999996,12286.389999999996
13057,U25973,110,-51643.41000000002,88,22,386159.53,334516.12
13058,U28015,110,-5266.700000000003,101,9,84624.20999999999,79357.51
13059,U28985,110,36481.98999999999,63,47,1047026.89,1083508.88
13060,U11822,110,12382.630000000003,92,18,249325.41000000003,261708.04000000004
13061,U27934,110,-51005.63,102,8,93568.51000000005,42562.880000000056
13062,U36132,110,3509.78,83,27,22403.12,25912.899999999998
13063,U26555,110,2101.319999999999,100,10,51625.24000000001,53726.56000000001
13064,U641998,110,-8076.679999999999,106,4,8234.26,157.58000000000084
13065,U11199,110,-6652.430000000013,84,26,269756.98999999993,263104.55999999994
13066,U41601,110,-6357.27,92,18,72055.20999999999,65697.93999999999
13067,U28863,110,-20627.499999999993,99,11,107620.82999999999,86993.32999999999
13068,U23703,110,1941.5700000000065,103,7,7382.050000000001,9323.620000000008
13069,U18580,110,43977.0,93,17,77501.28,121478.28
13070,U24291,110,-10889.590000000047,69,41,827848.2699999999,816958.6799999998
13071,U15836,110,3997.0299999999697,72,38,713841.6499999999,717838.6799999999
13072,U38685,110,544.3099999999888,76,34,421484.27999999997,422028.58999999997
13073,U34473,110,-2128.4199999999964,89,21,49609.81999999999,47481.399999999994
13074,U11587,110,-37188.62999999999,102,8,147856.21,110667.58
13075,U30512,110,3722.119999999984,82,28,651889.6000000001,655611.7200000001
13076,U18400,110,95746.04000000004,83,27,289713.07,385459.11000000004
13077,U26198,110,-46992.48000000009,90,20,621737.6900000001,574745.21
13078,U35012,110,-14428.779999999997,90,20,135294.11000000004,120865.33000000005
13079,U16825,110,-215765.6399999999,68,42,3926216.0900000003,3710450.45
13080,U30342,110,1241.1199999999992,68,42,23105.36,24346.48
13081,U9354,110,-232612.22999999998,97,13,490922.62,258310.39
13082,U12080,110,-4384.080000000002,99,11,40725.24,36341.159999999996
13083,U31578,110,350134.99000000005,88,22,1129608.79,1479743.78
13084,U12550,110,-122424.29000000004,78,32,588953.3499999999,466529.0599999998
13085,U26426,110,12209.039999999999,96,14,25300.380000000005,37509.420000000006
13086,U26945,110,4992.420000000002,97,13,57458.42000000005,62450.840000000055
13087,U20764,110,145024.55000000005,72,38,4192114.4499999993,4337138.999999999
13088,U30728,110,-5981.689999999996,97,13,87228.36000000006,81246.67000000006
13089,U9192,110,-566.9599999999714,86,24,356981.25999999995,356414.3
13090,U25442,110,9337.850000000002,84,26,33274.33,42612.18000000001
13091,U42234,110,94.42000000012922,50,60,3317971.01,3318065.4299999997
13092,U43079,110,-267906.5,94,16,449806.83,181900.33000000002
13093,U15816,110,-12143.47000000003,65,45,1749748.5199999998,1737605.0499999998
13094,U26096,110,-16710.34999999999,79,31,376610.23,359899.88
13095,U43100,110,-12165.390000000021,53,57,773524.5599999999,761359.1699999999
13096,U33053,110,-27146.91,79,31,262428.33999999997,235281.42999999996
13097,U625519,110,-1544.8200000000043,85,25,56115.51000000001,54570.69
13098,U43864,110,1247.1200000000001,96,14,17721.399999999998,18968.519999999997
13099,U32086,110,2154.0200000000023,92,18,310105.98,312260.0
13100,U31461,110,4322.289999999992,84,26,221186.13000000006,225508.42000000004
13101,U12521,110,-31313.509999999995,75,35,103187.69999999997,71874.18999999997
13102,U34062,110,-102959.85,71,39,641080.0,538120.15
13103,U36249,110,-7173.149999999996,99,11,54084.780000000006,46911.63000000001
13104,U34125,110,-842.4099999999999,95,15,6685.580000000001,5843.170000000001
13105,U9706,110,129830.78,72,38,380975.61,510806.39
13106,U38677,110,24909.999999999985,55,55,1449012.59,1473922.59
13107,U39524,110,5119.640000000001,94,16,44749.47000000001,49869.11000000001
13108,U9599,110,-11006.350000000195,82,28,2215210.3,2204203.9499999997
13109,U29054,110,-3165.0400000000145,95,15,177288.08000000007,174123.04000000007
13110,U25765,110,23663.790000000005,78,32,116870.97,140534.76
13111,U30246,110,41407.89,90,20,213833.06,255240.95
13112,U15183,110,-1169.179999999998,76,34,39873.76000000001,38704.58000000001
13113,U17735,110,489.7200000000021,84,26,100639.71999999999,101129.43999999999
13114,U15294,110,26917.729999999996,81,29,131352.63999999998,158270.37
13115,U19723,110,14346.390000000007,98,12,123856.91,138203.30000000002
13116,U18478,110,-17005.809999999998,97,13,109054.26000000002,92048.45000000003
13117,U688524,110,-1546.229999999999,69,41,33111.119999999995,31564.889999999996
13118,U12454,110,-95995.97,89,21,403167.58999999997,307171.62
13119,U34010,110,-6658.37,95,15,18932.829999999998,12274.46
13120,U24151,110,209892.48,75,35,330788.83,540681.31
13121,U39787,110,-148074.46999999997,76,34,1803175.76,1655101.29
13122,U970818,110,5326.320000000005,78,32,39082.53,44408.850000000006
13123,U26790,110,1899.2600000000016,96,14,46702.68,48601.94
13124,U9138,110,69681.51999999999,77,33,171523.11000000002,241204.63
13125,U37447,110,183.8200000000005,93,17,13887.559999999996,14071.379999999996
13126,U38858,110,-10097.279999999993,80,30,31826.94000000002,21729.660000000025
13127,U40591,110,-20538.050000000007,90,20,150503.00999999995,129964.95999999995
13128,U10531,110,-29223.960000000006,84,26,169500.86,140276.89999999997
13129,U33783,110,-13405.920000000002,94,16,42902.73,29496.81
13130,U29871,110,4811.389999999869,83,27,3776262.08,3781073.4699999997
13131,U34113,110,-377.8300000000012,87,23,143733.12,143355.29
13132,U39494,110,1963.109999999992,56,54,375617.3999999999,377580.5099999999
13133,U19569,110,-1367.319999999999,99,11,7739.789999999999,6372.47
13134,U15593,110,-3069.1100000000333,62,48,1727372.99,1724303.88
13135,U30389,109,-19855.890000000003,94,15,71851.22,51995.33
13136,U18705,109,10383.190000000002,88,21,61323.439999999995,71706.63
13137,U28430,109,155.06000000003024,49,60,1150897.9899999998,1151053.0499999998
13138,U16542,109,10199.290000000003,90,19,21402.290000000005,31601.58000000001
13139,U22789,109,40291.369999999995,80,29,1010150.96,1050442.33
13140,U37816,109,-18639.33999999993,79,30,612118.9100000001,593479.5700000002
13141,U13323,109,-80470.75999999998,87,22,279930.02,199459.26000000004
13142,U27985,109,250357.38999999998,86,23,725028.4500000001,975385.8400000001
13143,U40299,109,-608.3999999999987,100,9,21374.33,20765.930000000004
13144,U26193,109,367286.65,52,57,747314.04,1114600.69
13145,U19251,109,92910.29,79,30,181258.68,274168.97
13146,U34225,109,64258.55999999998,78,31,352938.8599999999,417197.4199999999
13147,U25461,109,-1938.309999999997,78,31,34137.80000000001,32199.490000000013
13148,U35378,109,-14549.099999999991,96,13,102939.66,88390.56000000001
13149,U32216,109,-352.5000000012369,51,58,6940888.8100000005,6940536.31
13150,U13189,109,29118.799999999996,95,14,20079.13,49197.92999999999
13151,U11388,109,3942.430000000002,103,6,26072.92,30015.35
13152,U15793,109,-3504.439999999997,100,9,107449.32999999993,103944.88999999993
13153,U17014,109,12395.559999999932,95,14,603036.78,615432.34
13154,U10488,109,-32273.430000000022,101,8,135490.67000000004,103217.24000000002
13155,U39944,109,544.3599999999899,86,23,260940.16,261484.52
13156,U906950,109,-453.6999999999989,65,44,29809.089999999997,29355.39
13157,U8856,109,-9104.859999999997,61,48,122952.35999999999,113847.49999999999
13158,U15570,109,-13637.829999999987,76,33,373453.11999999994,359815.2899999999
13159,U13079,109,2778.200000000004,93,16,89868.38000000002,92646.58000000002
13160,U43988,109,-6177.44,100,9,16128.569999999998,9951.129999999997
13161,U667450,109,135.21000000000015,80,29,12461.54,12596.750000000002
13162,U14520,109,-6322.25,79,30,81306.99999999999,74984.74999999999
13163,U16358,109,-91836.65999999999,90,19,347618.51000000007,255781.8500000001
13164,U43497,109,-2374.42,99,10,16595.410000000003,14220.990000000003
13165,U26021,109,-10432.429999999997,92,17,56619.68,46187.25
13166,U36269,109,222233.76,73,36,494283.18000000005,716516.9400000001
13167,U31506,109,5969.949999999999,99,10,12127.96,18097.909999999996
13168,U33809,109,-787911.5800000001,94,15,1560736.9,772825.3199999998
13169,U16600,109,102261.74999999994,89,20,453328.24000000005,555589.99
13170,U43071,109,11403.94,96,13,66670.52,78074.46
13171,U37603,109,9370.86,88,21,55051.89000000001,64422.75000000001
13172,U34087,109,-7940.09,105,4,24241.14,16301.05
13173,U25150,109,-2017.0,100,9,22918.530000000002,20901.530000000002
13174,U14454,109,132188.87,98,11,173901.22,306090.08999999997
13175,U27955,109,-350.7000000000046,96,13,4303.070000000007,3952.3700000000026
13176,U19487,109,17131.62999999999,100,9,29996.88000000001,47128.509999999995
13177,U34611,109,-3752.4699999999984,99,10,34318.34000000001,30565.870000000014
13178,U20025,109,9394.690000000017,77,32,396113.07999999996,405507.76999999996
13179,U936567,109,8662.749999999996,95,14,28321.18000000004,36983.93000000004
13180,U25814,109,164598.63000000006,92,17,387058.89,551657.52
13181,U24657,109,-18331.690000000002,99,10,46886.659999999996,28554.969999999994
13182,U29035,109,14148.040000000003,89,20,20149.46,34297.5
13183,U15203,109,-10083.460000000001,82,27,95181.4,85097.93999999999
13184,U22356,109,1125.7999999999258,73,36,1105944.9500000007,1107070.7500000005
13185,U25002,109,-3718.1499999999996,92,17,20225.969999999998,16507.82
13186,U23102,109,-20339.250000000015,92,17,81780.44999999998,61441.19999999997
13187,U35615,109,-122600.20999999995,54,55,340071.26000000007,217471.0500000001
13188,U23378,109,-159124.92999999993,63,46,1172252.55,1013127.6200000001
13189,U25988,109,6348.610000000001,67,42,185221.19999999998,191569.81
13190,U13209,109,-11148.859999999982,54,55,843898.18,832749.3200000001
13191,U23042,109,73086.16000000034,76,33,2757953.6000000006,2831039.7600000007
13192,U1247664,109,-142.24999999999991,96,13,2102.7800000000016,1960.5300000000016
13193,U9125,109,-32698.970000000012,97,12,432731.2400000001,400032.2700000001
13194,U11931,109,14392.950000000003,94,15,664719.6600000001,679112.6100000001
13195,U29107,109,-20029.409999999974,73,36,443709.41000000003,423680.00000000006
13196,U40468,109,658.4100000000038,91,18,50198.73000000001,50857.140000000014
13197,U36530,109,12446.500000000005,83,26,93379.81000000001,105826.31000000001
13198,U27891,109,3235.740000000014,82,27,353432.86999999976,356668.60999999975
13199,U10499,109,11935.02,92,17,13760.94,25695.96
13200,U29057,109,-524.1199999999997,88,21,61097.36,60573.24
13201,U12869,109,-36749.83,95,14,104189.57,67439.74
13202,U17822,109,5933.409999999989,87,22,341238.6800000001,347172.0900000001
13203,U20048,109,950.1200000000063,95,14,45836.84999999999,46786.97
13204,U17306,109,-5900.209999999967,79,30,1410633.67,1404733.46
13205,U20302,109,-142312.0400000025,94,15,31467962.39999999,31325650.35999999
13206,U26707,109,54582.48999999999,84,25,906417.0,960999.49
13207,U29360,109,-353700.65999999986,93,16,1422150.7500000002,1068450.0900000003
13208,U29509,109,-13.410000000000903,102,7,10510.29,10496.88
13209,U39176,109,8301.87999999998,87,22,206493.13,214795.00999999998
13210,U36366,109,-10313.159999999989,72,37,358927.11,348613.95
13211,U16144,109,-820.109999999974,82,27,132407.90999999995,131587.79999999996
13212,U911953,109,-14656.56,82,27,36342.25,21685.690000000002
13213,U23734,109,42792.82000000001,86,23,277710.1,320502.92
13214,U16160,109,-40022.59000000002,83,26,340330.96,300308.37
13215,U23653,109,4290.42000000042,64,45,7467671.84,7471962.260000001
13216,U29358,109,-3429.4699999999993,104,5,24976.750000000004,21547.280000000006
13217,U41703,109,-2392.07,101,8,9329.529999999999,6937.459999999999
13218,U22459,109,-5050.150000000023,74,35,585946.4,580896.25
13219,U23364,109,6947.389999999999,75,34,279325.98,286273.37
13220,U1343039,109,-59159.52000000001,74,35,1610141.6899999995,1550982.1699999995
13221,U19916,109,-6390.619999999997,91,18,86555.58999999998,80164.96999999999
13222,U17963,109,4161.689999999886,69,40,827354.06,831515.75
13223,U38079,109,527.1500000000017,93,16,27926.160000000007,28453.31000000001
13224,U35820,109,2465.739999999999,86,23,49083.960000000014,51549.70000000001
13225,U42381,109,10000.419999999991,41,68,487749.10000000003,497749.52
13226,U22338,109,-118.70000000000009,103,6,13535.400000000001,13416.7
13227,U22312,109,-871066.2200000002,94,15,3700851.31,2829785.09
13228,U34951,109,-159929.43999999997,92,17,638023.2600000001,478093.8200000002
13229,U37536,109,2313.7900000000063,94,15,73925.79,76239.58
13230,U37579,109,16796.86999999998,82,27,265493.94000000006,282290.81000000006
13231,U16660,109,49344.22999999975,87,22,4531357.460000001,4580701.69
13232,U37775,109,-1003.23,76,33,75476.02000000002,74472.79000000002
13233,U37663,109,-8085.999999999998,106,3,23734.079999999998,15648.08
13234,U29306,109,3335.4500000000007,92,17,152828.76,156164.21000000002
13235,U40780,109,11747.119999999995,69,40,491351.61000000004,503098.73000000004
13236,U35519,109,3781.1100000000015,66,43,176685.31,180466.42
13237,U31399,109,-3657.1399999999976,104,5,16158.139999999994,12500.999999999996
13238,U27849,109,-2486.379999999999,101,8,22156.6,19670.22
13239,U38298,109,-95063.36000000006,72,37,630987.8800000001,535924.52
13240,U32629,109,38750.34000000001,94,15,59393.829999999994,98144.17000000001
13241,U39043,109,22635.940000000002,91,18,135236.24,157872.18
13242,U10025,109,-5848.049999999997,64,45,1582659.4999999995,1576811.4499999995
13243,U23623,109,-6471.150000000025,85,24,4548569.040000001,4542097.890000001
13244,U36452,109,-5518.84,80,29,49111.950000000004,43593.11
13245,U11040,109,17017.899999999987,90,19,670563.1099999999,687581.0099999999
13246,U31376,109,55.12000000000262,76,33,63934.200000000004,63989.32000000001
13247,U29029,109,-34.55999999999972,88,21,71150.69999999998,71116.13999999998
13248,U10117,109,1719.869999999999,81,28,56156.32000000002,57876.19000000002
13249,U21185,109,-25047.429999999993,77,32,115198.49,90151.06000000001
13250,U665325,109,-8700.910000000003,88,21,55094.79,46393.88
13251,U32762,109,65216.11,87,22,56855.39,122071.5
13252,U22593,109,-14408.340000000002,77,32,103812.85999999997,89404.51999999997
13253,U42367,109,-28097.490000000005,94,15,59617.88,31520.389999999992
13254,U28064,109,-79004.73000000001,87,22,440859.67000000004,361854.94000000006
13255,U685228,109,14.609999999999673,62,47,186307.7,186322.31
13256,U1152642,109,2086.54,98,11,4961.819999999999,7048.359999999999
13257,U27690,109,1965.0299999999988,66,43,58640.100000000006,60605.130000000005
13258,U25086,109,20.15000000000208,75,34,30396.560000000005,30416.710000000006
13259,U14919,109,3015.4899999999957,99,10,23660.46,26675.949999999993
13260,U9262,109,-366.65000000003107,52,57,489158.8399999999,488792.1899999999
13261,U1126049,109,5234.19,82,27,43207.350000000006,48441.54000000001
13262,U12439,109,740904.2599999999,85,24,367806.96,1108711.22
13263,U8317,109,69833.73000000007,75,34,1177701.5599999998,1247535.2899999998
13264,U23573,109,-17427.8,101,8,35542.56,18114.76
13265,U26649,109,67385.89000000013,90,19,151168.16999999998,218554.0600000001
13266,U28289,109,6776.439999999998,82,27,63958.34,70734.78
13267,U31733,108,-34249.36,99,9,74677.09000000004,40427.73000000004
13268,U13844,108,-34975.020000000004,97,11,57207.97,22232.949999999997
13269,U18281,108,-422469.81,87,21,1725875.4700000007,1303405.6600000006
13270,U9429,108,647.9399999999966,86,22,116939.85999999997,117587.79999999997
13271,U687796,108,-0.1699999999997317,68,40,23637.93,23637.760000000002
13272,U15718,108,-5677317.570000001,69,39,13456609.2,7779291.629999998
13273,U11050,108,50327.89,78,30,46082.04,96409.93
13274,U16172,108,-12434.509999999997,99,9,31594.520000000004,19160.01000000001
13275,U38299,108,6036.33999999998,96,12,84158.82,90195.15999999999
13276,U38760,108,39859.7100000003,75,33,1993972.8399999999,2033832.55
13277,U28551,108,4427.570000000009,45,63,174798.89999999997,179226.46999999997
13278,U12306,108,65823.87,68,40,326681.42000000004,392505.29000000004
13279,U29502,108,-1321.3800000000233,95,13,263699.32,262377.94
13280,U43777,108,3204.690000000006,88,20,118678.14,121882.83
13281,U25247,108,173.80000000000004,104,4,2827.25,3001.05
13282,U37969,108,-257.81000000000506,95,13,83629.29999999999,83371.48999999998
13283,U37796,108,46726.679999999986,91,17,41339.920000000006,88066.59999999999
13284,U32364,108,-4975.0,61,47,64663.0,59688.0
13285,U27900,108,-4217.260000000003,96,12,22418.359999999986,18201.099999999984
13286,U24879,108,164.6900000000049,63,45,273974.44,274139.13
13287,U9606,108,-30381.559999999998,76,32,104754.38000000003,74372.82000000004
13288,U36085,108,7109.260000000009,48,60,3828331.9,3835441.16
13289,U22129,108,-25415.620000000003,98,10,162511.1,137095.48
13290,U17825,108,-2748.5300000000016,96,12,23515.760000000002,20767.23
13291,U24918,108,12384.300000000003,92,16,312432.16,324816.45999999996
13292,U19390,108,142775.56000000003,90,18,73633.65000000002,216409.21000000005
13293,U30471,108,-1843.4299999999816,81,27,753813.4099999999,751969.98
13294,U38090,108,56848.94999999998,82,26,337889.81999999995,394738.7699999999
13295,U9674,108,35591.159999999996,90,18,232633.34999999998,268224.50999999995
13296,U22396,108,5088.489999999998,93,15,153233.35,158321.84
13297,U43044,108,-18214.110000000004,71,37,73832.97999999998,55618.86999999998
13298,U29180,108,-303610.57,90,18,505075.11000000004,201464.54000000004
13299,U26926,108,64.65000000000026,103,5,9775.959999999997,9840.609999999997
13300,U36668,108,4126.129999999999,101,7,25746.38999999999,29872.51999999999
13301,U8085,108,-7137.840000000011,75,33,167303.47,160165.63
13302,U32002,108,-1131.1799999999985,98,10,28743.170000000006,27611.990000000005
13303,U26383,108,-977.419999999996,98,10,38108.80000000001,37131.38000000001
13304,U13696,108,1401284.9100000006,72,36,10696086.44,12097371.35
13305,U34453,108,7762.400000000011,88,20,32806.99,40569.39000000001
13306,U19383,108,-179994.05,91,17,527749.9600000001,347755.9100000001
13307,U15320,108,-32188.63,81,27,410472.00000000006,378283.37000000005
13308,U37696,108,-153.9300000000001,80,28,80685.59,80531.66
13309,U12053,108,128646.61999999997,85,23,73275.45000000001,201922.06999999998
13310,U38322,108,-5380.660000000002,93,15,75562.01,70181.34999999999
13311,U11125,108,6975.879999999994,94,14,50968.68,57944.56
13312,U11643,108,5264.270000000006,79,29,351579.21999999986,356843.4899999999
13313,U27705,108,-19955.770000000008,97,11,39273.84999999999,19318.079999999984
13314,U21238,108,-769.1900000000015,104,4,5725.76,4956.569999999999
13315,U35949,108,-64287.82999999996,61,47,2133190.8300000005,2068903.0000000005
13316,U27203,108,-620958.7,82,26,1268884.56,647925.8600000001
13317,U43316,108,-180854.51,65,43,1819448.26,1638593.75
13318,U20485,108,31784.210000000006,87,21,68152.91999999998,99937.12999999999
13319,U19997,108,-1907.3400000000001,77,31,88693.29000000001,86785.95000000001
13320,U17324,108,754.7000000000021,62,46,412925.79000000004,413680.49000000005
13321,U28747,108,89.7500000000104,76,32,68866.92,68956.67000000001
13322,U29441,108,-5957.57,90,18,58514.68,52557.11
13323,U29961,108,22558.229999999927,84,24,586833.86,609392.09
13324,U15767,108,15624.880000000041,69,39,918946.8300000001,934571.7100000001
13325,U8028,108,21818.949999999997,90,18,123989.53,145808.47999999998
13326,U22891,108,3099.8800000000015,95,13,13349.5,16449.38
13327,U29565,108,15514.200000000023,91,17,671493.63,687007.8300000001
13328,U35611,108,-8409.390000000007,91,17,61661.670000000006,53252.28
13329,U986249,108,33059.56,87,21,69883.74000000002,102943.30000000002
13330,U1329719,108,26784.95,68,40,173693.81,200478.76
13331,U34778,108,-17868.92000000003,74,34,1008104.1400000001,990235.2200000001
13332,U11997,108,217.59999999999582,76,32,93073.27999999997,93290.87999999996
13333,U22855,108,2210.0599999999977,93,15,48735.96999999998,50946.02999999998
13334,U42049,108,-2159.490000000009,97,11,65745.84,63586.34999999999
13335,U40661,108,97030.58,67,41,99777.28,196807.86
13336,U12677,108,315.79999999999876,97,11,16224.269999999993,16540.069999999992
13337,U20874,108,-22440.469999999994,74,34,336354.42999999993,313913.95999999996
13338,U38547,108,5889.75,96,12,56403.299999999996,62293.049999999996
13339,U19087,108,71797.99999999997,72,36,1193147.4199999997,1264945.4199999997
13340,U33800,108,-2896.8299999999936,78,30,171580.10000000024,168683.27000000025
13341,U639997,108,-5368.24,74,34,39982.61,34614.37
13342,U22786,108,2265.4399999999996,95,13,9865.870000000003,12131.310000000001
13343,U20389,108,11219.170000000004,92,16,46815.55999999999,58034.729999999996
13344,U28465,108,149726.04,99,9,147487.55,297213.58999999997
13345,U34645,108,-134.23000000000047,92,16,13942.160000000002,13807.93
13346,U29060,108,-56857.51999999999,79,29,120605.33999999998,63747.81999999999
13347,U26808,108,-83.27000000000066,94,14,25506.550000000003,25423.280000000002
13348,U18019,108,-10673.549999999994,86,22,53576.82000000003,42903.27000000003
13349,U27092,108,9253.660000000007,89,19,419586.9700000001,428840.6300000001
13350,U12896,108,-1962.6399999999994,94,14,35175.49,33212.85
13351,U40020,108,-10482.869999999986,94,14,162397.97,151915.1
13352,U29625,108,6404.979999999763,49,59,2721320.82,2727725.8
13353,U13843,108,24994.240000000013,89,19,119366.07999999999,144360.32
13354,U28332,108,-11017.849999999993,96,12,161854.59,150836.74
13355,U25152,108,-1467.55000000001,93,15,82649.83,81182.28
13356,U18501,108,2262.18,98,10,38168.43,40430.61
13357,U32207,108,-15864.180000000044,91,17,1353547.1800000002,1337683.0000000002
13358,U29125,108,11059.259999999977,52,56,633031.14,644090.4
13359,U13355,108,-25802.320000000014,68,40,386534.2200000001,360731.9000000001
13360,U41382,108,35154.949999999975,66,42,267479.08,302634.02999999997
13361,U17244,108,-39553.94,91,17,208172.16000000003,168618.22000000003
13362,U1323420,108,-7778.27,101,7,17364.87,9586.599999999999
13363,U41210,108,-5180.970000000008,92,16,81155.66999999998,75974.69999999998
13364,U19941,108,-29868.74999999999,85,23,217615.43,187746.68
13365,U18606,108,-7666.969999999998,78,30,931290.8600000001,923623.8900000001
13366,U14483,108,37628.75999999997,97,11,223348.39,260977.15
13367,U23556,108,25481.38999999999,65,43,366840.74,392322.13
13368,U30391,108,-46037.33,94,14,285973.94,239936.61
13369,U17367,108,-22818.76000000001,92,16,738855.83,716037.07
13370,U34109,108,-346.8300000000005,95,13,16444.39,16097.56
13371,U35213,108,5662.140000000003,97,11,50045.090000000004,55707.23000000001
13372,U27959,107,982.5299999999997,89,18,18669.35,19651.879999999997
13373,U19991,107,-4510.669999999986,76,31,155750.92,151240.25000000003
13374,U29177,107,56199.75,79,28,192346.70999999996,248546.45999999996
13375,U19859,107,30007.490000000005,91,16,131083.28,161090.77000000002
13376,U28121,107,-81595.06999999998,64,43,224244.81000000008,142649.7400000001
13377,U39410,107,-33035.71000000001,94,13,71008.17,37972.45999999999
13378,U16962,107,35418.540000000015,71,36,669053.9400000001,704472.4800000001
13379,U20206,107,-1031.2400000000052,79,28,467706.8699999999,466675.6299999999
13380,U24042,107,4049.650000000003,100,7,104952.87,109002.52
13381,U19573,107,6381.0,96,11,56276.86,62657.86
13382,U41806,107,-663.2999999999956,90,17,122283.73000000003,121620.43000000002
13383,U36190,107,-1082.8199999999995,88,19,39604.579999999994,38521.759999999995
13384,U32991,107,3273.239999999984,92,15,236664.76,239938.0
13385,U15522,107,-5734.7200000000175,91,16,166437.01999999993,160702.2999999999
13386,U39887,107,510348.44,85,22,496039.29999999993,1006387.74
13387,U35281,107,77125.14999999992,73,34,377460.36000000016,454585.51000000007
13388,U11417,107,-7309.479999999974,81,26,450221.10999999987,442911.6299999999
13389,U41977,107,-1465.8500000000054,101,6,34743.210000000014,33277.36000000001
13390,U29339,107,-13606.210000000001,91,16,128782.26000000001,115176.05
13391,U43215,107,2412.909999999996,84,23,81572.91,83985.82
13392,U29865,107,63.2699999999968,54,53,429999.93,430063.2
13393,U25416,107,1300.0500000000025,69,38,29971.11,31271.160000000003
13394,U13603,107,72093.60999999997,83,24,575887.8499999997,647981.4599999997
13395,U24833,107,25297.600000000013,94,13,63936.41999999999,89234.02
13396,U10823,107,-403.11999999999125,76,31,447905.63999999996,447502.51999999996
13397,U33831,107,30259.040000000005,92,15,37544.64,67803.68000000001
13398,U27322,107,1467.4999999999927,58,49,135306.18,136773.68
13399,U9776,107,6035.079999999987,49,58,526478.1,532513.1799999999
13400,U23717,107,2012.9900000000025,83,24,14370.98,16383.970000000001
13401,U34024,107,-1564.679999999998,84,23,59466.58999999999,57901.90999999999
13402,U16783,107,-78617.57999999999,93,14,497043.20999999985,418425.6299999999
13403,U23210,107,-6170.379999999994,88,19,91210.31000000001,85039.93000000002
13404,U36961,107,-586.2199999999998,89,18,33416.509999999995,32830.28999999999
13405,U24423,107,-7379.84,101,6,24356.579999999994,16976.739999999994
13406,U35983,107,77993.31000000001,91,16,108539.24,186532.55000000002
13407,U9406,107,-15431.039999999997,72,35,33489.19,18058.150000000005
13408,U15621,107,-12091.240000000013,60,47,399604.9500000001,387513.71000000014
13409,U8572,107,-13071.53000000002,67,40,175174.66999999993,162103.1399999999
13410,U21442,107,7047.669999999999,95,12,48729.20000000001,55776.87000000001
13411,U19460,107,-3707.4400000000023,80,27,942962.3600000001,939254.9200000002
13412,U11570,107,-12066.140000000001,97,10,67465.79999999999,55399.65999999999
13413,U37573,107,-6188.200000000001,99,8,26843.739999999998,20655.539999999997
13414,U33099,107,-122233.31999999999,81,26,330640.20000000007,208406.88000000006
13415,U10361,107,31684.77999999999,57,50,216255.99999999997,247940.77999999997
13416,U34014,107,-8985.51999999999,98,9,184448.58000000002,175463.06000000003
13417,U13669,107,-121264.92999999993,73,34,435197.17000000004,313932.2400000001
13418,U22742,107,-58371.48999999986,71,36,717922.05,659550.5600000002
13419,U9117,107,-11337.180000000144,74,33,968954.5799999998,957617.3999999997
13420,U9469,107,1387.720000000002,90,17,35192.3,36580.020000000004
13421,U14828,107,1839800.5499999993,70,37,3130848.4299999997,4970648.979999999
13422,U30468,107,-3426.5399999999936,80,27,486398.23000000004,482971.69000000006
13423,U42700,107,-1062.6799999999978,95,12,112744.09999999969,111681.41999999969
13424,U28464,107,-203166.31999999986,75,32,2948624.65,2745458.33
13425,U22908,107,10109.220000000001,99,8,31278.610000000008,41387.83000000001
13426,U30441,107,4705.259999999989,79,28,371206.5200000001,375911.7800000001
13427,U19491,107,-24852.180000000004,80,27,183268.71999999997,158416.53999999998
13428,U43605,107,-1267.2700000000011,76,31,41750.12999999997,40482.859999999964
13429,U36680,107,-36896.390000000014,94,13,144599.05,107702.65999999997
13430,U19474,107,-7677.660000000007,88,19,58710.33000000001,51032.67
13431,U1078289,107,-692.73,78,29,1998.1399999999996,1305.4099999999996
13432,U41615,107,52389.41,92,15,129165.73000000001,181555.14
13433,U23731,107,-34849.76000000001,93,14,124437.8,89588.04
13434,U24324,107,18315.09999999998,82,25,184811.85999999993,203126.9599999999
13435,U22373,107,-53121.02,96,11,116082.87999999999,62961.85999999999
13436,U31571,107,-5644.610000000002,93,14,32706.6,27061.989999999998
13437,U37109,107,39060.86000000006,70,37,939065.7999999999,978126.66
13438,U43628,107,2098.8500000000013,59,48,53661.61999999999,55760.46999999999
13439,U39824,107,9270.829999999989,86,21,266803.51,276074.34
13440,U10720,107,3287.9099999999926,93,14,55796.07000000003,59083.980000000025
13441,U23284,107,-2435.6299999999987,103,4,9225.719999999994,6790.089999999995
13442,U10914,107,1206.4600000000007,88,19,14579.61000000001,15786.07000000001
13443,U988132,107,41111.16,72,35,78128.41999999998,119239.57999999999
13444,U8846,107,-158263.84999999998,78,29,957901.5,799637.65
13445,U829665,107,-900.0199999999968,66,41,87965.89,87065.87
13446,U21293,107,-1667.3399999999892,94,13,113582.37,111915.03
13447,U19506,107,31001.47,72,35,187859.80000000005,218861.27000000005
13448,U24316,107,157738.71999999997,77,30,11474719.68,11632458.4
13449,U595668,107,14.470000000000162,73,34,1420.15,1434.6200000000003
13450,U36598,107,-18761.059999999998,95,12,88945.7,70184.64
13451,U9918,107,-3702.3499999999985,90,17,129886.26000000001,126183.91
13452,U27166,107,-26012.800000000017,97,10,96053.71000000002,70040.91
13453,U23967,107,384.1399999999994,60,47,141928.91,142313.05
13454,U30383,107,-19017.83,74,33,330481.33,311463.5
13455,U39139,107,-19968.660000000003,77,30,138190.72000000003,118222.06000000003
13456,U17515,107,-41256.609999999986,86,21,577451.1100000001,536194.5000000001
13457,U43813,107,39721.27,76,31,188799.49,228520.75999999998
13458,U41074,107,149099.54,74,33,386337.71,535437.25
13459,U14367,107,-86164.64999999997,75,32,5170061.869999999,5083897.219999999
13460,U19486,107,12951.260000000002,89,18,46629.030000000006,59580.29000000001
13461,U973275,107,-3961.5299999999997,71,36,25473.050000000003,21511.520000000004
13462,U29843,107,-9480.149999999994,84,23,153475.54000000004,143995.39000000004
13463,U25254,107,4793.549999999999,79,28,64832.86000000001,69626.41
13464,U43555,107,-1262.320000000001,96,11,33582.44,32320.120000000003
13465,U35266,107,13716.109999999986,88,19,235313.43999999997,249029.54999999996
13466,U32820,107,57450.00999999998,71,36,154566.93000000002,212016.94
13467,U25759,107,-413.6700000000033,90,17,25800.100000000002,25386.43
13468,U18385,107,-7326.289999999998,59,48,120167.76,112841.47
13469,U29810,107,-12847.640000000003,93,14,70344.41999999997,57496.77999999997
13470,U40532,107,13390.39,95,12,20214.219999999998,33604.61
13471,U33134,107,-819.2200000000003,99,8,15071.47,14252.25
13472,U19096,107,16602.839999999997,95,12,42996.86000000001,59599.700000000004
13473,U41337,107,11083.020000000002,88,19,89932.01000000004,101015.03000000004
13474,U18833,107,2380.9100000000003,73,34,67539.23999999999,69920.15
13475,U29042,107,-1135.6500000000003,98,9,27221.84,26086.19
13476,U20029,107,1543.519999999999,89,18,27915.909999999996,29459.429999999997
13477,U23089,107,1684.9800000000034,71,36,72827.89999999998,74512.87999999999
13478,U38930,107,-38563.219999999994,90,17,81661.13,43097.91000000001
13479,U37312,107,3137.1900000000046,98,9,11487.199999999997,14624.390000000001
13480,U33859,107,-43364.73999999998,87,20,470356.0200000002,426991.2800000002
13481,U27544,107,1459.4699999999984,79,28,26709.440000000002,28168.91
13482,U28696,107,-1312.1000000000022,59,48,32037.100000000002,30725.0
13483,U19558,107,5439.010000000005,76,31,147763.43999999997,153202.44999999998
13484,U1145998,107,-3362.840000000002,71,36,79913.09000000001,76550.25000000001
13485,U16574,107,-993017.29,60,47,2450343.21,1457325.92
13486,U36654,107,-1014.49,102,5,5694.23,4679.74
13487,U11917,107,-35929.47000000006,93,14,1317184.43,1281254.96
13488,U21530,107,-1706.9199999999983,87,20,98066.17,96359.25
13489,U34690,107,3522.5000000000064,84,23,49815.70999999999,53338.21
13490,U16623,107,-208929.69999999995,70,37,868913.8999999999,659984.2
13491,U8110,106,-5555.490000000004,94,12,231262.74,225707.25
13492,U34740,106,83477.65000000004,93,13,305910.89,389388.54000000004
13493,U43789,106,-8921.430000000004,69,37,18233.740000000005,9312.310000000001
13494,U41631,106,-31353.989999999998,92,14,133891.94,102537.95000000001
13495,U24699,106,-154445.65000000002,93,13,324092.84000000014,169647.19000000012
13496,U32945,106,45275.929999999986,62,44,132983.33999999997,178259.26999999996
13497,U37348,106,-40973.230000000054,70,36,124675.67999999996,83702.44999999991
13498,U29913,106,1729.5700000000038,84,22,99453.91,101183.48000000001
13499,U39850,106,6714.4900000000025,96,10,25226.08,31940.570000000003
13500,U28605,106,6005.130000000012,54,52,454674.68,460679.81
13501,U32426,106,-2326.060000000004,95,11,126199.64,123873.58
13502,U23269,106,-32133.779999999984,93,13,72613.95000000003,40480.17000000004
13503,U935933,106,-1678.6100000000013,88,18,10468.060000000003,8789.450000000003
13504,U27739,106,125317.1100000001,64,42,2149480.9299999992,2274798.039999999
13505,U13388,106,-4374.010000000013,86,20,80357.28,75983.26999999999
13506,U31476,106,2296.7299999999996,99,7,11534.870000000003,13831.600000000002
13507,U38353,106,9022.21,94,12,60586.53,69608.73999999999
13508,U15900,106,-15684.33,101,5,16059.43,375.10000000000036
13509,U29510,106,-20076.749999999993,97,9,35706.06999999999,15629.32
13510,U16898,106,-22376.87999999997,82,24,357745.74,335368.86000000004
13511,U18247,106,142341.57,82,24,117053.62999999999,259395.2
13512,U27852,106,792.8099999999991,82,24,118783.15999999996,119575.96999999996
13513,U31239,106,-10756.060000000034,85,21,564905.6799999999,554149.6199999999
13514,U11251,106,1649.28,91,15,29841.03,31490.309999999998
13515,U17975,106,5692.700000000005,89,17,12126.72,17819.420000000006
13516,U29521,106,1286.1299999999937,83,23,125806.41,127092.54
13517,U11959,106,-25997.540000000026,65,41,327960.39999999997,301962.8599999999
13518,U21599,106,65428.41,78,28,61284.630000000005,126713.04000000001
13519,U15738,106,-1946.7299999999987,93,13,30791.309999999994,28844.579999999994
13520,U31812,106,50596.03999999998,66,40,37135.97000000001,87732.00999999998
13521,U22916,106,14054.909999999996,91,15,202422.76999999996,216477.67999999996
13522,U11783,106,-2749.960000000002,71,35,76737.87000000002,73987.91000000002
13523,U28497,106,-18048.300000000003,95,11,33993.49999999999,15945.19999999999
13524,U15062,106,127401.51000000002,89,17,827397.46,954798.97
13525,U14130,106,33706.729999999974,77,29,1871321.5,1905028.23
13526,U40233,106,-40891.279999999984,53,53,1069151.81,1028260.53
13527,U29648,106,98885.80000000002,65,41,142286.44,241172.24000000002
13528,U20178,106,-1852.3399999999974,72,34,60210.21000000001,58357.87000000001
13529,U23642,106,-10795.67,93,13,61234.82,50439.15
13530,U38493,106,-66401.79,85,21,1263712.2600000002,1197310.4700000002
13531,U34815,106,-374.0900000000004,85,21,16190.840000000002,15816.750000000002
13532,U30170,106,-5194.530000000003,85,21,689798.7500000001,684604.2200000001
13533,U11989,106,7513.84,93,13,48733.600000000006,56247.44
13534,U33551,106,11681.949999999999,52,54,7713.0,19394.949999999997
13535,U32533,106,1735.329999999998,66,40,62200.0,63935.33
13536,U9745,106,-11930.919999999996,82,24,247427.31,235496.39
13537,U903104,106,1.1600000000022557,53,53,34078.98000000001,34080.140000000014
13538,U20202,106,6051.67000000001,93,13,128093.10000000003,134144.77000000005
13539,U31402,106,-11097.019999999984,93,13,70618.38999999998,59521.37
13540,U40303,106,-470.3500000000001,100,6,25472.47,25002.120000000003
13541,U17424,106,14303.11000000003,78,28,575929.7,590232.8099999999
13542,U39768,106,-22748.77000000025,79,27,3697576.93,3674828.16
13543,U39761,106,-21638.929999999935,67,39,2529276.0,2507637.0700000003
13544,U39689,106,3162.5800000000672,67,39,748623.61,751786.1900000001
13545,U27760,106,4722.139999999998,54,52,128143.89,132866.03
13546,U18265,106,-31219.260000000024,95,11,182661.43,151442.16999999998
13547,U36780,106,11149.889999999998,91,15,62067.87000000001,73217.76000000001
13548,U17249,106,-31537.080000000016,80,26,433600.39999999997,402063.31999999995
13549,U10384,106,-7032.190000000007,87,19,192620.72999999998,185588.53999999998
13550,U21901,106,9772.279999999984,77,29,606759.1499999999,616531.4299999999
13551,U36882,106,400.21999999999946,92,14,9091.050000000001,9491.27
13552,U28557,106,38499.72,91,15,122408.80000000002,160908.52000000002
13553,U14949,106,24835.37,96,10,14590.56,39425.93
13554,U15646,106,4586.069999999992,72,34,300149.64,304735.71
13555,U43176,106,-1388737.6999999995,79,27,3618424.78,2229687.08
13556,U34083,106,13576.350000000002,80,26,714076.7500000001,727653.1000000001
13557,U28957,106,27388.77,88,18,156161.59,183550.36
13558,U27511,106,-1460.6900000000023,96,10,36743.44000000001,35282.75000000001
13559,U28126,106,240.879999999991,81,25,87865.45,88106.32999999999
13560,U41716,106,21689.19,100,6,40907.11,62596.3
13561,U33912,106,30136.489999999998,95,11,24900.520000000004,55037.01
13562,U15502,106,-82.74000000000592,84,22,125314.03,125231.29
13563,U1056086,106,-96.57999999999934,101,5,7887.369999999999,7790.79
13564,U37345,106,-4133.629999999997,88,18,260312.09,256178.46
13565,U16710,106,2874.799999999994,91,15,68544.94,71419.73999999999
13566,U10559,106,7498.25,76,30,115479.43999999999,122977.68999999999
13567,U37066,106,191.78999999996967,96,10,174364.3399999999,174556.1299999999
13568,U29818,106,-3986.230000000001,89,17,7178.6800000000085,3192.4500000000075
13569,U21393,106,-88910.30000000002,71,35,398182.75999999995,309272.45999999996
13570,U19858,106,-489.929999999993,73,33,182443.32,181953.39
13571,U900518,106,-4208.89,66,40,62474.76999999999,58265.87999999999
13572,U18146,106,12485.339999999993,75,31,601687.1699999999,614172.5099999999
13573,U28768,106,-34605.66000000001,85,21,116185.47,81579.81
13574,U11290,106,1066.3500000001045,89,17,567984.54,569050.8900000001
13575,U28765,106,-3154.429999999975,78,28,561012.4099999999,557857.98
13576,U32987,106,19658.87999999996,63,43,1127465.5200000005,1147124.4000000004
13577,U19168,106,85672.59999999999,33,73,373826.87,459499.47
13578,U42037,106,7936.830000000002,93,13,38329.520000000004,46266.350000000006
13579,U41624,106,104785.49999999999,67,39,971006.44,1075791.94
13580,U17582,106,632.3499999999942,86,20,70249.35,70881.7
13581,U1378203,106,-1166.37,72,34,22764.38,21598.010000000002
13582,U35925,106,-10311.030000000002,72,34,57841.729999999996,47530.7
13583,U37383,106,19357.72,82,24,17768.05,37125.770000000004
13584,U13498,106,44.200000000005275,60,46,245289.21999999997,245333.41999999998
13585,U34605,106,46703.71000000001,94,12,31874.81999999999,78578.53
13586,U32031,106,501.55999999999403,90,16,147188.19,147689.75
13587,U29215,106,-19994.660000000003,100,6,36285.51000000001,16290.850000000006
13588,U15725,106,70558.77999999998,98,8,49271.99000000001,119830.76999999999
13589,U10395,106,-10353.959999999992,72,34,741888.1900000001,731534.2300000001
13590,U38711,106,41079.410000000025,91,15,645066.43,686145.8400000001
13591,U27814,106,-10089.440000000002,96,10,61120.54,51031.1
13592,U10942,106,21849.399999999998,64,42,287021.66,308871.06
13593,U14604,106,163.54000000000013,95,11,39223.240000000005,39386.780000000006
13594,U1186457,106,-2703.0100000000075,63,43,131830.79,129127.78
13595,U22562,106,12435.37,93,13,133244.38,145679.75
13596,U28441,106,30445.61,89,17,117406.50999999998,147852.12
13597,U35915,106,-15612.42,99,7,18284.84,2672.42
13598,U19244,106,-104430.1,91,15,225350.53999999995,120920.43999999994
13599,U36282,106,-20851.370000000003,85,21,66021.25000000003,45169.88000000003
13600,U38560,106,-111246.60000000003,79,27,274018.6799999998,162772.07999999978
13601,U35191,106,46020.399999999994,85,21,193272.25999999995,239292.65999999995
13602,U15409,106,62288.77999999999,86,20,110844.50000000001,173133.28
13603,U30983,106,-27109.119999999995,101,5,82599.62,55490.5
13604,U34985,106,-2115.300000000014,82,24,149946.23999999996,147830.93999999994
13605,U9829,106,-4227.349999999997,76,30,333644.32000000007,329416.9700000001
13606,U43469,106,1049.5200000000004,96,10,22020.489999999998,23070.01
13607,U18973,106,-10384.739999999998,89,17,232904.13,222519.39
13608,U42971,106,-130047.01000000001,100,6,157728.54999999996,27681.53999999995
13609,U11617,106,-2784.6800000000017,63,43,201466.82,198682.14
13610,U13210,106,-18349.51999999997,64,42,230402.77999999997,212053.26
13611,U41225,106,9006.639999999943,81,25,1108279.19,1117285.8299999998
13612,U17667,106,7076.16,92,14,21189.63,28265.79
13613,U37025,106,5238.060000000001,61,45,150264.14,155502.2
13614,U34781,106,171511.66,73,33,484829.36000000004,656341.02
13615,U40887,106,-8099.399999999987,60,46,267200.8900000001,259101.49000000008
13616,U19435,106,2655.7700000000004,80,26,263040.37999999995,265696.14999999997
13617,U22904,106,-730.0400000000009,92,14,80556.56,79826.51999999999
13618,U40480,106,-7793.859999999997,96,10,26336.530000000006,18542.67000000001
13619,U39888,106,-778.5100000000002,55,51,137536.56999999998,136758.05999999997
13620,U26331,106,83678.65,92,14,37841.55,121520.2
13621,U37974,106,-2543.8999999999996,80,26,66642.9,64098.99999999999
13622,U21427,106,-2460.440000000027,94,12,128424.31000000003,125963.87
13623,U43612,106,-2651.519999999997,100,6,45152.41999999999,42500.899999999994
13624,U15018,105,11032.06,86,19,21537.910000000003,32569.97
13625,U16890,105,-9499.869999999999,91,14,47104.54,37604.67
13626,U15426,105,-26707.030000000097,79,26,796377.84,769670.8099999998
13627,U28627,105,17519.72000000001,72,33,114177.82000000002,131697.54000000004
13628,U12668,105,-18813.78,100,5,33305.42,14491.64
13629,U43526,105,-3230.759999999998,89,16,35876.400000000016,32645.640000000018
13630,U10411,105,9094.329999999973,68,37,974313.76,983408.09
13631,U1183415,105,-955.1700000000003,85,20,18205.379999999997,17250.209999999995
13632,U11611,105,2803.970000000002,85,20,65616.12,68420.09
13633,U9988,105,-21472.84,101,4,27396.52,5923.68
13634,U34052,105,-9324.920000000013,86,19,263413.77,254088.85
13635,U20644,105,743089.43,81,24,5349504.670000001,6092594.100000001
13636,U39815,105,-3474.789999999998,63,42,272153.69,268678.9
13637,U25896,105,-7361.899999999996,78,27,165543.85999999996,158181.95999999996
13638,U10317,105,-53646.410000000054,75,30,1079819.98,1026173.57
13639,U41649,105,-1254.5800000000154,60,45,298022.5200000001,296767.94000000006
13640,U17742,105,3941.270000000004,89,16,183187.15999999997,187128.43
13641,U37252,105,-13546.540000000015,89,16,51733.29000000002,38186.75000000001
13642,U1345606,105,-2389.119999999998,67,38,14794.219999999996,12405.099999999999
13643,U43901,105,9340.980000000001,91,14,32900.25,42241.23
13644,U43962,105,-1851.0200000000004,101,4,7341.580000000002,5490.560000000001
13645,U35919,105,3670.510000000004,83,22,189132.66999999998,192803.18
13646,U12556,105,-18261.090000000007,95,10,145383.34999999998,127122.25999999997
13647,U26416,105,-36661.17999999849,65,40,8772281.22,8735620.040000003
13648,U37805,105,561.8800000000002,101,4,4732.65,5294.53
13649,U11338,105,-1918.180000000004,87,18,172004.13,170085.95
13650,U24993,105,18300.12999999999,81,24,251007.23000000007,269307.36000000004
13651,U30881,105,-53.1399999999993,54,51,33756.69,33703.55
13652,U9809,105,-13914.7,68,37,203730.73,189816.03
13653,U16889,105,-5287.9800000000005,91,14,45036.509999999995,39748.52999999999
13654,U14733,105,-93945.45999999999,88,17,2245509.3900000015,2151563.9300000016
13655,U15978,105,11120.129999999972,76,29,111910.36999999998,123030.49999999996
13656,U16520,105,-9439.779999999999,77,28,347713.88,338274.1
13657,U16121,105,94354.71999999999,95,10,29054.410000000003,123409.12999999999
13658,U15443,105,16216.79000000014,68,37,2041417.8799999997,2057634.6699999997
13659,U30277,105,1047.7400000000016,82,23,74003.87999999999,75051.62
13660,U15204,105,-49647.54999999998,83,22,296571.67,246924.12
13661,U11556,105,38024.71000000001,94,11,175707.49000000002,213732.2
13662,U15657,105,-1164.4499999999998,80,25,18447.42,17282.969999999998
13663,U26337,105,-7320.780000000008,91,14,131327.06,124006.27999999998
13664,U38974,105,38306.88999999992,54,51,430555.92999999993,468862.81999999983
13665,U11758,105,-87324.14,88,17,756259.1000000001,668934.9600000001
13666,U1162867,105,-3162.199999999999,70,35,52765.13,49602.93
13667,U12009,105,-48106.270000000004,89,16,74892.72,26786.449999999997
13668,U9912,105,31263.969999999987,61,44,386586.3400000001,417850.31000000006
13669,U19665,105,-2246.3500000000054,87,18,118296.62,116050.26999999999
13670,U1084223,105,-460.96000000000095,67,38,51226.38999999999,50765.42999999999
13671,U18597,105,5911.380000000002,95,10,51910.87,57822.25000000001
13672,U20916,105,-1232.2199999999966,91,14,107219.91000000002,105987.69000000002
13673,U9547,105,15334.119999999992,81,24,134200.6,149534.72
13674,U28173,105,6033.009999999981,81,24,527555.8099999999,533588.82
13675,U24725,105,-8962.590000000002,86,19,45247.840000000004,36285.25
13676,U12420,105,-50322.87999999996,82,23,426142.92000000004,375820.0400000001
13677,U20928,105,-17575.379999999997,90,15,207275.94000000003,189700.56000000003
13678,U43882,105,8105.940000000007,84,21,38116.97999999999,46222.92
13679,U22445,105,-96425.62999999993,94,11,440824.72999999986,344399.0999999999
13680,U34926,105,-35761.60999999999,79,26,131581.68,95820.07
13681,U15120,105,-23292.479999999654,60,45,7713645.25,7690352.7700000005
13682,U41519,105,-87258.07999999999,93,12,233307.16000000006,146049.08000000007
13683,U33577,105,-12028.619999999988,60,45,404353.32999999996,392324.70999999996
13684,U34629,105,17595.57,63,42,447615.8400000001,465211.4100000001
13685,U22147,105,303940.2900000001,64,41,3666127.8799999994,3970068.1699999995
13686,U27056,105,42853.58,95,10,57313.18999999997,100166.76999999997
13687,U43917,105,-3895.0200000000023,75,30,23538.260000000013,19643.240000000013
13688,U28505,105,1653.209999999999,89,16,16761.849999999995,18415.059999999994
13689,U26327,105,7450.809999999996,93,12,52661.14,60111.95
13690,U8895,105,-67432.55000000002,82,23,159911.97,92479.41999999998
13691,U16874,105,3240.910000000363,67,38,5188737.68,5191978.59
13692,U22633,105,-8466.669999999991,77,28,526234.1599999999,517767.48999999993
13693,U13851,105,230.33999999973457,80,25,945388.4299999998,945618.7699999996
13694,U25456,105,-4057.0699999999924,85,20,86957.23000000001,82900.16000000002
13695,U17075,105,-592573.11,89,16,4010791.1500000004,3418218.0400000005
13696,U16518,105,30706.06000000002,48,57,327458.18,358164.24
13697,U11247,105,-4212.130000000005,94,11,374245.79,370033.66
13698,U21718,105,109504.88000000005,70,35,106365.16999999997,215870.05000000002
13699,U23383,105,9329.789999999852,58,47,4387883.689999999,4397213.479999999
13700,U12166,105,1919.7100000000019,89,16,72558.97,74478.68000000001
13701,U32681,105,-2320.6700000000005,94,11,15650.05,13329.38
13702,U36101,105,-88658.04,92,13,167390.47,78732.43000000001
13703,U42743,105,-5597.98,55,50,37779.06,32181.079999999998
13704,U15758,105,-10469.559999999996,88,17,51929.47,41459.91
13705,U20055,105,17053.46,67,38,95439.62,112493.07999999999
13706,U21563,105,-6658.589999999999,76,29,39493.78,32835.19
13707,U12515,105,2075.2500000000064,76,29,210924.28000000003,212999.53000000003
13708,U32501,105,4765.509999999984,62,43,318937.45,323702.96
13709,U37192,105,-10492.619999999999,87,18,26065.360000000022,15572.740000000023
13710,U41363,105,-471.4699999999953,63,42,33839.29,33367.82000000001
13711,U9337,105,-174499.80000000002,86,19,599491.4800000001,424991.68000000005
13712,U42706,105,71727.57999999999,84,21,640276.23,712003.8099999999
13713,U26066,105,-3180.0500000000025,71,34,87339.29,84159.23999999999
13714,U19179,105,-13961.580000000004,89,16,80720.03,66758.45
13715,U41194,105,-5432.51,91,14,50501.360000000015,45068.85000000001
13716,U26785,105,-9312.150000000018,61,44,517071.47,507759.31999999995
13717,U897759,105,6.550000000001091,54,51,64273.11,64279.66
13718,U14708,105,42667.590000000004,88,17,47437.97,90105.56
13719,U20862,105,-85384.39000000001,89,16,683381.02,597996.63
13720,U42001,105,-782.6300000000001,79,26,33376.2,32593.569999999996
13721,U23705,105,-1442.5300000000063,79,26,88995.87000000001,87553.34
13722,U18343,105,2941.999999999999,90,15,55770.00000000001,58712.00000000001
13723,U18462,105,-2144.37,99,6,31751.65,29607.280000000002
13724,U1137107,105,538.65,56,49,17649.56,18188.210000000003
13725,U41573,105,-4730.309999999998,91,14,40145.84,35415.53
13726,U39511,105,-13911.730000000003,77,28,32550.72,18638.989999999998
13727,U25142,105,10404.380000000005,88,17,109036.87999999996,119441.25999999997
13728,U36866,105,-126.01999999999316,92,13,105820.54000000001,105694.52000000002
13729,U19453,105,-39784.750000000044,81,24,1192895.37,1153110.62
13730,U26024,105,15766.560000000003,92,13,108316.25999999995,124082.81999999995
13731,U16114,105,5488.309999999998,99,6,136514.8,142003.11
13732,U34773,105,-22500.66,69,36,118227.03000000001,95726.37000000001
13733,U37169,105,-33.35999999999558,88,17,166436.94999999998,166403.59
13734,U25305,105,-4085.59,86,19,29186.02,25100.43
13735,U27642,105,3463.470000000001,80,25,712057.3200000001,715520.79
13736,U36890,105,21031.329999999998,96,9,58659.78,79691.11
13737,U37961,105,9229.360000000004,92,13,13919.019999999995,23148.379999999997
13738,U25834,105,1251.609999999983,93,12,203349.23999999996,204600.84999999995
13739,U34441,105,-18085.489999999998,99,6,28209.200000000004,10123.710000000006
13740,U38012,105,-66818.73999999999,77,28,508335.36,441516.62
13741,U18589,105,-16673.93,65,40,430870.68,414196.75
13742,U22160,105,7764.18,71,34,146174.58000000002,153938.76
13743,U39516,105,1250.9100000000033,82,23,165536.65,166787.56
13744,U17208,105,197563.38000000012,55,50,959777.3300000001,1157340.7100000002
13745,U30231,105,-70.06999999999951,89,16,8860.22,8790.15
13746,U27591,105,6751.710000000001,94,11,24950.97,31702.68
13747,U22740,104,-8476.4,74,30,159608.61000000002,151132.21000000002
13748,U18304,104,-58.890000000003056,72,32,164233.82,164174.93
13749,U9311,104,95700.15,102,2,54387.740000000005,150087.89
13750,U24479,104,-66.74999999994361,47,57,1396143.7300000002,1396076.9800000002
13751,U31740,104,306063.92,90,14,322672.07999999996,628736.0
13752,U28875,104,-47060.09,64,40,345282.1700000001,298222.0800000001
13753,U37646,104,3367.9899999999984,80,24,17496.420000000002,20864.41
13754,U11695,104,75205.03999999998,58,46,1247743.8399999999,1322948.88
13755,U9244,104,-151741.78000000003,67,37,484606.4399999998,332864.6599999998
13756,U42775,104,-3064.970000000001,84,20,90296.91000000002,87231.94000000002
13757,U22820,104,-3357.300000000008,85,19,48496.09000000004,45138.79000000003
13758,U814669,104,-41.499999999999545,96,8,5429.900000000001,5388.4000000000015
13759,U20252,104,13986.780000000004,90,14,14691.66,28678.440000000002
13760,U32394,104,8885.589999999997,91,13,115768.34999999998,124653.93999999997
13761,U20689,104,-257794.44000000012,46,58,1063328.26,805533.8199999998
13762,U28106,104,9564.089999999993,89,15,149926.20999999993,159490.29999999993
13763,U21147,104,-29865.330000000045,67,37,1079486.4000000001,1049621.07
13764,U43926,104,8137.200000000008,87,17,158010.48,166147.68000000002
13765,U31038,104,-242.72999999997955,78,26,171775.02000000002,171532.29000000004
13766,U23302,104,-12354.989999999976,65,39,166969.01,154614.02000000002
13767,U28717,104,1229.4999999999989,82,22,30936.620000000006,32166.120000000006
13768,U18240,104,-11122.749999999998,97,7,34232.310000000005,23109.560000000005
13769,U12246,104,-25231.890000000003,61,43,65887.87,40655.979999999996
13770,U32760,104,-2867.3499999999995,63,41,147748.48,144881.13
13771,U33435,104,50690.810000000005,90,14,70188.03000000001,120878.84000000003
13772,U32793,104,-100994.31000000004,58,46,981937.7,880943.3899999999
13773,U10032,104,-1357.9400000000148,84,20,213792.55000000037,212434.61000000036
13774,U13337,104,-1304.1700000000028,99,5,19114.630000000005,17810.460000000003
13775,U42782,104,21740.329999999976,62,42,331062.41000000003,352802.74
13776,U23950,104,3480.400000000031,49,55,1520744.11,1524224.5100000002
13777,U34915,104,-1180.7399999999996,84,20,28136.459999999992,26955.719999999994
13778,U14455,104,13313.679999999998,91,13,43265.649999999994,56579.329999999994
13779,U13525,104,-6360.359999999999,77,27,283653.3900000001,277293.0300000001
13780,U36339,104,-330962.22,98,6,341763.4,10801.180000000051
13781,U10580,104,152039.17999999996,78,26,394389.03,546428.21
13782,U29874,104,717.8799999999995,95,9,14083.109999999999,14800.989999999998
13783,U25572,104,778390.96,79,25,256073.18999999997,1034464.1499999999
13784,U19137,104,-4088.449999999998,93,11,49154.52000000002,45066.07000000002
13785,U34653,104,-137.07999999999993,94,10,13793.099999999999,13656.019999999999
13786,U1124811,104,119.02999999999997,79,25,17541.55,17660.579999999998
13787,U28096,104,3593.450000000006,87,17,274289.25999999995,277882.70999999996
13788,U40781,104,-11315.18999999998,41,63,557329.7999999999,546014.61
13789,U824360,104,102.33000000000004,64,40,783.2899999999995,885.6199999999995
13790,U20981,104,132.88000000000193,93,11,12091.289999999999,12224.170000000002
13791,U15052,104,-116869.55000000013,62,42,1630566.3100000003,1513696.7600000002
13792,U15775,104,10867.980000000001,89,15,39112.44,49980.420000000006
13793,U20899,104,66502.70000000007,63,41,881330.32,947833.02
13794,U37275,104,-37111.32999999999,73,31,348835.0799999999,311723.7499999999
13795,U27807,104,-2281.960000000001,91,13,117910.08000000003,115628.12000000002
13796,U28843,104,41292.68000000001,80,24,60302.88,101595.56
13797,U22420,104,4753.040000000002,102,2,2655.98,7409.020000000002
13798,U16904,104,2231.480000000024,59,45,324925.29000000004,327156.7700000001
13799,U43209,104,20220.07,78,26,21417.27000000001,41637.34000000001
13800,U23441,104,-7577.2199999999975,89,15,175610.91000000003,168033.69000000003
13801,U39252,104,-12946.400000000222,75,29,6627985.8,6615039.399999999
13802,U14353,104,-5303.210000000001,69,35,119619.11999999997,114315.90999999996
13803,U9828,104,-2134467.99,59,45,3797399.91,1662931.92
13804,U31877,104,-12378.560000000005,86,18,57675.25000000001,45296.69
13805,U30257,104,1348.3400000000013,90,14,17151.75,18500.09
13806,U38045,104,5089.540000000003,90,14,26482.340000000004,31571.880000000005
13807,U42107,104,-11586.260000000002,88,16,118244.06999999998,106657.80999999997
13808,U36682,104,-20255.680000000004,93,11,23841.140000000003,3585.459999999999
13809,U8604,104,12194.52,77,27,41114.89,53309.41
13810,U40309,104,-406.63999999999936,98,6,4931.780000000002,4525.140000000002
13811,U41145,104,55256.47,88,16,55981.880000000005,111238.35
13812,U14332,104,-68075.34000000003,78,26,812606.1100000002,744530.7700000003
13813,U28105,104,-12962.210000000006,76,28,465085.3,452123.08999999997
13814,U40427,104,-136924.41,89,15,462283.58999999997,325359.17999999993
13815,U13596,104,19759.520000000004,82,22,54022.92,73782.44
13816,U33457,104,11417.96,77,27,246907.91,258325.87
13817,U15669,104,444.30999999995925,74,30,813934.3500000001,814378.66
13818,U14891,104,-1943433.1799999997,87,17,2122306.17,178872.99000000022
13819,U30761,104,4046.75,99,5,2529.6300000000006,6576.380000000001
13820,U14134,104,51806.06999999997,95,9,5997.54,57803.60999999997
13821,U1276203,104,-3160.560000000002,61,43,63134.57999999999,59974.01999999998
13822,U43528,104,224.06000000000597,69,35,156583.72,156807.78
13823,U8721,104,-25785.079999999914,91,13,567976.35,542191.27
13824,U10568,104,-50322.33,78,26,181703.25999999995,131380.92999999993
13825,U8603,104,-13603.840000000004,76,28,123891.26,110287.41999999998
13826,U37857,104,-39888.08000000001,78,26,489479.64,449591.56
13827,U19370,104,35365.259999999966,86,18,191051.31,226416.56999999995
13828,U29697,104,-1059.8099999999977,72,32,544984.5800000001,543924.77
13829,U37880,104,3748.529999999999,78,26,53298.75000000001,57047.280000000006
13830,U15681,104,-124386.08000000002,57,47,394160.77,269774.69
13831,U14022,104,-39717.98,83,21,212823.93,173105.94999999998
13832,U36407,104,-121468.79,74,30,226873.06,105404.27
13833,U12719,104,31603.209999999992,89,15,17179.43999999999,48782.64999999998
13834,U30552,104,1171.3500000000004,91,13,47952.01,49123.36
13835,U31821,104,-2516.300000000001,90,14,70871.49,68355.19
13836,U39584,104,6061.250000000005,93,11,57069.420000000006,63130.67000000001
13837,U27191,104,-15449.670000000002,101,3,23272.09,7822.419999999998
13838,U18340,104,-13329.130000000005,88,16,307392.07000000007,294062.94000000006
13839,U13557,104,-16831.68000000002,74,30,378181.29,361349.61
13840,U26433,104,-5658.779999999999,100,4,22691.519999999997,17032.739999999998
13841,U12801,104,-1719.9400000000005,99,5,13728.009999999993,12008.069999999992
13842,U11485,104,-10372.679999999998,89,15,123346.30000000003,112973.62000000004
13843,U14656,104,-146308.66000000003,90,14,770928.3600000001,624619.7000000001
13844,U26225,104,67791.77,88,16,175222.04,243013.81
13845,U36038,104,12224.279999999955,77,27,901692.8000000004,913917.0800000003
13846,U16772,104,-53560.57000000001,82,22,516970.18000000005,463409.61000000004
13847,U22721,104,47265.46999999998,79,25,91424.44,138689.90999999997
13848,U14373,104,-2431.4400000000073,84,20,59166.93,56735.48999999999
13849,U39519,104,13799.580000000005,91,13,58768.420000000006,72568.00000000001
13850,U41924,104,8880.119999999995,81,23,87708.97000000002,96589.09000000001
13851,U15654,104,-1481.8500000000013,70,34,53286.97999999999,51805.12999999999
13852,U27907,104,-28349.019999999986,65,39,298660.94,270311.92000000004
13853,U22612,104,13329.170000000018,66,38,166280.81,179609.98
13854,U42261,104,36871.91999999999,72,32,135620.45,172492.37
13855,U42686,104,12676.62,86,18,172701.22,185377.84
13856,U34059,104,-7400.390000000001,78,26,34390.020000000004,26989.630000000005
13857,U20238,104,-4002.5200000000027,94,10,42594.53,38592.009999999995
13858,U25677,104,-2734.2199999999834,63,41,186369.15000000002,183634.93000000005
13859,U20529,104,5971.96000000001,86,18,72350.17,78322.13
13860,U39986,104,86385.66999999998,92,12,90709.04000000004,177094.71000000002
13861,U10066,104,-401628.1400000001,89,15,841121.65,439493.50999999995
13862,U15985,103,21315.65,82,21,90431.24,111746.89000000001
13863,U13005,103,-371414.1500000002,77,26,1409809.75,1038395.5999999999
13864,U31532,103,-22429.390000000014,63,40,325342.3600000001,302912.9700000001
13865,U39688,103,-4253.630000000003,84,19,37979.64,33726.009999999995
13866,U32378,103,4213.660000000004,88,15,56639.31999999999,60852.979999999996
13867,U15677,103,-95075.45999999998,86,17,253058.43,157982.97000000003
13868,U21076,103,-17879.709999999977,61,42,476445.71,458566.00000000006
13869,U37301,103,-47003.28,89,14,50372.03,3368.75
13870,U12705,103,21394.460000000014,72,31,707686.4200000002,729080.8800000001
13871,U25185,103,-789.6400000000011,86,17,14226.429999999998,13436.789999999997
13872,U42019,103,3835.340000000003,83,20,68015.76999999999,71851.10999999999
13873,U25707,103,2428.9900000000007,97,6,4769.75,7198.740000000001
13874,U28501,103,-11194.839999999995,98,5,25653.230000000007,14458.390000000012
13875,U25051,103,11767.579999999973,56,47,1153220.84,1164988.4200000002
13876,U24385,103,14359.739999999998,61,42,115829.09999999998,130188.83999999997
13877,U14823,103,-3540.0900000000115,92,11,267195.98,263655.88999999996
13878,U12972,103,4410.3200000000015,51,52,172021.79000000004,176432.11000000004
13879,U38950,103,-51653.54000000005,72,31,805281.2500000003,753627.7100000003
13880,U24577,103,-1.7099999999991269,50,53,148625.84,148624.13
13881,U629716,103,-7753.159999999999,70,33,18987.030000000006,11233.870000000006
13882,U41837,103,55893.369999999326,67,36,29211941.649999995,29267835.019999996
13883,U10246,103,1317.7000000000007,86,17,48502.63,49820.33
13884,U31130,103,2735.0299999999966,87,16,37891.09,40626.119999999995
13885,U19845,103,-4077.2900000000022,80,23,123900.49999999999,119823.20999999998
13886,U17323,103,-40113.94000000002,70,33,217943.29,177829.34999999998
13887,U29191,103,-18322.59000000001,78,25,175631.12,157308.52999999997
13888,U43197,103,-7720.069999999999,77,26,143118.4,135398.33
13889,U8609,103,2846.750000000002,96,7,23180.74000000001,26027.490000000013
13890,U37313,103,-178308.60000000003,91,12,244877.88000000003,66569.28
13891,U10054,103,-12533.090000000004,92,11,84416.95000000001,71883.86000000002
13892,U40929,103,-168311.76000000024,57,46,4869196.400000001,4700884.640000001
13893,U26900,103,-123.03000000000065,53,50,89728.26,89605.23
13894,U31698,103,6582.109999999986,86,17,239691.94999999998,246274.05999999997
13895,U17255,103,-95568.40000000021,83,20,3720547.1399999997,3624978.7399999993
13896,U41061,103,-110621.46999999999,91,12,325047.8599999999,214426.38999999996
13897,U42350,103,3629.480000000001,87,16,27908.760000000002,31538.24
13898,U41486,103,2346781.47,91,12,165171.08,2511952.5500000003
13899,U945281,103,-5.230000000000132,79,24,4793.74,4788.509999999999
13900,U31975,103,201.51000000000292,84,19,232170.52000000002,232372.03000000003
13901,U11231,103,11824.110000000032,87,16,59703.5,71527.61000000003
13902,U40344,103,23511.44000000003,59,44,974812.8800000001,998324.3200000002
13903,U16306,103,-5471.510000000023,74,29,287575.75,282104.24
13904,U41318,103,34211.01,96,7,109641.48000000004,143852.49000000005
13905,U18743,103,-35847.25,84,19,200779.20999999993,164931.95999999993
13906,U36828,103,10912.300000000001,78,25,66552.03,77464.33
13907,U29529,103,-37473.87000000001,88,15,287911.43,250437.56
13908,U603647,103,-6469.1500000000015,76,27,128457.63000000002,121988.48000000001
13909,U30227,103,-1000.2300000000009,95,8,34187.85999999995,33187.62999999995
13910,U28942,103,-4307.150000000003,75,28,156130.99999999997,151823.84999999998
13911,U27161,103,-555.5900000000156,59,44,469279.4300000001,468723.8400000001
13912,U28339,103,2168.7500000000023,83,20,50521.91999999999,52690.66999999999
13913,U13763,103,-123880.18000000001,87,16,301044.14,177163.96000000002
13914,U12733,103,755940.68,59,44,870968.6499999999,1626909.33
13915,U24142,103,-181207.85999999993,72,31,2218455.6900000004,2037247.8300000005
13916,U36076,103,-682.04,89,14,37739.32,37057.28
13917,U35370,103,75897.91999999998,77,26,59554.08,135452.0
13918,U35206,103,25406.930000000066,70,33,296220.6700000002,321627.60000000027
13919,U26705,103,-110638.73999999998,80,23,668184.72,557545.98
13920,U38812,103,0.0,56,47,173511.4,173511.4
13921,U17910,103,215602.02,41,62,390472.29,606074.3099999999
13922,U10650,103,45.97000000000048,84,19,20821.52,20867.49
13923,U16762,103,-4731.590000000004,87,16,75875.25,71143.66
13924,U11741,103,16615.320000000007,86,17,95076.5,111691.82
13925,U8897,103,-4304.0199999999995,93,10,79957.17000000003,75653.15000000002
13926,U26609,103,2515.7299999999987,86,17,11730.440000000002,14246.170000000002
13927,U26122,103,-828.7400000000071,83,20,309995.32999999996,309166.58999999997
13928,U38284,103,-2910.2200000000003,94,9,14919.419999999998,12009.199999999997
13929,U21578,103,203586.06000000006,69,34,515171.3699999999,718757.4299999999
13930,U16856,103,20089.66,90,13,40973.579999999994,61063.23999999999
13931,U27101,103,16801.479999999992,75,28,268060.61,284862.08999999997
13932,U26366,103,-4468.760000000001,94,9,40492.82000000001,36024.060000000005
13933,U21647,103,-30355.98,80,23,66626.43,36270.45
13934,U13985,103,45190.64000000003,71,32,718247.1700000002,763437.8100000002
13935,U32647,103,616.6699999999992,91,12,33555.630000000005,34172.3
13936,U34559,103,163900.4,83,20,392199.69,556100.09
13937,U9355,103,-934596.6900000001,90,13,1769707.9000000006,835111.2100000005
13938,U42243,103,-2451.8600000000097,94,9,114480.97999999998,112029.11999999997
13939,U29687,103,-3065.379999999999,84,19,194946.17999999996,191880.79999999996
13940,U21494,103,-72455.17000000156,67,36,21753760.73,21681305.56
13941,U17271,103,175052.25000000006,75,28,285880.3400000002,460932.59000000026
13942,U30066,103,897.5199999999995,87,16,24628.659999999996,25526.179999999997
13943,U11489,103,-198370.11999999997,75,28,549377.5900000001,351007.4700000001
13944,U21531,103,-21991.99,94,9,143149.37,121157.37999999999
13945,U31961,103,-64184.25000000001,91,12,100994.08000000002,36809.83000000001
13946,U19624,103,27276.5,90,13,48060.12,75336.62
13947,U39834,103,990549.5800000001,83,20,4196520.710000001,5187070.290000001
13948,U43354,103,-413.3600000000006,70,33,240431.79000000004,240018.43000000005
13949,U19438,103,80497.73999999996,47,56,2110248.99,2190746.73
13950,U17203,103,-210934.2399999999,81,22,866252.63,655318.3900000001
13951,U17006,103,-119011.26000000008,74,29,605106.1900000001,486094.93
13952,U41565,103,8964.960000000006,88,15,54119.47000000001,63084.430000000015
13953,U35783,103,67752.28,79,24,162721.02000000002,230473.30000000002
13954,U38272,103,195.31999999999925,91,12,19977.009999999995,20172.329999999994
13955,U17376,103,-28348.200000000015,98,5,113660.16,85311.95999999999
13956,U8191,103,24715.089999999997,67,36,290586.09,315301.18000000005
13957,U34354,103,-2117.4300000000076,78,25,270339.81,268222.38
13958,U10205,103,89273.65000000001,86,17,29439.38,118713.03000000001
13959,U39628,103,-6401.64,96,7,17763.260000000002,11361.620000000003
13960,U32392,103,-8353.670000000042,46,57,1824623.9900000002,1816270.3200000003
13961,U43236,103,-623.6199999999909,86,17,135570.23000000004,134946.61000000004
13962,U25338,103,-327.5399999999995,94,9,21430.11,21102.57
13963,U39509,103,-46964.62999999991,61,42,1405045.9000000001,1358081.2700000003
13964,U23501,103,69.83999999999833,93,10,29863.340000000004,29933.18
13965,U10939,103,-1763.1599999999905,58,45,390090.71,388327.55000000005
13966,U25196,103,-132243.46,70,33,478622.32999999996,346378.87
13967,U968089,103,271.6899999999978,66,37,76356.82999999999,76628.51999999999
13968,U38589,103,-2144.810000000009,70,33,496657.65,494512.84
13969,U23840,103,3961.599999999997,85,18,20762.43999999999,24724.03999999999
13970,U32380,103,7571.889999999999,91,12,26323.300000000003,33895.19
13971,U9559,103,184523.40999999997,96,7,31603.22,216126.62999999998
13972,U18615,103,-4458.51,94,9,35188.49,30729.979999999996
13973,U41758,103,6609.07,90,13,29219.19,35828.259999999995
13974,U28449,103,-107011.65999999989,56,47,4680096.42,4573084.76
13975,U40340,103,60349.12000000001,74,29,583753.4400000001,644102.56
13976,U27073,103,-29616.109999999986,64,39,2539691.1599999997,2510075.05
13977,U11861,103,38.250000000000455,86,17,23907.060000000005,23945.310000000005
13978,U41595,103,1046.6099999999974,73,30,316031.67000000004,317078.28
13979,U28072,103,-579.1599999999999,51,52,124157.17,123578.01
13980,U11509,103,-4622.159999999974,69,34,321828.77999999997,317206.62
13981,U25886,103,130263.18000000001,77,26,290870.1500000001,421133.3300000001
13982,U9161,103,36677.82999999998,81,22,461228.56,497906.38999999996
13983,U43778,103,-887623.0299999997,88,15,996293.1499999997,108670.12
13984,U41731,103,17259.429999999964,70,33,369226.99000000005,386486.42000000004
13985,U974946,103,-5252.660000000001,63,40,42671.210000000014,37418.55000000001
13986,U8973,103,-3750.5399999999936,76,27,77433.42999999998,73682.88999999998
13987,U31644,103,-8708.93,60,43,146409.93,137701.0
13988,U42726,103,5148.920000000005,82,21,178964.47999999998,184113.4
13989,U1085983,103,999.7900000000002,53,50,2859.0799999999995,3858.87
13990,U14942,103,7233.419999999998,63,40,128335.87999999998,135569.3
13991,U40951,103,232.54999999996653,50,53,1902639.89,1902872.44
13992,U33458,103,69.92999999999012,62,41,192931.67,193001.6
13993,U28301,103,29277.309999999998,88,15,589207.0700000003,618484.3800000004
13994,U37454,103,23623.739999999998,85,18,23286.19,46909.92999999999
13995,U12654,103,-80265.93000000002,43,60,1131005.62,1050739.6900000002
13996,U23737,103,-10965.459999999995,84,19,113043.43,102077.97
13997,U41829,103,-795.8399999999995,94,9,14656.209999999997,13860.369999999997
13998,U29045,103,-23550.81,54,49,191989.32,168438.51
13999,U10548,103,-110199.38999999994,99,4,111876.12999999995,1676.7400000000052
14000,U30963,102,-2399.059999999985,39,63,637164.07,634765.01
14001,U10409,102,10832.000000000002,91,11,216178.06000000003,227010.06000000003
14002,U26155,102,22663.30999999999,81,21,120617.62999999995,143280.93999999994
14003,U17432,102,-1966.9500000000007,74,28,488761.35000000003,486794.4
14004,U12469,102,-7581.020000000004,82,20,96383.21999999997,88802.19999999997
14005,U38422,102,-6110.9999999999945,90,12,76307.77000000003,70196.77000000003
14006,U43624,102,-83358.06999999999,60,42,1492790.27,1409432.2
14007,U21942,102,-218551.40000000002,61,41,1220079.78,1001528.38
14008,U39340,102,-54230.19000000003,81,21,318261.2,264031.01
14009,U43408,102,1371.7399999999745,82,20,558735.2900000002,560107.0300000001
14010,U1118758,102,-871.1199999999973,59,43,99293.14,98422.02
14011,U15122,102,-11693.280000000337,93,9,2203523.82,2191830.5399999996
14012,U12188,102,6131.41,87,15,54562.67,60694.08
14013,U12063,102,-45740.46,76,26,233241.39000000004,187500.93000000005
14014,U21021,102,827.4100000000035,79,23,265012.35,265839.76
14015,U16669,102,-81937.41999999995,78,24,376956.4700000001,295019.05000000016
14016,U22876,102,1421.0299999999997,81,21,54664.67,56085.7
14017,U26227,102,1895.2200000000114,81,21,235478.48999999996,237373.70999999996
14018,U26075,102,29942.899999999998,81,21,216564.61000000002,246507.51
14019,U9896,102,1710.2600000000052,85,17,106443.73000000003,108153.99000000003
14020,U17120,102,199616.71000000005,81,21,861610.7599999997,1061227.4699999997
14021,U28238,102,-41935.10000000015,55,47,3980083.1300000004,3938148.0300000003
14022,U17648,102,394172.05999999994,65,37,252621.03999999998,646793.0999999999
14023,U28051,102,-27862.929999999982,65,37,188443.63,160580.7
14024,U24386,102,1916.8499999999985,81,21,42097.81,44014.659999999996
14025,U37622,102,11436.590000000002,70,32,51178.579999999994,62615.17
14026,U16091,102,-25429.99000000006,69,33,770786.38,745356.3899999999
14027,U36139,102,3220.9900000000016,54,48,338279.72000000003,341500.71
14028,U11379,102,-101.63000000004828,53,49,486613.27999999997,486511.6499999999
14029,U13085,102,-23196.679999999997,80,22,45393.92999999999,22197.249999999996
14030,U30869,102,-749.8600000000038,81,21,1060406.2200000002,1059656.36
14031,U31477,102,-0.6900000000314321,68,34,1178260.18,1178259.49
14032,U22844,102,-70883.1,65,37,634973.56,564090.4600000001
14033,U15379,102,-286.44999999999345,55,47,116514.87,116228.42
14034,U43182,102,74882.33000000003,71,31,292906.24000000005,367788.57000000007
14035,U40264,102,31223.820000000003,90,12,232332.93000000002,263556.75
14036,U8890,102,29916.73000000003,60,42,111132.19,141048.92000000004
14037,U28176,102,32007.799999999996,65,37,422426.6699999999,454434.4699999999
14038,U42535,102,-3126.2899999999245,76,26,3814444.1200000006,3811317.8300000005
14039,U17228,102,8920.639999999996,75,27,253561.47999999998,262482.12
14040,U40229,102,-21615.519999999942,48,54,1338011.4800000002,1316395.9600000002
14041,U13852,102,-1458.6800000000005,90,12,9559.12,8100.4400000000005
14042,U12162,102,-9741.720000000003,91,11,183452.9,173711.18
14043,U26508,102,-8718.300000000003,91,11,54692.84000000001,45974.54000000001
14044,U40143,102,-290.0,55,47,99846.60999999999,99556.60999999999
14045,U25632,102,6990.040000000011,89,13,272020.26,279010.30000000005
14046,U32610,102,-78613.32,59,43,715390.64,636777.3200000001
14047,U12124,102,-17307.429999999993,66,36,726384.44,709077.01
14048,U31092,102,4412.59,82,20,46457.590000000004,50870.18000000001
14049,U27185,102,-5085.230000000002,89,13,160917.71,155832.47999999998
14050,U34319,102,-2532.9900000000034,78,24,100444.88999999998,97911.89999999998
14051,U9299,102,8629.020000000037,56,46,2068183.29,2076812.31
14052,U19906,102,31707.949999999983,90,12,28687.520000000004,60395.46999999999
14053,U11638,102,-4250.239999999994,66,36,233805.6,229555.36000000002
14054,U11642,102,0.790000000029977,50,52,248569.97000000003,248570.76000000007
14055,U11956,102,-112525.15999999999,96,6,125869.27999999998,13344.119999999995
14056,U29460,102,-24589.610000000004,61,41,492801.3,468211.69
14057,U12161,102,-78345.53000000001,83,19,350322.92,271977.38999999996
14058,U26667,102,6419.770000000007,85,17,45928.759999999995,52348.53
14059,U42030,102,826.73,91,11,4524.49,5351.219999999999
14060,U43843,102,1922.2600000000016,43,59,371467.64,373389.9
14061,U11952,102,8539.669999999998,59,43,536701.3200000001,545240.9900000001
14062,U27038,102,2228.029999999999,89,13,23018.27,25246.3
14063,U22775,102,-2806.3700000000044,69,33,100726.03000000001,97919.66
14064,U24884,102,1918.4300000000007,92,10,7635.109999999998,9553.539999999999
14065,U13954,102,-15063.839999999997,89,13,116030.27,100966.43000000001
14066,U9235,102,-302875.07999999996,82,20,816200.8200000001,513325.7400000001
14067,U11896,102,3269.1899999998896,51,51,1874537.2899999998,1877806.4799999997
14068,U19062,102,555.7200000000091,76,26,466924.6299999998,467480.3499999998
14069,U17299,102,91181.70000000001,71,31,1040295.79,1131477.49
14070,U11770,102,14231.08,91,11,23666.6,37897.68
14071,U36213,102,37399.36999999999,69,33,222661.6700000001,260061.0400000001
14072,U14701,102,7904.079999999996,63,39,155892.09000000008,163796.17000000007
14073,U40395,102,-682.3099999999977,64,38,81355.05,80672.74
14074,U29486,102,2792.560000000002,61,41,70662.89,73455.45
14075,U23727,102,-2096.58,89,13,36696.59,34600.009999999995
14076,U33680,102,2431.2899999999927,84,18,34445.340000000004,36876.63
14077,U15435,102,47678.00000000008,49,53,925680.85,973358.8500000001
14078,U11943,102,-1333.4900000000005,86,16,15950.15,14616.66
14079,U41217,102,3100.8199999999993,92,10,14316.39,17417.21
14080,U20256,102,-1728.0900000000038,75,27,83043.08,81314.98999999999
14081,U11713,102,-4364.970000000015,72,30,217069.15,212704.18
14082,U36694,102,-81285.56,78,24,125741.79000000002,44456.230000000025
14083,U12114,102,-117066.10999999996,94,8,326473.94999999995,209407.84
14084,U29471,102,-98110.68,74,28,878699.8999999999,780589.22
14085,U43399,102,-2791.0699999999993,88,14,20842.989999999998,18051.92
14086,U19368,102,93217.12000000001,85,17,474799.08,568016.2000000001
14087,U33183,102,99293.09999999999,71,31,184757.83999999994,284050.93999999994
14088,U19543,102,-216324.35999999984,69,33,445745.15000000026,229420.79000000042
14089,U26663,102,-3112.1199999999994,92,10,51856.69999999999,48744.57999999999
14090,U31100,102,26623.429999999993,80,22,72570.34,99193.76999999999
14091,U15680,102,7200.060000000009,73,29,141350.48999999996,148550.54999999996
14092,U19591,102,10444.31,78,24,54456.41,64900.72
14093,U18551,102,2565.5800000000004,98,4,14678.42,17244.0
14094,U978306,102,-1181.2600000000002,60,42,18218.649999999998,17037.39
14095,U34265,102,18030.550000000007,85,17,26802.87,44833.420000000006
14096,U42023,102,4091.4400000000023,86,16,206940.63999999998,211032.08
14097,U19269,102,-1330.1899999999846,67,35,204051.46999999997,202721.28
14098,U19408,102,-9970.919999999998,79,23,72469.85,62498.93000000001
14099,U23196,102,282373.33999999997,90,12,203675.24000000002,486048.57999999996
14100,U28854,102,-40973.21000000001,97,5,69801.58,28828.369999999995
14101,U19286,102,-249609.97999999998,59,43,435575.76000000007,185965.7800000001
14102,U8231,102,31959.310000000027,41,61,371930.94,403890.25
14103,U36749,102,-55627.77000000003,83,19,508299.55000000005,452671.78
14104,U28171,102,1178.9599999999991,95,7,11267.4,12446.359999999999
14105,U22919,102,476.3299999999963,70,32,142990.96999999997,143467.29999999996
14106,U31754,102,-63588.049999999996,92,10,144075.75000000003,80487.70000000004
14107,U28973,102,-5776.509999999998,91,11,26949.54,21173.030000000002
14108,U35600,102,3715.739999999996,81,21,256320.96000000005,260036.70000000004
14109,U26166,102,230927.9500000002,54,48,12303997.64,12534925.59
14110,U24136,102,2821.7500000000027,83,19,36003.70000000001,38825.45000000001
14111,U33023,102,-26497.70000000002,83,19,118651.34,92153.63999999998
14112,U1369273,102,-2023.8400000000008,85,17,4631.800000000002,2607.960000000001
14113,U10173,102,8180.39000000013,81,21,4469563.75,4477744.140000001
14114,U14381,102,-10233.400000000018,89,13,236192.51,225959.11
14115,U41010,102,2379.6099999999997,94,8,42105.170000000006,44484.780000000006
14116,U8909,102,-16865.530000000002,83,19,49243.56000000002,32378.030000000017
14117,U41836,102,13884.360000000035,78,24,252097.73999999996,265982.1
14118,U28825,102,-486429.4,83,19,757895.13,271465.73
14119,U38065,102,-4445.750000000005,89,13,84803.26999999999,80357.51999999999
14120,U26384,102,-150750.31,74,28,1625739.1099999996,1474988.7999999996
14121,U32464,102,93.76999999999995,88,14,37726.09999999999,37819.86999999999
14122,U43341,102,-14976354.530000003,94,8,16010923.270000003,1034568.7400000002
14123,U24139,102,-3559.5,97,5,9599.56,6040.0599999999995
14124,U26313,102,-49529.240000000005,82,20,127018.47,77489.23
14125,U32020,102,27050.130000000005,89,13,154248.78999999998,181298.91999999998
14126,U9428,102,184168.5400000019,62,40,14428126.490000006,14612295.030000009
14127,U37710,102,-11593.220000000012,82,20,103761.03999999998,92167.81999999996
14128,U18219,102,-8590.360000000006,62,40,210606.35,202015.99
14129,U28197,102,3689.0099999999984,100,2,28510.989999999998,32199.999999999996
14130,U42165,102,19866.92,75,27,120452.93000000001,140319.85
14131,U23780,102,-11179.13000000001,88,14,177738.15000000005,166559.02000000005
14132,U35430,102,1484.5899999999965,90,12,88165.24,89649.83
14133,U38848,102,-134928.55,82,20,468304.23000000004,333375.68000000005
14134,U36777,102,-2609.1800000000007,88,14,41531.060000000005,38921.880000000005
14135,U30456,102,-27533.82,97,5,35558.01,8024.190000000002
14136,U41223,102,-1137.900000000007,61,41,296065.66000000003,294927.76
14137,U10825,102,42193.979999999996,57,45,453682.27999999997,495876.25999999995
14138,U11986,102,359781.51,63,39,560972.35,920753.86
14139,U10160,102,-1479.0800000000002,93,9,8099.210000000001,6620.130000000001
14140,U24832,101,16525.700000000004,52,49,381164.04,397689.74
14141,U15881,101,1928184.63,90,11,205202.02999999988,2133386.6599999997
14142,U975156,101,69.82999999999993,81,20,14022.649999999998,14092.479999999998
14143,U18528,101,-205314.11999999994,94,7,226814.09999999992,21499.97999999998
14144,U43320,101,-18586.159999999996,61,40,374627.69,356041.53
14145,U1069854,101,36.310000000000116,77,24,11034.119999999999,11070.429999999998
14146,U41280,101,-1976.3199999999997,89,12,78823.58,76847.26000000001
14147,U32755,101,22116.33,49,52,135669.21,157785.53999999998
14148,U11158,101,152906.91999999998,90,11,95723.02,248629.94
14149,U29388,101,-17579.48,66,35,384185.8,366606.32
14150,U37817,101,-8320.370000000003,64,37,47494.180000000015,39173.81000000001
14151,U16069,101,-13419.73000000006,58,43,3964027.94,3950608.21
14152,U38750,101,13072.980000000001,95,6,18519.560000000005,31592.540000000008
14153,U31340,101,16454.430000000004,90,11,36787.07,53241.5
14154,U27000,101,2213.0400000000027,89,12,67905.60999999994,70118.64999999995
14155,U14597,101,-17097.22999999998,81,20,264748.41000000003,247651.18000000005
14156,U32492,101,324828.2799999999,56,45,586983.78,911812.0599999999
14157,U11927,101,96334.73000000003,74,27,129819.69,226154.42000000004
14158,U8509,101,-15607.420000000004,73,28,175099.6,159492.18
14159,U21569,101,-18334.550000000003,76,25,63038.240000000005,44703.69
14160,U18193,101,-295.87999999999965,60,41,48506.02,48210.14
14161,U38904,101,60459.060000000005,92,9,26269.38,86728.44
14162,U32259,101,46852.29999999998,76,25,55726.80000000002,102579.1
14163,U23094,101,-31350.199999999997,82,19,229286.47999999998,197936.27999999997
14164,U24003,101,-227710.70000000022,73,28,1730375.56,1502664.8599999999
14165,U31842,101,214.15000000000146,85,16,48785.68,48999.83
14166,U29514,101,-3620.209999999998,86,15,54553.89000000001,50933.68000000001
14167,U16954,101,-29835.860000000397,55,46,6284915.429999998,6255079.5699999975
14168,U40995,101,18796.339999999997,82,19,183571.31,202367.65
14169,U28353,101,-198.77999999999335,75,26,94246.4,94047.62
14170,U17686,101,84.38000000000102,54,47,155564.04,155648.42
14171,U20523,101,-160.14000000000124,87,14,17539.149999999994,17379.009999999995
14172,U28519,101,-5377.779999999997,82,19,38985.69,33607.91
14173,U20063,101,-44043.94000000002,93,8,115235.79999999999,71191.85999999997
14174,U32620,101,1284.300000000011,51,50,111006.16999999998,112290.47
14175,U33007,101,2825.84,56,45,122461.0,125286.84
14176,U31425,101,30506.389999999992,83,18,42565.850000000006,73072.23999999999
14177,U31846,101,16694.890000000003,84,17,122231.44000000002,138926.33000000002
14178,U13441,101,14134.339999999997,87,14,84246.13,98380.47
14179,U15233,101,144.17999999999972,80,21,90373.42000000001,90517.6
14180,U15079,101,4392.279999999982,61,40,1170310.22,1174702.5
14181,U43903,101,4012.8200000000033,47,54,194963.21,198976.03
14182,U17042,101,21009.74,70,31,125290.16999999998,146299.90999999997
14183,U41453,101,-34595.87,87,14,407243.6299999999,372647.7599999999
14184,U41196,101,84840.39,89,12,30420.640000000003,115261.03
14185,U12956,101,14092.210000000003,72,29,65310.26,79402.47
14186,U35078,101,-36.970000000007275,70,31,201940.05,201903.08
14187,U25024,101,-502.449999999998,58,43,17223.080000000005,16720.63000000001
14188,U1253025,101,-2345.9800000000005,75,26,12137.58,9791.599999999999
14189,U40097,101,14738.729999999996,89,12,175217.5,189956.22999999998
14190,U1248171,101,-122.31000000000051,70,31,9002.499999999998,8880.189999999997
14191,U16731,101,-68138.18999999999,93,8,223442.22999999992,155304.03999999992
14192,U14522,101,-5633.259999999999,82,19,84911.94000000002,79278.68000000002
14193,U13945,101,59.51000000000204,77,24,168282.41,168341.92
14194,U25833,101,-2931.7299999999946,82,19,30731.2,27799.470000000005
14195,U26259,101,13881.229999999994,93,8,40736.36,54617.59
14196,U40245,101,795.119999999999,62,39,77713.76,78508.87999999999
14197,U36458,101,8213.269999999999,82,19,101919.44,110132.71
14198,U12802,101,4976.780000000001,93,8,19654.260000000006,24631.040000000008
14199,U10202,101,-10221.25999999999,77,24,274767.1200000002,264545.8600000002
14200,U22931,101,-4591.350000000003,90,11,62343.66,57752.31
14201,U43251,101,-24932.009999999966,87,14,98569.70999999998,73637.70000000001
14202,U9392,101,329.5299999999945,77,24,165513.49,165843.02
14203,U21421,101,-3390.3400000000165,62,39,710490.3399999999,707099.9999999999
14204,U8761,101,171172.03999999998,66,35,935717.73,1106889.77
14205,U15760,101,-1558.560000000005,93,8,63522.36,61963.799999999996
14206,U39838,101,39575.04999999999,76,25,106694.00000000001,146269.05
14207,U614980,101,346.59000000000015,66,35,73848.01,74194.59999999999
14208,U26200,101,-2217.589999999982,70,31,5317384.340000003,5315166.750000003
14209,U9561,101,1137.0799999999997,88,13,13499.810000000001,14636.890000000001
14210,U18908,101,1307.5300000000007,70,31,14319.219999999998,15626.749999999998
14211,U39599,101,-3062.4799999999977,69,32,46503.540000000015,43441.06000000002
14212,U18854,101,-558.5200000000041,55,46,100496.86,99938.34
14213,U11614,101,10408.98999999999,72,29,2109023.44,2119432.4299999997
14214,U41447,101,-92509.11,89,12,507551.78,415042.67000000004
14215,U16234,101,484184.0199999999,83,18,583443.33,1067627.3499999999
14216,U32030,101,-2911.849999999999,86,15,20214.3,17302.45
14217,U30559,101,151991.9000000002,73,28,1958061.8,2110053.7
14218,U37332,101,-28306.770000000015,91,10,268659.67000000004,240352.90000000002
14219,U8718,101,17659.439999999886,81,20,1715773.8,1733433.24
14220,U39159,101,-7289.080000000007,89,12,104924.35,97635.27
14221,U24721,101,1224.9999999999995,89,12,21389.850000000002,22614.850000000002
14222,U37937,101,-93316.91,87,14,185865.71,92548.79999999999
14223,U24808,101,3028.6000000000004,91,10,15568.9,18597.5
14224,U30672,101,-8339.78000000002,78,23,440547.05,432207.26999999996
14225,U26717,101,-3131.8299999999963,69,32,139906.49000000002,136774.66000000003
14226,U33225,101,-557.5500000000008,83,18,35651.99,35094.439999999995
14227,U25662,101,-458.7499999999652,70,31,320253.66000000015,319794.9100000002
14228,U31186,101,5050.209999999999,77,24,14067.119999999992,19117.32999999999
14229,U28407,101,4522.129999999997,87,14,20740.269999999993,25262.39999999999
14230,U43726,101,37529.46,79,22,149281.23,186810.69
14231,U35665,101,-780.5999999999897,70,31,172266.2,171485.60000000003
14232,U37106,101,-4682.39,83,18,23821.489999999994,19139.099999999995
14233,U20533,101,-1249.3399999999938,82,19,64302.740000000005,63053.40000000001
14234,U24920,101,592941.3399999999,73,28,1164755.2,1757696.5399999998
14235,U23061,101,-4816.33,92,9,13240.389999999998,8424.059999999998
14236,U27074,101,53813.26999999997,70,31,372238.06000000006,426051.33
14237,U43683,101,2102.6699999999983,72,29,48638.139999999985,50740.80999999998
14238,U26523,101,98.04000000000013,87,14,18509.0,18607.04
14239,U22480,101,-5474.67,94,7,61155.22000000001,55680.55000000001
14240,U32185,101,-1102.03,97,4,6803.95,5701.92
14241,U41979,101,-4732.299999999996,90,11,17915.259999999995,13182.96
14242,U13205,101,155066.36999999994,76,25,682842.8200000001,837909.19
14243,U10452,101,0.1300000000046566,51,50,265092.0,265092.13
14244,U35836,101,44551.54,89,12,420494.75,465046.29
14245,U29998,101,23603.84,68,33,398773.98,422377.82
14246,U42850,101,-16828.79999999999,90,11,82055.29,65226.490000000005
14247,U12126,101,41033.610000000015,60,41,1016616.4300000002,1057650.0400000003
14248,U24753,101,-4275.290000000012,74,27,66117.54,61842.249999999985
14249,U40717,101,306.7499999999127,84,17,1044801.44,1045108.1899999998
14250,U14410,101,22207.70000000002,66,35,158406.69,180614.39
14251,U28377,101,3292.299999999999,77,24,45232.08,48524.38
14252,U13646,101,-12310.850000000175,63,38,29027497.390000004,29015186.540000003
14253,U24118,101,-91021.15,48,53,1022595.9400000001,931574.79
14254,U847359,101,-11424.669999999995,70,31,135709.71,124285.04
14255,U17872,101,3639.280000000006,85,16,45673.34000000001,49312.62000000002
14256,U35411,101,-67636.08,64,37,209943.96000000002,142307.88
14257,U32988,101,4683.85,86,15,51639.55000000001,56323.40000000001
14258,U15098,101,41191.950000000026,74,27,1206039.56,1247231.51
14259,U16741,101,93955.04000000001,37,64,215042.12,308997.16000000003
14260,U12793,101,-9903.759999999987,85,16,104438.55000000003,94534.79000000004
14261,U8194,101,-28453.819999999985,79,22,415809.45,387355.63
14262,U15030,101,-135106.75999999998,71,30,1150580.42,1015473.6599999999
14263,U32497,101,-1498.9500000000116,39,62,250922.24,249423.28999999998
14264,U17146,101,1155.990000000013,88,13,125630.16000000002,126786.15000000004
14265,U23856,101,-780.7899999999996,84,17,101197.57,100416.78000000001
14266,U18064,101,-16864.790000000005,74,27,395868.72,379003.93
14267,U18943,101,-14423.479999999994,82,19,155987.98999999996,141564.50999999998
14268,U8478,101,20489.11,84,17,141841.43,162330.53999999998
14269,U8178,101,-22843.370000000003,89,12,106757.80000000002,83914.43000000002
14270,U24327,101,-7615.189999999999,79,22,350571.9,342956.71
14271,U38902,101,5675.200000000001,85,16,12063.64,17738.84
14272,U25417,101,23675.94,80,21,188300.9,211976.84
14273,U27249,100,-2445.2200000000007,75,25,62865.87,60420.65
14274,U37644,100,-3692.8400000000074,55,45,242261.16,238568.32
14275,U42548,100,11450.19,68,32,90767.1,102217.29000000001
14276,U10880,100,-1576.1899999999569,63,37,310630.7799999999,309054.58999999997
14277,U15454,100,-26998.279999999984,37,63,1059100.0,1032101.72
14278,U1198534,100,-22494.730000000003,59,41,53502.56999999999,31007.83999999999
14279,U37099,100,5540.8700000000035,75,25,43666.38000000001,49207.250000000015
14280,U968284,100,612.5899999999999,68,32,13703.450000000003,14316.040000000003
14281,U24720,100,-2783.88,89,11,18258.02999999998,15474.14999999998
14282,U1090300,100,0.19999999999998863,55,45,3071.06,3071.2599999999998
14283,U31728,100,87571.27000000002,45,55,366696.03,454267.30000000005
14284,U24669,100,-1065.8399999999988,93,7,22770.95,21705.11
14285,U32454,100,24065.860000000004,95,5,20049.129999999994,44114.99
14286,U25234,100,8532.710000000001,84,16,92229.51000000001,100762.22000000002
14287,U12152,100,-7301.790000000002,89,11,66501.66,59199.87
14288,U17788,100,-3728.079999999956,70,30,831099.5,827371.42
14289,U25911,100,-42869.859999999986,79,21,275937.0599999999,233067.1999999999
14290,U8711,100,-8278.999999999982,52,48,538685.41,530406.41
14291,U41301,100,-71218.79000000001,84,16,87464.19000000002,16245.400000000009
14292,U9476,100,85247.89999999998,48,52,192791.9,278039.8
14293,U27710,100,133.7000000000262,63,37,696895.1199999999,697028.82
14294,U38849,100,288.170000000001,95,5,8734.82,9022.990000000002
14295,U10431,100,-28102.050000000003,74,26,457652.10000000003,429550.05000000005
14296,U43660,100,-666.110000000006,73,27,265797.99999999994,265131.88999999996
14297,U34058,100,1045.639999999998,86,14,89376.98000000003,90422.62000000002
14298,U20556,100,-4880.639999999999,84,16,150901.85,146021.21000000002
14299,U15713,100,-3050.090000000001,67,33,84435.4,81385.31
14300,U13835,100,2250.380000000003,79,21,57169.43999999998,59419.819999999985
14301,U28431,100,-35400.77999999999,82,18,125877.80999999998,90477.03
14302,U9276,100,-8437.220000000001,82,18,293116.82,284679.6
14303,U10330,100,-29142.67999999947,81,19,48336417.62,48307274.94
14304,U16707,100,12720.019999999999,86,14,52651.10999999999,65371.12999999999
14305,U29859,100,5473.16,83,17,61371.15,66844.31
14306,U19412,100,-23882.729999999996,88,12,87551.19,63668.46000000001
14307,U21472,100,-28961.730000000003,90,10,56278.32,27316.589999999997
14308,U39147,100,-5341573.35,62,38,18813407.86,13471834.51
14309,U28907,100,-1528.6799999999962,89,11,35226.09,33697.41
14310,U25920,100,2708.2900000000013,84,16,22085.919999999995,24794.209999999995
14311,U28646,100,-2117.0199999999113,88,12,225526.4599999999,223409.44
14312,U22636,100,-89827.29000000002,60,40,1300936.84,1211109.55
14313,U30783,100,1956.6500000000324,82,18,171733.66,173690.31000000003
14314,U14055,100,8642.099999999991,78,22,82048.85,90690.95
14315,U13995,100,-929.9399999999976,61,39,147027.08000000002,146097.14
14316,U26448,100,-12530.07,73,27,65950.4,53420.329999999994
14317,U31628,100,141601.91999999993,71,29,1019715.1,1161317.02
14318,U43466,100,-5679.290000000017,81,19,526041.6799999999,520362.3899999999
14319,U41699,100,82304.13999999998,50,50,326179.19,408483.32999999996
14320,U8575,100,-123833.06000000011,75,25,4829296.3500000015,4705463.290000001
14321,U8311,100,12309.169999999998,55,45,1284813.72,1297122.89
14322,U35450,100,-1654.9999999999995,81,19,16039.84,14384.84
14323,U39595,100,-1829.2999999999995,94,6,12562.619999999999,10733.32
14324,U8476,100,393.22000000000196,66,34,109639.61000000002,110032.83000000002
14325,U31292,100,-2762.0499999999984,66,34,162605.36,159843.31
14326,U39605,100,4595.930000000003,89,11,112349.79999999999,116945.73
14327,U30379,100,338136.54,87,13,118420.59999999998,456557.13999999996
14328,U27129,100,129.21999999999883,66,34,199118.1,199247.32
14329,U19415,100,2349.559999999982,69,31,348419.76,350769.32
14330,U39496,100,-15789.960000000003,88,12,105100.59000000001,89310.63
14331,U28081,100,12415.720000000003,87,13,29046.76,41462.48
14332,U17326,100,-110096.81999999996,88,12,564009.02,453912.20000000007
14333,U11717,100,5400.570000000003,79,21,93197.57999999999,98598.15
14334,U29956,100,1544.1600000000035,23,77,601625.95,603170.11
14335,U39657,100,-406.90999999999894,73,27,35331.53999999999,34924.63
14336,U41866,100,-7112.999999999913,74,26,428087.89999999997,420974.9
14337,U8137,100,18861.55,85,15,58663.180000000015,77524.73000000001
14338,U13060,100,-34100.579999999994,87,13,91085.45000000001,56984.87000000002
14339,U16847,100,1452044.6,88,12,337996.75,1790041.35
14340,U28454,100,2102.8,93,7,19027.04,21129.84
14341,U40812,100,8419.86,77,23,244897.28,253317.14
14342,U1204650,100,5920.0700000000015,77,23,12243.629999999997,18163.699999999997
14343,U30449,100,56445.42999999999,85,15,81522.55000000002,137967.98
14344,U40389,100,-18318.450000000004,78,22,314898.98999999993,296580.5399999999
14345,U43441,100,-864.2099999999965,86,14,263956.25999999995,263092.04999999993
14346,U16279,100,1854.0900000000217,74,26,278888.3899999999,280742.4799999999
14347,U17579,100,55270.38000000003,49,51,224721.98000000004,279992.36000000004
14348,U28642,100,-8676.399999999965,52,48,378709.0400000001,370032.64000000013
14349,U44001,100,264.7800000000005,95,5,3952.84,4217.620000000001
14350,U24134,100,-35645.56000000003,55,45,689681.67,654036.11
14351,U21495,100,-2744.240000000002,91,9,35296.58000000001,32552.340000000007
14352,U21174,100,29274.80000000001,87,13,125083.62000000002,154358.42000000004
14353,U19522,100,13151.849999999999,93,7,7531.8,20683.649999999998
14354,U18575,100,-51311.450000000004,80,20,164556.59999999995,113245.14999999994
14355,U39818,100,-31153.080000000005,89,11,52673.71000000001,21520.63
14356,U610992,100,4782.710000000009,65,35,150130.10000000003,154912.81000000006
14357,U40720,100,678.0900000000001,75,25,140395.58000000002,141073.67
14358,U34891,100,-4412.339999999997,63,37,138969.47999999998,134557.13999999998
14359,U27893,100,7733.18,44,56,29530.160000000003,37263.340000000004
14360,U8153,100,-509.07999999993115,80,20,337616.85999999987,337107.7799999999
14361,U14795,100,355375.56000000006,34,66,39312386.169999994,39667761.73
14362,U38340,100,-34492.850000000006,72,28,240430.27,205937.41999999998
14363,U29159,100,-103756.39999999997,78,22,826575.5699999998,722819.1699999999
14364,U33825,100,5069.190000000001,91,9,15769.4,20838.59
14365,U18172,100,15250.5,65,35,2583257.15,2598507.65
14366,U15913,100,6662.439999999977,77,23,587412.9599999998,594075.3999999998
14367,U39707,100,-42564.11,62,38,265316.68999999994,222752.57999999996
14368,U13122,100,-362274.1700000001,83,17,369381.23000000004,7107.0599999999395
14369,U8744,100,-927.7499999999978,77,23,87916.25,86988.5
14370,U10251,100,-974.4000000000005,92,8,8045.370000000001,7070.97
14371,U42178,100,-8.96000000007416,86,14,1113807.4899999995,1113798.5299999996
14372,U27070,100,402079.39,81,19,93334.37999999999,495413.77
14373,U9063,100,1748.3700000000024,84,16,30552.53,32300.9
14374,U10904,100,101272.70000000004,49,51,400409.8899999999,501682.58999999997
14375,U34288,100,-12736.499999999996,76,24,195972.90000000002,183236.40000000002
14376,U23899,100,-399376.83,86,14,565451.88,166075.05
14377,U10750,100,461.86999999999966,89,11,19695.410000000003,20157.280000000002
14378,U16381,100,-4150.600000000002,57,43,379263.07999999996,375112.48
14379,U27290,100,-34496.26000000001,86,14,64331.38000000001,29835.120000000003
14380,U39030,100,-8637.599999999999,81,19,60063.25,51425.65
14381,U18850,100,-29017.010000000002,87,13,84699.48999999999,55682.47999999999
14382,U14877,100,154952.82,61,39,664890.1000000001,819842.9200000002
14383,U34340,100,-5011.130000000001,61,39,360019.72000000003,355008.59
14384,U979368,100,-3750.850000000002,63,37,63318.630000000005,59567.78
14385,U13418,100,577.6999999999998,81,19,16786.17,17363.87
14386,U35990,100,-5861.759999999998,91,9,52577.31000000001,46715.55000000002
14387,U13761,100,1085.0700000000097,81,19,167211.68000000002,168296.75000000003
14388,U29494,100,-74994.50000000004,90,10,478544.42,403549.9199999999
14389,U19449,100,2506.479999999975,71,29,362149.04,364655.51999999996
14390,U10824,100,-932.890000000014,65,35,735181.2799999999,734248.3899999999
14391,U40713,100,29066.499999999964,71,29,603599.16,632665.66
14392,U14535,100,235.56000000000495,91,9,27809.970000000012,28045.530000000017
14393,U32784,100,7951.2300000000005,82,18,69965.9,77917.12999999999
14394,U18786,100,-12454.210000000017,87,13,97644.03000000001,85189.81999999999
14395,U20514,100,310773.0100000008,87,13,5283757.109999999,5594530.12
14396,U1075692,100,-976.5999999999967,72,28,63881.59,62904.99
14397,U39116,100,-4498.259999999984,75,25,676300.0299999999,671801.7699999999
14398,U24889,100,-4084.7999999999993,73,27,91665.20999999999,87580.40999999999
14399,U9851,100,-2481.529999999995,72,28,304782.91000000003,302301.38000000006
14400,U17381,100,41234.030000000006,79,21,93832.22,135066.25
14401,U40970,100,-162.31999999999755,91,9,62946.100000000006,62783.780000000006
14402,U16968,100,-9692.969999999992,77,23,142325.20999999996,132632.23999999996
14403,U32892,100,16587.320000000032,72,28,2164207.479999999,2180794.799999999
14404,U29332,100,-24348.38000000001,76,24,245787.71999999997,221439.33999999997
14405,U20065,99,3269.789999999999,87,12,37025.26,40295.05
14406,U25597,99,2328.34,87,12,16264.480000000001,18592.82
14407,U35512,99,398.3399999999983,64,35,69494.33,69892.67
14408,U16655,99,-6926.329999999934,72,27,843463.32,836536.99
14409,U18018,99,-11820.180000000022,65,34,658786.1299999999,646965.9499999998
14410,U1131254,99,-855.1100000000015,72,27,15920.120000000004,15065.010000000002
14411,U24373,99,-8464.769999999986,46,53,813805.8300000001,805341.06
14412,U25939,99,-2202.929999999994,63,36,143349.06,141146.13
14413,U14030,99,-7186.869999999999,77,22,53532.67000000001,46345.80000000002
14414,U31355,99,-128.76999999999953,87,12,25727.74,25598.97
14415,U29001,99,13087.01,90,9,115829.87999999999,128916.88999999998
14416,U10703,99,548.5699999999994,87,12,28014.820000000003,28563.390000000003
14417,U42482,99,-39506.549999999996,87,12,53556.12000000001,14049.570000000014
14418,U591373,99,-31494.440000000002,70,29,87184.22,55689.78
14419,U29136,99,-3805.9500000000016,71,28,16292.190000000006,12486.240000000005
14420,U36809,99,-351.7799999999978,91,8,48505.08999999999,48153.30999999999
14421,U37333,99,-11499.8,83,16,145372.06999999995,133872.26999999996
14422,U19518,99,462.319999999993,81,18,538385.6000000004,538847.9200000004
14423,U9007,99,-89474.48000000001,78,21,912443.13,822968.65
14424,U10790,99,-88722.07999999999,73,26,846264.47,757542.39
14425,U26439,99,-1223.0399999995716,64,35,3484281.8299999996,3483058.79
14426,U27790,99,1402.960000000005,76,23,189321.38,190724.34
14427,U15009,99,7900.59,62,37,52852.439999999995,60753.03
14428,U24723,99,-63.20999999999822,63,36,430064.86,430001.64999999997
14429,U25369,99,-144335.70000000007,40,59,5649388.720000001,5505053.0200000005
14430,U35643,99,790.4100000000026,61,38,55823.88,56614.29
14431,U23483,99,-4188.8500000000095,65,34,317831.14,313642.29
14432,U37246,99,20787.579999999998,83,16,184905.91,205693.49
14433,U30050,99,4847.839999999996,76,23,470428.49,475276.32999999996
14434,U16245,99,604803.32,70,29,2875956.48,3480759.8
14435,U29476,99,6070.7100000000055,68,31,96605.73000000001,102676.44000000002
14436,U8100,99,26757.259999999995,82,17,73153.94999999998,99911.20999999998
14437,U12531,99,-5506.409999999998,72,27,41343.53,35837.12
14438,U36516,99,-196.2799999999989,67,32,63485.69000000001,63289.41000000001
14439,U41514,99,14202.509999999947,62,37,3758323.3699999996,3772525.8799999994
14440,U972680,99,59.7499999999996,75,24,18192.96,18252.71
14441,U9831,99,4227.759999999997,80,19,114433.19999999998,118660.95999999998
14442,U25653,99,-1489.08,85,14,46872.47999999999,45383.39999999999
14443,U16207,99,38290.929999999986,88,11,90147.40000000002,128438.33000000002
14444,U36755,99,-191963.82999999996,70,29,531489.9,339526.07000000007
14445,U1249478,99,412.1399999999993,77,22,10630.030000000002,11042.170000000002
14446,U32286,99,5755.619999999995,88,11,108281.44999999998,114037.06999999998
14447,U40096,99,49258.03999999995,65,34,530714.99,579973.0299999999
14448,U14984,99,3396.289999999999,82,17,29463.640000000003,32859.93
14449,U17281,99,-149644.21999999986,70,29,822743.0099999998,673098.7899999999
14450,U21742,99,33172.28999999998,91,8,335865.98,369038.26999999996
14451,U584965,99,-3176.4200000000037,72,27,39870.31999999999,36693.89999999999
14452,U23129,99,-119125.74999999997,89,10,945987.4500000001,826861.7000000001
14453,U32053,99,-18861.910000000003,73,26,151371.24000000002,132509.33000000002
14454,U43402,99,-73570.51000000001,94,5,83137.63999999997,9567.129999999961
14455,U36958,99,-1376.059999999994,68,31,214256.88,212880.82
14456,U24163,99,-4146.420000000042,42,57,2026244.1,2022097.6800000002
14457,U8797,99,724.8599999999997,87,12,60036.909999999996,60761.77
14458,U36911,99,441265.61,72,27,132537.84,573803.45
14459,U40770,99,-468.9599999999996,71,28,29384.940000000002,28915.980000000003
14460,U22412,99,75824.87999999998,91,8,47283.130000000005,123108.00999999998
14461,U41197,99,-22105.92,93,6,71365.39,49259.47
14462,U13997,99,108.57000000000164,86,13,28832.749999999996,28941.32
14463,U37694,99,-163075.44,87,12,260475.7800000001,97400.34000000008
14464,U28876,99,57755.669999999984,84,15,40031.54,97787.20999999999
14465,U24544,99,3811.8600000000024,82,17,92881.33,96693.19
14466,U11903,99,-6978.17,95,4,7987.82,1009.6499999999996
14467,U42748,99,-21235.67,87,12,35507.869999999995,14272.199999999997
14468,U10856,99,-40.220000000000255,74,25,81475.84,81435.62
14469,U11690,99,-41514.63000000001,79,20,280230.75999999995,238716.12999999995
14470,U18860,99,16082.099999999993,77,22,108216.55,124298.65
14471,U41373,99,-126231.16000000003,88,11,364731.27,238500.11
14472,U27837,99,-7471.419999999993,81,18,220987.7799999999,213516.35999999993
14473,U12877,99,1338.8600000000001,84,15,21267.819999999996,22606.679999999997
14474,U22423,99,9571.130000000001,79,20,19494.100000000002,29065.230000000003
14475,U18364,99,-150.16000000000508,60,39,86306.64999999998,86156.48999999998
14476,U19933,99,131858.18999999994,73,26,3322473.8800000004,3454332.0700000003
14477,U25901,99,66630.50999999998,88,11,158067.52999999997,224698.03999999995
14478,U19307,99,-9321.189999999995,87,12,39610.869999999995,30289.68
14479,U41994,99,-8108.090000000002,83,16,181093.61,172985.52
14480,U36454,99,768.209999999996,81,18,52014.350000000006,52782.560000000005
14481,U34471,99,45004.69,91,8,70013.37,115018.06
14482,U17002,99,-15685.009999999986,70,29,364937.65,349252.64
14483,U17230,99,-312609.0600000019,65,34,53368482.89,53055873.83
14484,U25568,99,-12105.620000000006,79,20,98647.34,86541.71999999999
14485,U27892,99,-1779.5799999999979,79,20,86501.62,84722.04
14486,U14753,99,-1090.710000000006,79,20,71427.69,70336.98
14487,U32727,99,11730.280000000008,61,38,207583.79,219314.07
14488,U8590,99,3911.200000000006,78,21,316552.87,320464.07
14489,U19649,99,41918.350000000006,51,48,509067.98999999993,550986.34
14490,U32736,99,-3925.9100000000035,80,19,29845.92,25920.009999999995
14491,U9207,99,1292.76,88,11,83690.97000000002,84983.73000000001
14492,U9864,99,-3470.420000000006,56,43,235657.51,232187.09
14493,U8046,99,4049.370000000132,46,53,2166375.54,2170424.91
14494,U35367,99,11862.700000000013,88,11,305803.62999999995,317666.32999999996
14495,U26666,99,27320.21000000001,84,15,60493.78,87813.99
14496,U19768,99,-636.2000000000007,93,6,13442.75,12806.55
14497,U32745,99,3690.379999999999,83,16,129728.21999999999,133418.59999999998
14498,U13336,99,41857.2,85,14,147406.83999999997,189264.03999999998
14499,U42487,99,34615.60999999997,64,35,1112096.0000000002,1146711.61
14500,U13287,99,-27512.299999999985,88,11,187273.14000000004,159760.84000000005
14501,U41685,99,21765.62,83,16,316414.87999999995,338180.49999999994
14502,U36419,99,5710.800000000005,53,46,208050.69000000003,213761.49000000005
14503,U20142,99,-2472.8200000000143,72,27,139187.03999999998,136714.21999999997
14504,U35992,99,36079.18000000013,47,52,721350.2999999999,757429.4800000001
14505,U30322,99,-16794.340000000007,83,16,68773.34000000001,51979.0
14506,U35808,99,2009.6300000000074,88,11,121893.23,123902.86
14507,U34359,99,10215.740000000002,87,12,36377.74,46593.479999999996
14508,U24985,99,4114.679999999997,28,71,122696.46,126811.14
14509,U10213,99,38352.53000000001,76,23,222425.41,260777.94
14510,U12615,99,53348.22999999996,43,56,299722.45,353070.68
14511,U17012,99,340088.3400000003,70,29,9485835.55,9825923.89
14512,U28232,99,5543.05,76,23,69219.18,74762.23
14513,U42257,99,153.45999999999998,65,34,20473.13,20626.59
14514,U35080,99,-88152.03999999996,77,22,504855.4,416703.36000000004
14515,U20037,99,-6195.130000000005,59,40,368975.2,362780.07
14516,U28771,99,9700.110000000004,84,15,18646.56000000001,28346.670000000013
14517,U9815,99,-1913.5400000000009,91,8,24126.66,22213.12
14518,U33483,99,-452540.44000000006,91,8,625577.58,173037.1399999999
14519,U16502,99,-12822.98,74,25,64986.0,52163.020000000004
14520,U23614,99,-7438.489999999998,90,9,27474.469999999998,20035.98
14521,U11671,99,22225.61,92,7,34778.77999999999,57004.38999999999
14522,U1137459,99,-3732.079999999997,93,6,15421.740000000002,11689.660000000003
14523,U33634,99,786.6199999999976,76,23,75144.52000000005,75931.14000000004
14524,U750744,99,-3016.379999999999,60,39,30871.58,27855.200000000004
14525,U960263,99,4252.679999999998,69,30,45722.43,49975.11
14526,U14527,99,-21556.370000000006,82,17,65166.6,43610.229999999996
14527,U37689,99,-20345.17,91,8,26398.81,6053.640000000003
14528,U32946,99,25290.350000000002,92,7,31586.37,56876.72
14529,U12868,99,150.10999999999913,83,16,257585.04000000007,257735.15000000005
14530,U42831,99,21003.769999999997,87,12,54480.35,75484.12
14531,U40915,99,193399.22999999998,83,16,96431.41000000002,289830.64
14532,U23759,99,4883.330000000003,81,18,112633.52,117516.85
14533,U27277,99,712.3199999999888,78,21,89832.94000000002,90545.26000000001
14534,U34594,99,7972.079999999929,76,23,2011745.76,2019717.8399999999
14535,U1145691,99,2974.7299999999987,78,21,32770.579999999994,35745.30999999999
14536,U27152,99,50254.37999999999,61,38,102866.01000000001,153120.39
14537,U593107,98,7.259999999998115,86,12,54167.400000000016,54174.66000000001
14538,U33638,98,62454.03999999999,72,26,341768.42000000004,404222.46
14539,U24874,98,2431.62,79,19,27046.55,29478.17
14540,U35034,98,378.91,77,21,6376.600000000001,6755.510000000001
14541,U23430,98,4593.759999999995,86,12,234847.35,239441.11
14542,U22677,98,-197249.33,66,32,1447776.78,1250527.45
14543,U18785,98,-106454.84,86,12,274458.79,168003.94999999998
14544,U34295,98,-6227.860000000044,82,16,422039.79,415811.92999999993
14545,U17665,98,139330.15000000005,78,20,754440.8000000002,893770.9500000002
14546,U1083534,98,-2341.9900000000002,74,24,15173.349999999999,12831.359999999999
14547,U40387,98,750.2900000000025,74,24,83404.36000000004,84154.65000000005
14548,U10833,98,-2361.2499999999986,88,10,12349.040000000008,9987.79000000001
14549,U19703,98,-7310.650000000002,87,11,44373.520000000004,37062.87
14550,U31119,98,254.35000000000582,80,18,53319.649999999994,53574.0
14551,U25007,98,-28908.190000000002,89,9,67820.85,38912.66
14552,U41315,98,459173.63,79,19,628664.25,1087837.88
14553,U31137,98,266.2099999999991,75,23,35283.28,35549.49
14554,U37056,98,15246.930000000046,91,7,504582.93999999994,519829.87
14555,U578972,98,-70.86000000000033,58,40,16270.94,16200.08
14556,U20832,98,-4951.129999999997,16,82,55050.299999999996,50099.17
14557,U20456,98,-6593.360000000003,88,10,51451.670000000006,44858.310000000005
14558,U39307,98,-262172.79,78,20,1176780.7100000002,914607.9200000002
14559,U21065,98,-27.749999999996362,77,21,91318.65,91290.9
14560,U17834,98,1243.6499999999996,80,18,53861.490000000005,55105.14000000001
14561,U21571,98,2560.719999999998,83,15,21919.709999999995,24480.429999999993
14562,U19922,98,-621469.23,75,23,1498890.9699999997,877421.7399999998
14563,U16616,98,16963.72000000051,53,45,5493559.72,5510523.44
14564,U30350,98,-3638.850000000004,87,11,79376.83999999998,75737.98999999998
14565,U41255,98,2450.9100000000253,86,12,221589.3,224040.21000000002
14566,U36956,98,-4085.819999999998,85,13,33214.72,29128.9
14567,U17921,98,367.37000000000853,78,20,139413.15000000002,139780.52000000002
14568,U31224,98,657.8699999999156,55,43,4169418.4300000006,4170076.3000000007
14569,U14194,98,-157006.11999999997,89,9,269450.17,112444.05000000002
14570,U18569,98,-15601.149999999992,89,9,41116.98000000002,25515.830000000024
14571,U37200,98,3175.2399999999984,89,9,6348.72,9523.96
14572,U14378,98,1498.9799999999877,88,10,203862.20999999993,205361.18999999992
14573,U23607,98,-2134.0399999999995,93,5,4364.04,2230.0000000000005
14574,U42231,98,-23486.719999999987,46,52,598714.38,575227.66
14575,U14546,98,-88551.79000000007,49,49,1398917.0499999998,1310365.2599999998
14576,U32849,98,-25698.54,87,11,78498.67,52800.13
14577,U9557,98,-35408.039999999964,87,11,958912.2600000004,923504.2200000004
14578,U22036,98,-41406.68,81,17,158169.41000000006,116762.73000000007
14579,U14841,98,-41698.89,66,32,507692.53999999986,465993.64999999985
14580,U13632,98,784.929999999993,61,37,486574.77999999997,487359.70999999996
14581,U42250,98,-3922.5800000000027,90,8,22568.520000000004,18645.940000000002
14582,U20629,98,-3669.7000000000016,65,33,482659.37999999995,478989.67999999993
14583,U26421,98,3587.3599999999988,70,28,68069.28,71656.64
14584,U23453,98,-2931.7199999999953,69,29,958277.1,955345.38
14585,U10729,98,-13650.359999999811,48,50,6597698.84,6584048.48
14586,U32486,98,-9742.32,85,13,115538.72,105796.4
14587,U42479,98,-81813.14000000003,57,41,274059.5300000001,192246.39000000007
14588,U29721,98,-4606.650000000001,94,4,20369.93,15763.279999999999
14589,U23774,98,-609.9599999999984,88,10,32998.259999999995,32388.299999999996
14590,U9458,98,-1119.0700000000047,59,39,172586.21,171467.13999999998
14591,U1318041,98,-5792.25,72,26,27349.649999999994,21557.399999999994
14592,U26940,98,-8646.95,80,18,74229.41,65582.46
14593,U12027,98,-140938.76000000004,72,26,1485135.71,1344196.95
14594,U10891,98,-564205.6699999999,66,32,1544720.7500000002,980515.0800000003
14595,U20785,98,6023.229999999998,81,17,93115.65999999999,99138.88999999998
14596,U8588,98,4891.5199999999995,89,9,26327.63,31219.15
14597,U19031,98,4126.969999999996,62,36,95152.0,99278.97
14598,U38563,98,-5611.260000000001,73,25,43953.23,38341.97
14599,U34436,98,-2671.7199999999993,89,9,27580.78,24909.059999999998
14600,U30629,98,-871.8000000000011,76,22,92111.61,91239.81
14601,U9217,98,3276.2600000000007,84,14,25817.920000000006,29094.180000000008
14602,U12548,98,5349.579999999986,89,9,153862.72000000012,159212.3000000001
14603,U16117,98,-40150.78,64,34,75434.59,35283.81
14604,U27466,98,41.33999999999946,89,9,34941.62,34982.96
14605,U28287,98,14191.499999999998,83,15,45872.36000000001,60063.86000000001
14606,U29535,98,-97997.87000000005,76,22,713565.2999999999,615567.4299999999
14607,U8360,98,-4346.049999999998,82,16,31223.279999999995,26877.229999999996
14608,U11480,98,4065.560000000012,89,9,147126.38,151191.94
14609,U40803,98,-15726.190000000022,79,19,195822.47,180096.27999999997
14610,U21967,98,1920.3399999999856,71,27,240224.95,242145.29
14611,U30644,98,-6422.420000000016,68,30,152672.03000000003,146249.61000000002
14612,U19273,98,12922.02,84,14,28877.31,41799.33
14613,U31779,98,-28083.25999999998,83,15,133820.22,105736.96000000002
14614,U27155,98,-1079.58,81,17,44892.49000000002,43812.91000000002
14615,U9444,98,-31178.789999999997,91,7,92205.21000000002,61026.42000000003
14616,U20971,98,0.2400000000197906,51,47,383709.84,383710.0800000001
14617,U34842,98,-859.5100000000002,83,15,27759.27,26899.760000000002
14618,U36568,98,-22221.040000000005,81,17,63817.69,41596.649999999994
14619,U20578,98,7282.640000000038,41,57,14576653.4,14583936.040000001
14620,U40466,98,4187.919999999998,84,14,45374.25999999999,49562.179999999986
14621,U39324,98,9700.669999999982,89,9,482669.4400000002,492370.11000000016
14622,U16146,98,-5977.299999999991,66,32,426481.23999999993,420503.93999999994
14623,U36827,98,-2924.9199999999996,84,14,46446.19,43521.270000000004
14624,U34151,98,-9536.829999999914,61,37,549850.09,540313.26
14625,U41989,98,-12345.149999999998,90,8,29079.97,16734.820000000003
14626,U16320,98,-221581.49,78,20,437977.18,216395.69
14627,U18428,98,-11680.929999999998,85,13,37097.44000000001,25416.51000000001
14628,U17977,98,2210.0500000000006,72,26,50899.45000000001,53109.500000000015
14629,U27160,98,-16269.8,57,41,563892.22,547622.4199999999
14630,U22438,98,-80044.97999999972,68,30,2731443.05,2651398.0700000003
14631,U1244222,98,17313.260000000002,59,39,98179.06,115492.32
14632,U9052,98,13070.539999999999,91,7,26396.61,39467.15
14633,U1220282,98,-1575.4599999999991,46,52,21190.99,19615.530000000002
14634,U14076,98,-6307.940000000002,85,13,17046.15,10738.21
14635,U37503,98,-25297.699999999997,82,16,129642.78999999998,104345.08999999998
14636,U41072,98,-2227.350000000006,76,22,168465.07,166237.72
14637,U9333,98,-959557.0200000001,73,25,1563087.5499999996,603530.5299999994
14638,U39377,98,-26547.710000000014,78,20,136063.59999999998,109515.88999999996
14639,U32033,98,-73982.17,81,17,118057.81,44075.64
14640,U27041,98,615.3899999999992,86,12,31018.139999999996,31633.529999999995
14641,U27044,98,-15427.79,65,33,155292.05000000002,139864.26
14642,U16366,98,-353739.2299999999,80,18,1183404.85,829665.6200000001
14643,U27392,98,-8018.739999999989,88,10,57345.379999999976,49326.639999999985
14644,U17141,98,104114.95000000007,58,40,2045781.24,2149896.19
14645,U19528,98,-2067.5099999999957,69,29,66103.57,64036.06000000001
14646,U852721,98,-9315.389999999996,70,28,61790.52000000001,52475.13000000002
14647,U42139,98,-30853.070000000003,90,8,55147.72,24294.649999999998
14648,U34341,98,13966.089999999997,83,15,9840.19,23806.28
14649,U24967,98,55395.399999999994,61,37,406759.11999999994,462154.5199999999
14650,U8918,98,9029.020000000008,86,12,26083.63,35112.65000000001
14651,U8928,98,-44032.42,93,5,89619.24,45586.82000000001
14652,U26261,98,-5375.619999999999,94,4,9480.84,4105.220000000001
14653,U9604,98,-6007.330000000022,73,25,348438.79,342431.45999999996
14654,U36728,98,231978.66000000006,83,15,664446.8,896425.4600000001
14655,U15734,98,214897.01000000004,80,18,701122.71,916019.72
14656,U42017,98,363.1100000000001,89,9,103966.17000000006,104329.28000000006
14657,U27348,98,1511.3299999999986,82,16,156715.28,158226.61
14658,U19198,98,9071.759999999998,60,38,57151.380000000005,66223.14
14659,U29143,98,-35107.41999999995,65,33,203304.76999999996,168197.35
14660,U8644,98,-6864.37000000001,47,51,501822.93,494958.56
14661,U22573,98,-281.79000000000667,85,13,112923.88000000002,112642.09000000001
14662,U28317,98,-6070.399999999995,81,17,88348.59000000001,82278.19000000002
14663,U14067,98,176.57000000000335,75,23,178415.72000000003,178592.29000000004
14664,U28641,98,-10485.750000000004,75,23,142190.18000000002,131704.43000000002
14665,U27049,98,308399.52999999997,89,9,621237.2699999999,929636.7999999998
14666,U28467,97,7527.459999999967,62,35,409842.79,417370.24999999994
14667,U20033,97,42226.069999999985,85,12,33104.16,75330.22999999998
14668,U11430,97,-40845.07999999984,67,30,810137.9299999999,769292.8500000001
14669,U14461,97,4216.580000000231,78,19,2711764.9799999995,2715981.5599999996
14670,U8289,97,-6929.409999999999,89,8,20871.18,13941.77
14671,U22301,97,70046.48999999999,52,45,85957.36000000002,156003.85
14672,U19867,97,-6181.85999999999,59,38,490255.37000000005,484073.51000000007
14673,U12809,97,610.8899999999999,76,21,22980.5,23591.39
14674,U38679,97,14194.260000000007,87,10,146205.48000000004,160399.74000000005
14675,U31472,97,-35903.94,69,28,205181.3,169277.36
14676,U39458,97,26222.679999999993,62,35,2234225.95,2260448.6300000004
14677,U21222,97,-112097.62999999998,69,28,675987.34,563889.71
14678,U32363,97,-5084.4400000000005,50,47,140690.0,135605.56
14679,U17390,97,64101.19000000002,51,46,477608.69000000006,541709.8800000001
14680,U35111,97,10465.100000000002,70,27,337864.55,348329.64999999997
14681,U11475,97,-10700.960000000001,74,23,87692.32999999999,76991.36999999998
14682,U30440,97,6579.769999999994,81,16,168761.02000000002,175340.79
14683,U33368,97,-897.5100000000002,89,8,12836.380000000003,11938.870000000003
14684,U36508,97,136.6599999999853,83,14,148786.71999999997,148923.37999999995
14685,U25339,97,39678.48000000003,55,42,330545.0,370223.48000000004
14686,U8124,97,-1123.8299999999863,80,17,91107.98000000003,89984.15000000004
14687,U32972,97,-71026.04,84,13,117649.32999999999,46623.28999999999
14688,U25036,97,-26547.53,77,20,354354.9,327807.37
14689,U43489,97,-14456.979999999961,62,35,483063.67000000004,468606.69000000006
14690,U17523,97,11908.690000000099,88,9,319399.7899999999,331308.48000000004
14691,U962735,97,-5663.969999999999,69,28,15647.04,9983.070000000002
14692,U40025,97,10154.920000000004,74,23,173141.57999999996,183296.49999999997
14693,U21602,97,-88670.52999999998,81,16,274209.29,185538.76
14694,U39839,97,-484887.0699999999,76,21,2813070.939999998,2328183.8699999982
14695,U27021,97,-436.88000000001114,82,15,69660.94000000003,69224.06000000003
14696,U9567,97,41155.57999999998,51,46,280938.65,322094.23
14697,U22184,97,1438.7200000000018,81,16,28523.900000000005,29962.620000000006
14698,U10597,97,-1863.400000000005,61,36,68365.32000000002,66501.92000000001
14699,U22736,97,22524.690000000017,80,17,154205.06000000006,176729.75000000006
14700,U30824,97,23492.840000000004,53,44,383779.77999999997,407272.62
14701,U27340,97,1048.1699999999983,72,25,274448.94,275497.11
14702,U32744,97,295.21999999999935,82,15,43970.03,44265.25
14703,U34263,97,1356.6499999999983,59,38,124815.1,126171.75
14704,U13955,97,-42373.07999999998,87,10,127697.13,85324.05000000002
14705,U24319,97,-26941.640000000014,56,41,393799.76,366858.12
14706,U14473,97,-4921.719999999998,63,34,136229.34999999998,131307.62999999998
14707,U25239,97,15367.909999999996,49,48,119136.25999999998,134504.16999999998
14708,U38018,97,-3009.5,72,25,727294.5700000001,724285.0700000001
14709,U37007,97,-5276.02999999999,82,15,62821.87,57545.84000000001
14710,U36048,97,88148.55000000005,73,24,550840.9199999998,638989.4699999999
14711,U42346,97,9571.279999999973,67,30,911560.2299999997,921131.5099999998
14712,U27183,97,17574.860000000015,83,14,137836.07000000004,155410.93000000005
14713,U23494,97,-83518.7,83,14,122442.36,38923.66
14714,U22151,97,71760.60999999999,74,23,179459.76,251220.37
14715,U26639,97,68088.14,86,11,20136.23,88224.37
14716,U17442,97,532213.5199999999,67,30,950627.9899999999,1482841.5099999998
14717,U33538,97,-6026.869999999997,65,32,202935.00999999998,196908.13999999998
14718,U43857,97,-7998.300000000029,59,38,393784.61,385786.30999999994
14719,U40291,97,-49676.850000000064,57,40,859695.98,810019.1299999999
14720,U38348,97,-3085.5999999999963,64,33,72272.42,69186.82
14721,U12776,97,268.899999999996,61,36,102984.57,103253.47
14722,U22588,97,-9747.430000000004,81,16,141353.81000000003,131606.38000000003
14723,U29013,97,1317.9699999999957,88,9,19295.750000000004,20613.72
14724,U30109,97,15677.180000000033,83,14,197174.90000000002,212852.08000000005
14725,U36217,97,1215.8300000000008,90,7,20466.049999999996,21681.879999999997
14726,U36665,97,12603.679999999895,66,31,2365065.4499999993,2377669.129999999
14727,U25201,97,8400.939999999997,80,17,114755.37999999999,123156.31999999999
14728,U34960,97,5975.150000000006,74,23,148763.86999999997,154739.01999999996
14729,U22271,97,-26715.940000000002,79,18,687978.9299999999,661262.99
14730,U27043,97,4884.8,84,13,19227.360000000008,24112.160000000007
14731,U12855,97,-697.6599999999977,85,12,63676.12999999999,62978.469999999994
14732,U13200,97,111.65999999991696,58,39,1086886.06,1086997.72
14733,U11445,97,-58482.79,77,20,246987.96999999994,188505.17999999993
14734,U35007,97,44928.78000000002,90,7,32359.55,77288.33000000002
14735,U24249,97,806.0000000000005,84,13,7573.0199999999995,8379.02
14736,U19884,97,-1090.33,86,11,12092.44,11002.11
14737,U29485,97,-5972.530000000001,64,33,42060.86,36088.33
14738,U35405,97,20611.379999999997,80,17,34878.98,55490.36
14739,U37283,97,-679.7800000000032,84,13,48946.429999999986,48266.64999999998
14740,U17815,97,5282.939999999999,66,31,221561.65,226844.59
14741,U35734,97,145567.08000000002,50,47,656537.18,802104.26
14742,U27509,97,8800.119999999997,66,31,37863.15,46663.27
14743,U40961,97,-1834.3799999999994,85,12,8814.78,6980.4000000000015
14744,U28853,97,5428.139999999999,90,7,11760.99,17189.129999999997
14745,U1290585,97,-28.270000000003126,93,4,202942.47,202914.2
14746,U28610,97,3436.199999999986,72,25,201895.14000000004,205331.34000000003
14747,U15538,97,26652.900000000005,71,26,196608.53000000003,223261.43000000002
14748,U25703,97,-125629.37999999998,76,21,296932.9900000001,171303.61000000013
14749,U1103889,97,-721.5199999999999,71,26,1975.6100000000004,1254.0900000000006
14750,U33118,97,114.70999999998276,76,21,329051.88,329166.58999999997
14751,U19894,97,-20142.540000000005,71,26,588749.3400000002,568606.8000000002
14752,U29719,97,119156.75000000023,60,37,4441961.549999999,4561118.299999999
14753,U26521,97,6708.730000000001,65,32,651538.17,658246.9
14754,U18608,97,3899.6699999999964,64,33,179248.93999999997,183148.60999999996
14755,U36523,97,3342.19,84,13,8367.470000000001,11709.660000000002
14756,U33305,97,-4799.930000000001,83,14,30254.079999999998,25454.149999999998
14757,U34501,97,16036.449999999988,81,16,220386.22999999998,236422.67999999996
14758,U41538,97,-85460.44999999995,78,19,1206182.0399999998,1120721.5899999999
14759,U25481,97,-55042.78000000003,74,23,174688.68,119645.89999999997
14760,U37038,97,4352.680000000001,7,90,48064.0,52416.68
14761,U21524,97,10898.339999999997,68,29,127036.65,137934.99
14762,U39684,97,-397722.5299999999,74,23,4849075.11,4451352.58
14763,U26801,97,-50777.98999999988,57,40,1415461.27,1364683.28
14764,U19417,97,-12829.229999999998,90,7,39204.6,26375.370000000003
14765,U28405,97,18306.63,62,35,113093.67,131400.3
14766,U33966,97,-28318.53,89,8,60777.83,32459.300000000003
14767,U23654,97,-6828.449999999998,92,5,19586.229999999996,12757.779999999999
14768,U25953,97,45065.53999999999,87,10,151975.51,197041.05
14769,U32056,97,-16667.499999999935,69,28,661803.31,645135.8100000002
14770,U15332,97,-9336.670000000004,81,16,43265.83,33929.159999999996
14771,U21027,97,7396.989999999985,46,51,304950.44999999995,312347.43999999994
14772,U30402,97,-2623.6599999999985,91,6,22213.399999999994,19589.739999999994
14773,U32233,97,7176.899999999997,84,13,105984.87999999999,113161.77999999998
14774,U14396,97,6103.800000000001,92,5,2991.91,9095.710000000001
14775,U28055,97,-1900.1199999999953,79,18,66103.6,64203.48000000001
14776,U975530,97,-6814.400000000003,63,34,39763.82000000001,32949.420000000006
14777,U25539,97,8783.04,72,25,122627.54,131410.58
14778,U40221,97,-15564.470000000023,63,34,1308293.4000000001,1292728.9300000002
14779,U31114,97,22462.03,63,34,97344.92,119806.95
14780,U23294,97,-1672.9800000000014,71,26,322836.39999999997,321163.42
14781,U15109,97,-7464.440000000008,78,19,483674.9699999999,476210.5299999999
14782,U31544,97,8314.069999999998,87,10,9789.57,18103.64
14783,U27962,97,1314.4599999999973,82,15,24087.270000000008,25401.730000000003
14784,U19217,97,-14750.449999999997,62,35,219492.78999999998,204742.33999999997
14785,U30503,97,-65326.58000000001,73,24,431122.78,365796.2
14786,U11339,97,-16834.850000000002,81,16,106420.83999999997,89585.98999999996
14787,U36423,97,-2359.640000000001,77,20,59418.71,57059.07
14788,U593825,97,3885.87,91,6,18325.21,22211.079999999998
14789,U34046,97,-22160.679999999993,53,44,164867.87999999998,142707.19999999998
14790,U38865,97,-1154.6999999999998,90,7,10306.53,9151.830000000002
14791,U39570,97,-34031.189999999995,86,11,214425.09000000005,180393.90000000005
14792,U25099,97,-4393.329999999999,57,40,8272.799999999997,3879.4699999999984
14793,U14916,97,43179.97,85,12,102125.93,145305.9
14794,U31393,97,8198.250000000013,70,27,206649.20000000004,214847.45000000004
14795,U42431,97,-10462.589999999987,78,19,123817.59,113355.00000000001
14796,U16047,97,-975334.6099999999,49,48,3741508.4999999995,2766173.8899999997
14797,U40876,97,1998.0299999999916,87,10,122174.74,124172.76999999999
14798,U8687,97,561.96,87,10,19648.12,20210.079999999998
14799,U12340,97,129847.84000000004,83,14,24965.42,154813.26000000004
14800,U40971,97,-398552.0700000001,52,45,3441795.5,3043243.4299999997
14801,U37968,97,-373278.43000000005,63,34,494476.22000000003,121197.78999999998
14802,U16751,97,1593.8000000000313,48,49,397289.27,398883.07000000007
14803,U1320572,97,-3.0699999999999363,64,33,6755.53,6752.46
14804,U38213,97,-3508.5200000000023,71,26,36080.210000000014,32571.69000000001
14805,U42856,97,7899.049999999987,69,28,89799.35999999999,97698.40999999997
14806,U26962,97,86342.90000000001,77,20,387690.42999999993,474033.32999999996
14807,U17048,97,43129.51000000001,81,16,96561.06000000001,139690.57
14808,U22846,97,33305.3599999998,74,23,4751542.86,4784848.22
14809,U22560,97,39128.71999999993,53,44,2449876.59,2489005.3099999996
14810,U760425,97,-0.7099999999989848,59,38,6502.44,6501.7300000000005
14811,U12277,97,-7403.7200000000375,70,27,400627.86,393224.13999999996
14812,U27823,97,-8641.140000000003,70,27,173086.98,164445.84
14813,U27785,97,3948.1,66,31,40529.31,44477.409999999996
14814,U18700,96,-5468.66,84,12,20999.789999999997,15531.129999999997
14815,U1354909,96,-5906.629999999999,67,29,56400.69000000002,50494.06000000002
14816,U42289,96,71816.59,78,18,149823.33000000002,221639.92
14817,U41902,96,-190103.56999999998,81,15,2425248.740000001,2235145.1700000013
14818,U17052,96,-997494.54,65,31,7944726.84,6947232.3
14819,U32049,96,86.41999999999985,87,9,16978.1,17064.519999999997
14820,U28200,96,-2372.9400000000014,84,12,21617.850000000002,19244.91
14821,U43951,96,-4990.74,83,13,28060.700000000008,23069.960000000006
14822,U9542,96,-3235.2199999999993,87,9,14960.41,11725.19
14823,U29097,96,3335.6700000000005,87,9,15505.690000000004,18841.360000000004
14824,U8126,96,6060.549999999996,82,14,104553.91000000002,110614.46000000002
14825,U20479,96,-19438.530000000006,82,14,135442.68,116004.15
14826,U29730,96,996.3099999999995,83,13,24468.07,25464.379999999997
14827,U16072,96,386.74999999997965,50,46,773712.6799999999,774099.4299999999
14828,U26799,96,1609.9399999999991,93,3,17956.05,19565.989999999998
14829,U18181,96,-12007.189999999995,87,9,69453.70999999998,57446.51999999998
14830,U20419,96,-55966.31999999999,73,23,494026.49,438060.17
14831,U28050,96,-181.02999999999975,78,18,86374.88,86193.85
14832,U22536,96,-764.3199999999993,59,37,89206.2,88441.88
14833,U35562,96,-43601.91000000001,79,17,133666.07,90064.16
14834,U34053,96,21821.66999999999,82,14,222292.68,244114.34999999998
14835,U21380,96,5213.070000000298,38,58,36898836.49,36904049.56
14836,U29327,96,42341.55000000006,85,11,571717.06,614058.6100000001
14837,U13994,96,-6504.849999999998,75,21,35171.14000000001,28666.290000000008
14838,U30972,96,-90716.12999999998,74,22,378012.06000000006,287295.93000000005
14839,U31248,96,-969.7999999999998,85,11,5036.3,4066.5000000000005
14840,U30556,96,-3811349.419999999,69,27,18034688.68,14223339.260000002
14841,U12002,96,1637.8400000000029,85,11,20635.519999999997,22273.36
14842,U19495,96,19165.930000000004,66,30,164693.28999999998,183859.21999999997
14843,U38529,96,-1490.400000000002,89,7,32920.11,31429.71
14844,U20448,96,-8954.959999999983,86,10,69789.40000000001,60834.440000000024
14845,U19827,96,91815.43000000005,84,12,149771.87999999998,241587.31000000003
14846,U1294304,96,-6188.429999999999,73,23,37764.94999999999,31576.51999999999
14847,U27347,96,-3687.119999999996,82,14,60679.86,56992.740000000005
14848,U35186,96,47743.719999999936,70,26,1160934.81,1208678.53
14849,U33719,96,1839.2899999999972,89,7,15163.340000000002,17002.629999999997
14850,U29734,96,-11371.729999999985,79,17,544195.6299999999,532823.8999999999
14851,U42314,96,-2847.16,57,39,37677.43,34830.270000000004
14852,U10502,96,-36913.36000000001,82,14,146327.30999999997,109413.94999999995
14853,U21306,96,-5057.709999999993,86,10,69966.79000000001,64909.080000000016
14854,U26953,96,46222.73000000001,60,36,803299.66,849522.39
14855,U33372,96,-16499.05000000001,83,13,116415.6,99916.54999999999
14856,U18180,96,-35380.50000000003,84,12,68778.26000000001,33397.75999999998
14857,U12866,96,-16074.4,80,16,124749.80999999998,108675.40999999999
14858,U24221,96,-2444.2500000000036,74,22,49619.009999999995,47174.759999999995
14859,U10874,96,-51279.65999999998,80,16,192365.07,141085.41000000003
14860,U34572,96,-27381.74999999994,71,25,630426.3799999999,603044.6299999999
14861,U39436,96,-2796.0700000000106,76,20,141362.01,138565.94
14862,U32670,96,33921.950000000004,83,13,31940.509999999995,65862.45999999999
14863,U32805,96,51161.03,86,10,122465.05999999998,173626.08999999997
14864,U32229,96,10585.180000000008,77,19,329888.38,340473.56
14865,U41377,96,-32225.869999999995,72,24,266957.4,234731.53000000003
14866,U16465,96,-7630.299999999996,62,34,235062.87999999998,227432.58
14867,U18579,96,14727.289999999974,79,17,302492.30999999994,317219.5999999999
14868,U30194,96,-4230.110000000001,78,18,64890.409999999996,60660.299999999996
14869,U28280,96,-7818.999999999999,95,1,11108.999999999996,3289.9999999999973
14870,U32898,96,-15009.460000000005,82,14,148505.18,133495.72
14871,U39681,96,-11708.250000000053,67,29,250848.71,239140.45999999993
14872,U19776,96,-1667.6799999999985,78,18,31554.56,29886.880000000005
14873,U26276,96,-16014.84000000007,43,53,1132931.5,1116916.66
14874,U15003,96,-10434.339999999998,78,18,43520.09,33085.75
14875,U34809,96,-75301.43000000004,73,23,375843.82000000007,300542.39
14876,U15869,96,-6328.620000000004,76,20,73251.38,66922.76
14877,U39110,96,2039.079999999961,51,45,1208903.2500000002,1210942.3300000003
14878,U1137638,96,1732.5699999999995,56,40,21582.59,23315.16
14879,U33158,96,-6594.269999999999,89,7,48106.05999999999,41511.78999999999
14880,U31678,96,-296931.41,79,17,311890.17,14958.76000000001
14881,U30052,96,-119652.60999999999,75,21,395038.52999999997,275385.92
14882,U8442,96,-39262.65000000001,89,7,58050.96,18788.30999999999
14883,U917241,96,-77.7700000000001,50,46,6324.9100000000035,6247.140000000003
14884,U1273796,96,-9361.249999999998,60,36,53600.85999999999,44239.60999999999
14885,U31166,96,-179.8900000000093,85,11,207921.39,207741.5
14886,U28729,96,-525.2599999999929,82,14,39789.630000000005,39264.37000000001
14887,U25526,96,36826.31999999999,62,34,335756.28,372582.60000000003
14888,U40276,96,5366.839999999989,91,5,106273.91999999998,111640.75999999998
14889,U24307,96,-26062.130000000005,63,33,225389.23,199327.1
14890,U30766,96,53167.70000000002,60,36,274725.49000000005,327893.19000000006
14891,U36422,96,-10621.399999999996,64,32,59043.78,48422.380000000005
14892,U20636,96,17480.299999999992,68,28,173462.41000000003,190942.71000000002
14893,U43602,96,4461.150000000002,75,21,71807.34,76268.49
14894,U41494,96,421.6199999999974,78,18,31775.550000000003,32197.170000000002
14895,U23838,96,-23578.71000000001,65,31,419004.72,395426.00999999995
14896,U22832,96,1725.0299999999943,72,24,69250.18000000001,70975.21
14897,U32059,96,161695.52000000005,51,45,261837.00999999998,423532.53
14898,U1320355,96,-4281.970000000001,60,36,80053.70999999999,75771.73999999999
14899,U34670,96,594.9499999999998,50,46,18987.739999999998,19582.69
14900,U35599,96,-1411.75,78,18,136838.92,135427.17
14901,U42015,96,10222.65,81,15,16239.18,26461.83
14902,U11505,96,-50477.450000000004,83,13,119198.62000000001,68721.17000000001
14903,U25925,96,-25988.30999999999,81,15,386181.20999999996,360192.89999999997
14904,U20676,96,-21266.82999999999,94,2,21308.719999999994,41.890000000003056
14905,U33439,96,70856.0,82,14,265061.76,335917.76
14906,U34280,96,-1275.3000000000006,77,19,11892.37,10617.07
14907,U40186,96,1463.4800000000005,79,17,55267.43,56730.91
14908,U24129,96,-85305.54,78,18,581669.6699999999,496364.12999999995
14909,U23807,96,24931.58000000001,84,12,239394.25,264325.83
14910,U17218,96,-5747.109999999999,76,20,33659.04,27911.93
14911,U40590,96,2267.3900000000012,67,29,63617.600000000006,65884.99
14912,U18101,96,-38935.99000000001,83,13,60288.07,21352.079999999987
14913,U16952,96,-15731.050000000003,58,38,537140.54,521409.49000000005
14914,U25032,96,-17086.59000000001,75,21,266198.45,249111.86
14915,U27339,96,-102181.64,55,41,397315.94,295134.3
14916,U17573,96,-4185.930000000131,70,26,856728.0599999998,852542.1299999997
14917,U38942,96,11238.539999999994,73,23,199465.7399999999,210704.2799999999
14918,U905915,96,-457.73000000000184,55,41,45553.95,45096.219999999994
14919,U17251,96,-1242.910000000008,73,23,366401.99000000005,365159.08
14920,U25129,96,281966.97,75,21,449969.1,731936.07
14921,U21643,96,896.1099999999906,73,23,517386.27,518282.38
14922,U33548,96,134446.8,83,13,64912.37,199359.16999999998
14923,U18918,96,-54160.97,84,12,113332.68,59171.70999999999
14924,U1147633,96,-8.249999999998181,50,46,33608.53,33600.28
14925,U17496,96,-13203.890000000001,86,10,40651.99,27448.1
14926,U26606,96,9521.239999999874,57,39,2076821.29,2086342.5299999998
14927,U25647,96,-513.939999999995,74,22,75557.70000000001,75043.76000000001
14928,U43172,96,-12332.3,91,5,45725.03,33392.729999999996
14929,U10915,96,-157350.46999999994,90,6,158791.68999999994,1441.2200000000012
14930,U8546,96,-30347.54999999999,69,27,211608.33,181260.78
14931,U33537,96,-40530.01999999999,87,9,121317.34999999999,80787.33
14932,U15411,96,112266.82999999965,64,32,14177966.100000001,14290232.930000002
14933,U17539,96,-63728.31000000001,72,24,707830.0000000001,644101.6900000001
14934,U25675,96,-5591.059999999987,83,13,72664.9,67073.84000000001
14935,U13561,96,138672.40000000002,76,20,439714.06999999995,578386.47
14936,U945643,96,791.9199999999955,56,40,68136.90000000001,68928.82
14937,U17160,96,-234249.71999999994,87,9,1549987.72,1315738.0
14938,U25424,96,46.4900000000008,63,33,54330.81999999999,54377.30999999999
14939,U30515,96,-315050.20000000007,64,32,6389603.42,6074553.22
14940,U28878,96,-10.090000000001055,75,21,16109.419999999996,16099.329999999994
14941,U13709,96,28640.920000000006,89,7,21242.799999999996,49883.72
14942,U24882,95,-4225.229999999995,78,17,56318.22000000001,52092.99000000001
14943,U31602,95,26152.179999999935,48,47,3533257.1000000006,3559409.2800000003
14944,U20800,95,-49041.80999999998,72,23,746740.3799999999,697698.57
14945,U35310,95,141.61000000000058,75,20,90442.15,90583.76
14946,U22718,95,14037.490000000009,42,53,538408.42,552445.91
14947,U26177,95,396.25999999999567,63,32,57485.13,57881.38999999999
14948,U30979,95,79067.62999999995,50,45,816815.34,895882.97
14949,U21939,95,-11750.240000000224,55,40,3103055.01,3091304.7699999996
14950,U41406,95,-9801.479999999996,51,44,220192.73,210391.25
14951,U9345,95,-11278.939999999995,79,16,83235.48000000001,71956.54000000001
14952,U16266,95,-83268.9,83,12,170207.73,86938.83000000002
14953,U11670,95,-7596.600000000002,68,27,233693.36999999997,226096.76999999996
14954,U9654,95,10759.639999999996,73,22,74916.76999999997,85676.40999999997
14955,U21489,95,-8741.620000000057,78,17,463096.13,454354.50999999995
14956,U41978,95,-11256.659999999996,83,12,86174.68999999999,74918.03
14957,U33746,95,2201.360000000004,77,18,59483.86,61685.22
14958,U17529,95,24892.52000000001,64,31,125841.05,150733.57
14959,U19879,95,115207.91999999993,86,9,242208.54,357416.45999999996
14960,U37054,95,-73040.67000000003,75,20,430174.79000000004,357134.12
14961,U1067093,95,-430.1100000000002,75,20,4862.57,4432.459999999999
14962,U38294,95,-62994.62,85,10,72617.87,9623.249999999993
14963,U17566,95,22701.330000000016,59,36,730309.4999999998,753010.8299999998
14964,U25817,95,-14486.96,83,12,56079.100000000006,41592.14000000001
14965,U35830,95,-21678.260000000002,88,7,39201.15999999999,17522.899999999987
14966,U598656,95,-2226.9199999999987,74,21,24472.2,22245.280000000002
14967,U11814,95,22780.48999999999,77,18,44810.740000000005,67591.23
14968,U26741,95,-6066.989999999998,70,25,67271.89,61204.9
14969,U33564,95,-2898.07,82,13,40129.299999999996,37231.229999999996
14970,U40376,95,128789.87999999996,82,13,181075.89,309865.76999999996
14971,U9152,95,2594.059999999946,70,25,1239270.66,1241864.72
14972,U27280,95,4111.070000000004,67,28,101975.83,106086.90000000001
14973,U13434,95,-3578.119999999996,60,35,484490.93,480912.81
14974,U8061,95,-95403.56,72,23,1673952.68,1578549.1199999999
14975,U37091,95,45886.729999999974,73,22,387098.02999999997,432984.75999999995
14976,U43603,95,-970.310000000003,90,5,11254.520000000002,10284.21
14977,U36878,95,21089.129999999997,77,18,120048.51,141137.63999999998
14978,U41662,95,-720.2000000000005,90,5,9839.650000000001,9119.45
14979,U34410,95,21322.34999999999,66,29,296461.36000000004,317783.71
14980,U607061,95,-1790.1600000000008,66,29,37037.86000000001,35247.700000000004
14981,U1330325,95,-12003.429999999998,64,31,60911.08000000001,48907.65000000001
14982,U26708,95,98653.90000000014,75,20,1510647.48,1609301.3800000001
14983,U8301,95,-2434.6499999999987,83,12,71587.76000000001,69153.11000000002
14984,U34353,95,725.1700000000046,80,15,28759.78,29484.950000000004
14985,U28363,95,11946.55,62,33,313068.39999999997,325014.94999999995
14986,U38259,95,-23752.589999999997,79,16,156152.4,132399.81
14987,U910819,95,30819.530000000006,65,30,45164.65999999999,75984.19
14988,U8875,95,86994.37,81,14,143703.71999999994,230698.08999999994
14989,U11207,95,-26434.999999999993,56,39,490659.06999999995,464224.06999999995
14990,U28278,95,-57638.729999999996,77,18,163516.69,105877.96
14991,U21069,95,213458.43999999992,73,22,4006004.7900000005,4219463.23
14992,U42640,95,-513.0600000000006,73,22,22632.870000000003,22119.81
14993,U8362,95,1389.6100000000004,85,10,10328.11,11717.720000000001
14994,U21892,95,-844.3800000000003,82,13,28832.120000000003,27987.74
14995,U41098,95,10165.34,79,16,36574.01,46739.350000000006
14996,U35071,95,-10667.640000000003,69,26,165101.66999999993,154434.0299999999
14997,U37291,95,-6231.270000000028,52,43,609126.76,602895.49
14998,U13833,95,-7900.179999999984,71,24,180128.74,172228.56
14999,U17829,95,-1722.88,82,13,101015.44999999998,99292.56999999998
15000,U12348,95,-148.04000000000087,59,36,63270.39000000001,63122.350000000006
15001,U33238,95,8514.479999999992,84,11,157593.87,166108.34999999998
15002,U20374,95,-950.5200000000068,68,27,188586.44999999992,187635.9299999999
15003,U28114,95,-16504.190000000002,63,32,164732.0,148227.81
15004,U15914,95,22164.699999999993,74,21,625587.6100000001,647752.31
15005,U20423,95,-96108.02999999998,68,27,1076815.69,980707.6599999999
15006,U15717,95,-21622.239999999925,78,17,892470.8299999998,870848.59
15007,U40118,95,289614.4100000005,53,42,3964476.2,4254090.61
15008,U31800,95,-2282.72,78,17,7511.45,5228.73
15009,U12623,95,-21082.909999999996,79,16,196390.81000000003,175307.90000000002
15010,U32483,95,42093.97,61,34,94968.22,137062.19
15011,U9737,95,818.0499999999997,82,13,12599.94,13417.99
15012,U37362,95,-7578.459999999963,77,18,1366538.6400000001,1358960.1800000002
15013,U31686,95,2638.3200000000024,86,9,157422.13,160060.45
15014,U8992,95,-7518.27,81,14,56771.62,49253.350000000006
15015,U12934,95,-5014.809999999999,86,9,130099.96,125085.15000000001
15016,U22724,95,3858.760000000012,80,15,241841.46999999997,245700.22999999998
15017,U24767,95,-49514.890000000014,47,48,1284875.91,1235361.02
15018,U16364,95,4434.680000000014,75,20,388066.1699999999,392500.8499999999
15019,U27970,95,598.0500000000014,80,15,35582.3,36180.350000000006
15020,U31221,95,-10802.139999999996,84,11,57351.13999999999,46549.0
15021,U20652,95,-32790.020000000004,86,9,136070.62,103280.59999999999
15022,U23648,95,-603.9299999999994,80,15,34059.479999999996,33455.549999999996
15023,U21969,95,4266.11,68,27,6716.600000000005,10982.710000000005
15024,U34758,95,-4024.3600000000015,82,13,39960.40000000001,35936.04000000001
15025,U26404,95,-963.8499999999698,47,48,363051.16000000003,362087.31000000006
15026,U22518,95,-86113.72,60,35,129608.99,43495.270000000004
15027,U38842,95,-456.9600000001822,64,31,908916.4800000002,908459.52
15028,U28412,95,4619.38,88,7,16072.349999999999,20691.73
15029,U17445,95,109105.85999999999,60,35,139353.91999999998,248459.77999999997
15030,U39713,95,-15464.62,65,30,158051.52000000002,142586.90000000002
15031,U43677,95,-96393.23000000001,86,9,428126.38000000006,331733.15
15032,U27633,95,403707.50999999995,78,17,137964.9,541672.4099999999
15033,U16632,95,1862.29,88,7,20340.899999999998,22203.19
15034,U9961,95,-2015.3099999999836,67,28,264526.0,262510.69
15035,U25115,95,-17.080000000001338,90,5,5237.180000000001,5220.099999999999
15036,U42079,95,21299.15999999998,65,30,667349.82,688648.98
15037,U42973,95,9128.06,82,13,9489.12,18617.18
15038,U31804,95,1274.6799999999992,83,12,25685.570000000007,26960.250000000007
15039,U43028,95,5236.9100000000035,83,12,25991.98,31228.890000000003
15040,U1138549,95,6479.4899999999725,57,38,110736.65,117216.13999999997
15041,U11357,95,-19515.36000000002,81,14,139149.81,119634.44999999998
15042,U36401,95,11228.520000000004,84,11,35593.57000000001,46822.09000000001
15043,U41034,95,-3642.7000000000935,65,30,9402775.34,9399132.64
15044,U26837,95,15310.149999999994,53,42,26285.329999999998,41595.479999999996
15045,U24953,95,276082.99000000017,82,13,233155.68999999992,509238.68000000005
15046,U21898,95,-35262.04,81,14,212851.39999999997,177589.35999999996
15047,U1330650,95,-12147.219999999994,70,25,183632.27000000002,171485.05000000002
15048,U33061,95,20745.570000000007,75,20,253544.6,274290.17000000004
15049,U38482,95,-248.62999999999997,86,9,3218.4199999999996,2969.7899999999995
15050,U20619,95,5337.880000000005,73,22,384595.86,389933.74
15051,U14865,95,-24268.66999999999,50,45,105568.10999999999,81299.44
15052,U15121,95,-30165.84999999999,80,15,198454.18,168288.33000000002
15053,U8239,95,585.8099999999977,74,21,114237.37000000001,114823.18000000001
15054,U16840,95,-29381.66000000001,63,32,200070.81999999998,170689.15999999997
15055,U24734,95,12979.380000000001,67,28,157716.18000000002,170695.56000000003
15056,U23605,95,41910.88000000001,67,28,795731.5399999999,837642.4199999999
15057,U40333,95,-103977.69,82,13,206286.22,102308.53
15058,U11657,95,20165.569999999992,83,12,36174.43000000001,56340.0
15059,U21636,95,1669.670000000002,60,35,269972.82999999996,271642.49999999994
15060,U20111,95,-29589.400000000012,78,17,275255.22,245665.81999999995
15061,U32126,95,-0.849999999973079,50,45,678347.8200000001,678346.9700000001
15062,U11754,95,-106776.50999999995,61,34,628033.4300000002,521256.9200000002
15063,U38419,95,-2398.9999999999973,84,11,124387.59000000003,121988.59000000003
15064,U33996,95,-4265.199999999981,71,24,239859.07,235593.87000000002
15065,U33447,95,-1369.7500000000002,89,6,6311.99,4942.24
15066,U25616,95,4640.060000000116,60,35,1309350.46,1313990.52
15067,U11412,95,385.8799999999974,87,8,35371.729999999996,35757.60999999999
15068,U35298,95,-6421.200000000004,60,35,152026.01,145604.81
15069,U42460,95,-14772.529999999999,62,33,72940.79000000001,58168.26000000001
15070,U24929,95,-724.3299999999988,88,7,14972.730000000001,14248.400000000003
15071,U40877,95,669.2000000000021,52,43,866715.94,867385.1399999999
15072,U12255,95,-1952.8199999999943,58,37,359716.61,357763.79
15073,U43231,95,-151.1199999999999,83,12,16762.120000000003,16611.000000000004
15074,U43356,95,-10001.509999999998,91,4,20781.62,10780.11
15075,U39600,95,55706.780000000006,64,31,232761.49,288468.27
15076,U26192,95,-1061.899999999988,85,10,198964.0,197902.1
15077,U41547,95,-241554.65000000005,63,32,1793195.77,1551641.1199999999
15078,U10010,95,-727.2599999999998,69,26,8767.699999999997,8040.439999999997
15079,U15827,95,-10070.089999999982,53,42,753074.3999999999,743004.3099999999
15080,U36538,95,143907.35,87,8,26638.49,170545.84
15081,U15259,95,-45382.180000000015,77,18,111388.75,66006.56999999998
15082,U21709,95,36688.82000000001,79,16,5687001.56,5723690.38
15083,U18132,95,46812.99999999999,79,16,95001.97999999998,141814.97999999998
15084,U8134,95,22591.330000000013,64,31,202315.35000000015,224906.68000000017
15085,U33711,95,-6059.489999999998,84,11,203088.47000000006,197028.98000000007
15086,U33826,95,-24436.679999999982,77,18,303202.93,278766.25
15087,U19580,95,-2569.0600000000054,69,26,92419.57999999999,89850.51999999997
15088,U42127,95,725.2199999999979,85,10,52591.66999999999,53316.88999999999
15089,U28374,95,-412.75000000000125,81,14,28308.139999999996,27895.389999999996
15090,U40582,95,-7244.59,91,4,46088.0,38843.41
15091,U38694,95,4011.5899999999965,61,34,154268.40999999995,158279.99999999994
15092,U41747,95,-2184.840000000001,82,13,22114.600000000002,19929.760000000002
15093,U37331,94,-33405.05,72,22,116322.22,82917.17
15094,U40746,94,32602.580000000013,87,7,23950.129999999994,56552.71000000001
15095,U38537,94,-181699.4400000001,78,16,898015.0700000002,716315.6300000001
15096,U11581,94,-24491.010000000006,81,13,63651.3,39160.28999999999
15097,U1381462,94,-6899.999999999999,70,24,119322.45000000003,112422.45000000003
15098,U12608,94,-10808.23000000001,74,20,366174.5700000001,355366.3400000001
15099,U32138,94,-5330.97000000001,60,34,425666.60000000003,420335.63
15100,U17722,94,5727.750000000004,76,18,113573.86000000002,119301.61000000002
15101,U19496,94,-35837.19999999999,70,24,88267.41,52430.210000000014
15102,U8632,94,-2934.089999999973,76,18,388203.33,385269.24000000005
15103,U42471,94,-21511.089999999986,60,34,392909.66000000003,371398.57000000007
15104,U23180,94,-3042.91,74,20,54694.329999999994,51651.42
15105,U9092,94,-97.46000000000004,79,15,52473.409999999996,52375.95
15106,U8680,94,154673.58,61,33,1006655.13,1161328.71
15107,U39737,94,362864.02,74,20,152555.51,515419.53
15108,U35999,94,6913.989999999997,70,24,92635.60999999997,99549.59999999996
15109,U35657,94,-42095.920000000006,74,20,316872.41000000003,274776.49000000005
15110,U32795,94,-7158.04,76,18,1442688.1200000003,1435530.0800000003
15111,U34312,94,60337.25000000002,49,45,212373.90000000002,272711.15
15112,U1207696,94,2790.330000000005,73,21,40222.780000000006,43013.11000000001
15113,U42892,94,-1078.1100000000042,77,17,53171.46,52093.34999999999
15114,U39022,94,-1192.9900000000187,62,32,763272.93,762079.9400000001
15115,U9827,94,930.1000000000006,90,4,21380.029999999995,22310.129999999997
15116,U33822,94,1680.5100000000025,64,30,168648.28999999998,170328.8
15117,U14272,94,-5081.77,83,11,44808.86,39727.09
15118,U1222544,94,14645.599999999999,45,49,46586.0,61231.6
15119,U22776,94,1843.979999999999,92,2,9753.49,11597.47
15120,U951653,94,-29.26000000000016,61,33,8292.0,8262.74
15121,U20457,94,-352715.70000000007,76,18,1511777.3699999999,1159061.67
15122,U23124,94,1554.3100000000559,72,22,704243.0900000001,705797.4000000001
15123,U35473,94,-68340.55,82,12,130331.59000000001,61991.04000000001
15124,U31676,94,2432.47,84,10,15140.960000000001,17573.43
15125,U29737,94,-3064.7300000000037,79,15,49049.939999999995,45985.20999999999
15126,U27861,94,17035.49,85,9,10238.9,27274.39
15127,U8486,94,1675.2400000000143,67,27,337966.81000000006,339642.05000000005
15128,U30714,94,-3717.850000000007,83,11,156546.35000000003,152828.50000000003
15129,U9771,94,-11771.509999999995,80,14,343131.01000000007,331359.50000000006
15130,U12147,94,-691.1199999999234,62,32,504546.13,503855.01000000007
15131,U20580,94,13895.02000000001,74,20,218885.39000000004,232780.41000000006
15132,U19316,94,145.98000000000184,55,39,31511.84,31657.820000000003
15133,U9493,94,-2176.1600000000035,69,25,319401.12,317224.95999999996
15134,U1265751,94,-10.380000000000734,68,26,27303.489999999998,27293.109999999997
15135,U24132,94,2226.68000000005,76,18,1648252.28,1650478.96
15136,U25372,94,-16634.899999999972,60,34,464179.67,447544.77
15137,U20778,94,-5084.409999999999,83,11,11820.080000000002,6735.670000000003
15138,U18957,94,-151803.09999999986,72,22,406312.32,254509.22000000015
15139,U20138,94,20766.42,85,9,31520.12,52286.53999999999
15140,U23230,94,101837.39,56,38,543833.53,645670.92
15141,U30448,94,6999.479999999998,67,27,1382746.2400000002,1389745.7200000002
15142,U21175,94,-11206.740000000009,84,10,131328.99,120122.24999999999
15143,U1307837,94,739.2099999999992,55,39,40321.619999999995,41060.829999999994
15144,U27545,94,-237.9999999999991,71,23,39169.02,38931.02
15145,U37695,94,11742.720000000001,25,69,87630.34000000001,99373.06000000001
15146,U29746,94,-93977.13000000022,59,35,2114379.519999999,2020402.389999999
15147,U32496,94,-8411.389999999998,73,21,145070.0,136658.61000000002
15148,U903412,94,-3083.5499999999997,89,5,7834.100000000001,4750.550000000001
15149,U11326,94,153903.16,74,20,58627.35,212530.51
15150,U15039,94,-23861.68,76,18,140138.93,116277.25
15151,U31737,94,-33368.69000000002,71,23,129573.59000000003,96204.90000000001
15152,U32937,94,-16913.64999999996,82,12,941220.6699999999,924307.02
15153,U37157,94,2330.510000000002,79,15,16954.96,19285.47
15154,U42819,94,-6981.93,72,22,38075.06999999999,31093.139999999992
15155,U9450,94,-17382.250000000233,61,33,4227821.1899999995,4210438.9399999995
15156,U38732,94,-33655.42,74,20,344887.77999999997,311232.36
15157,U43646,94,-36.409999999999926,84,10,11796.440000000017,11760.030000000017
15158,U903645,94,-5307.1399999999985,65,29,28126.940000000006,22819.800000000007
15159,U818997,94,-4821.34,69,25,23581.73,18760.39
15160,U36960,94,-342.5199999999986,73,21,36355.91,36013.39000000001
15161,U14933,94,396619.56999999995,56,38,1587081.04,1983700.6099999999
15162,U18322,94,3033.500000000034,81,13,182692.81999999995,185726.31999999998
15163,U28378,94,-32573.540000000005,86,8,176131.82,143558.28
15164,U11498,94,5185.85999999969,74,20,3033114.28,3038300.1399999997
15165,U9703,94,-2957.659999999977,74,20,229722.69999999995,226765.03999999998
15166,U42863,94,-57199.52999999999,73,21,225640.99000000005,168441.46000000005
15167,U12591,94,71.72000000000077,82,12,8364.8,8436.52
15168,U17057,94,-90472.54999999997,89,5,127114.24999999997,36641.7
15169,U32556,94,3393.2700000000013,67,27,88315.98,91709.25
15170,U42461,94,-46584.489999999976,70,24,196561.04,149976.55000000005
15171,U43662,94,220.52999999999986,86,8,19530.41,19750.94
15172,U40211,94,-595548.1600000001,80,14,985449.1900000001,389901.0299999999
15173,U33032,94,-16659.979999999996,89,5,16846.24,186.26000000000568
15174,U39564,94,-4112.5,60,34,74222.31,70109.81
15175,U10039,94,-6451.609999999999,76,18,58190.25,51738.64
15176,U13539,94,37825.77,78,16,382984.0,420809.77
15177,U43480,94,-2665.9800000000178,75,19,551059.1000000001,548393.1200000001
15178,U12807,94,3199.0199999999995,75,19,48481.96000000001,51680.98
15179,U29957,94,26280.159999999985,76,18,121442.04000000002,147722.2
15180,U30500,94,9345.39,68,26,124051.26000000001,133396.65000000002
15181,U9220,94,-11132.32,75,19,73150.00000000001,62017.680000000015
15182,U17654,94,672.8899999998484,59,35,523553.22000000003,524226.10999999987
15183,U15023,94,-56334.549999999974,76,18,286429.87,230095.32
15184,U21591,94,-15384.98,76,18,55009.59,39624.61
15185,U42198,94,53367.09999999993,46,48,2219422.35,2272789.45
15186,U34958,94,-1663.2599999999995,77,17,19818.990000000005,18155.730000000007
15187,U18677,94,-6694.939999999997,89,5,13345.409999999998,6650.470000000001
15188,U11069,94,32809.739999999976,60,34,190428.87,223238.61
15189,U28811,94,5865.509999999995,54,40,157487.41999999998,163352.93
15190,U42878,94,2026.9500000000053,88,6,13789.2,15816.150000000005
15191,U990687,94,0.1800000000019395,70,24,27954.840000000004,27955.020000000004
15192,U35014,94,424.74999999999955,89,5,11613.22,12037.97
15193,U18276,94,22787.699999999968,74,20,396632.64,419420.33999999997
15194,U11035,94,11728.130000000012,58,36,110902.75000000001,122630.88000000003
15195,U36852,94,71.53000000000355,81,13,15113.519999999999,15185.050000000003
15196,U1133926,94,-2313.6700000000005,63,31,7506.28,5192.609999999999
15197,U24649,94,-25531.899999999987,68,26,304626.87999999995,279094.98
15198,U8678,94,250.59999999999945,74,20,38856.65,39107.25
15199,U1201405,94,246.4499999999996,51,43,142154.79,142401.24000000002
15200,U23803,94,-3580.090000000024,53,41,780768.5299999999,777188.44
15201,U28887,94,-8429.210000000006,63,31,486601.48999999993,478172.2799999999
15202,U11567,94,-24952.179999999986,76,18,169252.71,144300.53
15203,U8948,94,-14454.55,82,12,53597.95000000001,39143.40000000001
15204,U39774,94,-3247.170000000042,65,29,1688318.83,1685071.6600000001
15205,U12684,94,-17900.21,78,16,69897.12,51996.909999999996
15206,U29878,94,-46776.94,76,18,275653.88,228876.94
15207,U26286,94,2299.750000000001,82,12,15886.45,18186.2
15208,U38072,94,-8954.439999999999,87,7,24665.299999999996,15710.859999999997
15209,U15431,94,-2066.6799999999994,59,35,53406.18000000001,51339.50000000001
15210,U17180,94,-41530.049999999996,77,17,110380.62,68850.57
15211,U30153,94,580448.4500000004,39,55,3236556.65,3817005.1000000006
15212,U16396,94,15762.349999999995,75,19,137592.7,153355.05000000002
15213,U26370,94,-2585.339999999993,71,23,109490.13,106904.79000000001
15214,U23870,94,315.8600000000038,70,24,17457.530000000002,17773.390000000007
15215,U35502,94,59623.96999999995,50,44,2576078.57,2635702.5399999996
15216,U15118,94,-45908.77999999999,73,21,394996.43,349087.65
15217,U41056,94,-125974.9,66,28,649426.29,523451.39
15218,U43797,94,48098.560000000005,83,11,27522.190000000002,75620.75
15219,U27040,94,-3112.8800000000083,57,37,224318.17,221205.29
15220,U17178,94,575631.0399999997,75,19,579317.13,1154948.1699999997
15221,U19636,94,-6684.2699999999995,79,15,19814.05,13129.779999999999
15222,U9472,94,-94681.86,84,10,144017.0,49335.14
15223,U21036,94,-12397.500000000004,85,9,74838.51000000001,62441.01000000001
15224,U41750,94,-5172.13,80,14,50419.23000000001,45247.10000000001
15225,U1338197,94,-1602.6199999999994,56,38,46307.270000000004,44704.65
15226,U25776,94,-5594.24,88,6,22730.679999999993,17136.439999999995
15227,U27448,94,6130.010000000002,84,10,20410.94,26540.95
15228,U35593,94,-761.56,82,12,26408.02,25646.46
15229,U31236,94,-4339.240000000003,74,20,164337.86000000004,159998.62000000005
15230,U42617,94,-11008.740000000005,78,16,41878.659999999996,30869.91999999999
15231,U23490,94,15215.539999999997,74,20,173298.84,188514.38
15232,U29362,94,42320.45,78,16,26309.76,68630.20999999999
15233,U22983,94,-62117.94,78,16,240672.5,178554.56
15234,U9611,94,-10880.09,58,36,108836.88999999998,97956.79999999999
15235,U18682,94,-19135.2,67,27,58181.240000000005,39046.04000000001
15236,U15460,94,-23981.619999999948,69,25,473175.6699999999,449194.05
15237,U15883,94,24123.609999999968,68,26,1023753.5299999999,1047877.1399999999
15238,U15549,94,4881.009999999999,73,21,59813.63999999999,64694.649999999994
15239,U34527,94,935.6599999999962,80,14,69870.8,70806.45999999999
15240,U37861,94,7337.05,72,22,25021.29,32358.34
15241,U38530,93,-4984.249999999997,76,17,42358.39,37374.14
15242,U41745,93,3168.2599999999948,72,21,158493.7,161661.96000000002
15243,U30541,93,-10211.650000000021,78,15,477762.35999999987,467550.70999999985
15244,U34578,93,12687.390000000003,63,30,149133.13,161820.52000000002
15245,U19883,93,44412.38000000001,82,11,119252.16,163664.54
15246,U34419,93,15529.390000000001,61,32,121004.36000000002,136533.75000000003
15247,U30631,93,-9468.399999999998,74,19,197051.68000000002,187583.28000000003
15248,U29812,93,10632.940000000006,81,12,145440.37999999998,156073.31999999998
15249,U40592,93,-10172.599999999999,77,16,96954.18,86781.57999999999
15250,U8881,93,-7650.5,71,22,133051.15,125400.65
15251,U10683,93,-88937.89,62,31,438246.8,349308.91
15252,U39389,93,164236.27999999994,56,37,2608942.54,2773178.82
15253,U1088510,93,42.60000000000191,53,40,25657.17,25699.77
15254,U43506,93,6327.499999999997,73,20,71885.97000000002,78213.47000000002
15255,U35888,93,20545.46000000002,63,30,1719288.68,1739834.14
15256,U24909,93,-5657.269999999984,67,26,327634.9100000001,321977.64000000013
15257,U12327,93,572482.21,42,51,955740.62,1528222.83
15258,U38912,93,16540.229999999996,69,24,38276.490000000005,54816.72
15259,U33658,93,-50170.2,64,29,108205.0,58034.8
15260,U33549,93,337547.61000000004,55,38,428916.59,766464.2000000001
15261,U33627,93,219339.88,69,24,1520478.91,1739818.79
15262,U24962,93,-12209.43,54,39,232352.89,220143.46000000002
15263,U29903,93,-18903.13,81,12,52862.159999999996,33959.03
15264,U42246,93,-1169422.6800000002,72,21,2066038.85,896616.1699999999
15265,U30989,93,-2375.619999999999,68,25,25890.339999999997,23514.719999999998
15266,U21138,93,-24744.78000000007,81,12,3810730.7100000014,3785985.930000001
15267,U28761,93,-730.1599999999971,70,23,63807.77000000001,63077.610000000015
15268,U9550,93,1206.79,88,5,4095.6200000000003,5302.41
15269,U37028,93,-594.4299999999979,71,22,34301.920000000006,33707.490000000005
15270,U12852,93,-147150.61999999903,46,47,13707801.630000005,13560651.010000005
15271,U32732,93,-115604.51,84,9,164315.3,48710.78999999999
15272,U29947,93,-156394.15999999995,62,31,577650.9400000002,421256.78000000026
15273,U35200,93,15222.130000000001,48,45,410468.04000000004,425690.17000000004
15274,U30275,93,-1991.029999999996,89,4,18022.799999999992,16031.769999999997
15275,U9143,93,17826.030000000028,65,28,439503.0999999999,457329.12999999995
15276,U39416,93,-11304.81,75,18,35735.340000000004,24430.530000000006
15277,U23897,93,-2826755.08,34,59,37468794.0,34642038.92
15278,U17201,93,6367.000000000153,68,25,1962802.18,1969169.1800000002
15279,U8247,93,4163.31,84,9,20121.29,24284.600000000002
15280,U15383,93,6002.30999999998,72,21,465814.97,471817.27999999997
15281,U42253,93,-6827.490000000004,60,33,795844.0,789016.51
15282,U16474,93,-403063.35999999987,60,33,2355146.38,1952083.02
15283,U16580,93,-492488.32999999996,73,20,897953.62,405465.29000000004
15284,U39635,93,-25483.410000000025,74,19,568268.26,542784.85
15285,U37319,93,-17788.160000000003,56,37,421468.32,403680.16000000003
15286,U26202,93,-468.99000000000524,72,21,256027.18999999997,255558.19999999995
15287,U39092,93,-114979.63999999996,69,24,867628.8400000001,752649.2000000002
15288,U25541,93,59624.880000000005,81,12,569303.34,628928.22
15289,U1166145,93,-1671.6299999999992,58,35,17193.739999999998,15522.109999999999
15290,U13446,93,15581.879999999983,61,32,729830.08,745411.96
15291,U13329,93,451890.73000000004,67,26,83187.53000000001,535078.26
15292,U9862,93,144882.2,58,35,272582.44,417464.64
15293,U35452,93,1865.7799999999993,71,22,5888.32,7754.0999999999985
15294,U42322,93,2136.6500000000015,71,22,87116.24999999999,89252.9
15295,U41556,93,-51772.350000000006,69,24,321199.09,269426.74
15296,U1209593,93,529.7800000000009,65,28,8718.61,9248.390000000001
15297,U15769,93,565.8100000000052,73,20,54508.69,55074.50000000001
15298,U15644,93,12070.319999999869,69,24,7658474.28,7670544.600000001
15299,U15641,93,-207.16000000002205,60,33,187262.08000000007,187054.92000000004
15300,U26699,93,611.5000000000023,79,14,49718.07,50329.57
15301,U21377,93,-19480.880000000005,62,31,2457959.25,2438478.37
15302,U37570,93,5508.889999999999,80,13,49869.42,55378.31
15303,U25159,93,-35893.529999999984,62,31,671219.3400000002,635325.8100000002
15304,U15296,93,-186720.75000000003,63,30,1017900.2499999997,831179.4999999997
15305,U29270,93,-48244.129999999976,87,6,53728.909999999974,5484.779999999999
15306,U14173,93,294047.01999999996,63,30,566320.1399999999,860367.1599999999
15307,U8955,93,-412.24999999999955,76,17,27227.010000000002,26814.760000000002
15308,U26880,93,5747.6500000000015,83,10,95297.30999999997,101044.95999999996
15309,U19327,93,-4042.9300000000194,73,20,218748.81000000003,214705.88
15310,U19098,93,181661.04,81,12,30240.97,211902.01
15311,U27562,93,-99124.60999999997,81,12,140050.36,40925.750000000015
15312,U12646,93,123218.27999999997,77,16,47398.87,170617.14999999997
15313,U12335,93,-910.7199999999939,72,21,257493.6,256582.88
15314,U38546,93,-75892.31,82,11,187175.40000000005,111283.09000000005
15315,U31934,93,24208.64000000001,67,26,69405.68,93614.32
15316,U22621,93,4693.369999999993,78,15,124311.70000000003,129005.07000000002
15317,U960664,93,12.63000000000008,65,28,2263.1499999999996,2275.7799999999997
15318,U43543,93,-3212.749999999999,86,7,16147.180000000006,12934.430000000008
15319,U1177342,93,-1.6499999999992951,56,37,13042.220000000001,13040.570000000002
15320,U22857,93,19639.36,79,14,21848.639999999996,41488.0
15321,U32788,93,-354.36000000002514,63,30,328934.64,328580.27999999997
15322,U33983,93,-11097.489999999996,76,17,49086.99,37989.5
15323,U9054,93,15883.58000000003,73,20,231363.87000000005,247247.45000000007
15324,U30437,93,8059.240000000003,60,33,165669.52000000002,173728.76
15325,U16644,93,-38461.19999999998,36,57,1563097.1800000002,1524635.9800000002
15326,U14758,93,5082.09,90,3,3923.07,9005.16
15327,U13314,93,1396.0000000000036,83,10,151736.89,153132.89
15328,U18812,93,-296871.7400000002,81,12,2810946.08,2514074.34
15329,U1071634,93,-7.700000000000017,73,20,1109.1,1101.3999999999999
15330,U39053,93,-513.7000000000006,66,27,31392.159999999996,30878.459999999995
15331,U15582,93,113800.31000000001,57,36,223589.94000000003,337390.25000000006
15332,U8490,93,325.5600000000064,71,22,285277.13,285602.69
15333,U33529,93,-2240.829999999958,66,27,1327569.5899999999,1325328.7599999998
15334,U17626,93,3540.429999999968,68,25,399034.18999999994,402574.61999999994
15335,U19751,93,43005.03999999999,38,55,164382.2,207387.24
15336,U26322,93,-3929.9599999999105,62,31,4092326.72,4088396.7600000002
15337,U12862,93,-50164.680000000066,68,25,883063.5700000001,832898.89
15338,U24032,93,1090.8299999999967,52,41,1249318.9599999995,1250409.7899999996
15339,U13992,93,2343.3600000000056,73,20,111146.43999999997,113489.79999999997
15340,U37018,93,-2648.1999999999994,89,4,13865.049999999997,11216.849999999999
15341,U36086,93,34719.8600000001,62,31,1923639.4,1958359.26
15342,U1264680,93,2.3000000000006366,49,44,87904.57,87906.87000000001
15343,U26594,93,212163.56,70,23,104490.71,316654.27
15344,U32489,93,3514.4700000000025,62,31,35816.33000000001,39330.80000000001
15345,U34533,93,-49161.159999999996,81,12,383783.1,334621.94
15346,U32044,93,-1129.5599999999868,74,19,223449.65,222320.09
15347,U36505,93,251.55000000000362,71,22,73823.57,74075.12000000001
15348,U13208,93,-8909.14,83,10,30233.05,21323.91
15349,U32722,93,-371.61999999999983,85,8,13023.079999999996,12651.459999999997
15350,U30619,93,6368.6799999999985,72,21,36973.51,43342.19
15351,U13567,93,-15365.399999999987,79,14,201595.80999999997,186230.40999999997
15352,U13738,93,-93663.11000000007,87,6,139362.90000000008,45699.79000000001
15353,U33480,93,-11990.909999999998,58,35,151556.92,139566.01
15354,U39731,93,4072.3799999999846,51,42,585952.29,590024.67
15355,U40328,93,6973.2300000000005,71,22,86407.05000000003,93380.28000000003
15356,U32617,93,-29195.75999999999,54,39,193653.49000000002,164457.73000000004
15357,U17924,93,-115015.70000000008,66,27,580521.5900000001,465505.89
15358,U17389,93,8431.549999999996,63,30,189418.88999999996,197850.43999999994
15359,U36815,93,9650.45,66,27,184135.72000000003,193786.17000000004
15360,U35307,93,-14265.419999999996,66,27,225983.06,211717.64
15361,U32283,93,-62943.5,73,20,548438.01,485494.51
15362,U20653,93,13358.539999999954,67,26,684836.8900000001,698195.43
15363,U11168,93,49752.58999999998,62,31,443609.23999999993,493361.8299999999
15364,U21206,93,15464.21,76,17,24389.709999999995,39853.92
15365,U43588,93,-42414.52999999999,80,13,425243.98000000004,382829.45000000007
15366,U19483,93,-8564.69,68,25,237526.96000000002,228962.27000000002
15367,U19852,93,10547.760000000002,78,15,125163.32,135711.08000000002
15368,U38641,93,31654.22000000001,66,27,451862.3500000001,483516.5700000001
15369,U28869,93,123300.26,79,14,156428.85,279729.11
15370,U14693,93,246312.26000000047,52,41,18739084.31,18985396.57
15371,U28828,93,-722.7300000000978,62,31,1207381.12,1206658.3900000001
15372,U15227,93,31821.149999999983,75,18,272108.04000000004,303929.19
15373,U26987,93,-7191.260000000001,80,13,80131.54000000001,72940.28000000001
15374,U27121,93,-3245.509999999983,70,23,391438.3700000001,388192.8600000001
15375,U25026,92,-226.67999999999847,67,25,36172.12000000001,35945.44000000001
15376,U21191,92,8037.049999999998,83,9,7477.49,15514.539999999997
15377,U24506,92,-2635.7899999999972,86,6,31236.349999999995,28600.559999999998
15378,U40739,92,-365.3899999999994,81,11,23705.219999999998,23339.829999999998
15379,U25841,92,114648.08,78,14,115664.65999999999,230312.74
15380,U15980,92,3456.160000000026,68,24,1251070.3299999998,1254526.4899999998
15381,U1263245,92,-10381.050000000001,63,29,30061.58,19680.53
15382,U16860,92,24053.960000000003,47,45,98384.68,122438.64
15383,U21985,92,1516.3599999999985,77,15,111421.42000000001,112937.78000000001
15384,U10557,92,3042.0899999999965,79,13,19077.93,22120.019999999997
15385,U16492,92,-5886.700000000004,78,14,113948.04999999999,108061.34999999998
15386,U24554,92,3489.37,86,6,38114.81999999998,41604.18999999998
15387,U8424,92,-36.66999999999986,82,10,14329.09,14292.42
15388,U38804,92,-4746.530000000001,71,21,59157.71,54411.18
15389,U33862,92,-6458.549999999999,70,22,205192.42,198733.87000000002
15390,U44056,92,-31061.989999999987,70,22,293217.49,262155.5
15391,U34747,92,-4674.359999999999,65,27,64496.16,59821.8
15392,U17477,92,6865.059999999973,54,38,987362.41,994227.47
15393,U39591,92,-21577.46,55,37,59555.10999999998,37977.64999999998
15394,U43393,92,-3901.1600000000044,80,12,146930.45999999996,143029.29999999996
15395,U27104,92,3517.9700000000016,73,19,28581.690000000002,32099.660000000003
15396,U32599,92,-92250.90000000001,81,11,138224.89,45973.990000000005
15397,U19027,92,-18227.089999999997,74,18,415515.42,397288.32999999996
15398,U43260,92,-1291.8999999999962,71,21,111982.92,110691.02
15399,U32868,92,24318.019999999993,73,19,216931.86,241249.87999999998
15400,U32591,92,41799.72999999998,76,16,57532.65000000002,99332.38
15401,U30754,92,19074.939999999973,55,37,277512.54,296587.48
15402,U13328,92,24416.56999999992,66,26,555765.4800000001,580182.05
15403,U10969,92,-2918.3300000000017,59,33,95703.66999999998,92785.33999999998
15404,U17609,92,9027.440000000006,88,4,126225.66000000002,135253.10000000003
15405,U11104,92,2991.3500000000013,76,16,27675.66,30667.010000000002
15406,U18831,92,36028.47,81,11,63478.899999999994,99507.37
15407,U22602,92,3038.0700000000006,81,11,39451.49,42489.56
15408,U24070,92,15523.53,66,26,54282.58000000001,69806.11000000002
15409,U16733,92,11994.909999999998,81,11,55738.439999999995,67733.34999999999
15410,U19913,92,-893.9499999999987,71,21,64043.49,63149.54
15411,U23647,92,-52003.07000000001,67,25,154315.94,102312.87
15412,U12670,92,-275.9399999999988,39,53,61272.93000000001,60996.990000000005
15413,U26413,92,31313.68999999999,57,35,86770.36000000002,118084.05
15414,U16375,92,96426.1,55,37,233197.94000000003,329624.04000000004
15415,U28070,92,8139.419999999998,84,8,12288.819999999998,20428.239999999998
15416,U16647,92,-29897.960000000006,85,7,380837.4,350939.44
15417,U31999,92,-901.4799999999994,71,21,13344.67,12443.19
15418,U34912,92,1522690.1099999999,75,17,2254231.2,3776921.31
15419,U29439,92,-216.74000000000024,73,19,18060.28,17843.539999999997
15420,U694647,92,-16499.87,66,26,24048.139999999996,7548.269999999997
15421,U26777,92,7460.830000000002,61,31,356398.27,363859.10000000003
15422,U9131,92,22313.16999999997,66,26,410430.95000000007,432744.12000000005
15423,U18690,92,-4892.769999999999,66,26,61327.81999999999,56435.049999999996
15424,U35137,92,47667.96000000001,80,12,66915.57,114583.53000000001
15425,U24517,92,-1996.8799999999999,76,16,51205.52,49208.64
15426,U28840,92,10942.05,44,48,24468.260000000002,35410.31
15427,U24571,92,244173.4499999999,52,40,420880.76,665054.21
15428,U34229,92,-1359.0800000000017,75,17,41797.69000000002,40438.610000000015
15429,U23077,92,-94110.44000000003,79,13,698915.8299999997,604805.3899999997
15430,U8766,92,26751.059999999998,82,10,9473.45,36224.509999999995
15431,U23541,92,72624.39999999995,77,15,2171855.55,2244479.9499999997
15432,U10605,92,85610.75000000003,78,14,1362011.86,1447622.61
15433,U28788,92,-101370.20999999998,75,17,330671.20999999996,229301.0
15434,U29248,92,6538.5700000000015,76,16,222229.08000000002,228767.65000000002
15435,U39271,92,10608.899999999994,75,17,25821.74,36430.64
15436,U13093,92,-154394.11,76,16,439202.3500000001,284808.2400000001
15437,U24519,92,24567.689999999995,79,13,81371.42,105939.10999999999
15438,U38909,92,24652.919999999995,80,12,48781.90000000003,73434.82000000002
15439,U39617,92,7437.820000000001,71,21,111601.48999999999,119039.31
15440,U39697,92,1873.04,78,14,11920.880000000001,13793.920000000002
15441,U26931,92,27762.99,80,12,138885.77,166648.75999999998
15442,U12356,92,16058.700000000003,57,35,259615.26000000004,275673.96
15443,U16129,92,-7766.050000000218,78,14,197287.13000000003,189521.0799999998
15444,U27924,92,-43077.94,75,17,158564.22999999998,115486.28999999998
15445,U19929,92,-98.31000000006667,87,5,234181.84000000014,234083.5300000001
15446,U42476,92,-1663.160000000002,81,11,28520.69,26857.529999999995
15447,U19008,92,40417.360000000015,75,17,291245.05999999994,331662.4199999999
15448,U40416,92,6073.830000000002,71,21,16956.820000000003,23030.650000000005
15449,U8498,92,18.809999999998922,65,27,37163.610000000015,37182.42000000001
15450,U42103,92,-4432.350000000002,83,9,7908.120000000003,3475.7700000000004
15451,U17011,92,-15927.190000000002,77,15,89311.77,73384.58
15452,U28324,92,-42912.07,85,7,60660.8,17748.730000000003
15453,U33010,92,1811.0,73,19,59620.95999999999,61431.95999999999
15454,U34464,92,1209.3999999999999,66,26,43298.74,44508.14
15455,U25349,92,1804.7199999999884,57,35,215499.9,217304.62
15456,U1366031,92,-9917.37,58,34,20136.23,10218.859999999999
15457,U29884,92,-41035.3,74,18,285840.24,244804.94
15458,U29539,92,-191.76999999999953,64,28,56534.48,56342.71000000001
15459,U28939,92,-2045.2299999999998,76,16,77569.93000000001,75524.70000000001
15460,U937460,92,1858.35,61,31,56072.51999999999,57930.86999999999
15461,U27291,92,4325.5300000000025,77,15,29160.790000000005,33486.32000000001
15462,U22047,92,-3057.9900000000034,66,26,124746.73,121688.73999999999
15463,U36547,92,-5609.7199999999975,72,20,34078.770000000004,28469.050000000007
15464,U10582,92,-3056.5900000000074,79,13,82791.85,79735.26
15465,U26696,92,-36151.240000000005,76,16,187887.69,151736.45
15466,U40818,92,2672.359999999999,74,18,127584.18000000001,130256.54000000001
15467,U31272,92,1236.6200000000044,80,12,95851.20999999998,97087.82999999999
15468,U22439,92,-2388.700000000007,80,12,325195.08999999997,322806.38999999996
15469,U21558,92,-14401.940000000002,71,21,131668.59000000003,117266.65000000002
15470,U11112,92,7710.950000000003,77,15,59708.329999999994,67419.28
15471,U37878,92,-13919.630000000005,77,15,62558.20000000001,48638.57000000001
15472,U25769,92,-1657.7700000000004,88,4,9506.99,7849.219999999999
15473,U37426,92,-117.44000000000108,64,28,30450.87000000001,30333.430000000008
15474,U24701,92,-3864.8699999999953,71,21,683708.62,679843.75
15475,U23972,92,-449.4699999999908,46,46,213183.09000000003,212733.62000000002
15476,U24948,92,13432.979999999998,70,22,25638.79,39071.77
15477,U20091,92,-4731.049999999998,60,32,323531.6800000001,318800.6300000001
15478,U8615,92,278511.02,83,9,204988.63,483499.65
15479,U18470,92,-21578.320000000003,61,31,218511.95999999996,196933.63999999996
15480,U31487,92,-4495.920000000018,56,36,213870.31999999998,209374.39999999997
15481,U41526,92,19263.140000000003,76,16,35813.05999999999,55076.2
15482,U1226159,92,-1211.81,57,35,9663.249999999998,8451.439999999999
15483,U23233,92,-212281.89999999997,39,53,699910.83,487628.93
15484,U1190489,92,-13154.179999999997,83,9,28711.209999999992,15557.029999999995
15485,U35646,92,-10903.619999999999,81,11,55217.500000000015,44313.88000000002
15486,U25762,92,-739.9800000000042,49,43,342472.75,341732.77
15487,U11316,92,-6682.069999999998,83,9,27532.689999999995,20850.619999999995
15488,U17948,92,-24914.040000000285,77,15,5099484.8,5074570.76
15489,U9783,92,-6827.660000000001,87,5,40071.83000000001,33244.170000000006
15490,U20324,92,11081.299999999997,66,26,57546.29,68627.59
15491,U25401,92,8348.930000000002,83,9,18687.100000000006,27036.030000000006
15492,U38424,92,-3827.12,88,4,5177.85,1350.7300000000005
15493,U22758,92,-166841.8400000001,70,22,1294538.42,1127696.5799999998
15494,U25929,92,63180.68,61,31,270746.28,333926.96
15495,U23447,92,-180307.34999999998,78,14,410982.59,230675.24000000005
15496,U43675,92,129846.04999999999,76,16,61748.36,191594.40999999997
15497,U33651,92,-16069.829999999996,88,4,31107.059999999998,15037.230000000001
15498,U1163122,92,-5684.379999999998,54,38,53372.72000000001,47688.34000000001
15499,U38801,92,-18003.06,67,25,41423.51000000001,23420.450000000008
15500,U28534,92,-22858.159999999993,69,23,402051.64,379193.48000000004
15501,U8840,92,-4067.0999999999794,71,21,736805.73,732738.63
15502,U43689,92,27490.32,73,19,49004.570000000014,76494.89000000001
15503,U28770,92,-5865.530000000004,60,32,262712.31,256846.78
15504,U32520,92,-32583.11,59,33,249034.06999999998,216450.95999999996
15505,U1252569,92,54.269999999996344,62,30,39724.67,39778.939999999995
15506,U34590,92,54624.24999999999,71,21,45211.590000000004,99835.84
15507,U28047,92,20.64999999999973,83,9,6081.72,6102.37
15508,U20112,92,10593.410000000002,86,6,4855.28,15448.690000000002
15509,U37453,92,7496.6799999999985,83,9,26361.09,33857.77
15510,U18514,92,384.6099999999933,72,20,42437.87,42822.479999999996
15511,U43665,92,-4374.689999999995,80,12,66906.26999999999,62531.579999999994
15512,U33508,92,-1122.7199999999993,84,8,57902.33,56779.61
15513,U15297,92,68197.54999999999,61,31,199808.42000000007,268005.9700000001
15514,U10007,92,4471.359999999997,80,12,139093.93999999994,143565.29999999993
15515,U28833,92,-9095.220000000016,78,14,167766.29000000004,158671.07
15516,U21802,92,-17674.23999999998,84,8,46182.99,28508.75000000002
15517,U31792,92,1681.660000000001,84,8,15688.559999999998,17370.219999999998
15518,U32577,92,379.1899999999987,74,18,90260.79999999999,90639.98999999999
15519,U14048,92,88140.17999999998,78,14,222512.48999999996,310652.6699999999
15520,U22242,92,41427.41999999994,33,59,904683.3400000001,946110.76
15521,U12240,92,-2720.7600000000093,63,29,1942764.9400000002,1940044.1800000002
15522,U853522,92,144.57000000000008,56,36,66893.54000000001,67038.11000000002
15523,U39669,92,48464.78,71,21,53037.28,101502.06
15524,U41212,92,-1555.6399999999999,86,6,8000.9000000000015,6445.260000000002
15525,U31514,92,-5049.55,80,12,5770.24,720.6899999999996
15526,U33950,91,-417.82000000000517,80,11,76396.30999999998,75978.48999999998
15527,U24904,91,3661.2099999999973,63,28,278488.47,282149.68
15528,U26533,91,-11907.37999999996,44,47,2336251.8000000003,2324344.4200000004
15529,U18394,91,19362.03999999992,46,45,5591773.95,5611135.99
15530,U22969,91,-1268.9400000000005,83,8,13637.84,12368.9
15531,U28338,91,16480.269999999997,69,22,44897.89000000003,61378.160000000025
15532,U21422,91,-76468.23,74,17,272362.29000000004,195894.06000000006
15533,U24878,91,9911.600000000028,35,56,263515.76,273427.36000000004
15534,U31871,91,-196899.44,79,12,283715.27,86815.83000000002
15535,U25760,91,-571.19,87,4,6572.129999999999,6000.939999999999
15536,U41199,91,-5515.789999999999,85,6,14587.569999999998,9071.779999999999
15537,U10608,91,-13576.639999999996,77,14,16731.86,3155.220000000005
15538,U43142,91,1092.6399999999994,78,13,67678.5,68771.14
15539,U40153,91,-3377.029999999999,83,8,34927.14,31550.11
15540,U18410,91,1779.280000000008,75,16,35089.20999999999,36868.49
15541,U30624,91,20659.899999999998,71,20,27352.410000000003,48012.31
15542,U19837,91,-2611.2399999999993,74,17,37418.099999999984,34806.859999999986
15543,U30534,91,3149.940000000065,77,14,1006627.26,1009777.2000000001
15544,U43723,91,9117.98,76,15,41491.39000000001,50609.37000000001
15545,U30999,91,3782.279999999999,83,8,63215.91,66998.19
15546,U21831,91,4431.060000000004,88,3,14756.529999999997,19187.59
15547,U13587,91,-13467.3,88,3,16621.039999999997,3153.739999999998
15548,U15198,91,51616.54999999999,82,9,42695.28,94311.82999999999
15549,U1265905,91,-1262.8400000000006,51,40,42994.840000000004,41732.0
15550,U35336,91,-2309.99,75,16,22034.880000000005,19724.890000000007
15551,U15533,91,-33350.02999999997,70,21,1483892.6700000002,1450542.6400000001
15552,U14998,91,-23841.100000000002,87,4,45517.25000000001,21676.150000000005
15553,U10686,91,-22883.600000000013,73,18,407031.89999999997,384148.29999999993
15554,U30782,91,-66331.99000000003,59,32,1277126.87,1210794.8800000001
15555,U13830,91,30351.630000000005,52,39,325025.89,355377.52
15556,U37668,91,9892.539999999999,72,19,102451.76,112344.29999999999
15557,U14271,91,-25463.56,77,14,94696.86000000002,69233.30000000002
15558,U26394,91,2517141.41,54,37,5111385.62,7628527.03
15559,U14502,91,-30493.600000000035,60,31,640629.7300000001,610136.1300000001
15560,U19621,91,-9017.570000000247,70,21,1179540.9900000002,1170523.42
15561,U31615,91,-11391.980000000001,83,8,36361.83,24969.85
15562,U31175,91,116021.24,47,44,109432.54999999997,225453.78999999998
15563,U14741,91,-1151395.58,65,26,1801156.26,649760.6799999999
15564,U36556,91,564169.54,77,14,2715487.9,3279657.44
15565,U15882,91,-20730.1,81,10,48506.530000000006,27776.430000000008
15566,U32838,91,-80816.23999999999,72,19,243324.84,162508.6
15567,U20953,91,-16203.22000000002,54,37,1811604.8599999999,1795401.64
15568,U1334515,91,-1645.8400000000004,60,31,27156.729999999996,25510.889999999996
15569,U43993,91,-3441.7399999999943,58,33,208033.71000000002,204591.97000000003
15570,U10250,91,-10924.91,83,8,27625.26999999999,16700.35999999999
15571,U21765,91,-36949.98999999999,66,25,433768.67000000004,396818.68000000005
15572,U15749,91,-35218.170000000006,81,10,64895.73,29677.559999999998
15573,U15466,91,-23249.929999999993,56,35,177199.94,153950.01
15574,U22671,91,-2374.3499999999985,79,12,21162.279999999995,18787.929999999997
15575,U33135,91,-949.3100000000004,87,4,12865.75,11916.439999999999
15576,U39662,91,3859.9900000000125,61,30,722191.86,726051.85
15577,U21386,91,20618.44,79,12,28577.930000000004,49196.37
15578,U43639,91,-1669.8100000000015,80,11,24004.55,22334.739999999998
15579,U14201,91,-42236.67999999999,57,34,229455.68,187219.0
15580,U37270,91,-11750.459999999955,59,32,1059390.25,1047639.79
15581,U32069,91,2902.3300000000017,80,11,25152.91,28055.24
15582,U40981,91,-464283.8,81,10,567183.27,102899.47000000003
15583,U1174203,91,-6689.58,55,36,36019.89000000001,29330.310000000005
15584,U990449,91,197.99999999999807,65,26,20977.649999999998,21175.649999999994
15585,U10306,91,-27560.420000000024,63,28,455982.11999999994,428421.6999999999
15586,U34074,91,-5446.140000000008,82,9,130668.77999999997,125222.63999999996
15587,U20660,91,12745.600000000006,75,16,37070.69,49816.29000000001
15588,U1139576,91,-291.73999999999944,62,29,11711.939999999999,11420.199999999999
15589,U35408,91,-20901.29,65,26,60098.83999999999,39197.54999999999
15590,U8315,91,9.570000000008804,64,27,124210.91999999998,124220.48999999999
15591,U1104743,91,-549.8599999999999,69,22,2850.2,2300.34
15592,U17403,91,-16442.639999999992,48,43,334354.00999999995,317911.36999999994
15593,U11444,91,69893.68,54,37,138673.49,208567.16999999998
15594,U880494,91,-5238.449999999997,58,33,60700.270000000004,55461.82000000001
15595,U29574,91,-1777.1400000000046,60,31,592079.1,590301.96
15596,U11394,91,-10867.990000000002,52,39,215025.31999999995,204157.32999999996
15597,U36185,91,-1387.420000000013,76,15,96729.78999999998,95342.36999999997
15598,U22499,91,-18172.44,83,8,43653.64,25481.2
15599,U13450,91,-15243.689999999988,70,21,439744.91,424501.22
15600,U24646,91,-24489.94000000001,76,15,171384.61000000002,146894.67
15601,U40895,91,-776.3600000000006,79,12,34999.31,34222.95
15602,U8559,91,26571.590000000004,68,23,151854.27000000002,178425.86000000002
15603,U14423,91,-1107755.73,80,11,1667106.76,559351.03
15604,U35650,91,45.580000000001746,74,17,47585.91,47631.490000000005
15605,U40779,91,-1395.9700000000012,76,15,49839.25,48443.28
15606,U35070,91,65601.80000000002,81,10,55063.43999999999,120665.24
15607,U8051,91,-9981.670000000002,86,5,38347.670000000006,28366.000000000004
15608,U30496,91,1620.359999999986,67,24,219945.31999999998,221565.67999999996
15609,U1375127,91,72.33999999999632,65,26,99561.83,99634.17
15610,U16799,91,-39885.31,79,12,113171.03,73285.72
15611,U43185,91,-2654.5100000000007,79,12,20829.890000000003,18175.38
15612,U19577,91,-134.25,85,6,5134.54,5000.29
15613,U41641,91,65295.399999999994,73,18,39715.369999999995,105010.76999999999
15614,U29715,91,24863.170000000006,82,9,47744.87,72608.04000000001
15615,U43148,91,-5359.709999999997,84,7,57109.280000000006,51749.57000000001
15616,U25742,91,-1959.9299999999348,44,47,2578463.4199999995,2576503.4899999993
15617,U13440,91,11205.490000000062,64,27,388758.3300000001,399963.8200000001
15618,U39935,91,41641.12,83,8,3270.2700000000004,44911.39
15619,U41420,91,23297.530000000006,68,23,87493.16000000003,110790.69000000003
15620,U17114,91,-46409.94000000001,78,13,185657.13,139247.19
15621,U590224,91,-49423.81000000003,60,31,411506.0399999999,362082.22999999986
15622,U16509,91,33739.889999999985,68,23,175409.52999999997,209149.41999999995
15623,U20572,91,-4911.859999999997,82,9,143494.57,138582.71000000002
15624,U28507,91,2347.97,83,8,7155.8,9503.77
15625,U27963,91,-2195.7300000000005,79,12,21058.850000000002,18863.120000000003
15626,U40095,91,-25967.989999999998,73,18,162518.39,136550.40000000002
15627,U43180,91,4267.790000000005,78,13,13379.039999999997,17646.83
15628,U39062,91,-347.48999999999796,64,27,156664.36,156316.87
15629,U33807,91,-43923.419999999984,73,18,267536.13,223612.71000000002
15630,U23161,91,-1260.3799999999997,74,17,47987.44000000001,46727.06000000001
15631,U22684,91,-8692.890000000001,86,5,9703.170000000002,1010.2800000000007
15632,U16902,91,305003.46,56,35,895209.5299999998,1200212.9899999998
15633,U25144,91,-3253.2900000000027,77,14,53407.07,50153.78
15634,U11179,91,450.52999999999884,75,16,109323.84000000001,109774.37000000001
15635,U14532,91,-2951.4000000000124,63,28,88470.59999999999,85519.19999999998
15636,U27234,91,-450.4099999999993,78,13,35548.11,35097.700000000004
15637,U32247,91,-5480.2300000000005,81,10,73823.48,68343.25
15638,U31858,91,-190.33999999999878,73,18,63291.64000000001,63101.30000000001
15639,U40413,91,-7405.329999999996,84,7,34500.650000000016,27095.32000000002
15640,U16363,91,24740.069999999578,42,49,16630476.58,16655216.65
15641,U30514,91,-12097.599999999999,76,15,60182.640000000014,48085.040000000015
15642,U37683,91,19202.709999999995,72,19,76590.31000000001,95793.02
15643,U20699,91,-78559.31000000003,56,35,827419.71,748860.3999999999
15644,U16100,90,122071.38000000009,55,35,2573455.2600000002,2695526.64
15645,U9465,90,1546.0599999999977,83,7,25672.2,27218.26
15646,U18263,90,32288.109999999993,72,18,233246.16,265534.27
15647,U20596,90,10161.75999999998,63,27,334323.5,344485.26
15648,U16211,90,-175261.78999999998,79,11,239329.15,64067.360000000015
15649,U987635,90,10635.18,39,51,75129.66,85764.84
15650,U35785,90,5765.0700000000115,55,35,238629.19,244394.26
15651,U30289,90,8585.669999999998,66,24,352158.34,360744.01
15652,U42885,90,63047.270000000004,67,23,433337.13,496384.4
15653,U11751,90,-2089.1500000000015,84,6,7116.420000000001,5027.2699999999995
15654,U36162,90,38646.47,62,28,738574.04,777220.51
15655,U37729,90,617126.5399999999,30,60,284460.8,901587.3399999999
15656,U36631,90,-2865.9799999999987,80,10,50814.27,47948.29
15657,U17359,90,5300.039999999996,64,26,151706.03,157006.07
15658,U24623,90,-6628.1400000000085,79,11,522877.19999999984,516249.0599999998
15659,U34315,90,-2287.33,82,8,9288.22,7000.889999999999
15660,U12194,90,-26671.200000000008,81,9,111132.16999999998,84460.96999999997
15661,U30352,90,-43946.21000000003,78,12,79453.32000000002,35507.10999999999
15662,U21701,90,-6842.920000000001,76,14,57341.54,50498.62
15663,U23078,90,920.7700000000002,83,7,5640.529999999999,6561.299999999999
15664,U18829,90,-109026.96999999999,80,10,227645.44,118618.47000000002
15665,U17554,90,1616.4099999999867,70,20,194378.69,195995.09999999998
15666,U29699,90,15976.749999999996,70,20,60108.48000000002,76085.23000000001
15667,U39317,90,-5639.820000000007,48,42,550221.97,544582.1499999999
15668,U10838,90,1265.739999999998,63,27,164027.62,165293.36
15669,U38827,90,-1043.9299999999967,82,8,50138.55,49094.62000000001
15670,U40634,90,-4648.880000000001,79,11,35892.90000000001,31244.020000000008
15671,U19430,90,-5233.760000000006,63,27,82178.83000000002,76945.07
15672,U32371,90,394925.93999999994,28,62,833117.9099999999,1228043.8499999999
15673,U34102,90,18540.73,54,36,159923.62999999992,178464.35999999993
15674,U28629,90,-1791.2000000000169,45,45,374344.20999999996,372553.00999999995
15675,U31793,90,-334.2199999999998,58,32,6436.329999999999,6102.109999999999
15676,U13860,90,13467.360000000095,49,41,6276041.2299999995,6289508.59
15677,U14505,90,34523.310000000034,76,14,769194.9699999999,803718.2799999999
15678,U34409,90,1873.6000000000008,78,12,21082.67,22956.27
15679,U13410,90,94909.60000000008,64,26,409302.00000000006,504211.60000000015
15680,U33705,90,-732.6500000000397,51,39,1774669.95,1773937.2999999998
15681,U41942,90,-23673.22000000001,70,20,277683.36,254010.13999999998
15682,U8131,90,-2699.229999999987,46,44,331633.12,328933.89
15683,U12429,90,1359227.97,71,19,1139672.94,2498900.91
15684,U13711,90,87713.52999999981,73,17,1077957.8400000003,1165671.37
15685,U31789,90,-338.0900000000031,68,22,24862.41999999998,24524.329999999976
15686,U11660,90,19686.529999999984,47,43,638933.47,658620.0
15687,U33715,90,34778.509999999995,49,41,515660.36,550438.87
15688,U34035,90,-6064.649999999987,73,17,284468.58999999997,278403.94
15689,U8549,90,-73389.38999999998,70,20,1237840.6400000001,1164451.2500000002
15690,U15166,90,630.5999999999876,41,49,364491.49000000005,365122.09
15691,U20495,90,23886.33,84,6,5311.8,29198.13
15692,U18846,90,-43338.88999999999,74,16,363855.96,320517.07
15693,U25854,90,-9213.03,81,9,64242.63000000001,55029.60000000001
15694,U12678,90,7928.5799999999945,77,13,31608.999999999953,39537.57999999994
15695,U27887,90,35345.42,78,12,43985.220000000016,79330.64000000001
15696,U25739,90,53427.18000000001,69,21,189468.03999999998,242895.21999999997
15697,U14102,90,28984.479999999996,64,26,161542.3,190526.77999999997
15698,U8759,90,-38878.73,67,23,383396.3500000001,344517.6200000001
15699,U26107,90,-9357.310000000056,66,24,1114025.26,1104667.95
15700,U16528,90,-2981.3400000000206,46,44,533169.7699999999,530188.4299999999
15701,U14927,90,1.629999999997608,86,4,29166.870000000006,29168.500000000004
15702,U25976,90,-883.0499999999952,70,20,75339.69,74456.64000000001
15703,U21483,90,-765.3000000000005,86,4,16451.999999999996,15686.699999999995
15704,U31509,90,-37143.89,80,10,60412.80999999999,23268.91999999999
15705,U25420,90,-116.60999999999876,43,47,70251.91,70135.3
15706,U11497,90,-25800.25000000003,75,15,369014.91000000003,343214.66000000003
15707,U39267,90,-1723.450000000001,85,5,7547.1100000000015,5823.660000000001
15708,U11781,90,-11047.460000000001,81,9,40889.240000000005,29841.780000000006
15709,U22663,90,347294.68000000005,57,33,930905.73,1278200.4100000001
15710,U24798,90,735.9000000000007,73,17,7777.259999999998,8513.16
15711,U36263,90,4506.589999999869,78,12,2209137.080000001,2213643.670000001
15712,U35937,90,734.1399999999942,51,39,188585.26999999996,189319.40999999995
15713,U40174,90,782728.0700000002,68,22,3667817.04,4450545.11
15714,U26681,90,500.7100000000007,80,10,16306.259999999995,16806.969999999994
15715,U11732,90,-20313.610000000008,58,32,209236.44999999998,188922.83999999997
15716,U40817,90,39934.34999999999,62,28,107203.74,147138.09
15717,U8045,90,-27948.470000000005,78,12,158090.69000000003,130142.22000000003
15718,U31652,90,116489.61,72,18,758011.09,874500.7
15719,U29671,90,-1710.7700000000002,77,13,19536.839999999993,17826.069999999992
15720,U41500,90,529.4800000000133,51,39,255658.62,256188.1
15721,U33381,90,-19620.850000000002,84,6,27518.500000000004,7897.6500000000015
15722,U16180,90,-15595.73000000001,52,38,520919.02,505323.29000000004
15723,U16385,90,-46338.810000000005,69,21,251712.84999999995,205374.03999999995
15724,U24449,90,-3146.559999999999,79,11,15203.129999999997,12056.569999999998
15725,U29801,90,1647.5700000002596,59,31,1387471.22,1389118.7900000003
15726,U36738,90,-5571.11,69,21,109866.18999999999,104295.07999999999
15727,U21270,90,-8663.06999999997,71,19,301439.88000000006,292776.8100000001
15728,U23229,90,-3115.619999999999,81,9,58816.22,55700.600000000006
15729,U36835,90,20427.370000000003,61,29,360133.28,380560.65
15730,U40864,90,13248.659999999998,83,7,66753.37,80002.03
15731,U22647,90,-22185.479999999996,83,7,47143.45,24957.97
15732,U27068,90,34299.03000000015,58,32,2936729.2399999998,2971028.27
15733,U23677,90,95247.59999999998,63,27,546188.8900000001,641436.4900000001
15734,U18885,90,-24323.569999999992,59,31,433244.2200000001,408920.6500000001
15735,U25985,90,13707.489999999998,67,23,112928.47000000003,126635.96000000002
15736,U37697,90,-376.7700000000014,72,18,15497.999999999996,15121.229999999994
15737,U10203,90,-693.7899999999973,76,14,102266.47,101572.68000000001
15738,U15378,90,18823.419999999966,50,40,302784.28999999986,321607.70999999985
15739,U27172,90,922.5899999999892,81,9,82846.79999999999,83769.38999999998
15740,U31444,90,7424.739999999999,78,12,102352.56000000001,109777.30000000002
15741,U21360,90,-14897.270000000017,54,36,343209.48,328312.20999999996
15742,U17565,90,-24340.520000000004,61,29,765849.95,741509.4299999999
15743,U36695,90,-1233.5900000000001,75,15,365251.95000000007,364018.36000000004
15744,U26352,90,-4565.070000000001,74,16,6415.850000000001,1850.7800000000007
15745,U16892,90,-20182.380000000077,65,25,621689.0900000001,601506.71
15746,U15636,90,2285.960000000023,59,31,439006.32000000007,441292.2800000001
15747,U11593,90,10600.940000000002,68,22,204220.40999999995,214821.34999999995
15748,U34282,90,2911.1199999999994,73,17,31891.579999999998,34802.7
15749,U36927,90,-4083.270000000001,70,20,29331.75999999999,25248.48999999999
15750,U43688,90,-31469.61,71,19,266347.99,234878.38
15751,U1242867,90,2026.5100000000016,57,33,17229.179999999993,19255.689999999995
15752,U992824,90,-25925.399999999998,55,35,26471.479999999996,546.0799999999981
15753,U25998,90,-31031.500000000007,78,12,74991.29,43959.789999999986
15754,U17414,90,-57342.74999999997,55,35,712582.71,655239.96
15755,U30306,90,10180.959999999997,63,27,39815.090000000004,49996.05
15756,U18192,90,-117482.86999999995,82,8,146981.56999999995,29498.699999999997
15757,U41394,90,2412.3700000000035,69,21,96128.20000000003,98540.57000000004
15758,U43625,90,5713.78,79,11,7771.3099999999995,13485.09
15759,U19312,90,-3925.899999999998,61,29,98945.40999999999,95019.51
15760,U29321,90,121015.00000000006,77,13,4478.6799999999985,125493.68000000005
15761,U819138,90,-863.7200000000015,51,39,20681.63,19817.91
15762,U17956,90,-21869.199999999993,66,24,175414.69999999995,153545.49999999997
15763,U43207,90,-12994.669999999998,77,13,26100.780000000006,13106.110000000008
15764,U30658,90,-2029.1499999999978,66,24,36963.009999999995,34933.86
15765,U38558,90,4430.059999999999,56,34,169009.72,173439.78
15766,U14740,90,11181.369999999995,57,33,655565.35,666746.72
15767,U11530,90,-2445.099999999998,82,8,29668.92,27223.82
15768,U38011,90,19961.350000000035,69,21,328400.38999999996,348361.74
15769,U35177,90,1923.3799999999985,85,5,6105.010000000003,8028.390000000001
15770,U41335,90,10899.340000000004,79,11,188320.51,199219.85
15771,U12582,90,11816.189999999999,82,8,153808.1300000001,165624.3200000001
15772,U11019,90,148580.5100000001,74,16,560413.0100000004,708993.5200000005
15773,U836867,90,8128.149999999999,58,32,87201.11,95329.26
15774,U27526,90,92466.26000000007,83,7,145876.86999999985,238343.12999999992
15775,U13553,90,-2612.6199999999994,69,21,33380.74,30768.12
15776,U14406,90,3711.0800000000636,39,51,1387866.4200000002,1391577.5000000002
15777,U38032,90,1198.1199999999994,81,9,18804.41,20002.53
15778,U32869,90,781.2000000001863,68,22,1693639.5899999999,1694420.79
15779,U15136,90,29033.81,72,18,536743.74,565777.55
15780,U22521,90,-184484.55000000005,73,17,389075.19,204590.63999999996
15781,U36678,89,-75066.20000000001,67,22,101739.69,26673.48999999999
15782,U20124,89,1792.4099999999962,48,41,122716.87,124509.28
15783,U41085,89,4982.5999999999985,67,22,142167.61,147150.21
15784,U1176385,89,363.57999999999976,45,44,14387.86,14751.44
15785,U26046,89,-10813.029999999995,76,13,48442.1,37629.07000000001
15786,U10657,89,2272.629999999994,76,13,51117.81999999999,53390.44999999999
15787,U31434,89,-103120.46999999999,68,21,483907.94000000006,380787.4700000001
15788,U29594,89,40.7399999999966,62,27,219367.59999999998,219408.33999999997
15789,U19354,89,17870.209999999995,72,17,134616.32,152486.53
15790,U39865,89,1059.0600000000036,79,10,13739.67,14798.730000000003
15791,U28604,89,1882.549999999944,78,11,1167303.84,1169186.3900000001
15792,U32895,89,9610.289999999994,67,22,227239.11,236849.39999999997
15793,U30636,89,-5898.659999999999,78,11,15015.770000000002,9117.110000000004
15794,U38124,89,-34685.7,68,21,578063.0099999999,543377.3099999999
15795,U25356,89,-9250.400000000001,58,31,316442.07,307191.67
15796,U40486,89,-16968.840000000004,67,22,214084.22,197115.38
15797,U608446,89,-17881.61,70,19,35773.450000000004,17891.840000000004
15798,U16714,89,-1453985.71,49,40,2413805.23,959819.52
15799,U1120590,89,-569.5800000000004,55,34,8287.510000000002,7717.930000000002
15800,U24822,89,610.5500000000009,78,11,39434.049999999996,40044.6
15801,U11374,89,-17242.73,81,8,29699.780000000006,12457.050000000007
15802,U40031,89,-476725.35,79,10,502329.41,25604.059999999998
15803,U28122,89,551.6300000000008,65,24,38778.50000000001,39330.130000000005
15804,U10187,89,19197.169999999984,50,39,957484.6299999999,976681.7999999998
15805,U12570,89,-61996.41,70,19,459442.38000000006,397445.9700000001
15806,U9640,89,-3803.3500000000117,63,26,409683.4999999999,405880.14999999985
15807,U27451,89,-710.4899999999988,73,16,27901.79999999999,27191.30999999999
15808,U17998,89,609.5899999999965,58,31,232172.66999999995,232782.25999999995
15809,U43357,89,20324.949999999997,49,40,126626.1,146951.05
15810,U19868,89,-8836.03,69,20,58669.600000000006,49833.57000000001
15811,U42436,89,214830.97,58,31,228331.68,443162.65
15812,U37338,89,-484.74999999999955,55,34,39119.46,38634.71
15813,U17067,89,8344.460000000005,67,22,97011.24,105355.70000000001
15814,U22342,89,-40427.73000000017,75,14,1104834.3900000001,1064406.66
15815,U21529,89,18142.42,45,44,29849.19,47991.61
15816,U11627,89,-29084.870000000046,72,17,809692.67,780607.8
15817,U1110325,89,-791.1500000000008,70,19,13538.1,12746.949999999999
15818,U31739,89,-9672.110000000015,78,11,96016.07,86343.95999999999
15819,U24380,89,-14551.329999999929,70,19,723058.63,708507.3
15820,U42421,89,-5776.75,86,3,12482.609999999995,6705.859999999995
15821,U25838,89,-1105.1599999999937,71,18,72111.83999999998,71006.68
15822,U1167182,89,-2611.079999999999,63,26,22471.01,19859.93
15823,U9768,89,5591.69,75,14,34779.79,40371.48
15824,U9435,89,-42456.840000000026,74,15,136544.91999999998,94088.07999999996
15825,U16774,89,2477.549999999981,76,13,126986.49,129464.03999999998
15826,U33902,89,3552.929999999999,71,18,17224.039999999997,20776.969999999998
15827,U17596,89,-7360.810000000016,63,26,496001.37,488640.56
15828,U32580,89,15623.039999999997,73,16,56305.12000000001,71928.16
15829,U18230,89,7577.35,77,12,33286.32,40863.67
15830,U12225,89,30.529999999998836,69,20,71466.10999999999,71496.63999999998
15831,U10029,89,-4518.44,80,9,10814.029999999997,6295.589999999997
15832,U32857,89,-297.31999999999243,77,12,335307.80999999994,335010.48999999993
15833,U13934,89,4010.019999999999,64,25,6767.909999999994,10777.929999999993
15834,U15291,89,-57808.719999999994,67,22,321266.23,263457.51
15835,U35910,89,-15457.950000000012,76,13,199353.53,183895.58
15836,U19257,89,-1274.33,62,27,27490.890000000007,26216.560000000005
15837,U10368,89,-18425.6,80,9,33947.409999999996,15521.809999999998
15838,U13774,89,-2102.510000000001,71,18,57903.399999999994,55800.88999999999
15839,U24566,89,71683.48000000001,64,25,272892.2699999999,344575.7499999999
15840,U1301978,89,493.34000000000003,44,45,9881.34,10374.68
15841,U41187,89,354683.1500000001,59,30,2830563.2699999996,3185246.4199999995
15842,U21592,89,533988.1400000002,66,23,170320.19000000006,704308.3300000003
15843,U34890,89,-19937.620000000014,61,28,332492.51,312554.89
15844,U600497,89,-17236.519999999997,52,37,30966.989999999994,13730.469999999998
15845,U33317,89,-12113.359999999997,81,8,16689.8,4576.440000000002
15846,U16636,89,2004.8299999999995,59,30,18626.85,20631.679999999997
15847,U42422,89,3953.670000000035,74,15,156626.72999999978,160580.39999999982
15848,U22236,89,-7325.710000000001,52,37,60307.40000000001,52981.69000000001
15849,U14681,89,4090.339999999994,72,17,76978.71999999999,81069.05999999998
15850,U21997,89,1464.76,76,13,2634.9800000000005,4099.740000000001
15851,U26243,89,-22597.410000000003,67,22,116142.37999999999,93544.96999999999
15852,U13309,89,26388.93000000006,63,26,662269.79,688658.7200000001
15853,U1355906,89,-14332.960000000003,64,25,59932.900000000016,45599.94000000002
15854,U20432,89,113641.57,68,21,8529.220000000007,122170.79000000001
15855,U18032,89,-28545.420000000016,74,15,303391.20999999996,274845.7899999999
15856,U16916,89,-36276.07999999998,72,17,431903.56,395627.48000000004
15857,U33824,89,-5827.790000000003,41,48,299650.68,293822.89
15858,U29061,89,628.6400000000373,72,17,176392.60000000003,177021.24000000008
15859,U34658,89,-10538.51,55,34,105877.56000000004,95339.05000000005
15860,U28083,89,-650.1599999999507,82,7,33811.46999999992,33161.30999999997
15861,U19361,89,21251.649999999994,74,15,109137.19,130388.84
15862,U27766,89,-49.94999999999943,79,10,16646.809999999998,16596.859999999997
15863,U36515,89,10948.769999999991,71,18,228878.52999999997,239827.29999999996
15864,U37484,89,-40925.65999999997,66,23,354654.14,313728.48000000004
15865,U19011,89,-949.2299999999996,73,16,156895.28999999998,155946.05999999997
15866,U39559,89,-641.3800000000001,65,24,3408.27,2766.89
15867,U43546,89,-51053.5500000002,49,40,5231448.58,5180395.03
15868,U23894,89,6417.010000000002,39,50,579226.2700000001,585643.2800000001
15869,U13289,89,-1433.9,78,11,6881.81,5447.91
15870,U21692,89,-69776.67999999996,67,22,187917.66999999998,118140.99000000002
15871,U25656,89,-165419.5,79,10,228218.31999999998,62798.81999999998
15872,U36804,89,3201.74000000002,45,44,831075.6799999999,834277.4199999999
15873,U33174,89,-12073.609999999997,52,37,92362.23000000001,80288.62000000001
15874,U40886,89,22678.589999999997,57,32,47686.19,70364.78
15875,U17901,89,-284367.30999999994,67,22,1675084.3900000004,1390717.0800000005
15876,U43171,89,-34076.51,51,38,459705.1299999999,425628.6199999999
15877,U40349,89,-550.5399999999989,79,10,15053.050000000001,14502.510000000002
15878,U10515,89,-0.5400000000000773,81,8,15731.58,15731.039999999999
15879,U38983,89,-5409.82,77,12,12276.230000000001,6866.410000000002
15880,U27876,89,-19633.09999999995,79,10,45828.32999999995,26195.23
15881,U40171,89,-25491.21999999987,62,27,1714995.35,1689504.1300000001
15882,U16208,89,-317.5400000000144,60,29,178833.83000000002,178516.29
15883,U13773,89,-1090840.92,62,27,3423818.7099999995,2332977.7899999996
15884,U15972,89,150241.4100000001,65,24,305947.72,456189.13000000006
15885,U11159,89,-2550.8600000000006,67,22,346046.2,343495.34
15886,U13873,89,8176.450000000004,67,22,31990.35,40166.8
15887,U16165,89,6887.470000000001,73,16,81849.12,88736.59
15888,U23738,89,-7420.010000000004,53,36,145116.99,137696.97999999998
15889,U13077,89,-8394.98000000004,58,31,964642.99,956248.01
15890,U10814,89,-658.4499999999989,57,32,153390.59,152732.13999999998
15891,U39826,89,-9387.829999999998,61,28,101174.24000000002,91786.41000000002
15892,U14110,89,-1102.720000000003,65,24,73634.99999999999,72532.27999999998
15893,U13942,89,-25430.499999999996,61,28,623862.76,598432.26
15894,U38852,89,-72510.94,65,24,278911.14,206400.2
15895,U22981,89,-41101.99999999966,68,21,12829337.65,12788235.65
15896,U33140,89,-1904.0199999999993,68,21,44620.09000000001,42716.070000000014
15897,U25790,89,42577.829999999994,79,10,15129.109999999997,57706.93999999999
15898,U37112,89,40270.100000000006,79,10,145656.28999999998,185926.38999999998
15899,U1073721,89,1.1999999999998636,71,18,2629.5100000000016,2630.7100000000014
15900,U17502,89,7475873.930000001,59,30,6663085.799999999,14138959.73
15901,U9051,89,-20539.100000000006,81,8,211865.16,191326.06
15902,U40663,89,14440.239999999998,73,16,17129.059999999998,31569.299999999996
15903,U10460,89,3641.7699999999986,75,14,20247.43,23889.199999999997
15904,U12237,89,-414.130000000001,51,38,111459.82,111045.69
15905,U16557,89,780.1200000000008,83,6,28724.5,29504.620000000003
15906,U12853,89,15718.350000000004,70,19,54080.85999999999,69799.20999999999
15907,U24179,89,-491.35999999999194,73,16,414336.12000000005,413844.76000000007
15908,U15992,89,8321.879999999997,75,14,23961.010000000002,32282.89
15909,U20574,89,-106544.21999999996,42,47,635218.2999999999,528674.08
15910,U34657,89,-1120.3299999999144,63,26,869333.4,868213.0700000001
15911,U31096,89,-70868.56999999999,80,9,412448.81999999995,341580.24999999994
15912,U32334,89,-7529.769999999993,76,13,23503.229999999992,15973.46
15913,U33574,88,134.12000000000526,74,14,130008.03000000003,130142.15000000004
15914,U8834,88,-3919.509999999997,78,10,19055.079999999994,15135.569999999998
15915,U26958,88,145.03000000003476,53,35,864434.9900000001,864580.0200000001
15916,U13021,88,10399.500000000015,72,16,158500.8,168900.3
15917,U13164,88,-12606.969999999996,61,27,141465.07,128858.1
15918,U1212765,88,-1159.7400000000002,69,19,8897.83,7738.09
15919,U8089,88,23713.219999999987,54,34,248611.72,272324.94
15920,U35947,88,49208.58999999985,69,19,16554896.01,16604104.6
15921,U16686,88,30023.07999999999,55,33,292987.61,323010.69
15922,U43498,88,-6178.020000000002,76,12,50723.69,44545.67
15923,U37399,88,-18980.43,66,22,125766.08,106785.65
15924,U8091,88,-287352.31000000006,80,8,1272888.19,985535.8799999999
15925,U10212,88,-3941.929999999993,67,21,400615.01,396673.08
15926,U10713,88,584.5100000000093,81,7,264934.7,265519.21
15927,U29533,88,-967.5299999999994,61,27,20084.260000000013,19116.730000000014
15928,U25782,88,-19206.260000000006,58,30,113692.80999999998,94486.54999999997
15929,U42848,88,9512.56,78,10,91529.56,101042.12
15930,U34906,88,-114.80999999999857,83,5,6730.319999999999,6615.51
15931,U31362,88,5484.32,68,20,68277.62,73761.94
15932,U32237,88,-3810.549999999997,70,18,123779.98000000001,119969.43000000001
15933,U31124,88,1232.8000000000006,83,5,6968.789999999998,8201.589999999998
15934,U10473,88,-108855.24000000003,59,29,1167516.7,1058661.46
15935,U37264,88,665946.3199999997,73,15,1007678.79,1673625.1099999999
15936,U15318,88,-417970.12,71,17,784461.65,366491.53
15937,U35902,88,4153.14,71,17,146824.06999999983,150977.20999999985
15938,U11454,88,80604.61000000002,70,18,402484.37,483088.98
15939,U42912,88,-51019.65000000001,80,8,104047.42,53027.76999999999
15940,U10652,88,-2927.739999999998,80,8,25319.25000000001,22391.510000000013
15941,U26380,88,118871.71999999991,69,19,2094804.3499999999,2213676.07
15942,U37286,88,-5259.12999999998,79,9,129306.54999999997,124047.42
15943,U41184,88,-17330.450000000026,63,25,343409.64000000013,326079.1900000001
15944,U15870,88,77711.50000000001,72,16,235148.54999999996,312860.05
15945,U20378,88,-4689.549999999999,64,24,97900.05,93210.5
15946,U29904,88,-12773.67,81,7,19907.469999999998,7133.799999999997
15947,U37417,88,-6010.159999999997,70,18,16456.54,10446.380000000005
15948,U21957,88,-7724.330000000002,81,7,57983.329999999994,50258.99999999999
15949,U41577,88,-29259.20999999997,78,10,696348.6700000002,667089.4600000002
15950,U14751,88,-1499.9199999999987,77,11,12431.91,10931.990000000002
15951,U41521,88,-1395.5199999999995,84,4,10632.8,9237.279999999999
15952,U24388,88,11141.820000000002,68,20,75425.66,86567.48000000001
15953,U18008,88,-141719.56000000003,77,11,298641.93999999994,156922.37999999992
15954,U30442,88,474.3099999999997,73,15,22342.04000000001,22816.350000000013
15955,U28486,88,-2401.8100000000004,66,22,117005.57999999999,114603.76999999999
15956,U21699,88,-429.86000000000035,78,10,10962.630000000001,10532.77
15957,U30051,88,67172.09,72,16,106531.02,173703.11
15958,U1382869,88,0.0,66,22,31862.069999999992,31862.069999999992
15959,U27826,88,-1137.2699999999998,80,8,6132.190000000004,4994.920000000005
15960,U16303,88,-29968.250000000004,78,10,79269.65000000001,49301.40000000001
15961,U18611,88,3631.390000000001,77,11,29606.589999999997,33237.979999999996
15962,U623385,88,-8.140000000002829,44,44,151265.28999999998,151257.14999999997
15963,U34403,88,423131.49999999994,44,44,1067527.9,1490659.4
15964,U10961,88,38506.68000000003,40,48,16381.800000000007,54888.48000000004
15965,U11118,88,0.0,42,46,1011866.66,1011866.66
15966,U41933,88,25511.329999999998,70,18,117605.43,143116.75999999998
15967,U32508,88,3525.159999999996,45,43,223456.78,226981.94
15968,U18977,88,16807.530000000002,77,11,43947.299999999996,60754.83
15969,U36737,88,-3052.52,77,11,70234.70999999999,67182.18999999999
15970,U31780,88,-43872.489999999656,82,6,1461531.2799999998,1417658.79
15971,U11605,88,-5579.620000000001,61,27,50110.939999999995,44531.31999999999
15972,U12773,88,-5438.8499999999985,80,8,23586.790000000005,18147.940000000006
15973,U33141,88,4660.190000000002,81,7,36698.40000000001,41358.59000000001
15974,U24923,88,-20954.339999999997,74,14,32064.26,11109.920000000002
15975,U39346,88,-593594.75,58,30,1462024.82,868430.0700000001
15976,U30493,88,-23657.14,56,32,293010.31999999995,269353.17999999993
15977,U43607,88,17888.859999999997,76,12,94377.56999999998,112266.42999999998
15978,U11565,88,-7522.149999999994,63,25,390195.53,382673.38
15979,U30241,88,-133995.08,68,20,418072.0200000001,284076.94000000006
15980,U14707,88,-203732.06000000008,63,25,1387893.43,1184161.3699999999
15981,U10935,88,12683.470000000014,79,9,137060.69999999998,149744.16999999998
15982,U8880,88,-7964.809999999998,74,14,143380.6,135415.79
15983,U27663,88,-8219.539999999994,68,20,187977.14,179757.60000000003
15984,U9676,88,130122.57999999993,53,35,2903149.46,3033272.04
15985,U36736,88,-8115.96,75,13,22144.449999999997,14028.489999999998
15986,U14308,88,5586.449999999999,59,29,51745.810000000005,57332.26
15987,U10112,88,-1072585.13,70,18,3189570.4900000007,2116985.360000001
15988,U30605,88,-8454.199999999997,84,4,32409.789999999997,23955.59
15989,U17501,88,155849.49,77,11,299035.37999999995,454884.86999999994
15990,U37976,88,-7779.360000000001,76,12,112722.27999999998,104942.91999999998
15991,U34399,88,30549.20000000004,55,33,238937.81999999998,269487.02
15992,U17194,88,-411528.0899999999,71,17,2887587.7500000005,2476059.6600000006
15993,U14943,88,-4462.560000000005,63,25,196981.17999999996,192518.61999999997
15994,U11502,88,1927.529999999998,78,10,21218.620000000003,23146.15
15995,U26863,88,-24031.32,83,5,46621.47000000001,22590.15000000001
15996,U15947,88,-19629.260000000002,62,26,343817.91,324188.64999999997
15997,U19184,88,16422.920000000006,41,47,235983.17,252406.09000000003
15998,U25687,88,-1653.4799999999984,59,29,65783.43000000001,64129.95000000001
15999,U30828,88,-6349.299999999999,71,17,11915.939999999997,5566.639999999998
16000,U976414,88,3350.0,45,43,10328.98,13678.98
16001,U24393,88,-10947.979999999996,75,13,134551.34999999998,123603.36999999998
16002,U30149,88,-31611.87999999983,75,13,3946078.5799999996,3914466.6999999997
16003,U17080,88,-55563.76000000026,44,44,12607902.150000002,12552338.390000002
16004,U25603,88,-576.579999999994,61,27,45092.11,44515.530000000006
16005,U8827,88,-4316.609999999986,75,13,175089.3099999999,170772.69999999992
16006,U1239689,88,2350.3599999999983,46,42,29027.48,31377.839999999997
16007,U26143,88,13354.300000000007,74,14,114490.27,127844.57
16008,U17093,88,6127.329999999999,75,13,45502.05000000001,51629.38000000001
16009,U29951,88,-17087.10999999996,69,19,447412.39999999997,430325.29
16010,U40009,88,58712.190000000024,68,20,491820.97000000003,550533.16
16011,U33107,88,2205.019999999999,78,10,15288.33,17493.35
16012,U21379,88,409325.13,51,37,418682.19,828007.3200000001
16013,U31372,88,-351.9799999999999,80,8,7511.9800000000005,7160.000000000001
16014,U8213,88,-1934.6299999999997,80,8,27983.730000000003,26049.100000000002
16015,U14207,88,27969.440000000002,68,20,143913.64,171883.08000000002
16016,U1219371,88,51.19999999999982,49,39,17369.58,17420.780000000002
16017,U1338883,88,-19249.97,69,19,34213.24999999999,14963.279999999992
16018,U38171,88,-11.079999999999018,69,19,15040.34,15029.260000000002
16019,U29550,88,25116.740000000005,72,16,35025.71,60142.450000000004
16020,U17612,88,-21395.379999999997,67,21,166799.82,145404.44
16021,U22779,88,-495.18,81,7,8659.310000000001,8164.130000000001
16022,U42085,88,44600.700000000004,47,41,444732.26999999996,489332.97
16023,U34970,88,-9197.299999999981,57,31,308862.46,299665.16000000003
16024,U34945,88,22096.27999999998,71,17,61746.619999999995,83842.89999999998
16025,U32848,88,59450.350000000006,59,29,571150.3500000001,630600.7000000001
16026,U29404,88,-8552.959999999995,69,19,106563.78,98010.82
16027,U25830,88,54038.35000000001,60,28,101692.52,155730.87000000002
16028,U34558,88,-41192.73000000001,67,21,138202.07,97009.34
16029,U29184,88,3224.0,80,8,19460.55,22684.55
16030,U8696,88,-342016.5899999999,81,7,459396.5399999999,117379.95000000001
16031,U31107,88,2620.76,62,26,47512.73,50133.490000000005
16032,U36639,88,383.7799999999997,68,20,21451.070000000003,21834.850000000002
16033,U20855,88,5776.139999999999,65,23,115924.11,121700.25
16034,U17068,88,-128708.95000000003,61,27,1680946.0,1552237.05
16035,U37945,88,27747.86999999999,61,27,347475.13,375223.0
16036,U25107,88,-30720.599999999962,62,26,506060.6800000001,475340.08000000013
16037,U33364,88,490.4499999999999,84,4,12119.17,12609.62
16038,U27062,88,-3.092281986027956e-11,49,39,228476.84,228476.83999999997
16039,U31384,88,10.000000000000341,48,40,32249.569999999996,32259.569999999996
16040,U9391,88,67611.41,78,10,166162.88999999998,233774.3
16041,U22302,88,-5246.95,86,2,5770.69,523.7399999999998
16042,U38707,88,2920.8699999999603,66,22,656853.15,659774.02
16043,U26139,87,-849.390000000003,57,30,65843.9,64994.509999999995
16044,U38889,87,134759.75,70,17,182071.20999999996,316830.95999999996
16045,U10394,87,-15404.81,61,26,104161.83999999998,88757.02999999998
16046,U15771,87,11179.180000000002,68,19,85380.41000000002,96559.59000000003
16047,U9280,87,9248.849999999999,78,9,42516.240000000005,51765.090000000004
16048,U30335,87,1093.680000000001,83,4,13364.33,14458.01
16049,U33057,87,4569.819999999999,77,10,14736.09,19305.91
16050,U14937,87,1805.7000000000025,78,9,23664.840000000004,25470.540000000008
16051,U34769,87,-16216.800000000003,72,15,84658.98,68442.18
16052,U14400,87,-40167.31,43,44,1058676.54,1018509.23
16053,U21008,87,-441848.8700000001,66,21,3343544.58,2901695.71
16054,U8143,87,536.5100000000006,75,12,9495.150000000001,10031.660000000002
16055,U15178,87,24703.849999999984,44,43,226732.47999999998,251436.32999999996
16056,U1058114,87,-0.1899999999999764,68,19,640.79,640.6
16057,U27009,87,11300.519999999946,52,35,1635958.3699999999,1647258.89
16058,U32341,87,-37513.34999999998,64,23,526011.2000000001,488497.8500000001
16059,U36555,87,-649.9699999999999,77,10,7652.06,7002.09
16060,U15154,87,-4010.5200000000004,74,13,21236.249999999996,17225.729999999996
16061,U42766,87,-1151359.1800000002,68,19,2374476.6300000004,1223117.4500000002
16062,U32217,87,7165.13,74,13,63990.139999999985,71155.26999999999
16063,U28183,87,-6145.570000000014,61,26,672398.2699999999,666252.6999999998
16064,U24800,87,73729.74000000002,54,33,189695.56999999998,263425.31
16065,U29856,87,-494.7499999999818,74,13,135702.71,135207.96000000002
16066,U38785,87,-106653.53,73,14,318362.45,211708.92
16067,U30361,87,-1700.6700000000078,56,31,90002.65,88301.97999999998
16068,U28487,87,-3077.129999999998,71,16,71198.56,68121.43
16069,U30668,87,-45.18999999999221,46,41,545013.49,544968.3
16070,U43425,87,-3795.6799999999994,81,6,24863.760000000002,21068.08
16071,U41761,87,74068.54,75,12,352236.38,426304.92
16072,U1180160,87,27.819999999997908,54,33,26934.129999999997,26961.949999999997
16073,U43942,87,1374.57,62,25,56797.83,58172.4
16074,U8353,87,7802.319999999998,75,12,12058.86,19861.18
16075,U25857,87,-32394.889999999985,47,40,956101.6,923706.71
16076,U24527,87,15982.760000000182,56,31,2255095.8800000013,2271078.6400000015
16077,U40560,87,-354.0000000000002,82,5,2701.2400000000002,2347.24
16078,U33811,87,68605.73999999999,73,14,23218.269999999993,91824.00999999998
16079,U29825,87,875.8999999999996,84,3,6941.1,7817.0
16080,U977838,87,85.95999999999935,50,37,23339.750000000004,23425.710000000003
16081,U38042,87,-42607.200000000004,70,17,109597.66999999998,66990.46999999997
16082,U25829,87,1016.6799999999948,52,35,232224.36000000002,233241.04
16083,U33325,87,4943.530000000001,76,11,35599.85,40543.38
16084,U38459,87,-8851.239999999996,76,11,27713.11999999999,18861.879999999997
16085,U21698,87,1499.210000000001,63,24,36032.61,37531.82
16086,U26920,87,77953.63000000002,44,43,1006054.19,1084007.82
16087,U22906,87,41293.330000000016,64,23,357575.68000000005,398869.01000000007
16088,U18591,87,7465.199999999895,61,26,773417.66,780882.8599999999
16089,U14563,87,-821.3100000000017,79,8,7321.390000000002,6500.080000000001
16090,U13065,87,-88049.09999999999,71,16,170268.62000000002,82219.52000000003
16091,U37387,87,12847.229999999989,79,8,11273.929999999998,24121.15999999999
16092,U21459,87,-12135.339999999998,83,4,36789.68,24654.340000000004
16093,U10309,87,-306.69999999999783,59,28,59267.62,58960.920000000006
16094,U10678,87,-381058.60000000003,61,26,1188092.69,807034.0899999999
16095,U34632,87,4602.3899999999985,79,8,12310.590000000002,16912.98
16096,U22007,87,1455.9099999999999,82,5,2219.400000000001,3675.310000000001
16097,U44008,87,-14097.210000000023,61,26,758154.94,744057.7299999999
16098,U11752,87,-63810.119999999995,78,9,99594.98000000003,35784.86000000003
16099,U8938,87,6090.410000000008,64,23,158779.83999999997,164870.24999999997
16100,U763356,87,0.9299999999995521,41,46,9427.259999999998,9428.189999999999
16101,U29300,87,-670.7299999999997,82,5,6797.57,6126.84
16102,U39602,87,49935.130000000005,67,20,212107.84,262042.97
16103,U1363850,87,-1558.230000000001,71,16,25553.799999999992,23995.569999999992
16104,U41964,87,1789.1599999999967,80,7,24225.019999999993,26014.17999999999
16105,U43849,87,-20399.739999999998,60,27,347370.57,326970.83
16106,U32611,87,3173.0500000000025,72,15,35350.850000000006,38523.90000000001
16107,U40636,87,8592.640000000001,75,12,45247.92,53840.56
16108,U1376723,87,-4363.49,55,32,107992.95999999998,103629.46999999997
16109,U42174,87,-877.6799999999976,65,22,117314.52,116436.84000000001
16110,U18425,87,11677.770000000002,72,15,68251.89000000001,79929.66000000002
16111,U37153,87,3096.919999999998,69,18,28588.11,31685.03
16112,U39652,87,5929.489999999994,71,16,153208.44,159137.93
16113,U28008,87,-6042.500000000009,67,20,28813.559999999987,22771.059999999976
16114,U11058,87,54738.100000000006,51,36,97957.31000000001,152695.41000000003
16115,U27356,87,26321.45000000003,76,11,167566.49999999994,193887.94999999998
16116,U40878,87,-1693.6800000000076,74,13,127613.59000000001,125919.91
16117,U20066,87,-10490.27999999994,68,19,279329.37,268839.0900000001
16118,U27037,87,199464.77000000002,44,43,608773.2,808237.97
16119,U30654,87,172793.85,74,13,68615.76000000001,241409.61000000002
16120,U14319,87,-15024.449999999979,63,24,249323.37,234298.92
16121,U38007,87,-2658.2000000000025,74,13,66053.09,63394.88999999999
16122,U27394,87,114792.8,76,11,91258.99,206051.79
16123,U11230,87,-79166.87999999999,78,9,192104.25,112937.37000000001
16124,U27418,87,-734.2200000000012,50,37,340731.6,339997.38
16125,U16239,87,-22405.2,68,19,83401.35,60996.15000000001
16126,U33253,87,461.2499999999982,43,44,188643.7,189104.95
16127,U31604,87,27198.360000000004,68,19,66781.02,93979.38
16128,U32646,87,-12989.190000000002,58,29,182762.20999999993,169773.01999999993
16129,U29244,87,-7939.670000000003,62,25,526057.1300000002,518117.46000000025
16130,U30874,87,-5712.690000000013,52,35,612955.9900000001,607243.3
16131,U33084,87,551.7399999999997,76,11,7615.24,8166.98
16132,U14301,87,480.9999999999889,51,36,243044.63999999998,243525.63999999998
16133,U22015,87,5653.880000000001,73,14,27665.790000000005,33319.670000000006
16134,U28142,87,9750.41000000001,59,28,293177.32000000007,302927.7300000001
16135,U40283,87,-51115.429999999986,70,17,315602.3899999999,264486.9599999999
16136,U23224,87,6040.280000000001,62,25,180380.85999999996,186421.13999999996
16137,U14434,87,-4411.55,79,8,25187.980000000003,20776.430000000004
16138,U37182,87,11366.009999999964,67,20,1423498.36,1434864.37
16139,U9618,87,435451.07,62,25,2048956.0,2484407.07
16140,U31933,87,11826.349999999997,32,55,67539.23000000003,79365.58000000002
16141,U17396,87,52692.86999999998,51,36,3147817.8000000007,3200510.670000001
16142,U22653,87,-126508.01,72,15,148656.13999999998,22148.12999999999
16143,U37281,87,2651.379999999999,79,8,5345.280000000001,7996.66
16144,U15517,87,-93563.98999999999,45,42,709828.6,616264.61
16145,U27492,87,5838.04,67,20,24962.039999999997,30800.079999999998
16146,U29104,87,-8209.340000000011,65,22,257035.93,248826.58999999997
16147,U40049,87,-5672.469999999999,76,11,25469.670000000006,19797.200000000004
16148,U37398,87,-5086.330000000001,78,9,34949.64,29863.309999999998
16149,U16846,87,-5426.130000000004,35,52,550163.11,544736.98
16150,U9488,87,16221.509999999878,59,28,2359519.17,2375740.6799999997
16151,U1352365,87,-1437.5900000000008,61,26,14735.329999999998,13297.739999999998
16152,U21154,87,-9808.420000000171,72,15,2193316.2299999986,2183507.809999998
16153,U14273,87,2859.4799999999964,59,28,183568.12,186427.6
16154,U26540,87,-11312.279999999984,66,21,128516.18000000001,117203.90000000002
16155,U33451,87,-23420.51,66,21,82012.96999999999,58592.45999999999
16156,U1364780,87,-3844.5200000000077,63,24,216211.48,212366.96
16157,U28040,87,1818.9500000000126,71,16,112061.02999999997,113879.97999999998
16158,U28883,87,-767552.81,74,13,996673.81,229121.0
16159,U35412,87,5324.440000000022,65,22,121377.99999999997,126702.43999999999
16160,U22520,87,-2726.279999999997,70,17,70906.93999999997,68180.65999999997
16161,U23390,87,112945.69000000008,45,42,1623925.73,1736871.4200000002
16162,U15373,87,-13920.020000000068,67,20,996715.0900000004,982795.0700000004
16163,U40270,87,-27162.910000000036,60,27,320321.35000000003,293158.44
16164,U17353,87,-28980.06,77,10,108480.38000000003,79500.32000000004
16165,U15939,87,-3081.559999999996,63,24,102438.15000000001,99356.59000000001
16166,U16448,87,40919.55000000001,61,26,250091.13999999998,291010.69
16167,U41366,87,-16079.809999999978,66,21,195974.36,179894.55000000002
16168,U20104,87,-8243.029999999999,81,6,68950.36999999998,60707.33999999998
16169,U34017,87,27591.309999999998,38,49,56766.21999999999,84357.52999999998
16170,U14784,87,131846.25000000003,34,53,190697.91999999998,322544.17000000004
16171,U18037,87,42980.71999999999,55,32,462601.88000000006,505582.60000000003
16172,U28310,87,3849.4799999999946,71,16,53672.19,57521.67
16173,U24376,87,50402.399999999994,56,31,401888.66,452291.05999999994
16174,U25803,87,-29363.18000000001,55,32,166625.18,137261.99999999997
16175,U27215,87,-1679.7800000000002,83,4,8793.22,7113.439999999999
16176,U11625,87,-36158.46000000001,72,15,215903.52999999997,179745.06999999995
16177,U8049,87,-3110.9800000000014,70,17,53134.9,50023.92
16178,U24253,87,10362.370000000006,37,50,344936.64,355299.01
16179,U8300,87,137.29999999999927,72,15,115521.23,115658.53
16180,U9334,87,-22791.899999999998,79,8,91256.33,68464.43000000001
16181,U34213,87,-161.76000000000056,74,13,49769.54000000001,49607.780000000006
16182,U42974,87,17195.970000000005,59,28,170758.14,187954.11000000002
16183,U32519,87,-5801.99,40,47,126448.75000000001,120646.76000000001
16184,U23782,87,1974.9999999999945,35,52,2359031.1900000004,2361006.1900000004
16185,U19526,87,-1908.5199999999977,73,14,40539.33,38630.810000000005
16186,U23249,87,4026.149999999998,73,14,128439.48000000001,132465.63
16187,U26909,87,-106355.44999999995,56,31,857459.3999999999,751103.95
16188,U37171,86,-2141.3300000000017,56,30,152193.3,150051.96999999997
16189,U24751,86,281.81999999999516,63,23,197284.19999999998,197566.02
16190,U29004,86,3915.739999999999,77,9,38632.700000000004,42548.44
16191,U26753,86,2586.710000000001,64,22,18483.39,21070.1
16192,U15279,86,-810.1199999999965,75,11,63035.5,62225.380000000005
16193,U38635,86,-2430.3500000000004,74,12,12660.58,10230.23
16194,U31103,86,-1810580.9599999997,72,14,2050944.56,240363.60000000033
16195,U36487,86,1695.4900000002235,33,53,6830681.0,6832376.49
16196,U28637,86,-174543.93,68,18,384769.35,210225.41999999998
16197,U39928,86,-827.64,62,24,73715.04999999999,72887.40999999999
16198,U13756,86,-18014.229999999985,53,33,611984.9400000001,593970.7100000001
16199,U1317011,86,455.12999999999954,56,30,6715.160000000002,7170.290000000001
16200,U31185,86,-39430.21000000001,76,10,82263.09999999999,42832.889999999985
16201,U15569,86,-28053.00999999999,56,30,275745.63999999996,247692.62999999998
16202,U14510,86,12177.389999999972,47,39,590264.7100000001,602442.1000000001
16203,U19609,86,-1017.35,73,13,19938.299999999996,18920.949999999997
16204,U13574,86,43190.46999999998,69,17,62878.86,106069.32999999999
16205,U31261,86,1221.700000000042,67,19,990547.7100000001,991769.4100000001
16206,U21585,86,5445.789999999983,64,22,277247.12999999995,282692.9199999999
16207,U44004,86,1763.7499999999918,63,23,138227.18,139990.93
16208,U42052,86,7288.909999999999,81,5,32103.32,39392.229999999996
16209,U37322,86,2409.0999999999995,68,18,48251.5,50660.6
16210,U1188319,86,-5854.669999999997,73,13,21707.46,15852.79
16211,U12946,86,-2931.1800000000085,66,20,37821.04,34889.85999999999
16212,U41123,86,2005.229999999995,70,16,24831.529999999995,26836.75999999999
16213,U21755,86,-10746.569999999998,71,15,81502.17000000001,70755.60000000002
16214,U19028,86,-409948.5600000003,65,21,4766001.13,4356052.569999999
16215,U12141,86,-21161.42,64,22,104951.50000000003,83790.08000000003
16216,U666857,86,47.30000000000018,51,35,19024.589999999997,19071.889999999996
16217,U1157016,86,-3901.460000000001,72,14,7738.870000000002,3837.4100000000008
16218,U11665,86,4688.37,62,24,63322.44000000003,68010.81000000003
16219,U12938,86,3131.310000000002,78,8,32032.559999999998,35163.87
16220,U24246,86,77180.55000000002,77,9,126352.61,203533.16000000003
16221,U33264,86,1451.08,81,5,8713.959999999997,10165.039999999997
16222,U9172,86,-24332.170000000002,75,11,66078.58000000002,41746.41000000002
16223,U34405,86,8697.580000000002,70,16,11161.310000000001,19858.890000000003
16224,U42513,86,22551.86999999998,54,32,321743.79,344295.66
16225,U16454,86,1610.410000000058,61,25,505055.33999999997,506665.75
16226,U29849,86,-997034.0499999993,64,22,7521593.22,6524559.17
16227,U26965,86,234.22000000002026,37,49,74854.39,75088.61000000002
16228,U33861,86,-51652.90000000011,63,23,2048150.2,1996497.2999999998
16229,U38167,86,16107.34,61,25,186494.47999999998,202601.81999999998
16230,U15427,86,8552.950000000003,75,11,285793.89,294346.84
16231,U8323,86,-324.23000000000036,70,16,10642.899999999998,10318.669999999998
16232,U34547,86,-11745.619999999999,74,12,52335.12000000001,40589.500000000015
16233,U39518,86,210004.67000000004,74,12,585595.7200000001,795600.3900000001
16234,U19362,86,-60299.82999999998,58,28,579010.75,518710.92000000004
16235,U27582,86,6321.380000000001,62,24,14491.650000000001,20813.030000000002
16236,U43417,86,-970.0300000000025,65,21,37609.4,36639.369999999995
16237,U15993,86,1455.4300000000076,54,32,802859.16,804314.5900000001
16238,U16330,86,7.6700000000419095,33,53,897755.9299999999,897763.6
16239,U29196,86,14386.93,69,17,43617.590000000004,58004.520000000004
16240,U43195,86,-26710.02,82,4,32248.9,5538.880000000001
16241,U16936,86,-9716.979999999994,58,28,194643.38999999998,184926.41
16242,U20362,86,13052.169999999991,61,25,322835.05,335887.22
16243,U28970,86,-20989.820000000003,63,23,87628.73999999999,66638.91999999998
16244,U10293,86,212078.1499999999,59,27,2393927.69,2606005.84
16245,U15529,86,15505.500000000011,68,18,294613.19999999995,310118.69999999995
16246,U38497,86,2384.110000000014,65,21,304406.31,306790.42
16247,U35655,86,63807.95999999999,70,16,71232.09,135040.05
16248,U16701,86,44560.190000000024,80,6,62541.879999999976,107102.07
16249,U9775,86,-1507.899999999996,80,6,38672.890000000014,37164.99000000002
16250,U13414,86,5831.23000000001,54,32,353616.47,359447.69999999995
16251,U23212,86,34631.50999999999,66,20,174955.9000000001,209587.4100000001
16252,U18909,86,1584.4999999999982,66,20,81243.12,82827.62
16253,U40127,86,44076.88999999999,82,4,15998.409999999998,60075.29999999999
16254,U28069,86,68842.20999999998,78,8,70765.29999999997,139607.50999999995
16255,U24851,86,-4147.530000000001,76,10,8788.959999999997,4641.429999999997
16256,U40710,86,-779890.4400000002,77,9,1941360.71,1161470.2699999998
16257,U20594,86,-1678.449999999997,57,29,141062.26,139383.81
16258,U28750,86,376.5799999999999,67,19,26865.69,27242.269999999997
16259,U26411,86,-350948.25999999995,63,23,563377.9400000001,212429.6800000001
16260,U27295,86,9835.0,75,11,130256.54999999997,140091.55
16261,U29847,86,4366.880000000001,65,21,61990.62,66357.5
16262,U1383187,86,-44.77000000000061,50,36,18736.38,18691.61
16263,U24984,86,550.1500000000003,77,9,15557.23,16107.38
16264,U36740,86,4665.879999999983,66,20,197989.91999999995,202655.79999999993
16265,U26581,86,-44410.47,70,16,98205.04999999999,53794.57999999999
16266,U28938,86,-11389.280000000006,51,35,233218.08999999997,221828.80999999997
16267,U34784,86,12647.769999999999,73,13,100037.37999999999,112685.15
16268,U40130,86,-110180.9600000001,69,17,643488.3900000001,533307.43
16269,U43853,86,-40198.119999999995,56,30,155879.62999999998,115681.50999999998
16270,U15509,86,-5996.919999999998,78,8,27185.92999999999,21189.00999999999
16271,U34919,86,-3051.7400000000052,44,42,1010667.78,1007616.04
16272,U26874,86,-100205.73999999998,61,25,334453.02,234247.28000000003
16273,U36914,86,-59528.240000000005,79,7,104054.23999999999,44525.999999999985
16274,U14104,86,-5329.76999999996,49,37,1039283.64,1033953.8700000001
16275,U40972,86,78564.19000000005,77,9,20391.32,98955.51000000004
16276,U17270,86,1444.0099999999966,51,35,221414.53,222858.54
16277,U1240799,86,420.6299999999993,43,43,13923.72,14344.349999999999
16278,U40953,86,8151.009999999998,76,10,29094.930000000004,37245.94
16279,U38815,86,1062.3499999999995,77,9,15611.470000000001,16673.82
16280,U21562,86,-9940.899999999994,80,6,46787.940000000024,36847.04000000003
16281,U22604,86,-11710.939999999997,48,38,48864.06,37153.12
16282,U35341,86,-1882.7100000000057,71,15,106762.47999999998,104879.76999999997
16283,U20516,86,18401.259999999995,65,21,276555.32000000007,294956.5800000001
16284,U16792,86,24452.489999999998,57,29,257438.06,281890.55
16285,U10477,86,6906.179999999998,80,6,21945.04,28851.219999999998
16286,U30698,86,-2927.8600000000006,69,17,28298.38,25370.52
16287,U36095,86,-112908.36000000004,49,37,760717.0,647808.6399999999
16288,U21841,86,42216.590000000084,36,50,5829876.0,5872092.59
16289,U31029,86,21279.659999999996,65,21,254859.93000000002,276139.59
16290,U35551,86,39226.24999999997,72,14,689432.72,728658.97
16291,U29135,86,2191.3600000000015,70,16,95862.05,98053.41
16292,U32942,86,-38932.729999999996,69,17,183061.49,144128.76
16293,U16469,86,-50103.48999999998,51,35,526418.92,476315.43000000005
16294,U24209,86,-1102.349999999997,71,15,152020.4,150918.05
16295,U28124,86,-5290.260000000009,49,37,1032120.17,1026829.91
16296,U38648,86,-1193.7400000000005,73,13,31550.64,30356.899999999998
16297,U779742,86,-39.369999999999436,73,13,52185.70999999999,52146.33999999999
16298,U34529,86,5562.19,79,7,9883.259999999997,15445.449999999997
16299,U18916,86,-14044.640000000003,65,21,42266.72000000001,28222.080000000005
16300,U41632,86,57131.03999999999,73,13,64835.41,121966.45
16301,U16829,86,47202.380000000005,72,14,805576.7500000003,852779.1300000004
16302,U23708,86,29822.609999999997,77,9,19014.480000000007,48837.090000000004
16303,U16691,86,-409534.6999999999,70,16,1831300.7799999998,1421766.0799999998
16304,U27230,86,-26065.179999999993,71,15,116350.10999999999,90284.93
16305,U15359,86,-115141.69000000018,46,40,5364175.93,5249034.239999999
16306,U17511,86,-77560.16,60,26,672154.5200000001,594594.3600000001
16307,U21775,86,1898.5499999999956,73,13,306600.89,308499.44
16308,U37995,86,7727.34,67,19,160841.96,168569.3
16309,U41258,86,-3356.83,74,12,16157.699999999999,12800.869999999999
16310,U40783,86,212.8100000000013,52,34,75476.11,75688.92
16311,U21854,86,-7120.9,78,8,11167.759999999998,4046.8599999999988
16312,U27222,86,-460.6299999999993,52,34,30973.210000000006,30512.580000000005
16313,U10680,86,-1041.8100000000018,79,7,17990.869999999995,16949.059999999994
16314,U28676,86,227295.42,66,20,375095.94999999995,602391.37
16315,U39262,86,1246.69,79,7,9603.050000000001,10849.740000000002
16316,U43494,86,-7739.490000000002,79,7,12601.889999999996,4862.399999999994
16317,U39231,86,-9574.069999999998,71,15,84656.02,75081.95000000001
16318,U35651,86,2886.4099999999853,69,17,322618.88999999996,325505.29999999993
16319,U14788,86,7961.7899999999945,72,14,122609.01,130570.79999999999
16320,U11900,86,1463.5500000000084,71,15,66694.29999999999,68157.84999999999
16321,U10438,86,2251.8800000000047,81,5,43822.799999999996,46074.68
16322,U17959,86,7024.679999999996,77,9,16108.39,23133.069999999996
16323,U37374,86,3796.460000000001,78,8,7395.5,11191.960000000001
16324,U23019,86,-346.05000000000007,80,6,11589.199999999997,11243.149999999998
16325,U24431,86,-137941.09,74,12,339178.72,201237.62999999998
16326,U9339,86,14539.11,75,11,86328.87999999998,100867.98999999998
16327,U24757,86,-37485.19999999999,74,12,75908.66,38423.460000000014
16328,U37518,86,-91.11000000000026,65,21,30988.839999999997,30897.729999999996
16329,U12451,86,-1513.570000000002,75,11,32393.44,30879.869999999995
16330,U26266,86,-14907.430000000037,54,32,893165.14,878257.71
16331,U23756,86,3836.6500000000087,79,7,172135.17,175971.82
16332,U17409,85,-10264.879999999941,44,41,612497.1199999998,602232.2399999999
16333,U12528,85,-10325.510000000004,65,20,40537.80999999999,30212.29999999999
16334,U1361858,85,-15.000000000000018,14,71,136.76,121.75999999999998
16335,U40331,85,-113118.78999999998,68,17,965239.37,852120.5800000001
16336,U8540,85,4.489999999999782,63,22,21842.600000000002,21847.090000000004
16337,U16619,85,27661.530000000035,59,26,156211.68,183873.21000000002
16338,U40108,85,-5639.1799999999985,70,15,90692.77,85053.59000000001
16339,U11240,85,-783.5100000000001,69,16,7273.420000000001,6489.910000000001
16340,U38686,85,27773.880000000005,55,30,103308.31000000001,131082.19
16341,U26906,85,-96805.84000000021,59,26,6205435.540000002,6108629.700000002
16342,U10399,85,-3797.240000000001,71,14,29398.259999999995,25601.019999999993
16343,U29973,85,-187133.49000000017,46,39,1633925.73,1446792.2399999998
16344,U27500,85,21898.33000000001,73,12,25735.67999999999,47634.009999999995
16345,U18509,85,-29982.15,60,25,100962.79000000001,70980.64000000001
16346,U36880,85,10687.819999999989,68,17,138340.24000000002,149028.06
16347,U12086,85,-7387.9,82,3,8495.95,1108.050000000001
16348,U13139,85,-14343.37999999998,65,20,444065.97,429722.58999999997
16349,U39427,85,22656.620000000003,47,38,664450.9600000001,687107.5800000001
16350,U18848,85,3788.580000000002,71,14,34629.74,38418.32
16351,U28725,85,-36452.81999999998,55,30,298308.8,261855.98
16352,U17466,85,-517308.9199999998,42,43,5006889.3,4489580.38
16353,U8237,85,7698.470000000019,53,32,634280.18,641978.65
16354,U8849,85,2088.650000000001,77,8,14831.049999999992,16919.699999999993
16355,U13257,85,-149524.36999999997,49,36,609463.54,459939.17000000004
16356,U19478,85,-11577.909999999998,68,17,76616.25999999997,65038.34999999997
16357,U38001,85,76499.80999999991,66,19,5316609.410000002,5393109.220000002
16358,U24995,85,630.7799999999961,67,18,40374.93,41005.71
16359,U14418,85,15700.259999999997,62,23,138026.96,153727.22
16360,U20350,85,-120508.88999999997,68,17,730146.2099999998,609637.3199999998
16361,U42005,85,-131043.84999999998,71,14,1635818.3399999999,1504774.4899999998
16362,U9445,85,-5855.84,62,23,48069.69,42213.850000000006
16363,U29221,85,-84613.55000000002,60,25,711898.54,627284.99
16364,U33864,85,13840.750000000018,75,10,29680.279999999995,43521.03000000001
16365,U21364,85,-18078.16999999999,73,12,265195.49,247117.32
16366,U17321,85,-90032.70999999996,55,30,1401085.41,1311052.7
16367,U9825,85,-40803.00999999998,46,39,367836.17000000004,327033.16000000003
16368,U18482,85,-1280.2599999999975,47,38,95707.0,94426.74
16369,U41581,85,-4279.290000000145,63,22,7758253.5,7753974.21
16370,U27465,85,3705.5000000000027,49,36,207492.31,211197.81
16371,U40137,85,39558.59000000001,67,18,159266.44999999998,198825.03999999998
16372,U8769,85,-6655.880000000001,76,9,36357.69999999998,29701.81999999998
16373,U29235,85,-9806.080000000022,53,32,336271.3399999999,326465.2599999999
16374,U33791,85,-4045.7099999999996,69,16,12442.680000000002,8396.970000000003
16375,U15753,85,-9175.8,53,32,43650.85,34475.05
16376,U17257,85,-4554.459999999971,47,38,3343208.32,3338653.86
16377,U34308,85,9972.24,75,10,17407.23,27379.47
16378,U8429,85,-2655.8600000000006,75,10,29352.82,26696.96
16379,U40141,85,-31739.70000000002,50,35,363618.64,331878.94
16380,U31695,85,2738.150000000002,68,17,58057.01000000001,60795.16000000001
16381,U9492,85,-47753.28,63,22,199340.46,151587.18
16382,U40439,85,30887.370000000003,65,20,88706.13000000002,119593.50000000003
16383,U11319,85,-11628.960000000001,80,5,22297.260000000002,10668.300000000001
16384,U19646,85,-174.09000000000378,76,9,421426.44000000006,421252.35000000003
16385,U24973,85,48019.24999999997,60,25,357995.82,406015.06999999995
16386,U23854,85,-2939.0899999999965,52,33,391439.58999999997,388500.5
16387,U13663,85,-55854.02999999999,41,44,307573.62,251719.59
16388,U9281,85,-6761.860000000001,72,13,21826.120000000003,15064.260000000002
16389,U16753,85,306716.28,56,29,813836.53,1120552.81
16390,U22305,85,13076.550000000008,65,20,260746.3,273822.85
16391,U35251,85,932.260000000001,64,21,13822.39,14754.65
16392,U37820,85,-386.8499999999993,77,8,7952.560000000002,7565.710000000003
16393,U30214,85,35893.280000000006,77,8,47859.01,83752.29000000001
16394,U36989,85,15737.059999999996,80,5,13922.0,29659.059999999998
16395,U10214,85,46772.33999999998,70,15,96812.48999999999,143584.82999999996
16396,U13681,85,526183.7400000001,24,61,1907095.74,2433279.48
16397,U965757,85,-1305.8600000000013,70,15,40708.979999999996,39403.119999999995
16398,U19050,85,-20277.29999999993,55,30,2819784.85,2799507.5500000003
16399,U15720,85,-5778.539999999961,57,28,634682.87,628904.3300000001
16400,U19295,85,12757.94999999999,71,14,136301.38,149059.33
16401,U42009,85,-648.1699999999983,74,11,70218.76999999999,69570.59999999999
16402,U42994,85,-9079.940000000017,72,13,793685.7700000001,784605.8300000001
16403,U27389,85,-170652.15,57,28,641499.05,470846.9
16404,U31171,85,10285.830000000033,59,26,2068278.18,2078564.01
16405,U38200,85,6488.299999999997,62,23,84409.12999999999,90897.43
16406,U27793,85,329529.49000000005,67,18,212322.73999999993,541852.23
16407,U28492,85,416.09000000000015,66,19,45268.73000000001,45684.82000000001
16408,U25301,85,-5713.990000000023,58,27,196444.11,190730.11999999997
16409,U29408,85,-402.3199999999959,60,25,106457.48000000001,106055.16000000002
16410,U37769,85,27532.760000000002,72,13,36492.200000000004,64024.96000000001
16411,U13104,85,9472.340000000064,69,16,525162.7099999998,534635.0499999999
16412,U34290,85,-2402.879999999998,80,5,32605.259999999995,30202.379999999997
16413,U8303,85,8558.269999999991,66,19,74195.65,82753.91999999998
16414,U10030,85,15885.299999999997,74,11,112852.56999999998,128737.86999999998
16415,U40740,85,-1169.3300000000004,58,27,142316.52999999997,141147.19999999998
16416,U8375,85,15947.750000000011,74,11,232343.84999999998,248291.59999999998
16417,U8537,85,-36284.790000000015,56,29,654791.6400000001,618506.8500000001
16418,U31870,85,-12344.89,66,19,114359.97,102015.08
16419,U28812,85,-2241.7199999999975,79,6,28896.28,26654.56
16420,U16650,85,-232899.39000000022,60,25,2481143.0300000003,2248243.64
16421,U19782,85,12199.830000000002,78,7,12732.099999999999,24931.93
16422,U41232,85,-71036.31000000008,55,30,894264.7,823228.3899999999
16423,U18600,85,-23277.45,69,16,441108.36,417830.91
16424,U10932,85,-28406.96000000001,69,16,193756.18999999997,165349.22999999995
16425,U38754,85,83197.30999999997,78,7,76321.56000000001,159518.87
16426,U37510,85,212.5500000000011,79,6,21936.480000000003,22149.030000000006
16427,U35887,85,-24700.36000000002,46,39,957459.2799999999,932758.9199999999
16428,U32742,85,80690.95,65,20,439510.25,520201.2
16429,U20144,85,-20609.87000000001,67,18,167052.75,146442.88
16430,U20526,85,16563.970000000023,65,20,363066.94,379630.91000000003
16431,U32867,85,265.4999999999977,80,5,22839.35,23104.849999999995
16432,U42954,85,3363.1999999999935,69,16,72018.51999999999,75381.71999999999
16433,U15508,85,-2951.7299999999623,51,34,815169.43,812217.7000000001
16434,U23517,85,-7355.530000000012,63,22,299324.0700000003,291968.54000000027
16435,U41690,85,-251502.81000000008,63,22,1743080.6399999997,1491577.8299999996
16436,U25957,85,-845.5199999999988,79,6,12291.619999999997,11446.099999999999
16437,U17423,85,-8218.620000000003,56,29,231984.67,223766.05000000002
16438,U23537,85,-19866.470000000005,51,34,296175.64,276309.17
16439,U17192,85,1058.0899999999965,70,15,51168.35,52226.439999999995
16440,U33492,85,-2201.189999999999,55,30,75812.48,73611.29
16441,U35023,85,-51670.25999999987,69,16,2364474.59,2312804.33
16442,U992546,85,48.37999999999994,54,31,6430.2,6478.58
16443,U937301,85,-1809.6400000000003,46,39,18127.020000000004,16317.380000000005
16444,U22864,85,919871.3700000002,45,40,5978939.42,6898810.79
16445,U13754,85,4374.709999999998,73,12,64442.05,68816.76
16446,U1271293,85,89.38999999999996,46,39,16984.6,17073.989999999998
16447,U42393,85,17060.08,70,15,20360.2,37420.28
16448,U9895,85,-11161.999999999996,70,15,139095.80999999997,127933.80999999997
16449,U35287,85,-15146.66,66,19,273835.18,258688.52
16450,U18913,85,6526.5800000000745,65,20,1533841.5199999998,1540368.0999999999
16451,U25458,85,2956.5600000000236,55,30,134453.50999999998,137410.07
16452,U13119,85,-8141.56,72,13,95138.57,86997.01000000001
16453,U35247,85,3700.970000000045,53,32,1038851.9600000001,1042552.9300000002
16454,U28396,85,-8169.990000000003,57,28,30706.48,22536.489999999998
16455,U10189,85,-287.6799999999989,49,36,39307.70000000001,39020.02000000001
16456,U26834,85,400978.37,68,17,186577.97999999998,587556.35
16457,U25546,85,-121.69999999999709,71,14,68494.14000000001,68372.44000000002
16458,U43405,85,1205409.1,71,14,149855.91999999993,1355265.02
16459,U20294,85,-1204.0300000000004,81,4,5242.650000000001,4038.62
16460,U1102215,85,-7613.839999999998,63,22,28158.15,20544.310000000005
16461,U25240,85,-182034.51,75,10,272644.37,90609.85999999999
16462,U34033,85,-14934.580000000004,77,8,76657.22,61722.64
16463,U32730,85,8710.870000000004,70,15,9929.909999999998,18640.780000000002
16464,U17891,85,-522.510000000005,64,21,111505.81,110983.29999999999
16465,U40149,85,-299.3400000000004,74,11,8099.589999999999,7800.249999999999
16466,U27214,85,106.4399999999996,57,28,37036.15,37142.590000000004
16467,U11906,85,-1214.3100000000009,76,9,15571.08,14356.769999999999
16468,U36398,85,-3733.2100000000023,79,6,23779.4,20046.19
16469,U34176,85,-2561.4199999999973,80,5,9083.809999999998,6522.39
16470,U1243270,85,1506.75,53,32,11815.699999999999,13322.449999999999
16471,U37004,85,73.37000000000239,55,30,108584.33,108657.7
16472,U590600,85,-724.2600000000018,52,33,24699.420000000006,23975.160000000003
16473,U12914,85,-31088.630000000005,73,12,242777.43000000002,211688.80000000002
16474,U21919,85,60380.44999999997,64,21,565302.53,625682.98
16475,U26098,85,1444.6300000000028,68,17,110163.61999999998,111608.24999999999
16476,U43829,85,439.4300000000012,69,16,37794.71000000001,38234.14000000001
16477,U31262,85,15824.519999999997,67,18,11707.07,27531.589999999997
16478,U846954,84,1.2499999999987268,41,43,15533.869999999999,15535.119999999997
16479,U8802,84,-5282.54,77,7,20197.72,14915.18
16480,U26855,84,-6300.80999999999,45,39,179813.91999999998,173513.11
16481,U33116,84,-5747.669999999999,60,24,54908.47000000001,49160.80000000001
16482,U43618,84,-30238.130000000005,78,6,96132.33,65894.2
16483,U19054,84,-6858.639999999992,68,16,100587.17000000001,93728.53000000003
16484,U18041,84,-1395.4499999999825,63,21,205259.61,203864.16
16485,U42704,84,-15938.59,60,24,50563.229999999996,34624.64
16486,U29883,84,309093.08,70,14,74625.6,383718.68000000005
16487,U42951,84,2018.2499999999986,69,15,18179.359999999997,20197.609999999997
16488,U40003,84,44016.65,63,21,126818.47,170835.12
16489,U9008,84,14288.420000000004,75,9,90512.38,104800.8
16490,U10921,84,11824.810000000001,41,43,207424.1,219248.91
16491,U35176,84,-130.66000000000008,71,13,16973.159999999996,16842.499999999996
16492,U20654,84,-85421.05000000002,59,25,326168.83999999997,240747.78999999995
16493,U10685,84,-300.80999999999995,73,11,8108.27,7807.460000000001
16494,U28814,84,-3656.4499999999434,63,21,1113805.51,1110149.06
16495,U17768,84,2777.26,67,17,105682.47999999998,108459.73999999998
16496,U22791,84,-64480.450000000004,66,18,358361.58999999997,293881.13999999996
16497,U33266,84,690.6600000000026,67,17,253098.12000000002,253788.78000000003
16498,U1356048,84,-691.7900000000001,71,13,5035.290000000001,4343.500000000001
16499,U38328,84,-15057.29,71,13,22484.700000000004,7427.4100000000035
16500,U28890,84,25096.329999999994,61,23,625754.5499999999,650850.8799999999
16501,U31368,84,1185.4800000000005,73,11,10327.11,11512.59
16502,U28159,84,60891.04000000002,68,16,173315.51,234206.55000000005
16503,U11726,84,-485849.18000000005,68,16,894042.0500000002,408192.8700000001
16504,U11220,84,4575.08999999999,72,12,48725.630000000005,53300.719999999994
16505,U17406,84,71480.26,42,42,929145.6399999999,1000625.8999999999
16506,U27415,84,333.6899999999987,52,32,110809.4,111143.09
16507,U13848,84,-27533.910000000014,76,8,74258.13000000003,46724.220000000016
16508,U28591,84,-2308.770000000002,69,15,23558.420000000002,21249.65
16509,U33080,84,-15310.699999999992,72,12,113911.68999999999,98600.98999999999
16510,U14109,84,-8853.349999999995,54,30,286303.79,277450.44
16511,U9042,84,10682.900000000003,59,25,63332.41000000001,74015.31000000001
16512,U37618,84,12379.990000000029,53,31,328052.81000000006,340432.8000000001
16513,U43754,84,10613.330000000002,70,14,12658.24,23271.57
16514,U20677,84,47.52000000000089,67,17,11847.220000000001,11894.740000000002
16515,U33527,84,-128.38999999999942,56,28,45515.31,45386.92
16516,U1205254,84,-694.1699999999964,40,44,99401.5,98707.33
16517,U12904,84,290.0899999999866,59,25,494958.8300000001,495248.92000000004
16518,U28236,84,-3625.3700000000026,72,12,141807.90000000002,138182.53000000003
16519,U9683,84,53015.44,52,32,90088.56999999999,143104.01
16520,U39886,84,2203.5599999999977,76,8,38464.58,40668.14
16521,U17411,84,-406082.56,63,21,920439.07,514356.50999999995
16522,U31699,84,-19975.97,74,10,76739.68999999996,56763.71999999996
16523,U11349,84,-186611.55000000008,75,9,1014967.8799999997,828356.3299999996
16524,U24211,84,28529.909999999996,65,19,82447.05000000002,110976.96000000002
16525,U18618,84,-5503.1900000000005,57,27,50871.12,45367.93
16526,U27695,84,6817.949999999997,64,20,126609.35,133427.3
16527,U16017,84,-4778.729999999997,61,23,63431.64000000001,58652.91000000001
16528,U15268,84,-637.5400000000081,61,23,309908.74,309271.19999999995
16529,U36776,84,-3030.1399999999985,75,9,14655.389999999996,11625.249999999996
16530,U17832,84,-3821.379999999999,64,20,39114.49000000002,35293.11000000002
16531,U29154,84,9857.240000000033,37,47,1246977.89,1256835.13
16532,U42985,84,5894.659999999996,62,22,66249.32999999999,72143.98999999999
16533,U34797,84,18215.309999999965,65,19,258867.06999999998,277082.37999999995
16534,U10008,84,-1206526.769999999,70,14,3299926.259999998,2093399.4899999988
16535,U15848,84,-29082.71999999972,59,25,3929696.01,3900613.29
16536,U8209,84,379.1600000000009,63,21,115508.53000000001,115887.69000000002
16537,U31401,84,806.8499999999958,50,34,209655.0,210461.85
16538,U23909,84,16706.530000000086,55,29,1213619.6700000002,1230326.2000000002
16539,U25373,84,-26247.039999999997,53,31,108787.0,82539.96
16540,U12564,84,6537.57,70,14,37253.17,43790.74
16541,U33214,84,317.8399999999999,70,14,26264.15999999999,26581.99999999999
16542,U14755,84,-998703.5500000003,33,51,3009920.43,2011216.88
16543,U1051312,84,-588.8499999999999,72,12,3165.4,2576.55
16544,U17781,84,-5378.85,76,8,78709.61,73330.76
16545,U42790,84,3828.750000000002,44,40,172720.59999999998,176549.34999999998
16546,U38778,84,12440.62000000001,72,12,72243.84999999999,84684.47
16547,U28719,84,21207.24000000002,73,11,244511.46999999997,265718.70999999996
16548,U28453,84,11283.77,71,13,159370.44999999998,170654.21999999997
16549,U11529,84,6645.740000000002,64,20,57104.84,63750.58
16550,U15485,84,7356.880000000005,69,15,662888.53,670245.41
16551,U39661,84,5282.469999999976,58,26,289120.04000000004,294402.51
16552,U21288,84,10362.84,52,32,40630.950000000004,50993.79000000001
16553,U31112,84,9812.560000000009,74,10,103334.40000000001,113146.96000000002
16554,U949855,84,-4107.440000000001,61,23,31827.72,27720.28
16555,U24482,84,115470.72999999997,52,32,173229.51999999993,288700.2499999999
16556,U17752,84,70.5899999999989,76,8,11651.990000000002,11722.58
16557,U38418,84,12656.76999999999,59,25,289296.24,301953.01
16558,U35248,84,-11129.939999999997,66,18,24854.46,13724.520000000002
16559,U42950,84,38475.48000000002,79,5,77997.15,116472.63
16560,U31174,84,7998.619999999992,55,29,223279.62999999998,231278.24999999997
16561,U31076,84,-717.3200000000015,48,36,74483.27000000002,73765.95000000001
16562,U10757,84,-2884.3299999999967,77,7,107675.93999999999,104791.60999999999
16563,U32395,84,-3582.40999999998,66,18,449280.6,445698.19
16564,U826391,84,1053.48,70,14,11431.960000000001,12485.44
16565,U26451,84,1964.1899999999996,74,10,11450.65,13414.84
16566,U43834,84,125677.34999999996,62,22,810332.9300000002,936010.2800000001
16567,U39379,84,53564.280000000006,63,21,120220.68,173784.96
16568,U21305,84,56326.70999999998,72,12,106670.26000000001,162996.96999999997
16569,U27066,84,-17696.679999999982,60,24,697248.99,679552.31
16570,U18221,84,7996.220000000001,61,23,101136.73,109132.95
16571,U22137,84,-1907.1199999999994,68,16,11206.340000000002,9299.220000000003
16572,U13971,84,21592.829999999984,54,30,974272.4099999999,995865.2399999999
16573,U41675,84,-9495.88,70,14,36184.170000000006,26688.290000000008
16574,U37498,84,-28898.28,73,11,80850.71,51952.43000000001
16575,U23484,84,-83460.93,79,5,108624.48,25163.550000000003
16576,U20788,84,-13964.370000000024,65,19,592797.71,578833.34
16577,U35257,84,51990.350000000006,70,14,91369.47000000002,143359.82
16578,U22409,84,-17015.97,74,10,66019.59000000001,49003.62000000001
16579,U29429,84,-95505.04000000005,68,16,331405.88,235900.83999999997
16580,U21988,84,6451.339999999998,67,17,94107.29999999999,100558.63999999998
16581,U33499,84,-79.79000000000997,59,25,181615.96000000005,181536.17000000004
16582,U8506,84,641.0700000000015,41,43,95706.96999999999,96348.04
16583,U12538,84,-10708.620000000006,74,10,72811.50000000001,62102.880000000005
16584,U601123,84,-5183.139999999999,47,37,218955.21000000002,213772.07
16585,U31943,84,-642.1699999999997,53,31,2443.04,1800.8700000000003
16586,U34550,84,208618.68999999983,30,54,1220232.8900000001,1428851.58
16587,U14525,84,-49247.15,59,25,619943.1099999999,570695.9599999998
16588,U16793,84,-115.31000000000229,72,12,69732.23,69616.92
16589,U13807,84,-8235.12000000001,71,13,107703.56999999998,99468.44999999997
16590,U29319,84,-175955.16,45,39,1372522.15,1196566.99
16591,U8419,84,-17090.28000000001,67,17,135640.54,118550.26
16592,U36187,84,-67100.67000000001,81,3,67621.90000000001,521.2299999999959
16593,U20806,84,44103.14999999997,58,26,330847.54000000004,374950.69
16594,U30758,84,-72392.41,74,10,228498.72999999998,156106.31999999998
16595,U1097713,84,-1319.3400000000015,48,36,20697.13,19377.79
16596,U14633,84,106951.68000000001,57,27,351011.6000000001,457963.2800000001
16597,U20873,84,15926.04,69,15,78111.66,94037.70000000001
16598,U13170,84,-1165.7900000000227,71,13,300796.01999999996,299630.2299999999
16599,U17370,84,-19588.73,66,18,37702.98999999999,18114.25999999999
16600,U33418,84,5540.090000000001,74,10,21853.5,27393.59
16601,U28385,84,-2948.529999999997,69,15,26283.429999999997,23334.9
16602,U970663,84,-7868.859999999999,64,20,45347.7,37478.84
16603,U38411,84,983.3900000000025,74,10,25004.75,25988.140000000003
16604,U19044,84,-35394.94999999998,61,23,347200.62,311805.67000000004
16605,U39292,84,-2980.659999999916,47,37,3147525.9399999995,3144545.2799999993
16606,U36679,84,50573.720000000016,80,4,157649.25000000003,208222.97000000003
16607,U39226,84,9699.43,73,11,9370.289999999997,19069.719999999998
16608,U25652,84,33.329999999984295,68,16,305711.46,305744.79
16609,U17172,84,-9987.740000000107,58,26,1082532.13,1072544.3899999997
16610,U16607,84,15436.950000000003,66,18,74838.69,90275.64
16611,U39716,84,-1192.8299999999997,64,20,10837.43,9644.6
16612,U30525,84,276269.5899999999,73,11,395853.93000000005,672123.52
16613,U19645,84,-28322.630000000005,58,26,86278.66,57956.03
16614,U19163,84,1970.0099999999993,66,18,16090.52,18060.53
16615,U30956,84,-22810.879999999997,76,8,42324.399999999994,19513.519999999997
16616,U30202,84,-49586.99999999999,66,18,119664.11,70077.11000000002
16617,U11494,84,-2210.2000000000007,68,16,132573.72999999998,130363.52999999998
16618,U32660,84,8633.98,63,21,166746.51999999996,175380.49999999997
16619,U11364,84,827.0199999999652,60,24,236076.15999999997,236903.17999999993
16620,U20804,84,-48030.650000000016,70,14,292872.93999999994,244842.28999999992
16621,U21490,84,4016.1899999999996,78,6,26979.940000000002,30996.13
16622,U8867,84,-9590.399999999996,62,22,64253.11,54662.71000000001
16623,U22311,84,1162.5799999999995,77,7,4576.43,5739.01
16624,U28866,84,-21303.21999999999,73,11,94811.5,73508.28000000001
16625,U36089,84,178478.82,72,12,38567.33,217046.15000000002
16626,U13262,84,6562.020000000009,73,11,130171.12000000001,136733.14
16627,U42587,84,-3336.6599999999967,70,14,13644.869999999997,10308.210000000001
16628,U37397,84,-28361.110000000008,63,21,168979.55999999997,140618.44999999995
16629,U24357,83,-2574.1300000000047,71,12,342428.96,339854.83
16630,U11447,83,2673.099999999995,61,22,185609.86,188282.96
16631,U11005,83,902.6899999998961,67,16,1718981.47,1719884.16
16632,U36982,83,-426.57000000000284,58,25,58089.020000000004,57662.450000000004
16633,U42473,83,-1222.5500000000002,64,19,23603.579999999998,22381.03
16634,U9954,83,33682.860000000015,66,17,162613.57000000007,196296.43000000008
16635,U17454,83,-5499.979999999993,59,24,211256.57,205756.59000000003
16636,U13365,83,10999.640000000001,56,27,260079.78,271079.42
16637,U38056,83,-582.7499999999993,67,16,34661.96,34079.21
16638,U41813,83,-3584.320000000003,77,6,71033.55,67449.23
16639,U605670,83,-8251.41,61,22,8460.51,209.10000000000036
16640,U9958,83,19464.690000000013,59,24,164917.61,184382.3
16641,U42905,83,-4272.040000000001,66,17,9110.75,4838.709999999999
16642,U42668,83,-61.01999999999816,64,19,69226.70999999999,69165.68999999999
16643,U30491,83,-7055.290000000001,73,10,48729.979999999996,41674.689999999995
16644,U36653,83,-3776.310000000065,61,22,725564.91,721788.6
16645,U24915,83,6054.930000000002,58,25,103162.76,109217.69
16646,U34404,83,51083.40000000001,74,9,33387.42999999999,84470.83
16647,U18594,83,187111.45999999996,55,28,111990.42000000001,299101.88
16648,U24160,83,-5541.5599999999995,72,11,61707.61999999999,56166.05999999999
16649,U966421,83,-596.2699999999991,58,25,25856.6,25260.329999999998
16650,U42739,83,-1252.260000000001,62,21,13363.42,12111.16
16651,U42478,83,-2513.37,68,15,10939.869999999999,8426.5
16652,U15600,83,5302.3699999999935,41,42,158793.99000000002,164096.36000000002
16653,U20531,83,-19398.79,52,31,425257.15000000014,405858.36000000016
16654,U41383,83,1694.139999999986,56,27,552724.3400000003,554418.4800000003
16655,U30169,83,-11446.279999999999,62,21,128256.85,116810.57
16656,U38403,83,92300.02000000002,51,32,598054.12,690354.14
16657,U20059,83,-759.1199999999995,80,3,15345.12,14586.000000000002
16658,U756312,83,-5847.74,69,14,19655.300000000003,13807.560000000003
16659,U10341,83,22644.109999999986,60,23,659381.99,682026.1
16660,U35131,83,-1734.9100000000003,78,5,5717.58,3982.6699999999996
16661,U1101039,83,74.06000000000085,71,12,24416.7,24490.760000000002
16662,U17678,83,10358.730000000025,61,22,421509.02,431867.75000000006
16663,U1201082,83,-14109.320000000002,50,33,110747.10000000002,96637.78000000001
16664,U34647,83,-18232.239999999998,76,7,333490.92,315258.68
16665,U23674,83,-12076.310000000001,57,26,141847.61,129771.29999999999
16666,U756891,83,-12754.150000000001,64,19,19799.1,7044.949999999997
16667,U21283,83,-2420.0700000000015,59,24,106011.79,103591.71999999999
16668,U14785,83,375058.13,59,24,343498.80000000005,718556.93
16669,U13586,83,-2062.9400000000023,67,16,50539.84,48476.899999999994
16670,U30907,83,3825.8800000000047,61,22,121862.03,125687.91
16671,U15112,83,30485.349999999966,39,44,776458.45,806943.7999999999
16672,U22970,83,12229.460000000005,58,25,230830.56,243060.02
16673,U21970,83,-8829.659999999998,70,13,65208.11,56378.450000000004
16674,U41785,83,-236.2500000000582,61,22,320932.21,320695.95999999996
16675,U42833,83,-58262.979999999974,65,18,179973.64,121710.66000000003
16676,U857051,83,-24518.8,67,16,83155.06,58636.259999999995
16677,U37799,83,-176.44000000000054,72,11,20451.96,20275.519999999997
16678,U40041,83,-3585.6700000000073,51,32,364961.16000000003,361375.49000000005
16679,U23635,83,-1373.2100000000003,72,11,9271.44,7898.2300000000005
16680,U41031,83,-61417.04999999999,60,23,146805.03,85387.98000000001
16681,U8290,83,-48319.61,77,6,130149.57000000004,81829.96000000004
16682,U759285,83,-8731.58,61,22,24474.509999999995,15742.929999999995
16683,U10538,83,379476.6200000001,50,33,845368.37,1224844.9900000002
16684,U18288,83,20938.86,62,21,160561.85999999993,181500.7199999999
16685,U681368,83,-404.7700000000009,56,27,44722.57,44317.799999999996
16686,U19524,83,-15374.17000000001,45,38,102934.31,87560.13999999998
16687,U26296,83,1740.3100000000004,64,19,51518.600000000006,53258.91
16688,U23313,83,3742.1300000000065,45,38,89122.2,92864.33
16689,U10254,83,-19183.979999999996,53,30,86473.33,67289.35
16690,U8060,83,-1318.2300000000253,52,31,179642.45,178324.21999999997
16691,U20429,83,-685.9500000000007,65,18,45853.74,45167.78999999999
16692,U24647,83,185306.52000000002,59,24,269134.3,454440.82
16693,U31918,83,19153.729999999996,60,23,174666.95,193820.68
16694,U33040,83,51181.08999999999,72,11,116122.6,167303.69
16695,U16869,83,-114786.86999999998,59,24,447065.60000000003,332278.73000000004
16696,U40669,83,19194.530000000002,70,13,123449.78,142644.31
16697,U23137,83,68397.74000000002,67,16,233625.89,302023.63
16698,U11594,83,4704.099999999998,72,11,182909.23000000004,187613.33000000005
16699,U17338,83,988024.22,54,29,375621.7099999999,1363645.93
16700,U8542,83,3710.6800000000003,55,28,26417.66,30128.34
16701,U18979,83,6544.08,76,7,36132.450000000004,42676.530000000006
16702,U16210,83,-244489.32999999993,48,35,1864177.3800000001,1619688.0500000003
16703,U25654,83,-4214.1799999999885,71,12,67793.53999999996,63579.35999999998
16704,U26347,83,22269.750000000015,55,28,304983.67000000004,327253.42000000004
16705,U41039,83,562.8900000002188,68,15,1238392.38,1238955.27
16706,U23770,83,-16422.890000000007,50,33,61230.399999999994,44807.50999999999
16707,U27031,83,-1663.16,54,29,22557.28,20894.12
16708,U41086,83,-8139.11,75,8,19085.4,10946.29
16709,U12133,83,123695.32999999996,54,29,143762.96,267458.2899999999
16710,U17069,83,652427.5199999999,66,17,90626.6,743054.1199999999
16711,U22675,83,56948.89999999803,57,26,69213678.51,69270627.41
16712,U10410,83,507.7799999999997,78,5,2746.3900000000003,3254.17
16713,U22430,83,58168.490000000005,76,7,191543.8,249712.28999999998
16714,U8961,83,87109.46000000004,72,11,14826.01,101935.47000000003
16715,U43086,83,-40299.41,55,28,526877.7999999999,486578.3899999999
16716,U32783,83,-8256.170000000004,75,8,37769.03,29512.859999999993
16717,U33077,83,624.5999999999475,70,13,468083.55,468708.1499999999
16718,U12210,83,-33075.58000000054,50,33,2713985.12,2680909.5399999996
16719,U22013,83,593.8400000000008,65,18,24490.530000000002,25084.370000000003
16720,U37372,83,-52210.39000000003,60,23,1214947.9700000002,1162737.58
16721,U17922,83,-18208.05,66,17,112015.51000000001,93807.46
16722,U14343,83,33341.220000000016,62,21,137965.62,171306.84000000003
16723,U33559,83,-6.309999999999491,67,16,53281.81,53275.5
16724,U36614,83,-1940.5299999999997,59,24,37559.56999999999,35619.03999999999
16725,U17716,83,-4447.180000000001,70,13,111048.74000000002,106601.56000000001
16726,U15208,83,-1471444.41,67,16,2951431.0500000003,1479986.6400000004
16727,U12632,83,-561.8899999999991,67,16,50738.83000000001,50176.94000000001
16728,U26131,83,-17404.55,77,6,28264.92,10860.369999999999
16729,U14409,83,-34381.74999999999,75,8,117732.70000000001,83350.95000000001
16730,U15937,83,-53921.659999999996,62,21,198491.13,144569.47
16731,U34760,83,-13847.720000000001,60,23,571081.42,557233.7000000001
16732,U15689,83,11370.559999999867,62,21,5796546.290000001,5807916.850000001
16733,U16458,83,-2113.479999999998,70,13,59044.38,56930.9
16734,U26171,83,102737.26000000001,64,19,220838.89,323576.15
16735,U28917,83,-5222.95,52,31,38636.880000000005,33413.93000000001
16736,U23204,83,10524.030000000037,56,27,612370.7499999999,622894.7799999999
16737,U31161,83,81897.93000000001,61,22,187923.06,269820.99
16738,U25792,83,-1189969.1099999999,48,35,10288646.819999998,9098677.709999999
16739,U11683,83,216.3900000000009,49,34,51525.490000000005,51741.880000000005
16740,U17124,83,149896.38,52,31,887785.7200000001,1037682.1000000001
16741,U14114,83,-5625.9199999999855,70,13,345032.81000000006,339406.8900000001
16742,U17029,83,-563.4200000000001,74,9,37808.579999999994,37245.159999999996
16743,U1271573,83,518.66,53,30,6325.58,6844.24
16744,U29836,83,43546.25999999997,43,40,682577.23,726123.49
16745,U19121,83,-30529.61000000002,49,34,741145.59,710615.98
16746,U11779,83,1852.150000000035,39,44,790532.24,792384.39
16747,U23060,83,-30821.379999999997,71,12,66806.78,35985.4
16748,U42633,83,-823.2300000000005,70,13,36155.1,35331.869999999995
16749,U27025,83,158502.29000000004,60,23,317535.1799999999,476037.4699999999
16750,U30945,83,-14548.960000000003,62,21,130015.13000000002,115466.17000000001
16751,U20468,83,-1989.2200000000107,71,12,167890.41,165901.19
16752,U28700,83,11332.709999999997,60,23,25124.76,36457.469999999994
16753,U41630,83,-16639.09000000001,64,19,377914.7900000001,361275.70000000007
16754,U42924,83,-25396.869999999988,52,31,241946.91000000003,216550.04000000004
16755,U26541,83,2204.5899999999992,76,7,18272.010000000002,20476.600000000002
16756,U27978,83,1391.2999999999988,64,19,11429.789999999999,12821.089999999998
16757,U21067,83,-16796.099999999977,78,5,61156.95999999996,44360.859999999986
16758,U36979,83,-2152.1200000000144,55,28,156007.7299999999,153855.60999999987
16759,U25334,83,94021.05999999998,63,20,71679.86999999998,165700.92999999996
16760,U36801,83,10619.350000000055,71,12,541992.91,552612.2600000001
16761,U35866,83,33966.369999999995,43,40,405906.72000000003,439873.09
16762,U29694,83,-54.079999999983556,51,32,116472.63,116418.55000000002
16763,U16591,83,15716.14000000001,42,41,758124.1199999999,773840.2599999999
16764,U12059,83,-1486.9200000000028,61,22,38034.990000000005,36548.07
16765,U21286,83,12747.050000000005,76,7,15737.899999999998,28484.950000000004
16766,U1166170,83,245.38999999999987,62,21,16885.8,17131.19
16767,U42083,83,-6987.820000000014,52,31,217521.43,210533.61
16768,U682500,83,-9.070000000000164,57,26,7915.490000000001,7906.42
16769,U39847,83,-178150.69000000006,62,21,1145837.0,967686.3099999999
16770,U14453,83,51900.75,58,25,363726.15,415626.9
16771,U44069,82,58789.59000000003,60,22,242740.11000000002,301529.70000000007
16772,U25966,82,-42066.78,72,10,161194.57,119127.79000000001
16773,U22744,82,-77790.90000000001,65,17,303142.4600000001,225351.56000000006
16774,U27067,82,2777.1899999999996,69,13,25589.42,28366.609999999997
16775,U21673,82,2070.899999999999,48,34,27714.449999999993,29785.34999999999
16776,U22395,82,-7839.060000000001,67,15,99265.09,91426.03
16777,U28024,82,872.3899999999987,73,9,21696.659999999996,22569.049999999996
16778,U11389,82,-1994.3499999999997,75,7,6441.130000000008,4446.780000000009
16779,U37772,82,3931.7899999999936,62,20,319887.22000000003,323819.01
16780,U37133,82,-26840.49000000002,49,33,653955.75,627115.26
16781,U33768,82,556.4599999999928,60,22,53138.97000000001,53695.43
16782,U17198,82,11192.86999999999,62,20,118054.34,129247.20999999999
16783,U1070536,82,-1496.6600000000003,54,28,17029.13,15532.470000000001
16784,U12206,82,230254.88000000003,60,22,313209.67000000004,543464.55
16785,U1364070,82,-1121.5399999999972,62,20,31649.0,30527.460000000003
16786,U21487,82,2107.7499999999973,61,21,113830.53000000001,115938.28000000001
16787,U34583,82,38399.450000000004,63,19,102021.08,140420.53
16788,U36748,82,322.5200000000021,70,12,14004.63,14327.150000000001
16789,U11620,82,7038.16,73,9,25236.059999999998,32274.219999999998
16790,U37718,82,2156.0300000000025,46,36,99978.43000000001,102134.46
16791,U39531,82,4889.329999999991,67,15,180910.94,185800.27
16792,U33816,82,255401.55,45,37,1098486.4300000002,1353887.9800000002
16793,U30817,82,-6783.119999999994,64,18,53146.82000000001,46363.70000000001
16794,U41535,82,18447.289999999994,52,30,434128.84000000014,452576.1300000001
16795,U40445,82,57815.630000000005,35,47,1240829.06,1298644.69
16796,U13238,82,-151006.33000000002,68,14,268908.77,117902.44
16797,U33112,82,62261.25,47,35,56064.92,118326.17
16798,U929273,82,0.9800000000000745,50,32,642.8799999999998,643.8599999999998
16799,U24056,82,10481.099999999977,62,20,719714.9600000001,730196.06
16800,U22723,82,-9953.519999999997,69,13,78458.48,68504.95999999999
16801,U17400,82,27153.899999999998,57,25,100509.95000000001,127663.85
16802,U10967,82,-25316.429999999997,66,16,156490.94,131174.51
16803,U28648,82,18919.480000000003,55,27,134056.51,152975.99000000002
16804,U39288,82,-2648.59,69,13,20619.799999999996,17971.209999999995
16805,U9440,82,-31375.23,56,26,234236.48,202861.25
16806,U10004,82,20723.33,67,15,314976.14,335699.47000000003
16807,U14746,82,-642.3600000000151,45,37,424786.93000000005,424144.57000000007
16808,U31823,82,16134.309999999998,71,11,52623.22000000001,68757.53
16809,U36836,82,12065.640000000005,57,25,66649.14,78714.78
16810,U18715,82,1334.2099999999991,64,18,27410.399999999994,28744.609999999993
16811,U32602,82,1380.5800000000036,72,10,23114.72,24495.300000000003
16812,U43956,82,-1099.2100000000064,69,13,196530.84000000003,195431.63
16813,U13031,82,-22360.76,78,4,22815.670000000002,454.9100000000035
16814,U40826,82,-123323.76,65,17,217895.39,94571.63000000002
16815,U37728,82,31872.030000000013,55,27,439725.38000000006,471597.4100000001
16816,U33353,82,-63925.22000000003,71,11,386918.30000000005,322993.08
16817,U1099981,82,-4598.77,70,12,13825.41,9226.64
16818,U21533,82,-25844.93,74,8,50308.619999999995,24463.689999999995
16819,U37468,82,-13750.37,69,13,68995.0,55244.63
16820,U12489,82,-137893.58999999994,55,27,1898945.36,1761051.7700000003
16821,U9687,82,-2252.0500000000293,60,22,324840.1699999999,322588.1199999999
16822,U39869,82,8303.48,57,25,111377.75,119681.23
16823,U24332,82,-1568.1600000000108,53,29,346296.98000000004,344728.82
16824,U26586,82,-25560.32000000001,76,6,44716.42,19156.099999999988
16825,U43904,82,-15314.940000000028,65,17,251683.84,236368.89999999997
16826,U11500,82,-6027.010000000001,68,14,34904.740000000005,28877.730000000003
16827,U16875,82,-49321.32000000016,68,14,1114514.56,1065193.24
16828,U37352,82,-23493.719999999998,64,18,102273.40999999999,78779.68999999999
16829,U13019,82,-19250.03999999999,69,13,54369.55999999999,35119.520000000004
16830,U25414,82,2116.9999999995343,44,38,6285571.73,6287688.73
16831,U38809,82,22006.370000000003,60,22,89302.62000000001,111308.99000000002
16832,U939444,82,-362.01999999999765,58,24,19776.339999999997,19414.32
16833,U21086,82,-737434.0099999979,55,27,31861529.5,31124095.490000002
16834,U18366,82,-117087.57999999996,66,16,458164.8799999999,341077.29999999993
16835,U22578,82,10451.129999999996,76,6,46024.77000000001,56475.90000000001
16836,U22696,82,-140206.83,75,7,474182.92000000004,333976.0900000001
16837,U24952,82,10075.049999999997,68,14,35027.64,45102.689999999995
16838,U31905,82,15691.690000000008,25,57,177957.83000000002,193649.52000000002
16839,U18952,82,-664.0099999999984,56,26,29336.78,28672.77
16840,U18843,82,-5568.5300000000025,60,22,149641.26,144072.73
16841,U19994,82,1068.0600000000013,62,20,130537.73000000001,131605.79
16842,U17560,82,-10088.349999999993,39,43,487477.67,477389.32
16843,U30894,82,-1488.4800000000137,62,20,75354.37999999999,73865.89999999998
16844,U14252,82,2.5699999999949057,54,28,177115.07,177117.64
16845,U33796,82,2058.6499999999983,63,19,36057.45,38116.1
16846,U35485,82,-35816.46999999999,66,16,201140.88,165324.41000000003
16847,U704769,82,-1766.6799999999998,55,27,8298.11,6531.43
16848,U973341,82,0.0,41,41,20848.0,20848.0
16849,U35316,82,-9139.999999999996,64,18,215279.95000000004,206139.95000000004
16850,U8706,82,796.3499999999993,75,7,15916.079999999993,16712.429999999993
16851,U22804,82,24259.77999999997,54,28,523227.78,547487.56
16852,U30800,82,-183015.66000000003,49,33,309866.61000000004,126850.95000000001
16853,U38512,82,6936.690000000005,41,41,236816.59999999998,243753.28999999998
16854,U14475,82,4349.619999999995,75,7,137820.7,142170.32
16855,U35425,82,4195.419999999999,54,28,21893.38,26088.8
16856,U1364269,82,599.2700000000004,71,11,7825.65,8424.92
16857,U9664,82,-6836.2699999999995,75,7,13165.299999999997,6329.029999999998
16858,U24257,82,-10687.489999999998,54,28,405732.56000000006,395045.07000000007
16859,U30404,82,-696.6900000000037,73,9,28411.970000000005,27715.280000000002
16860,U21975,82,-1580.6999999999982,74,8,27260.750000000004,25680.050000000007
16861,U32888,82,105474.29,63,19,65311.70000000001,170785.99
16862,U35654,82,-143870.83000000002,62,20,341932.66,198061.82999999996
16863,U11056,82,28490.359999999993,72,10,252223.16,280713.52
16864,U21622,82,-2904.599999999995,62,20,143285.0,140380.4
16865,U1114367,82,-68.96999999999866,74,8,10568.160000000002,10499.190000000002
16866,U35563,82,7231.800000000001,76,6,26024.559999999998,33256.36
16867,U12865,82,-33878.96,65,17,202658.28000000003,168779.32000000004
16868,U34160,82,10961.119999999999,64,18,241273.94999999995,252235.06999999995
16869,U32112,82,52949.68999999999,71,11,8559.269999999997,61508.959999999985
16870,U14087,82,-7749.870000000001,63,19,12014.32,4264.449999999999
16871,U19292,82,1486.059999999986,57,25,252893.52,254379.58
16872,U30620,82,-1086.8400000000147,56,26,206992.57,205905.72999999998
16873,U30899,82,20489.28,64,18,76865.45000000001,97354.73000000001
16874,U35303,82,-2063.9600000000128,64,18,242340.2999999999,240276.33999999988
16875,U31394,82,-562.0199999999995,64,18,30442.910000000003,29880.890000000003
16876,U8081,82,-2879.4500000000003,68,14,19821.910000000003,16942.460000000003
16877,U21897,82,40086.469999999994,45,37,79178.36,119264.82999999999
16878,U39505,82,-46061.91999999999,76,6,54255.17999999999,8193.260000000002
16879,U10925,82,1178.1799999999942,65,17,32586.489999999983,33764.66999999998
16880,U30490,82,-153.9699999999998,63,19,15078.519999999999,14924.55
16881,U1176164,82,-116.4000000000002,72,10,8177.760000000002,8061.3600000000015
16882,U9106,82,-1788.7500000000055,71,11,114227.66000000002,112438.91000000002
16883,U13256,82,-40085.480000000156,46,36,8255335.23,8215249.75
16884,U36599,82,31144.479999999996,51,31,191929.61000000002,223074.09000000003
16885,U43836,82,1762.259999999997,63,19,47804.420000000006,49566.68
16886,U40437,82,1885.739999999991,66,16,26546.479999999996,28432.219999999987
16887,U40776,82,-11495.329999999998,77,5,22417.690000000006,10922.360000000008
16888,U42371,82,-2615.7500000000005,62,20,59976.40999999999,57360.65999999999
16889,U43939,82,1311.8099999999977,45,37,126328.32,127640.13
16890,U12287,82,26082.109999999986,52,30,457916.26999999996,483998.37999999995
16891,U42538,82,1346.5700000000015,60,22,79106.86,80453.43000000001
16892,U34323,82,-27532.75000000003,65,17,405338.9,377806.15
16893,U13795,82,-8665.840000000002,77,5,31893.929999999997,23228.089999999997
16894,U14121,82,-85296.89999999995,51,31,1234553.93,1149257.03
16895,U1190471,82,-193.1699999999983,49,33,27494.14,27300.97
16896,U23427,82,880.690000000006,74,8,130180.31,131061.0
16897,U35524,82,-4609.619999999995,67,15,179019.42,174409.80000000002
16898,U42385,82,33633.8,67,15,26396.519999999993,60030.31999999999
16899,U24946,82,-13113.469999999996,65,17,118310.12000000001,105196.65000000001
16900,U36044,82,-13013.11999999998,75,7,87314.23,74301.11000000002
16901,U40019,82,100682.51000000001,39,43,911083.78,1011766.29
16902,U8480,82,-11912.090000000011,47,35,235171.12,223259.02999999997
16903,U8448,82,-1921.600000000013,46,36,293509.70999999996,291588.1099999999
16904,U21630,82,171399.20000000007,73,9,556430.12,727829.3200000001
16905,U27625,82,2876.11,50,32,41180.26,44056.37
16906,U10316,82,-13325.499999999998,58,24,167866.28,154540.78
16907,U26786,82,-40.400000000000546,64,18,37203.1,37162.7
16908,U14190,82,-783.829999999999,73,9,15452.519999999999,14668.689999999999
16909,U11481,82,-496.33000000000163,61,21,30044.889999999996,29548.559999999994
16910,U37898,82,10783.759999999998,66,16,96325.02,107108.78
16911,U34989,82,-59921.35,67,15,1233217.75,1173296.4
16912,U595609,82,20.340000000000146,52,30,56443.1,56463.44
16913,U17380,82,-28127.599999999995,70,12,41936.08999999999,13808.489999999994
16914,U15856,82,-2167.95,45,37,479292.99000000005,477125.04000000004
16915,U36669,82,-68745.84000000001,66,16,227640.15999999997,158894.31999999995
16916,U8776,82,-27873.469999999998,62,20,30724.649999999998,2851.1800000000003
16917,U16480,82,-2285.4000000000005,78,4,21267.039999999997,18981.639999999996
16918,U8694,82,-6153.02,64,18,10727.129999999997,4574.109999999997
16919,U11579,82,253.22000000000082,65,17,84210.31999999999,84463.54
16920,U41966,82,6815.0700000000015,68,14,64601.37,71416.44
16921,U11765,82,-2365.7900000000027,73,9,14064.799999999997,11699.009999999995
16922,U39812,82,9067.419999999996,56,26,139414.81000000003,148482.23
16923,U22124,82,1170.12000000001,62,20,292316.0899999999,293486.2099999999
16924,U37448,82,-35.460000000000036,42,40,29087.619999999995,29052.159999999996
16925,U42276,82,-1953.8000000000004,53,29,20003.58,18049.780000000002
16926,U22932,82,-36965.26999999999,67,15,114177.64999999997,77212.37999999998
16927,U40696,82,10315.89,64,18,95522.39999999998,105838.28999999998
16928,U43049,82,2476.5799999998744,55,27,2123383.7700000005,2125860.3500000006
16929,U32714,82,-14628.230000000003,56,26,119800.7,105172.47
16930,U20924,82,19280.239999999994,76,6,92708.90000000001,111989.14
16931,U41048,82,-383.58000000015613,63,19,955297.4800000002,954913.9
16932,U37204,82,-804.7399999999986,69,13,24072.459999999995,23267.719999999998
16933,U40236,82,12513.289999999994,65,17,46892.86,59406.149999999994
16934,U25962,82,-127200.71999999997,66,16,299851.45,172650.73000000004
16935,U37409,82,-97030.82000000011,53,29,1338078.66,1241047.8399999999
16936,U10179,82,-654.6500000000003,66,16,66015.95999999999,65361.30999999999
16937,U29559,82,26688.719999999998,67,15,104171.30999999998,130860.02999999998
16938,U18552,82,-6518.840000000004,42,40,280040.76,273521.92
16939,U27123,82,21982.249999999996,74,8,48767.58999999998,70749.83999999998
16940,U19717,82,-3422.270000000006,43,39,166410.87,162988.59999999998
16941,U42635,81,-6281.320000000001,64,17,50879.149999999994,44597.829999999994
16942,U42235,81,3780.0999999999904,59,22,154926.30000000002,158706.4
16943,U24273,81,-21979.69999999999,73,8,43810.06999999999,21830.370000000003
16944,U21614,81,-1435.1599999999971,67,14,22286.819999999996,20851.66
16945,U15257,81,-171.45000000000306,75,6,53684.479999999996,53513.02999999999
16946,U39670,81,16468.260000000006,41,40,326135.63,342603.89
16947,U14688,81,-5416.460000000001,67,14,49214.12,43797.66
16948,U32270,81,-6753.579999999998,62,19,241147.59999999998,234394.02
16949,U21546,81,9.060000000000002,66,15,54275.01000000001,54284.07000000001
16950,U11032,81,78115.77000000002,58,23,358622.38,436738.15
16951,U9423,81,-7243.469999999927,30,51,76667.94,69424.47000000007
16952,U14820,81,3322.870000000005,71,10,160423.20999999996,163746.07999999996
16953,U38597,81,647.3600000000013,38,43,112471.16,113118.52
16954,U11580,81,-16687.189999999995,61,20,148266.66999999995,131579.47999999995
16955,U16315,81,-14650.639999999992,68,13,197691.08999999997,183040.44999999998
16956,U12808,81,14605.140000000014,61,20,583800.38,598405.52
16957,U43310,81,-3160.3700000000013,73,8,15895.809999999998,12735.439999999997
16958,U23449,81,-2101.139999999992,71,10,51174.269999999975,49073.12999999998
16959,U16702,81,-75096.82999999996,53,28,659928.4,584831.5700000001
16960,U18695,81,52120.54,46,35,157378.42,209498.96000000002
16961,U8467,81,-27319.44,65,16,135052.91,107733.47
16962,U30121,81,-16243.43,75,6,37043.409999999996,20799.979999999996
16963,U11156,81,314988.9800000001,41,40,2652505.37,2967494.35
16964,U9715,81,5436.0899999999965,43,38,233125.03,238561.12
16965,U21352,81,-45.5300000000002,71,10,6904.580000000001,6859.050000000001
16966,U611929,81,387.8500000000001,51,30,16144.01,16531.86
16967,U27204,81,-31932.489999999987,75,6,138718.42000000004,106785.93000000005
16968,U37981,81,4078.1599999999853,67,14,160944.01,165022.16999999998
16969,U21902,81,-324.99000000000524,60,21,237827.27,237502.27999999997
16970,U13433,81,448380.3799999999,60,21,1129081.15,1577461.5299999998
16971,U39411,81,-59932.060000000005,71,10,82524.29999999999,22592.239999999983
16972,U16589,81,-5901.73,70,11,21086.559999999998,15184.829999999998
16973,U40637,81,61702.619999999995,53,28,60018.46000000001,121721.08
16974,U30401,81,17328.769999999997,61,20,176401.45999999993,193730.22999999992
16975,U11409,81,-1505.3800000000138,56,25,600940.98,599435.6
16976,U30890,81,22457.29000000001,68,13,612467.24,634924.53
16977,U36968,81,786.2900000000017,53,28,82871.97000000002,83658.26000000002
16978,U40673,81,39296.52999999997,75,6,132711.68,172008.20999999996
16979,U10130,81,-23246.35,64,17,97198.2,73951.85
16980,U985328,81,-3713.41,44,37,96944.92000000001,93231.51000000001
16981,U27383,81,-8427.07,50,31,162836.00999999998,154408.93999999997
16982,U30920,81,2478.8099999999995,68,13,27159.989999999998,29638.799999999996
16983,U1181029,81,-5473.66,54,27,12666.550000000001,7192.890000000001
16984,U14014,81,-23530.08,67,14,127254.97000000002,103724.89000000001
16985,U12397,81,-99928.17,63,18,263690.02,163761.85000000003
16986,U30346,81,-12772.339999999997,63,18,59317.41,46545.07000000001
16987,U18882,81,3607.550000000001,49,32,138135.94,141743.49
16988,U24166,81,5157.649999999994,63,18,140988.62,146146.27
16989,U35576,81,-1887.68,73,8,5380.480000000001,3492.800000000001
16990,U37478,81,-1170.33,74,7,23241.920000000006,22071.590000000004
16991,U16763,81,83611.82999999996,54,27,1940315.5699999998,2023927.4
16992,U40996,81,781.9799999999987,50,31,79992.24000000002,80774.22000000002
16993,U10513,81,161065.21000000002,56,25,1392005.28,1553070.49
16994,U42958,81,-24610.919999999995,63,18,155901.61000000002,131290.69000000003
16995,U31427,81,-8744.679999999986,40,41,419989.79000000004,411245.11000000004
16996,U36058,81,-6146.680000000002,60,21,84704.56,78557.87999999999
16997,U30340,81,-248010.13000000006,56,25,3372324.57,3124314.44
16998,U23154,81,1410.4199999999946,72,9,82704.08999999995,84114.50999999995
16999,U39831,81,17912.05,70,11,291234.2399999998,309146.2899999998
17000,U22120,81,-4127.799999999998,53,28,46748.279999999984,42620.47999999999
17001,U41333,81,10518.170000000006,66,15,49808.17999999999,60326.35
17002,U21087,81,-1912.7600000000086,48,33,331271.1400000001,329358.38000000006
17003,U1378915,81,-1219.6199999999972,61,20,64474.20999999999,63254.59
17004,U35046,81,-4491.029999999998,63,18,94068.99,89577.96
17005,U595503,81,-7279.090000000003,60,21,31978.510000000002,24699.42
17006,U41730,81,18341.290000000008,50,31,371065.67,389406.95999999996
17007,U23611,81,595.8299999999941,53,28,133823.37,134419.19999999998
17008,U33347,81,12640.41,68,13,19056.54,31696.95
17009,U24659,81,14364.430000000006,50,31,117742.55999999997,132106.98999999996
17010,U33886,81,21298.410000000003,70,11,36382.759999999995,57681.17
17011,U21415,81,-42278.750000000015,60,21,462434.41,420155.66
17012,U23546,81,82239.04000000001,61,20,175243.43,257482.47
17013,U13630,81,-17726.940000000086,40,41,3539314.1900000004,3521587.2500000005
17014,U17313,81,-2398.4400000000005,70,11,75503.89000000001,73105.45000000001
17015,U36071,81,2330.559999999999,63,18,110671.25,113001.81
17016,U12057,81,3193.9900000000052,47,34,326722.94999999995,329916.93999999994
17017,U42335,81,-56230.13,74,7,72700.66,16470.530000000006
17018,U42003,81,48206.03999999992,69,12,2883234.48,2931440.52
17019,U27964,81,-9412.419999999976,63,18,189137.98,179725.56000000003
17020,U22504,81,-1169.9000000000087,48,33,111101.69,109931.79
17021,U21227,81,84542.23999999999,57,24,144257.19,228799.43
17022,U1057078,81,-192.7000000000001,43,38,10574.88,10382.179999999998
17023,U25319,81,-10011.629999999994,56,25,238273.28999999998,228261.65999999997
17024,U35567,81,-2488.4900000000016,54,27,135062.06000000003,132573.57000000004
17025,U19753,81,47780.630000000005,45,36,290751.13,338531.76
17026,U8052,81,41031.030000000064,19,62,276588.95999999996,317619.99000000005
17027,U30439,81,-114718.39999999998,81,0,114718.39999999998,0.0
17028,U19633,81,-872.9500000000019,49,32,44729.75,43856.799999999996
17029,U9836,81,121650.08,71,10,27461.559999999998,149111.64
17030,U43913,81,-37972.25,66,15,44208.37,6236.120000000003
17031,U36241,81,33486.28,70,11,9824.939999999999,43311.22
17032,U21734,81,-150297.21000000005,55,26,815034.27,664737.0599999999
17033,U42643,81,-15666.77,68,13,33281.45,17614.679999999997
17034,U19432,81,171804.58999999994,63,18,561594.6699999996,733399.2599999995
17035,U22226,81,-2923.619999999999,69,12,18968.270000000004,16044.650000000005
17036,U23814,81,6396.769999999988,50,31,394949.32999999996,401346.0999999999
17037,U20030,81,-3114.270000000004,69,12,247801.55999999997,244687.28999999998
17038,U14683,81,40434.01000000001,65,16,350230.95999999996,390664.97
17039,U8351,81,17223.02000000001,75,6,75364.29,92587.31
17040,U28348,81,-63.080000000005725,76,5,16731.669999999995,16668.58999999999
17041,U18365,81,-67.03000000000029,70,11,19688.170000000002,19621.140000000003
17042,U29156,81,3514.6499999999655,62,19,669732.3,673246.9500000001
17043,U26203,81,1332.160000000001,61,20,61689.77000000001,63021.930000000015
17044,U16392,81,128512.98999999992,65,16,505372.6300000001,633885.62
17045,U38821,81,-1683.1200000000028,72,9,96573.35,94890.23
17046,U12419,81,-14229.449999999997,49,32,308146.06999999995,293916.61999999994
17047,U14599,81,4877.679999999987,51,30,147607.68,152485.36
17048,U29770,81,-5442.25999999976,67,14,2743336.1100000003,2737893.8500000006
17049,U34904,81,14941.210000000008,52,29,214994.31999999995,229935.52999999997
17050,U10781,81,82547.84999999999,73,8,192144.06000000006,274691.91000000003
17051,U758400,81,-13.219999999999914,55,26,7891.179999999999,7877.959999999999
17052,U33844,81,41601.69999999999,69,12,35404.38,77006.07999999999
17053,U35024,81,11281.25,49,32,156112.06,167393.31
17054,U40525,81,-1420.6599999999962,45,36,464152.9199999999,462732.25999999995
17055,U18523,81,1471.6499999999942,49,32,1029416.1599999999,1030887.8099999999
17056,U30845,81,344804.2700000002,37,44,866510.15,1211314.4200000002
17057,U42186,81,137.5800000000013,45,36,38280.950000000004,38418.530000000006
17058,U15280,81,-3793.229999999995,54,27,42000.020000000004,38206.79000000001
17059,U33367,81,-6349.160000000002,60,21,110939.20999999999,104590.04999999999
17060,U13183,81,-7640.700000000012,50,31,1374631.4399999997,1366990.7399999998
17061,U40577,81,5157.91,54,27,33891.05,39048.96000000001
17062,U19733,81,25882.359999999986,44,37,523215.63,549097.99
17063,U18727,81,-192879.94999999992,56,25,714898.03,522018.0800000001
17064,U8306,81,-95433.43,65,16,154618.91999999998,59185.48999999999
17065,U37367,81,-5469.960000000001,72,9,26423.079999999998,20953.119999999995
17066,U18120,81,2579.72,76,5,15945.359999999997,18525.079999999998
17067,U18246,81,1625.9700000000003,67,14,22675.97,24301.940000000002
17068,U23367,81,211861.4100000001,58,23,788723.4,1000584.81
17069,U1058190,81,625.4699999999993,67,14,11280.510000000002,11905.980000000001
17070,U40382,81,10507.45,63,18,12784.140000000001,23291.590000000004
17071,U14609,81,101.8900000000001,73,8,2764.0599999999995,2865.95
17072,U32001,81,99803.77000000005,40,41,2509502.76,2609306.53
17073,U24152,81,14921.27,42,39,108245.71000000002,123166.98000000003
17074,U30650,81,12.160000000000082,69,12,5568.47,5580.63
17075,U38189,81,6466.539999999997,72,9,28338.539999999994,34805.07999999999
17076,U34257,81,25167.640000000003,74,7,16140.57,41308.21000000001
17077,U16044,81,3900.3900000001304,52,29,2373211.97,2377112.3600000003
17078,U42106,81,25910.100000000002,51,30,412688.39,438598.49
17079,U32589,81,19176.84000000001,57,24,615842.7900000002,635019.6300000001
17080,U40065,81,-10887.100000000022,64,17,162095.46000000002,151208.36
17081,U20863,81,-21076.690000000002,66,15,212882.59000000003,191805.90000000002
17082,U17547,81,43064.820000000014,67,14,261546.52000000002,304611.34
17083,U9870,81,-77526.46999999991,46,35,2620291.1399999997,2542764.67
17084,U684396,81,-25154.4,75,6,53674.70999999997,28520.30999999997
17085,U42063,81,254.02000000000407,58,23,69591.93999999999,69845.95999999999
17086,U14642,81,13738.749999999995,65,16,107119.98,120858.73
17087,U11003,81,5501.520000000006,40,41,464574.63999999996,470076.16
17088,U36616,81,-317294.10000000003,74,7,331212.62000000005,13918.520000000019
17089,U8499,81,-74741.32999999996,63,18,1539088.71,1464347.38
17090,U19493,81,-2359.3800000000606,49,32,1198935.2599999995,1196575.8799999994
17091,U42125,81,-444.6899999999986,75,6,17841.47,17396.780000000002
17092,U25465,81,-265.599999999999,59,22,215652.19000000012,215386.5900000001
17093,U41824,81,19759.86999999996,69,12,322379.1200000001,342138.99000000005
17094,U1243660,81,6.10000000000008,54,27,2505.5200000000004,2511.6200000000003
17095,U1218969,81,-15667.720000000001,54,27,166798.12,151130.4
17096,U18419,81,-8416.729999999992,53,28,109307.47000000002,100890.74000000002
17097,U25649,81,6719.139999999998,61,20,54960.549999999996,61679.689999999995
17098,U17221,81,20939.309999999878,45,36,8088698.33,8109637.64
17099,U8313,80,-13175.860000000006,65,15,180911.98000000004,167736.12000000002
17100,U8616,80,8443.930000000002,72,8,33863.83,42307.76
17101,U34483,80,7848.010000000002,70,10,58111.25,65959.26000000001
17102,U11162,80,-7966.449999999999,42,38,332845.12,324878.67
17103,U26246,80,872.6600000000035,67,13,534963.8999999999,535836.5599999999
17104,U24484,80,517987.8400000001,61,19,1854583.83,2372571.67
17105,U9666,80,-9959.550000000001,69,11,27742.68,17783.129999999997
17106,U21432,80,76978.51999999999,60,20,174600.27000000002,251578.79
17107,U25965,80,329718.14,63,17,441542.6,771260.74
17108,U10011,80,-1972005.9899999998,64,16,2900939.96,928933.9700000002
17109,U33788,80,-68158.07000000007,60,20,971373.8600000001,903215.79
17110,U28697,80,13988.759999999995,50,30,196349.97999999998,210338.74
17111,U40249,80,8163.279999999981,59,21,745408.16,753571.4400000001
17112,U29087,80,-1342.8499999999974,71,9,15671.669999999998,14328.820000000002
17113,U43196,80,3008.2199999999984,77,3,10592.58,13600.8
17114,U28204,80,39135.06000000001,66,14,97280.10000000005,136415.16000000006
17115,U35701,80,6305.7300000000005,65,15,39232.87,45538.600000000006
17116,U36186,80,-11971.480000000003,64,16,189937.58000000005,177966.10000000003
17117,U16010,80,-46260.08999999998,55,25,158523.52999999997,112263.43999999999
17118,U14705,80,3520.4799999999964,43,37,93931.44000000002,97451.92000000001
17119,U39715,80,-6056.389999999999,50,30,125959.69,119903.3
17120,U14734,80,172439.74999999985,33,47,1851333.4,2023773.1499999997
17121,U21317,80,336.3099999999977,70,10,47472.32000000001,47808.630000000005
17122,U27684,80,-1679.6900000000005,75,5,39564.689999999995,37884.99999999999
17123,U16848,80,96076.37999999999,49,31,667986.58,764062.96
17124,U21090,80,-23082.020000000037,59,21,93496.66999999994,70414.6499999999
17125,U25286,80,-30239.890000000003,68,12,135883.02999999997,105643.13999999997
17126,U29490,80,-18466.880000000005,72,8,49427.58,30960.699999999997
17127,U40932,80,-17667.649999999998,57,23,66683.54000000001,49015.890000000014
17128,U32003,80,2298.6299999999974,71,9,41794.259999999995,44092.88999999999
17129,U20831,80,-31912.73,60,20,145134.08999999997,113221.35999999997
17130,U16687,80,74628.95000000001,61,19,70527.47,145156.42
17131,U10180,80,-18612.850000000006,59,21,165779.32999999996,147166.47999999995
17132,U32712,80,7799.600000000004,65,15,54442.46999999999,62242.06999999999
17133,U30616,80,-4851.049999999999,69,11,47612.939999999995,42761.89
17134,U14128,80,7370.749999999998,66,14,38334.229999999996,45704.979999999996
17135,U23243,80,-15038.139999999996,74,6,89803.93999999999,74765.79999999999
17136,U41720,80,515522.06000000006,69,11,224256.34999999995,739778.41
17137,U36017,80,-401.78000000001134,54,26,212073.78999999998,211672.00999999998
17138,U15290,80,-820971.75,55,25,1951811.97,1130840.22
17139,U9970,80,-6550.22,75,5,10394.670000000002,3844.4500000000016
17140,U19670,80,-29488.77999999993,44,36,760339.7,730850.92
17141,U26342,80,-1566.1900000000007,77,3,9578.63,8012.439999999999
17142,U24698,80,-153.18000000000006,73,7,6729.060000000002,6575.880000000002
17143,U22639,80,1632.3800000000022,70,10,20457.29,22089.670000000002
17144,U22034,80,14649.49,53,27,378496.65,393146.14
17145,U31629,80,1064.0099999999973,72,8,16594.819999999996,17658.829999999994
17146,U38369,80,-61.50000000003638,53,27,333384.86,333323.3599999999
17147,U29854,80,-1198.9700000000012,61,19,62300.4,61101.43
17148,U16158,80,34782.89,64,16,135680.91,170463.8
17149,U8260,80,-942.7900000000066,66,14,78607.36000000002,77664.57
17150,U18301,80,-11501.390000000003,50,30,73032.32,61530.93000000001
17151,U16082,80,681363.37,61,19,345536.22000000003,1026899.5900000001
17152,U24876,80,-216745.16999999987,68,12,277230.67999999993,60485.51000000007
17153,U42995,80,-391915.37,65,15,1076546.7499999998,684631.3799999998
17154,U23686,80,12014.71,64,16,134945.46,146960.16999999998
17155,U11628,80,52467.06999999997,67,13,292354.64,344821.70999999996
17156,U827107,80,-2699.0400000000004,70,10,5532.09,2833.0499999999997
17157,U15601,80,-11305.540000000008,57,23,85193.56999999999,73888.02999999998
17158,U30140,80,1032800.2199999999,43,37,1996607.4500000002,3029407.67
17159,U19943,80,349.95999999999924,71,9,52017.35999999999,52367.31999999999
17160,U20295,80,2027.8199999999995,61,19,61942.30000000001,63970.12000000001
17161,U12245,80,-1442.6599999999996,53,27,214013.67000000004,212571.01000000004
17162,U11507,80,-2871.659999999999,66,14,23401.21,20529.55
17163,U38414,80,-187416.40999999997,54,26,824267.7699999999,636851.3599999999
17164,U32096,80,-557.9199999999983,59,21,61455.79,60897.87
17165,U970597,80,-20530.279999999995,60,20,78284.12,57753.84
17166,U32938,80,26242.060000000005,73,7,41604.22,67846.28
17167,U656079,80,862.4399999999982,65,15,9221.14,10083.579999999998
17168,U25588,80,0.2900000000008731,37,43,61840.0,61840.29
17169,U41326,80,-2551.0300000000075,67,13,180467.39000000004,177916.36000000004
17170,U39109,80,-967.8700000000003,47,33,5203.68,4235.8099999999995
17171,U707145,80,15.780000000000655,40,40,35269.880000000005,35285.66
17172,U35028,80,-103.92000000000053,76,4,5890.94,5787.019999999999
17173,U618085,80,-4997.349999999999,53,27,39463.03,34465.68
17174,U36593,80,2284.1100000000006,37,43,57382.259999999995,59666.369999999995
17175,U17577,80,95503.44999999998,63,17,550645.49,646148.94
17176,U39426,80,-6062.670000000001,72,8,85080.54000000001,79017.87000000001
17177,U43058,80,38.089999999999236,72,8,15527.559999999998,15565.649999999998
17178,U29466,80,31011.660000000196,60,20,2979347.85,3010359.5100000002
17179,U27003,80,2572.350000000001,71,9,32875.33,35447.68
17180,U26602,80,74078.16,65,15,131186.08999999997,205264.24999999997
17181,U667655,80,-387.42999999999995,66,14,6277.35,5889.92
17182,U24654,80,-6532.589999999999,60,20,62116.68999999998,55584.099999999984
17183,U40007,80,156654.18,60,20,200333.66,356987.83999999997
17184,U30410,80,-118727.43999999996,51,29,251009.88999999998,132282.45
17185,U12616,80,15469.770000000008,39,41,38759.52,54229.29000000001
17186,U25917,80,-460.71000000000004,65,15,20902.53,20441.82
17187,U31634,80,-1005.6900000000007,72,8,8048.78,7043.089999999999
17188,U30171,80,-1567.31000000002,59,21,645580.2799999999,644012.9699999999
17189,U17383,80,13049.730000000129,57,23,1123002.9199999997,1136052.65
17190,U29724,80,65327.99000000002,70,10,35391.45999999999,100719.45000000001
17191,U10528,80,-72449.45999999993,53,27,985214.3099999996,912764.8499999996
17192,U1061999,80,2.61,41,39,2341.74,2344.35
17193,U9817,80,67844.1199999999,60,20,1966561.54,2034405.66
17194,U21873,80,-919.9500000000025,57,23,94075.47,93155.52
17195,U776284,80,-98.91000000000008,56,24,2633.59,2534.6800000000003
17196,U24099,80,-27995.819999999992,72,8,61988.82,33993.00000000001
17197,U38634,80,-4332.709999999996,72,8,76466.84,72134.13
17198,U39310,80,-41615.770000000004,66,14,103028.73999999999,61412.96999999999
17199,U39432,80,154351.96999999997,72,8,185267.1,339619.06999999995
17200,U33189,80,76376.86,46,34,238497.86000000002,314874.72000000003
17201,U18889,80,569.7200000000521,38,42,644414.1699999999,644983.89
17202,U638494,80,-41341.05,52,28,239202.11,197861.06
17203,U38206,80,2739.8999999999996,57,23,135952.46999999997,138692.36999999997
17204,U20153,80,68449.93,72,8,80637.18999999999,149087.12
17205,U39216,80,-59321.75999999999,69,11,799278.1,739956.34
17206,U13228,80,-585.4099999999947,46,34,154921.57999999996,154336.16999999995
17207,U25716,80,2390.100000000006,59,21,249430.51,251820.61000000002
17208,U15943,80,-1799.4699999999998,75,5,28702.01,26902.539999999997
17209,U9317,80,-17348.559999999998,70,10,46552.969999999994,29204.409999999996
17210,U26584,80,-25990.27,75,5,67656.75999999998,41666.489999999976
17211,U32978,80,4391.9100000000035,59,21,101204.69,105596.6
17212,U28943,80,-12163.769999999948,58,22,595307.55,583143.7800000001
17213,U8272,80,-12718.94,40,40,92279.98000000001,79561.04000000001
17214,U21554,80,189138.19999999998,59,21,251000.32,440138.52
17215,U14171,80,2842.4099999999994,63,17,9501.850000000002,12344.260000000002
17216,U30762,80,-10554.179999999993,65,15,133764.46,123210.28
17217,U35354,80,3733.5000000000045,58,22,232402.71999999997,236136.21999999997
17218,U43867,80,1552.9700000000066,60,20,87860.2,89413.17
17219,U17719,80,-4094.36,74,6,19517.800000000007,15423.440000000006
17220,U16313,80,119999.68999999999,49,31,273974.18000000005,393973.87000000005
17221,U39611,80,51791.17999999995,59,21,128215.32000000002,180006.49999999997
17222,U34913,80,-3822.100000000006,52,28,474607.70999999996,470785.61
17223,U37022,80,-1444.9799999999968,52,28,75365.74,73920.76000000001
17224,U19424,80,96432.75999999997,48,32,924909.7499999999,1021342.5099999999
17225,U900892,80,-4322.220000000001,52,28,53369.39,49047.17
17226,U22146,80,23197.089999999997,58,22,12091.779999999997,35288.869999999995
17227,U19713,80,1468.0,68,12,27823.29,29291.29
17228,U37329,80,20745.830000000016,36,44,2571519.42,2592265.25
17229,U38829,80,-16558.429999999997,75,5,83270.20999999999,66711.78
17230,U9590,80,12787.81,48,32,1026765.72,1039553.53
17231,U952032,80,-15368.75,58,22,76826.07000000002,61457.32000000002
17232,U24164,80,-2833821.42,58,22,5017549.950000001,2183728.530000001
17233,U42968,80,170.67000000000013,67,13,3881.209999999999,4051.879999999999
17234,U29698,80,776.0999999999993,69,11,27579.00000000001,28355.10000000001
17235,U40567,80,61831.50999999995,50,30,3412607.279999999,3474438.7899999986
17236,U11076,80,-245918.23999999996,76,4,348035.2700000002,102117.03000000023
17237,U19313,80,-16115.900000000001,71,9,109540.12999999999,93424.22999999998
17238,U33219,80,-33571.669999999984,56,24,290010.20999999985,256438.53999999986
17239,U37359,80,-2942.699999999978,62,18,306249.48000000004,303306.7800000001
17240,U14761,80,56919.94000000002,64,16,159970.97,216890.91000000003
17241,U13969,79,7344.989999999999,58,21,344313.86,351658.85
17242,U30326,79,-55024.71,62,17,271112.97,216088.25999999998
17243,U28417,79,0.19000000006926854,39,40,826428.19,826428.38
17244,U43760,79,-9432.41,66,13,29950.63,20518.22
17245,U25639,79,3332.5800000000004,66,13,19267.18,22599.760000000002
17246,U22762,79,-1716.1200000000026,69,10,109641.53,107925.41
17247,U22915,79,-13034.979999999981,71,8,369077.29000000004,356042.31000000006
17248,U33202,79,-1547.7099999999998,72,7,19291.740000000005,17744.030000000006
17249,U40997,79,-32371.730000000003,55,24,236363.05999999997,203991.32999999996
17250,U22882,79,12758.749999999998,57,22,35694.89,48453.64
17251,U13824,79,7051.62,55,24,90442.09,97493.70999999999
17252,U879563,79,-10.230000000000855,47,32,14998.779999999997,14988.549999999996
17253,U979448,79,-7164.049999999999,53,26,58557.939999999995,51393.89
17254,U41063,79,238.96999999999753,68,11,15359.120000000003,15598.09
17255,U41190,79,9787.479999999987,53,26,430279.72,440067.19999999995
17256,U17325,79,-17781.310000000005,63,16,176225.66999999998,158444.36
17257,U11372,79,-12474.05000000001,52,27,469186.52999999997,456712.48
17258,U34442,79,-36.65000000000373,66,13,141731.90999999997,141695.25999999998
17259,U23606,79,364.29999999999956,75,4,18958.75,19323.05
17260,U21779,79,-13130.099999999999,72,7,63826.54999999999,50696.44999999999
17261,U39235,79,47286.64,71,8,36302.9,83589.54000000001
17262,U26685,79,3726.330000000002,70,9,253958.28000000006,257684.61000000007
17263,U20803,79,33.0299999999962,65,14,91217.56,91250.59
17264,U24903,79,-59.409999999999954,60,19,700.5899999999998,641.1799999999998
17265,U37542,79,18512.339999999993,71,8,50525.490000000005,69037.83
17266,U21262,79,-51990.380000000005,69,10,145841.24000000005,93850.86000000004
17267,U36159,79,8525.079999999993,62,17,238754.27,247279.34999999998
17268,U22313,79,-1185.9499999999957,39,40,86322.42,85136.47
17269,U1220928,79,-4203.039999999999,40,39,53032.04,48829.0
17270,U21624,79,13347.430000000008,61,18,55798.26000000001,69145.69000000002
17271,U31244,79,-15048.649999999998,70,9,33725.02,18676.37
17272,U43634,79,-11271.420000000006,66,13,43798.33999999999,32526.919999999984
17273,U1200087,79,-0.7200000000025284,40,39,77837.79,77837.06999999999
17274,U34666,79,-83031.13999999998,74,5,217101.69,134070.55000000002
17275,U37429,79,-32362.870000000003,71,8,42459.26,10096.39
17276,U30670,79,-4206.14,71,8,29289.700000000004,25083.560000000005
17277,U30627,79,-658.0499999999993,61,18,30441.08,29783.030000000002
17278,U16368,79,-15608.630000000001,62,17,61507.229999999996,45898.59999999999
17279,U13685,79,21401.990000000005,59,20,195786.58000000002,217188.57
17280,U39576,79,-102.83999999999995,60,19,57689.57000000001,57586.73000000001
17281,U32711,79,-48401.87000000009,48,31,1203124.1099999999,1154722.2399999998
17282,U43552,79,-72.38999999999669,37,42,435190.04000000004,435117.65
17283,U35216,79,3882.029999999999,71,8,27959.11,31841.14
17284,U15674,79,17859.68,44,35,44327.93,62187.61
17285,U42984,79,5119.269999999993,62,17,73136.81,78256.07999999999
17286,U12005,79,-15543.300000000034,56,23,905399.03,889855.73
17287,U28455,79,-209.98999999997613,52,27,349036.31,348826.32
17288,U1077505,79,-458.38999999999993,63,16,2719.97,2261.58
17289,U30887,79,-2572.100000000002,65,14,109300.96,106728.86
17290,U10216,79,-1688.7799999999156,49,30,358887.0,357198.2200000001
17291,U1118102,79,-2518.0999999999985,54,25,56988.45,54470.35
17292,U18329,79,-2598.5400000000004,66,13,10339.19,7740.65
17293,U27369,79,24990.61999999997,60,19,148098.16000000003,173088.78
17294,U33782,79,-813.769999999999,75,4,9037.6,8223.830000000002
17295,U38907,79,-8767.579999999994,61,18,404237.53,395469.95
17296,U19146,79,18784.279999999995,66,13,101502.01999999996,120286.29999999996
17297,U40680,79,26702.660000000003,62,17,38341.07000000001,65043.73000000001
17298,U35242,79,-5192.13,71,8,15401.010000000002,10208.880000000001
17299,U26251,79,4186.950000000001,66,13,18997.570000000003,23184.520000000004
17300,U39823,79,-1290.4599999999962,66,13,66638.37000000001,65347.91000000001
17301,U9544,79,-14704.500000000007,56,23,164848.0,150143.5
17302,U33533,79,-4661.2199999999975,67,12,75268.06999999999,70606.84999999999
17303,U32731,79,-21679.820000000036,67,12,148126.61999999997,126446.79999999993
17304,U31764,79,-173.9300000000003,57,22,127243.5,127069.57
17305,U12095,79,-100491.65999999996,52,27,821454.2,720962.54
17306,U1141920,79,458.8199999999997,41,38,43571.259999999995,44030.079999999994
17307,U11246,79,835.7399999999716,60,19,287555.63,288391.37
17308,U14441,79,-101668.73999999996,49,30,580442.92,478774.18000000005
17309,U17156,79,-106743.59,62,17,153318.01,46574.42000000001
17310,U10646,79,-10244.700000000008,59,20,223533.05,213288.34999999998
17311,U18539,79,-11337.769999999999,72,7,26436.220000000005,15098.450000000006
17312,U11361,79,2552.980000000003,60,19,58916.159999999996,61469.14
17313,U16732,79,1062852.6,55,24,6485684.97,7548537.57
17314,U28759,79,36093.97000000001,69,10,17726.010000000002,53819.98000000001
17315,U33263,79,-9381.569999999958,31,48,429508.67000000004,420127.1000000001
17316,U1090028,79,-213.95999999999822,52,27,63590.89000000001,63376.93000000001
17317,U27229,79,-3063.870000000007,67,12,133680.74,130616.86999999998
17318,U29089,79,4439.380000000001,51,28,100633.96,105073.34000000001
17319,U22938,79,-37170.91,70,9,80126.81000000003,42955.90000000002
17320,U25406,79,-3227.409999999999,59,20,106991.01000000002,103763.60000000002
17321,U39383,79,-2503668.96,72,7,2629348.77,125679.81000000006
17322,U32623,79,-5100.77,59,20,123293.16999999998,118192.39999999998
17323,U1294893,79,-1332.99,74,5,2184.24,851.2499999999998
17324,U17525,79,2854.3500000000004,66,13,44015.53,46869.88
17325,U19256,79,10.92999999998574,60,19,284610.13,284621.06
17326,U977075,79,-8905.890000000001,59,20,26718.62999999999,17812.73999999999
17327,U34247,79,2610.389999999968,41,38,193794.84000000003,196405.22999999998
17328,U38333,79,90574.01,49,30,441335.49,531909.5
17329,U39181,79,647.7299999999617,51,28,414638.04000000004,415285.77
17330,U15961,79,-52641.25,65,14,263684.9,211043.65000000002
17331,U10348,79,425316.43000000063,48,31,15045253.77,15470570.2
17332,U9255,79,-646998.1900000002,48,31,10096814.02,9449815.83
17333,U41478,79,-58888.31999999998,64,15,177243.49,118355.17000000001
17334,U10051,79,-5417.930000000005,70,9,58415.03999999999,52997.109999999986
17335,U35521,79,-20436.08,67,12,246248.6,225812.52000000002
17336,U22489,79,-2427.6699999999996,50,29,41328.34999999999,38900.67999999999
17337,U38486,79,-3585.3399999999997,71,8,10392.94,6807.6
17338,U40543,79,-8832.099999999999,63,16,38811.93,29979.83
17339,U28279,79,-4907.980000000001,66,13,27257.200000000004,22349.22
17340,U29198,79,5884.969999999966,54,25,400228.0300000001,406113.00000000006
17341,U18476,79,3519.2700000000004,35,44,196832.65000000002,200351.92
17342,U28986,79,-101.83000000002775,73,6,258471.79999999996,258369.96999999994
17343,U26385,79,-28228.989999999994,60,19,177572.66999999995,149343.67999999996
17344,U21254,79,-11700.669999999998,51,28,76904.25,65203.58
17345,U15687,79,11415.349999999999,41,38,162104.64,173519.99000000002
17346,U24781,79,6621.36,66,13,42963.62,49584.98
17347,U35148,79,-4497.849999999998,75,4,21509.100000000006,17011.250000000007
17348,U28630,79,28797.05999999999,64,15,26126.480000000003,54923.53999999999
17349,U31043,79,-1935.26,73,6,7094.49,5159.23
17350,U31988,79,-4937.780000000019,56,23,311837.38,306899.6
17351,U10343,79,10831.269999999999,61,18,88875.22,99706.49
17352,U30846,79,-191.7400000000006,61,18,34248.48000000001,34056.74000000001
17353,U35426,79,13931.959999999994,43,36,250392.76,264324.72000000003
17354,U702098,79,33.02999999999986,65,14,4047.7999999999997,4080.8299999999995
17355,U34838,79,10789.46000000002,48,31,784933.99,795723.45
17356,U37906,79,92309.35000000006,68,11,428624.52000000014,520933.8700000002
17357,U17844,79,14.63999999998586,48,31,768960.2799999999,768974.9199999999
17358,U42438,79,2293666.31,55,24,2955380.83,5249047.140000001
17359,U793612,79,-1472.54,70,9,8694.080000000002,7221.540000000002
17360,U25663,79,2729.109999999987,59,20,274029.6599999999,276758.7699999999
17361,U36931,79,28771.979999999996,62,17,17387.289999999997,46159.26999999999
17362,U38174,79,-17561.529999999988,66,13,100186.56999999999,82625.04000000001
17363,U21160,79,888.4900000000024,70,9,18121.620000000003,19010.110000000004
17364,U41133,79,-538.7900000000081,73,6,37302.44,36763.649999999994
17365,U40128,79,-63594.649999999994,73,6,305844.26,242249.61000000002
17366,U588956,79,-1788.2400000000002,63,16,5732.419999999997,3944.179999999997
17367,U14923,79,342.70000000000164,44,35,49342.18,49684.880000000005
17368,U12715,79,2720.539999999997,56,23,196600.25999999995,199320.79999999996
17369,U23604,79,-11084.08,68,11,29694.290000000005,18610.210000000006
17370,U18738,79,13.0600000000195,61,18,163169.4,163182.46000000002
17371,U19260,79,-23971.429999999997,53,26,76054.56999999998,52083.139999999985
17372,U17278,79,23317.120000000024,44,35,219871.47999999998,243188.6
17373,U21070,79,-14526.440000000033,56,23,243020.84000000005,228494.40000000002
17374,U13552,79,-10014.890000000007,71,8,844282.04,834267.15
17375,U32136,79,-605.4099999999999,55,24,150530.5,149925.09
17376,U44071,79,-32848.990000000005,70,9,59071.67,26222.679999999993
17377,U23058,79,-1578.8699999999994,74,5,12869.359999999997,11290.489999999998
17378,U21979,79,3289.8500000000004,61,18,13159.82,16449.67
17379,U38758,79,-2122.6400000000062,61,18,264879.65,262757.01
17380,U709092,79,679.6700000000005,49,30,7545.500000000001,8225.170000000002
17381,U580321,79,-7898.12,65,14,15080.899999999998,7182.779999999998
17382,U10381,79,-52077.0,46,33,1396540.8900000001,1344463.8900000001
17383,U23021,79,112080.67999999996,57,22,649488.27,761568.95
17384,U26571,79,-6255.140000000002,59,20,67425.20000000001,61170.06000000001
17385,U16748,79,-4958.159999999994,72,7,60265.50000000002,55307.340000000026
17386,U9536,79,-35.32999999999993,70,9,12672.800000000001,12637.470000000001
17387,U35773,79,4999.9999999999845,44,35,241313.57,246313.56999999998
17388,U763893,79,-10092.71,52,27,30433.110000000004,20340.400000000005
17389,U9082,79,-7910.300000000003,49,30,375610.89,367700.59
17390,U43916,79,-33360.649999999994,64,15,53129.39,19768.740000000005
17391,U8409,79,-10017.079999999998,56,23,51933.22,41916.14
17392,U33618,79,44099.57,68,11,23064.459999999995,67164.03
17393,U8524,79,3084.920000000003,69,10,15398.090000000004,18483.010000000006
17394,U39843,79,-58611.12999999999,60,19,111701.28999999998,53090.15999999999
17395,U42693,79,-2087.0499999999993,55,24,46198.29000000001,44111.240000000005
17396,U30278,79,18085.460000000017,50,29,228850.28,246935.74000000002
17397,U16350,79,2000.6100000000015,63,16,69537.77,71538.38
17398,U34042,79,8147.689999999997,64,15,88392.93000000001,96540.62000000001
17399,U26538,79,1035.5500000000015,67,12,15800.699999999997,16836.25
17400,U30561,79,-19560.64999999991,37,42,734774.5699999998,715213.9199999999
17401,U28520,79,152.75000000000216,62,17,80196.04000000001,80348.79000000001
17402,U24524,79,1579.6499999999992,60,19,127533.75000000001,129113.40000000001
17403,U899857,79,194.84000000000242,41,38,15428.95,15623.790000000003
17404,U32219,79,232437.06,64,15,27367.64,259804.7
17405,U16126,79,1475.2700000000004,53,26,32945.240000000005,34420.51000000001
17406,U16725,79,-11593.60000000002,48,31,429093.9,417500.3
17407,U29794,79,-15436.890000000003,69,10,173037.78999999998,157600.89999999997
17408,U17510,79,22723.269999999997,65,14,121634.06999999999,144357.34
17409,U945841,78,-0.7300000000054752,57,21,137001.66999999998,137000.93999999997
17410,U26892,78,123462.65000000002,70,8,184886.19999999998,308348.85
17411,U27004,78,-786406.5800000001,45,33,1004979.06,218572.47999999998
17412,U34149,78,-53533.979999999996,57,21,174829.25000000003,121295.27000000003
17413,U25831,78,-344.2999999999993,66,12,32369.39,32025.09
17414,U23108,78,851.4299999999992,67,11,58930.73,59782.16
17415,U795366,78,-7300.029999999999,62,16,94567.08,87267.05
17416,U30032,78,71169.80999999997,62,16,861849.7500000002,933019.5600000002
17417,U11474,78,104954.93000000004,61,17,90772.24999999999,195727.18000000002
17418,U14723,78,33925.509999999995,45,33,319682.51999999996,353608.02999999997
17419,U34031,78,-12621.119999999839,64,14,1166676.6099999999,1154055.49
17420,U36810,78,16.299999999999272,56,22,19477.379999999997,19493.679999999997
17421,U33490,78,23702.92,60,18,32495.66,56198.58
17422,U9459,78,-1813.8799999999987,58,20,160632.98,158819.1
17423,U592377,78,-8781.849999999999,63,15,33923.18,25141.33
17424,U19200,78,2405.5300000000134,48,30,224574.77000000002,226980.30000000005
17425,U29069,78,89817.45999999999,69,9,145264.29,235081.75
17426,U39016,78,44900.299999999996,46,32,338081.14,382981.44
17427,U10465,78,5444.490000000022,69,9,260542.9699999999,265987.45999999996
17428,U13656,78,-465.93000000000393,50,28,138066.86,137600.93
17429,U14530,78,18998.28000000001,53,25,569515.44,588513.72
17430,U37118,78,-25608.920000000006,63,15,265274.39,239665.47
17431,U31314,78,-803202.31,60,18,998740.35,195538.03999999992
17432,U14818,78,-27843.020000000022,59,19,627793.63,599950.61
17433,U22630,78,12417.11000000001,60,18,334535.42,346952.52999999997
17434,U13531,78,-34221.04999999999,55,23,266761.02,232539.97000000003
17435,U29576,78,-133.08999999999992,42,36,6089.579999999999,5956.489999999999
17436,U13906,78,23183.300000000003,64,14,243922.50000000003,267105.80000000005
17437,U41122,78,81124.06,51,27,484882.74,566006.8
17438,U39673,78,32958.25999999999,57,21,26116.399999999998,59074.65999999999
17439,U11294,78,4565.3499999999985,58,20,112922.94000000002,117488.29000000001
17440,U39523,78,-35623.54999999999,50,28,231411.12,195787.57
17441,U20853,78,-5078.009999999998,41,37,35943.68,30865.670000000002
17442,U34218,78,3610.7500000000036,68,10,31672.55,35283.3
17443,U16416,78,-2428.8500000000076,62,16,101074.03,98645.18
17444,U19245,78,3188.8299999999963,62,16,31760.94000000001,34949.770000000004
17445,U19140,78,181722.18000000002,66,12,47753.6,229475.78000000003
17446,U42082,78,686.0699999999447,46,32,656309.3,656995.37
17447,U11198,78,-79020.44,64,14,179999.31,100978.87
17448,U10305,78,4138.649999999995,56,22,150453.15,154591.8
17449,U22379,78,-11288.660000000013,60,18,132184.28,120895.61999999998
17450,U17164,78,10369.84000000001,59,19,479461.33999999997,489831.18
17451,U25309,78,46278.01999999993,43,35,1896416.03,1942694.05
17452,U837155,78,718.4599999999997,54,24,10457.789999999997,11176.249999999996
17453,U8361,78,-6875.0099999999975,70,8,22955.68000000001,16080.670000000013
17454,U14783,78,136548.75,58,20,106393.37000000001,242942.12
17455,U33209,78,234.0,60,18,136475.41999999998,136709.41999999998
17456,U591305,78,-169.65999999999912,61,17,23916.02,23746.36
17457,U17767,78,2020.7600000000007,59,19,52603.549999999996,54624.31
17458,U24076,78,-26966.270000000004,70,8,119802.54999999999,92836.27999999998
17459,U14972,78,2652.0700000000143,54,24,276822.80000000005,279474.87000000005
17460,U21853,78,-91102.73,69,9,150166.41,59063.68000000001
17461,U18722,78,-7310.1,67,11,62419.88,55109.78
17462,U23389,78,-816.0500000000002,71,7,4181.43,3365.38
17463,U37472,78,4268.2199999999975,63,15,133115.84,137384.06
17464,U20965,78,-528.7700000000004,63,15,105363.20999999999,104834.43999999999
17465,U14989,78,192.69999999995866,36,42,674677.56,674870.26
17466,U16996,78,-3923.5399999999936,47,31,160595.19,156671.65000000002
17467,U10553,78,514.6100000000001,68,10,20089.84,20604.45
17468,U31791,78,2950.0800000000045,70,8,155486.54,158436.62000000002
17469,U38555,78,-17263.43,66,12,50936.15,33672.72
17470,U704150,78,-1920.6800000000003,58,20,9656.98,7736.299999999999
17471,U27278,78,52135.58999999999,70,8,127713.76000000001,179849.35
17472,U939561,78,-69.21999999999971,60,18,7805.75,7736.530000000001
17473,U32850,78,-37099.170000000006,37,41,313328.9,276229.73000000004
17474,U962713,78,-11753.469999999996,61,17,13576.759999999997,1823.2900000000009
17475,U23054,78,653.9899999999984,65,13,27875.35,28529.339999999997
17476,U18331,78,-33259.90000000004,55,23,197571.18000000002,164311.27999999997
17477,U13360,78,1339.5700000000652,46,32,1399100.93,1400440.5
17478,U16314,78,-3629.199999999999,63,15,116026.93000000002,112397.73000000003
17479,U14313,78,109.62999999999974,58,20,29558.440000000002,29668.070000000003
17480,U40580,78,15631.629999999997,45,33,125705.32,141336.95
17481,U11323,78,41.75999999999854,50,28,398248.32,398290.08
17482,U13960,78,3388.270000000004,57,21,77595.0,80983.27
17483,U18188,78,1544.840000000024,56,22,447356.5700000001,448901.41000000015
17484,U31181,78,-27706.20000000002,55,23,423528.00000000006,395821.80000000005
17485,U743038,78,-151.78999999999888,44,34,28718.420000000002,28566.630000000005
17486,U13913,78,112169.36000000002,48,30,479293.7899999999,591463.1499999999
17487,U41071,78,207.55000000000086,70,8,60161.64000000001,60369.19000000001
17488,U16777,78,-115019.91999999991,54,24,2041087.2100000002,1926067.2900000003
17489,U13512,78,3914.910000000004,71,7,30402.54,34317.450000000004
17490,U32425,78,-68162.08,73,5,122020.28,53858.2
17491,U22260,78,9467.400000000001,64,14,114252.39000000001,123719.79000000001
17492,U17528,78,2558.0000000000027,56,22,40726.69999999999,43284.69999999999
17493,U24018,78,-21388.47,63,15,104702.28,83313.81
17494,U16761,78,-187124.21000000008,44,34,980253.1100000001,793128.9
17495,U20564,78,6450.130000000001,64,14,16067.070000000002,22517.200000000004
17496,U38155,78,53272.249999999985,60,18,83632.92,136905.16999999998
17497,U12097,78,-23643.97999999999,46,32,281402.55999999994,257758.57999999996
17498,U14662,78,-7118.459999999998,73,5,26939.7,19821.24
17499,U18857,78,-1354.500000000003,62,16,85450.65,84096.15
17500,U18067,78,-4610.120000000001,52,26,42118.76,37508.64
17501,U18766,78,-49142.19,48,30,202503.22,153361.03
17502,U26090,78,52211.66,68,10,229024.97999999995,281236.63999999996
17503,U10606,78,79721.83999999985,58,20,782146.16,861867.9999999999
17504,U35708,78,35785.840000000004,45,33,247525.69,283311.53
17505,U31863,78,-121026.50000000001,63,15,210840.57000000004,89814.07000000002
17506,U27531,78,572140.8600000001,66,12,3019636.4500000007,3591777.3100000005
17507,U40810,78,-1005.2800000000007,58,20,69515.29,68510.01
17508,U13900,78,77351.57000000002,55,23,119722.16999999998,197073.74
17509,U19700,78,2592.970000000001,44,34,139667.18,142260.15
17510,U19038,78,2427.4800000000105,46,32,1103488.46,1105915.94
17511,U42080,78,574.520000000002,72,6,42480.0,43054.520000000004
17512,U19014,78,-16368.68,57,21,104510.15999999999,88141.47999999998
17513,U18900,78,-16550.9,70,8,28777.989999999998,12227.089999999997
17514,U12963,78,-94968.23999999976,62,16,2733774.9200000004,2638806.6800000006
17515,U40122,78,-1004.5299999999945,69,9,53457.48,52452.95000000001
17516,U39760,78,6224.999999999997,66,12,35245.48,41470.48
17517,U14145,78,-17157.590000000007,72,6,67721.29000000001,50563.7
17518,U36661,78,-4816.7599999999975,56,22,24440.11,19623.350000000002
17519,U42206,78,-6380.65,71,7,36191.86,29811.21
17520,U40650,78,27079.61000000002,44,34,231649.65,258729.26
17521,U41152,78,68330.63,59,19,1307021.03,1375351.6600000001
17522,U709926,78,-440.51999999999316,52,26,213134.55000000008,212694.0300000001
17523,U16806,78,-3560.780000000009,59,19,178271.53,174710.75
17524,U28360,78,135.0500000000029,47,31,280423.94,280558.99
17525,U35890,78,-43294.94000000002,55,23,978153.3,934858.36
17526,U29259,78,5908.729999999999,62,16,25309.000000000007,31217.730000000007
17527,U24412,78,-15353.909999999943,55,23,1883389.25,1868035.34
17528,U39992,78,-231.6600000000393,33,45,599450.81,599219.15
17529,U19429,78,-37062.79,68,10,58124.22,21061.43
17530,U17387,78,13675.73000000067,52,26,14469817.98,14483493.71
17531,U17047,78,-209.91999999999683,72,6,64347.41000000001,64137.49000000001
17532,U15845,78,3057.3099999999977,66,12,50316.270000000004,53373.58
17533,U26984,78,13539.520000000006,70,8,29729.249999999996,43268.770000000004
17534,U31235,78,101009.71,62,16,10061.34,111071.05
17535,U9477,78,-7208.979999999998,71,7,69367.17999999998,62158.19999999998
17536,U10324,78,321952.2100000004,46,32,4581308.92,4903261.130000001
17537,U24486,78,-605.7400000002235,47,31,6021124.359999999,6020518.619999999
17538,U24189,78,-130470.19999999994,60,18,374993.63000000006,244523.4300000001
17539,U27875,78,300117.2100000001,71,7,40799.97,340917.18000000005
17540,U41228,78,4260.009999999998,67,11,67544.04,71804.04999999999
17541,U38157,78,-1312.0199999999998,74,4,1386.5599999999997,74.53999999999996
17542,U37808,78,105849.37999999999,66,12,211818.09999999998,317667.48
17543,U22104,78,32697.180000000004,59,19,412666.74,445363.92
17544,U31494,78,-2414.9999999999986,57,21,63930.28999999999,61515.28999999999
17545,U44028,78,2242.810000000004,72,6,77615.3,79858.11
17546,U24931,78,10278.42,62,16,50775.439999999995,61053.85999999999
17547,U36990,78,-23465.880000000005,73,5,37137.06000000001,13671.180000000008
17548,U27225,78,-20634.53999999992,66,12,453901.06,433266.5200000001
17549,U35815,78,30111.52000000002,39,39,225199.93,255311.45
17550,U12998,78,7614.769999999997,38,40,342914.44000000006,350529.2100000001
17551,U30848,78,2671.2099999999946,55,23,126382.23999999999,129053.44999999998
17552,U27973,78,4919.76,52,26,41601.82999999999,46521.58999999999
17553,U34777,78,-300457.79000000004,42,36,1106375.21,805917.4199999999
17554,U39489,78,11387.160000000009,56,22,244107.36,255494.52
17555,U13435,78,-20342.030000000028,51,27,948884.3700000001,928542.3400000001
17556,U1129908,78,-7672.250000000002,46,32,41741.29000000001,34069.04000000001
17557,U28898,78,-3592.04,54,24,6374.3099999999995,2782.2699999999995
17558,U41608,78,2837.830000000006,54,24,73500.18000000001,76338.01000000001
17559,U30879,78,-155.29000000000138,68,10,12022.879999999997,11867.589999999997
17560,U38060,78,23814.580000000005,63,15,82845.32,106659.90000000001
17561,U19729,78,4308.880000000002,59,19,53689.9,57998.780000000006
17562,U11269,78,-14782.979999999992,70,8,97566.47000000003,82783.49000000003
17563,U23369,78,14619.060000000007,71,7,80495.02,95114.08000000002
17564,U19554,78,3366.7099999999955,59,19,92730.89,96097.59999999999
17565,U30587,78,-815.0500000000002,66,12,16290.34,15475.29
17566,U38488,78,13851.52,61,17,29018.99,42870.51
17567,U20799,78,26224.35,70,8,61148.840000000004,87373.19
17568,U34090,78,-2083.8099999999895,55,23,123006.27,120922.46000000002
17569,U20851,78,1877.870000000003,55,23,54149.10000000001,56026.970000000016
17570,U13292,78,-22925.39999999994,50,28,2738221.24,2715295.8400000003
17571,U38462,78,-1489.1799999999985,58,20,119831.41999999997,118342.23999999998
17572,U21980,78,-86.40000000000873,42,36,582317.2799999999,582230.8799999999
17573,U27112,78,-898.4399999999863,52,26,394429.53,393531.09
17574,U16378,78,1036.620000000008,37,41,764224.51,765261.13
17575,U28699,78,173.90999999999667,50,28,70772.48,70946.39
17576,U25383,78,5176.680000000004,67,11,56846.13999999999,62022.81999999999
17577,U841521,78,-447.4199999999996,66,12,11641.58,11194.16
17578,U11397,78,-208.52000000000191,59,19,29375.739999999994,29167.219999999994
17579,U31451,78,-3037.8299999999967,64,14,25570.849999999995,22533.019999999997
17580,U1198734,77,-677.130000000001,43,34,37312.93,36635.8
17581,U41320,77,-51932.82999999999,62,15,341260.8900000001,289328.06000000006
17582,U42920,77,-145097.81,52,25,489333.51999999996,344235.70999999996
17583,U34722,77,3332.58,61,16,100774.77,104107.35
17584,U13779,77,17830.679999999982,61,16,357096.61,374927.29
17585,U33271,77,2950.8600000000006,57,20,18195.380000000005,21146.240000000005
17586,U33643,77,7956.110000000003,44,33,70209.66,78165.77
17587,U20793,77,-3626.469999999999,62,15,13239.76,9613.29
17588,U11941,77,7809.330000000002,46,31,114166.40999999999,121975.73999999999
17589,U18971,77,125093.88999999996,45,32,1996487.7100000002,2121581.6
17590,U35883,77,409.6100000000097,55,22,179187.76000000004,179597.37000000005
17591,U26141,77,-9838.60000000001,50,27,199806.11999999997,189967.51999999996
17592,U11452,77,-50378.41000000001,56,21,334544.8899999999,284166.47999999986
17593,U8868,77,67.45000000000016,56,21,26465.910000000007,26533.360000000008
17594,U1176086,77,-5210.5199999999995,46,31,32416.64,27206.12
17595,U590258,77,-7412.350000000003,54,23,23163.97,15751.619999999999
17596,U9046,77,-8822.17,52,25,133430.01,124607.84000000001
17597,U1162010,77,-7723.73,58,19,24572.94,16849.21
17598,U11193,77,-12898.160000000022,52,25,245069.37,232171.20999999996
17599,U1116870,77,-2829.7599999999984,45,32,49369.40000000001,46539.640000000014
17600,U12752,77,-5313.060000000006,51,26,115703.99000000002,110390.93000000001
17601,U18328,77,6530.730000000001,47,30,26294.68,32825.41
17602,U28335,77,-1208.7199999999984,68,9,64785.86000000003,63577.14000000003
17603,U14246,77,14883.600000000002,66,11,20221.64,35105.240000000005
17604,U839223,77,84.02999999999884,42,35,25877.79,25961.82
17605,U9565,77,-27813.730000000156,40,37,1454530.3800000001,1426716.65
17606,U24325,77,2694.0699999999974,63,14,34986.869999999995,37680.939999999995
17607,U44021,77,16578.079999999998,56,21,24945.290000000005,41523.37
17608,U29420,77,10564.970000000001,62,15,88628.9,99193.87
17609,U29138,77,-59.459999999983665,64,13,252831.96,252772.5
17610,U31417,77,1799.3600000000013,65,12,16772.95,18572.31
17611,U10427,77,99562.33000000005,63,14,953746.79,1053309.12
17612,U1160421,77,-49.379999999999825,54,23,6406.8499999999985,6357.469999999998
17613,U20960,77,15294.75,69,8,8910.97,24205.72
17614,U34998,77,-1632.5100000000002,48,29,78460.62,76828.11
17615,U22495,77,-10142.14,71,6,35605.18,25463.04
17616,U33614,77,4628.280000000001,71,6,14324.8,18953.08
17617,U8774,77,2909.7400000000002,65,12,93955.03000000001,96864.77000000002
17618,U1135738,77,238.71999999999963,70,7,9834.32,10073.039999999999
17619,U15683,77,-155983.59,63,14,499118.15,343134.56000000006
17620,U18404,77,-23763.430000000004,60,17,53376.47,29613.039999999997
17621,U16525,77,-2054.430000000003,50,27,52547.37,50492.94
17622,U19721,77,17628.280000000006,52,25,230681.15,248309.43
17623,U10613,77,55165.01000000001,63,14,82276.48,137441.49
17624,U31713,77,1454.1300000000067,57,20,60198.17,61652.3
17625,U16343,77,-2879.5,63,14,7203.150000000001,4323.650000000001
17626,U41299,77,4015.8600000000024,49,28,18137.56,22153.420000000006
17627,U12054,77,-23517.44000000001,67,10,91136.57,67619.13
17628,U25683,77,4330.039999999999,73,4,5646.66,9976.699999999999
17629,U30236,77,-15908.030000000002,71,6,23300.93,7392.899999999998
17630,U17145,77,1751.7700000000054,57,20,152774.03000000003,154525.80000000005
17631,U29214,77,-6116.649999999987,62,15,182548.43999999997,176431.78999999998
17632,U12260,77,-45547.70000000001,63,14,187640.44999999998,142092.74999999997
17633,U13832,77,4451.380000000002,65,12,24149.2,28600.58
17634,U43317,77,32480.109999999997,68,9,13766.22,46246.329999999994
17635,U1193675,77,317.05000000000473,47,30,65006.02,65323.07
17636,U43661,77,-18943.56999999999,54,23,111042.04,92098.47
17637,U42217,77,-11549.74999999997,52,25,959832.69,948282.94
17638,U23048,77,-50274.180000000226,58,19,1900431.3,1850157.1199999999
17639,U15956,77,-1236.2099999999998,48,29,83759.46,82523.25
17640,U21961,77,-106344.61,71,6,175546.58999999997,69201.97999999997
17641,U974430,77,4.6900000000001,40,37,38243.44,38248.130000000005
17642,U1088485,77,-1256.4600000000005,46,31,35146.00000000001,33889.54000000001
17643,U40290,77,-10856.849999999982,65,12,467344.15,456487.30000000005
17644,U16883,77,9373.65,67,10,15476.43,24850.08
17645,U16734,77,-215684.99,47,30,575003.87,359318.88
17646,U16470,77,-4569.169999999999,48,29,182941.55999999994,178372.38999999993
17647,U8479,77,729.8599999999963,59,18,79338.40000000001,80068.26000000001
17648,U35003,77,71859.23,22,55,131297.13,203156.36
17649,U16643,77,77.60000000005675,56,21,2585025.05,2585102.65
17650,U37830,77,9560.960000000032,55,22,951335.1799999999,960896.14
17651,U1028178,77,-62.339999999999996,63,14,2564.7100000000005,2502.3700000000003
17652,U32340,77,-4072.3300000000145,41,36,148413.29,144340.96
17653,U25290,77,41106.909999999996,51,26,73869.19000000002,114976.1
17654,U17243,77,458387.9999999999,58,19,5458883.07,5917271.07
17655,U25117,77,-7296.78,63,14,73281.32999999999,65984.54999999999
17656,U26657,77,-1826.1700000000174,59,18,221563.75999999998,219737.58999999997
17657,U43129,77,-12909.949999999999,59,18,58028.559999999976,45118.60999999998
17658,U1155529,77,-3476.8200000000015,50,27,49516.549999999996,46039.729999999996
17659,U40544,77,-1035.4499999999996,74,3,15753.529999999999,14718.08
17660,U38017,77,-5674.720000000004,42,35,189526.31999999995,183851.59999999995
17661,U43878,77,-4444.560000000001,69,8,22799.910000000003,18355.350000000002
17662,U33468,77,83049.73,50,27,368284.7899999999,451334.5199999999
17663,U33608,77,-23417.639999999992,59,18,156638.14,133220.50000000003
17664,U23043,77,4425.579999999993,53,24,359160.52999999997,363586.11
17665,U16467,77,2752.2399999999966,62,15,118121.33000000002,120873.57
17666,U11793,77,16699.059999999998,72,5,3963.6600000000003,20662.719999999998
17667,U1129753,77,108.95000000003347,46,31,121676.93999999997,121785.89000000001
17668,U26534,77,-6835.490000000002,55,22,51374.0,44538.509999999995
17669,U752866,77,-1283.5999999999992,63,14,14176.369999999999,12892.77
17670,U14261,77,8147.1700000000055,58,19,18539.99,26687.160000000007
17671,U42121,77,-51415.00999999999,62,15,246514.37,195099.36000000002
17672,U13595,77,507.6799999999978,70,7,28062.86,28570.539999999997
17673,U44036,77,-5443.470000000001,44,33,98008.23,92564.76
17674,U10093,77,137308.32000000007,41,36,2304898.9,2442207.2199999997
17675,U1194131,77,1217.3400000000015,47,30,71498.34,72715.68
17676,U8325,77,-1320.3499999999967,51,26,124135.25000000001,122814.90000000002
17677,U28349,77,407.8900000000037,57,20,28139.4,28547.290000000005
17678,U32835,77,-116724.53999999998,40,37,463412.38000000006,346687.8400000001
17679,U8832,77,765.7399999999936,43,34,147836.31999999998,148602.05999999997
17680,U10572,77,14131.339999999997,37,40,164187.28,178318.62
17681,U1200517,77,-12120.590000000002,45,32,36211.34,24090.749999999993
17682,U26979,77,54855.76999999999,46,31,254300.74000000008,309156.51000000007
17683,U599580,77,1013.3800000000008,47,30,16795.190000000002,17808.570000000003
17684,U25727,77,-7144.3299999999945,53,24,69020.12000000002,61875.79000000003
17685,U40110,77,15394.980000000001,70,7,36459.22,51854.200000000004
17686,U36167,77,-596306.37,55,22,3302052.4,2705746.03
17687,U27406,77,-40.36000000000058,44,33,128548.85,128508.49
17688,U23762,77,82957.79,66,11,219982.74999999997,302940.54
17689,U26638,77,4674.149999999996,32,45,136117.19,140791.34
17690,U38402,77,11675.210000000001,68,9,16047.529999999999,27722.739999999998
17691,U30947,77,-399.1099999999951,63,14,47425.67,47026.560000000005
17692,U39960,77,-55694.759999999995,63,14,173840.69,118145.93000000001
17693,U18815,77,1123.9700000000012,72,5,61707.7,62831.67
17694,U613630,77,146.69999999999527,42,35,170915.7,171062.4
17695,U39246,77,-4006.940000000018,68,9,114151.02999999998,110144.08999999997
17696,U12056,77,64790.599999999984,46,31,1410076.3399999999,1474866.94
17697,U24467,77,-15261.040000000023,65,12,142233.03,126971.98999999998
17698,U12100,77,-401.83999999999986,53,24,3081.32,2679.4800000000005
17699,U29872,77,77077.18000000001,62,15,148339.77,225416.95
17700,U31091,77,-15406.55,66,11,28780.219999999998,13373.669999999998
17701,U1103657,77,-1254.9699999999996,47,30,8112.759999999999,6857.79
17702,U10467,77,1242.0699999999943,55,22,82507.56,83749.62999999999
17703,U18961,77,66.59999999999854,54,23,182394.59999999998,182461.19999999998
17704,U20736,77,-1392.8700000000008,65,12,25995.769999999997,24602.899999999994
17705,U36552,77,-43893.270000000004,54,23,373839.08,329945.81
17706,U31631,77,-1345.0599999999686,63,14,307420.7,306075.64
17707,U26745,77,2547.9599999999946,59,18,91656.33999999998,94204.29999999997
17708,U15459,77,23109.41000000001,63,14,370658.1699999999,393767.57999999996
17709,U36965,77,-1214.9800000000014,63,14,20849.459999999995,19634.479999999996
17710,U34489,77,-912.5599999999831,35,42,821364.42,820451.8600000001
17711,U26081,77,-64683.28,44,33,606698.29,542015.01
17712,U20267,77,26033.27,73,4,14433.62,40466.89
17713,U8221,77,96915.12999999999,68,9,107657.15,204572.27999999997
17714,U30671,77,-2096.940000000004,58,19,255477.49000000002,253380.55000000002
17715,U12594,77,27.019999999956894,51,26,679225.9300000002,679252.9500000001
17716,U29473,77,-7913.029999999999,66,11,72730.4,64817.369999999995
17717,U24501,77,-4910.799999999997,68,9,53136.650000000016,48225.85000000002
17718,U41986,77,3599.8099999999995,71,6,6746.41,10346.22
17719,U32883,77,-4470.220000000001,64,13,17675.549999999996,13205.329999999994
17720,U29236,77,45594.33999999972,66,11,2950206.439999999,2995800.779999999
17721,U13465,77,-27774.400000000023,58,19,2047586.56,2019812.1600000001
17722,U29011,77,-12700.1,63,14,56001.45,43301.35
17723,U22701,77,748.869999999999,58,19,121857.15999999997,122606.02999999997
17724,U23040,77,-1583.3099999999988,62,15,33875.490000000005,32292.180000000008
17725,U33610,77,30414.48,51,26,135409.62000000002,165824.10000000003
17726,U31787,77,-123260.2100000002,64,13,2286743.56,2163483.3499999996
17727,U33258,77,-1859.8800000000044,52,25,160690.88999999998,158831.00999999998
17728,U15022,77,-951.6100000000033,53,24,118605.26000000001,117653.65000000001
17729,U1094571,77,97.95999999999937,44,33,7392.0499999999965,7490.009999999996
17730,U20538,77,-18386.550000000003,45,32,113645.78999999998,95259.23999999998
17731,U28435,77,-1178.1999999999998,70,7,8560.44,7382.240000000001
17732,U23090,77,-1090.590000000001,46,31,4462.200000000001,3371.6099999999997
17733,U16113,77,3052.390000000002,34,43,72796.13999999998,75848.52999999998
17734,U26039,77,-14547.179999999997,65,12,103591.26999999999,89044.09
17735,U43001,77,1691.6500000000015,54,23,146454.1,148145.75
17736,U43297,77,-1413.4799999999998,65,12,23335.879999999997,21922.399999999998
17737,U23100,77,12894.489999999998,61,16,16827.53,29722.019999999997
17738,U42342,77,4485.189999999994,63,14,15193.470000000008,19678.660000000003
17739,U41011,77,21252.830000000005,58,19,84515.16,105767.99
17740,U35782,77,-58908.84,46,31,256467.44000000003,197558.60000000003
17741,U16295,77,11093.269999999999,59,18,52367.61,63460.88
17742,U39298,77,228.01000000000005,69,8,4672.409999999999,4900.419999999999
17743,U31864,77,1174.9300000000012,50,27,39963.88,41138.81
17744,U37213,77,-66.60999999999993,70,7,2425.3399999999997,2358.7299999999996
17745,U24391,77,1062.309999999986,50,27,2163885.94,2164948.25
17746,U28720,77,3744.7899999998863,40,37,1945303.0,1949047.7899999998
17747,U24445,77,-1037.97,54,23,7792.64,6754.67
17748,U8770,77,782373.4000000001,51,26,119182.06999999999,901555.4700000001
17749,U41594,77,-2798.690000000004,68,9,46892.140000000014,44093.45000000001
17750,U32825,77,-6351.669999999999,74,3,9349.55,2997.88
17751,U43670,77,7658.620000000002,67,10,23387.62,31046.24
17752,U33235,77,-78.33999999999855,65,12,52241.82000000001,52163.48000000001
17753,U24243,77,383236.3800000001,56,21,1178788.7999999998,1562025.18
17754,U11929,76,-2546.44,65,11,6206.63,3660.19
17755,U31059,76,8902.760000000002,63,13,14544.720000000001,23447.480000000003
17756,U33917,76,-9463.409999999998,48,28,24887.540000000005,15424.130000000006
17757,U42064,76,-15.580000000004247,48,28,62986.03,62970.45
17758,U24017,76,-107049.45999999999,66,10,185625.81,78576.35
17759,U9390,76,348836.94,52,24,207544.14000000004,556381.0800000001
17760,U16864,76,2822.3299999999804,51,25,417197.02,420019.35
17761,U12464,76,178460.91,66,10,125056.23999999999,303517.15
17762,U21479,76,-162119.36,44,32,763508.9299999999,601389.57
17763,U10416,76,-95504.74,38,38,311413.16,215908.41999999998
17764,U9803,76,370.1699999999837,43,33,290577.8,290947.97
17765,U11715,76,315.9500000000006,70,6,12136.510000000002,12452.460000000003
17766,U30173,76,-39130.85999999998,74,2,115132.24999999999,76001.39000000001
17767,U1144597,76,-2012.99,56,20,12619.949999999999,10606.96
17768,U27412,76,-16496.799999999996,65,11,49305.77,32808.97
17769,U36773,76,3775.220000000001,57,19,181864.69999999995,185639.91999999995
17770,U35596,76,5112.649999999997,74,2,3889.0800000000027,9001.73
17771,U16709,76,-266408.65,47,29,965346.4199999999,698937.7699999999
17772,U8316,76,18843.540000000037,35,41,1291587.49,1310431.03
17773,U40360,76,-23679.47,64,12,33088.05,9408.580000000002
17774,U15514,76,5357.390000000033,59,17,1058745.8299999998,1064103.22
17775,U16332,76,-6560002.74,64,12,6606887.1,46884.359999999404
17776,U19485,76,66190.84999999999,44,32,55772.49000000001,121963.34
17777,U892416,76,0.16000000000030923,57,19,16659.05,16659.21
17778,U14732,76,41962.840000000004,66,10,56487.759999999995,98450.6
17779,U16475,76,2412.1899999999882,61,15,1312779.9199999997,1315192.1099999996
17780,U1158805,76,-35739.92,67,9,58939.37,23199.450000000004
17781,U22584,76,-1424.4000000000124,31,45,426950.48000000004,425526.08
17782,U10570,76,210.53999999998575,41,35,332453.73,332664.26999999996
17783,U36125,76,-17116.69,64,12,37582.51,20465.820000000003
17784,U1308350,76,-6860.620000000001,40,36,58538.97999999999,51678.359999999986
17785,U29468,76,34245.73000000001,46,30,145876.30000000002,180122.03000000003
17786,U33083,76,-1282.8000000000002,39,37,130987.97000000002,129705.17000000001
17787,U9695,76,8554.409999999996,52,24,202513.68999999997,211068.09999999998
17788,U37889,76,-30511.410000000054,39,37,1650483.99,1619972.5799999998
17789,U37770,76,3324.460000000001,63,13,51021.020000000004,54345.48
17790,U1163964,76,87.42000000000007,42,34,12211.879999999997,12299.299999999997
17791,U26293,76,-136.24999999999977,67,9,15492.24,15355.99
17792,U14716,76,-307370.51999999996,53,23,649193.3099999999,341822.79
17793,U35768,76,-4532.339999999997,64,12,195618.05,191085.71
17794,U38317,76,29310.909999999996,66,10,65348.76,94659.67
17795,U29804,76,-1974.3999999999996,47,29,256586.48,254612.08000000002
17796,U18362,76,-16666.35000000002,58,18,830748.4600000001,814082.1100000001
17797,U41962,76,-9768.470000000001,67,9,52616.59,42848.119999999995
17798,U33987,76,85.5799999999976,64,12,17930.3,18015.879999999997
17799,U39694,76,-1807.7699999999968,51,25,244300.21000000002,242492.44000000003
17800,U43831,76,490735.37000000005,46,30,48855.01000000001,539590.3800000001
17801,U38599,76,-33171.96000000001,60,16,78199.14,45027.17999999999
17802,U34019,76,38385.26000000001,55,21,1102537.6099999999,1140922.8699999999
17803,U29368,76,4532.620000000006,49,27,202793.01,207325.63
17804,U1317204,76,-3811.76,58,18,9189.320000000002,5377.560000000001
17805,U12950,76,-7552.780000000029,62,14,190455.28,182902.49999999997
17806,U42408,76,-7982.27,70,6,9029.529999999999,1047.2599999999984
17807,U28979,76,13586.750000000022,43,33,128477.23,142063.98
17808,U27736,76,12912.199999999997,51,25,120193.76,133105.96
17809,U30543,76,622.7799999999993,68,8,15478.83,16101.609999999999
17810,U26104,76,30903.53,54,22,608858.5,639762.03
17811,U20469,76,884.3100000000013,71,5,60507.630000000005,61391.94
17812,U43008,76,-60697.20000000001,69,7,84235.13,23537.929999999993
17813,U10366,76,381021.4400000009,38,38,19691574.14,20072595.580000002
17814,U26260,76,-3755.9399999999982,70,6,16026.390000000001,12270.450000000003
17815,U38678,76,-242115.61999999997,57,19,630894.4999999998,388778.8799999998
17816,U17715,76,-36081.82,68,8,128031.62,91949.79999999999
17817,U41146,76,20519.520000000008,57,19,139101.12000000002,159620.64000000004
17818,U41466,76,-5869.750000000015,56,20,298316.39999999997,292446.64999999997
17819,U17931,76,-127688.74,66,10,161293.50999999998,33604.769999999975
17820,U29806,76,26058.999999999985,57,19,176303.41999999998,202362.41999999998
17821,U10940,76,-0.5699999999989132,60,16,57189.56999999999,57188.99999999999
17822,U963419,76,-1751.7000000000003,61,15,9807.519999999999,8055.819999999998
17823,U23891,76,-28372.229999999938,56,20,5092138.999999999,5063766.77
17824,U9403,76,55558.69999999998,54,22,133230.97,188789.66999999998
17825,U24963,76,-47589.62,50,26,770737.01,723147.39
17826,U17945,76,10014.400000000001,59,17,46972.04,56986.44
17827,U38489,76,5997.130000000001,50,26,89465.25,95462.38
17828,U42589,76,6565.020000000002,68,8,87079.61000000002,93644.63000000002
17829,U694456,76,-17905.72,66,10,34577.880000000005,16672.160000000003
17830,U40433,76,-13613.360000000017,50,26,285462.4299999999,271849.06999999983
17831,U21228,76,0.3099999999103602,38,38,2300959.7,2300960.0100000002
17832,U21287,76,-1315833.38,65,11,1794434.2,478600.82000000007
17833,U21453,76,-9680.949999999997,69,7,16113.919999999998,6432.970000000001
17834,U30220,76,-2035.659999999998,71,5,4328.749999999999,2293.090000000001
17835,U28576,76,1470.4399999999994,69,7,17488.12,18958.559999999998
17836,U41374,76,-1415703.69,69,7,1615747.69,200044.0
17837,U13845,76,-156517.03,52,24,563249.5800000001,406732.55000000005
17838,U34885,76,-22183.68,65,11,246023.75,223840.07
17839,U13298,76,74400.23000000007,36,40,1274134.44,1348534.67
17840,U9080,76,-3761.7399999999916,66,10,30993.499999999996,27231.760000000006
17841,U25772,76,-2514.780000000006,51,25,141519.21,139004.43
17842,U36414,76,47476.28999999999,63,13,108282.03999999998,155758.32999999996
17843,U15616,76,513464.72000000015,38,38,3563612.22,4077076.9400000004
17844,U20347,76,-346.4500000000012,58,18,37900.950000000004,37554.5
17845,U24896,76,-403.9800000000004,65,11,15680.649999999998,15276.669999999998
17846,U18832,76,-5248.090000000002,55,21,82260.49,77012.40000000001
17847,U29654,76,-56822.14999999997,50,26,539270.9799999997,482448.8299999998
17848,U35668,76,51964.81,40,36,277980.27999999997,329945.08999999997
17849,U24660,76,-107.7099999999992,70,6,14557.93,14450.220000000001
17850,U35704,76,-821.2599999999984,48,28,193612.90999999997,192791.64999999997
17851,U40892,76,133201.25,32,44,205581.13,338782.38
17852,U29530,76,-62087.15000000002,61,15,238740.43,176653.27999999997
17853,U14015,76,-1531.919999999932,56,20,883517.5300000004,881985.6100000005
17854,U43642,76,4133.68,67,9,11981.169999999998,16114.849999999999
17855,U28694,76,3445.7400000000016,65,11,39608.020000000004,43053.76000000001
17856,U27216,76,231.8400000000006,72,4,19366.909999999996,19598.749999999996
17857,U1315261,76,-3945.500000000011,42,34,277821.72,273876.22
17858,U42455,76,795.8299999999987,63,13,15178.730000000001,15974.56
17859,U25132,76,17842.36,60,16,25073.57,42915.93
17860,U20502,76,-15875.960000000006,58,18,90458.95,74582.98999999999
17861,U15501,76,17688.690000000024,41,35,680324.87,698013.56
17862,U15450,76,46852.23,55,21,26534.739999999994,73386.97
17863,U8901,76,43589.85999999999,45,31,1662240.5,1705830.36
17864,U32128,76,10737.300000000007,44,32,145530.33999999997,156267.63999999998
17865,U626186,76,-10340.380000000006,63,13,57619.7,47279.31999999999
17866,U8295,76,2344.749999999999,66,10,13917.36,16262.11
17867,U12503,76,1971.7900000000013,70,6,32442.829999999998,34414.62
17868,U43181,76,-30381.990000000005,59,17,121567.72000000002,91185.73000000001
17869,U17961,76,414.6700000000015,64,12,29520.410000000003,29935.080000000005
17870,U23657,76,10728.100000000117,35,41,834673.78,845401.8800000001
17871,U41229,76,-186661.76999999993,61,15,390593.9700000001,203932.20000000016
17872,U39851,76,518054.89,38,38,797365.26,1315420.15
17873,U34370,76,1524.72,68,8,7651.580000000002,9176.300000000001
17874,U33597,76,6856.1900000000005,50,26,65956.68,72812.87
17875,U26407,76,-114034.10999999999,60,16,534333.1599999999,420299.04999999993
17876,U16967,76,519842.79,65,11,580792.4099999996,1100635.1999999995
17877,U27958,76,-90143.08000000002,55,21,211929.59,121786.50999999998
17878,U23823,76,210409.92,49,27,248313.90000000002,458723.82000000007
17879,U39215,76,-1395.2200000000066,45,31,693437.04,692041.8200000001
17880,U32204,76,975976.8699999999,21,55,1702972.98,2678949.8499999996
17881,U12006,76,14466.380000000026,59,17,525793.4400000004,540259.8200000004
17882,U16361,76,-5349.579999999991,42,34,599246.06,593896.4800000001
17883,U28643,76,-21179.37999999996,35,41,735680.4400000001,714501.06
17884,U13819,76,-21029.609999999986,46,30,662109.6900000001,641080.0800000001
17885,U37600,76,29323.299999999996,32,44,153220.58000000002,182543.88
17886,U1115120,76,-1467.5499999999997,54,22,22359.999999999996,20892.449999999997
17887,U15196,76,-22773.619999999995,61,15,713996.15,691222.53
17888,U20922,76,9268.800000000001,38,38,469235.23999999993,478504.0399999999
17889,U22299,76,2728.999999999998,57,19,46208.37000000001,48937.37000000001
17890,U8775,76,-7314.600000000005,48,28,171262.97999999998,163948.37999999998
17891,U33815,76,8356.1,62,14,25130.820000000003,33486.920000000006
17892,U42108,76,-71953.19000000002,53,23,2373714.8099999996,2301761.6199999996
17893,U19635,76,-57142.05,69,7,97260.31000000001,40118.26000000001
17894,U18610,76,-211012.63999999998,42,34,586353.0599999999,375340.4199999999
17895,U41572,76,14458.509999999998,63,13,28287.50000000001,42746.01000000001
17896,U18155,76,1175.6199999999947,63,13,36811.80000000001,37987.420000000006
17897,U29070,76,-599.2300000000032,56,20,179295.38,178696.15
17898,U38100,76,-4158.230000000001,62,14,83160.12,79001.89
17899,U16179,76,-11951.8,56,20,193703.96000000002,181752.16000000003
17900,U18237,76,88247.79000000002,23,53,144003.79,232251.58000000002
17901,U21504,76,8014.5400000000545,32,44,982211.5599999999,990226.1
17902,U18748,76,2592.319999999989,41,35,643414.8,646007.12
17903,U22953,76,1850.8299999999995,47,29,667514.3300000001,669365.16
17904,U29561,76,-262204.32999999996,60,16,401548.54,139344.21000000002
17905,U11939,76,-6825.059999999998,40,36,684529.0,677703.94
17906,U37251,76,391.7499999999996,64,12,11479.349999999999,11871.099999999999
17907,U38086,76,-45936.18999999997,52,24,434022.26000000007,388086.07000000007
17908,U36337,76,3311.429999999993,68,8,138515.84999999998,141827.27999999997
17909,U34122,76,-6813.809999999999,47,29,290760.81999999995,283947.00999999995
17910,U20604,76,917.989999999998,44,32,243120.45,244038.44
17911,U24597,76,-29555.09,45,31,122306.73000000001,92751.64000000001
17912,U958007,75,-3705.4300000000007,56,19,17706.890000000003,14001.460000000003
17913,U708944,75,507.15000000000055,44,31,17536.42,18043.57
17914,U25472,75,-37146.31000000001,55,20,118369.45999999999,81223.14999999998
17915,U8403,75,-29693.849999999977,61,14,491727.56000000006,462033.7100000001
17916,U40432,75,152909.78000000012,61,14,2415739.920000002,2568649.700000002
17917,U14720,75,366626.88,64,11,125290.67999999998,491917.56
17918,U35834,75,-2715.7100000000005,63,12,14387.61,11671.9
17919,U26471,75,-11876.75,64,11,62342.69999999999,50465.94999999999
17920,U40712,75,-73161.76000000001,65,10,91685.15,18523.389999999985
17921,U11107,75,20933.210000000006,52,23,85554.40999999999,106487.62
17922,U37984,75,30191.759999999984,51,24,160053.64,190245.4
17923,U19258,75,5608.789999999979,36,39,515093.8,520702.58999999997
17924,U37724,75,11090.59,68,7,20723.29,31813.88
17925,U12969,75,-5751.360000000001,69,6,14822.419999999998,9071.059999999998
17926,U41748,75,-2028.3300000000042,59,16,284109.5799999999,282081.2499999999
17927,U41900,75,-1568.3300000000002,55,20,49246.59000000002,47678.26000000002
17928,U33445,75,-28373.82,59,16,61919.67999999999,33545.85999999999
17929,U40319,75,-116.13000000000277,65,10,61566.520000000004,61450.39
17930,U13245,75,7073.679999999999,63,12,105452.46,112526.14
17931,U35123,75,513.6899999999989,67,8,10824.55,11338.239999999998
17932,U19482,75,-71591.62,61,14,166534.1,94942.48000000001
17933,U22068,75,-140997.05000000002,51,24,605322.4699999999,464325.4199999998
17934,U14012,75,6831.530000000006,65,10,213661.79999999996,220493.32999999996
17935,U18739,75,2107.589999999981,29,46,613099.94,615207.5299999999
17936,U19500,75,-7641.670000000008,38,37,661187.96,653546.2899999999
17937,U19511,75,-561.2599999999993,43,32,40862.09,40300.829999999994
17938,U17759,75,-184.00000000001165,61,14,141241.31,141057.31
17939,U19049,75,136998.06999999998,49,26,1036072.65,1173070.72
17940,U36114,75,-30938.42000000001,63,12,190992.2,160053.78
17941,U12898,75,-121289.06000000001,64,11,162969.9,41680.83999999998
17942,U1092370,75,-1748.6200000000003,50,25,23275.300000000007,21526.680000000008
17943,U40053,75,-36865.40999999998,65,10,124301.72,87436.31000000003
17944,U40014,75,-12932.090000000013,51,24,180592.94000000006,167660.85000000003
17945,U23878,75,46268.24,35,40,212629.2,258897.44
17946,U25313,75,-10119.489999999998,59,16,95310.23000000001,85190.74000000002
17947,U1344923,75,-9010.320000000002,41,34,53983.18,44972.86
17948,U36268,75,15255.78999999999,55,20,77644.77,92900.56
17949,U13545,75,3159.4000000000005,63,12,15171.289999999999,18330.69
17950,U42520,75,-49585.49999999999,62,13,63926.829999999994,14341.330000000002
17951,U40460,75,2165.290000000007,61,14,97906.31999999996,100071.60999999997
17952,U23316,75,55273.95999999998,63,12,84135.53000000001,139409.49
17953,U25862,75,-173517.59,67,8,233365.68,59848.09
17954,U26105,75,-3893.1,54,21,24664.789999999997,20771.69
17955,U36657,75,5517.629999999999,39,36,234831.85,240349.48
17956,U37574,75,2858.42,53,22,18275.940000000002,21134.36
17957,U15813,75,42458.72,36,39,51608.39,94067.11
17958,U35827,75,12763.16,53,22,173128.30000000008,185891.46000000008
17959,U22508,75,2588.539999999999,61,14,12169.409999999996,14757.949999999995
17960,U36261,75,8366.67,70,5,10733.56,19100.23
17961,U22329,75,36117.47999999998,51,24,246342.85,282460.32999999996
17962,U31227,75,-1888.1100000000024,37,38,235091.89000000004,233203.78000000003
17963,U33228,75,1279.3500000000004,59,16,21007.9,22287.25
17964,U41461,75,6571.86,67,8,112600.29000000001,119172.15000000001
17965,U22545,75,-25088.17,58,17,56755.73999999999,31667.569999999992
17966,U36231,75,18301.07000000001,53,22,1045033.69,1063334.76
17967,U25891,75,308.6400000000168,8,67,112520.84,112829.48000000001
17968,U19277,75,38.47999999999912,33,42,311665.02999999997,311703.50999999995
17969,U31163,75,3501.610000000004,40,35,86622.04000000001,90123.65000000001
17970,U15355,75,-14274.670000000011,67,8,58765.560000000005,44490.88999999999
17971,U26551,75,31160.9,44,31,74429.59999999998,105590.49999999997
17972,U35733,75,341136.05,61,14,617170.3799999999,958306.4299999999
17973,U19673,75,-61789.169999999984,45,30,373551.77,311762.60000000003
17974,U41448,75,368.6000000000058,54,21,286145.91000000003,286514.51
17975,U17599,75,16665.219999999998,56,19,83797.86000000002,100463.08000000002
17976,U40255,75,-9197.389999999998,65,10,30437.71,21240.32
17977,U33342,75,-25977.540000000008,58,17,265601.04,239623.49999999997
17978,U20760,75,561.9999999999985,69,6,11837.689999999999,12399.689999999997
17979,U16259,75,34804.13000000002,54,21,175393.44999999998,210197.58000000002
17980,U33570,75,12812.650000000023,64,11,439162.91000000003,451975.56000000006
17981,U23710,75,-158.0699999999962,54,21,43022.59000000001,42864.52000000001
17982,U1246797,75,-4610.96,49,26,11001.349999999999,6390.3899999999985
17983,U33045,75,-1963.3500000000001,71,4,5314.81,3351.46
17984,U19787,75,-14672.970000000014,42,33,620762.7300000001,606089.7600000001
17985,U31849,75,-31955.430000000004,59,16,186161.16999999995,154205.73999999996
17986,U21413,75,5410.080000000001,68,7,9104.32,14514.400000000001
17987,U11071,75,3826.2200000000103,53,22,177531.93000000002,181358.15000000002
17988,U15712,75,-138375.57999999993,48,27,506326.7900000001,367951.2100000002
17989,U14108,75,648.2599999999957,41,34,28717.55,29365.809999999994
17990,U22888,75,-64628.819999999934,41,34,369926.33,305297.51000000007
17991,U42355,75,-1494.840000000001,52,23,23893.180000000004,22398.340000000004
17992,U8366,75,8217.079999999973,58,17,396664.16,404881.23999999993
17993,U13503,75,-403.6799999999996,54,21,40993.85,40590.17
17994,U39438,75,-51113.50000000001,64,11,61490.46000000001,10376.96
17995,U40832,75,70031.1,65,10,186615.43999999994,256646.53999999995
17996,U10132,75,-1611.960000000001,68,7,17394.780000000002,15782.820000000002
17997,U41160,75,-38466.56,69,6,98462.26000000001,59995.70000000001
17998,U39233,75,-0.28000000000065484,59,16,30015.74,30015.46
17999,U43055,75,1931.9299999999998,69,6,5809.5199999999995,7741.449999999999
18000,U43806,75,-15506.77,62,13,76349.08,60842.31
18001,U15568,75,2036.8500000000029,57,18,58902.46,60939.310000000005
18002,U32522,75,-1082.7399999999998,50,25,159316.57000000004,158233.83000000005
18003,U10400,75,-110.39000000001397,47,28,556126.84,556016.45
18004,U36966,75,-2707.47,62,13,53927.399999999994,51219.92999999999
18005,U625389,75,-2212.309999999999,48,27,53183.560000000005,50971.25000000001
18006,U21797,75,-41534.69000000001,60,15,197647.30000000002,156112.61000000002
18007,U29645,75,849.6000000000058,47,28,305960.11,306809.70999999996
18008,U43741,75,6681.130000000005,49,26,524879.79,531560.92
18009,U28160,75,2943.960000000003,39,36,332495.87,335439.83
18010,U23971,75,425.2400000000248,58,17,158304.23000000016,158729.47000000018
18011,U20658,75,39723.240000000005,59,16,90151.37999999999,129874.62
18012,U43002,75,3121.109999999996,67,8,34392.61,37513.719999999994
18013,U37222,75,5033.319999999994,62,13,113841.17999999996,118874.49999999996
18014,U34524,75,2616.9200000000133,52,23,234267.73,236884.65000000002
18015,U39983,75,14864.469999999987,52,23,117305.58,132170.05
18016,U11541,75,17121.609999999997,55,20,59208.13999999999,76329.74999999999
18017,U32376,75,-1836.6699999999837,57,18,488110.72000000003,486274.05000000005
18018,U34023,75,724.4999999999991,62,13,60553.64,61278.14
18019,U27733,75,36690.04000000001,54,21,75572.87999999999,112262.92
18020,U772432,75,806.9999999999998,58,17,10364.79,11171.79
18021,U30223,75,-41827.429999999986,47,28,944113.51,902286.0800000001
18022,U23405,75,-9338.409999999993,55,20,88747.44000000002,79409.03000000003
18023,U36600,75,-100418.20000000001,66,9,362112.01,261693.81
18024,U1094437,75,-3162.809999999999,68,7,9771.25,6608.4400000000005
18025,U10512,75,475798.8100000003,54,21,1085322.7900000003,1561121.6000000006
18026,U18546,75,34675.82,51,24,141637.49,176313.31
18027,U9132,75,6197.290000000001,58,17,31675.04,37872.33
18028,U25937,75,-18633.27,62,13,36486.32,17853.05
18029,U19289,75,-26326.260000000002,59,16,115047.66999999998,88721.40999999997
18030,U31745,75,1793.9800000000005,57,18,16259.91,18053.89
18031,U30056,75,-7621.5400000000045,65,10,48271.88,40650.34
18032,U35004,75,696.1399999999994,69,6,15445.09,16141.23
18033,U36105,75,-2961.9700000000003,65,10,41675.360000000015,38713.390000000014
18034,U13083,75,15639.169999999966,52,23,329156.48000000004,344795.65
18035,U14826,75,6538.019999999975,43,32,1410803.4200000002,1417341.4400000002
18036,U12745,75,11363.830000000002,50,25,249895.96999999997,261259.8
18037,U44018,75,21208.84999999999,54,21,124632.28000000001,145841.13
18038,U585008,75,-1403.5100000000002,44,31,21631.299999999996,20227.789999999994
18039,U39782,75,8940.03000000041,34,41,3393051.27,3401991.3000000003
18040,U16096,75,-201274.8,56,19,324593.41000000003,123318.61000000004
18041,U26393,75,13584.260000000015,50,25,73897.74000000002,87482.00000000003
18042,U1164695,75,-6729.970000000001,53,22,41997.18,35267.21
18043,U41172,75,-547.0699999999904,52,23,101496.20999999999,100949.14
18044,U19683,75,3457.270000000004,43,32,275640.08999999997,279097.36
18045,U20497,75,2469.9699999999984,64,11,16088.68,18558.649999999998
18046,U19839,75,18090.029999999995,50,25,106602.42000000001,124692.45000000001
18047,U9479,75,-23031.109999999986,56,19,1725017.52,1701986.4100000001
18048,U29091,75,85932.44,62,13,161269.2,247201.64
18049,U11111,75,-19857.63,67,8,77804.91,57947.28
18050,U43902,75,28420.420000000002,49,26,123459.45999999999,151879.88
18051,U10084,75,11046.45,59,16,44128.56,55175.009999999995
18052,U15289,75,-11274.12,63,12,79151.88,67877.76000000001
18053,U12395,75,1205.7699999999973,66,9,25299.699999999993,26505.46999999999
18054,U19202,75,1030747.1000000001,60,15,1118085.81,2148832.91
18055,U17155,75,36442.16000000009,46,29,539496.6799999999,575938.8400000001
18056,U15282,75,-392676.14999999997,65,10,457557.67,64881.52000000002
18057,U43067,75,-2270.7800000000016,59,16,104607.62000000001,102336.84000000001
18058,U1063625,75,-1386.4900000000002,72,3,1707.0600000000004,320.57000000000016
18059,U25295,75,-385137.58999999973,45,30,2276131.3499999996,1890993.7599999998
18060,U42224,75,169.6700000000008,65,10,21758.89,21928.56
18061,U27006,75,2635.4100000000008,59,16,62411.409999999996,65046.82
18062,U30859,75,-3490.3599999999983,57,18,11866.669999999996,8376.309999999998
18063,U28931,75,2792.6600000000035,55,20,60973.62000000001,63766.28000000001
18064,U31585,75,-123880.21999999999,58,17,482765.59,358885.37000000005
18065,U42883,75,-30480.60000000001,70,5,49769.29000000001,19288.69
18066,U1330849,75,-12372.730000000007,48,27,122004.15,109631.41999999998
18067,U13810,75,-31497.530000000035,49,26,140478.68999999997,108981.15999999995
18068,U24374,75,-93707.33999999997,41,34,1977837.11,1884129.77
18069,U36873,75,21694.650000000005,50,25,403877.96,425572.61000000004
18070,U22556,75,14199.110000000002,65,10,19395.89,33595.0
18071,U32397,75,-10552.07,72,3,12868.93,2316.8600000000006
18072,U11161,75,197.92999999998995,33,42,72112.18000000001,72310.11
18073,U13758,75,7716.289999999994,50,25,277706.33,285422.62
18074,U36977,75,-7106.77,68,7,16971.759999999995,9864.989999999994
18075,U604432,74,-2690.71,48,26,25563.340000000007,22872.63000000001
18076,U29845,74,1652.889999999999,44,30,44217.759999999995,45870.649999999994
18077,U24437,74,-227180.40000000002,61,13,531747.4600000001,304567.06000000006
18078,U42896,74,1270.5200000000004,59,15,20945.16,22215.68
18079,U751750,74,435.3899999999997,38,36,78659.09,79094.48
18080,U27403,74,7018.259999999992,58,16,52124.289999999986,59142.54999999998
18081,U29658,74,-435366.8999999999,41,33,1105594.8399999999,670227.94
18082,U29119,74,104094.00999999998,62,12,120100.01000000002,224194.02000000002
18083,U26789,74,-7225.960000000003,58,16,125252.29000000001,118026.33
18084,U40901,74,-406458.93999999994,63,11,508660.0,102201.06000000006
18085,U38099,74,1153.8600000000006,64,10,54681.79000000001,55835.65000000001
18086,U12971,74,-43714.47999999998,47,27,452957.59,409243.11000000004
18087,U25585,74,-190.43000000000086,64,10,10717.72,10527.289999999999
18088,U32308,74,-1795.809999999999,61,13,3032.4300000000007,1236.6200000000017
18089,U15442,74,18133.26000000001,61,13,103620.93000000001,121754.19000000002
18090,U13783,74,-157828.89999999997,48,26,237346.72,79517.82000000004
18091,U35432,74,-43.689999999999934,66,8,2618.3900000000003,2574.7000000000003
18092,U9921,74,14632.849999999993,59,15,101823.35000000002,116456.20000000001
18093,U27360,74,2212.8800000000006,54,20,29231.930000000004,31444.810000000005
18094,U34026,74,152.8699999999999,64,10,5870.129999999998,6022.999999999998
18095,U36910,74,-12905.779999999975,68,6,651035.3700000001,638129.5900000001
18096,U30067,74,-13889.220000000008,46,28,231716.65999999997,217827.43999999997
18097,U29639,74,-4543.09,67,7,7695.249999999999,3152.159999999999
18098,U41314,74,-344.53000000002794,42,32,929656.45,929311.9199999999
18099,U22613,74,-28249.48,45,29,551316.8699999999,523067.3899999999
18100,U14969,74,-5733.220000000003,46,28,193304.06,187570.84
18101,U1155441,74,-906.5700000000002,55,19,17829.850000000006,16923.280000000006
18102,U42344,74,-1181.929999999993,50,24,688146.12,686964.19
18103,U11797,74,-21192.480000000003,57,17,57601.820000000014,36409.34000000001
18104,U38622,74,11334.679999999998,55,19,168506.37,179841.05
18105,U37209,74,-18130.60000000006,56,18,366028.50000000006,347897.9
18106,U8175,74,3139.6000000000004,67,7,18962.730000000003,22102.33
18107,U28779,74,-19288.299999999996,53,21,140812.56,121524.26000000001
18108,U13622,74,-1262110.5699999998,57,17,1531473.5499999998,269362.98
18109,U40726,74,364.02999999999065,49,25,71588.37999999999,71952.40999999997
18110,U16704,74,-4797.480000000004,54,20,87628.42999999998,82830.94999999997
18111,U35095,74,2670.6799999999766,42,32,476911.47,479582.14999999997
18112,U26596,74,-74.17999999999984,57,17,17141.600000000002,17067.420000000002
18113,U25445,74,-1427.289999999999,67,7,27946.440000000002,26519.15
18114,U34765,74,-27978.24,50,24,270231.87,242253.63
18115,U28189,74,-817.5900000000006,68,6,2883.2500000000005,2065.66
18116,U20762,74,12739.050000000003,53,21,64085.68,76824.73000000001
18117,U13330,74,3623.980000000001,67,7,1954.7399999999989,5578.719999999999
18118,U35296,74,-31581.910000000007,69,5,57967.17000000001,26385.260000000006
18119,U32699,74,6312.83,60,14,20870.81,27183.64
18120,U35847,74,165000.39999999997,54,20,55289.23000000001,220289.62999999998
18121,U14101,74,-4425.58999999998,38,36,554914.7200000001,550489.1300000001
18122,U19479,74,6845.950000000002,70,4,5408.36,12254.310000000001
18123,U35771,74,-4094.5599999999995,68,6,7595.169999999999,3500.6099999999997
18124,U42163,74,1749.8099999999986,65,9,83320.18999999999,85069.99999999999
18125,U31467,74,-671.8399999999996,71,3,5077.21,4405.370000000001
18126,U31566,74,48837.87999999999,57,17,276729.12000000005,325567.00000000006
18127,U8636,74,1411.0000000000002,43,31,9582.91,10993.91
18128,U15960,74,17818.920000000002,61,13,65675.17000000001,83494.09000000001
18129,U12851,74,-316580.49999999994,63,11,737483.7799999999,420903.27999999997
18130,U11818,74,4540.5199999999995,54,20,96956.42999999998,101496.94999999998
18131,U12744,74,-9121.74,48,26,59715.74999999999,50594.009999999995
18132,U40629,74,-20396.179999999993,56,18,91580.77999999998,71184.59999999999
18133,U20396,74,-65801.9,62,12,159335.90999999997,93534.00999999998
18134,U26050,74,14957.080000000002,55,19,34754.77,49711.85
18135,U19365,74,14924.949999999997,46,28,229938.18,244863.13
18136,U27422,74,7532.880000000005,67,7,24348.52,31881.400000000005
18137,U8103,74,-2184.6199999999926,47,27,452917.32999999996,450732.70999999996
18138,U8512,74,-293.16999999999894,47,27,18713.030000000002,18419.860000000004
18139,U14072,74,2888.389999999991,47,27,180558.13,183446.52
18140,U9261,74,-26540.26999999998,63,11,131862.06000000006,105321.79000000008
18141,U40300,74,17430.64,51,23,71388.62,88819.26
18142,U39890,74,28072.539999999964,43,31,231878.80000000002,259951.33999999997
18143,U27845,74,-200852.1200000001,53,21,2210923.36,2010071.2399999998
18144,U39417,74,-204087.2200000001,59,15,762462.3200000001,558375.1
18145,U41257,74,-7718.999999999999,63,11,28874.11,21155.11
18146,U25808,74,-6564.650000000001,69,5,13584.269999999999,7019.619999999998
18147,U32072,74,-1606.590000000002,42,32,247950.32,246343.73
18148,U27669,74,567.8500000000099,46,28,129168.65999999999,129736.51
18149,U23323,74,-5790.089999999966,62,12,672964.62,667174.53
18150,U40002,74,5983.280000000001,68,6,6721.6900000000005,12704.970000000001
18151,U28133,74,-3794.370000000002,62,12,36801.00000000002,33006.63000000002
18152,U10349,74,-5560.070000000003,47,27,57104.42999999999,51544.359999999986
18153,U14583,74,-19796.680000000022,40,34,185362.78,165566.09999999998
18154,U710069,74,-10.25000000000091,56,18,7600.900000000001,7590.65
18155,U30884,74,-9376.349999999997,67,7,51632.73,42256.380000000005
18156,U21601,74,-321.9999999999994,70,4,8457.789999999999,8135.79
18157,U8117,74,118542.75,58,16,356945.26000000007,475488.01000000007
18158,U33953,74,-3272.5400000000045,50,24,61370.24,58097.7
18159,U856244,74,-3721.6600000000035,60,14,35703.89,31982.229999999996
18160,U43147,74,23187.550000000007,63,11,30397.270000000008,53584.820000000014
18161,U18692,74,9055.279999999999,62,12,30586.409999999993,39641.68999999999
18162,U43126,74,2781.750000000016,56,18,192773.47,195555.22000000003
18163,U38470,74,-1601.1099999999894,42,32,122640.08000000003,121038.97000000004
18164,U39845,74,15842.850000000002,44,30,167030.27,182873.12
18165,U39214,74,14036.420000000002,58,16,17468.1,31504.52
18166,U41955,74,-10873.52999999999,54,20,126170.21999999994,115296.68999999996
18167,U40743,74,-21227.210000000003,59,15,65775.85,44548.64
18168,U24754,74,10202.839999999997,42,32,454613.57,464816.41000000003
18169,U11436,74,-2935.5000000000005,62,12,18201.120000000003,15265.620000000003
18170,U24476,74,-5409.48999999999,48,26,370469.33999999997,365059.85
18171,U15762,74,-7958.73,62,12,14029.159999999996,6070.429999999997
18172,U36722,74,-2290.330000000001,57,17,49933.19,47642.86
18173,U11499,74,-681.6800000000014,70,4,10685.9,10004.219999999998
18174,U34768,74,3.5499999999998977,57,17,6983.04,6986.59
18175,U35166,74,-3627.560000000005,55,19,243779.5,240151.94
18176,U29732,74,2777.7099999999996,67,7,19000.000000000007,21777.710000000006
18177,U32624,74,1860.5499999999956,64,10,57214.55,59075.1
18178,U26977,74,475365.66000000003,56,18,484863.17999999993,960228.84
18179,U35853,74,23459.880000000005,44,30,502855.48000000004,526315.3600000001
18180,U16626,74,12337.53,60,14,21924.74,34262.270000000004
18181,U42764,74,-10493.409999999943,56,18,407618.9200000001,397125.5100000002
18182,U37070,74,21403.82999999999,58,16,238022.32000000004,259426.15000000002
18183,U26608,74,27339.709999999995,48,26,35322.840000000004,62662.55
18184,U897533,74,0.27000000000043656,56,18,41588.799999999996,41589.06999999999
18185,U1030040,74,-355.5000000000002,53,21,2557.58,2202.08
18186,U37886,74,-8394.19,27,47,300727.1,292332.91
18187,U26975,74,-795.6999999999953,64,10,24105.539999999997,23309.840000000004
18188,U33975,74,5873.699999999999,64,10,42599.77,48473.469999999994
18189,U23585,74,10707.149999999987,53,21,205736.96000000008,216444.11000000007
18190,U21835,74,-75.48000000000566,44,30,96597.16999999997,96521.68999999996
18191,U41534,74,3830.3399999999983,66,8,15851.230000000003,19681.57
18192,U8912,74,-1292.289999999968,62,12,177895.13999999998,176602.85
18193,U24426,74,-14025.110000000002,50,24,38862.16999999999,24837.05999999999
18194,U749668,74,359.52999999999884,49,25,78821.95000000001,79181.48000000001
18195,U28177,74,-565291.9099999999,53,21,1228522.1600000001,663230.2500000002
18196,U31488,74,108628.94000000002,61,13,904247.5200000001,1012876.4600000002
18197,U12350,74,565.400000000004,52,22,38668.75000000001,39234.15000000001
18198,U31694,74,-39482.67,63,11,77934.59000000001,38451.92000000001
18199,U843624,74,-23354.160000000003,64,10,27704.38,4350.2199999999975
18200,U27847,74,-566.7199999999975,43,31,412355.16,411788.44
18201,U34244,74,45779.29000000002,38,36,481547.7899999999,527327.08
18202,U11750,74,11337.599999999997,58,16,56243.340000000004,67580.94
18203,U29151,74,-11107.830000000005,51,23,693352.6800000002,682244.8500000002
18204,U21978,74,9779.979999999996,66,8,75708.79000000001,85488.77
18205,U16353,74,14381.169999999991,43,31,417140.42000000004,431521.59
18206,U13559,74,-379.48999999999796,49,25,98762.72,98383.23000000001
18207,U26234,74,43106.17999999999,63,11,52020.71000000002,95126.89000000001
18208,U17373,74,49037.530000000006,48,26,222734.51000000004,271772.04000000004
18209,U30565,74,16455.620000000006,58,16,12700.66,29156.280000000006
18210,U34811,74,-7333.710000000002,62,12,33425.42,26091.709999999995
18211,U902978,74,0.6600000000003661,39,35,6459.310000000001,6459.970000000002
18212,U14979,74,-989.7399999999907,38,36,526910.37,525920.63
18213,U15955,74,-141535.77000000002,64,10,403902.47,262366.69999999995
18214,U14444,74,-90523.2599999999,45,29,1000408.7699999999,909885.51
18215,U26170,74,8096.049999999997,57,17,15042.449999999992,23138.49999999999
18216,U9535,74,6072.17,48,26,147225.42000000004,153297.59000000005
18217,U1381419,74,-97173.74000000006,58,16,98237.10000000006,1063.3600000000006
18218,U17766,74,4352.499999999999,60,14,34839.11,39191.61
18219,U26852,74,-6962.590000000002,57,17,87161.04000000001,80198.45000000001
18220,U954583,74,-5290.179999999998,53,21,46827.32000000001,41537.14000000001
18221,U1325725,74,-7.359999999999545,42,32,9113.83,9106.470000000001
18222,U15055,74,-2216.37,44,30,30965.110000000004,28748.740000000005
18223,U37598,74,-3758.4299999999994,65,9,45717.82,41959.39
18224,U35255,74,-7170.009999999993,29,45,5711100.0,5703929.99
18225,U24049,74,-135384.15000000002,62,12,232864.27,97480.11999999997
18226,U36786,74,-2923.1000000000026,37,37,571683.96,568760.86
18227,U33751,74,3271.319999999999,62,12,14119.460000000001,17390.78
18228,U35798,74,-18133.359999999997,60,14,29281.469999999998,11148.11
18229,U10081,74,-3626.079999999998,49,25,142899.38,139273.30000000002
18230,U37652,74,1675.6199999999953,55,19,749047.77,750723.39
18231,U17026,74,-4047.069999999999,65,9,43360.58,39313.51
18232,U22691,74,9249.800000000001,59,15,67888.92,77138.72
18233,U19243,74,1067.8399999999983,54,20,107779.27999999998,108847.11999999998
18234,U21273,74,-193.76999999999862,50,24,30674.6,30480.83
18235,U19971,74,58314.659999999996,57,17,48601.020000000004,106915.68
18236,U19855,74,-2260.0699999999733,64,10,178383.55000000005,176123.48000000007
18237,U19744,74,-1194.8100000000004,49,25,53409.41,52214.600000000006
18238,U16186,74,39643.74999999994,40,34,421705.51000000007,461349.26
18239,U8156,74,-54754.25000000001,51,23,311211.06000000006,256456.81000000006
18240,U28243,74,2411.48,69,5,36190.02,38601.5
18241,U20235,74,-106344.33,64,10,145643.94999999998,39299.61999999998
18242,U40286,74,28883.370000000003,62,12,149180.91,178064.28
18243,U32307,74,-617.2299999999983,61,13,55598.130000000005,54980.90000000001
18244,U23732,74,-40580.78,66,8,80979.45000000004,40398.67000000004
18245,U24861,74,-10699.02,59,15,88969.26000000001,78270.24
18246,U42917,73,-4151.86,48,25,16281.83,12129.970000000001
18247,U8398,73,1872.3399999999695,40,33,551979.39,553851.73
18248,U31756,73,20958.12,46,27,279139.81000000006,300097.93000000005
18249,U593561,73,-2088.7099999999996,59,14,11834.75,9746.04
18250,U970660,73,2.960000000000008,40,33,1033.05,1036.01
18251,U12247,73,214303.35,50,23,1150347.96,1364651.31
18252,U16670,73,4357.320000000007,48,25,418386.63,422743.95
18253,U30537,73,138.73999999988882,40,33,655922.17,656060.9099999999
18254,U1178927,73,-7846.1799999999985,52,21,19050.18,11204.000000000002
18255,U15175,73,-2402.800000000003,55,18,75098.84,72696.04
18256,U42411,73,2036.7599999999331,48,25,1105214.59,1107251.35
18257,U38494,73,-17702.52,63,10,26938.159999999996,9235.639999999996
18258,U33883,73,-28159.830000000005,67,6,47191.17000000001,19031.340000000007
18259,U1318229,73,-1174.67,50,23,2934.68,1760.0099999999998
18260,U36157,73,-145089.43000000002,54,19,683749.7999999999,538660.3699999999
18261,U15331,73,9672.250000000015,48,25,239352.1,249024.35000000003
18262,U41721,73,30689.34999999999,57,16,99951.72000000002,130641.07
18263,U43229,73,-66100.39000000001,63,10,90997.76999999997,24897.37999999996
18264,U42606,73,9133.459999999997,54,19,82674.39,91807.84999999999
18265,U35330,73,187932.720000002,39,34,15662370.47,15850303.190000003
18266,U24595,73,4834.04999999998,44,29,334571.53,339405.58
18267,U35107,73,-3651.790000000001,59,14,35096.859999999986,31445.069999999985
18268,U1241409,73,-46.76999999999998,52,21,10406.199999999999,10359.429999999998
18269,U26242,73,-2407.1099999999715,55,18,225270.76,222863.65000000002
18270,U28038,73,151.9500000000495,51,22,252379.56000000003,252531.51000000007
18271,U17415,73,41201.44000000004,41,32,481496.9000000001,522698.34000000014
18272,U38923,73,16738.350000000006,41,32,808107.61,824845.96
18273,U34458,73,-2383.17000000003,59,14,286948.75,284565.57999999996
18274,U16138,73,-8848.039999999997,47,26,31563.400000000005,22715.360000000008
18275,U31913,73,-3057.429999999999,63,10,25660.0,22602.57
18276,U17462,73,28.649999999998023,67,6,9488.820000000003,9517.470000000001
18277,U21455,73,-87473.13000000005,49,24,203113.66999999995,115640.5399999999
18278,U29586,73,2880.3699999999953,49,24,3131263.44,3134143.81
18279,U25944,73,-8612.430000000006,54,19,497370.41,488757.98
18280,U12833,73,3369.3599999999997,59,14,30634.72,34004.08
18281,U22859,73,3603.169999999999,68,5,5450.0,9053.169999999998
18282,U38499,73,-47610.98000000002,62,11,161384.38,113773.4
18283,U26755,73,179664.37000000008,23,50,375564.29999999993,555228.67
18284,U23363,73,5702.0700000000015,63,10,17461.82,23163.89
18285,U16721,73,-9624.499999999998,60,13,67856.9,58232.399999999994
18286,U1219460,73,-2214.099999999999,54,19,46807.700000000004,44593.600000000006
18287,U36781,73,-55718.84000000001,55,18,608420.9699999999,552702.1299999999
18288,U42615,73,-7035.459999999999,59,14,103747.06,96711.6
18289,U31468,73,-47215.329999999994,57,16,185948.24,138732.91
18290,U15277,73,132775.03000000003,40,33,179945.72000000003,312720.75000000006
18291,U14856,73,-3360.7799999999993,63,10,14818.82,11458.04
18292,U28663,73,-2090.9200000000023,54,19,62810.81000000003,60719.89000000002
18293,U23527,73,25236.109999999997,59,14,99365.99,124602.1
18294,U14940,73,38963.11999999999,56,17,90426.04000000001,129389.16
18295,U13099,73,-44608.56,63,10,67558.41000000002,22949.85000000002
18296,U13362,73,-15553.260000000002,61,12,34744.47,19191.21
18297,U17690,73,6514.4400000000005,59,14,117530.74,124045.18000000001
18298,U36191,73,23550.700000000004,43,30,249220.33000000002,272771.03
18299,U42799,73,12556.559999999998,60,13,138217.17,150773.73
18300,U24269,73,-79765.2699999999,55,18,319970.57,240205.3000000001
18301,U12874,73,9028.500000000002,59,14,41172.06,50200.56
18302,U19344,73,79827.17000000001,58,15,184284.65,264111.82
18303,U38397,73,-150039.81000000014,55,18,2730038.27,2579998.46
18304,U32881,73,4473.179999999993,61,12,22935.97,27409.149999999994
18305,U26860,73,-26636.579999999998,58,15,60343.77999999999,33707.2
18306,U22743,73,595.310000000005,64,9,62506.78,63102.090000000004
18307,U23349,73,7022.909999999981,45,28,189603.44999999995,196626.35999999993
18308,U17235,73,35886.30999999998,47,26,193401.51999999996,229287.82999999996
18309,U32929,73,170.8399999999965,47,26,241420.80000000002,241591.64
18310,U9627,73,-12302.550000000643,58,15,3791546.68,3779244.1299999994
18311,U24587,73,-8240.970000000008,55,18,402919.45,394678.48
18312,U12433,73,25.57000000000022,45,28,32980.45,33006.02
18313,U24907,73,-4602.0300000000025,55,18,136063.34,131461.31
18314,U20503,73,-16886.759999999995,42,31,232756.45,215869.69
18315,U38198,73,1760.870000000007,67,6,24166.3,25927.170000000006
18316,U33949,73,260.2199999999992,60,13,12413.980000000001,12674.2
18317,U28902,73,2231.809999999998,54,19,88596.14000000001,90827.95000000001
18318,U28698,73,7380.239999999984,43,30,321312.63000000006,328692.87000000005
18319,U21235,73,14107.960000000005,45,28,83276.31999999999,97384.28
18320,U21519,73,3556.100000000035,55,18,5152926.82,5156482.92
18321,U38009,73,-1115.4699999999962,52,21,255723.19,254607.72
18322,U22350,73,54653.82,42,31,122613.6,177267.42
18323,U994012,73,1265.6900000000005,38,35,18672.47,19938.160000000003
18324,U30263,73,-57.88000000000284,42,31,385056.48,384998.6
18325,U19626,73,-7944.110000000002,55,18,94438.39,86494.28
18326,U40820,73,2647.8500000000063,63,10,49873.3,52521.15000000001
18327,U24842,73,-78994.62999999998,61,12,115437.84999999998,36443.22
18328,U30919,73,-5080.050000000013,53,20,270898.81,265818.76
18329,U12317,73,34569.119999999995,51,22,365582.5900000001,400151.7100000001
18330,U41939,73,-12204.23,63,10,50220.78,38016.55
18331,U31044,73,-996.1600000000027,42,31,75214.17999999998,74218.01999999997
18332,U31835,73,-3684.980000000002,58,15,13963.709999999995,10278.729999999994
18333,U8421,73,-6155.700000000006,62,11,76766.85999999999,70611.15999999997
18334,U15377,73,-28404.02,54,19,104142.76000000002,75738.74000000002
18335,U33716,73,-68359.85,54,19,184348.87,115989.01999999999
18336,U27530,73,-7991.459999999997,56,17,47798.020000000004,39806.560000000005
18337,U29155,73,-50800.56,42,31,164958.31999999998,114157.75999999998
18338,U40198,73,15150.010000000002,46,27,724483.26,739633.27
18339,U27349,73,1080.9600000000075,52,21,123946.16,125027.12000000001
18340,U9979,73,140844.71000000002,46,27,113277.38,254122.09000000003
18341,U17108,73,-104604.25999999998,59,14,3150021.2599999993,3045416.9999999995
18342,U20074,73,368.4200000000019,48,25,307975.79000000004,308344.21
18343,U34384,73,77293.59000000003,52,21,451098.25,528391.8400000001
18344,U8072,73,98.71999999999753,62,11,47503.810000000005,47602.53
18345,U24340,73,-145.88999999992666,47,26,749833.74,749687.8500000001
18346,U32842,73,1169.0400000000009,56,17,117651.09,118820.13
18347,U11119,73,-178066.11,34,39,621798.53,443732.42000000004
18348,U15478,73,88327.45,52,21,178545.16,266872.61
18349,U19399,73,-35662.90000000001,41,32,475232.6400000001,439569.74000000005
18350,U32410,73,-7583.700000000003,49,24,193645.66999999998,186061.96999999997
18351,U41746,73,-9373.86,65,8,50935.53,41561.67
18352,U32750,73,-11771.190000000002,49,24,316589.1399999999,304817.9499999999
18353,U39167,73,-67333.26,66,7,100243.47,32910.21000000001
18354,U38425,73,-4579.41,70,3,4866.580000000001,287.170000000001
18355,U38542,73,-45803.18000000001,54,19,332600.4,286797.22000000003
18356,U16028,73,-50496.59000000002,47,26,277332.02,226835.43
18357,U16058,73,-55513.69999999998,48,25,345890.75,290377.05000000005
18358,U1355321,73,-16761.079999999994,67,6,28301.149999999994,11540.07
18359,U8889,73,-203679.27000000002,60,13,1948719.21,1745039.94
18360,U21556,73,119.10999999999994,52,21,1718.26,1837.37
18361,U18533,73,-37439.76000000001,55,18,271005.36,233565.59999999998
18362,U32639,73,85787.77,60,13,279071.34,364859.11000000004
18363,U14694,73,6442.649999999996,44,29,217154.19999999995,223596.84999999995
18364,U29018,73,642.9299999999935,56,17,127922.93999999999,128565.86999999998
18365,U40741,73,-36972.420000000006,60,13,84321.20999999999,47348.789999999986
18366,U38416,73,-6991.52,59,14,34780.68,27789.16
18367,U14745,73,8549.109999999999,58,15,56399.44,64948.55
18368,U33766,73,-42072.6,68,5,57677.94999999999,15605.349999999991
18369,U10487,73,-52444.029999999984,53,20,818410.06,765966.03
18370,U16805,73,16925.709999999963,29,44,2170283.0,2187208.71
18371,U24637,73,-63996.30999999998,46,27,159671.97,95675.66000000002
18372,U1269947,73,-1633.9200000000003,60,13,9826.500000000002,8192.580000000002
18373,U41393,73,1326.949999999999,63,10,17972.35,19299.299999999996
18374,U34289,73,3428.3099999999868,63,10,595158.74,598587.0499999999
18375,U11145,73,-5906.4,66,7,19512.510000000002,13606.110000000002
18376,U25135,73,-29.090000000001737,59,14,51928.310000000005,51899.22
18377,U33565,73,-13834.72,68,5,27145.999999999996,13311.279999999997
18378,U26074,73,27604.360000000015,56,17,200982.03,228586.39
18379,U26315,73,-78939.82000000002,53,20,330639.05000000005,251699.23000000004
18380,U13706,73,-1168844.53,57,16,1343325.06,174480.53000000003
18381,U31781,73,47823.069999999985,59,14,164021.87,211844.93999999997
18382,U8858,73,10824.390000000007,51,22,320711.44999999995,331535.83999999997
18383,U28859,73,-694.4999999999728,47,26,404929.4199999999,404234.9199999999
18384,U28022,73,-422.8999999999996,69,4,12788.059999999996,12365.159999999996
18385,U1163499,73,3709.2100000000055,45,28,95519.37,99228.58
18386,U13742,73,-15859.050000000003,59,14,54198.939999999995,38339.88999999999
18387,U30510,73,-598.2999999999911,45,28,197514.51,196916.21000000002
18388,U25125,73,-29146.259999999995,49,24,846409.9,817263.64
18389,U35060,73,-7974.159999999994,61,12,136503.91999999998,128529.76
18390,U28611,73,-3839.8600000000006,70,3,6741.6100000000015,2901.750000000001
18391,U33992,73,-50206.23999999999,46,27,180656.99,130450.75
18392,U36889,73,10144.329999999998,36,37,80139.58,90283.91
18393,U42179,73,-17083.870000000003,59,14,49971.58,32887.71
18394,U37632,73,-1919.3100000000002,62,11,19297.79,17378.48
18395,U43404,73,25313.57,65,8,45616.899999999994,70930.47
18396,U21433,73,-16790.08,34,39,442504.88000000006,425714.80000000005
18397,U33461,73,1497.0599999999995,49,24,29009.780000000002,30506.840000000004
18398,U29082,73,3058.2000000000517,56,17,701864.22,704922.42
18399,U24807,73,7959.01,34,39,6312.35,14271.36
18400,U16183,73,33496.46999999999,52,21,166550.27000000002,200046.74
18401,U41920,73,3004.5299999999997,61,12,18064.359999999997,21068.889999999996
18402,U11116,73,33815.79999999999,45,28,215634.3,249450.09999999998
18403,U10916,73,-28038.959999999934,59,14,1087921.86,1059882.9000000001
18404,U24457,73,-7648.6,59,14,1185440.1300000004,1177791.5300000003
18405,U20830,73,46005.479999999996,47,26,63540.780000000006,109546.26000000001
18406,U24289,73,10912.790000000003,66,7,55628.47000000001,66541.26000000001
18407,U36476,73,-320.5200000000011,60,13,25391.82,25071.3
18408,U11176,73,-1527.180000000002,54,19,62455.969999999994,60928.78999999999
18409,U16248,73,70063.36000000002,58,15,246707.6899999999,316771.04999999993
18410,U26672,73,-4627.760000000003,54,19,74353.94999999998,69726.18999999997
18411,U43026,73,4646.899999999996,50,23,189143.0,193789.9
18412,U13106,73,-318.80999999999585,46,27,107296.95000000001,106978.14000000001
18413,U20547,73,-35244.99000000002,68,5,55697.15000000003,20452.16000000001
18414,U904606,73,-996.5700000000011,52,21,38938.43,37941.86
18415,U17669,73,-3407.6800000000003,60,13,29034.520000000004,25626.840000000004
18416,U13081,73,-60767.869999999995,32,41,511490.52,450722.65
18417,U32448,73,-90879.85999999999,43,30,609516.26,518636.4
18418,U14799,73,36073.44,57,16,60106.909999999996,96180.35
18419,U16269,73,-6168.05999999995,40,33,1285857.63,1279689.5699999998
18420,U30795,73,-827.2300000000073,63,10,65446.49000000002,64619.26000000001
18421,U678382,73,1995.7900000000009,49,24,22751.899999999998,24747.69
18422,U42684,73,2763.0600000000004,57,16,27799.409999999978,30562.46999999998
18423,U992078,72,-20586.250000000007,49,23,65256.959999999985,44670.70999999998
18424,U16105,72,-3790.369999999937,57,15,397339.8,393549.43000000005
18425,U21301,72,35981.07999999998,57,15,256244.69,292225.76999999996
18426,U34211,72,30.45000000000286,50,22,23056.129999999997,23086.58
18427,U662034,72,11093.329999999998,36,36,105002.5,116095.83
18428,U37975,72,-349.8799999999999,56,16,44333.08,43983.200000000004
18429,U16653,72,329089.9600000001,62,10,527632.7,856722.66
18430,U39055,72,-1183.5200000000114,50,22,156294.91,155111.38999999998
18431,U22614,72,-53315.729999999996,58,14,295227.25999999995,241911.52999999997
18432,U574545,72,-15.310000000000372,35,37,8500.1,8484.79
18433,U18199,72,618.6900000000012,60,12,13132.470000000001,13751.160000000002
18434,U16717,72,-27256.37000000001,62,10,43234.66000000001,15978.29
18435,U12889,72,1913.88,39,33,28932.29,30846.170000000002
18436,U14598,72,543318.8,33,39,4411190.0,4954508.8
18437,U11791,72,221.38999999999942,57,15,20773.920000000002,20995.31
18438,U26862,72,-61881.50999999997,45,27,476710.16,414828.65
18439,U12812,72,-3352.2400000000002,62,10,21165.01,17812.769999999997
18440,U27302,72,-8858.970000000001,52,20,135823.17,126964.20000000001
18441,U19919,72,-47310.42000000001,59,13,94773.6,47463.17999999999
18442,U17404,72,-20155.09,44,28,121410.61,101255.52
18443,U22878,72,-120302.28999999998,57,15,733869.77,613567.48
18444,U32201,72,4362.379999999997,52,20,32642.180000000004,37004.56
18445,U41987,72,5291.029999999999,47,25,173870.56,179161.59
18446,U9582,72,194842.37000000005,44,28,49706.289999999986,244548.66000000003
18447,U14193,72,12113.0,59,13,7113.47,19226.47
18448,U21521,72,13875.729999999992,50,22,109344.64000000001,123220.37000000001
18449,U26281,72,-25097.1,59,13,222712.08,197614.97999999998
18450,U21833,72,17515.350000000006,54,18,279260.13,296775.48
18451,U30374,72,-36941.14,56,16,380443.89,343502.75
18452,U31950,72,-687813.0899999999,59,13,782234.2499999999,94421.16000000003
18453,U43820,72,-2214.01,61,11,25254.33,23040.32
18454,U39084,72,99932.39999999997,42,30,214760.64,314693.04
18455,U36926,72,-1122.2399999999998,66,6,5724.15,4601.91
18456,U27637,72,-2586.5299999999993,69,3,4686.58,2100.0500000000006
18457,U36604,72,2522.549999999998,61,11,3814.7300000000023,6337.280000000001
18458,U20761,72,7795.630000000003,56,16,55978.80999999998,63774.43999999999
18459,U19268,72,-11294.870000000006,60,12,361380.31999999995,350085.44999999995
18460,U35484,72,12866.799999999963,58,14,942704.1599999999,955570.9599999998
18461,U15818,72,53747.650000000234,38,34,4568241.4,4621989.050000001
18462,U8670,72,-7729.309999999998,56,16,226657.58000000002,218928.27000000002
18463,U25894,72,23010.82,22,50,112050.68,135061.5
18464,U43596,72,10660.179999999998,29,43,210413.81999999998,221073.99999999997
18465,U26778,72,27302.32999999998,38,34,242310.03000000003,269612.36
18466,U831581,72,-543.4400000000005,44,28,57360.44,56817.0
18467,U876791,72,59.52999999999997,54,18,2890.94,2950.4700000000003
18468,U12144,72,579.4300000000017,43,29,90073.6,90653.03000000001
18469,U38947,72,3980.829999999998,64,8,16448.15,20428.98
18470,U43246,72,3665.7500000000027,57,15,54696.97,58362.72
18471,U12131,72,-293426.28,66,6,349513.17,56086.889999999956
18472,U16019,72,81249.33000000006,55,17,932020.8300000001,1013270.1600000001
18473,U38879,72,36050.69999999998,64,8,240892.8799999999,276943.57999999984
18474,U41107,72,-1001.1700000000201,52,20,233591.35,232590.18
18475,U10901,72,120639.96999999997,57,15,206202.11000000002,326842.07999999996
18476,U20071,72,-7325.410000000002,47,25,88792.57000000002,81467.16000000002
18477,U27179,72,284796.5900000001,48,24,3816052.309999999,4100848.8999999994
18478,U16036,72,-117369.41999999998,53,19,843000.7399999999,725631.3199999998
18479,U24088,72,-1805.8799999999926,49,23,142735.21,140929.33
18480,U17650,72,1606.1899999999987,54,18,166586.26,168192.45
18481,U40078,72,-109624.16,61,11,141947.09000000003,32322.930000000022
18482,U30446,72,-2783.5400000000027,56,16,139184.81,136401.27
18483,U25344,72,18154.109999999986,61,11,212696.44,230850.55
18484,U37294,72,40550.65999999998,62,10,47990.23,88540.88999999998
18485,U36195,72,5749.990000000001,67,5,7651.5599999999995,13401.55
18486,U15475,72,69383.21,59,13,89189.33,158572.54
18487,U11078,72,-73244.88999999998,61,11,120865.45999999999,47620.57000000001
18488,U21362,72,1454.560000000005,47,25,161101.88,162556.44
18489,U29931,72,-105844.15,45,27,386863.28,281019.13
18490,U820672,72,-0.3099999999999383,49,23,3331.6200000000003,3331.3100000000004
18491,U39910,72,-9500.370000000003,51,21,75641.02000000002,66140.65000000002
18492,U16867,72,13346.320000000065,47,25,1036273.94,1049620.26
18493,U26967,72,38961.3,50,22,93953.93,132915.22999999998
18494,U9215,72,-59631.130000000005,59,13,73306.23999999999,13675.109999999986
18495,U8190,72,1037.7799999999997,52,20,116905.62999999999,117943.40999999999
18496,U17603,72,-122617.15000000107,38,34,13316386.550000003,13193769.400000002
18497,U9036,72,-15459.630000000006,62,10,142646.80999999997,127187.17999999996
18498,U10433,72,125131.34,48,24,136159.96,261291.3
18499,U16287,72,13323.57,62,10,29220.620000000003,42544.19
18500,U23139,72,-17917.189999999995,57,15,467236.56000000006,449319.37000000005
18501,U36177,72,9995.989999999994,49,23,54958.71000000001,64954.7
18502,U23768,72,23188.329999999987,49,23,350155.8599999999,373344.18999999994
18503,U9675,72,32196.929999999997,56,16,53346.82000000001,85543.75
18504,U20435,72,-153299.21000000002,68,4,157565.93,4266.719999999972
18505,U17416,72,-86793.90999999995,27,45,2379028.16,2292234.25
18506,U35822,72,-33076.79,63,9,73210.42,40133.63
18507,U18772,72,-2478.370000000002,62,10,19770.870000000006,17292.500000000004
18508,U30088,72,-3317.3199999999997,67,5,19202.47,15885.150000000001
18509,U36913,72,189137.61,47,25,466275.88,655413.49
18510,U29040,72,172.13000000000102,58,14,39060.770000000004,39232.90000000001
18511,U43844,72,-3986.0599999999963,60,12,23963.22,19977.160000000003
18512,U37725,72,5634.949999999999,61,11,58078.170000000006,63713.12
18513,U9446,72,-2592.8300000000013,52,20,64693.11999999999,62100.289999999986
18514,U12846,72,5778.699999999999,58,14,49651.16000000005,55429.860000000044
18515,U10162,72,-4721.789999999998,56,16,28876.480000000007,24154.69000000001
18516,U26007,72,-278.17999999999955,60,12,18462.67,18184.489999999998
18517,U38166,72,576.8299999999988,52,20,34021.979999999996,34598.81
18518,U14686,72,207535.67999999993,40,32,464880.5200000001,672416.2
18519,U29090,72,-4616.840000000015,35,37,449681.97,445065.12999999995
18520,U37193,72,-30946.48,54,18,42217.25,11270.77
18521,U1273976,72,-1011.3700000000002,62,10,9041.74,8030.37
18522,U35463,72,-368.5099999999665,51,21,258864.61999999988,258496.1099999999
18523,U35965,72,-9448.540000000015,54,18,310610.53,301161.99
18524,U19887,72,39324.109999999986,52,20,445806.91000000003,485131.02
18525,U21716,72,43200.22,63,9,65733.74999999999,108933.96999999999
18526,U974654,72,32739.000000000004,51,21,118045.20000000001,150784.2
18527,U15069,72,-34258.06,59,13,174463.36,140205.3
18528,U35396,72,-333540.73000000004,61,11,982334.24,648793.51
18529,U39696,72,51099.09999999998,33,39,1215790.6,1266889.7000000002
18530,U12325,72,-3896.5400000000013,65,7,24894.48,20997.94
18531,U35739,72,4400.4299999999985,62,10,28495.92000000001,32896.350000000006
18532,U17395,72,6371.970000000001,33,39,221977.35,228349.32
18533,U28428,72,78538.60000000003,49,23,39051.63000000001,117590.23000000004
18534,U43323,72,2614.830000000002,56,16,18791.060000000005,21405.890000000007
18535,U27524,72,-256.199999999998,60,12,30233.55,29977.350000000002
18536,U42051,72,-11234.250000000053,39,33,1001173.33,989939.08
18537,U36988,72,-3670.8900000000003,66,6,39891.399999999994,36220.509999999995
18538,U20452,72,18728.47999999999,62,10,92315.54,111044.01999999999
18539,U38890,72,39001.32999999998,60,12,242380.18999999997,281381.51999999996
18540,U28366,72,47203.5,57,15,25110.85,72314.35
18541,U9527,72,4251.740000000008,53,19,719854.0399999998,724105.7799999998
18542,U14352,72,-24757.63,58,14,339755.84,314998.21
18543,U13601,72,-38816.52,56,16,187156.75000000003,148340.23000000004
18544,U30175,72,-3280.119999999959,48,24,914956.1499999999,911676.0299999999
18545,U43564,72,-12302.13,61,11,53835.570000000014,41533.44000000002
18546,U38221,72,-6917.889999999998,53,19,115604.48,108686.59
18547,U26389,72,-1.8000000000006366,46,26,46914.21000000001,46912.41
18548,U36713,72,28398.32,60,12,11489.0,39887.32
18549,U28987,72,8218.879999999981,57,15,135828.08000000002,144046.96
18550,U44040,72,-2310.61,56,16,13086.600000000002,10775.990000000002
18551,U26946,72,36132.880000000005,45,27,828243.33,864376.21
18552,U12045,72,235.3299999999997,49,23,34964.76,35200.090000000004
18553,U11536,72,10626.720000000001,66,6,81618.16,92244.88
18554,U25133,72,-126887.48000000024,51,21,1343621.2800000003,1216733.8
18555,U35154,72,23260.030000000042,49,23,1461291.1100000003,1484551.1400000004
18556,U27265,72,2080.300000000002,64,8,17151.58,19231.880000000005
18557,U23550,72,30944.750000000004,57,15,59147.420000000006,90092.17000000001
18558,U10174,72,-2563.1200000000003,63,9,163058.42,160495.30000000002
18559,U17695,72,-494.38000000000466,57,15,148945.57,148451.19
18560,U42926,72,3700.1699999999996,67,5,14548.1,18248.27
18561,U33051,72,-13392.259999999998,61,11,88991.70999999999,75599.45
18562,U36500,72,-4633.52,68,4,4970.590000000001,337.0700000000006
18563,U19129,72,4594.099999999997,47,25,98630.29,103224.38999999998
18564,U35709,72,531.3599999999952,44,28,242179.6,242710.96
18565,U28511,72,8699.809999999934,38,34,1032748.02,1041447.83
18566,U11635,72,-14835.160000000007,49,23,193863.57000000007,179028.41000000006
18567,U17866,72,26989.229999999996,53,19,44779.66,71768.89
18568,U36027,72,43161.51,56,16,4356.09,47517.600000000006
18569,U11766,72,-74486.91000000003,41,31,16985337.59,16910850.68
18570,U23395,72,6993.340000000001,57,15,122190.97,129184.31
18571,U24220,72,46274.29,66,6,24562.980000000007,70837.27
18572,U43747,72,-973.0699999999953,58,14,30251.489999999994,29278.42
18573,U33852,72,-454.9099999999962,58,14,137133.78000000003,136678.87000000002
18574,U22472,72,17573.0,57,15,159102.3599999999,176675.3599999999
18575,U17791,72,-4114.87,57,15,13066.19,8951.32
18576,U42120,72,2857.9599999999996,42,30,13165.859999999999,16023.819999999998
18577,U33014,72,36849.39999999999,54,18,139290.65999999997,176140.05999999997
18578,U32887,72,3038.4600000000064,55,17,141567.8,144606.26
18579,U10936,72,-21512.46999999999,52,20,179660.65000000002,158148.18000000002
18580,U35549,72,463.30999999999995,64,8,8469.65,8932.96
18581,U26532,72,9278.860000000002,58,14,28521.340000000004,37800.200000000004
18582,U12885,72,-502162.98000000004,43,29,2144286.12,1642123.1400000001
18583,U10702,72,7046.4299999999985,45,27,36408.31999999999,43454.74999999999
18584,U15662,72,-341848.31999999995,62,10,594820.18,252971.8600000001
18585,U26731,72,226995.72000000003,66,6,207612.83000000002,434608.55000000005
18586,U43263,72,573.6100000000042,49,23,175885.96,176459.57
18587,U38367,72,1120.4800000000002,59,13,23992.9,25113.38
18588,U31874,72,60477.46999999999,34,38,673249.17,733726.64
18589,U34804,71,-3578.7499999999927,55,16,140782.41999999998,137203.66999999998
18590,U19777,71,-13021.32,50,21,55349.840000000004,42328.520000000004
18591,U42754,71,56006.159999999974,41,30,1000625.6899999998,1056631.8499999999
18592,U10645,71,12594.64999999998,53,18,358579.47000000003,371174.12
18593,U19189,71,7194.869999999999,53,18,5714.27,12909.14
18594,U20721,71,-716.5300000000007,66,5,19098.969999999994,18382.439999999995
18595,U1203479,71,50.27000000000044,33,38,75520.37,75570.64
18596,U33805,71,-6849.000000000002,61,10,74352.07999999999,67503.07999999999
18597,U37824,71,-44539.38000000001,67,4,56605.04000000001,12065.659999999996
18598,U9449,71,-411.120000000001,59,12,50603.32,50192.2
18599,U43846,71,-54220.679999999986,44,27,612494.27,558273.5900000001
18600,U21187,71,26351.609999999993,63,8,23795.49000000001,50147.100000000006
18601,U11590,71,-72620.92000000001,53,18,201442.24,128821.31999999998
18602,U28656,71,3377.3600000000115,35,36,240624.89,244002.25000000003
18603,U16995,71,543.2700000000001,60,11,18620.519999999997,19163.789999999997
18604,U12602,71,35446.40000000001,43,28,150901.49000000002,186347.89
18605,U37673,71,682.2500000000018,48,23,313263.78,313946.03
18606,U22199,71,-885.0299999999975,58,13,102715.31999999986,101830.28999999986
18607,U15606,71,34422.369999999995,49,22,220555.83,254978.19999999998
18608,U20857,71,19932.13,47,24,172685.89,192618.02000000002
18609,U37674,71,-610.6700000000101,37,34,553304.9500000001,552694.28
18610,U28046,71,-5338.31,58,13,39396.92999999999,34058.619999999995
18611,U11114,71,-26796.310000000005,65,6,67720.76000000001,40924.450000000004
18612,U20775,71,-6028.619999999994,62,9,28861.699999999993,22833.079999999998
18613,U40554,71,-715.5600000000006,64,7,41791.61,41076.05
18614,U36541,71,10693.419999999998,55,16,109568.33,120261.75
18615,U11557,71,-9606.030000000002,62,9,23820.120000000003,14214.09
18616,U15705,71,-46706.26,50,21,112071.39,65365.13
18617,U31380,71,1639.4399999999987,59,12,62299.09,63938.53
18618,U41639,71,-610.0099999999907,46,25,590424.07,589814.0599999999
18619,U10290,71,-13901.299999999988,38,33,367410.5800000001,353509.2800000001
18620,U24561,71,-428.35000000000036,46,25,21636.28,21207.93
18621,U1241779,71,-32591.83,51,20,75941.37000000002,43349.54000000002
18622,U37615,71,-1512.5199999999995,66,5,11485.939999999999,9973.419999999998
18623,U1380063,71,10.990000000002352,50,21,22774.510000000002,22785.500000000004
18624,U34222,71,1473.0799999999995,64,7,5799.92,7273.0
18625,U40225,71,-11771.719999999987,24,47,753282.38,741510.66
18626,U25556,71,34.32999999999697,42,29,43547.920000000006,43582.25
18627,U10013,71,128743.87999999989,41,30,3319551.58,3448295.46
18628,U33268,71,-53048.53999999999,60,11,71493.19,18444.65000000001
18629,U17984,71,15692.760000000024,51,20,267895.5,283588.26
18630,U13420,71,628.1999999999998,65,6,9245.29,9873.490000000002
18631,U10418,71,-2991.590000000013,36,35,913934.18,910942.5900000001
18632,U27593,71,-4545.079999999997,63,8,57486.55000000001,52941.470000000016
18633,U18779,71,1666.0400000001027,31,40,1825120.3,1826786.34
18634,U32045,71,-637.0999999999913,60,11,180408.22999999998,179771.13
18635,U12976,71,-3267.4300000000007,63,8,6179.01,2911.5799999999995
18636,U41398,71,-21915.629999999997,53,18,238510.10000000003,216594.47000000003
18637,U40325,71,-9820.740000000003,46,25,198238.22,188417.48
18638,U38379,71,466581.3300000001,47,24,1418995.75,1885577.08
18639,U9889,71,5251.959999999999,46,25,177535.58000000002,182787.54
18640,U15586,71,69010.01,40,31,152294.21000000002,221304.22000000003
18641,U38914,71,1039.2399999999898,33,38,148123.20000000004,149162.44000000003
18642,U28089,71,-47709.63999999999,64,7,68773.73,21064.090000000004
18643,U39725,71,10705.249999999996,35,36,147120.07,157825.32
18644,U17504,71,-7319.709999999969,36,35,972160.3400000001,964840.6300000001
18645,U15832,71,-1625.7800000000068,36,35,54854.030000000006,53228.25
18646,U26022,71,59117.53000000007,62,9,1215915.69,1275033.22
18647,U40424,71,-17433.719999999994,60,11,46795.17,29361.450000000004
18648,U19628,71,1702.9799999999998,47,24,51973.01000000001,53675.99000000001
18649,U681016,71,-948.7199999999975,49,22,66034.3,65085.58
18650,U30004,71,2435.0299999999997,59,12,72963.16,75398.19
18651,U20562,71,3394.06,53,18,124469.88999999997,127863.94999999997
18652,U19130,71,-18497.33,56,15,167515.62999999998,149018.3
18653,U38176,71,856.1199999999999,60,11,10987.3,11843.419999999998
18654,U21029,71,-22651.29999999998,53,18,540002.2,517350.89999999997
18655,U15756,71,-1261.4400000000023,36,35,77257.50000000001,75996.06000000001
18656,U41203,71,-10215.650000000001,55,16,74172.54000000001,63956.89000000001
18657,U38583,71,43685.520000000004,56,15,448023.58999999997,491709.11
18658,U8595,71,21881.680000000168,49,22,3331834.21,3353715.89
18659,U9957,71,-11981.660000000002,53,18,89281.44000000002,77299.78000000001
18660,U28518,71,66500.03000000001,52,19,164677.96,231177.99
18661,U35027,71,8145.109999999994,48,23,73680.15999999999,81825.26999999999
18662,U41044,71,-1.1300000000010186,33,38,105218.28,105217.15
18663,U24744,71,-13216.630000000003,59,12,19527.33,6310.699999999999
18664,U25692,71,-2330.7999999999965,58,13,119586.09999999998,117255.29999999997
18665,U41381,71,-1923.29,48,23,4200.630000000001,2277.340000000001
18666,U33262,71,-5359.90000000014,57,14,1093653.31,1088293.41
18667,U25121,71,18405.77,62,9,47298.59,65704.36
18668,U16855,71,11644.63000000002,48,23,1011717.5800000001,1023362.2100000001
18669,U41397,71,-231.82999999999993,52,19,74091.94,73860.11
18670,U11663,71,-66394.68000000025,66,5,69758.82000000025,3364.1399999999994
18671,U27051,71,-259965.94000000003,52,19,520961.86,260995.91999999995
18672,U10142,71,6401.040000000001,65,6,4692.510000000001,11093.550000000003
18673,U39462,71,52142.2900000002,50,21,3062309.4099999997,3114451.6999999997
18674,U35275,71,2068.980000000003,52,19,208042.02,210111.0
18675,U25768,71,2007.5499999999884,50,21,484974.25,486981.8
18676,U18650,71,-11062.920000000006,47,24,746992.9500000003,735930.0300000003
18677,U33042,71,3025.14,53,18,23073.06,26098.2
18678,U18826,71,-82919.51999999999,45,26,467380.63,384461.11
18679,U19394,71,-24769.25,62,9,56532.79,31763.54
18680,U9917,71,40684.060000000005,51,20,85815.68000000001,126499.74000000002
18681,U10474,71,-3348.4799999999113,55,16,3096718.7699999996,3093370.2899999996
18682,U30244,71,-6248.830000000009,47,24,145422.51,139173.68
18683,U8267,71,-3116.9800000000014,47,24,28677.56,25560.58
18684,U8737,71,-7120.559999999994,49,22,79892.57999999999,72772.01999999999
18685,U15730,71,47902.420000000006,48,23,275341.87,323244.29
18686,U13794,71,-3590.0700000000015,48,23,161246.92,157656.85
18687,U8646,71,-126874.17000000001,55,16,352941.35,226067.17999999996
18688,U40768,71,148.4699999999998,68,3,7674.320000000001,7822.790000000001
18689,U39594,71,-4482.420000000004,59,12,157131.42,152649.0
18690,U40104,71,6179.079999999998,63,8,39596.369999999995,45775.45
18691,U36208,71,7754.960000000001,63,8,20348.520000000004,28103.480000000003
18692,U17817,71,707.9200000000022,53,18,24976.66,25684.58
18693,U28103,71,-643.9099999999141,59,12,949575.33,948931.42
18694,U679459,71,36099.740000000005,49,22,49049.19999999999,85148.94
18695,U30852,71,-20738.54,62,9,61577.46000000001,40838.920000000006
18696,U22264,71,281.959999999998,52,19,43960.36000000001,44242.32000000001
18697,U13416,71,-25559.920000000013,44,27,435067.62,409507.69999999995
18698,U30553,71,-116105.98000000001,54,17,2252717.5300000003,2136611.5500000003
18699,U42101,71,-16728.269999999997,46,25,62888.35,46160.08
18700,U33186,71,2620.9499999999994,60,11,14346.720000000001,16967.670000000002
18701,U25232,71,30147.720000000005,52,19,110284.64,140432.36000000002
18702,U43318,71,-393.0600000000041,57,14,86589.91000000002,86196.85000000002
18703,U32604,71,81366.97999999998,47,24,220396.62999999998,301763.61
18704,U33060,71,-9805.809999999998,54,17,14892.82,5087.010000000002
18705,U42470,71,1000.000000000005,38,33,110730.64,111730.64
18706,U26650,71,-239.23000000000047,63,8,8669.81,8430.579999999998
18707,U22310,71,9271.330000000002,59,12,60078.0,69349.33
18708,U30206,71,-86572.22,50,21,412245.10000000003,325672.88
18709,U41057,71,-12264.97000000001,54,17,643263.3300000002,630998.3600000002
18710,U9012,71,-671789.19,57,14,948202.12,276412.93000000005
18711,U41073,71,15306.319999999996,36,35,36130.83,51437.149999999994
18712,U8493,71,2309.2699999999986,38,33,67615.71999999999,69924.98999999999
18713,U26743,71,26966.93999999998,58,13,915050.81,942017.75
18714,U39835,71,3960.870000000001,56,15,60108.07000000001,64068.94000000001
18715,U8999,71,8970.960000000003,59,12,74092.82000000002,83063.78000000003
18716,U41268,71,1095.4400000000023,55,16,81102.75,82198.19
18717,U33893,71,-8358.79,61,10,35606.80000000001,27248.01000000001
18718,U31682,71,33.32999999999964,69,2,4248.21,4281.54
18719,U23697,71,-300476.4,60,11,579402.72,278926.31999999995
18720,U14839,71,15966.729999999998,54,17,1629762.4000000001,1645729.1300000001
18721,U36666,71,-357.3100000000094,58,13,359368.38,359011.07
18722,U22769,71,-38259.840000000004,57,14,71035.95999999999,32776.11999999999
18723,U41880,71,32953.509999999995,44,27,188535.16,221488.66999999998
18724,U17357,71,2231.670000000003,59,12,60100.44,62332.11000000001
18725,U22380,71,1546.2599999999998,66,5,4487.46,6033.719999999999
18726,U27401,71,-7392.999999999985,50,21,333996.44,326603.44
18727,U36684,71,-17993.259999999973,43,28,547216.3300000001,529223.0700000001
18728,U1198482,71,33.19000000000051,50,21,22601.239999999998,22634.43
18729,U42967,71,-52160.880000000005,47,24,479172.12,427011.24
18730,U14776,71,47776.379999999976,33,38,237369.77000000002,285146.15
18731,U21652,71,27101.53,46,25,255527.76999999996,282629.29999999993
18732,U43530,71,24629.600000000035,40,31,988281.37,1012910.97
18733,U37555,71,-372.58000000000004,62,9,5927.540000000001,5554.960000000001
18734,U32564,71,-34948.31,68,3,64210.57000000001,29262.26000000001
18735,U30366,71,-6811.609999999998,67,4,7819.7699999999995,1008.1600000000017
18736,U12764,71,7241.650000000004,56,15,39904.69999999999,47146.34999999999
18737,U39969,70,50889.18999999997,39,31,1365704.98,1416594.17
18738,U12964,70,-207401.15999999997,44,26,1306208.73,1098807.57
18739,U37353,70,9859.259999999995,57,13,135555.12,145414.38
18740,U12189,70,3833.9599999999787,64,6,128221.43000000001,132055.38999999998
18741,U16260,70,-61738.70999999998,41,29,395084.54999999993,333345.83999999997
18742,U26783,70,-112478.33000000003,46,24,824268.3400000001,711790.01
18743,U34584,70,15652.409999999998,60,10,22278.449999999997,37930.85999999999
18744,U37272,70,-597.7799999999988,41,29,54168.75,53570.97
18745,U21419,70,3940.0,39,31,1586292.1199999999,1590232.1199999999
18746,U38710,70,-4928.650000000037,52,18,1019254.4,1014325.75
18747,U17486,70,-260180.25000000003,55,15,348387.76,88207.50999999998
18748,U25892,70,533.2699999999994,50,20,30703.959999999995,31237.229999999996
18749,U17117,70,116767.08999999995,30,40,836970.1000000002,953737.1900000002
18750,U19465,70,15207.689999999999,62,8,12874.99,28082.68
18751,U17264,70,2030.049999999998,52,18,36449.92000000001,38479.97000000001
18752,U751975,70,-7635.969999999999,54,16,46916.20999999999,39280.23999999999
18753,U20022,70,146129.22000000006,60,10,703126.2300000001,849255.4500000002
18754,U18967,70,13769.480000000025,60,10,74931.43999999999,88700.92000000001
18755,U40076,70,15208.010000000007,59,11,97147.89999999998,112355.90999999999
18756,U10768,70,-34524.100000000006,34,36,286611.17000000004,252087.07000000004
18757,U28445,70,87636.44999999997,24,46,214874.15,302510.6
18758,U16970,70,-103307.76999999997,47,23,367709.55,264401.78
18759,U39848,70,37628.89,46,24,17648.15,55277.04
18760,U9304,70,1405528.21,54,16,100466.91,1505995.1199999999
18761,U1369045,70,-18011.179999999997,66,4,19123.859999999993,1112.6799999999967
18762,U38031,70,-4464.070000000004,52,18,190028.5,185564.43
18763,U1270402,70,1600.0,37,33,3010.0,4610.0
18764,U25413,70,-662.8600000000001,63,7,9297.939999999999,8635.079999999998
18765,U956850,70,-9210.160000000002,49,21,31724.46,22514.299999999996
18766,U38439,70,-14036.48,52,18,56025.840000000004,41989.36
18767,U39836,70,-36824.329999999994,55,15,82507.56,45683.23
18768,U24576,70,-2044.8999999999635,53,17,2510366.38,2508321.48
18769,U14982,70,9016.460000000014,50,20,190343.21,199359.67
18770,U8674,70,-4622.97,58,12,23467.750000000004,18844.780000000002
18771,U35338,70,-566.32,69,1,570.7,4.3799999999999955
18772,U29208,70,-3081.329999999998,27,43,618497.69,615416.36
18773,U39685,70,-3755.1599999999958,47,23,113154.99,109399.83000000002
18774,U984578,70,-1818.8200000000002,50,20,33543.89,31725.07
18775,U15692,70,-93.50000000000337,37,33,86047.23,85953.73
18776,U24229,70,-341944.48999999993,38,32,1203505.1199999999,861560.6299999999
18777,U16918,70,121807.32999999999,53,17,120178.33,241985.65999999997
18778,U22582,70,-990.2999999999828,58,12,187858.19,186867.89
18779,U27284,70,1762.0699999999924,46,24,654132.29,655894.36
18780,U32981,70,5590.410000000001,35,35,55083.42,60673.83
18781,U19176,70,-401.6699999999999,66,4,12969.419999999996,12567.749999999996
18782,U25836,70,-1093.5899999999997,49,21,24515.290000000005,23421.700000000004
18783,U32616,70,-19853.65,51,19,84651.2,64797.549999999996
18784,U40401,70,2840696.2,46,24,7121457.5,9962153.7
18785,U10440,70,5927.76,40,30,62230.45999999999,68158.21999999999
18786,U10844,70,452.8999999999978,35,35,510450.43,510903.33
18787,U11434,70,-48943.36999999985,41,29,1249229.7,1200286.33
18788,U16582,70,-5713.150000000003,47,23,54204.53999999999,48491.38999999999
18789,U757492,70,-9692.969999999994,47,23,116749.68000000001,107056.71000000002
18790,U17285,70,3516.649999999916,36,34,5138309.130000001,5141825.780000001
18791,U10561,70,-18689.42000000007,54,16,523465.76999999996,504776.34999999986
18792,U25365,70,1896.4100000000144,32,38,292359.6,294256.01
18793,U11360,70,-8844.22,35,35,23361.640000000014,14517.420000000015
18794,U31985,70,-6273.309999999999,64,6,27688.74,21415.430000000004
18795,U29585,70,-1395.6,64,6,4785.209999999999,3389.609999999999
18796,U32697,70,36773.46,56,14,63188.15,99961.61
18797,U31338,70,-24581.47,60,10,88527.95999999999,63946.48999999999
18798,U41276,70,-42454.43,57,13,160870.06999999998,118415.63999999998
18799,U42010,70,4571.190000000001,55,15,105358.45,109929.64
18800,U8065,70,23328.76000000001,53,17,113998.62,137327.38
18801,U14081,70,1366.2300000000125,51,19,192785.07000000004,194151.30000000005
18802,U36439,70,-5088.81000000001,30,40,390953.79,385864.98
18803,U41564,70,-26552.489999999976,37,33,958340.82,931788.33
18804,U25617,70,2781.199999999997,62,8,176289.3,179070.5
18805,U37758,70,504.9799999999998,44,26,12578.02,13083.0
18806,U36349,70,-18347.65,51,19,87855.95,69508.29999999999
18807,U37405,70,50.83000000000061,55,15,31524.02,31574.850000000002
18808,U11954,70,7567.110000000006,42,28,83290.28000000001,90857.39000000001
18809,U42659,70,-1781.7800000000007,59,11,11518.7,9736.92
18810,U720143,70,-235.14000000000033,67,3,10140.150000000001,9905.010000000002
18811,U20345,70,-2429.8299999999845,51,19,128070.91,125641.08000000002
18812,U17200,70,17980.6,57,13,35629.73,53610.33
18813,U43016,70,-7223.589999999991,41,29,265278.43,258054.84
18814,U27297,70,4864.0399999999745,42,28,325000.18999999994,329864.2299999999
18815,U27493,70,-3368.8099999999995,57,13,22113.65,18744.840000000004
18816,U35404,70,-7900.039999999999,57,13,43278.37,35378.33
18817,U34763,70,27612.47,46,24,109225.0,136837.47
18818,U22081,70,-5350.9400000000005,35,35,82309.45999999999,76958.51999999999
18819,U731149,70,2.0,34,36,2143.02,2145.02
18820,U29413,70,1466.5699999999924,61,9,106616.98000000001,108083.55
18821,U43810,70,-9539.380000000005,36,34,815744.24,806204.86
18822,U19064,70,-5074.29,60,10,48850.39,43776.1
18823,U12944,70,2055970.8000000003,58,12,396696.78,2452667.58
18824,U26042,70,-20350.63,66,4,30516.410000000003,10165.780000000002
18825,U30877,70,-48126.95000000004,56,14,702054.3400000001,653927.39
18826,U39999,70,-278981.0200000001,54,16,2894739.579999999,2615758.559999999
18827,U10793,70,3796.9899999999893,46,24,332672.4000000001,336469.3900000001
18828,U14566,70,195309.1100000002,53,17,157353.2,352662.3100000002
18829,U16934,70,-27786.17999999928,38,32,6099340.25,6071554.07
18830,U19422,70,761.4500000000082,50,20,248482.85000000003,249244.30000000005
18831,U29294,70,-135138.6,52,18,428626.08999999997,293487.49
18832,U1129369,70,-8626.41,41,29,40121.69,31495.280000000002
18833,U27925,70,10834.109999999999,56,14,36225.700000000004,47059.810000000005
18834,U12022,70,-31505.829999999994,56,14,264598.66000000003,233092.83000000005
18835,U41157,70,-100004.85000000003,45,25,874354.46,774349.6099999999
18836,U1069683,70,-1674.52,41,29,13732.510000000002,12057.990000000002
18837,U29354,70,34.45999999999913,34,36,515430.17000000004,515464.63000000006
18838,U13970,70,18503.19,35,35,135532.49,154035.68
18839,U36266,70,27286.540000000008,54,16,209516.05,236802.59
18840,U1149069,70,-29072.379999999997,43,27,34723.780000000006,5651.400000000009
18841,U31113,70,-6353.29,67,3,6358.139999999999,4.849999999999454
18842,U41431,70,39186.63,46,24,125250.76000000001,164437.39
18843,U14822,70,186360.94999999992,53,17,1688283.7300000002,1874644.6800000002
18844,U43880,70,1857.509999999982,52,18,316399.41999999987,318256.9299999999
18845,U35865,70,-11385.48,63,7,72890.64,61505.16
18846,U29302,70,-2627.2700000000027,61,9,43600.96,40973.689999999995
18847,U36303,70,-3342.7499999999986,54,16,10901.249999999998,7558.5
18848,U43243,70,-33170.79000000004,42,28,1318880.99,1285710.2
18849,U36271,70,-1556.850000000003,41,29,460004.86,458448.01
18850,U26199,70,-63619.200000000026,53,17,243829.11,180209.90999999997
18851,U25648,70,-107594.07000000004,53,17,434536.88,326942.80999999994
18852,U38481,70,-7217.069999999999,64,6,21910.559999999998,14693.489999999998
18853,U28196,70,420.1900000000023,45,25,574626.8200000001,575047.01
18854,U21613,70,122534.38,55,15,44508.100000000006,167042.48
18855,U39456,70,-9968.520000000028,30,40,22794248.0,22784279.48
18856,U20624,70,481.79000000003026,54,16,534418.63,534900.42
18857,U11789,70,26225.81,60,10,61019.88000000001,87245.69000000002
18858,U10267,70,2135.2299999999996,46,24,44100.869999999995,46236.09999999999
18859,U26643,70,2749.0699999999924,60,10,249509.33999999994,252258.40999999992
18860,U41832,70,24245.899999999914,30,40,1621838.76,1646084.66
18861,U38409,70,-14032.040000000008,61,9,112862.03,98829.98999999999
18862,U33403,70,-86166.8600000001,34,36,2614136.76,2527969.8999999994
18863,U13265,70,6402.310000000003,61,9,61690.29000000001,68092.6
18864,U39121,70,8561.560000000001,57,13,24107.3,32668.86
18865,U31123,70,-9775.420000000013,65,5,25671.090000000004,15895.669999999991
18866,U27145,70,-34244.69000000001,39,31,696767.51,662522.82
18867,U8779,70,105155.38000000003,63,7,124879.76999999999,230035.15000000002
18868,U26936,70,-9361.259999999991,48,22,163215.53,153854.27000000002
18869,U43406,70,163823.69999999998,45,25,700924.3300000002,864748.0300000001
18870,U42181,70,-3101.8500000000013,56,14,109067.84,105965.98999999999
18871,U11998,70,-1229.5600000000002,62,8,27994.6,26765.039999999997
18872,U24416,70,-60157.41000000002,53,17,191550.38999999998,131392.97999999998
18873,U18877,70,12188.679999999993,54,16,84394.23999999999,96582.91999999998
18874,U37686,70,-158.9400000000096,51,19,289775.25,289616.31
18875,U12272,70,-11108.350000000002,49,21,83257.93,72149.57999999999
18876,U25840,70,8348.29,63,7,25967.479999999996,34315.77
18877,U21762,70,-35.48999999998137,60,10,1035119.49,1035084.0
18878,U31438,70,2507.3,53,17,52234.08,54741.380000000005
18879,U43244,70,-663.8599999999674,48,22,387943.56,387279.7
18880,U19274,70,-48416.850000000006,58,12,112465.98999999999,64049.139999999985
18881,U19075,70,3344.8099999999963,47,23,222889.00999999995,226233.81999999995
18882,U36912,70,46632.61999999998,57,13,76486.64,123119.25999999998
18883,U36376,70,955.3399999999965,50,20,241575.28000000003,242530.62000000002
18884,U639732,70,-826.49,69,1,827.49,1.0
18885,U19823,70,4330.530000000023,43,27,117666.15000000001,121996.68000000004
18886,U28018,70,1111.6199999999935,48,22,164309.28999999998,165420.90999999997
18887,U17090,70,100385.26000000005,52,18,983684.23,1084069.49
18888,U13484,70,-74933.64000000003,48,22,1491326.8000000003,1416393.1600000001
18889,U9135,70,-4253.880000000002,53,17,89491.87999999998,85237.99999999997
18890,U34446,70,80066.64,33,37,291330.0,371396.64
18891,U27596,70,7410.820000000002,61,9,13898.419999999995,21309.239999999998
18892,U35383,70,-190809.00999999995,68,2,230986.88999999996,40177.880000000005
18893,U43833,70,116439.84999999999,44,26,139996.22999999998,256436.07999999996
18894,U27641,70,-7788.91,62,8,32406.320000000007,24617.410000000007
18895,U20773,70,626.4500000000005,60,10,14343.97,14970.42
18896,U20890,70,-2214.0999999999976,58,12,54750.71000000002,52536.61000000002
18897,U40879,70,380351.52000000025,56,14,66441.93000000002,446793.4500000003
18898,U15841,70,1562.4,55,15,33108.78,34671.18
18899,U9541,70,45876.610000000015,51,19,420786.80999999994,466663.4199999999
18900,U13610,70,9886.820000000002,39,31,522842.26,532729.08
18901,U31563,70,-5055.779999999999,58,12,21663.32,16607.54
18902,U31127,70,839.9100000000035,34,36,279727.49,280567.4
18903,U10153,70,407837.3500000001,51,19,842250.2599999999,1250087.6099999999
18904,U30760,70,-728288.29,52,18,1505796.1400000001,777507.8500000001
18905,U25157,70,2183.180000000003,47,23,91545.45,93728.63
18906,U40173,70,-23200.4,62,8,81481.61,58281.21
18907,U22102,70,11316.790000000005,51,19,284229.86,295546.64999999997
18908,U19484,70,0.5800000000007799,39,31,17672.309999999998,17672.89
18909,U29181,70,20268.77,60,10,61887.5,82156.27
18910,U12171,70,-10260.63,55,15,109247.11999999998,98986.48999999998
18911,U32028,70,32.31000000000017,61,9,4715.800000000001,4748.1100000000015
18912,U21409,70,-1212.0499999999968,47,23,74490.67,73278.62
18913,U25148,69,-292903.3,59,10,355400.1,62496.79999999999
18914,U25361,69,65671.53999999998,53,16,260989.64,326661.18
18915,U16548,69,3679.8199999999765,60,9,700205.88,703885.7
18916,U19236,69,796.51,65,4,2817.4999999999995,3614.0099999999993
18917,U16906,69,-39050.430000000044,37,32,1045115.1199999999,1006064.6899999998
18918,U39916,69,-126262.86000000007,39,30,1643872.6199999996,1517609.7599999995
18919,U12674,69,31674.810000000012,46,23,68726.26000000008,100401.0700000001
18920,U9314,69,37024.61,57,12,497590.57000000007,534615.18
18921,U13712,69,-36783.29000000002,41,28,458591.01000000007,421807.72000000003
18922,U42164,69,-3962.3599999999983,58,11,35703.270000000004,31740.910000000007
18923,U8184,69,-2659.6000000000004,59,10,16859.91,14200.31
18924,U8020,69,9146.880000000037,46,23,173806.21999999997,182953.1
18925,U38205,69,543.159999999999,58,11,23372.650000000005,23915.810000000005
18926,U665129,69,-776.4600000000003,46,23,19288.989999999998,18512.53
18927,U38184,69,-54148.49999999997,40,29,1923182.82,1869034.32
18928,U22321,69,-22427.39000000007,57,12,1028704.25,1006276.86
18929,U39115,69,87591.01000000002,38,31,530566.7699999999,618157.7799999999
18930,U10992,69,-46741.80999999994,44,25,1358716.5,1311974.69
18931,U37110,69,-34189.30000000008,56,13,1715853.93,1681664.63
18932,U15603,69,-5022.869999999997,50,19,258104.72,253081.85
18933,U16813,69,16004.779999999977,54,15,907477.75,923482.53
18934,U29652,69,-2713.270000000004,53,16,187907.22,185193.95
18935,U18124,69,26125.370000000014,45,24,301213.55,327338.92
18936,U9001,69,61920.030000000006,51,18,78199.81999999999,140119.85
18937,U26677,69,567.1199999999917,29,40,264002.18999999994,264569.30999999994
18938,U9742,69,-32847.95000000001,43,26,285860.97000000003,253013.02000000002
18939,U16226,69,14014.319999999998,62,7,31260.46,45274.78
18940,U16801,69,-4944.299999999988,56,13,331335.13999999996,326390.83999999997
18941,U38484,69,-1316.3099999999986,49,20,33340.41,32024.100000000006
18942,U16955,69,28996.980000000003,43,26,153037.99,182034.97
18943,U29711,69,44904.1100000001,29,40,1783987.63,1828891.74
18944,U34513,69,-5394.220000000004,56,13,43495.63,38101.409999999996
18945,U32747,69,41627.62,52,17,329943.00000000006,371570.62000000005
18946,U24493,69,22710.209999999974,60,9,107286.12000000004,129996.33000000002
18947,U21564,69,-6913.0599999999995,55,14,58973.049999999996,52059.99
18948,U9647,69,-7117.6900000000005,61,8,51996.33000000001,44878.64000000001
18949,U23238,69,82115.79,50,19,169883.33,251999.12
18950,U26152,69,4083.0600000000004,54,15,59265.45000000001,63348.51000000001
18951,U38429,69,-9611.410000000003,63,6,24208.120000000006,14596.710000000003
18952,U13924,69,-11343.829999999998,64,5,68684.95000000001,57341.12000000001
18953,U17102,69,-1844.520000000001,47,22,14694.869999999999,12850.349999999999
18954,U22231,69,2232.740000000001,39,30,158301.17,160533.91
18955,U37428,69,168637.2399999999,44,25,322357.48000000004,490994.72
18956,U25553,69,-20207.350000000002,52,17,182117.89,161910.54
18957,U10350,69,102660.77,46,23,198210.24,300871.01
18958,U35505,69,-199218.27,43,26,282801.68,83583.41
18959,U18253,69,86143.07999999999,52,17,239225.46000000005,325368.54000000004
18960,U22263,69,-42534.05999999866,32,37,31547577.339999996,31505043.279999997
18961,U650444,69,4126.450000000001,42,27,31374.439999999995,35500.89
18962,U23963,69,43113.82,57,12,23749.02,66862.84
18963,U43659,69,-3345.2999999999993,58,11,27684.270000000004,24338.970000000005
18964,U31360,69,-19049.05999999996,51,18,613535.6399999997,594486.5799999997
18965,U14647,69,2895.640000000008,40,29,306325.78,309221.42000000004
18966,U1354216,69,-18939.890000000007,53,16,37469.07000000001,18529.18
18967,U20370,69,9724.1,57,12,89283.12,99007.22
18968,U17337,69,113782.09999999996,48,21,1183160.9300000002,1296943.03
18969,U17469,69,-14995.16999999999,52,17,230121.40999999997,215126.24
18970,U37366,69,11015.93,16,53,86172.08,97188.01000000001
18971,U40109,69,15025.630000000003,56,13,200471.5,215497.13
18972,U23325,69,-217.0800000000163,47,22,299348.11,299131.02999999997
18973,U13838,69,-234.69000000000233,56,13,123736.91,123502.22
18974,U13903,69,-2686.840000000003,53,16,62345.20999999997,59658.369999999966
18975,U40858,69,-59005.61,52,17,327871.99000000005,268866.38000000006
18976,U25670,69,-4198.519999999999,49,20,104685.28,100486.76
18977,U17185,69,-2201.0,49,20,201045.69,198844.69
18978,U33775,69,3637.8500000000004,56,13,13322.52,16960.370000000003
18979,U23188,69,-4263.97,55,14,57719.56,53455.59
18980,U25810,69,-13834.269999999975,50,19,145509.55,131675.28000000003
18981,U27541,69,9.220000000001164,36,33,28688.0,28697.22
18982,U19849,69,-107116.92,66,3,118133.23999999999,11016.319999999992
18983,U35727,69,24840.56,54,15,53169.28000000001,78009.84000000001
18984,U24837,69,-4710.419999999995,37,32,64889.479999999996,60179.06
18985,U38127,69,2030.0200000000013,50,19,22342.8,24372.82
18986,U38492,69,-63.409999999999684,65,4,27204.609999999997,27141.199999999997
18987,U43012,69,341499.71000000014,51,18,546220.1600000001,887719.8700000003
18988,U37746,69,4648.239999999988,48,21,531187.92,535836.16
18989,U33287,69,-213330.65,50,19,642573.1600000001,429242.5100000001
18990,U42632,69,685.0299999999999,65,4,7374.010000000001,8059.040000000001
18991,U14968,69,700.6399999999965,62,7,70568.81,71269.45
18992,U32430,69,82398.90000000002,42,27,194519.54000000004,276918.44000000006
18993,U9420,69,20447.11,53,16,95106.61,115553.72
18994,U40824,69,-10159.86,56,13,49711.5,39551.64
18995,U34699,69,1260.4299999999998,57,12,12565.2,13825.630000000001
18996,U24174,69,57.73999999999978,44,25,38674.840000000004,38732.58
18997,U18888,69,105946.40000000011,38,31,1525028.9,1630975.3
18998,U26840,69,-187836.81000000003,50,19,3340392.8600000003,3152556.0500000003
18999,U974779,69,619.1700000000005,45,24,12637.679999999997,13256.849999999997
19000,U28675,69,-25247.22999999999,64,5,34375.979999999996,9128.750000000007
19001,U34065,69,4179.47,64,5,975.3499999999999,5154.82
19002,U851495,69,3634.5899999999997,38,31,9938.99,13573.58
19003,U37217,69,-2021.5699999999974,51,18,45647.06,43625.49
19004,U12409,69,-8905.109999999997,43,26,79490.94,70585.83
19005,U680476,69,9010.760000000002,59,10,40807.600000000006,49818.36000000001
19006,U25446,69,-10013.729999999985,57,12,89747.71999999994,79733.98999999996
19007,U35826,69,1028.2799999999993,54,15,39996.48,41024.76
19008,U38148,69,316928.3000000001,57,12,413339.11,730267.4100000001
19009,U20163,69,4068.43,49,20,63538.329999999994,67606.76
19010,U26994,69,-2123.3299999999845,53,16,146765.21,144641.88
19011,U961071,69,-1965.9600000000005,53,16,7128.030000000001,5162.07
19012,U36659,69,-17474.08,62,7,33053.7,15579.619999999995
19013,U799967,69,-825.0599999999977,59,10,42019.74,41194.68
19014,U42881,69,-65.75000000000591,34,35,74999.54999999999,74933.79999999999
19015,U35343,69,14025.050000000003,52,17,118639.31,132664.36
19016,U986510,69,-7265.050000000002,63,6,9990.849999999997,2725.7999999999947
19017,U15796,69,43510.00000000002,60,9,255907.09999999998,299417.1
19018,U27187,69,87306.30000000035,43,26,11091928.830000002,11179235.130000003
19019,U1243067,69,665.1600000000002,54,15,3262.0099999999998,3927.17
19020,U9534,69,-177852.75,38,31,1223805.0799999996,1045952.3299999996
19021,U1091909,69,186.26000000000116,42,27,9260.71,9446.970000000001
19022,U26374,69,-2058.7599999999993,39,30,112091.27999999998,110032.51999999999
19023,U26175,69,-162547.51,42,27,555145.06,392597.55000000005
19024,U14384,69,-680.5599999999995,60,9,11464.539999999997,10783.979999999998
19025,U28127,69,-5005.970000000001,57,12,31157.97,26152.0
19026,U38522,69,16020.490000000005,39,30,176085.27999999997,192105.76999999996
19027,U28477,69,-737764.74,38,31,3367891.67,2630126.9299999997
19028,U26206,69,156149.3600000001,48,21,1623734.3799999997,1779883.7399999998
19029,U24058,69,14191.76999999968,41,28,1409246.8699999999,1423438.6399999997
19030,U27146,69,-12686.499999999984,56,13,204252.80999999997,191566.31
19031,U993385,69,212.5999999999999,54,15,12146.53,12359.130000000001
19032,U18202,69,-388477.74000000005,57,12,585200.4299999997,196722.68999999965
19033,U22642,69,24355.350000000006,51,18,345361.66,369717.01
19034,U18209,69,13138.250000000002,62,7,106645.75,119784.0
19035,U28458,69,-43222.8,64,5,54875.88,11653.079999999994
19036,U12699,69,-7903.110000000015,54,15,153891.91999999998,145988.80999999997
19037,U43298,69,93483.21000000002,56,13,71083.15000000001,164566.36000000004
19038,U31049,69,3229.4400000000105,31,38,476830.42000000004,480059.86000000004
19039,U29975,69,-2122.619999999999,53,16,91017.61,88894.99
19040,U24856,69,11641.220000000001,48,21,34038.34,45679.56
19041,U17284,69,-40916.0,62,7,128544.27000000002,87628.27000000002
19042,U36509,69,5238.689999999995,43,26,88893.79999999999,94132.48999999999
19043,U18797,69,-26178.199999999983,49,20,185891.86000000002,159713.66000000003
19044,U11192,69,-322.59000000000015,52,17,71515.17,71192.58
19045,U11443,69,-333.0800000000019,62,7,32809.99,32476.909999999996
19046,U33561,69,11749.31,51,18,76081.56000000001,87830.87000000001
19047,U1063078,69,1118.5200000000002,35,34,7530.4800000000005,8649.0
19048,U17885,69,496.72000000000116,54,15,26328.01,26824.73
19049,U25879,69,6795.2199999999975,61,8,53431.479999999996,60226.7
19050,U34841,69,-144246.94999999998,36,33,461278.95,317032.0
19051,U36560,69,1496.7600000000002,55,14,21462.96,22959.72
19052,U30040,69,657.4800000000063,46,23,84611.55000000002,85269.03000000003
19053,U16307,69,-36729.18999999999,58,11,111338.90999999999,74609.72
19054,U1094040,69,4754.969999999999,46,23,23330.19,28085.159999999996
19055,U22095,69,-21939.759999999995,10,59,299237.33,277297.57
19056,U9153,69,5098.140000000001,63,6,3649.5200000000004,8747.660000000002
19057,U18796,69,-18499.000000000007,37,32,174788.25,156289.25
19058,U18183,69,293577.7300000001,59,10,11024.289999999999,304602.0200000001
19059,U38886,69,5441.480000000005,46,23,227569.12999999998,233010.61
19060,U30274,69,5021.649999999999,60,9,7509.37,12531.019999999999
19061,U34235,69,9081.720000000001,45,24,899509.4,908591.12
19062,U32777,69,-22276.889999999996,41,28,117785.54999999999,95508.65999999999
19063,U38030,69,-4166.339999999998,66,3,21548.600000000006,17382.26000000001
19064,U24178,69,-45285.8,56,13,93278.09999999999,47992.29999999999
19065,U11858,69,1325.2800000000034,45,24,23263.740000000005,24589.020000000008
19066,U29979,69,-3951.3700000000003,53,16,17144.71,13193.339999999998
19067,U22073,69,-9684.229999999996,45,24,63545.06,53860.83
19068,U17703,69,606.77,54,15,13707.709999999997,14314.479999999998
19069,U11926,69,-5089.110000000001,34,35,84738.7,79649.59
19070,U11403,69,-751.6399999999996,57,12,15254.16,14502.52
19071,U38696,69,-2356.81,60,9,13880.09,11523.28
19072,U32733,69,103.64000000000124,42,27,47406.119999999995,47509.759999999995
19073,U23561,69,-128106.55999999998,51,18,753476.5,625369.9400000001
19074,U13272,69,16844.940000000017,60,9,54148.91999999998,70993.85999999999
19075,U19323,69,-5648.999999999998,46,23,58408.240000000005,52759.240000000005
19076,U27651,68,871811.4899999995,58,10,4544.9400000000005,876356.4299999995
19077,U17878,68,743.77999999999,48,20,161661.73999999996,162405.51999999996
19078,U10648,68,-19527.18,57,11,57947.700000000004,38420.520000000004
19079,U19908,68,-2070.1299999999856,51,17,164659.5,162589.37000000002
19080,U14172,68,44840.919999999984,58,10,563415.9899999999,608256.9099999999
19081,U28545,68,50795.199999999975,45,23,67988.44,118783.63999999998
19082,U38453,68,65.52999999999767,62,6,64043.93,64109.46
19083,U1351676,68,-234.8700000000001,62,6,7344.530000000001,7109.660000000001
19084,U28513,68,-9148.839999999997,62,6,23233.68,14084.840000000004
19085,U22753,68,90663.04999999997,52,16,17674.189999999995,108337.23999999996
19086,U13177,68,-3706.930000000022,58,10,128881.05,125174.11999999998
19087,U1206325,68,4382.010000000001,48,20,10996.39,15378.400000000001
19088,U8271,68,855.2499999999995,62,6,8280.79,9136.04
19089,U16412,68,-213050.40999999992,41,27,366284.07999999996,153233.67000000004
19090,U28463,68,-16333.169999999996,63,5,28808.179999999997,12475.01
19091,U21363,68,2043.2100000000005,25,43,33911.63,35954.84
19092,U1165259,68,-10272.469999999998,42,26,53152.42,42879.95
19093,U10837,68,-45901.969999999994,45,23,194201.97999999998,148300.00999999998
19094,U13964,68,-754.6300000000083,57,11,112456.09999999999,111701.46999999999
19095,U39149,68,-19283.13,63,5,21187.440000000002,1904.3100000000013
19096,U1292271,68,-66.26000000000104,51,17,11405.400000000001,11339.140000000001
19097,U35920,68,840.3500000000677,31,37,3072165.81,3073006.16
19098,U17078,68,-574.5800000000013,44,24,77236.94,76662.36
19099,U29960,68,104.36999999999898,42,26,74775.99,74880.36
19100,U42420,68,-82322.37,50,18,608237.2799999999,525914.9099999999
19101,U30415,68,-673.2000000000007,60,8,22977.03,22303.829999999998
19102,U20103,68,-12564.180000000002,45,23,30397.79,17833.61
19103,U34516,68,-3908.319999999905,56,12,751684.73,747776.41
19104,U39664,68,3610.819999999987,39,29,668903.22,672514.0399999999
19105,U23374,68,254983.64,53,15,185978.69000000003,440962.3300000001
19106,U1155104,68,-86.73999999999921,42,26,23543.5,23456.760000000002
19107,U11103,68,-23185.040000000015,46,22,217687.33,194502.28999999998
19108,U27367,68,103464.48999999999,58,10,136226.00999999998,239690.49999999997
19109,U13115,68,-90794.64000000003,56,12,111811.9,21017.259999999966
19110,U30043,68,-591711.0100000005,34,34,7753419.709999999,7161708.699999998
19111,U12574,68,10038.99,51,17,62746.04000000001,72785.03000000001
19112,U8444,68,-3267.929999999997,53,15,54820.0,51552.07
19113,U34180,68,-10473.739999999998,61,7,100478.48,90004.73999999999
19114,U19756,68,1063.2700000000168,42,26,201450.56,202513.83000000002
19115,U29978,68,191.75000000000546,40,28,189663.24000000002,189854.99000000002
19116,U10151,68,5355.34,50,18,127482.01999999999,132837.36
19117,U12645,68,2547.7700000000013,58,10,16027.460000000001,18575.230000000003
19118,U43514,68,-9678.32000000001,55,13,98919.40999999999,89241.08999999998
19119,U41590,68,1849.2499999999977,30,38,683940.96,685790.21
19120,U15510,68,-5296.38,63,5,16638.839999999997,11342.459999999995
19121,U36955,68,21.200000000000387,51,17,27026.93999999999,27048.139999999992
19122,U29377,68,-15141.179999999997,49,19,46297.920000000006,31156.74000000001
19123,U1233720,68,2.240000000000066,45,23,2481.7199999999993,2483.9599999999996
19124,U14718,68,-1091.9599999999996,66,2,4086.5800000000004,2994.620000000001
19125,U27372,68,-1795.6500000000015,60,8,37349.94,35554.29
19126,U40279,68,68.99000000000888,51,17,46188.6,46257.59000000001
19127,U11208,68,3601.729999999993,51,17,74067.54000000001,77669.27
19128,U10907,68,-43080.80999999999,62,6,87805.20999999999,44724.4
19129,U17744,68,-129512.08,61,7,132641.96,3129.87999999999
19130,U32748,68,-13869.699999999995,43,25,144015.58,130145.87999999999
19131,U13243,68,-15926.290000000261,35,33,11079486.869999997,11063560.579999996
19132,U20584,68,-27415.34,58,10,78258.90000000001,50843.56000000001
19133,U43254,68,8094.740000000005,52,16,85965.05,94059.79000000001
19134,U40509,68,-7.329999999985721,64,4,39393.57,39386.24000000001
19135,U30129,68,1739.5499999999884,52,16,438475.95,440215.5
19136,U30911,68,72.70999999995809,49,19,3054200.0,3054272.71
19137,U17604,68,515040.85,29,39,3691921.35,4206962.2
19138,U9414,68,-683.6100000000031,44,24,110218.31999999999,109534.70999999999
19139,U42058,68,-3766.869999999989,39,29,319381.6000000001,315614.7300000001
19140,U35757,68,-8115.57,61,7,19389.51,11273.939999999999
19141,U30860,68,50953.999999999985,38,30,755609.15,806563.15
19142,U36733,68,-15312.63,47,21,242151.35,226838.72
19143,U25186,68,-135182.84000000003,64,4,146804.92,11622.079999999987
19144,U24465,68,-43570.89000000001,47,21,200361.29,156790.4
19145,U8357,68,-77.1799999999999,55,13,41088.92,41011.74
19146,U31155,68,-3103.5699999999997,58,10,8851.4,5747.83
19147,U28041,68,-57007.9,63,5,87440.06999999999,30432.16999999999
19148,U22764,68,5727.360000000001,60,8,31494.329999999994,37221.689999999995
19149,U857180,68,-9162.150000000001,47,21,19669.490000000005,10507.340000000004
19150,U16284,68,-146852.38000000003,37,31,545963.59,399111.20999999996
19151,U12081,68,-587.8899999999899,53,15,319580.04999999993,318992.1599999999
19152,U40756,68,-8958.10000000002,38,30,318985.96,310027.86
19153,U18232,68,28101.76000000001,59,9,50379.729999999996,78481.49
19154,U8617,68,-62610.91,46,22,484506.04,421895.13
19155,U10980,68,-5100.26,59,9,74808.46999999999,69708.20999999999
19156,U25964,68,-8180.9000000000015,44,24,146749.31,138568.41
19157,U12824,68,12118.09,47,21,83205.05000000002,95323.14000000001
19158,U32090,68,-4273.549999999996,50,18,55620.689999999995,51347.14
19159,U41415,68,-2140.240000000001,58,10,75709.21,73568.97
19160,U19600,68,-2664.0,51,17,17615.55,14951.55
19161,U8177,68,-45855.3,56,12,139694.4,93839.09999999999
19162,U33428,68,10812.34,60,8,11267.94,22080.28
19163,U11894,68,-6204.530000000001,66,2,6657.68,453.14999999999964
19164,U31603,68,619634.1400000004,32,36,13735068.1,14354702.24
19165,U42057,68,66.96999999999986,46,22,3781.9700000000003,3848.94
19166,U1010262,68,-3216.260000000002,60,8,10255.750000000007,7039.490000000005
19167,U845189,68,2.842170943040401e-14,36,32,3892.34,3892.34
19168,U36113,68,1930.750000000001,37,31,24904.269999999997,26835.019999999997
19169,U18784,68,-278.51,63,5,2474.0,2195.49
19170,U27986,68,18522.220000000034,39,29,712542.4,731064.6200000001
19171,U18375,68,-10081.449999999997,47,21,76125.15000000001,66043.70000000001
19172,U34015,68,35437.00000000004,51,17,309602.73,345039.73000000004
19173,U19459,68,-2520.960000000005,46,22,179216.09999999998,176695.13999999998
19174,U18614,68,-22292.619999999988,61,7,51305.979999999996,29013.360000000008
19175,U10957,68,-473671.06000000006,52,16,2337689.0,1864017.94
19176,U23064,68,-133629.01,44,24,738993.16,605364.15
19177,U43219,68,-4323.590000000001,60,8,17930.729999999996,13607.139999999996
19178,U27424,68,-11666.280000000006,62,6,30585.15000000001,18918.870000000003
19179,U40943,68,-286595.11999999994,45,23,942855.3200000001,656260.2000000002
19180,U19341,68,4907.600000000006,57,11,335488.49,340396.08999999997
19181,U19427,68,-121322.37,43,25,1201557.5899999999,1080235.2199999997
19182,U43146,68,1768.8900000000006,57,11,11239.56,13008.45
19183,U32010,68,-61198.52,53,15,183780.61,122582.09
19184,U38526,68,46841.69,59,9,75301.12999999999,122142.81999999999
19185,U26746,68,-31362.400000000005,50,18,261391.02000000002,230028.62000000002
19186,U34770,68,-50.49000000000018,56,12,12491.619999999999,12441.13
19187,U9657,68,-16114.820000000007,52,16,218992.13,202877.31
19188,U8592,68,10435.890000000014,58,10,134489.14,144925.03000000003
19189,U42280,68,8049.580000000018,56,12,519798.7599999999,527848.34
19190,U12778,68,10000.009999999991,59,9,27500.09,37500.09999999999
19191,U19964,68,8138.339999999998,56,12,30615.39999999997,38753.73999999997
19192,U18492,68,6316.91,60,8,39356.86000000001,45673.770000000004
19193,U15905,68,355662.46000000014,55,13,87501.37000000001,443163.83000000013
19194,U37423,68,-226310.89,59,9,271804.87,45493.97999999998
19195,U28827,68,8246.810000000016,51,17,92054.71,100301.52000000002
19196,U24115,68,4530.2699999999995,62,6,15057.36,19587.63
19197,U36148,68,-8471.029999999997,58,10,16533.479999999996,8062.449999999999
19198,U855210,68,-705.6600000000002,44,24,13139.269999999999,12433.609999999999
19199,U42390,68,-824.6200000000039,51,17,149930.78,149106.16
19200,U29092,68,-2765.8499999999995,62,6,6200.510000000001,3434.6600000000017
19201,U24805,68,656.0600000000007,62,6,25953.459999999995,26609.519999999997
19202,U40952,68,-16895.64,52,16,133226.57,116330.93000000001
19203,U13535,68,29873.030000000017,26,42,306272.6,336145.63
19204,U8819,68,2812.139999999994,46,22,129915.84,132727.97999999998
19205,U24012,68,1116.4299999999957,53,15,77724.90999999999,78841.33999999998
19206,U36492,68,6310.300000000002,59,9,53742.50000000002,60052.800000000025
19207,U25853,68,-596.7099999999984,64,4,47238.520000000004,46641.810000000005
19208,U19481,68,-805.7799999999988,41,27,38312.82,37507.04
19209,U24714,68,10320.519999999995,56,12,167611.83999999988,177932.35999999987
19210,U13692,68,29070.319999999996,56,12,39025.310000000005,68095.63
19211,U28981,68,-41698.57,55,13,59968.1,18269.53
19212,U21658,68,2930.979999999974,31,37,1131574.17,1134505.15
19213,U28998,68,51380.53999999999,52,16,126470.0,177850.53999999998
19214,U32684,68,-29352.850000000013,46,22,438129.19999999995,408776.3499999999
19215,U32583,68,94234.42000000004,55,13,238238.78,332473.20000000007
19216,U30579,68,-5204.200000000001,64,4,17564.1,12359.899999999998
19217,U17242,68,-51412.530000000006,44,24,343947.01,292534.48
19218,U16397,68,-34734.710000000014,63,5,58465.530000000006,23730.819999999992
19219,U28107,68,59719.10999999997,55,13,11626.729999999994,71345.83999999997
19220,U28321,68,21485.63,44,24,219706.12,241191.75
19221,U1221821,68,-1.8199999999998941,34,34,3344.4399999999996,3342.62
19222,U23849,68,79987.40999999996,56,12,91217.08,171204.48999999996
19223,U43718,68,-2420.5299999999997,44,24,21987.440000000002,19566.910000000003
19224,U40265,68,16749.250000000004,29,39,197471.23000000004,214220.48000000004
19225,U34525,68,882.7399999999866,40,28,343258.66000000003,344141.4
19226,U24140,68,-135444.09000000003,37,31,3919823.68,3784379.5900000003
19227,U35048,68,-5880.719999999999,47,21,37433.97999999999,31553.259999999987
19228,U32422,68,423.9899999999907,42,26,1018806.4,1019230.39
19229,U17995,68,14051.82000000001,52,16,98576.42000000001,112628.24000000002
19230,U27314,68,176.61000000000604,50,18,138099.38999999998,138276.0
19231,U24784,68,-8242.55000000001,48,20,149267.88999999998,141025.33999999997
19232,U23056,68,107235.75999999998,42,26,530597.82,637833.58
19233,U9454,68,90779.46,60,8,71582.48999999999,162361.95
19234,U33218,68,-5117.109999999986,36,32,859068.27,853951.16
19235,U600081,68,-4669.779999999999,43,25,33300.45,28630.67
19236,U28323,68,-2668.5699999999997,60,8,3861.6200000000003,1193.0500000000006
19237,U16079,68,-259.26000000000147,60,8,9962.05,9702.789999999997
19238,U14178,68,17482.620000000003,54,14,31199.35,48681.97
19239,U39374,68,180.2199999999989,64,4,16877.19,17057.409999999996
19240,U17437,68,-19370.149999999994,38,30,387144.10000000003,367773.95000000007
19241,U10255,68,6547.209999999997,51,17,51067.049999999996,57614.259999999995
19242,U12467,68,-7232.5300000000025,51,17,263668.31999999995,256435.78999999995
19243,U36220,68,3484.439999999988,34,34,146495.59000000003,149980.03000000003
19244,U17094,68,-603701.8600000001,47,21,1946121.5400000003,1342419.6800000002
19245,U8416,68,-2732.4599999999987,57,11,69665.87,66933.41
19246,U13180,68,-1716.87000000001,50,18,396961.23,395244.36
19247,U36362,68,-115493.68000000001,50,18,442938.7199999999,327445.0399999999
19248,U32150,68,6695.060000000003,52,16,81798.29000000001,88493.35
19249,U24690,68,-62196.34999999998,39,29,654355.22,592158.87
19250,U22315,68,-5574.089999999999,63,5,18120.21,12546.119999999999
19251,U15608,68,191886.57,53,15,385410.18,577296.75
19252,U28314,68,2925.8099999999827,53,15,138027.3,140953.10999999996
19253,U33972,68,-338.64999999999964,57,11,22479.389999999996,22140.739999999998
19254,U10728,68,1093.2999999999956,39,29,141166.80999999997,142260.10999999996
19255,U42603,68,899.7100000000025,38,30,40415.420000000006,41315.130000000005
19256,U9624,68,-16702.420000000002,59,9,100110.30000000002,83407.88000000002
19257,U25521,68,-82.70999999999913,38,30,45787.520000000004,45704.810000000005
19258,U33394,68,-20083.56000000001,51,17,154757.27000000002,134673.71000000002
19259,U14712,68,95436.18000000001,40,28,315583.60000000003,411019.78
19260,U17312,68,-7102.300000000005,53,15,106148.61000000003,99046.31000000003
19261,U10555,68,-59464.59999999999,62,6,291564.54000000004,232099.94000000006
19262,U31704,68,-810.0500000000018,37,31,60953.869999999995,60143.81999999999
19263,U27181,68,-48364.00999999999,53,15,165667.77,117303.76000000001
19264,U28271,68,-4765.7800000000125,63,5,25172.500000000015,20406.72
19265,U20558,68,-3912.369999999998,55,13,48095.229999999996,44182.86
19266,U25980,68,-22496.060000000005,60,8,106401.26,83905.19999999998
19267,U40535,68,49449.86000000001,41,27,198646.86,248096.72
19268,U16775,68,-48903.46999999995,44,24,1045298.7299999999,996395.2599999999
19269,U13930,68,79443.03999999992,51,17,1346851.46,1426294.5
19270,U15695,67,2744.3800000000015,55,12,32369.120000000003,35113.50000000001
19271,U1179492,67,466.1299999999992,48,19,19790.82,20256.949999999997
19272,U9748,67,2320.9400000000023,51,16,486008.0999999999,488329.0399999999
19273,U36862,67,18218.350000000002,39,28,220711.58,238929.93
19274,U16779,67,39511.85,59,8,28431.090000000004,67942.94
19275,U35442,67,2998.91,57,10,14438.009999999998,17436.92
19276,U30806,67,-1357.630000000002,47,20,100217.84999999999,98860.21999999999
19277,U43013,67,-6200.6500000000815,52,15,537781.2500000001,531580.6000000001
19278,U18884,67,181.28999999999996,54,13,28593.839999999997,28775.129999999997
19279,U21064,67,975.7700000000186,39,28,258995.05000000002,259970.82000000004
19280,U1171030,67,99.19000000000051,36,31,55251.84,55351.03
19281,U42262,67,13478.189999999997,51,16,55341.57000000002,68819.76000000002
19282,U26358,67,-27073.500000000004,58,9,42591.38000000001,15517.880000000008
19283,U16538,67,12880.459999999995,49,18,111379.65000000001,124260.11
19284,U31990,67,-2402.409999999997,53,14,42096.56,39694.15
19285,U35113,67,1000.0,33,34,56633.219999999994,57633.219999999994
19286,U11920,67,6921.500000000005,57,10,57610.4,64531.90000000001
19287,U1345851,67,-3591.1299999999965,41,26,66674.22,63083.090000000004
19288,U11525,67,-356004.00999999995,37,30,1511145.27,1155141.26
19289,U30100,67,3519.76,64,3,26690.0,30209.760000000002
19290,U38759,67,-164380.15,53,14,767250.52,602870.37
19291,U20376,67,8298.170000000002,49,18,37633.649999999994,45931.81999999999
19292,U771803,67,-2.050000000000873,48,19,63136.56999999995,63134.519999999946
19293,U29607,67,-10859.689999999999,49,18,56972.81,46113.119999999995
19294,U28594,67,-93120.86000000002,58,9,360790.7499999999,267669.8899999999
19295,U39762,67,2982.4000000000024,53,14,58454.090000000004,61436.490000000005
19296,U8950,67,60215.35999999999,50,17,139200.64,199416.0
19297,U19315,67,-47777.330000000016,48,19,186739.60999999996,138962.27999999994
19298,U9093,67,20142.899999999998,51,16,60062.17,80205.06999999999
19299,U15106,67,414.3099999999977,53,14,467433.82,467848.13
19300,U40259,67,-3794.7200000000007,63,4,8535.29,4740.57
19301,U36803,67,24630.020000000004,37,30,335161.79000000004,359791.81000000006
19302,U8070,67,-1109.0599999999708,48,19,350229.33,349120.27
19303,U29379,67,200540.66000000012,42,25,296279.34000000014,496820.00000000023
19304,U8241,67,18643.69,56,11,28244.28,46887.97
19305,U13701,67,-130217.42000000036,42,25,12515206.929999998,12384989.509999998
19306,U28679,67,-5205.570000000003,43,24,27082.159999999978,21876.589999999975
19307,U17882,67,6874.400000000005,45,22,36809.88,43684.28
19308,U606081,67,3829.8599999999988,37,30,43169.39,46999.25
19309,U43643,67,6583.360000000004,45,22,122898.73,129482.09
19310,U40280,67,95.91999999999825,56,11,96350.3,96446.22
19311,U13037,67,6091.780000000006,45,22,762575.7000000001,768667.4800000001
19312,U29031,67,8506.260000000007,48,19,74440.16,82946.42000000001
19313,U16383,67,-10683.420000000004,58,9,56668.11999999999,45984.69999999998
19314,U9892,67,736.8100000000018,55,12,25169.07,25905.88
19315,U20839,67,-13385.39,61,6,25509.450000000008,12124.060000000009
19316,U15173,67,15731.449999999999,51,16,371895.67000000004,387627.12000000005
19317,U1354363,67,218.21000000000117,42,25,32978.53,33196.74
19318,U17116,67,-17944.50000000003,33,34,128569.98,110625.47999999997
19319,U20600,67,-5686.559999999992,61,6,52729.56,47043.00000000001
19320,U1199566,67,5935.840000000003,36,31,32066.95,38002.79
19321,U10938,67,5241.519999999997,42,25,164179.6,169421.12
19322,U1091640,67,1058.320000000001,37,30,31713.349999999995,32771.67
19323,U20958,67,1555.4399999999996,56,11,14591.109999999999,16146.55
19324,U30368,67,3741.9300000000003,59,8,16620.17,20362.1
19325,U40440,67,-2329.6000000000013,42,25,41628.479999999996,39298.88
19326,U20253,67,-5600.610000000001,39,28,21626.47,16025.86
19327,U29479,67,-11720.040000000028,49,18,289685.39999999997,277965.3599999999
19328,U9159,67,-90590.13999999997,52,15,731973.1999999997,641383.0599999997
19329,U10091,67,-8505.02,63,4,24641.91,16136.89
19330,U23985,67,-5887.419999999999,56,11,20812.230000000003,14924.810000000005
19331,U29121,67,40596.02999999999,54,13,101247.76999999999,141843.8
19332,U9922,67,2563.399999999995,59,8,59970.760000000024,62534.16000000002
19333,U41739,67,-2959.5899999999733,45,22,117283.86999999998,114324.28000000001
19334,U32443,67,-6185.330000000001,62,5,22838.61,16653.28
19335,U11416,67,-118236.58999999998,51,16,267452.04000000004,149215.45000000007
19336,U13354,67,997297.55,54,13,492816.3799999999,1490113.93
19337,U43152,67,450.0899999999983,58,9,138500.66999999998,138950.75999999998
19338,U10611,67,-4594.92,59,8,18500.230000000007,13905.310000000007
19339,U41623,67,62939.87999999977,35,32,1768003.9300000002,1830943.81
19340,U18652,67,-1162.7199999999996,61,6,5326.049999999998,4163.329999999999
19341,U33848,67,-1014.1000000000006,59,8,11100.300000000001,10086.2
19342,U901268,67,1832.0599999999977,38,29,26610.250000000004,28442.31
19343,U42027,67,21.769999999998618,58,9,70732.81999999999,70754.59
19344,U13697,67,181191.37,56,11,112546.27000000002,293737.64
19345,U30420,67,-5248.08,60,7,8036.359999999999,2788.279999999999
19346,U14037,67,53893.779999999984,51,16,1087421.69,1141315.47
19347,U8135,67,-6787.990000000005,42,25,168112.68,161324.69
19348,U41763,67,2160.5699999999397,65,2,1038015.4400000001,1040176.01
19349,U12725,67,11761.14,57,10,380435.01,392196.15
19350,U15071,67,141852.24000000002,55,12,1294845.5299999998,1436697.7699999998
19351,U27522,67,-1799.3699999999992,64,3,10599.429999999997,8800.059999999998
19352,U27613,67,110.21999999999207,55,12,64473.11,64583.329999999994
19353,U37176,67,-1409.400000000008,58,9,44978.64,43569.23999999999
19354,U12399,67,74956.55999999994,46,21,819378.48,894335.0399999999
19355,U18179,67,19610.15,36,31,474200.51999999996,493810.67
19356,U13870,67,-15812.540000000005,44,23,89027.69,73215.15
19357,U35769,67,2916.1500000000015,54,13,62067.19,64983.340000000004
19358,U28343,67,-14619.330000000004,51,16,204930.36000000002,190311.03
19359,U10982,67,-30629.640000000007,55,12,47853.200000000004,17223.559999999998
19360,U9475,67,174409.74,45,22,155890.45,330300.19
19361,U31702,67,-19318.880000000005,61,6,56508.270000000004,37189.39
19362,U11332,67,21022.140000000003,56,11,77446.59000000001,98468.73000000001
19363,U39008,67,-4048.179999999992,49,18,204272.90000000002,200224.72000000003
19364,U35682,67,1168.6299999999992,62,5,19536.6,20705.229999999996
19365,U9763,67,-142248.55999999997,51,16,473193.93999999994,330945.38
19366,U35050,67,18038.21000000001,45,22,150735.52000000002,168773.73000000004
19367,U26556,67,127107.87999999999,59,8,111594.08000000003,238701.96000000002
19368,U23893,67,-494752.11,33,34,3306126.54,2811374.43
19369,U15594,67,-36148.0,46,21,4638286.8,4602138.8
19370,U42855,67,96.14000000000142,46,21,21496.89,21593.030000000002
19371,U36842,67,-8130.339999999999,59,8,29704.86,21574.52
19372,U28276,67,2214.260000000008,44,23,177564.20999999996,179778.46999999997
19373,U1248450,67,0.829999999998563,40,27,32802.8,32803.630000000005
19374,U20611,67,5183.12,52,15,150775.93,155959.05
19375,U15494,67,-6550.349999999991,50,17,184697.36,178147.01
19376,U37223,67,4891.640000000005,59,8,234922.80999999997,239814.44999999998
19377,U38405,67,25150.229999999992,52,15,49575.259999999995,74725.48999999999
19378,U17349,67,4820.219999999999,48,19,133632.3,138452.52
19379,U20039,67,2864.399999999992,64,3,914.5999999999996,3778.9999999999914
19380,U37051,67,-1052.3200000000004,41,26,40648.25,39595.93
19381,U41765,67,4891.019999999997,46,21,105851.58000000002,110742.6
19382,U10194,67,-4135.340000000032,36,31,480247.25,476111.91
19383,U21499,67,42231.170000000006,40,27,432448.82999999996,474679.99999999994
19384,U34515,67,9697.239999999998,47,20,79018.09,88715.32999999999
19385,U42432,67,-8127.920000000001,55,12,21297.750000000004,13169.830000000002
19386,U26027,67,10251.11,46,21,174410.03,184661.14
19387,U12130,67,-2252.14,58,9,11645.77,9393.630000000001
19388,U20663,67,1499.3500000000204,44,23,407558.83,409058.18000000005
19389,U28555,67,-335.4100000000001,50,17,20921.2,20585.79
19390,U42356,67,-22507.370000000006,50,17,106732.39000000003,84225.02000000002
19391,U23193,67,-464.330000000008,52,15,155434.77000000002,154970.44
19392,U35429,67,-71027.47000000002,56,11,231942.5,160915.02999999997
19393,U11673,67,22548.86,53,14,11997.69,34546.55
19394,U24818,67,421.7100000000255,36,31,1201395.3299999998,1201817.0399999998
19395,U24653,67,-34984.19999999997,55,12,1507434.0300000003,1472449.8300000003
19396,U9969,67,-32713.650000000012,44,23,82269.60999999997,49555.95999999996
19397,U38262,67,852.6499999999942,58,9,76220.07,77072.72
19398,U859620,67,-64126.22999999998,42,25,222076.21000000002,157949.98000000004
19399,U1221183,67,-3176.460000000001,42,25,58695.41,55518.950000000004
19400,U8814,67,-2911.9300000000007,52,15,25231.029999999995,22319.099999999995
19401,U16993,67,-94147.86999999998,47,20,318914.05,224766.18
19402,U25659,67,-4867.789999999999,47,20,45062.38,40194.59
19403,U36918,67,3.079999999998744,61,6,3961.3500000000017,3964.4300000000003
19404,U40693,67,-11305.789999999997,60,7,89072.28,77766.49
19405,U753068,67,2115.4899999999984,60,7,15668.7,17784.19
19406,U38276,67,2502.430000000003,58,9,14580.679999999995,17083.109999999997
19407,U37446,67,-272.8899999999994,51,16,7981.15,7708.26
19408,U34351,67,-66.57000000000163,53,14,13991.58,13925.009999999998
19409,U30779,67,2718.640000000001,43,24,47262.91000000001,49981.55000000001
19410,U35837,67,-882.1499999999987,42,25,40938.65,40056.5
19411,U22797,67,-4517.580000000001,48,19,8232.09,3714.5099999999993
19412,U9151,67,-203745.3700000005,54,13,1950306.9600000004,1746561.5899999999
19413,U13760,67,-1554.0099999999784,39,28,460744.35000000003,459190.3400000001
19414,U34485,67,12524.09,55,12,39723.99,52248.08
19415,U28110,67,2676.5199999999963,43,24,187120.65000000002,189797.17
19416,U29546,67,245.62999999999968,50,17,9333.58,9579.21
19417,U39119,67,-4440.569999999994,49,18,102325.76,97885.19
19418,U31490,67,-1167.379999999986,57,10,132256.50999999995,131089.12999999998
19419,U21754,67,-604.2500000000036,58,9,100177.48,99573.23
19420,U9500,67,2426.2000000000016,59,8,135958.99,138385.19
19421,U35671,67,56753.159999999974,36,31,195432.1,252185.25999999998
19422,U41586,67,-6961.049999999999,56,11,28924.54,21963.49
19423,U38117,67,-35929.61000000001,63,4,135283.59000000003,99353.98000000001
19424,U30536,67,-266.77999999998974,49,18,244523.44999999995,244256.66999999995
19425,U42953,67,-26325.010000000006,50,17,61224.03,34899.01999999999
19426,U25936,67,5068.029999999999,55,12,16818.440000000002,21886.47
19427,U20273,67,-17941.979999999996,44,23,219011.2,201069.22000000003
19428,U38275,67,-388.9699999999998,52,15,13882.12,13493.150000000001
19429,U28636,67,-23688.959999999992,36,31,262295.0,238606.04
19430,U14632,67,154571.34,47,20,440890.98,595462.32
19431,U15862,67,-57529.94000000009,54,13,219763.22000000003,162233.27999999994
19432,U22801,67,-1086.1799999999967,47,20,77771.27000000002,76685.09000000003
19433,U1000997,67,444.1399999999999,41,26,4223.74,4667.879999999999
19434,U18198,67,6240.580000000004,52,15,66010.44,72251.02
19435,U41310,67,-2101.7199999996465,46,21,2821685.5799999996,2819583.86
19436,U10973,67,-3464.2799999999997,52,15,21794.95,18330.670000000002
19437,U23991,67,-74220.85,59,8,93032.01000000001,18811.160000000003
19438,U30593,67,-11839.470000000001,58,9,43253.01,31413.54
19439,U42405,67,20773.699999999662,29,38,3698963.7800000003,3719737.48
19440,U16078,67,1089.5700000000008,53,14,24380.96,25470.53
19441,U42687,67,-1834.5500000000013,57,10,25419.79,23585.239999999998
19442,U35101,67,1847.1400000000067,56,11,90108.01,91955.15
19443,U9115,67,6000.9499999999225,38,29,2209489.6199999996,2215490.5699999994
19444,U29683,67,-6934.130000000002,64,3,16871.63,9937.5
19445,U31807,67,10573.220000000001,48,19,169496.24,180069.46
19446,U36658,67,-25078.020000000004,47,20,49715.969999999994,24637.94999999999
19447,U36236,67,1393.0400000000097,54,13,154154.9,155547.94
19448,U16244,67,-7884.490000000015,35,32,2044773.82,2036889.33
19449,U34137,67,2876.950000000008,51,16,172880.21,175757.16
19450,U971353,67,-26753.179999999993,44,23,62605.63000000001,35852.45000000002
19451,U33860,67,-15.000000000020009,39,28,1399548.79,1399533.79
19452,U39248,67,-1818.9600000000064,59,8,29919.739999999998,28100.77999999999
19453,U29030,67,1379.1100000000042,52,15,62529.15000000001,63908.26000000001
19454,U33396,67,80201.16000000009,52,15,573695.15,653896.31
19455,U11132,66,-5281.429999999999,47,19,8383.029999999999,3101.5999999999995
19456,U22363,66,2666.21999999999,54,12,75081.17,77747.38999999998
19457,U31263,66,1827.2999999999993,46,20,233741.65000000002,235568.95
19458,U11072,66,-114061.2099999999,35,31,1310820.98,1196759.77
19459,U30601,66,116442.57,54,12,72236.68,188679.25
19460,U24769,66,26139.15,53,13,13681.439999999999,39820.59
19461,U24299,66,-14778.930000000008,54,12,155062.86999999997,140283.93999999994
19462,U40698,66,12181.479999999998,40,26,4995.93,17177.409999999996
19463,U19058,66,-55948.67999999999,50,16,72719.25,16770.570000000007
19464,U8223,66,-2032.0400000000009,42,24,100067.14,98035.1
19465,U16152,66,38440.19,51,15,171537.55000000002,209977.74000000002
19466,U33169,66,-6901.14,59,7,21877.54,14976.400000000001
19467,U22847,66,26.94999999999527,30,36,173612.14,173639.09
19468,U37482,66,-45979.03000000001,48,18,442351.82000000007,396372.79000000004
19469,U20094,66,-1458.0900000000042,51,15,34640.17999999999,33182.08999999999
19470,U22591,66,19766.04999999993,58,8,674424.3,694190.35
19471,U31881,66,245.40999999999786,49,17,53880.189999999995,54125.59999999999
19472,U25049,66,-1879.0300000000134,43,23,631307.03,629428.0
19473,U1240858,66,15.200000000000273,34,32,7837.560000000001,7852.760000000002
19474,U9986,66,3444.3300000000017,46,20,45557.0,49001.33
19475,U17821,66,-30814.920000000002,55,11,73929.53,43114.61
19476,U36484,66,-618.2800000000235,52,14,1135516.84,1134898.56
19477,U12826,66,-3283.3799999999974,47,19,95974.07000000002,92690.69000000003
19478,U19300,66,1077.1100000000001,55,11,2525.840000000001,3602.950000000001
19479,U38603,66,-25247.209999999992,54,12,40736.810000000005,15489.600000000013
19480,U42146,66,-122.62000000000171,41,25,225380.93999999997,225258.31999999998
19481,U21960,66,-9059.719999999983,58,8,221093.02999999988,212033.3099999999
19482,U23984,66,1325.7700000000332,33,33,1273420.98,1274746.75
19483,U34741,66,-22502.969999999987,47,19,124652.21999999999,102149.25
19484,U22219,66,7990.7300000000105,49,17,290104.92,298095.65
19485,U24594,66,-6909.08,56,10,19383.78,12474.699999999999
19486,U18170,66,1926.550000000003,56,10,152989.26,154915.81
19487,U18066,66,-7062.109999999999,59,7,10187.170000000004,3125.060000000005
19488,U27549,66,7234.420000000014,51,15,204017.9,211252.32
19489,U26053,66,-4305.43,57,9,5914.59,1609.1599999999999
19490,U36892,66,42671.67,46,20,135252.24,177923.90999999997
19491,U14322,66,1732954.9,50,16,2228533.63,3961488.53
19492,U30707,66,-26754.899999999994,43,23,167129.14,140374.24000000002
19493,U32375,66,-242199.21000000002,62,4,254895.16,12695.949999999983
19494,U11868,66,-1689.869999999999,51,15,49055.68,47365.81
19495,U19330,66,937.33000000003,38,28,374829.55,375766.88
19496,U31865,66,24573.000000000025,53,13,87962.93000000001,112535.93000000004
19497,U8305,66,19662.380000000005,52,14,148537.46,168199.84
19498,U24158,66,-806.4000000000051,35,31,250973.80000000002,250167.40000000002
19499,U13983,66,-65.32000000000357,48,18,23350.970000000005,23285.65
19500,U20517,66,311060.57,53,13,1129844.65,1440905.22
19501,U10134,66,44593.33999999999,43,23,222245.88000000003,266839.22000000003
19502,U30072,66,2588.7699999999895,42,24,915000.5,917589.27
19503,U12380,66,20745.389999999996,42,24,99692.35,120437.74
19504,U22774,66,977.2500000000018,46,20,72465.47,73442.72
19505,U17341,66,-4999.35,53,13,20151.4,15152.050000000001
19506,U29426,66,4154.720000000001,52,14,32144.700000000004,36299.420000000006
19507,U36040,66,19081.389999999992,52,14,43851.46999999999,62932.85999999998
19508,U42921,66,262303.3,54,12,94851.56000000001,357154.86
19509,U8642,66,12683.700000000015,44,22,456740.60000000003,469424.30000000005
19510,U32504,66,8767.819999999996,52,14,125180.48999999999,133948.31
19511,U972061,66,-936.1999999999998,41,25,18740.39,17804.19
19512,U38432,66,-209.50999999999857,40,26,98246.27,98036.76000000001
19513,U34284,66,-5.349999999999454,34,32,26824.77,26819.420000000002
19514,U36099,66,5507.4400000000005,45,21,70886.83,76394.27
19515,U20865,66,-7118.009999999995,57,9,28045.03,20927.020000000004
19516,U34347,66,-67582.70000000001,49,17,486314.76,418732.06
19517,U956368,66,150.14000000000044,33,33,44653.87,44804.01
19518,U27335,66,-6543.360000000001,50,16,224784.56000000003,218241.2
19519,U30969,66,-62698.55000000004,51,15,415496.7499999999,352798.19999999984
19520,U14833,66,4523.349999999995,58,8,87792.08,92315.43
19521,U15966,66,-11234.83999999995,50,16,368233.1700000001,356998.33000000013
19522,U13190,66,-156897.61000000004,51,15,1240507.68,1083610.0699999998
19523,U16169,66,158891.63,27,39,928875.81,1087767.44
19524,U9350,66,-3053.209999999986,40,26,236907.49000000005,233854.28000000006
19525,U39395,66,41153.58,36,30,93841.92,134995.5
19526,U1056021,66,-506.74,58,8,3295.4500000000003,2788.71
19527,U12122,66,4984.8399999999965,45,21,383600.1699999999,388585.0099999999
19528,U22538,66,617.4100000000069,29,37,436724.27,437341.68000000005
19529,U9011,66,10964.310000000001,59,7,14693.57,25657.88
19530,U641890,66,2061.1400000000012,39,27,25063.79,27124.93
19531,U22503,66,15159.499999999995,47,19,15269.160000000003,30428.659999999996
19532,U1119522,66,765.3300000000002,54,12,20491.739999999998,21257.07
19533,U29477,66,5216.630000000033,36,30,1405009.0000000002,1410225.6300000004
19534,U15129,66,27100.30000000001,49,17,59571.8,86672.1
19535,U32221,66,868334.3499999994,53,13,498100.51000000007,1366434.8599999994
19536,U13068,66,-38.5,34,32,65399.53,65361.03
19537,U24245,66,-7172.120000000001,53,13,103294.89000000001,96122.77000000002
19538,U11253,66,-4615.02,60,6,14049.67,9434.65
19539,U10355,66,-25157.43999999999,54,12,131212.58000000002,106055.14000000003
19540,U12320,66,-30591.36,48,18,108283.55000000003,77692.19000000003
19541,U32122,66,-2898.409999999999,54,12,100216.36000000002,97317.95000000001
19542,U34321,66,-1179.3799999999994,55,11,5062.510000000002,3883.130000000003
19543,U27317,66,391152.68999999994,48,18,243939.03999999998,635091.73
19544,U32563,66,-8170.170000000013,53,13,278410.59,270240.42000000004
19545,U36791,66,-14709.419999999996,55,11,52074.05000000002,37364.63000000002
19546,U43414,66,-1340.1499999999978,51,15,55266.94,53926.79000000001
19547,U11431,66,-13591.2,58,8,17213.32,3622.119999999999
19548,U14355,66,-37537.19,55,11,169199.64,131662.45
19549,U19425,66,-1094.2900000000002,50,16,21076.09,19981.8
19550,U35506,66,-9867.5,35,31,287077.37000000005,277209.87000000005
19551,U8249,66,196790.49,53,13,122281.14000000001,319071.63
19552,U21203,66,-11739.48999999999,49,17,1140934.9700000002,1129195.4800000002
19553,U33691,66,-13425.380000000001,47,19,17248.870000000003,3823.4900000000016
19554,U37980,66,-31080.5,57,9,48653.03999999999,17572.539999999994
19555,U32827,66,2119.709999999999,46,20,193474.19999999998,195593.90999999997
19556,U29330,66,6752.3499999999985,47,19,150724.56,157476.91
19557,U8162,66,17281.839999999997,50,16,63010.90000000002,80292.74000000002
19558,U8425,66,-1843.240000000007,52,14,192375.33000000002,190532.09
19559,U26726,66,-616.5999999999694,46,20,551219.33,550602.73
19560,U22897,66,-880.0299999999988,50,16,75504.18,74624.15
19561,U17522,66,-184539.96999999997,49,17,4908935.03,4724395.0600000005
19562,U26690,66,10748.269999999993,56,10,36902.7,47650.96999999999
19563,U15837,66,-571.840000000007,45,21,113727.23999999987,113155.39999999986
19564,U33005,66,-336.59999999999013,47,19,61655.38999999999,61318.79
19565,U37884,66,-456.099999999999,45,21,23456.760000000006,23000.660000000007
19566,U23598,66,-167998.33999999997,50,16,939990.61,771992.27
19567,U20123,66,28126.049999999992,41,25,78541.13999999998,106667.18999999997
19568,U10516,66,3399.9999999999995,14,52,10014.27,13414.27
19569,U13185,66,-13326.910000000003,58,8,37702.58,24375.67
19570,U1146237,66,-60.199999999999505,36,30,13815.97,13755.77
19571,U19982,66,23750.63999999999,33,33,713636.91,737387.55
19572,U13371,66,167.57999999999834,55,11,37003.020000000004,37170.600000000006
19573,U22466,66,-690.4400000000004,57,9,8010.98,7320.539999999999
19574,U8869,66,228407.74000000002,57,9,556211.78,784619.52
19575,U13097,66,-13543.039999999972,49,17,415521.64999999997,401978.61
19576,U37438,66,-18744.79,53,13,76479.75000000001,57734.960000000014
19577,U13859,66,-27102.230000000014,56,10,963668.62,936566.39
19578,U32147,66,27614.309999999987,56,10,44027.78,71642.08999999998
19579,U22132,66,-1931.8499999999958,57,9,75754.15000000001,73822.30000000002
19580,U26988,66,-147038.16999999998,36,30,550888.25,403850.08
19581,U12603,66,378269.04000000004,35,31,958285.9,1336554.94
19582,U35718,66,-626.289999999999,51,15,86496.81999999999,85870.53
19583,U9651,66,-28703.09000000001,27,39,92314.27000000002,63611.18000000001
19584,U37225,66,-24831.25,48,18,78249.39,53418.14
19585,U42327,66,-988.1999999999998,59,7,3851.0999999999995,2862.8999999999996
19586,U33102,66,5899.509999999998,43,23,46756.28,52655.78999999999
19587,U33031,66,-14465.779999999999,53,13,70569.12999999999,56103.34999999999
19588,U34454,66,85949.91000000002,46,20,53914.090000000004,139864.00000000003
19589,U35386,66,23202.420000000013,55,11,287026.86,310229.28
19590,U29935,66,3650.5899999999965,49,17,304245.00000000006,307895.5900000001
19591,U12319,66,-25568.709999999985,52,14,264064.74,238496.03
19592,U30773,66,-2086.27,46,20,64353.17,62266.9
19593,U35468,66,-21440.830000000005,59,7,41880.0,20439.169999999995
19594,U21528,66,-2586.5599999999977,51,15,208490.82,205904.26
19595,U27630,66,4129.299999999999,48,18,27407.33,31536.63
19596,U36764,66,29846.130000000016,43,23,251882.71000000002,281728.84
19597,U623001,66,1824.5899999999997,51,15,4572.5199999999995,6397.109999999999
19598,U24828,66,7250.480000000003,35,31,230799.50999999998,238049.99
19599,U36155,66,6282.090000000004,43,23,44960.10999999999,51242.2
19600,U32906,66,-2762.3799999999983,55,11,23504.17,20741.79
19601,U37013,66,1871.6800000000003,43,23,171716.94,173588.62
19602,U28208,66,222.30000000000064,34,32,90514.85999999999,90737.15999999999
19603,U32517,66,-599350.47,46,20,1322470.71,723120.24
19604,U30111,66,-20563.11,56,10,93158.26999999999,72595.15999999999
19605,U11711,66,4335.360000000004,49,17,141883.45,146218.81000000003
19606,U22941,66,-138993.08,55,11,284193.58,145200.50000000003
19607,U13247,66,-11577.069999999998,34,32,96141.34,84564.27
19608,U823324,66,-118.67000000000007,49,17,3022.7000000000003,2904.03
19609,U19932,66,1386467.8,51,15,313166.32,1699634.12
19610,U14713,66,-14050.420000000002,53,13,93727.18999999997,79676.76999999997
19611,U25750,66,-1893.3900000000322,33,33,201677.02,199783.62999999995
19612,U24683,66,-20146.129999999997,52,14,52690.03000000001,32543.900000000016
19613,U38835,66,1636.0099999999984,34,32,68264.51000000001,69900.52
19614,U688879,66,-2615.7200000000003,35,31,76160.54000000001,73544.82
19615,U29483,66,213432.94,56,10,177499.56,390932.5
19616,U16828,66,25491.96000000002,40,26,324821.25,350313.21
19617,U9128,66,11026.300000000001,51,15,44713.200000000004,55739.50000000001
19618,U38644,66,-135221.22000000003,47,19,362783.37999999995,227562.15999999992
19619,U13631,66,14153.660000000003,40,26,377705.7,391859.36
19620,U14138,66,-1271.1599999999999,49,17,88643.71000000002,87372.55000000002
19621,U1366638,66,475.52000000000226,46,20,24337.579999999998,24813.1
19622,U30245,66,9918.259999999995,57,9,63053.909999999996,72972.16999999998
19623,U27749,66,-512.1200000000008,62,4,4342.490000000001,3830.37
19624,U19830,66,-4180.580000000001,62,4,7662.939999999999,3482.359999999998
19625,U21347,66,-3887.9799999999977,53,13,27213.85,23325.870000000003
19626,U14977,66,-1999.8099999999988,39,27,425501.57000000007,423501.76000000007
19627,U39294,66,-6671.809999999994,44,22,70385.0,63713.19
19628,U16142,66,-48424.58999999999,39,27,239079.72,190655.13
19629,U21553,66,-154506.78999999998,49,17,614816.1699999998,460309.37999999983
19630,U17826,66,-216.3,45,21,33804.33,33588.03
19631,U20061,66,22846.95,36,30,195692.56999999998,218539.52
19632,U20858,66,-1265.03999999995,38,28,898229.0,896963.9600000001
19633,U12088,66,988.2399999999969,48,18,58666.819999999985,59655.05999999998
19634,U35016,66,-9615.45,59,7,54355.56,44740.11
19635,U21756,66,-84230.69999999997,52,14,230950.68999999997,146719.99
19636,U22886,66,472.6200000000026,59,7,82373.29000000001,82845.91
19637,U21428,66,1683.4200000000012,55,11,20820.769999999997,22504.19
19638,U23514,65,-5016.210000000008,48,17,268065.82,263049.61
19639,U21389,65,-129009.63,46,19,753885.2000000001,624875.5700000001
19640,U30825,65,6170.6,31,34,80483.12999999999,86653.73
19641,U42273,65,-81.03999999999873,40,25,25748.0,25666.960000000003
19642,U23821,65,1272.9900000000007,57,8,17228.82,18501.81
19643,U39133,65,25535.959999999934,44,21,1687818.87,1713354.83
19644,U42212,65,-2123.5800000000054,57,8,22338.02,20214.439999999995
19645,U38120,65,21753.359999999997,41,24,215123.64,236877.0
19646,U34401,65,-11427.77,62,3,13404.71,1976.9399999999987
19647,U24803,65,1530.83,59,6,10142.300000000001,11673.130000000001
19648,U17517,65,438.88999999999965,46,19,80517.95999999999,80956.84999999999
19649,U21694,65,1549.5099999999995,41,24,28852.840000000004,30402.350000000002
19650,U34255,65,45281.91,37,28,581951.24,627233.15
19651,U9214,65,1171.4500000000003,56,9,35401.619999999995,36573.06999999999
19652,U35258,65,1458.7700000000004,29,36,38543.299999999996,40002.06999999999
19653,U43734,65,643.4400000000005,54,11,17643.440000000002,18286.880000000005
19654,U38769,65,354179.80000000005,55,10,51278.310000000005,405458.11000000004
19655,U40412,65,4927.280000000001,59,6,11789.619999999999,16716.9
19656,U15747,65,50260.980000000025,41,24,599636.5399999999,649897.5199999999
19657,U41714,65,-6824.270000000004,53,12,48875.42999999999,42051.15999999999
19658,U40659,65,1751.82,56,9,463855.74000000005,465607.56000000006
19659,U36252,65,14634.890000000043,59,6,360569.04,375203.93000000005
19660,U33227,65,16.809999999990893,61,4,10438.220000000003,10455.029999999993
19661,U16090,65,-6528.500000000018,36,29,922609.6900000001,916081.1900000001
19662,U42622,65,-1866.5899999999892,52,13,223666.38000000003,221799.79000000004
19663,U35144,65,1716.989999999997,54,11,69480.13000000002,71197.12000000001
19664,U10379,65,344.95999999993364,21,44,1072506.0,1072850.96
19665,U36867,65,1643.7399999999989,48,17,15503.789999999997,17147.529999999995
19666,U42251,65,29272.399999999983,52,13,29666.909999999996,58939.30999999998
19667,U27717,65,-2390.2099999999937,55,10,33352.00000000001,30961.790000000015
19668,U20136,65,-1404.7700000000011,58,7,28287.710000000003,26882.940000000002
19669,U26167,65,7764.380000000001,53,12,28450.699999999993,36215.079999999994
19670,U39920,65,-276852.99000000005,43,22,412057.3300000001,135204.34000000003
19671,U40420,65,-49513.2299999999,27,38,1804424.22,1754910.99
19672,U18719,65,-4184.539999999999,48,17,107649.24,103464.70000000001
19673,U39528,65,-982993.7200000001,40,25,3353789.9,2370796.1799999997
19674,U39729,65,90012.07999999999,28,37,1018491.12,1108503.2
19675,U30321,65,-10582.989999999998,49,16,112605.27999999998,102022.28999999998
19676,U40526,65,-21.259999999999735,53,12,4711.740000000001,4690.480000000001
19677,U18710,65,-14465.46,62,3,35386.11,20920.65
19678,U40667,65,73968.59000000004,30,35,916105.5499999999,990074.14
19679,U39624,65,39050.84000000003,32,33,528657.09,567707.93
19680,U16723,65,8083.849999999997,59,6,10109.379999999997,18193.229999999996
19681,U26620,65,2427.410000000018,30,35,289613.9,292041.31000000006
19682,U35613,65,725.1299999999995,55,10,35615.82,36340.95
19683,U8514,65,1840.489999999977,45,20,143751.88999999998,145592.37999999998
19684,U973618,65,0.5700000000002223,35,30,19739.56,19740.13
19685,U38843,65,-9390.229999999992,27,38,599685.52,590295.29
19686,U17360,65,-96396.09999999999,54,11,163605.03999999992,67208.93999999993
19687,U27698,65,3707.2700000000004,54,11,17773.96,21481.23
19688,U28978,65,180.02999999999997,58,7,7313.199999999999,7493.229999999999
19689,U24667,65,-23240.37,41,24,188763.21000000002,165522.84000000003
19690,U39613,65,-931.7699999999993,58,7,10601.85,9670.080000000002
19691,U26494,65,-35214.97000000001,52,13,124888.91999999998,89673.94999999998
19692,U12659,65,-1971.6400000000024,40,25,482429.5,480457.86
19693,U23744,65,-215542.61,49,16,717718.78,502176.17000000004
19694,U11143,65,-1740.0100000000014,45,20,57658.850000000006,55918.840000000004
19695,U23898,65,-8537.73,52,13,137144.43,128606.7
19696,U23785,65,26305.660000000036,54,11,1544007.77,1570313.4300000002
19697,U17283,65,-485771.26,37,28,1692533.4799999995,1206762.2199999995
19698,U11545,65,-3108.380000000001,37,28,64800.969999999994,61692.59
19699,U17379,65,-133755.13999999998,47,18,681020.7200000001,547265.5800000001
19700,U8464,65,-5965.799999999995,43,22,148996.96000000005,143031.16000000006
19701,U40068,65,-55260.36,55,10,90869.3,35608.94
19702,U26477,65,2399.7899999999986,58,7,25042.37,27442.159999999996
19703,U27045,65,35247.60999999999,46,19,159780.43999999997,195028.04999999996
19704,U31638,65,69.25999999999914,60,5,6175.05,6244.3099999999995
19705,U21503,65,-13758.550000000003,58,7,204609.0,190850.45
19706,U20541,65,-13986.059999999998,52,13,20022.51,6036.450000000001
19707,U18535,65,5185.4,52,13,9563.55,14748.949999999999
19708,U16570,65,-12786.139999999994,46,19,441534.26000000007,428748.12000000005
19709,U9196,65,-365.3000000000102,48,17,206238.04,205872.74
19710,U37284,65,-29883.210000000006,41,24,125114.72999999998,95231.51999999997
19711,U16990,65,-3186.639999999983,41,24,856029.46,852842.82
19712,U17399,65,-373232.4900000001,48,17,534711.5800000002,161479.09000000008
19713,U19489,65,-12884.619999999995,50,15,82533.13,69648.51000000001
19714,U39305,65,-31252.02,49,16,142971.37,111719.34999999999
19715,U8461,65,-10478.500000000007,48,17,182135.05,171656.55
19716,U14466,65,1978.4300000000167,52,13,1197892.4700000002,1199870.9000000001
19717,U16683,65,-73682.5,54,11,184950.13,111267.63
19718,U9327,65,-36225.13999999999,45,20,254979.92000000004,218754.78000000006
19719,U25872,65,2189.729999999999,43,22,10693.749999999995,12883.479999999994
19720,U35921,65,-15822.749999999995,60,5,16721.459999999995,898.710000000001
19721,U747043,65,-70458.58,45,20,108315.3,37856.72
19722,U34196,65,14336.93,49,16,15403.980000000003,29740.910000000003
19723,U9863,65,5990.299999999998,54,11,77187.98,83178.28
19724,U11649,65,21026.299999999996,37,28,434905.36,455931.66
19725,U28905,65,17268.14,55,10,40216.71,57484.85
19726,U11702,65,-30903.09,56,9,62856.69,31953.600000000002
19727,U42254,65,-3920.390000000001,55,10,6085.030000000001,2164.64
19728,U1379852,65,-57.20999999999997,50,15,6008.900000000001,5951.6900000000005
19729,U840100,65,221.99999999999963,38,27,3160.210000000001,3382.2100000000005
19730,U11439,65,-43691.27999999997,35,30,493676.10000000003,449984.82000000007
19731,U16824,65,-176365.93999999994,29,36,754152.45,577786.51
19732,U43974,65,-5635.799999999982,41,24,435973.3599999999,430337.55999999994
19733,U13504,65,5178.840000000001,50,15,17955.0,23133.84
19734,U12598,65,-6317.480000000003,57,8,28009.899999999998,21692.419999999995
19735,U23999,65,50111.14000000006,44,21,5399232.5200000005,5449343.66
19736,U27932,65,-15535.429999999997,49,16,172234.36000000002,156698.93000000002
19737,U9466,65,-7137.019999999997,51,14,126647.99999999999,119510.97999999998
19738,U38607,65,345.189999999999,49,16,61958.3,62303.490000000005
19739,U15099,65,39519.369999999995,53,12,99110.04000000001,138629.41
19740,U1374923,65,-4388.159999999999,52,13,28163.53,23775.37
19741,U13660,65,-379394.77999999915,41,24,6082791.619999999,5703396.84
19742,U13156,65,4775.120000000003,50,15,190101.52,194876.63999999998
19743,U39337,65,14677.76,51,14,20462.980000000003,35140.740000000005
19744,U11887,65,-12316.489999999998,45,20,134221.85,121905.36000000002
19745,U22386,65,166663.67999999993,52,13,174656.56000000006,341320.24
19746,U38693,65,15713.210000000003,37,28,16574.370000000003,32287.580000000005
19747,U42061,65,-78545.65999999995,46,19,1999261.6,1920715.9400000002
19748,U38722,65,-3928.8300000000163,47,18,774095.98,770167.1499999999
19749,U14309,65,4011.59,54,11,44107.6,48119.19
19750,U30161,65,-21788.97000000001,42,23,179674.55000000002,157885.58000000002
19751,U32081,65,7671.31999999984,29,36,3173578.28,3181249.5999999996
19752,U12770,65,-2984.640000000003,42,23,102865.23000000001,99880.59000000001
19753,U42216,65,-6824.17,54,11,25278.37,18454.199999999997
19754,U36981,65,25.42000000000064,39,26,28818.920000000006,28844.340000000007
19755,U14930,65,369812.7700000001,44,21,456607.60000000003,826420.3700000001
19756,U25564,65,3888.56,47,18,11896.469999999998,15785.029999999997
19757,U32245,65,-62409.490000000005,36,29,367905.36,305495.87
19758,U40725,65,-1304.0100000000007,51,14,107043.00000000003,105738.99000000003
19759,U32953,65,7769.240000000002,55,10,32416.18000000001,40185.42000000001
19760,U15229,65,121497.13,52,13,112469.98,233967.11
19761,U41712,65,3476.3100000000068,44,21,52208.22,55684.530000000006
19762,U42202,65,-33118.21999999999,30,35,159718.02,126599.8
19763,U930774,65,0.47999999999975707,47,18,7198.33,7198.8099999999995
19764,U16176,65,2712.4,60,5,9297.339999999998,12009.739999999998
19765,U36144,65,-1621.779999999993,51,14,194885.36,193263.58
19766,U39878,65,11322.419999999987,41,24,296112.22000000003,307434.64
19767,U10543,65,-8645.030000000017,52,13,131650.81,123005.77999999998
19768,U8432,65,555.2099999999991,48,17,72951.76,73506.97
19769,U18778,65,-72628.01000000001,58,7,116526.64000000001,43898.630000000005
19770,U12067,65,-40439.81999999999,49,16,167155.50999999998,126715.68999999999
19771,U38774,65,-8794.200000000019,53,12,160760.42999999996,151966.22999999995
19772,U9723,65,-141435.64999999994,51,14,210427.05999999985,68991.40999999992
19773,U20190,65,-58905.299999999996,58,7,203546.21,144640.91
19774,U25267,65,-33576.82000000001,53,12,196611.06999999998,163034.24999999997
19775,U31406,65,17612.1,51,14,53012.13000000001,70624.23000000001
19776,U27646,65,-8343.869999999999,55,10,202976.42,194632.55000000002
19777,U37481,65,3368.430000000015,47,18,555438.34,558806.77
19778,U23724,65,5694.549999999999,58,7,14035.880000000001,19730.43
19779,U32023,65,-1353.88,59,6,7153.1799999999985,5799.299999999998
19780,U38761,65,-705.0600000000001,59,6,5999.040000000001,5293.9800000000005
19781,U24592,65,269.3000000000004,59,6,5258.36,5527.66
19782,U977748,65,-5.0,48,17,15599.400000000001,15594.400000000001
19783,U687464,65,-8135.060000000001,54,11,12909.98,4774.919999999998
19784,U12322,65,-9911.54,56,9,20766.11,10854.57
19785,U15548,65,3526.630000000008,29,36,304954.59,308481.22000000003
19786,U32707,65,-5247.340000000016,56,9,121001.18999999999,115753.84999999998
19787,U11142,65,186423.09999999995,42,23,389899.6,576322.7
19788,U29027,65,-7399.710000000001,54,11,46692.789999999986,39293.07999999999
19789,U21058,65,-14753.570000000007,40,25,569853.96,555100.3899999999
19790,U910051,65,-409.32000000000016,55,10,11058.400000000001,10649.080000000002
19791,U31633,65,-13612.999999999996,44,21,666878.48,653265.48
19792,U993669,65,-28169.379999999997,38,27,51416.590000000004,23247.210000000006
19793,U8387,65,20166.659999999996,47,18,58393.14000000001,78559.8
19794,U23843,65,-503721.24,52,13,4524931.309999999,4021210.0699999984
19795,U32351,65,-476.0899999999947,51,14,331929.74,331453.65
19796,U20233,65,-8815.67,52,13,20928.1,12112.429999999998
19797,U17056,65,-1094.4599999999627,36,29,8036544.0,8035449.54
19798,U12857,65,-3388.3999999999996,50,15,162619.11,159230.71
19799,U976727,65,-11572.42,41,24,66778.43000000001,55206.01000000001
19800,U744319,65,1.7300000000000466,44,21,4684.43,4686.160000000001
19801,U26871,65,-21547.090000000004,57,8,154278.09999999998,132731.00999999998
19802,U33056,65,1554119.84,49,16,649450.8,2203570.64
19803,U30218,65,-481769.15,49,16,780333.84,298564.68999999994
19804,U41487,65,1010.3299999999945,48,17,70447.64,71457.97
19805,U8109,65,-556.5499999999815,47,18,636561.3300000001,636004.7800000001
19806,U26467,65,1339.9699999999987,38,27,19678.93,21018.899999999998
19807,U31580,65,7927.23,59,6,17080.44,25007.67
19808,U43623,65,-2163.9599999999996,37,28,15294.18,13130.220000000001
19809,U40088,65,-3721.3500000000004,64,1,3760.1800000000003,38.82999999999993
19810,U11335,65,3218.119999999998,46,19,146305.83,149523.94999999998
19811,U22385,65,10142.269999999991,53,12,12777.81,22920.07999999999
19812,U17594,65,773908.7000000007,44,21,25709973.499999996,26483882.199999996
19813,U15577,65,26481.189999999966,55,10,391466.67000000004,417947.86
19814,U28011,65,-5335.109999999988,46,19,303597.72000000003,298262.61000000004
19815,U9020,65,-48311.819999999985,49,16,545546.1699999999,497234.3499999999
19816,U40423,65,-9088.739999999976,55,10,168803.81,159715.07
19817,U29971,65,-168486.09,57,8,411179.8400000001,242693.7500000001
19818,U9383,65,-23301.060000000023,36,29,220313.48,197012.41999999998
19819,U29653,65,81204.20999999999,41,24,11041.98,92246.18999999999
19820,U41368,65,152345.02999999997,46,19,450423.05,602768.08
19821,U23285,65,-57821.980000000025,43,22,546362.54,488540.56
19822,U19819,65,-24.44999999998072,55,10,581479.34,581454.89
19823,U17756,65,7770.17,48,17,79921.20000000001,87691.37000000001
19824,U25217,65,-7908.74999999996,38,27,387133.78,379225.0300000001
19825,U38325,65,8349.93,58,7,24669.68,33019.61
19826,U9529,65,3779.010000000003,35,30,216956.94999999998,220735.96
19827,U12957,65,9754.520000000002,55,10,26245.84,36000.36
19828,U26365,65,30538.28,56,9,14344.750000000002,44883.03
19829,U22552,65,-279.80999999999995,27,38,25866.03,25586.219999999998
19830,U26330,65,-4713.650000000001,59,6,25009.369999999995,20295.719999999994
19831,U27789,65,-1819.469999999993,49,16,77702.62,75883.15000000001
19832,U17610,65,2933.02,57,8,27699.89,30632.91
19833,U15482,65,-8496.369999999995,55,10,108076.2,99579.83
19834,U22234,65,-81903.11999999992,53,12,420622.48000000016,338719.3600000002
19835,U11249,64,-1326.170000000001,54,10,17214.37,15888.199999999997
19836,U11612,64,4626.690000000003,18,46,193020.0,197646.69
19837,U974211,64,-4882.110000000001,40,24,19586.46,14704.349999999999
19838,U40615,64,95046.32999999999,32,32,438199.0800000001,533245.41
19839,U36799,64,8969.359999999995,52,12,128058.57,137027.93
19840,U12033,64,-44331.710000000014,53,11,880160.51,835828.8
19841,U11052,64,-244.79999999999927,57,7,38357.28,38112.479999999996
19842,U32345,64,-15972.710000000003,52,12,46837.04,30864.329999999998
19843,U20967,64,-17952.27,53,11,49081.78000000001,31129.510000000013
19844,U30813,64,4431.72,51,13,28067.07000000001,32498.79000000001
19845,U12273,64,2510.920000000002,49,15,150340.77,152851.69
19846,U39902,64,-388.0800000000028,48,16,59124.38000000001,58736.30000000001
19847,U17435,64,-11718.169999999995,51,13,29838.44,18120.270000000004
19848,U29072,64,11098.669999999973,43,21,782491.77,793590.44
19849,U13618,64,-2459108.4000000004,48,16,2612304.7199999993,153196.3199999989
19850,U11630,64,-5111.99,50,14,44595.490000000005,39483.50000000001
19851,U1046850,64,0.3100000000000023,38,26,839.7799999999997,840.0899999999997
19852,U19993,64,796.350000000001,46,18,23339.22,24135.570000000003
19853,U41066,64,-26875.029999999984,44,20,182919.4,156044.37
19854,U29853,64,-70180.44,51,13,159096.35000000003,88915.91000000003
19855,U31407,64,-219.15000000000055,32,32,163126.27000000002,162907.12000000002
19856,U38024,64,21262.06,53,11,29834.230000000003,51096.29000000001
19857,U43283,64,13207.500000000002,55,9,20359.85,33567.35
19858,U35158,64,220169.09999999998,27,37,747600.99,967770.09
19859,U26806,64,-10663.650000000001,55,9,48000.83,37337.18
19860,U40447,64,-6767.699999999998,46,18,352748.11,345980.41
19861,U23946,64,8877.120000000003,45,19,30167.46,39044.58
19862,U16887,64,-13053.250000000291,25,39,3212452.2,3199398.9499999997
19863,U31915,64,-10227.929999999964,35,29,1069025.4,1058797.47
19864,U37336,64,3624.9199999999987,40,24,20430.920000000002,24055.84
19865,U22140,64,-1164.7899999999645,31,33,728220.56,727055.7700000001
19866,U13353,64,-4319.760000000002,45,19,64278.399999999994,59958.63999999999
19867,U8675,64,-218.20999999999913,44,20,13770.65,13552.44
19868,U12685,64,4218.689999999993,42,22,149748.92,153967.61000000002
19869,U21035,64,3313.3799999998882,47,17,887954.1,891267.4799999999
19870,U16588,64,8428.380000000003,55,9,14673.74,23102.120000000003
19871,U35474,64,-11856.599999999995,48,16,145674.56,133817.96
19872,U30730,64,-1233.7899999999972,57,7,55872.7,54638.91
19873,U31693,64,-311.55999999999995,57,7,9070.349999999999,8758.789999999999
19874,U15663,64,100375.3,39,25,769052.1900000001,869427.4900000001
19875,U15088,64,9312.230000000003,45,19,117262.61,126574.84
19876,U20670,64,6819.899999999997,41,23,877084.0,883903.9
19877,U41895,64,-1497.5600000000004,59,5,11206.3,9708.739999999998
19878,U16565,64,1115029.1,42,22,867300.7600000002,1982329.8600000003
19879,U9422,64,291865.31999999995,34,30,157847.0,449712.31999999995
19880,U9144,64,-6704.759999999962,42,22,393807.79000000004,387103.0300000001
19881,U9799,64,-45371.21000000001,46,18,175239.36000000002,129868.15000000001
19882,U25697,64,93077.05000000006,37,27,50707.59000000001,143784.64000000007
19883,U18474,64,1360.7999999999997,58,6,19521.68,20882.48
19884,U23055,64,1507.1700000000033,45,19,212827.83,214335.0
19885,U28839,64,10746.56,41,23,73208.35999999999,83954.91999999998
19886,U15507,64,-71424.25999999995,38,26,838756.47,767332.21
19887,U24314,64,683.7500000000003,61,3,1726.6599999999999,2410.4100000000003
19888,U15809,64,17900.750000000055,42,22,417543.5799999999,435444.32999999996
19889,U34856,64,-2036.1699999999892,42,22,260609.99999999997,258573.83
19890,U20984,64,1946.6899999999941,55,9,83657.65999999999,85604.34999999998
19891,U37145,64,-1489.8599999999915,54,10,26833.329999999987,25343.469999999994
19892,U37926,64,-6248.62,39,25,13614.4,7365.78
19893,U717726,64,754.7799999999767,31,33,335007.19999999995,335761.9799999999
19894,U29261,64,13369.18000000001,42,22,343335.94,356705.12
19895,U36711,64,-7236.6900000000105,36,28,416971.9100000001,409735.2200000001
19896,U15629,64,-20767.0,57,7,63532.76,42765.76
19897,U25242,64,-1203.1800000000044,58,6,38991.54,37788.35999999999
19898,U14153,64,147335.99000000005,33,31,465701.6,613037.5900000001
19899,U43890,64,18215.37000000002,42,22,529509.79,547725.16
19900,U23271,64,-3658.989999999999,48,16,54902.60999999999,51243.619999999995
19901,U14468,64,-288940.37,51,13,495067.56,206127.19
19902,U25565,64,4.547473508864641e-13,36,28,40885.060000000005,40885.060000000005
19903,U8919,64,1546.590000000001,48,16,82914.58999999998,84461.17999999998
19904,U17630,64,-42058.58,47,17,180708.3,138649.71999999997
19905,U40653,64,641.6699999999837,35,29,625502.23,626143.8999999999
19906,U1185313,64,-28499.67,44,20,37029.130000000005,8529.460000000006
19907,U10490,64,-21473.12,61,3,23621.1,2147.9799999999996
19908,U28266,64,9322.519999999997,44,20,109417.43,118739.94999999998
19909,U10602,64,-31014.369999999995,47,17,286619.14999999997,255604.77999999997
19910,U39706,64,-21401.359999999997,54,10,37817.67,16416.31
19911,U39540,64,-93489.72999999997,51,13,669842.96,576353.23
19912,U25868,64,-6010.6099999999715,39,25,548025.14,542014.53
19913,U747188,64,1055.0400000000009,38,26,13956.639999999998,15011.679999999998
19914,U27824,64,-11782.25,48,16,113926.14,102143.89
19915,U23977,64,-3157.279999999999,60,4,24716.110000000004,21558.830000000005
19916,U12999,64,-3053.7999999999975,52,12,160406.56999999998,157352.77
19917,U28006,64,25.30000000000006,60,4,714.040000000001,739.340000000001
19918,U27260,64,5231.389999999986,53,11,10381.4,15612.789999999986
19919,U33759,64,-802.5500000000038,50,14,35298.04,34495.49
19920,U31763,64,-11533.280000000002,59,5,32534.820000000003,21001.54
19921,U16938,64,-63.35000000000632,43,21,329990.9900000002,329927.6400000002
19922,U15754,64,-241.12000000000037,49,15,59748.799999999996,59507.67999999999
19923,U31149,64,980.7799999999997,52,12,26982.57,27963.35
19924,U1083972,64,-929.8600000000001,35,29,65207.0,64277.14
19925,U16601,64,94948.89999999998,50,14,149470.82,244419.71999999997
19926,U27470,64,34079.10000000002,41,23,127306.34999999999,161385.45
19927,U33352,64,-15658.339999999998,61,3,26985.710000000003,11327.370000000004
19928,U9349,64,54283.40999999999,52,12,243101.35000000003,297384.76
19929,U43998,64,-5774.509999999991,49,15,80450.85,74676.34000000001
19930,U951148,64,-989.0999999999999,36,28,6339.599999999999,5350.5
19931,U11680,64,-2975.6299999999947,53,11,59225.70999999999,56250.079999999994
19932,U43107,64,1199.3100000000002,59,5,3940.6400000000003,5139.950000000001
19933,U40217,64,2693.569999999996,34,30,82188.31,84881.87999999999
19934,U35938,64,-21864.699999999997,54,10,46488.6,24623.9
19935,U22421,64,-8817.869999999988,51,13,247121.06,238303.19
19936,U36123,64,297.8800000000025,54,10,63701.9,63999.780000000006
19937,U35558,64,17259.350000000006,46,18,86289.09999999998,103548.44999999998
19938,U19293,64,-668.1200000000014,60,4,9153.000000000002,8484.880000000001
19939,U9039,64,-13922.179999999998,58,6,63832.99999999999,49910.81999999999
19940,U35327,64,3088.4200000000055,46,18,210417.29,213505.71000000002
19941,U13128,64,-15100.299999999997,42,22,112074.43000000001,96974.13
19942,U32224,64,2883.9100000000003,59,5,4589.78,7473.6900000000005
19943,U23116,64,6352.890000000003,51,13,35378.729999999996,41731.619999999995
19944,U23035,64,978.8199999999797,42,22,236702.81000000003,237681.63
19945,U25487,64,5934.320000000001,51,13,27596.25,33530.57
19946,U10287,64,126171.73999999996,54,10,194780.93,320952.6699999999
19947,U26780,64,-17986.509999999995,58,6,39404.81999999999,21418.309999999998
19948,U18455,64,12679.80000000001,52,12,99472.08,112151.88
19949,U41161,64,52334.06000000005,55,9,615959.84,668293.9
19950,U30044,64,228673.73999999996,28,36,591795.46,820469.2
19951,U29305,64,38670.96,36,28,115586.58,154257.54
19952,U33579,64,-8719.01,60,4,12628.119999999999,3909.1099999999988
19953,U27497,64,-1752.1400000000006,54,10,14811.359999999997,13059.219999999996
19954,U35686,64,-145611.43000000002,44,20,426293.4700000001,280682.04000000004
19955,U43579,64,-5926.919999999995,51,13,51108.67999999999,45181.759999999995
19956,U26231,64,-118965.89000000001,48,16,719106.36,600140.47
19957,U18574,64,-3403.7499999999727,32,32,323258.69,319854.94
19958,U37578,64,-7380.69,41,23,71192.23,63811.53999999999
19959,U41814,64,-6803.600000000006,52,12,241185.88,234382.28
19960,U9245,64,11820.149999999998,48,16,303705.71,315525.86000000004
19961,U25625,64,-5331.430000000004,56,8,30767.499999999996,25436.069999999992
19962,U10808,64,-1031.0999999999767,37,27,294990.98,293959.88
19963,U28246,64,54.050000000013824,35,29,359113.99000000005,359168.04000000004
19964,U17787,64,4943.830000000002,48,16,103295.26999999999,108239.09999999999
19965,U19275,64,-4012.939999999995,32,32,130943.81999999999,126930.88
19966,U1125002,64,-772.4099999999997,54,10,7363.279999999999,6590.869999999999
19967,U27358,64,-11311.790000000005,35,29,262566.43,251254.63999999998
19968,U35256,64,9282.279999999995,32,32,47605.950000000004,56888.229999999996
19969,U23495,64,-79910.55999999997,55,9,181204.13,101293.57000000004
19970,U12265,64,15799.29,48,16,64590.68999999999,80389.97999999998
19971,U20962,64,50285.470000000096,36,28,1667260.57,1717546.0400000003
19972,U19255,64,-4564.85,47,17,1990480.3100000003,1985915.4600000002
19973,U23690,64,-294784.11,25,39,2373984.4699999997,2079200.3599999999
19974,U911638,64,2278.73,40,24,11102.720000000001,13381.45
19975,U13973,64,-40794.020000000004,56,8,46068.57000000001,5274.550000000003
19976,U17137,64,-181041.41999999993,38,26,1926862.8399999999,1745821.42
19977,U10119,64,7754.729999999998,33,31,39187.13,46941.85999999999
19978,U29590,64,-1400.0400000000013,51,13,22175.05,20775.01
19979,U43656,64,-141052.03000000003,43,21,241554.85,100502.81999999998
19980,U20706,64,-99512.66999999993,37,27,1173050.8299999998,1073538.16
19981,U25140,64,-42773.68000000001,42,22,174498.02000000002,131724.34000000003
19982,U39556,64,-732285.51,54,10,785644.86,53359.34999999998
19983,U16423,64,8427.240000000002,53,11,20929.850000000002,29357.090000000004
19984,U16534,64,-3170.6999999999994,47,17,12009.800000000001,8839.100000000002
19985,U30024,64,9.691802915767767e-12,41,23,58238.92000000001,58238.92000000002
19986,U21720,64,-607.6900000000005,37,27,103970.78000000001,103363.09000000001
19987,U9395,64,-10151.190000000002,49,15,112081.34999999999,101930.15999999999
19988,U21047,64,988.3599999999994,35,29,51374.670000000006,52363.030000000006
19989,U17260,64,21412.42,51,13,39159.27,60571.689999999995
19990,U40154,64,-148196.56999999975,30,34,2475605.51,2327408.94
19991,U26450,64,-10564.349999999999,59,5,27013.37,16449.02
19992,U9513,64,-56015.58,38,26,302187.0,246171.41999999998
19993,U42768,64,2413.739999999999,56,8,26592.679999999993,29006.41999999999
19994,U15416,64,484.58000000000357,43,21,196360.27999999994,196844.85999999996
19995,U31811,64,-1642.210000000001,48,16,111003.57,109361.36
19996,U34243,64,-37901.93000000001,53,11,135731.38,97829.45
19997,U17274,64,1627.2999999999956,41,23,51187.45,52814.74999999999
19998,U42594,64,-654.7199999999915,51,13,167207.3899999998,166552.6699999998
19999,U43500,64,12606.029999999999,52,12,63596.99,76203.01999999999
20000,U43553,64,5727.1,56,8,15326.619999999999,21053.72
20001,U26136,64,-8294.86,51,13,43163.10999999999,34868.24999999999
20002,U14427,64,-522.1900000000019,54,10,53025.16,52502.97
20003,U10693,64,19734.769999999997,51,13,180776.81,200511.58
20004,U23191,64,-5375.509999999999,56,8,20556.550000000003,15181.040000000005
20005,U23873,64,33055.54000000001,51,13,56456.14,89511.68000000001
20006,U8626,64,242102.96000000002,27,37,202005.48,444108.44000000006
20007,U11839,64,-46006.56,52,12,178797.85,132791.29
20008,U26983,64,-8587.260000000015,48,16,427657.23000000004,419069.97000000003
20009,U26955,64,65690.16000000002,56,8,56920.22000000002,122610.38000000003
20010,U39114,64,-9489.019999999993,50,14,79400.72,69911.70000000001
20011,U22608,64,404519.62000000005,52,12,323542.49,728062.1100000001
20012,U26937,64,-78317.13999999997,31,33,1450235.6700000002,1371918.5300000003
20013,U19763,64,84835.48000000003,37,27,263747.27999999997,348582.76
20014,U10326,64,1919.7199999999998,51,13,8791.880000000001,10711.6
20015,U32415,64,-91391.36,53,11,260420.10000000003,169028.74000000005
20016,U16985,64,-105428.68000000017,57,7,2134565.0700000003,2029136.3900000001
20017,U42456,64,7954.330000000002,46,18,13393.569999999998,21347.9
20018,U12207,64,424.28,49,15,5233.819999999999,5658.0999999999985
20019,U37831,64,-35.75,26,38,174045.69999999998,174009.94999999998
20020,U39352,64,2534.1799999999525,36,28,10113157.579999998,10115691.759999998
20021,U13882,64,127.4100000000326,44,20,696772.01,696899.42
20022,U1210064,64,-10704.48,45,19,67117.94,56413.46000000001
20023,U32192,64,-78427.01999999999,54,10,187546.25999999995,109119.23999999996
20024,U31359,64,49.34999999999957,56,8,10176.92,10226.27
20025,U1120419,64,8089.469999999999,37,27,29059.73,37149.2
20026,U13926,64,-37.77000000006956,51,13,2253499.52,2253461.75
20027,U9759,64,-3101.3799999999983,39,25,85606.56,82505.18
20028,U11490,64,-117894.09000000001,40,24,633461.79,515567.7
20029,U26595,64,585.8499999999949,47,17,63670.78999999999,64256.639999999985
20030,U28772,64,-1238.6099999999988,56,8,16972.11,15733.500000000002
20031,U860572,64,-107.92999999999847,38,26,64636.94,64529.01
20032,U42960,64,-5843.579999999996,58,6,9631.85,3788.270000000004
20033,U22687,64,-6573.799999999988,45,19,305065.54000000004,298491.74000000005
20034,U39607,64,-207.04999999999927,41,23,210085.5,209878.45
20035,U12774,64,-87762.70999999999,31,33,688476.66,600713.9500000001
20036,U33132,64,-295.5599999999995,50,14,6568.210000000001,6272.6500000000015
20037,U42517,64,-3142.1300000000006,60,4,8758.03,5615.9
20038,U24960,64,-15140.26,56,8,97157.23,82016.97
20039,U19870,64,-10986.269999999999,61,3,316867.93999999965,305881.66999999963
20040,U25069,63,130432.74999999997,46,17,171639.59,302072.33999999997
20041,U15765,63,-19781.11,43,20,166663.82,146882.71000000002
20042,U32674,63,90.50000000000182,18,45,75127.2,75217.7
20043,U35675,63,145.3200000000004,48,15,11889.130000000001,12034.45
20044,U28655,63,-1449669.1200000006,43,20,3689319.5,2239650.3799999994
20045,U31511,63,24745.450000000004,52,11,26817.690000000002,51563.14000000001
20046,U33974,63,-25466.179999999993,48,15,857395.5,831929.3200000001
20047,U27868,63,992.5399999999895,49,14,176971.21,177963.74999999997
20048,U27558,63,75155.16000000002,50,13,38231.85,113387.01000000001
20049,U27992,63,1167.1299999999997,53,10,20478.82,21645.95
20050,U33025,63,-1144.0599999999995,52,11,13638.169999999996,12494.109999999997
20051,U33148,63,-13045.25,47,16,101138.59000000003,88093.34000000003
20052,U26910,63,-23010.990000000016,33,30,1069784.5799999998,1046773.5899999999
20053,U21142,63,-34780.729999999996,37,26,233692.15000000002,198911.42000000004
20054,U16327,63,-10555.709999999992,53,10,73776.59,63220.880000000005
20055,U39431,63,-140753.91999999998,48,15,3425624.7799999993,3284870.8599999994
20056,U43691,63,-2326.649999999999,53,10,42893.68000000001,40567.030000000006
20057,U40271,63,15075.23,57,6,224267.78999999998,239343.02
20058,U22529,63,-30899.239999999932,29,34,522399.67,491500.43000000005
20059,U17169,63,460260.6600000002,52,11,863744.2700000001,1324004.9300000004
20060,U31021,63,360.7600000000007,50,13,7910.870000000001,8271.630000000001
20061,U39879,63,358.65999999999894,43,20,46075.600000000006,46434.26
20062,U23475,63,-1248.6699999999896,39,24,121382.37,120133.70000000001
20063,U18091,63,20366.080000000005,52,11,17177.98,37544.060000000005
20064,U20750,63,6175.369999999999,52,11,32954.31,39129.67999999999
20065,U33735,63,-19737.739999999998,54,9,38133.29000000001,18395.55000000001
20066,U31904,63,-234.33999999999838,40,23,73639.03000000001,73404.69000000002
20067,U43123,63,10283.6,43,20,30235.080000000005,40518.68000000001
20068,U14541,63,-2854017.75,42,21,3018686.32,164668.56999999983
20069,U24409,63,-119677.13,39,24,493159.27,373482.14
20070,U11421,63,-5015.720000000001,57,6,17165.49,12149.77
20071,U706964,63,-1517.3200000000002,44,19,14228.060000000001,12710.740000000002
20072,U15655,63,32186.419999999984,55,8,1165006.34,1197192.76
20073,U690030,63,-7915.790000000001,40,23,16555.480000000003,8639.690000000002
20074,U27460,63,-30720.230000000003,46,17,119491.12000000002,88770.89000000001
20075,U18323,63,-35156.770000000004,46,17,460444.2399999999,425287.46999999986
20076,U41934,63,-1862.9000000000015,33,30,240724.18,238861.28
20077,U43274,63,1565.9599999999982,32,31,177526.43,179092.38999999998
20078,U965580,63,-1562.109999999998,41,22,68736.46,67174.35
20079,U28685,63,-3694.149999999994,38,25,454295.13,450600.98
20080,U1318255,63,-33881.46999999999,50,13,73086.04,39204.57000000001
20081,U25682,63,10660.209999999997,52,11,74218.90999999997,84879.11999999997
20082,U20914,63,18328.999999999993,39,24,84743.44,103072.44
20083,U10547,63,-8600.909999999998,44,19,63604.39,55003.48
20084,U39866,63,719.1800000000306,45,18,448643.11,449362.29000000004
20085,U1161283,63,1829.899999999998,39,24,90697.86,92527.76
20086,U16788,63,-125348.72000000019,43,20,1345665.51,1220316.7899999998
20087,U10549,63,-5344.959999999992,41,22,522952.0,517607.04000000004
20088,U18463,63,310.09000000000015,47,16,46722.080000000016,47032.17000000001
20089,U10736,63,1991.9300000000003,56,7,17096.340000000004,19088.270000000004
20090,U11780,63,922.889999999999,55,8,23330.84,24253.73
20091,U583510,63,7108.319999999997,34,29,63509.259999999995,70617.57999999999
20092,U10595,63,-286.4499999999978,53,10,53491.130000000005,53204.68000000001
20093,U31408,63,662.7400000000217,39,24,589955.45,590618.19
20094,U9923,63,-19635.570000000003,60,3,41734.060000000005,22098.49
20095,U35711,63,-3995.890000000003,54,9,55052.470000000016,51056.580000000016
20096,U29803,63,-25864.729999999996,42,21,648030.0900000001,622165.3600000001
20097,U40396,63,-21761.96,46,17,47206.82,25444.86
20098,U15308,63,-95023.30999999988,28,35,1227401.19,1132377.8800000001
20099,U27716,63,-34679.45,57,6,110356.75,75677.3
20100,U14658,63,-626.410000000003,47,16,183930.32,183303.91
20101,U30673,63,-17.30000000000041,42,21,114473.02000000002,114455.72000000002
20102,U27378,63,-2379.999999999988,11,52,117897.39000000001,115517.39000000003
20103,U19647,63,5.089999999999861,31,32,90758.2,90763.29
20104,U11261,63,-1473.8399999999901,37,26,777497.84,776024.0
20105,U38306,63,-114006.77999999997,41,22,594242.6400000001,480235.86000000016
20106,U35447,63,-4084.9500000000007,52,11,33825.22,29740.27
20107,U41943,63,1912.4999999999973,56,7,20192.270000000004,22104.77
20108,U43654,63,62.039999999997605,49,14,79018.26000000001,79080.3
20109,U41456,63,6612.52,31,32,153904.87,160517.38999999998
20110,U19893,63,842.659999999998,40,23,318948.01,319790.67
20111,U17886,63,803156.1500000001,41,22,1818849.08,2622005.2300000004
20112,U12197,63,-1367.900000000001,55,8,14070.39,12702.489999999998
20113,U14231,63,67043.17,52,11,124099.23999999999,191142.40999999997
20114,U17292,63,-4410.970000000011,49,14,274329.22,269918.24999999994
20115,U28526,63,-1461.8200000000015,49,14,41094.659999999996,39632.84
20116,U10873,63,8859.460000000003,45,18,82948.39000000001,91807.85000000002
20117,U26118,63,5857.739999999991,45,18,141391.84000000003,147249.58000000002
20118,U17708,63,-416900.27,33,30,2015248.75,1598348.48
20119,U1100284,63,624.4800000000005,35,28,17720.88,18345.36
20120,U25479,63,-10869.8,53,10,23743.92000000001,12874.12000000001
20121,U42486,63,-61539.87,45,18,253466.13999999998,191926.27
20122,U26921,63,-266.4500000000105,45,18,360658.17999999993,360391.7299999999
20123,U32926,63,-539.9799999999996,38,25,58690.09,58150.11
20124,U34130,63,-252635.37999999998,58,5,305237.32999999996,52601.94999999998
20125,U25392,63,11497.350000000011,48,15,366463.11,377960.46
20126,U13157,63,-3088.4300000000003,51,12,105727.5,102639.07
20127,U28356,63,1576.8800000000047,50,13,126434.62000000001,128011.50000000001
20128,U34957,63,6701.2699999999795,55,8,489798.9200000001,496500.19000000006
20129,U33526,63,787.9399999999991,50,13,63212.09,64000.03
20130,U39316,63,64107.67999999999,13,50,135298.7,199406.38
20131,U18378,63,-5914.61,52,11,19737.059999999998,13822.449999999997
20132,U35851,63,26493.58,51,12,28215.749999999996,54709.33
20133,U24745,63,-4222.129999999999,51,12,37261.48,33039.350000000006
20134,U26390,63,5318.260000000007,43,20,131492.99,136811.25
20135,U14107,63,7860.0300000000025,33,30,34520.95,42380.979999999996
20136,U1157457,63,-113.63999999999987,47,16,8518.66,8405.02
20137,U38807,63,19870.139999999985,31,32,670971.03,690841.17
20138,U23936,63,798.8600000000001,48,15,377.22999999999985,1176.09
20139,U38118,63,12078.62000000001,46,17,213628.16,225706.78000000003
20140,U30120,63,-93.33000000000175,54,9,49619.8,49526.47
20141,U17374,63,11008.680000000002,51,12,41092.11,52100.79
20142,U30977,63,18556.720000000005,46,17,87811.17,106367.89
20143,U39703,63,6825.579999999903,25,38,1787996.9600000002,1794822.54
20144,U11681,63,-43408.98,54,9,69697.18000000001,26288.200000000004
20145,U24059,63,-75979.48999999998,50,13,217451.32999999993,141471.83999999997
20146,U10639,63,12443.1,52,11,33201.909999999996,45645.009999999995
20147,U29916,63,-6302.309999999994,46,17,106486.91000000002,100184.60000000002
20148,U22243,63,1875.52,53,10,10550.0,12425.52
20149,U32168,63,-2672.450000000004,48,15,95194.9,92522.45
20150,U24655,63,-11677.06000000002,48,15,333018.14,321341.08
20151,U20845,63,511.53000000000395,47,16,68695.31,69206.84
20152,U36083,63,-28296.82,38,25,605393.39,577096.5700000001
20153,U30980,63,3798.5000000000023,50,13,14461.659999999996,18260.16
20154,U40921,63,-31777.260000000006,39,24,336601.06000000006,304823.80000000005
20155,U18053,63,-137265.73,55,8,191177.7,53911.97
20156,U42152,63,-976.8399999999995,53,10,14829.610000000004,13852.770000000004
20157,U41860,63,31686.29000000001,34,29,641389.16,673075.4500000001
20158,U20490,63,-1569.700000000001,41,22,42665.51,41095.81
20159,U24549,63,-21471.659999999996,53,10,25786.69,4315.0300000000025
20160,U1218093,63,11.300000000000729,44,19,14253.729999999998,14265.029999999999
20161,U24161,63,-3780.4799999999987,48,15,84846.61000000002,81066.13000000002
20162,U8455,63,606.4400000000009,55,8,20350.159999999996,20956.6
20163,U22792,63,16091.240000000042,35,28,404571.28,420662.5200000001
20164,U17232,63,39002.62999999998,53,10,1091041.01,1130043.64
20165,U10762,63,148885.0,52,11,92111.03,240996.03
20166,U12342,63,8901.429999999935,53,10,1632954.77,1641856.2
20167,U8347,63,-18510.33,37,26,76536.53,58026.2
20168,U17896,63,-4025.649999999999,55,8,17561.969999999998,13536.319999999998
20169,U33069,63,416722.6999999999,61,2,83398.13,500120.8299999999
20170,U39493,63,2830.4000000000015,57,6,20998.690000000002,23829.090000000004
20171,U16371,63,14217.979999999981,39,24,2497459.61,2511677.59
20172,U36034,63,-3160.83,55,8,13142.18,9981.35
20173,U8578,63,10994.529999999995,52,11,63276.009999999995,74270.54
20174,U979416,63,-22039.940000000006,53,10,24349.800000000007,2309.8600000000006
20175,U35922,63,4423.319999999994,53,10,59143.19000000001,63566.51
20176,U8503,63,-19154.93,51,12,95954.25,76799.32
20177,U37150,63,4555.560000000001,51,12,67615.73000000001,72171.29000000001
20178,U24930,63,-6936.49,58,5,22358.47,15421.980000000001
20179,U28408,63,3057.2899999999972,46,17,95528.04,98585.32999999999
20180,U19360,63,99629.52,53,10,418065.27,517694.79000000004
20181,U28251,63,-67578.53000000001,44,19,256591.67,189013.14
20182,U23257,63,-50520.649999999994,33,30,232776.84,182256.19
20183,U25162,63,-14163.859999999995,57,6,29767.91,15604.050000000005
20184,U37207,63,-295.90999999999644,50,13,63031.61,62735.700000000004
20185,U33504,63,-51546.68000000001,44,19,364852.42000000004,313305.74000000005
20186,U21105,63,-97703.16000000003,37,26,8428153.18,8330450.02
20187,U35973,63,-13696.290000000014,37,26,496037.8,482341.50999999995
20188,U16950,63,-8181.099999999997,42,21,156555.36,148374.25999999998
20189,U40338,63,-61111.18999999999,33,30,413272.76,352161.57
20190,U10816,63,20407.38000000001,39,24,117187.95,137595.33000000002
20191,U1025311,63,-14.069999999999936,47,16,7961.07,7947.0
20192,U37565,63,-5349.19,41,22,40073.4,34724.21
20193,U21344,63,250567.88000000006,39,24,863388.0,1113955.8800000001
20194,U24525,63,-751.4500000000091,37,26,463966.11,463214.66
20195,U11077,63,-4509.590000000005,47,16,117895.26000000001,113385.67
20196,U33900,63,643.8299999999999,56,7,16870.739999999998,17514.57
20197,U31188,63,3155.6799999999985,40,23,40066.91999999999,43222.59999999999
20198,U20640,63,14.420000000001892,29,34,99973.0,99987.42
20199,U35464,63,2595.6199999999967,49,14,73591.4,76187.01999999999
20200,U28856,63,27600.53,55,8,19924.36,47524.89
20201,U19519,63,68454.05999999998,47,16,497268.02999999997,565722.09
20202,U37306,63,-4688.989999999991,45,18,421114.55,416425.56
20203,U13854,63,-1612.8900000000044,37,26,371396.18,369783.29
20204,U31725,63,-42410.75,46,17,607760.4099999999,565349.6599999999
20205,U30992,63,6760.249999999995,51,12,138279.52,145039.77
20206,U41007,63,1201.0500000000015,54,9,9117.080000000002,10318.130000000003
20207,U28312,63,121146.03999999998,45,18,221706.45999999993,342852.4999999999
20208,U38905,63,-534.7700000000004,55,8,59537.69,59002.92
20209,U1227691,63,-8670.170000000004,31,32,11302.86,2632.689999999997
20210,U27557,63,1021.3800000000003,45,18,27040.260000000002,28061.640000000003
20211,U11833,63,-6141.959999999999,46,17,61264.409999999996,55122.45
20212,U597054,63,-2.9600000000002638,37,26,13321.999999999998,13319.039999999997
20213,U25297,63,17413.500000000004,24,39,73391.15,90804.65
20214,U14061,63,111996.22,41,22,197356.84999999998,309353.06999999995
20215,U26836,63,-18772.260000000137,40,23,1259961.18,1241188.9199999997
20216,U8369,63,-80356.90999999999,53,10,88717.12,8360.210000000006
20217,U39031,63,-3073.610000000001,38,25,69103.4,66029.79
20218,U14474,63,4978.010000000003,48,15,141168.49000000008,146146.5000000001
20219,U13140,63,-18887.940000000002,47,16,64813.78,45925.84
20220,U20007,63,-385.41999999999643,32,31,49335.95999999999,48950.53999999999
20221,U8228,63,-7218.06,50,13,22659.28,15441.219999999998
20222,U8645,63,64881.91999999995,43,20,1260766.42,1325648.3399999999
20223,U29941,63,1418.2100000000012,46,17,20096.129999999994,21514.339999999997
20224,U33479,63,2682.6000000000004,50,13,19302.529999999995,21985.129999999997
20225,U13264,63,522.7700000000041,42,21,358528.8,359051.57
20226,U23133,63,-51120.14000000001,46,17,134928.47,83808.32999999999
20227,U28579,63,-30101.990000000096,37,26,1048521.1399999998,1018419.1499999997
20228,U20988,63,512.0500000000021,46,17,38530.77999999999,39042.829999999994
20229,U31567,63,-2269.45,48,15,13406.139999999998,11136.689999999999
20230,U18631,63,-309073.33,23,40,933665.0,624591.6699999999
20231,U16633,63,0.5699999999969805,34,29,102350.56,102351.12999999999
20232,U40431,63,-82898.04000000001,51,12,475047.25999999995,392149.22
20233,U35619,63,5454.469999999999,49,14,44554.02,50008.49
20234,U10495,62,1935.3499999999708,50,12,2248851.56,2250786.91
20235,U23358,62,-105.76000000000931,37,25,1351644.55,1351538.79
20236,U24802,62,11399.019999999999,44,18,46836.549999999996,58235.56999999999
20237,U32872,62,-1677.88,54,8,4055.5400000000036,2377.6600000000035
20238,U8538,62,5623.0999999999985,51,11,41795.91000000001,47419.01000000001
20239,U1142833,62,93.99000000000024,38,24,17335.610000000004,17429.600000000006
20240,U32989,62,942.4499999999994,52,10,36798.51000000001,37740.96000000001
20241,U24434,62,227.0099999999996,44,18,9787.36,10014.37
20242,U17182,62,-435.20999999999634,32,30,72797.07,72361.86000000002
20243,U28144,62,1998.3399999999965,45,17,147328.05,149326.38999999998
20244,U23907,62,-5121.92,56,6,32913.72,27791.800000000003
20245,U41921,62,-110819.63999999998,38,24,839029.65,728210.01
20246,U15918,62,72990.14,44,18,103656.62000000001,176646.76
20247,U33411,62,-967.1900000000013,52,10,7611.6799999999985,6644.489999999997
20248,U33049,62,4557.22,57,5,849.87,5407.09
20249,U10573,62,-6493.529999999994,53,9,114743.05999999998,108249.52999999998
20250,U28481,62,10207.549999999987,51,11,403794.34000000014,414001.89000000013
20251,U31607,62,-3922.9799999999977,53,9,158750.36,154827.37999999998
20252,U20122,62,3538.100000000001,41,21,13638.67,17176.77
20253,U31226,62,25200.85,47,15,66921.41,92122.26000000001
20254,U639313,62,-6850.470000000002,46,16,56155.119999999995,49304.649999999994
20255,U10911,62,91.59999999999945,50,12,8353.86,8445.46
20256,U16638,62,-5752.580000000002,47,15,63905.27,58152.689999999995
20257,U22637,62,-82593.40000000001,41,21,507191.42000000004,424598.02
20258,U15500,62,22016.349999999995,52,10,347254.7899999999,369271.1399999999
20259,U30349,62,-21548.690000000002,57,5,35870.13999999999,14321.44999999999
20260,U14210,62,-17080.990000000013,41,21,199121.47,182040.47999999998
20261,U12981,62,-8738.849999999999,56,6,90915.78,82176.93
20262,U20870,62,0.28999999999973625,35,27,171746.0,171746.29
20263,U17923,62,-8277.749999999993,51,11,52612.96000000001,44335.210000000014
20264,U31554,62,-10871.5,38,24,254962.0,244090.5
20265,U17642,62,1689.5499999999993,47,15,170458.81,172148.36
20266,U14825,62,-1139.559999999965,25,37,1225848.87,1224709.31
20267,U11523,62,11450253.8,42,20,2134849.4399999995,13585103.24
20268,U1358353,62,-209.73000000000008,51,11,32560.609999999997,32350.879999999997
20269,U42048,62,-751.91,52,10,7599.489999999999,6847.579999999999
20270,U27894,62,-2729.109999999997,48,14,45795.32,43066.21000000001
20271,U23595,62,543.7099999999685,49,13,191396.64,191940.34999999998
20272,U38390,62,-5631.08,55,7,11482.199999999999,5851.119999999999
20273,U19638,62,27018.7,45,17,13427.34,40446.04
20274,U12370,62,5879.199999999997,56,6,15466.18,21345.379999999997
20275,U32570,62,-8871.289999999995,43,19,157857.12,148985.83
20276,U15887,62,1049009.0300000003,47,15,2956435.2,4005444.2300000004
20277,U16945,62,9850.819999999996,48,14,73975.41000000002,83826.23000000001
20278,U982636,62,-11782.899999999998,44,18,14398.689999999997,2615.789999999999
20279,U22877,62,-151452.29999999993,41,21,1253766.6800000002,1102314.3800000004
20280,U27250,62,-314.51000000000477,36,26,194323.52,194009.00999999998
20281,U40556,62,-617.8500000000004,54,8,28875.3,28257.449999999997
20282,U20264,62,19834.560000000012,43,19,182442.52,202277.08000000002
20283,U8971,62,-14982.22,39,23,63754.0,48771.78
20284,U1352198,62,-975.9900000000005,54,8,10061.669999999998,9085.679999999998
20285,U23641,62,-2198.2500000000005,48,14,5130.829999999999,2932.5799999999986
20286,U43725,62,-24051.059999999998,52,10,65562.5,41511.44
20287,U40559,62,-5115.610000000001,58,4,14249.66,9134.05
20288,U15806,62,232310.99,46,16,984456.81,1216767.8
20289,U1192264,62,38.039999999999736,47,15,12878.46,12916.499999999998
20290,U21099,62,713.2999999999998,53,9,7053.460000000001,7766.760000000001
20291,U16007,62,-2189.6399999999994,52,10,62342.63,60152.99
20292,U30022,62,61504.42999999982,27,35,1756395.99,1817900.42
20293,U23045,62,613.8700000000049,30,32,70153.52,70767.39000000001
20294,U26809,62,-17387.46000000001,41,21,476480.91000000003,459093.45
20295,U37402,62,351120.12000000005,34,28,2898832.44,3249952.56
20296,U19051,62,5745.239999999995,32,30,271841.9,277587.14
20297,U11618,62,-25080.44,53,9,92436.58,67356.14
20298,U20150,62,-533.9800000000012,47,15,22694.949999999997,22160.969999999998
20299,U41755,62,-319570.1299999999,46,16,5168142.99,4848572.86
20300,U38626,62,-113.75000000000198,45,17,216867.67000000007,216753.92000000007
20301,U28299,62,359.4399999999996,45,17,16924.22,17283.66
20302,U26843,62,3199.8600000000006,55,7,17912.16,21112.02
20303,U25959,62,59764.83,44,18,70061.45000000001,129826.28000000001
20304,U8628,62,-45661.06999999996,41,21,418240.63999999996,372579.57
20305,U29612,62,1016.2699999999998,52,10,7966.14,8982.41
20306,U10970,62,-3279.0300000000057,37,25,93787.32,90508.29000000001
20307,U42290,62,100616.83000000002,42,20,440434.36999999994,541051.2
20308,U24046,62,1523.3599999999963,35,27,79570.13000000002,81093.49000000002
20309,U983605,62,-7940.140000000008,50,12,21486.989999999998,13546.849999999991
20310,U19521,62,-31742.7,51,11,110040.52999999998,78297.82999999999
20311,U27480,62,7481.119999999999,33,29,459818.63000000006,467299.75000000006
20312,U28570,62,42876.31999999999,48,14,66092.38,108968.7
20313,U37621,62,-27886.180000000004,52,10,55236.399999999994,27350.21999999999
20314,U21016,62,-15549.299999999996,46,16,97796.64999999998,82247.34999999998
20315,U41259,62,-32841.00000000001,45,17,121073.39000000003,88232.39000000001
20316,U10434,62,-74276.59999999999,56,6,238642.00000000006,164365.40000000008
20317,U35134,62,-18592.969999999987,42,20,835374.3200000002,816781.3500000002
20318,U27980,62,5001.21,42,20,11991.169999999998,16992.379999999997
20319,U31714,62,170.30999999999995,52,10,13495.229999999996,13665.539999999995
20320,U1273741,62,0.09999999999990905,32,30,9681.779999999999,9681.88
20321,U35911,62,51607.87000000001,41,21,251805.5,303413.37
20322,U27901,62,10612.000000000004,52,10,44415.53,55027.53
20323,U32516,62,20289.739999999998,60,2,9723.83,30013.57
20324,U15716,62,55706.919999999925,51,11,719328.41,775035.33
20325,U17679,62,-3691.699999999999,39,23,91019.18000000001,87327.48000000001
20326,U26213,62,16018.859999999995,55,7,142396.44,158415.3
20327,U42718,62,4191.230000000001,45,17,72382.59999999999,76573.82999999999
20328,U29631,62,7258.4000000000015,42,20,266160.99,273419.39
20329,U16768,62,-11774.530000000006,44,18,310282.42999999993,298507.8999999999
20330,U11406,62,4876.340000000002,52,10,13341.45,18217.79
20331,U16961,62,2478.8899999999967,54,8,122231.38,124710.27
20332,U39966,62,270735.24999999994,44,18,4330424.05,4601159.3
20333,U24400,62,240402.08,40,22,454017.63999999996,694419.72
20334,U39265,62,-22100.479999999963,48,14,321414.19,299313.71
20335,U22778,62,33.150000000001455,28,34,59954.009999999995,59987.159999999996
20336,U8986,62,-108720.74999999999,47,15,186541.36999999994,77820.61999999995
20337,U30233,62,9145.330000000002,53,9,98413.30000000002,107558.63000000002
20338,U39543,62,100416.15,47,15,102751.73,203167.88
20339,U22620,62,1237.0500000000002,54,8,21264.0,22501.05
20340,U13951,62,-37922.24,45,17,284404.67999999993,246482.43999999994
20341,U30025,62,964.8800000000028,44,18,65658.22,66623.1
20342,U19187,62,-9804.269999999999,54,8,15556.46,5752.1900000000005
20343,U16103,62,-28472.650000000034,34,28,1825695.9699999997,1797223.3199999996
20344,U29735,62,2286.499999999998,58,4,55987.10000000001,58273.60000000001
20345,U14374,62,-1616.230000000007,42,20,89769.39000000001,88153.16
20346,U30191,62,-227548.65000000002,53,9,361104.5200000001,133555.87000000005
20347,U12739,62,9931.880000000006,52,10,6105.01,16036.890000000007
20348,U24112,62,-16921.32,50,12,96708.73999999999,79787.41999999998
20349,U11016,62,-2633.2499999999973,47,15,269105.10000000003,266471.85000000003
20350,U37651,62,-23.979999999981374,39,23,504845.97,504821.99
20351,U39468,62,1618958.0000000026,16,46,10623904.23,12242862.230000002
20352,U14023,62,90.95000000000005,42,20,4646.459999999999,4737.409999999999
20353,U27474,62,5419.4,57,5,13535.419999999998,18954.82
20354,U15260,62,-326052.3500000001,30,32,1440495.3100000003,1114442.9600000002
20355,U35868,62,13904.689999999995,46,16,74819.34999999999,88724.03999999998
20356,U21993,62,2261.3800000000083,29,33,218313.13,220574.51
20357,U19813,62,-8019.579999999996,41,21,182760.91,174741.33000000002
20358,U26431,62,4775.799999999999,47,15,26693.08,31468.88
20359,U822902,62,221.05000000000007,48,14,4625.030000000001,4846.080000000001
20360,U15011,62,-2236.5599999999977,32,30,126272.62,124036.06
20361,U1154443,62,502.0299999999992,35,27,20852.689999999995,21354.719999999994
20362,U28810,62,-275.5800000000001,57,5,4481.03,4205.45
20363,U12665,62,-67.01000000012573,51,11,744572.75,744505.7399999999
20364,U13755,62,-3779.639999999991,36,26,828058.96,824279.32
20365,U12471,62,2035.0900000000001,53,9,241688.11000000002,243723.2
20366,U29085,62,-3198.9299999999935,50,12,65819.69,62620.76000000001
20367,U18235,62,-17163.370000000003,49,13,171698.16,154534.79
20368,U39421,62,-4301.389999999999,51,11,56707.17,52405.78
20369,U9055,62,-47812.159999999996,57,5,69936.75,22124.590000000004
20370,U43819,62,10099.1,33,29,27405.899999999998,37505.0
20371,U16606,62,-2559.3499999999995,30,32,74884.0,72324.65
20372,U21540,62,5631.490000000009,48,14,190177.36999999997,195808.86
20373,U8772,62,10017.92999999995,41,21,493839.1000000001,503857.03
20374,U27329,62,108076.48999999999,44,18,122878.08,230954.57
20375,U17059,62,56531.07,38,24,166528.37999999995,223059.44999999995
20376,U10788,62,-410.20000000001096,38,24,564153.8999999999,563743.7
20377,U32866,62,176322.02,33,29,111605.01000000001,287927.03
20378,U31191,62,4008.8499999999985,54,8,21233.279999999995,25242.129999999994
20379,U594929,62,-1081.319999999998,48,14,40346.67000000002,39265.35000000002
20380,U34883,62,-586046.76,57,5,587475.48,1428.719999999972
20381,U10958,62,-6416.450000000012,38,24,452847.93,446431.48
20382,U12542,62,3331.730000000007,35,27,526317.7000000001,529649.43
20383,U19614,62,-35.22999999999938,55,7,51495.83,51460.600000000006
20384,U43346,62,-9278.569999999992,27,35,335403.32999999996,326124.75999999995
20385,U12476,62,-544.7700000000023,41,21,77241.10000000002,76696.33000000002
20386,U33308,62,1063.0200000000007,46,16,35855.97,36918.990000000005
20387,U17088,62,-11331.320000000003,31,31,197069.11,185737.78999999998
20388,U24996,62,-1201217.2000000002,37,25,3443563.37,2242346.17
20389,U36904,62,-1305.5199999999932,51,11,112305.74000000002,111000.22000000003
20390,U42948,62,961.2399999999907,47,15,113188.14,114149.37999999999
20391,U21922,62,-3100.21,48,14,16495.699999999997,13395.489999999998
20392,U29251,62,-27.700000000001296,51,11,84120.12,84092.42
20393,U1252033,62,2506.96,40,22,8387.32,10894.279999999999
20394,U27794,62,36429.07999999999,55,7,44684.47,81113.54999999999
20395,U26617,62,-68010.15000000002,41,21,851227.1099999999,783216.9599999998
20396,U21746,62,-49873.5,28,34,448070.49999999994,398196.99999999994
20397,U22530,62,-68953.88,58,4,81622.16000000002,12668.280000000013
20398,U853629,62,20342.6,54,8,11431.11,31773.71
20399,U30267,62,-21.999999999992724,29,33,71122.81,71100.81
20400,U13720,62,-67599.58,39,23,141152.93,73553.34999999999
20401,U30345,62,-145662.60999999996,46,16,402807.42000000004,257144.81000000008
20402,U22322,62,29612.550000000003,41,21,58532.729999999996,88145.28
20403,U40940,62,97715.93000000002,57,5,102400.84999999998,200116.78
20404,U31654,62,8210.460000000037,30,32,658611.38,666821.8400000001
20405,U9230,62,5646.59000000005,41,21,2806404.530000001,2812051.120000001
20406,U43189,62,9242.609999999997,49,13,44156.17,53398.78
20407,U642873,62,-3172.16,48,14,14251.939999999999,11079.779999999999
20408,U26187,62,-5796.930000000002,40,22,52005.96000000001,46209.030000000006
20409,U11110,62,-15828.630000000008,39,23,237947.05000000002,222118.42
20410,U29253,62,45606.92000000003,36,26,1379927.4,1425534.3199999998
20411,U11067,62,3663.159999999996,39,23,124307.76999999999,127970.93
20412,U27737,62,3.382183422218077e-12,43,19,68708.43,68708.43
20413,U13544,62,-92184.47000000003,47,15,1877934.67,1785750.2
20414,U24035,62,-28383.51999999999,49,13,91018.94,62635.42000000001
20415,U22912,62,29914.759999999973,41,21,1059467.9900000002,1089382.7500000002
20416,U40456,62,-261205.88000000006,36,26,477784.76,216578.87999999995
20417,U43103,62,16136.800000000008,47,15,589223.67,605360.4700000001
20418,U39832,62,-262.92999999999995,39,23,28207.300000000007,27944.370000000006
20419,U961408,62,-679.1400000000003,34,28,14382.98,13703.84
20420,U16178,62,1515188.94,39,23,1850852.06,3366041.0
20421,U29817,62,-15621.210000000003,41,21,346082.8,330461.58999999997
20422,U22285,62,-16012.379999999992,44,18,245783.28,229770.9
20423,U18457,62,-2220.7899999999945,55,7,32686.00999999999,30465.219999999998
20424,U15048,62,-1305.3999999999992,51,11,22784.79999999999,21479.39999999999
20425,U32383,62,9346.909999999998,44,18,7106.11,16453.019999999997
20426,U29726,62,8810.019999999997,38,24,148508.55000000002,157318.57
20427,U25183,62,646.1600000000049,40,22,202368.22,203014.38
20428,U14075,62,-3427.7200000000103,47,15,152972.88999999998,149545.16999999998
20429,U43435,62,-8884.689999999995,52,10,35124.93,26240.240000000005
20430,U22741,62,-875.6099999999747,49,13,251785.19999999995,250909.58999999997
20431,U39358,61,20339.730000000032,33,28,864853.37,885193.1
20432,U41231,61,-12710.02,51,10,23176.919999999995,10466.899999999994
20433,U19793,61,-102200.73000000001,48,13,163149.38,60948.649999999994
20434,U39905,61,-6238.760000000003,41,20,59584.11000000001,53345.350000000006
20435,U29352,61,50994.82000000001,43,18,462589.53,513584.35000000003
20436,U16682,61,6801.959999999992,41,20,122438.09,129240.04999999999
20437,U43669,61,-40900.25000000002,46,15,159098.76,118198.50999999998
20438,U612290,61,-5511.729999999998,39,22,29527.379999999997,24015.65
20439,U41387,61,-5609.219999999999,51,10,20128.789999999997,14519.569999999998
20440,U28954,61,-1959.7900000000016,46,15,11486.99,9527.199999999999
20441,U17706,61,57160.229999999996,40,21,195332.47,252492.7
20442,U22535,61,-107.16000000000349,48,13,218134.3,218027.13999999998
20443,U22936,61,-6450.16,46,15,116523.31999999999,110073.15999999999
20444,U14254,61,-72942.70999999999,43,18,254016.83999999997,181074.12999999998
20445,U11204,61,24572.019999999997,46,15,104717.33000000002,129289.35
20446,U43335,61,-258.5100000000002,52,9,13354.15,13095.64
20447,U16297,61,1682.1100000000042,42,19,99246.46999999999,100928.57999999999
20448,U21385,61,-106296.46999999997,53,8,127797.99999999997,21501.53
20449,U19601,61,-55530.94000000001,44,17,285534.61000000004,230003.67000000004
20450,U12915,61,-5680.560000000005,35,26,182566.21000000002,176885.65000000002
20451,U35731,61,2981.4200000000033,21,40,166376.96000000002,169358.38000000003
20452,U18827,61,-14456.470000000001,52,9,32014.370000000003,17557.9
20453,U31411,61,1399.16,48,13,22251.339999999997,23650.499999999996
20454,U34158,61,-16804.42,54,7,48785.89,31981.47
20455,U948676,61,0.9800000000005821,33,28,127914.59,127915.56999999999
20456,U18601,61,121268.12,35,26,243200.37000000002,364468.49
20457,U12709,61,-17993.79999999996,47,14,411611.88000000006,393618.0800000001
20458,U43575,61,-1693.7999999999975,50,11,49617.95,47924.15
20459,U22391,61,91.82999999998198,36,25,806368.46,806460.2899999999
20460,U21541,61,36071.41999999999,28,33,660795.8700000002,696867.2900000003
20461,U8956,61,-200206.15999999997,46,15,260983.5,60777.340000000026
20462,U748504,61,-2240.350000000002,40,21,42347.9,40107.55
20463,U35683,61,-272.50000000000034,57,4,4622.86,4350.36
20464,U35843,61,-4413.229999999995,53,8,89411.5,84998.27
20465,U31953,61,29.000000000014552,31,30,596293.3400000001,596322.3400000001
20466,U674698,61,5603.190000000003,35,26,17700.36,23303.550000000003
20467,U13938,61,93972.54999999999,35,26,68356.13,162328.68
20468,U21576,61,-18843.770000000004,37,24,88221.37999999999,69377.60999999999
20469,U16809,61,-150922.25999999998,35,26,612783.21,461860.94999999995
20470,U39083,61,4579.67,46,15,83267.43,87847.09999999999
20471,U25263,61,25351.11,43,18,422974.51,448325.62
20472,U39809,61,-40861.939999999995,32,29,567846.36,526984.42
20473,U22990,61,53087.19000000006,39,22,2202745.0,2255832.19
20474,U27110,61,-8993.659999999998,46,15,36791.90000000001,27798.240000000013
20475,U13469,61,-7488.770000000004,30,31,245591.0,238102.22999999998
20476,U32230,61,-77178.23,40,21,135191.62999999998,58013.39999999998
20477,U14297,61,20251.579999999987,34,27,913522.6599999999,933774.2399999999
20478,U13917,61,4002812.1200000006,48,13,314008.5200000001,4316820.640000001
20479,U1198114,61,3923.2599999999948,36,25,194454.0,198377.26
20480,U25003,61,-148222.28999999998,38,23,615222.3,467000.01000000007
20481,U34789,61,1521.44,51,10,21946.539999999994,23467.979999999992
20482,U31441,61,34374.57999999984,49,12,2349045.14,2383419.7199999997
20483,U16059,61,-91603.22000000002,34,27,490179.54000000004,398576.32
20484,U1335404,61,-546.8899999999996,52,9,3157.8300000000004,2610.9400000000005
20485,U20269,61,26371.769999999997,41,20,118391.20999999999,144762.97999999998
20486,U16868,61,-701582.49,58,3,709757.42,8174.930000000051
20487,U8758,61,-2955.639999999992,47,14,174055.00999999998,171099.37
20488,U12580,61,-1064.6699999999996,43,18,203206.71,202142.03999999998
20489,U34252,61,1296.4099999999958,46,15,1017809.3,1019105.7100000001
20490,U29370,61,-302.0400000000046,38,23,154534.31999999995,154232.27999999994
20491,U28221,61,-14202.780000000004,56,5,22528.29,8325.509999999997
20492,U23583,61,14317.919999999996,47,14,932085.67,946403.5900000001
20493,U37390,61,185.86000000010245,17,44,1134054.15,1134240.01
20494,U36447,61,-2081.31,49,12,9456.380000000001,7375.0700000000015
20495,U38314,61,-18590.420000000002,55,6,26876.269999999997,8285.849999999995
20496,U975351,61,489.25000000000045,32,29,42677.42,43166.67
20497,U33940,61,-6069.080000000002,58,3,58060.68,51991.6
20498,U28150,61,11787.86,50,11,30949.249999999996,42737.11
20499,U23258,61,-1607174.0499999996,56,5,1656699.4199999997,49525.37000000011
20500,U935871,61,170.76999999999975,34,27,18349.28,18520.05
20501,U14912,61,2851.1700000000033,52,9,37382.759999999995,40233.93
20502,U11265,61,37996.170000000006,45,16,163426.16,201422.33000000002
20503,U15547,61,-147152.36,53,8,231294.19,84141.83000000002
20504,U29798,61,-255.3499999999999,52,9,32554.589999999997,32299.239999999998
20505,U9872,61,10832.79,51,10,50383.32,61216.11
20506,U37985,61,-188259.96000000002,48,13,378495.06,190235.09999999998
20507,U28742,61,-1726.0800000000017,30,31,186393.74,184667.65999999997
20508,U19455,61,147.54000000000087,33,28,25608.25,25755.79
20509,U40841,61,1665.0199999999993,51,10,67606.09,69271.11
20510,U13651,61,-1200445.3399999924,28,33,187847727.01,186647281.67
20511,U22211,61,17284.060000000005,50,11,23986.579999999998,41270.64
20512,U43216,61,7124.91,50,11,34331.79,41456.7
20513,U24242,61,-16645.190000000013,49,12,216837.27999999997,200192.08999999997
20514,U11141,61,-557.7499999999997,50,11,38662.11,38104.36
20515,U30527,61,-22170.060000000012,35,26,268388.0200000001,246217.96000000008
20516,U12308,61,-494.4099999999989,50,11,27755.619999999995,27261.209999999995
20517,U42415,61,-34699.020000000004,49,12,82231.81,47532.78999999999
20518,U29928,61,-62714.96,56,5,104900.75,42185.79
20519,U22297,61,-23417.159999999996,52,9,69080.2,45663.04
20520,U20691,61,-26118.410000000003,55,6,83214.21000000002,57095.80000000002
20521,U43218,61,335.1399999999976,45,16,51866.030000000006,52201.170000000006
20522,U36256,61,14417.980000000003,38,23,152895.5,167313.48
20523,U739617,61,-11136.729999999996,50,11,13514.309999999994,2377.579999999998
20524,U13096,61,3311.8699999999953,51,10,29891.400000000005,33203.270000000004
20525,U26503,61,-47006.29000000001,45,16,238794.86000000002,191788.57
20526,U15726,61,10637.949999999983,46,15,329510.12,340148.06999999995
20527,U41670,61,-31806.890000000014,52,9,156375.99,124569.09999999998
20528,U41467,61,-584258.9500000002,33,28,5498344.470000002,4914085.520000001
20529,U27869,61,-1729.3299999999995,49,12,11710.9,9981.57
20530,U18782,61,4562.37000000001,48,13,94532.3,99094.67000000001
20531,U40897,61,99309.07,40,21,79613.58,178922.65000000002
20532,U13612,61,439845.3200000002,51,10,316137.45,755982.7700000003
20533,U8294,61,-7121.700000000001,49,12,41638.11,34516.41
20534,U28404,61,8305.130000000003,49,12,128547.15999999999,136852.28999999998
20535,U32649,61,-404.96000000000004,52,9,2293.9799999999996,1889.0199999999995
20536,U36869,61,-1581.6699999999837,42,19,703451.74,701870.0700000001
20537,U11696,61,-2834.99,54,7,17913.54,15078.550000000001
20538,U27817,61,3727.5000000000005,48,13,30852.7,34580.200000000004
20539,U1130628,61,3221.2399999999984,51,10,10313.289999999999,13534.529999999997
20540,U26815,61,-2657.9800000000555,41,20,911004.65,908346.6699999999
20541,U30010,61,23768.669999999987,53,8,131103.29,154871.96
20542,U30964,61,1052.990000000002,50,11,71724.92,72777.91
20543,U1331471,61,10.890000000001272,35,26,34714.18,34725.07
20544,U14782,61,-38746.94000000007,30,31,369416.52,330669.57999999996
20545,U11234,61,4788.680000000001,34,27,99294.79999999999,104083.48
20546,U16294,61,147696.29,32,29,20359.55,168055.84
20547,U24346,61,-31184.87999999999,20,41,220244.12,189059.24
20548,U39038,61,-2508.1800000000026,49,12,32581.120000000003,30072.94
20549,U10990,61,-9363.179999999993,49,12,163618.58000000002,154255.40000000002
20550,U21731,61,3186.9200000000037,41,20,111762.60999999999,114949.52999999998
20551,U26773,61,871.9900000000098,41,20,175347.15000000002,176219.14000000004
20552,U25311,61,63094.209999999985,39,22,38252.99999999999,101347.20999999998
20553,U43289,61,6284.790000000008,41,20,78811.16,85095.95000000001
20554,U38355,61,-5077.569999999999,49,12,68024.81,62947.24
20555,U28680,61,3667.4500000000025,41,20,116485.74,120153.19
20556,U26665,61,5243.510000000005,54,7,2370.500000000001,7614.010000000006
20557,U18904,61,-720131.0200000004,44,17,5785184.659999999,5065053.639999999
20558,U18825,61,1011.8299999999995,52,9,17844.730000000003,18856.56
20559,U24002,61,189.7500000000009,46,15,17622.02,17811.77
20560,U31004,61,-839.7399999999925,37,24,108102.80999999998,107263.06999999999
20561,U1250645,61,-1118.7299999999993,35,26,60408.68000000001,59289.95000000001
20562,U27552,61,601.6300000000041,28,33,191740.61,192342.24
20563,U30681,61,101.72999999999978,54,7,2193.8500000000004,2295.58
20564,U11764,61,-9717.440000000002,49,12,40391.130000000005,30673.690000000002
20565,U25997,61,5073.290000000045,32,29,238201.86,243275.15000000002
20566,U1202799,61,-26.56999999999946,56,5,9001.769999999999,8975.199999999999
20567,U38757,61,1187.3299999999997,49,12,39532.51,40719.840000000004
20568,U19758,61,14334.51,48,13,18766.21,33100.72
20569,U8972,61,-1176.190000000001,52,9,10526.369999999997,9350.179999999997
20570,U24658,61,567.1499999999993,47,14,10283.069999999998,10850.219999999998
20571,U43769,61,-7006.050000000003,45,16,151404.41999999998,144398.37
20572,U15645,61,-1339.8700000000265,33,28,621496.73,620156.86
20573,U20035,61,83.01999999999589,32,29,100745.50999999997,100828.52999999996
20574,U27943,61,9710.400000000012,43,18,116193.18000000001,125903.58000000002
20575,U17236,61,-71830.74,33,28,318370.75,246540.01
20576,U31199,61,9074.849999999999,47,14,5310.76,14385.609999999999
20577,U11451,61,-285.7800000000036,45,16,25634.64,25348.859999999997
20578,U11913,61,-22313.21,53,8,25455.049999999996,3141.8399999999965
20579,U21312,61,-44410.520000000004,44,17,237893.78,193483.26
20580,U36161,61,-3085.83,59,2,4432.709999999999,1346.8799999999992
20581,U41014,61,-1622.0500000000002,57,4,11519.099999999999,9897.05
20582,U16787,61,1575.2300000000032,42,19,147638.00999999998,149213.24
20583,U991490,61,-5926.379999999999,37,24,11490.369999999999,5563.99
20584,U22190,61,-355.0,33,28,124082.26000000001,123727.26000000001
20585,U16018,61,-527.7099999999973,50,11,58831.46000000001,58303.75000000001
20586,U25847,61,-3663.989999999999,48,13,27460.250000000004,23796.260000000006
20587,U38125,61,31075.510000000006,50,11,46524.490000000005,77600.00000000001
20588,U20943,61,-95258.50000000001,45,16,450491.58,355233.08
20589,U41113,61,-14295.779999999999,51,10,311579.44000000006,297283.66000000003
20590,U30204,61,-73050.20999999999,47,14,214961.62,141911.41
20591,U34964,61,3367.699999999997,48,13,13116.87,16484.57
20592,U1355606,61,1992.529999999997,35,26,34359.59,36352.119999999995
20593,U11196,61,893.9299999999989,41,20,96441.25,97335.18
20594,U38196,61,99303.49000000002,42,19,268190.5,367493.99
20595,U34274,61,-31488.100000000006,50,11,84032.31000000001,52544.21000000001
20596,U28743,61,-855.0400000000014,43,18,30157.089999999975,29302.049999999974
20597,U18374,61,-57.120000000000346,56,5,11521.4,11464.279999999999
20598,U9936,61,12985.260000000002,49,12,19192.729999999996,32177.989999999998
20599,U1134125,61,-8.609999999999673,50,11,16872.699999999997,16864.089999999997
20600,U12358,61,31340.250000000033,38,23,816305.39,847645.64
20601,U20883,61,158425.76,39,22,699149.34,857575.1
20602,U12307,61,-111939.06,47,14,388522.85,276583.79
20603,U13517,61,-65763.03000000001,52,9,205126.51,139363.47999999998
20604,U31212,61,-967.8599999999985,50,11,22145.429999999997,21177.57
20605,U18047,61,10707.769999999953,41,20,653191.48,663899.2499999999
20606,U36328,61,8127.290000000002,55,6,24781.4,32908.69
20607,U30302,61,-5457.710000000003,30,31,438533.22,433075.50999999995
20608,U15386,61,5822.489999999998,53,8,37719.5,43541.99
20609,U24570,61,34085.60000000002,37,24,1055193.63,1089279.23
20610,U30805,61,-49.05999999999957,55,6,12767.81,12718.75
20611,U15255,61,-82367.05000000005,36,25,702358.9199999999,619991.8699999999
20612,U32861,61,-88.24000000000139,48,13,84928.41999999998,84840.17999999998
20613,U21460,61,676.4400000000031,56,5,180671.60000000053,181348.04000000053
20614,U33851,61,17793.73,42,19,27774.06,45567.79
20615,U39841,61,-7580.74,32,29,24053.420000000002,16472.68
20616,U17589,61,475.7899999999863,53,8,76553.01000000002,77028.80000000002
20617,U33707,61,437.7000000000153,23,38,320239.52,320677.22000000003
20618,U41591,61,890.1699999999997,46,15,15555.080000000002,16445.25
20619,U16536,61,-41575.93999999997,40,21,378572.00000000006,336996.06000000006
20620,U42214,61,-14419.980000000007,35,26,176638.0,162218.02
20621,U34005,61,-34012.42,59,2,46014.68,12002.260000000002
20622,U40702,61,27608.129999999994,37,24,130460.32,158068.45
20623,U13645,61,99700.93000000001,47,14,167105.93000000002,266806.86000000004
20624,U9326,61,-2330.9099999999853,27,34,745008.7699999999,742677.8599999999
20625,U20005,61,8071.210000000001,49,12,18301.000000000004,26372.210000000006
20626,U18169,61,-139372.36,49,12,884303.82,744931.46
20627,U30369,61,-312641.41999999987,46,15,397504.81999999995,84863.40000000008
20628,U8078,61,17744.609999999895,52,9,661056.6100000002,678801.2200000001
20629,U40884,60,4830.9700000000075,43,17,180983.27000000002,185814.24000000002
20630,U40260,60,8967.150000000001,34,26,118662.70999999999,127629.85999999999
20631,U35244,60,-13057.269999999931,35,25,501803.01,488745.7400000001
20632,U33337,60,-6081.489999999992,35,25,343629.64,337548.15
20633,U43740,60,5960.45,39,21,162495.81,168456.26
20634,U43891,60,7866.260000000002,38,22,52518.31,60384.57
20635,U37516,60,-16593.97,49,11,40019.240000000005,23425.270000000004
20636,U38175,60,-916.810000000005,41,19,112202.23000000001,111285.42000000001
20637,U11368,60,49942.67,44,16,219282.58,269225.25
20638,U18387,60,202.47000000002313,30,30,205402.39,205604.86000000004
20639,U23415,60,20906.160000000065,47,13,640731.63,661637.79
20640,U41567,60,690.6499999999069,33,27,1343365.9,1344056.5499999998
20641,U988082,60,-21039.489999999998,34,26,65556.89,44517.4
20642,U13541,60,54827.48999999999,33,27,69231.98999999999,124059.47999999998
20643,U33226,60,-3612.21,57,3,6249.67,2637.46
20644,U14831,60,-159983.77,51,9,385697.32,225713.55000000002
20645,U29618,60,-28924.969999999965,44,16,462349.81,433424.84
20646,U903088,60,-1601.8899999999987,44,16,37057.39999999999,35455.50999999999
20647,U35374,60,-42.930000000000604,39,21,13361.34,13318.41
20648,U12871,60,151331.55999999997,44,16,137225.58000000007,288557.14
20649,U32353,60,-76046.51,31,29,170087.38,94040.87000000001
20650,U14283,60,3961.5599999999977,50,10,154112.0,158073.56
20651,U39665,60,-102074.22999999995,47,13,1296581.69,1194507.46
20652,U10974,60,1318.880000000001,39,21,142150.06999999998,143468.94999999998
20653,U39478,60,-148652.56000000003,22,38,1963780.0,1815127.44
20654,U23104,60,-42254.729999999996,46,14,153143.31,110888.58
20655,U23839,60,50876.37999999999,51,9,70622.35,121498.73
20656,U31141,60,8246.51000000001,43,17,207018.36999999997,215264.87999999998
20657,U32822,60,116113.69999999998,48,12,665885.99,781999.69
20658,U30790,60,49909.55999999999,52,8,88679.86000000002,138589.42
20659,U28928,60,45753.920000000006,49,11,12852.56,58606.48
20660,U18069,60,75412.98999999999,25,35,387119.86,462532.85
20661,U12578,60,-18909.91,41,19,139028.19999999998,120118.28999999998
20662,U11342,60,1653.440000000001,45,15,23379.529999999995,25032.969999999998
20663,U33204,60,3722.94,56,4,51731.10999999999,55454.049999999996
20664,U18054,60,13.789999999999054,47,13,15406.710000000003,15420.500000000002
20665,U25955,60,-1075.4599999999919,42,18,284037.63,282962.17000000004
20666,U19207,60,4757.18,51,9,21032.750000000004,25789.930000000004
20667,U15858,60,-34390.47000000007,32,28,532716.34,498325.8699999999
20668,U25090,60,5058.079999999978,34,26,391839.13,396897.20999999996
20669,U41650,60,219.4199999999997,44,16,42207.50000000001,42426.920000000006
20670,U20586,60,-91182.67000000001,43,17,304187.0,213004.33
20671,U8804,60,77.36000000000969,45,15,156592.82,156670.18000000002
20672,U601277,60,5414.61,39,21,9711.339999999998,15125.949999999997
20673,U19783,60,35312.29,53,7,55726.3,91038.59
20674,U15876,60,144999.99,42,18,203355.78,348355.77
20675,U13867,60,-34897.340000000004,50,10,115538.33999999998,80640.99999999997
20676,U43516,60,-792.549999999999,36,24,39916.1,39123.55
20677,U32933,60,-21751.999999999996,33,27,211672.22,189920.22
20678,U1081110,60,-3381.8899999999976,49,11,16572.260000000002,13190.370000000004
20679,U10125,60,89.19999999993365,37,23,2174584.6599999997,2174673.8599999994
20680,U36497,60,7429.89,54,6,5793.509999999999,13223.4
20681,U38131,60,-1670.9600000000019,33,27,400952.12,399281.16
20682,U23781,60,-291330.33999999997,46,14,1001680.8099999999,710350.47
20683,U14551,60,-47474.159999999996,52,8,177521.62999999995,130047.46999999994
20684,U34756,60,87.47000000000007,55,5,1973.0999999999997,2060.5699999999997
20685,U43925,60,-209.8699999999856,35,25,234903.84999999998,234693.97999999998
20686,U14133,60,-19124.31999999995,40,20,700022.9099999999,680898.59
20687,U15461,60,16322.11,44,16,101483.12,117805.23
20688,U34490,60,-1297.429999999999,41,19,53104.340000000004,51806.91
20689,U10441,60,2169.8199999999993,47,13,65711.07,67880.89
20690,U17521,60,-17311.29999999999,44,16,434970.23999999993,417658.93999999994
20691,U39555,60,13635.569999999992,21,39,824731.27,838366.84
20692,U11973,60,1668.2900000000136,40,20,182964.59000000003,184632.88000000003
20693,U34011,60,-5083.800000000002,48,12,35897.96,30814.159999999996
20694,U21777,60,-3158.239999999999,35,25,17677.850000000006,14519.610000000008
20695,U10886,60,-189.36000000000047,43,17,49733.149999999994,49543.78999999999
20696,U23857,60,15065.230000000003,35,25,108734.25,123799.48000000001
20697,U19833,60,-600.749999999997,43,17,147587.93,146987.18
20698,U14442,60,1282.9199999999978,40,20,57515.71000000001,58798.630000000005
20699,U41422,60,-4100.700000000001,43,17,47123.380000000005,43022.68000000001
20700,U37869,60,244.9899999999994,47,13,31976.58,32221.57
20701,U41557,60,-46970.36000000001,52,8,82756.25000000004,35785.890000000036
20702,U25918,60,-17698.79,51,9,47350.73,29651.940000000002
20703,U14361,60,8533.580000000002,45,15,172087.62000000005,180621.20000000007
20704,U11367,60,73003.61000000009,30,30,968150.41,1041154.0200000001
20705,U24602,60,1419.6500000000083,49,11,135314.35,136734.0
20706,U17938,60,48153.800000000025,28,32,130713.47000000002,178867.27000000005
20707,U27626,60,-190364.42999999993,36,24,454467.5,264103.07000000007
20708,U31625,60,263698.33999999997,39,21,956904.02,1220602.3599999999
20709,U30808,60,-56489.570000000014,44,16,222348.92,165859.35
20710,U23324,60,728.3800000000028,27,33,326827.65,327556.03
20711,U1176129,60,-1709.82,35,25,7252.83,5543.01
20712,U26960,60,0.5,35,25,216743.09999999998,216743.59999999998
20713,U37040,60,-323.4200000000019,47,13,91621.61000000002,91298.19000000002
20714,U20042,60,-1795.4599999999919,42,18,150863.94,149068.48
20715,U28658,60,-48988.58,43,17,85275.15,36286.56999999999
20716,U34735,60,-34429.749999999985,31,29,1227355.64,1192925.89
20717,U24020,60,-2247.969999999994,40,20,264275.67,262027.69999999998
20718,U26267,60,-37832.31,52,8,144243.65,106411.34
20719,U43257,60,4557.08,31,29,73733.04000000001,78290.12000000001
20720,U25774,60,-441695.9800000002,29,31,3028674.05,2586978.0699999994
20721,U26117,60,-37624.81999999999,41,19,348470.4399999999,310845.6199999999
20722,U33990,60,129065.03,50,10,27996.2,157061.23
20723,U24473,60,15358.21,55,5,10630.789999999999,25989.0
20724,U19083,60,0.3600000000010368,30,30,99521.74,99522.1
20725,U602660,60,-623.2100000000012,40,20,25090.870000000003,24467.66
20726,U24908,60,10221.52,48,12,13776.44,23997.96
20727,U36147,60,-60299.97,23,37,362161.18000000005,301861.2100000001
20728,U33673,60,879.7499999999997,51,9,6412.51,7292.26
20729,U29075,60,-38208.02000000001,45,15,143908.18,105700.15999999997
20730,U23966,60,1403.0900000000372,38,22,413357.31999999995,414760.41
20731,U22437,60,-25993.180000000015,27,33,334362.06,308368.88
20732,U39414,60,-11937.119999999995,33,27,267432.96,255495.84000000003
20733,U32170,60,-1908.6400000000044,48,12,68822.5,66913.86
20734,U15648,60,2703.210000000009,48,12,152749.63999999998,155452.85
20735,U32770,60,-3609.2000000000335,27,33,8190583.26,8186974.06
20736,U38500,60,-2092.550000000003,35,25,225093.94,223001.39
20737,U22113,60,-69175.71,39,21,216498.27,147322.56
20738,U14531,60,-11107.73000000001,29,31,860785.86,849678.13
20739,U34248,60,16631.91999999999,45,15,140509.09999999998,157141.01999999996
20740,U33838,60,57377.84000000001,36,24,668276.58,725654.4199999999
20741,U11336,60,974.1299999999994,54,6,7082.26,8056.389999999999
20742,U23345,60,45990.89999999999,52,8,9984.489999999994,55975.389999999985
20743,U12128,60,-9278.619999999997,43,17,72341.6,63062.98000000001
20744,U27453,60,-13034.570000000003,49,11,24904.64,11870.069999999996
20745,U38680,60,-404.24,45,15,4439.4,4035.16
20746,U41702,60,-15940.340000000084,37,23,737229.9199999998,721289.5799999997
20747,U20567,60,14521.070000000002,52,8,53762.009999999995,68283.08
20748,U22765,60,-4140.790000000001,48,12,121634.23,117493.44
20749,U43268,60,-603.5300000000007,44,16,24474.890000000003,23871.36
20750,U39951,60,-62222.40999999997,41,19,1038475.41,976253.0000000001
20751,U21587,60,6889.849999999946,50,10,1097849.34,1104739.19
20752,U26009,60,-14587.330000000075,21,39,2103000.36,2088413.0299999998
20753,U27217,60,91120.61000000006,47,13,189993.19,281113.80000000005
20754,U16390,60,-508041.26000000007,43,17,895753.97,387712.7099999999
20755,U32559,60,-38224.35999999998,36,24,1960061.19,1921836.83
20756,U13518,60,-19310.120000000003,48,12,45339.35999999999,26029.23999999999
20757,U23127,60,-68201.09,42,18,187367.01,119165.92000000001
20758,U31182,60,3087.0599999999986,55,5,1543.1599999999999,4630.219999999998
20759,U33804,60,1187.2599999999998,50,10,8632.97,9820.23
20760,U25348,60,54367.610000000044,29,31,280916.16000000003,335283.7700000001
20761,U35903,60,-178.59000000000117,46,14,62486.01000000001,62307.420000000006
20762,U40147,60,-3332.75,56,4,7852.000000000001,4519.250000000001
20763,U1342597,60,-58.80999999999938,49,11,5415.22,5356.410000000001
20764,U16621,60,862.7300000000055,41,19,65499.5,66362.23000000001
20765,U10307,60,-625.8999999999796,52,8,285829.0,285203.10000000003
20766,U31326,60,25700.050000000003,31,29,22128.219999999998,47828.270000000004
20767,U23162,60,13400.179999999953,31,29,797860.73,811260.9099999999
20768,U17106,60,64266.46000000001,50,10,460.6399999999998,64727.100000000006
20769,U20990,60,6471.210000000004,38,22,105851.66999999998,112322.87999999999
20770,U41121,60,-418.9200000000001,54,6,16578.989999999998,16160.069999999998
20771,U37936,60,271.2999999999993,46,14,14294.66,14565.96
20772,U32828,60,-74236.88999999998,30,30,756441.0,682204.11
20773,U15976,60,-17600.320000000014,37,23,198968.03,181367.71
20774,U33277,60,153199.14999999997,38,22,63424.670000000006,216623.81999999998
20775,U1022758,60,683.9600000000013,47,13,24041.009999999995,24724.969999999998
20776,U8170,60,230.87999999999872,52,8,16685.920000000002,16916.8
20777,U20940,60,-35614.69,51,9,130069.89,94455.2
20778,U36548,60,-3896.7400000000002,42,18,57957.8,54061.060000000005
20779,U23227,60,-764.0300000000007,58,2,10964.03,10200.0
20780,U37257,60,-1301.4300000000003,52,8,21461.989999999998,20160.559999999998
20781,U1079635,60,5381.289999999997,47,13,103264.87000000001,108646.16
20782,U899639,60,1557.4199999999998,35,25,20736.449999999993,22293.86999999999
20783,U13212,60,-54784.46000000002,50,10,69256.62999999996,14472.16999999994
20784,U708589,60,-7097.299999999999,36,24,57132.74,50035.44
20785,U35350,60,2933.3900000000003,47,13,67085.37000000001,70018.76000000001
20786,U19347,60,13.939999999985632,31,29,509726.74,509740.68
20787,U43550,60,26767.429999999997,36,24,430155.5,456922.93
20788,U12184,60,546.2599999999999,39,21,35342.65,35888.91
20789,U21695,60,199282.09000000003,34,26,2935971.1,3135253.19
20790,U40443,60,-1957.300000000001,47,13,66309.59,64352.28999999999
20791,U37608,60,-4795.939999999999,51,9,15227.35,10431.410000000002
20792,U8298,60,5848.889999999999,46,14,166201.68000000002,172050.57
20793,U42547,60,18468.199999999975,35,25,273656.04,292124.23999999993
20794,U42886,60,-5631.24,42,18,64396.33999999999,58765.09999999999
20795,U33752,60,-913.2199999999993,48,12,23913.35,23000.129999999997
20796,U17605,60,-23267.989999999994,46,14,79381.26999999999,56113.28
20797,U22037,60,-27514.33,51,9,54615.659999999996,27101.329999999994
20798,U35322,60,1845.119999999999,40,20,180817.22,182662.34
20799,U12050,60,-19518.91,54,6,24202.66,4683.75
20800,U27231,60,-20807.959999999995,49,11,72065.74000000003,51257.78000000004
20801,U28963,60,653.7799999999993,54,6,26591.16,27244.94
20802,U8407,60,4864.519999999987,43,17,170418.43,175282.94999999998
20803,U22064,60,182.23999999999756,41,19,171862.93,172045.16999999998
20804,U11703,60,-31536.17,35,25,494963.21,463427.04000000004
20805,U37295,60,-60679.60999999999,45,15,209598.09000000003,148918.48000000004
20806,U10927,60,480339.18000000017,42,18,132341.21,612680.3900000001
20807,U14627,60,4252.880000000001,52,8,69572.66000000002,73825.54000000002
20808,U25384,60,-4755.7300000000105,38,22,249325.63,244569.9
20809,U10102,60,-8346.169999999995,38,22,51781.24000000001,43435.07000000002
20810,U41878,60,-24166.709999999977,42,18,558321.43,534154.7200000001
20811,U9514,60,-1485.7299999999957,39,21,75338.45,73852.72
20812,U15560,60,-14074.72999999999,51,9,47382.61999999999,33307.89
20813,U12121,60,3240.7400000000007,40,20,38970.990000000005,42211.73
20814,U16576,60,51564.01999999998,44,16,11390.68,62954.69999999998
20815,U43910,60,54206.71000000001,44,16,183585.25999999992,237791.9699999999
20816,U8102,60,8558.269999999997,41,19,70005.38,78563.65
20817,U14582,60,-102286.39,43,17,318330.08999999997,216043.69999999995
20818,U33058,60,4231.669999999993,38,22,202008.93,206240.59999999998
20819,U25079,60,13455.319999999982,25,35,730614.0499999998,744069.3699999998
20820,U16104,60,14116.830000000018,42,18,122246.09,136362.92
20821,U29641,60,7418.609999999999,40,20,13367.300000000003,20785.910000000003
20822,U14594,60,1018817.3799999995,43,17,531516.58,1550333.9599999995
20823,U35859,60,143294.19999999992,36,24,1850724.5,1994018.7
20824,U27878,60,-14990.449999999997,30,30,209518.0,194527.55
20825,U12383,60,-3822.3,49,11,32346.379999999986,28524.079999999987
20826,U26932,60,42665.72999999998,41,19,188109.78000000006,230775.51000000004
20827,U24947,59,-13423.26,51,8,55754.920000000006,42331.66
20828,U14666,59,-1850.0999999999985,43,16,27678.610000000004,25828.510000000006
20829,U19671,59,2840.9699999999975,46,13,76434.69,79275.66
20830,U10890,59,-18584.509999999995,50,9,145821.47,127236.96
20831,U30269,59,4083.830000000008,41,18,86271.94999999998,90355.77999999998
20832,U27671,59,1722.4400000000005,44,15,30638.020000000004,32360.460000000006
20833,U29718,59,-7211.349999999997,45,14,48092.79000000001,40881.44000000001
20834,U9814,59,-166273.66999999993,52,7,266418.67,100145.00000000006
20835,U22834,59,-24161.73999999999,29,30,159967.68,135805.94
20836,U30558,59,81932.48000000001,44,15,96413.14,178345.62
20837,U22594,59,-4389.54,51,8,30465.799999999996,26076.259999999995
20838,U25411,59,-126453.92000000001,23,36,1369712.16,1243258.24
20839,U22945,59,19072.68000000021,26,33,4662839.850000001,4681912.530000001
20840,U19802,59,-538.9599999999889,42,17,124091.99,123553.03000000001
20841,U34112,59,176.00000000000347,34,25,56849.69,57025.69
20842,U39779,59,118527.48000000003,49,10,29618.98,148146.46000000002
20843,U16014,59,-3053.0299999999997,42,17,100346.74999999999,97293.71999999999
20844,U18760,59,-3842.55,33,26,30265.77,26423.22
20845,U28179,59,-3.7199999999990254,52,7,12166.99,12163.27
20846,U38723,59,-166856.66999999998,54,5,226573.41,59716.74000000002
20847,U14608,59,95410.37000000008,35,24,790425.5700000001,885835.9400000002
20848,U20009,59,-59301.31000000006,37,22,1212399.6099999996,1153098.2999999996
20849,U28493,59,25728.629999999997,54,5,16795.179999999997,42523.81
20850,U24023,59,33391.130000000005,44,15,202284.20999999993,235675.33999999994
20851,U13009,59,373.3799999999991,56,3,3902.6600000000003,4276.039999999999
20852,U1175563,59,-2270.25,54,5,5462.719999999999,3192.4699999999993
20853,U31530,59,21.019999999997594,32,27,97429.16,97450.18000000001
20854,U29821,59,98876.37,45,14,18863.22,117739.59
20855,U15336,59,-11056.860000000013,49,10,150243.72,139186.86
20856,U18726,59,35867.65999999979,44,15,6208602.900000001,6244470.560000001
20857,U30927,59,-13146.250000000004,35,24,216765.2,203618.95
20858,U29954,59,3254.9300000000035,32,27,91501.56,94756.49
20859,U38406,59,-1260.9899999999998,55,4,14254.169999999998,12993.179999999998
20860,U36706,59,12993.820000000002,5,54,1260.0,14253.820000000002
20861,U30156,59,30500.409999999996,51,8,126528.26000000001,157028.67
20862,U843798,59,2042.9899999999932,37,22,40587.26000000001,42630.25
20863,U43454,59,-9494.730000000012,34,25,119571.86,110077.12999999999
20864,U29219,59,28920.320000000007,42,17,406958.61,435878.93
20865,U37935,59,7690.170000000009,29,30,354445.48,362135.64999999997
20866,U39301,59,-406216.02,43,16,1033138.04,626922.02
20867,U38668,59,32764.040000000005,35,24,184491.9,217255.94
20868,U27599,59,12039.840000000002,41,18,150422.12999999998,162461.96999999997
20869,U17356,59,-28874.600000000006,45,14,54497.11000000002,25622.510000000017
20870,U36877,59,229290.64,39,20,29702.3,258992.94
20871,U31533,59,21745.23,42,17,5386.099999999999,27131.329999999998
20872,U39020,59,996.8999999999978,30,29,126121.46,127118.36
20873,U18033,59,176.05999999999983,53,6,8813.14,8989.199999999999
20874,U16689,59,-11009.180000000004,42,17,72463.71999999997,61454.539999999964
20875,U37654,59,17975.820000000003,54,5,10751.51,28727.33
20876,U36768,59,492.0700000000003,52,7,13686.429999999998,14178.499999999998
20877,U39249,59,-2259.0200000000095,48,11,103871.84,101612.81999999999
20878,U15488,59,-12946.509999999998,54,5,16496.57,3550.0600000000013
20879,U9672,59,-6380.899999999998,53,6,437152.91000000003,430772.01
20880,U42220,59,4798.87,43,16,49156.32,53955.19
20881,U14358,59,505.8000000000029,39,20,85752.09000000001,86257.89000000001
20882,U43816,59,3875.1699999999983,33,26,66400.78,70275.95
20883,U43366,59,16342.779999999999,52,7,59758.75,76101.53
20884,U18895,59,8816.089999999997,26,33,356204.79000000004,365020.88
20885,U36932,59,30956.209999999992,51,8,178015.39,208971.6
20886,U676044,59,-180.9400000000017,34,25,24961.2,24780.26
20887,U24797,59,26242.39,44,15,143374.99,169617.38
20888,U35495,59,-487.2599999999991,38,21,35242.89,34755.63
20889,U13400,59,57624.29000000004,30,29,1997240.1600000001,2054864.4500000002
20890,U24159,59,64363.07000000007,48,11,1739724.48,1804087.55
20891,U11742,59,25098.269999999997,46,13,2967.8899999999994,28066.159999999996
20892,U10369,59,10634.509999999893,42,17,729286.01,739920.5199999999
20893,U28205,59,15637.219999999998,33,26,130441.43,146078.65
20894,U8627,59,-38788.56,32,27,232536.93,193748.37
20895,U33477,59,-277.0200000000001,47,12,15680.49,15403.47
20896,U28969,59,816.6900000000014,49,10,19660.85,20477.54
20897,U42123,59,-9233.9,56,3,11965.439999999999,2731.539999999999
20898,U618585,59,-1062.3300000000002,51,8,2964.46,1902.1299999999999
20899,U29823,59,2832.100000000004,44,15,102575.75999999997,105407.85999999997
20900,U43544,59,-7417.000000000002,38,21,160556.06000000003,153139.06000000003
20901,U32029,59,-378847.79,45,14,553677.24,174829.45
20902,U18361,59,9461.210000000003,56,3,3849.2100000000005,13310.420000000004
20903,U16603,59,47397.96999999979,44,15,1147149.06,1194547.0299999998
20904,U19382,59,-17411.34,39,20,72177.1,54765.76000000001
20905,U36150,59,2439.36,49,10,22735.800000000003,25175.160000000003
20906,U27726,59,6427.860000000038,39,20,297393.6,303821.46
20907,U41090,59,2027.7900000000745,27,32,3032244.6399999997,3034272.4299999997
20908,U1067912,59,-2850.6,47,12,13175.09,10324.49
20909,U30492,59,-1109.9399999999982,39,20,33904.44,32794.50000000001
20910,U28624,59,731.4800000000005,47,12,37218.909999999996,37950.39
20911,U41441,59,1492.4900000000066,46,13,61328.369999999995,62820.86
20912,U37273,59,-27314.679999999935,34,25,531193.5999999999,503878.9199999999
20913,U31173,59,19.9099999999964,31,28,74751.68000000001,74771.59000000001
20914,U1171670,59,-604.02,36,23,12913.869999999997,12309.849999999997
20915,U11328,59,-2833.0499999999997,54,5,13925.199999999997,11092.149999999998
20916,U9375,59,28871.07,48,11,45720.70000000002,74591.77000000002
20917,U29036,59,11506.22,35,24,136934.7,148440.92
20918,U34936,59,2002.4500000000012,43,16,24193.97,26196.420000000002
20919,U29538,59,-12522.149999999996,51,8,77471.11,64948.96000000001
20920,U9865,59,554.2300000000002,27,32,104174.51999999999,104728.74999999999
20921,U24176,59,-85422.29,29,30,736837.72,651415.4299999999
20922,U25602,59,-13628.759999999998,49,10,26035.430000000004,12406.670000000006
20923,U24530,59,-6504.000000000004,47,12,61575.450000000004,55071.45
20924,U36046,59,-38129.76000000002,35,24,59504.630000000005,21374.869999999988
20925,U10138,59,20763.18,49,10,115352.47999999995,136115.65999999995
20926,U35886,59,-173883.04,47,12,671324.8800000002,497441.8400000002
20927,U43794,59,-39571.840000000004,58,1,39571.87,0.029999999998835847
20928,U18051,59,7531.580000000002,40,19,37813.14,45344.72
20929,U20542,59,40220.62,54,5,3063.0,43283.62
20930,U25926,59,-29939.220000000016,40,19,518427.6599999999,488488.4399999999
20931,U37089,59,-3390.6299999999974,52,7,55300.39,51909.76
20932,U40163,59,-17433.210000000017,40,19,291525.33999999997,274092.12999999995
20933,U29077,59,632.6699999999973,43,16,37154.53999999999,37787.20999999999
20934,U18256,59,-2169.5900000000192,51,8,511093.05000000016,508923.46000000014
20935,U24210,59,14357.520000000193,29,30,3331426.9400000004,3345784.4600000004
20936,U41094,59,-948.1700000000001,54,5,6849.1,5900.93
20937,U43239,59,-4191.1900000000005,53,6,30671.02000000001,26479.83000000001
20938,U11264,59,19531.610000000008,41,18,212060.57,231592.18000000002
20939,U23726,59,-117869.45000000001,48,11,377099.23,259229.77999999997
20940,U28325,59,640.1999999999988,46,13,423000.28,423640.48000000004
20941,U35744,59,-5979.940000000003,53,6,71655.2,65675.26
20942,U21028,59,-2605.0099999999948,56,3,126946.98999999999,124341.98
20943,U18203,59,36613.95000000001,36,23,292285.49,328899.44
20944,U35406,59,-175.71999999999662,31,28,101512.81999999999,101337.09999999999
20945,U9181,59,-6865.710000000001,50,9,26574.92,19709.21
20946,U11370,59,-12748.310000000001,53,6,23347.87,10599.559999999998
20947,U8517,59,945.8600000000042,44,15,120259.43000000001,121205.29000000001
20948,U10918,59,2948.8699999999994,46,13,11054.079999999994,14002.949999999993
20949,U714008,59,388.7100000000004,39,20,10003.140000000003,10391.850000000004
20950,U35461,59,-2135.109999999996,44,15,69077.51000000001,66942.40000000001
20951,U43889,59,-869.1800000000022,47,12,14717.820000000005,13848.640000000003
20952,U27547,59,-7277.389999999999,55,4,19939.67,12662.279999999999
20953,U16452,59,-3119.279999999997,41,18,42804.61,39685.33
20954,U24627,59,-16373.55000000008,41,18,1025997.9800000004,1009624.4300000004
20955,U12653,59,-5916.1500000000015,31,28,121478.29,115562.13999999998
20956,U35991,59,31327.560000000005,42,17,206054.15999999997,237381.71999999997
20957,U9577,59,-14741.590000000026,47,12,253069.2,238327.61
20958,U24934,59,-7496.010000000009,37,22,317038.14,309542.13
20959,U25216,59,-3582.230000000003,48,11,84373.00999999998,80790.77999999997
20960,U673654,59,-606.2100000000003,31,28,14269.98,13663.769999999999
20961,U15789,59,-76.93000000010943,39,20,2611817.49,2611740.56
20962,U37489,59,-274338.69999999995,44,15,380780.49,106441.79000000004
20963,U33875,59,768.7199999999993,46,13,16471.35,17240.07
20964,U28294,59,-4184.220000000005,40,19,97562.87,93378.65
20965,U19280,59,-1338.279999999767,35,24,3572415.1799999997,3571076.9
20966,U38452,59,49.10000000000005,50,9,818.8899999999995,867.9899999999996
20967,U34141,59,1065.5500000000065,45,14,102307.6,103373.15000000001
20968,U26493,59,-559.5400000000118,45,14,205369.69999999998,204810.15999999997
20969,U39622,59,54911.51,28,31,276565.01999999996,331476.52999999997
20970,U16034,59,-379621.05,51,8,520494.46,140873.41000000003
20971,U35805,59,-2702.25000000001,31,28,1048883.53,1046181.28
20972,U33247,59,-30532.869999999995,46,13,300179.44,269646.57
20973,U23928,59,-1019245.1899999988,18,41,31086668.64,30067423.450000003
20974,U28773,59,-8082.950000000026,32,27,371823.58,363740.63
20975,U10115,59,-3143.9399999999996,49,10,14116.210000000001,10972.27
20976,U24121,59,-57245.830000000016,34,25,1440623.5699999998,1383377.7399999998
20977,U8435,59,5624.940000000018,38,21,262682.03,268306.97000000003
20978,U1313904,59,0.49999999999886313,30,29,16436.079999999998,16436.579999999998
20979,U27776,59,-334464.1899999999,46,13,859279.5700000002,524815.3800000004
20980,U25204,59,-43.50000000000408,39,20,65222.949999999975,65179.44999999997
20981,U19318,59,-9044.789999999988,36,23,338211.43,329166.64
20982,U31448,59,1751.6400000000006,52,7,4842.389999999999,6594.03
20983,U37148,59,-40884.49999999999,50,9,69318.66,28434.16000000001
20984,U43764,59,-7929.290000000001,55,4,18191.149999999994,10261.859999999993
20985,U30659,59,-290.3600000000006,39,20,210560.48,210270.12
20986,U35215,59,-7249.530000000024,37,22,460496.0,453246.47
20987,U33171,59,35276.80999999999,47,12,92561.55999999998,127838.36999999997
20988,U12617,59,-88836.95000000001,42,17,537580.4299999998,448743.4799999998
20989,U27773,59,22728.410000000003,51,8,15809.89,38538.3
20990,U41847,59,6652.33,46,13,29535.739999999998,36188.07
20991,U13482,59,-8884.069999999989,34,25,434037.1999999999,425153.1299999999
20992,U705381,59,-12426.75,38,21,42484.189999999995,30057.439999999995
20993,U22300,59,3508.1899999999987,42,17,4712.02,8220.21
20994,U34133,59,-102012.76999999999,47,12,108497.36,6484.590000000011
20995,U42498,59,-242.02000000000015,54,5,4642.16,4400.139999999999
20996,U9920,59,-7521.549999999997,48,11,93831.12,86309.56999999999
20997,U34914,59,-21807.860000000008,45,14,150456.80000000002,128648.94
20998,U28781,59,-217.2899999999998,54,5,8801.900000000001,8584.610000000002
20999,U32864,59,-1116.909999999994,50,9,161662.47999999998,160545.56999999998
21000,U33827,59,-30766.820000000007,43,16,164532.84,133766.02
21001,U8700,59,6217.489999999996,52,7,75670.09,81887.57999999999
21002,U23134,59,44280.419999999984,49,10,105857.29999999999,150137.71999999997
21003,U28673,59,16213.810000000016,41,18,160374.24,176588.05000000002
21004,U13619,59,-99109.41000000201,27,32,28147376.39,28048266.979999997
21005,U18080,59,-104.29999999999927,47,12,114092.66,113988.36
21006,U10508,59,1528.8400000000038,47,12,104724.12999999999,106252.97
21007,U11863,59,-282001.04999999993,48,11,414578.1,132577.05000000005
21008,U13581,59,-95870.44,39,20,1793049.0299999998,1697178.5899999999
21009,U32512,59,-67860.48999999996,41,18,673142.26,605281.77
21010,U17231,59,13702.73000000001,36,23,502939.62,516642.35
21011,U36342,59,2190.659999999999,49,10,13475.42,15666.079999999998
21012,U37508,59,-19462.67,51,8,46359.18,26896.510000000002
21013,U19809,59,-854.380000000001,29,30,147393.68,146539.3
21014,U33092,59,4136.490000000001,51,8,11250.789999999995,15387.279999999995
21015,U15615,59,19397.59999999999,41,18,174111.79,193509.39
21016,U28574,59,-448.3499999999967,46,13,151896.2700000001,151447.9200000001
21017,U25274,59,-8733.310000000001,49,10,17182.4,8449.09
21018,U9503,59,4137.76,25,34,105988.72,110126.48
21019,U34297,59,1286.0999999999995,49,10,53433.75,54719.85
21020,U38025,59,-2103.9600000000005,50,9,10325.149999999998,8221.189999999997
21021,U24540,59,15655.379999999997,41,18,105039.1,120694.48000000001
21022,U25698,59,-30550.859999999986,45,14,230085.36,199534.5
21023,U40317,59,-1159.2700000000063,37,22,119771.76999999997,118612.49999999997
21024,U9899,59,4384.539999999996,36,23,69526.80999999998,73911.34999999998
21025,U29329,59,-134598.98999999993,42,17,1474013.55,1339414.56
21026,U17946,59,11548.910000000005,42,17,288448.04000000004,299996.95000000007
21027,U28270,59,2732.4500000000007,38,21,144067.19,146799.64
21028,U30260,59,5009.34,54,5,7741.19,12750.529999999999
21029,U32234,59,36941.61,45,14,85375.9,122317.51
21030,U41183,59,-878.5000000000291,40,19,760614.2000000001,759735.7000000001
21031,U35946,59,10611.780000000004,48,11,22824.16,33435.94
21032,U21200,58,573.420000000001,46,12,13115.289999999999,13688.71
21033,U17653,58,-1.8189894035458565e-12,31,27,193186.07,193186.07
21034,U15471,58,4139.230000000001,42,16,74921.62999999999,79060.85999999999
21035,U43234,58,-298.7300000000005,51,7,11747.62,11448.89
21036,U32632,58,-6231.239999999999,46,12,20096.71,13865.470000000001
21037,U37195,58,-100595.17000000013,32,26,2811972.9299999997,2711377.76
21038,U39804,58,9770.24,51,7,33922.58,43692.82
21039,U28235,58,-202.97,55,3,2205.2599999999998,2002.2899999999997
21040,U12686,58,55587.420000000006,52,6,56421.58,112009.0
21041,U22183,58,3637.0999999999995,49,9,77664.12000000002,81301.22000000003
21042,U17234,58,-76557.28,31,27,647936.06,571378.78
21043,U36210,58,6481.699999999997,44,14,70377.46,76859.16
21044,U34183,58,-24052.649999999994,36,22,427517.99,403465.33999999997
21045,U30518,58,-1032.2199999999866,46,12,115840.41,114808.19000000002
21046,U14853,58,-19964.20000000004,29,29,3000910.0,2980945.8
21047,U34184,58,-17.340000000001055,48,10,17800.949999999997,17783.609999999997
21048,U26460,58,-46922.280000000006,40,18,183566.9,136644.62
21049,U12377,58,63659.84000000001,44,14,59234.060000000034,122893.90000000005
21050,U38860,58,-9447.659999999974,33,25,669971.56,660523.9000000001
21051,U37754,58,-259659.79000000004,46,12,371430.43999999994,111770.6499999999
21052,U13893,58,2256.9900000000016,50,8,23013.28,25270.27
21053,U36767,58,52116.05999999996,49,9,74181.86000000003,126297.91999999998
21054,U31143,58,18757.840000000004,50,8,70819.15000000001,89576.99000000002
21055,U34507,58,4875.290000000001,46,12,59084.17,63959.46
21056,U24339,58,-12676.81000000001,32,26,383734.06999999995,371057.25999999995
21057,U41174,58,4872.499999999998,38,20,31379.15,36251.65
21058,U40501,58,-8293.08999999999,41,17,102515.97000000003,94222.88000000003
21059,U32084,58,-318562.75,25,33,3190600.0,2872037.25
21060,U42636,58,3335.609999999999,50,8,14178.480000000001,17514.09
21061,U26054,58,24416.49000000002,30,28,1208269.8699999999,1232686.3599999999
21062,U33039,58,355.3399999999931,38,20,83990.14,84345.48
21063,U23529,58,1288.7100000000046,37,21,119452.13,120740.84000000001
21064,U15103,58,12293.449999999983,37,21,992789.9,1005083.35
21065,U980215,58,-4534.529999999998,45,13,39431.42999999999,34896.899999999994
21066,U659037,58,-901.5899999999997,51,7,1913.0000000000002,1011.4100000000005
21067,U30603,58,3744.9300000000003,42,16,24009.64,27754.57
21068,U29454,58,-10754.209999999994,52,6,38095.080000000016,27340.870000000024
21069,U27293,58,-455.2199999999939,39,19,512748.57000000007,512293.3500000001
21070,U21855,58,20352.140000000003,51,7,15248.750000000002,35600.89000000001
21071,U40414,58,197398.74000000002,36,22,195691.85,393090.59
21072,U18372,58,30.73999999999981,46,12,9988.84,10019.58
21073,U20796,58,5636.120000000004,34,24,42130.58,47766.700000000004
21074,U42532,58,-21328.86,48,10,77777.94,56449.08
21075,U25611,58,457.5299999999952,50,8,136298.31,136755.84
21076,U16309,58,-4261.000000000001,52,6,27180.069999999996,22919.069999999996
21077,U10642,58,1691.0400000000045,44,14,87330.69999999998,89021.73999999999
21078,U36674,58,-32462.649999999994,45,13,81615.39,49152.740000000005
21079,U11755,58,38585.96000000001,29,29,509396.3900000001,547982.3500000001
21080,U8450,58,518.2799999999997,49,9,21902.28,22420.559999999998
21081,U15545,58,-14919.629999999888,45,13,1229074.86,1214155.2300000002
21082,U16370,58,33894.16,43,15,35284.56,69178.72
21083,U18565,58,110432.33000000002,42,16,108563.90999999999,218996.24
21084,U43547,58,-667.8500000000013,49,9,41032.36,40364.51
21085,U38908,58,-4190.300000000001,48,10,4356.870000000002,166.57000000000062
21086,U29372,58,-2423.95,45,13,25668.28,23244.329999999998
21087,U29023,58,-80264.47,39,19,218954.68,138690.21
21088,U15610,58,287782.96999999974,24,34,3576393.12,3864176.09
21089,U43302,58,78361.25,28,30,287199.4,365560.65
21090,U26709,58,149025.27,38,20,558984.4900000001,708009.7600000001
21091,U40158,58,-146095.55000000002,41,17,298627.68000000005,152532.13000000003
21092,U26698,58,5804.17,51,7,24462.989999999998,30267.159999999996
21093,U39658,58,-8823.359999999995,39,19,227288.11,218464.75
21094,U35895,58,-16115.889999999992,55,3,24824.340000000004,8708.450000000012
21095,U37029,58,1119.5999999999995,48,10,14346.749999999998,15466.349999999999
21096,U42147,58,-64855.35999999998,41,17,156919.39,92064.03000000003
21097,U32801,58,22813.579999999998,43,15,74373.19,97186.77
21098,U12163,58,1561.92,39,19,19582.920000000002,21144.840000000004
21099,U26633,58,515.8199999999997,42,16,15568.36,16084.18
21100,U21858,58,1260.4800000000005,46,12,10541.459999999997,11801.939999999999
21101,U22999,58,-26758.96,43,15,362915.07,336156.11
21102,U1153380,58,687.149999999999,30,28,16158.130000000003,16845.280000000002
21103,U18891,58,-4507.990000000009,49,9,74814.58,70306.59
21104,U16865,58,-1422.7000000000007,47,11,33370.380000000005,31947.680000000004
21105,U36501,58,4664.2,53,5,4879.18,9543.380000000001
21106,U13506,58,-21155.11,41,17,179199.49999999997,158044.38999999996
21107,U31154,58,-499680.72000000015,54,4,520460.9000000002,20780.18000000005
21108,U8510,58,12965.49,33,25,154422.76,167388.25
21109,U10669,58,4089.990000000002,46,12,42980.76000000001,47070.750000000015
21110,U37713,58,-110.5200000000008,55,3,11184.300000000001,11073.78
21111,U1144957,58,-9599.690000000002,47,11,49047.63000000002,39447.94000000002
21112,U22148,58,-12414.449999999999,40,18,66204.35,53789.90000000001
21113,U29493,58,-462.0700000000001,46,12,16783.02,16320.95
21114,U42039,58,518.7900000000081,49,9,87889.04999999999,88407.84
21115,U36765,58,-1360.9599999999978,49,9,71145.62999999998,69784.66999999998
21116,U37276,58,231422.30999999994,38,20,803062.72,1034485.0299999999
21117,U41635,58,1845.340000000002,45,13,49030.87,50876.21000000001
21118,U30962,58,449.1700000000002,51,7,1509.45,1958.6200000000003
21119,U29860,58,-28966.580000000005,50,8,36212.939999999995,7246.35999999999
21120,U21025,58,-6391.910000000001,46,12,46422.2,40030.28999999999
21121,U10738,58,711177.43,45,13,233956.51000000004,945133.9400000001
21122,U28808,58,-122.9899999999983,47,11,25829.08,25706.090000000004
21123,U25231,58,95498.62,45,13,140541.33000000002,236039.95
21124,U14018,58,30741.269999999993,40,18,97617.11000000002,128358.38
21125,U42583,58,-237458.42999999996,52,6,457573.9199999999,220115.48999999996
21126,U30694,58,96112.13,25,33,1619375.7700000003,1715487.9000000004
21127,U16679,58,-8292.859999999999,52,6,17578.780000000002,9285.920000000004
21128,U28851,58,-1919.7599999999984,49,9,20378.659999999996,18458.899999999998
21129,U29026,58,29173.68999999999,43,15,72386.88000000002,101560.57
21130,U35011,58,-5220.8,40,18,44641.85,39421.049999999996
21131,U23336,58,-21620.649999999998,48,10,129571.5,107950.85
21132,U29522,58,-14267.700000000023,47,11,250684.41999999998,236416.71999999997
21133,U12887,58,20971.510000000002,44,14,79579.47,100550.98000000001
21134,U27513,58,-394.59999999999934,53,5,12890.820000000002,12496.220000000003
21135,U35017,58,-2766.5600000000054,53,5,118341.45,115574.88999999998
21136,U42874,58,557.9199999999998,46,12,6269.619999999998,6827.539999999998
21137,U29528,58,1079.1599999999996,51,7,7646.290000000001,8725.45
21138,U24685,58,-3848.9100000000035,45,13,103705.63999999998,99856.72999999998
21139,U13308,58,52761.820000000014,39,19,170925.59,223687.41
21140,U35116,58,14577.459999999994,48,10,87808.39000000003,102385.85000000002
21141,U41684,58,-6954.539999999999,49,9,41774.380000000005,34819.840000000004
21142,U40039,58,12658.110000000004,45,13,50545.029999999984,63203.139999999985
21143,U42328,58,11007.54,38,20,34730.73,45738.270000000004
21144,U10131,58,-7896.199999999997,44,14,79155.33000000002,71259.13000000002
21145,U21964,58,173.4100000000002,43,15,9883.449999999999,10056.859999999999
21146,U28690,58,32416.699999999997,41,17,110297.9,142714.59999999998
21147,U42789,58,23057.659999999996,34,24,241591.91,264649.57
21148,U32070,58,47400.639999999985,43,15,338667.37,386068.01
21149,U21456,58,214980.13,25,33,35610.100000000006,250590.23
21150,U36778,58,-6178.18,50,8,40427.259999999995,34249.079999999994
21151,U43334,58,-831.730000000003,31,27,37355.030000000006,36523.3
21152,U1128854,58,-3276.5199999999995,35,23,11354.44,8077.920000000001
21153,U24419,58,-407.4700000000007,49,9,28845.939999999995,28438.469999999994
21154,U24998,58,124719.99999999997,44,14,318712.70999999996,443432.70999999996
21155,U42148,58,59788.99,47,11,17179.8,76968.79
21156,U29557,58,-638.9199999999983,46,12,110011.90000000001,109372.98000000001
21157,U35914,58,-697.7499999999992,48,10,18786.32,18088.57
21158,U34869,58,-5151.939999999997,44,14,93637.16000000002,88485.22000000002
21159,U1197738,58,-9276.679999999998,46,12,21080.3,11803.62
21160,U41769,58,-19001.169999999925,41,17,1300184.24,1281183.07
21161,U26550,58,41124.25999999996,39,19,1016978.35,1058102.6099999999
21162,U8386,58,8380.06,42,16,27383.270000000004,35763.33
21163,U43019,58,380.869999999999,46,12,6123.670000000001,6504.54
21164,U24955,58,164.80999999999767,30,28,311306.11,311470.92
21165,U36011,58,204338.67,34,24,1010345.95,1214684.6199999999
21166,U37956,58,14330.93,53,5,9105.5,23436.43
21167,U25958,58,-686.5500000000028,32,26,98157.5,97470.95
21168,U13253,58,104348.41999999995,41,17,260532.36999999997,364880.7899999999
21169,U35649,58,-4590.120000000001,47,11,23161.989999999998,18571.869999999995
21170,U38104,58,1526.7699999999995,36,22,21779.44,23306.21
21171,U42518,58,14005.590000000002,53,5,4668.149999999999,18673.74
21172,U19862,58,-7708.650000000001,52,6,154815.0,147106.35
21173,U30019,58,-10042.669999999998,46,12,68396.32,58353.65000000001
21174,U41530,58,-38780.299999999996,43,15,272720.01000000007,233939.71000000008
21175,U37671,58,1410.4499999999998,48,10,16270.339999999998,17680.789999999997
21176,U8679,58,-1985.5099999999984,49,9,67224.87,65239.36
21177,U11191,58,-4.920000000001664,39,19,86113.39,86108.47
21178,U15254,58,91907.90000000001,41,17,184650.87999999998,276558.77999999997
21179,U8738,58,-1007.2899999999997,53,5,4146.920000000001,3139.630000000001
21180,U1313507,58,907.7800000000001,37,21,1865.15,2772.9300000000003
21181,U8497,58,40387.990000000005,37,21,129214.29,169602.28
21182,U30742,58,1768.7199999999996,50,8,16399.82,18168.54
21183,U26363,58,306209.68,39,19,141074.06999999995,447283.74999999994
21184,U11476,58,-272316.05000000005,36,22,571268.46,298952.4099999999
21185,U24110,58,10718.589999999991,42,16,38687.64,49406.22999999999
21186,U18621,58,51148.59999999997,35,23,468333.7299999999,519482.3299999999
21187,U1343422,58,843.0700000000002,31,27,7110.500000000001,7953.5700000000015
21188,U43262,58,-31.190000000000225,54,4,5470.0700000000015,5438.880000000001
21189,U16387,58,-64009.98999999999,27,31,528592.8,464582.81000000006
21190,U14290,58,-23785.949999999997,45,13,69668.52,45882.57000000001
21191,U30511,58,1763.9500000000007,52,6,18801.06,20565.010000000002
21192,U38715,58,-222381.73000000004,33,25,712382.7799999998,490001.04999999976
21193,U24686,58,-7708.139999999995,50,8,36565.78,28857.640000000003
21194,U18767,58,-30314.8,51,7,54942.6,24627.8
21195,U26405,58,43252.45999999999,46,12,22504.33,65756.79
21196,U18771,58,7584.760000000001,52,6,7546.1799999999985,15130.939999999999
21197,U26973,58,4935.500000000003,42,16,26879.89,31815.390000000003
21198,U32507,58,16162.800000000003,53,5,9237.22,25400.020000000004
21199,U16258,58,181.66000000000872,40,18,951835.4400000002,952017.1000000002
21200,U37253,58,628.6300000000003,53,5,10225.169999999998,10853.8
21201,U34226,58,77756.1,39,19,132969.65999999997,210725.75999999998
21202,U35889,58,-29.130000000001456,48,10,51354.509999999995,51325.37999999999
21203,U21882,58,-4940.430000000001,46,12,153288.83000000002,148348.40000000002
21204,U10186,58,-12623.24,39,19,126470.37999999999,113847.13999999998
21205,U9741,58,5877.280000000007,35,23,180675.66999999998,186552.94999999998
21206,U9976,58,26651.419999999995,38,20,187337.94999999998,213989.36999999997
21207,U24184,58,-58724.34000000001,36,22,242311.8,183587.45999999996
21208,U1220803,58,-2091.719999999999,39,19,25088.020000000004,22996.300000000007
21209,U40133,58,109141.71000000002,41,17,475441.86000000004,584583.5700000001
21210,U21889,58,22351.789999999957,29,29,1298782.8800000004,1321134.6700000004
21211,U33310,58,47.61000000000218,37,21,31045.18,31092.79
21212,U18068,58,-14260.190000000002,23,35,426464.29999999993,412204.1099999999
21213,U36670,58,440511.27,46,12,135691.72,576202.99
21214,U31834,58,-149120.66999999993,39,19,798304.0399999998,649183.3699999999
21215,U10405,58,-360.34999999999934,50,8,8207.66,7847.31
21216,U39117,58,35936.86000000001,37,21,290028.82,325965.68
21217,U14369,58,-1380485.34,33,25,4679756.529999999,3299271.1899999995
21218,U39793,58,527.9499999999872,30,28,153437.43,153965.37999999998
21219,U27750,58,-27350.250000000015,44,14,623484.7700000001,596134.5200000001
21220,U12191,58,-37.209999999988625,47,11,236054.80999999997,236017.59999999998
21221,U16012,58,657.4500000000012,48,10,9342.950000000003,10000.400000000003
21222,U20841,58,-43134.59,44,14,229418.37,186283.78
21223,U30325,58,-6950.1500000000015,36,22,97813.91,90863.76000000001
21224,U40926,58,-12715.970000000001,46,12,52933.009999999995,40217.03999999999
21225,U15024,58,-40579.12000000001,50,8,108366.75,67787.62999999999
21226,U31653,58,102150.67000000001,41,17,161249.54,263400.21
21227,U12848,58,594.3200000000005,40,18,21256.940000000002,21851.260000000002
21228,U43952,58,7884.9000000000015,45,13,465517.67,473402.57
21229,U9755,58,9147.949999999997,34,24,142169.24,151317.19
21230,U12676,58,-26224.48000000002,45,13,165565.71999999997,139341.23999999996
21231,U30961,58,-7731.59,53,5,42526.479999999996,34794.89
21232,U18212,58,24284.959999999985,29,29,297930.69,322215.64999999997
21233,U30167,58,-138527.08000000002,39,19,556181.2,417654.11999999994
21234,U40519,58,-163853.81999999995,31,27,1698089.01,1534235.19
21235,U30618,58,-2000.9799999999996,54,4,5034.5,3033.5200000000004
21236,U14240,58,-1120647.86,36,22,5417624.880000001,4296977.0200000005
21237,U35987,58,-9710.98,47,11,91314.85999999999,81603.87999999999
21238,U19160,58,-4092.999999999998,50,8,16271.85,12178.850000000002
21239,U28528,58,0.07000000000061846,32,26,19797.0,19797.07
21240,U10745,58,-54748.0,48,10,129816.86,75068.86
21241,U22059,58,90590.56000000004,27,31,1112738.3699999994,1203328.9299999995
21242,U30970,58,54763.77,44,14,90972.1,145735.87
21243,U20667,58,179.02000000000226,43,15,20320.3,20499.32
21244,U36416,58,9457.030000000002,52,6,42808.46000000001,52265.490000000005
21245,U26779,57,-53361.36999999998,42,15,196334.67,142973.30000000005
21246,U12016,57,8671.100000000028,41,16,532061.74,540732.84
21247,U35420,57,-552.9599999999992,52,5,22453.059999999994,21900.099999999995
21248,U21005,57,-321.43000000000114,47,10,24672.870000000017,24351.440000000017
21249,U32749,57,2675.1699999999983,38,19,43080.39000000001,45755.560000000005
21250,U20084,57,-131031.93000000005,48,9,143967.17,12935.239999999962
21251,U17460,57,9198.799999999992,45,12,24754.519999999997,33953.31999999999
21252,U30211,57,-21950.39,48,9,31883.84,9933.45
21253,U576132,57,240.8799999999992,29,28,27954.57,28195.449999999997
21254,U27687,57,17727.510000000002,44,13,133321.97,151049.48
21255,U34120,57,-985.6000000000004,51,6,6614.280000000001,5628.68
21256,U11978,57,-91.83000000000015,49,8,5241.530000000001,5149.700000000001
21257,U31731,57,66.72000000000025,28,29,43113.450000000004,43180.170000000006
21258,U36871,57,6417.590000000002,52,5,9529.7,15947.290000000003
21259,U737914,57,-1729.7300000000005,37,20,24719.980000000003,22990.250000000004
21260,U1320186,57,1073.0,25,32,10864.0,11937.0
21261,U16203,57,16844.9,32,25,234152.64999999997,250997.54999999996
21262,U16437,57,4527.719999999999,48,9,28883.27,33410.99
21263,U38336,57,3232.1399999996647,22,35,55087763.0,55090995.14
21264,U15094,57,3566.2700000000013,35,22,27421.940000000006,30988.210000000006
21265,U27648,57,-33452.57000000001,46,11,81578.82999999999,48126.25999999998
21266,U9548,57,-3887.8399999999965,42,15,257199.46,253311.62
21267,U21952,57,217.08999999999577,44,13,141561.08000000002,141778.17
21268,U39615,57,11389.82,43,14,5466.210000000001,16856.03
21269,U39365,57,7449.930000000008,38,19,240859.24999999997,248309.18
21270,U32893,57,79.16999999999894,42,15,14045.990000000003,14125.160000000002
21271,U20754,57,3285.1199999999853,40,17,165553.24,168838.36
21272,U22474,57,52.169999999992726,29,28,99858.89,99911.06
21273,U30467,57,-4953.149999999996,42,15,128249.80999999998,123296.65999999999
21274,U8911,57,9548.059999999998,28,29,104506.09999999999,114054.15999999999
21275,U19697,57,82667.83,45,12,57957.200000000004,140625.03
21276,U9250,57,-5203.560000000016,35,22,220313.83999999994,215110.2799999999
21277,U19206,57,-6446.09,44,13,90002.01,83555.92
21278,U34665,57,-7217.01,45,12,46504.63,39287.619999999995
21279,U22961,57,-3813.1600000000035,34,23,443378.08,439564.92000000004
21280,U43808,57,-11000.669999999996,44,13,64193.890000000014,53193.220000000016
21281,U30577,57,54707.87000000001,30,27,111949.68999999999,166657.56
21282,U41191,57,3736.729999999998,42,15,32252.950000000004,35989.68
21283,U21568,57,25769.849999999988,42,15,128088.31000000003,153858.16
21284,U27438,57,1384.78,42,15,5307.99,6692.7699999999995
21285,U29247,57,-32054.79000000011,32,25,1076095.78,1044040.9899999999
21286,U15026,57,309968.56999999995,31,26,373713.19,683681.76
21287,U40012,57,-11083.470000000001,53,4,18922.850000000002,7839.380000000001
21288,U36727,57,9373.379999999997,43,14,166250.61,175623.99
21289,U22747,57,3462.1599999999657,36,21,1417255.0499999998,1420717.2099999997
21290,U15542,57,15645.270000000006,45,12,94494.41999999998,110139.68999999999
21291,U34310,57,-657101.44,35,22,1232080.75,574979.31
21292,U36420,57,4831.8,51,6,3801.8799999999997,8633.68
21293,U22514,57,-11984.410000000003,45,12,102903.07,90918.66
21294,U37455,57,5262.030000000004,41,16,69124.76000000001,74386.79000000001
21295,U18665,57,102777.72,27,30,25420.91,128198.63
21296,U28309,57,-71029.47000000003,28,29,305296.51,234267.03999999998
21297,U12937,57,-762.6200000000008,52,5,8076.93,7314.3099999999995
21298,U39015,57,-11773.859999999999,49,8,69847.43000000001,58073.57000000001
21299,U30381,57,-379.48999999995794,37,20,797016.0,796636.51
21300,U21435,57,-30306.920000000006,46,11,309245.15,278938.23000000004
21301,U30674,57,37.51000000000204,33,24,71715.59,71753.1
21302,U17206,57,-5616.560000000092,33,24,2356829.0,2351212.44
21303,U22347,57,-16768.96,32,25,112283.79999999999,95514.84
21304,U38219,57,116133.07000000002,35,22,211221.64,327354.71
21305,U986754,57,-18.119999999999436,36,21,21437.42,21419.3
21306,U19551,57,-3750.7999999999997,49,8,23751.06,20000.260000000002
21307,U36546,57,-5805.18,50,7,9548.869999999999,3743.6899999999987
21308,U20341,57,4006.819999999999,46,11,48283.9,52290.72
21309,U37873,57,8776.430000000002,45,12,52111.28000000001,60887.710000000014
21310,U43753,57,-2413.8000000000006,50,7,12829.99,10416.189999999999
21311,U41269,57,-36654.759999999995,42,15,199891.81,163237.05
21312,U1323362,57,-802.8000000000001,48,9,4336.9400000000005,3534.1400000000003
21313,U22978,57,6950.759999999998,34,23,19801.359999999997,26752.119999999995
21314,U9408,57,-2937.159999999989,25,32,456671.0,453733.84
21315,U29067,57,-11027.610000000011,34,23,280949.66,269922.05
21316,U29176,57,-31411.349999999995,46,11,77590.07,46178.720000000016
21317,U32222,57,30650.11,45,12,66597.09,97247.2
21318,U34754,57,-7047.8699999999535,38,19,494063.8400000001,487015.97000000015
21319,U16411,57,-28645.850000000006,44,13,199211.51000000007,170565.66000000006
21320,U42433,57,18798.390000000003,46,11,29307.649999999998,48106.04
21321,U43856,57,43363.17,37,20,315121.24,358484.41
21322,U12030,57,-2802.3199999999924,41,16,90991.98,88189.66
21323,U26138,57,-42007.309999999976,40,17,552129.78,510122.47000000003
21324,U19127,57,2965.3699999999976,41,16,30234.589999999997,33199.95999999999
21325,U33035,57,3953.9299999999994,52,5,4966.050000000001,8919.98
21326,U900779,57,-9.769999999999948,44,13,3638.0200000000013,3628.2500000000014
21327,U30524,57,60550.59,38,19,166212.11999999997,226762.70999999996
21328,U24031,57,-109351.03000000003,50,7,209102.56000000003,99751.53
21329,U43096,57,31529.560000000023,39,18,313564.4,345093.96
21330,U34536,57,512.8899999999993,53,4,2947.61,3460.4999999999995
21331,U21015,57,-23875.600000000006,48,9,259409.68999999997,235534.08999999997
21332,U36380,57,-11145.039999999995,50,7,76162.1,65017.06000000001
21333,U14932,57,3262.1300000008196,19,38,12811271.4,12814533.530000001
21334,U41202,57,2015.2900000000059,35,22,204996.24,207011.53
21335,U26899,57,47652.45999999999,45,12,35000.950000000004,82653.41
21336,U30804,57,4588.520000000019,39,18,381372.5,385961.02
21337,U33763,57,129546.39000000001,29,28,103634.67999999998,233181.07
21338,U43040,57,-5061.789999999997,52,5,11728.109999999991,6666.319999999994
21339,U42516,57,870.4599999999518,42,15,1184378.29,1185248.75
21340,U37103,57,15715.059999999994,39,18,81190.17000000001,96905.23000000001
21341,U41103,57,177342.64,38,19,607163.81,784506.4500000001
21342,U20014,57,-10886.629999999997,38,19,301154.72000000003,290268.09
21343,U948850,57,2046.9999999999995,48,9,2545.4300000000003,4592.43
21344,U17831,57,7358.880000000001,48,9,42246.130000000005,49605.01000000001
21345,U12310,57,18458.230000000003,39,18,23945.62,42403.850000000006
21346,U28344,57,-66791.41,51,6,85055.06,18263.649999999994
21347,U11387,57,1408.089999999976,25,32,1617712.6300000001,1619120.7200000002
21348,U28726,57,-12262.339999999995,41,16,73741.03000000001,61478.69000000002
21349,U25747,57,653.8100000000559,37,20,785147.15,785800.9600000001
21350,U41290,57,-291.65000000000146,43,14,125043.9,124752.25
21351,U30185,57,136.13000000000017,49,8,62122.71000000001,62258.840000000004
21352,U40167,57,-460533.87,49,8,525861.19,65327.31999999995
21353,U20383,57,-41870.64,40,17,199632.96000000002,157762.32
21354,U41859,57,39323.610000000044,32,25,682733.48,722057.0900000001
21355,U27015,57,-18011.72000000004,30,27,924206.36,906194.6399999999
21356,U42663,57,10592.13,44,13,6215.34,16807.47
21357,U37315,57,-535.6000000000004,48,9,15157.5,14621.9
21358,U19401,57,-473.79000000000815,39,18,456055.9900000001,455582.20000000007
21359,U22811,57,-29173.73999999999,43,14,66597.51,37423.770000000004
21360,U25008,57,53383.690000000024,43,14,174163.62000000002,227547.31000000006
21361,U1185848,57,-2361.3100000000004,42,15,18717.07,16355.759999999998
21362,U41163,57,3060.5300000000007,47,10,12273.839999999998,15334.369999999999
21363,U23373,57,9738.250000000004,37,20,181815.44999999995,191553.69999999995
21364,U35358,57,102535.83999999998,41,16,160360.25000000003,262896.09
21365,U26819,57,208127.4,46,11,62660.630000000005,270788.03
21366,U20089,57,-6599.939999999999,32,25,27538.190000000002,20938.250000000004
21367,U27627,57,-9038.99999999997,38,19,1946561.72,1937522.72
21368,U28132,57,17092.390000000003,9,48,17254.28,34346.67
21369,U17280,57,-201674.12,31,26,1066373.96,864699.84
21370,U13796,57,21432.869999999995,37,20,76618.59,98051.45999999999
21371,U32824,57,-101.24999999999909,40,17,48770.66,48669.41
21372,U11640,57,278071.52,45,12,17476.810000000005,295548.33
21373,U36227,57,70552.85000000003,26,31,1838217.0899999999,1908769.94
21374,U27162,57,7226.619999999997,35,22,1367069.9100000001,1374296.5300000003
21375,U18643,57,31017.309999999998,28,29,153250.86,184268.16999999998
21376,U33105,57,1843.4099999999999,49,8,11897.51,13740.92
21377,U18164,57,8217.41,44,13,17817.42,26034.829999999998
21378,U33142,57,831.6000000000058,46,11,67796.1,68627.70000000001
21379,U36421,57,421118.5,31,26,758842.8400000001,1179961.34
21380,U22307,57,766.9299999999997,49,8,2926.1700000000005,3693.1000000000004
21381,U21492,57,-30149.670000000016,46,11,50674.41000000001,20524.739999999994
21382,U14511,57,27870.580000000045,44,13,431249.67999999993,459120.26
21383,U32226,57,2330.369999999999,46,11,51517.64,53848.009999999995
21384,U34526,57,1013.6299999999983,39,18,34951.71,35965.34
21385,U34366,57,13661.84999999998,48,9,137514.24,151176.08999999997
21386,U39376,57,-18384.94,33,24,216551.83000000005,198166.89000000004
21387,U16818,57,4373.589999999972,37,20,894029.17,898402.76
21388,U29355,57,-7654.210000000006,41,16,101203.22000000002,93549.01000000001
21389,U30213,57,1370.9599999999991,47,10,21762.6,23133.559999999998
21390,U9033,57,-9339.940000000002,43,14,75411.5,66071.56
21391,U30546,57,-5290.730000000018,33,24,871421.1199999999,866130.3899999999
21392,U13376,57,-11359.980000000001,45,12,56265.91999999999,44905.93999999999
21393,U10351,57,-347978.1599999999,34,23,1401653.5000000002,1053675.3400000003
21394,U1192472,57,-3.299999999998363,34,23,38518.13,38514.83
21395,U18381,57,13072.62000000006,37,20,931008.05,944080.6700000002
21396,U708151,57,9.569999999999766,40,17,3013.65,3023.22
21397,U23320,57,-14244.589999999997,31,26,270353.7,256109.11000000002
21398,U40974,57,-52864.87,45,12,139745.02999999997,86880.15999999997
21399,U34615,57,28427.279999999988,48,9,82075.34,110502.61999999998
21400,U27405,57,5082.709999999999,29,28,88989.15999999999,94071.87
21401,U1073410,57,0.0900000000000567,39,18,1802.06,1802.15
21402,U25021,57,7150.640000000007,34,23,161056.88,168207.52000000002
21403,U33220,57,777.7900000000024,34,23,61182.520000000004,61960.310000000005
21404,U28149,57,241.5200000000037,44,13,70986.5,71228.02
21405,U41625,57,6667.979999999993,25,32,336948.62,343616.6
21406,U29409,57,-17260.20000000007,37,20,1445389.44,1428129.2399999998
21407,U16663,57,3894.080000000004,44,13,101244.41,105138.49
21408,U39671,57,-1176.9300000000003,43,14,50430.140000000014,49253.210000000014
21409,U27821,57,-2479.7400000000016,43,14,74362.85,71883.11
21410,U23119,57,-1393.2800000000395,42,15,422298.99,420905.70999999996
21411,U43938,57,-391.9799999999791,47,10,322786.5699999999,322394.5899999999
21412,U30394,57,1262.17,37,20,111658.0,112920.17
21413,U28399,57,1653.6100000000013,50,7,14250.48,15904.09
21414,U11661,57,-17749.630000000005,41,16,119364.7,101615.06999999999
21415,U40047,57,4116.62999999999,35,22,259276.45,263393.08
21416,U38898,57,-10939.490000000005,30,27,97352.82,86413.33
21417,U34502,57,176382.75000000006,44,13,538465.14,714847.8900000001
21418,U11634,57,-11802.74,30,27,199971.75000000003,188169.01000000004
21419,U34437,57,-148435.31,51,6,252744.90000000002,104309.59000000003
21420,U33712,57,2986.260000000015,48,9,316423.85000000003,319410.11000000004
21421,U39730,57,6627.3199999999915,25,32,1022171.8200000001,1028799.14
21422,U11216,57,840.4000000000016,42,15,54417.01000000001,55257.41000000001
21423,U22205,57,-12157.149999999998,41,16,76160.94,64003.79000000001
21424,U740734,57,-520.969999999998,40,17,40363.78,39842.81
21425,U18388,57,32551.460000000017,45,12,58110.05999999998,90661.52
21426,U26094,57,13692.85,39,18,225972.81999999992,239665.66999999993
21427,U32606,57,-8857.74999999999,52,5,26111.63999999999,17253.89
21428,U33744,57,-25055.150000000005,43,14,72133.57999999999,47078.42999999998
21429,U33193,57,714.0800000000036,48,9,27210.219999999998,27924.300000000003
21430,U8907,57,13110.73,43,14,38688.44,51799.17
21431,U22362,57,23549.689999999995,41,16,112055.18999999999,135604.87999999998
21432,U26769,57,-1164.3399999999288,35,22,1125597.86,1124433.5200000003
21433,U42013,57,-1073.7300000000012,41,16,49315.96,48242.229999999996
21434,U24171,57,-2332035.0100000002,26,31,6513272.34,4181237.3299999996
21435,U893109,57,-2913.0700000000006,36,21,15649.199999999999,12736.129999999997
21436,U38260,57,8091.470000000005,41,16,49031.59000000001,57123.06000000001
21437,U20196,57,-3578.7,52,5,15532.589999999998,11953.89
21438,U34637,57,3377.6400000000012,51,6,7514.669999999998,10892.31
21439,U42195,57,-1144.5099999999966,44,13,91488.34999999998,90343.83999999998
21440,U26466,57,-315.50999999999965,55,2,8065.51,7750.000000000001
21441,U16929,57,1352.8999999999996,48,9,9949.699999999997,11302.599999999997
21442,U19990,57,-44635.55,38,19,141998.95,97363.40000000001
21443,U37867,57,869.8899999999993,38,19,41288.92,42158.81
21444,U38381,57,-1667.7800000000534,26,31,1115221.34,1113553.56
21445,U24869,57,76668.34000000004,33,24,143695.35,220363.69000000006
21446,U26636,57,21246.17999999998,45,12,443753.0699999999,464999.2499999999
21447,U29472,57,-1812.4299999999962,43,14,95303.66999999998,93491.23999999999
21448,U41876,57,-331.3999999999998,49,8,6014.84,5683.4400000000005
21449,U29579,57,28690.139999999898,42,15,1567401.5699999998,1596091.7099999997
21450,U20765,57,920.0200000000036,43,14,101801.89,102721.91
21451,U41707,57,-3706.2900000000022,50,7,23527.91,19821.62
21452,U16136,57,1057.4000000000008,46,11,30177.04000000001,31234.440000000013
21453,U16002,56,78980.30999999998,25,31,1064618.6400000001,1143598.9500000002
21454,U36165,56,-3243.4100000000026,40,16,69260.76000000001,66017.35
21455,U37030,56,-46395.29000000001,43,13,55146.08000000001,8750.79
21456,U32398,56,101783.31999999996,44,12,674212.15,775995.47
21457,U19007,56,431.1500000000233,31,25,959946.1,960377.25
21458,U1110127,56,-4500.91,54,2,5500.969999999999,1000.0599999999995
21459,U1088052,56,1226.3299999999997,34,22,9142.909999999998,10369.239999999998
21460,U13326,56,155630.77,43,13,277763.56,433394.32999999996
21461,U23439,56,-3105.8099999999927,29,27,224046.17,220940.36000000002
21462,U44038,56,778.3000000000002,38,18,29112.259999999995,29890.559999999994
21463,U40362,56,8262.959999999992,37,19,228310.0,236572.96
21464,U13027,56,-59.56999999999989,39,17,5813.969999999999,5754.4
21465,U40246,56,-204440.56999999995,43,13,2600683.73,2396243.16
21466,U11668,56,-767.8400000000026,44,12,230450.61999999997,229682.77999999997
21467,U15148,56,125000.52,29,27,339206.24999999994,464206.76999999996
21468,U8574,56,-124612.67999999989,31,25,726785.09,602172.41
21469,U29501,56,-117329.08999999998,43,13,545352.38,428023.29000000004
21470,U25992,56,1901.5,33,23,11114.8,13016.3
21471,U24126,56,7045.1100000000015,46,10,23107.33,30152.440000000002
21472,U32830,56,187183.16999999998,20,36,188208.0,375391.17
21473,U43995,56,-45.39000000000033,27,29,60867.82000000001,60822.43000000001
21474,U32140,56,158.3000000000535,30,26,1405460.5499999998,1405618.8499999999
21475,U25969,56,84861.61,39,17,82847.65999999999,167709.27
21476,U22429,56,22792.43,43,13,25009.62,47802.05
21477,U9118,56,96596.99000000002,44,12,163588.74,260185.73
21478,U28934,56,-95853.44999999997,45,11,367746.98000000004,271893.5300000001
21479,U33273,56,-1807.0700000000045,47,9,87585.65999999999,85778.58999999998
21480,U20400,56,-18609.23,51,5,28954.690000000002,10345.460000000003
21481,U38621,56,10514.45,46,10,9504.18,20018.63
21482,U41655,56,437034.9200000002,35,21,1139640.4200000004,1576675.3400000005
21483,U19957,56,12700.680000000004,32,24,125031.12999999999,137731.81
21484,U39278,56,-1194.9400000000005,50,6,12298.59,11103.65
21485,U8144,56,-373.7000000000039,51,5,25415.41,25041.709999999995
21486,U19838,56,4319.820000000003,37,19,124253.85999999997,128573.67999999998
21487,U41562,56,-14551.870000000003,40,16,50234.57,35682.7
21488,U22400,56,-9711.19000000006,38,18,770363.7900000002,760652.6000000001
21489,U42976,56,-19558.600000000002,51,5,31825.719999999998,12267.119999999995
21490,U27551,56,-3646.239999999998,34,22,462329.51,458683.27
21491,U12843,56,-62315.49,35,21,511823.39999999997,449507.91
21492,U32560,56,-23914.830000000016,44,12,166313.3,142398.46999999997
21493,U33054,56,25777.960000000014,38,18,11398.65,37176.610000000015
21494,U20209,56,11193.570000000003,45,11,79495.9,90689.47
21495,U23485,56,-1633.0800000000006,40,16,32944.270000000004,31311.190000000002
21496,U40390,56,53060.179999999986,43,13,498583.37999999995,551643.5599999999
21497,U19199,56,-15436.980000000045,29,27,394856.19000000006,379419.21
21498,U17954,56,10903.560000000007,27,29,143827.62,154731.18
21499,U28925,56,281829.07999999996,45,11,509713.06000000006,791542.14
21500,U23904,56,28804.82999999999,47,9,49992.060000000005,78796.89
21501,U9808,56,9351.620000000012,42,14,101199.49999999996,110551.11999999997
21502,U33113,56,-382.3800000000001,49,7,21251.61,20869.23
21503,U18261,56,-4368.540000000006,41,15,86464.79999999999,82096.25999999998
21504,U31439,56,4800.330000000004,45,11,135514.62,140314.95
21505,U29346,56,1356.9200000000003,40,16,10054.200000000003,11411.120000000003
21506,U660918,56,15615.979999999987,39,17,92946.54999999999,108562.52999999997
21507,U20920,56,-10073.060000000009,38,18,146644.51,136571.45
21508,U12384,56,-104.23999999999943,26,30,51772.89,51668.65
21509,U28372,56,89.50000000000122,37,19,16470.019999999997,16559.519999999997
21510,U23366,56,-8898.75999999998,37,19,266677.6,257778.84
21511,U9725,56,-1015.2500000000001,50,6,9305.0,8289.75
21512,U13855,56,2709.390000000003,39,17,73425.47,76134.86
21513,U15651,56,546366.6499999999,37,19,337852.93,884219.5799999998
21514,U22167,56,-8022.489999999982,32,24,557191.88,549169.39
21515,U23621,56,-5114.409999999999,49,7,9466.359999999999,4351.95
21516,U23709,56,3008.6200000001118,48,8,1978930.44,1981939.06
21517,U1148011,56,85.81,29,27,17964.38,18050.190000000002
21518,U43265,56,-24701.449999999997,50,6,114771.54000000001,90070.09000000001
21519,U41483,56,7859.759999999999,38,18,25955.129999999997,33814.89
21520,U38098,56,-913.8500000000004,44,12,8498.73,7584.879999999999
21521,U15673,56,8388.07,42,14,17783.370000000003,26171.440000000002
21522,U15157,56,240612.91999999998,35,21,762539.1799999998,1003152.0999999999
21523,U25972,56,54927.650000000016,32,24,147566.66999999998,202494.32
21524,U34719,56,-3161.41,53,3,9209.699999999997,6048.289999999997
21525,U43059,56,-8586.76,48,8,27629.23,19042.47
21526,U44072,56,7380.739999999996,42,14,55131.41,62512.15
21527,U14920,56,-26693.37999999997,36,20,283972.81,257279.43000000002
21528,U28460,56,-36735.76000000001,35,21,579741.2300000001,543005.4700000001
21529,U35544,56,93972.09999999993,20,36,4161978.35,4255950.45
21530,U43370,56,-1587.6900000000003,39,17,20082.210000000003,18494.520000000004
21531,U25028,56,-1337.509999999999,31,25,105387.56,104050.05
21532,U26916,56,-30336.950000000004,34,22,185207.22,154870.27
21533,U1063148,56,-758.7699999999999,48,8,4348.42,3589.65
21534,U38684,56,23806.96999999999,35,21,62427.27,86234.23999999999
21535,U43983,56,-76090.03,37,19,503217.7100000001,427127.68000000005
21536,U975263,56,3610.92,35,21,31943.010000000002,35553.93
21537,U1137421,56,-2576.1299999999974,47,9,72736.59999999999,70160.47
21538,U11135,56,-2046.5199999999998,50,6,2974.6600000000003,928.1400000000006
21539,U21243,56,-62645.20000000001,50,6,128918.15,66272.94999999998
21540,U32261,56,-19709.069999999996,27,29,309735.81,290026.74
21541,U38293,56,10149.90000000007,32,24,2978881.42,2989031.32
21542,U11600,56,-1279.639999999986,37,19,899649.72,898370.08
21543,U626468,56,-6444.86,51,5,7311.780000000001,866.920000000001
21544,U34826,56,-12900.89,41,15,231693.79,218792.90000000002
21545,U39232,56,-5581.699999999995,45,11,478484.74,472903.04
21546,U31570,56,-19035.970000000005,37,19,346380.88,327344.91
21547,U24224,56,12699.419999999995,43,13,53557.600000000006,66257.02
21548,U29838,56,-1204.819999999999,47,9,38654.71,37449.89
21549,U19396,56,-83556.67000000003,41,15,583150.64,499593.97
21550,U30924,56,4140.02,38,18,20481.25,24621.27
21551,U39460,56,-25050.519999999946,41,15,353949.93000000005,328899.4100000001
21552,U28780,56,338.8099999999995,50,6,12346.29,12685.1
21553,U26408,56,-90797.99999999999,29,27,422069.25000000006,331271.25000000006
21554,U23874,56,16206.68,36,20,100695.41,116902.09
21555,U25478,56,-6799.4299999999985,42,14,37941.13,31141.699999999997
21556,U25815,56,7600.120000000008,40,16,93813.79000000001,101413.91000000002
21557,U1326813,56,1999.010000000001,31,25,17898.59,19897.600000000002
21558,U38572,56,-65610.95999999998,40,16,156389.59999999998,90778.64
21559,U34971,56,-22371.139999999996,36,20,70737.49999999999,48366.359999999986
21560,U19231,56,98192.02,36,20,253159.86000000002,351351.88
21561,U10268,56,65503.270000000004,44,12,105892.20999999999,171395.47999999998
21562,U40902,56,2185.8799999999997,48,8,12079.880000000001,14265.76
21563,U37526,56,2645.7200000000003,47,9,10004.859999999999,12650.579999999998
21564,U16076,56,19814.729999999974,37,19,1583989.0400000003,1603803.7700000003
21565,U20780,56,18557.20000000001,41,15,570131.72,588688.9199999999
21566,U14537,56,-143365.03,20,36,923895.0700000001,780530.04
21567,U42788,56,-3307.600000000002,28,28,85808.15,82500.54999999999
21568,U15973,56,-170696.89,39,17,327184.73,156487.83999999997
21569,U29668,56,-1396.2800000000002,48,8,9231.630000000001,7835.35
21570,U16877,56,-6399.129999999996,29,27,250069.75,243670.62
21571,U38145,56,6111.409999999999,49,7,12108.13,18219.539999999997
21572,U23289,56,34246.389999999985,37,19,233406.74,267653.13
21573,U35630,56,-5054.340000000001,49,7,18663.77,13609.43
21574,U31034,56,-2476.949999999999,38,18,32786.99,30310.04
21575,U39360,56,-2686.720000000002,46,10,54058.08,51371.36
21576,U20729,56,470980.78,26,30,223339.84000000003,694320.6200000001
21577,U23469,56,-616.1699999999979,36,20,10510.689999999999,9894.52
21578,U40757,56,-4114.529999999999,46,10,23263.909999999996,19149.379999999997
21579,U27287,56,48.81999999998543,33,23,201083.67,201132.49
21580,U15394,56,113.89000000000432,48,8,65015.63,65129.520000000004
21581,U42908,56,-108382.94000000005,25,31,961054.9600000001,852672.02
21582,U28250,56,52189.65000000001,52,4,2313.4,54503.05000000001
21583,U30463,56,-377.22999999999774,45,11,24014.409999999996,23637.18
21584,U36016,56,-119.06000000000088,52,4,8282.959999999988,8163.899999999987
21585,U24019,56,2846.149999999984,41,15,425907.3699999999,428753.51999999984
21586,U43273,56,56.61999999999534,32,24,1320828.9300000002,1320885.5500000003
21587,U18350,56,-12991.700000000004,35,21,250786.2,237794.5
21588,U13766,56,-3658.09,48,8,20867.629999999997,17209.539999999997
21589,U36093,56,19602.23999999999,36,20,70642.59,90244.82999999999
21590,U12882,56,32215.88999999997,41,15,437522.9,469738.79
21591,U1108411,56,-3.979039320256561e-13,28,28,10376.46,10376.46
21592,U31875,56,20148.440000000002,40,16,71513.92000000001,91662.36000000002
21593,U39402,56,107395.21000000008,48,8,593709.4199999999,701104.63
21594,U23706,56,-41500.369999999995,37,19,79089.43000000002,37589.06000000003
21595,U31460,56,52980.60000000002,25,31,160997.8,213978.40000000002
21596,U15867,56,21986.610000000015,41,15,213500.06,235486.67
21597,U38822,56,-39006.79000000004,46,10,1094335.37,1055328.58
21598,U24765,56,-8918.739999999998,36,20,586125.62,577206.88
21599,U9589,56,-7262.849999999998,48,8,14104.339999999993,6841.489999999995
21600,U1166117,56,158.2700000000002,29,27,18059.43,18217.7
21601,U42776,56,964.5600000000007,40,16,20944.96,21909.52
21602,U24027,56,1451.670000000037,24,32,372767.53,374219.20000000007
21603,U21182,56,2744.829999999999,37,19,15731.34,18476.17
21604,U42283,56,19269.580000000005,40,16,138854.09,158123.67
21605,U17358,56,5564.110000000006,48,8,91255.23,96819.34
21606,U43051,56,3896.850000000006,43,13,69807.52,73704.37000000001
21607,U37762,56,-36719.33,34,22,601841.91,565122.5800000001
21608,U12638,56,6533.099999999999,26,30,49886.259999999995,56419.35999999999
21609,U24025,56,2601.049999999998,41,15,26086.85,28687.899999999998
21610,U15143,56,-4775.93,32,24,97721.72,92945.79000000001
21611,U43326,56,-147508.96999999997,50,6,283097.37999999995,135588.40999999997
21612,U23790,56,-68554.69,53,3,76017.56,7462.869999999995
21613,U35817,56,799.9400000000023,30,26,355792.98,356592.92
21614,U41696,56,7898.049999999988,51,5,252312.82,260210.87
21615,U22870,56,-14835.569999999994,44,12,38873.950000000004,24038.380000000012
21616,U18869,56,3217.4199999999996,52,4,16887.399999999998,20104.819999999996
21617,U1183274,56,-2563.03,42,14,16072.42,13509.39
21618,U14592,56,13888.969999999988,42,14,187997.25999999998,201886.22999999998
21619,U38705,56,41435.389999999985,27,29,285731.1,327166.49
21620,U41095,56,-25600.460000000003,52,4,33212.15,7611.689999999999
21621,U39028,56,391331.32000000007,51,5,11403.86,402735.18000000005
21622,U39269,56,102954.27,44,12,132606.24,235560.51
21623,U9717,56,22324.55,36,20,107388.93,129713.48
21624,U20912,56,537999.34,46,10,58327.26,596326.6
21625,U37841,56,9956.37,43,13,104480.67000000001,114437.04000000001
21626,U22519,56,-9357.690000000031,37,19,276889.98,267532.2899999999
21627,U763417,56,1302.8300000000002,30,26,6073.740000000001,7376.570000000001
21628,U37973,56,-6997.3,43,13,71904.44,64907.14
21629,U1254263,56,-1464.6299999999997,39,17,10082.06,8617.43
21630,U30382,56,8858.48999999999,32,24,1047790.85,1056649.3399999999
21631,U8235,56,20744.03000000001,31,25,86908.87999999999,107652.91
21632,U35670,56,19986.300000000003,45,11,43008.90999999999,62995.20999999999
21633,U25503,56,-85277.80000000005,21,35,269191.00000000006,183913.2
21634,U29189,56,-74109.51999999999,35,21,284973.94999999995,210864.42999999996
21635,U34606,56,-12808.060000000001,51,5,25063.62,12255.559999999998
21636,U37859,56,49037.850000000086,23,33,2399558.88,2448596.73
21637,U23669,56,29308.149999999994,31,25,118485.25,147793.4
21638,U752578,56,703.0999999999999,29,27,35946.0,36649.1
21639,U14105,56,-32870.55999999999,42,14,130119.3,97248.74000000002
21640,U1138711,56,250.65999999999985,39,17,5489.419999999999,5740.079999999999
21641,U25381,56,54008.14,47,9,108184.42000000001,162192.56
21642,U26190,56,11860.040000000037,41,15,549888.0700000001,561748.1100000001
21643,U39806,56,3537.5999999999976,43,13,53444.63999999999,56982.23999999999
21644,U28645,56,3638.589999999989,37,19,95175.64999999998,98814.23999999996
21645,U19578,56,280.3899999999976,26,30,114536.0,114816.39
21646,U39475,56,-1050717.3599999938,16,40,103000000.0,101949282.64
21647,U9155,56,-8351.14000000009,40,16,1172319.3199999998,1163968.1799999997
21648,U33530,56,20026.200000000004,51,5,3884.62,23910.820000000003
21649,U1229741,56,1317.0600000000004,40,16,4684.37,6001.43
21650,U640927,56,584.06,40,16,9048.25,9632.31
21651,U27797,56,-607820.1299999999,25,31,3553598.7199999997,2945778.59
21652,U15520,56,-31226.49000000001,46,10,386127.6999999998,354901.2099999998
21653,U13384,56,-14148.520000000006,47,9,107948.34000000001,93799.82
21654,U29363,56,-98086.73999999999,25,31,692096.0,594009.26
21655,U16976,56,-1244.4000000000087,41,15,213486.87,212242.46999999997
21656,U1138670,56,9284.250000000002,42,14,13493.069999999998,22777.32
21657,U30663,56,-1043.27,49,7,7507.92,6464.65
21658,U11735,56,2590.350000000006,38,18,308577.37,311167.72
21659,U37263,56,648.6600000000003,40,16,17419.08,18067.74
21660,U1329874,56,-1445.8100000000002,47,9,3840.0300000000007,2394.2200000000003
21661,U39210,56,-5032.75,41,15,56198.420000000006,51165.670000000006
21662,U8438,56,264.1700000000019,33,23,114574.65000000001,114838.82
21663,U29765,55,1122.8500000000015,40,15,62065.25,63188.1
21664,U36916,55,2957.0000000000164,30,25,266661.81,269618.81
21665,U1114885,55,-14.1499999999981,37,18,12109.87,12095.720000000003
21666,U13260,55,6423.780000000017,47,8,487762.1100000001,494185.89000000013
21667,U39544,55,23246.859999999986,47,8,67611.63999999998,90858.49999999997
21668,U35540,55,5736.340000000015,44,11,107536.89,113273.23000000001
21669,U18441,55,146.62999999999997,36,19,4681.37,4828.0
21670,U30327,55,-5562.709999999998,46,9,12181.979999999996,6619.269999999998
21671,U20697,55,-7897.900000000002,43,12,53292.26000000001,45394.36000000001
21672,U30431,55,2874.79,43,12,8332.55,11207.34
21673,U29200,55,5597.159999999996,44,11,46427.86000000001,52025.020000000004
21674,U21326,55,25890.639999999996,42,13,84094.92,109985.56
21675,U35864,55,-266.0800000000023,34,21,510769.3799999999,510503.2999999999
21676,U30478,55,12948.84,49,6,30205.57,43154.41
21677,U20487,55,16259.689999999995,46,9,36194.090000000004,52453.78
21678,U23195,55,-649.7899999999996,35,20,51822.08,51172.29
21679,U41999,55,-3478.469999999999,43,12,24479.010000000006,21000.540000000008
21680,U21830,55,-5536.389999999999,46,9,23059.319999999996,17522.929999999997
21681,U21119,55,-530.0099999999998,50,5,14316.69,13786.68
21682,U42600,55,19710.660000000003,43,12,57210.420000000006,76921.08000000002
21683,U33072,55,1371.1199999999917,38,17,138313.93000000005,139685.05000000005
21684,U37666,55,-18810.72000000001,24,31,229000.33000000002,210189.61000000002
21685,U1353908,55,947.7999999999997,31,24,18656.2,19604.0
21686,U10435,55,20609.039999999986,45,10,1017286.8300000001,1037895.8700000001
21687,U13240,55,-14985.509999999997,44,11,37445.53,22460.020000000004
21688,U24731,55,15165.670000000002,46,9,40724.479999999996,55890.149999999994
21689,U43084,55,310823.7600000001,23,32,719453.28,1030277.0400000002
21690,U23041,55,6658.680000000007,34,21,184298.03,190956.71
21691,U39487,55,1644.200000000001,43,12,29386.210000000006,31030.410000000007
21692,U36854,55,-593.9199999999946,39,16,34441.14,33847.22
21693,U32724,55,6311.280000000002,41,14,17522.03,23833.31
21694,U29193,55,-109620.62,43,12,140157.59,30536.97
21695,U19196,55,-25412.43,43,12,140401.31,114988.88
21696,U9434,55,19273.050000000017,42,13,215017.72999999998,234290.78
21697,U17175,55,38029.11999999999,39,16,62360.47000000001,100389.59
21698,U8096,55,2320.080000000002,38,17,58701.8,61021.880000000005
21699,U24712,55,1033.4400000000064,36,19,100940.23,101973.67
21700,U12422,55,-5533.759999999999,48,7,66432.29999999999,60898.539999999986
21701,U28787,55,-4787.350000000013,41,14,187062.40000000002,182275.05000000002
21702,U14345,55,-3683.0,53,2,5254.239999999999,1571.2399999999989
21703,U31299,55,20602853.009999998,38,17,18728650.689999998,39331503.699999996
21704,U18602,55,7334.119999999995,35,20,177888.32,185222.44
21705,U39247,55,18580.96000000002,41,14,251990.65,270571.61
21706,U34032,55,-23430.129999999983,32,23,217804.35,194374.22000000003
21707,U18345,55,13599.27,32,23,40201.74,53801.009999999995
21708,U28347,55,103863.89999999997,28,27,2031418.56,2135282.46
21709,U38107,55,-861.920000000001,53,2,7263.4,6401.479999999999
21710,U22704,55,-101276.81999999999,45,10,233191.05999999997,131914.24
21711,U31278,55,7206.470000000006,26,29,226243.82,233450.29
21712,U29237,55,73156.48,37,18,66167.29000000001,139323.77000000002
21713,U20421,55,-200.57999999999984,49,6,8673.43,8472.85
21714,U8733,55,-20226.450000000004,40,15,67337.57,47111.12
21715,U33299,55,-2090.9299999999976,33,22,93783.34999999999,91692.42
21716,U36788,55,706.5200000000009,46,9,23525.2,24231.72
21717,U21877,55,-11073.629999999976,29,26,466996.71,455923.0800000001
21718,U41205,55,-55858.399999999994,43,12,269339.92,213481.52
21719,U37057,55,-39345.38000000001,46,9,100106.5,60761.11999999999
21720,U11513,55,10220.020000000008,49,6,53377.79,63597.81000000001
21721,U29784,55,47343.72,15,40,91099.17,138442.89
21722,U12134,55,-364032.4700000001,49,6,364833.05000000016,800.5800000000745
21723,U13825,55,83653.54,27,28,459980.5999999999,543634.1399999999
21724,U9099,55,-1160.2800000000007,37,18,92457.03999999998,91296.75999999998
21725,U37714,55,-3723.8099999999995,47,8,21477.32,17753.510000000002
21726,U18352,55,-46117.420000000006,49,6,156507.09999999998,110389.67999999996
21727,U39134,55,157450.76999999996,44,11,415570.34,573021.11
21728,U40084,55,-3278.5100000000007,50,5,109559.29,106280.78
21729,U38345,55,-93889.82,46,9,196633.82,102744.0
21730,U13564,55,-45010.990000000005,44,11,217235.16999999995,172224.17999999993
21731,U1154852,55,-2577.540000000002,35,20,19829.129999999997,17251.589999999997
21732,U27617,55,185979.8,32,23,390722.17,576701.97
21733,U24113,55,-747935.43,29,26,3977128.8799999994,3229193.4499999993
21734,U28904,55,-9642.369999999999,44,11,39679.61,30037.24
21735,U22672,55,-3321.490000000001,39,16,192574.38000000003,189252.89000000004
21736,U24615,55,-4311.15999999996,30,25,1146346.49,1142035.33
21737,U38876,55,214713.98,23,32,1195396.7899999998,1410110.7699999998
21738,U35112,55,-608.9799999999996,40,15,10704.07,10095.09
21739,U22561,55,-6428.230000000002,43,12,44866.82,38438.59
21740,U19203,55,-48.2499999999994,31,24,8256.77,8208.52
21741,U11074,55,-11783.55,52,3,12773.589999999998,990.039999999999
21742,U8965,55,-1656.7799999999997,8,47,7894.4400000000005,6237.660000000001
21743,U12472,55,-153149.13999999993,38,17,271216.6699999999,118067.53
21744,U42914,55,-754.3300000000006,40,15,24523.699999999997,23769.369999999995
21745,U32924,55,652.4499999999989,36,19,64504.78000000002,65157.23000000002
21746,U15360,55,-2048676.4200000006,16,39,7624319.359999999,5575642.939999999
21747,U36450,55,-28.260000000005675,42,13,44642.670000000006,44614.41
21748,U32301,55,54451.28999999998,28,27,223853.6,278304.89
21749,U19773,55,34257.56999999999,36,19,65236.93000000001,99494.5
21750,U27818,55,-4123.83,42,13,94351.67,90227.84
21751,U19144,55,-321.4500000000171,37,18,335394.82999999996,335073.37999999995
21752,U24079,55,130.28000000000046,49,6,6823.969999999998,6954.249999999999
21753,U27583,55,-10379.900000000001,44,11,82326.27,71946.37
21754,U37084,55,7583.799999999999,49,6,3565.4200000000005,11149.22
21755,U20740,55,38935.20999999999,39,16,161027.62,199962.83
21756,U18561,55,3792.2100000000028,37,18,136024.12,139816.33
21757,U34635,55,-16378.6,42,13,188193.46,171814.86
21758,U15893,55,-16568.11,47,8,86596.15999999997,70028.04999999997
21759,U43721,55,51978.54,40,15,136748.23,188726.77000000002
21760,U28884,55,13.49000000000251,43,12,28948.100000000002,28961.590000000004
21761,U13049,55,-4981.58,45,10,29892.870000000003,24911.29
21762,U22628,55,-599.9999999999982,29,26,33845.71000000001,33245.71000000001
21763,U9332,55,1086.7000000000057,27,28,619649.0,620735.7
21764,U36816,55,8606.339999999997,27,28,297462.0,306068.33999999997
21765,U1047391,55,-1057.1700000000005,30,25,6060.500000000001,5003.33
21766,U22367,55,-67078.48999999999,31,24,185114.41999999998,118035.93
21767,U23211,55,-1518.0100000000011,42,13,30257.879999999997,28739.869999999995
21768,U11909,55,-2953.4399999999905,36,19,43977.93000000001,41024.49000000002
21769,U35572,55,-5919.45,49,6,18705.870000000003,12786.420000000002
21770,U942199,55,-78.24000000000007,34,21,5108.19,5029.95
21771,U37119,55,-52777.039999999986,50,5,63191.549999999996,10414.51000000001
21772,U41470,55,749.7199999999993,30,25,31936.670000000002,32686.39
21773,U40243,55,-16785.80000000001,43,12,177222.18,160436.37999999998
21774,U36638,55,-2317.619999999999,40,15,84876.43,82558.81
21775,U21231,55,-16252.910000000002,43,12,241038.89,224785.98
21776,U34362,55,72055.30999999997,31,24,207072.25,279127.55999999994
21777,U16321,55,160413.98,44,11,130875.07999999997,291289.06
21778,U41833,55,123819.09999999998,40,15,68362.51,192181.61
21779,U14286,55,-3195.6699999999983,49,6,54792.04000000001,51596.37000000001
21780,U31956,55,17743.550000000003,45,10,111124.77000000002,128868.32000000002
21781,U11305,55,-2118.9599999999973,30,25,77539.71,75420.75000000001
21782,U35190,55,-23639.439999999995,46,9,137010.78,113371.34
21783,U22540,55,41105.42,51,4,30466.779999999995,71572.2
21784,U30087,55,-217707.06,32,23,1505507.17,1287800.1099999999
21785,U36224,55,2374.039999999999,34,21,28274.9,30648.940000000002
21786,U25781,55,-94145.21999999999,34,21,617620.3099999999,523475.08999999997
21787,U19780,55,-271153.82,42,13,653344.8200000002,382191.0000000002
21788,U34518,55,-30812.910000000003,36,19,521125.24,490312.32999999996
21789,U27042,55,-76325.13,43,12,209289.69999999998,132964.56999999998
21790,U27253,55,67343.84,31,24,983832.41,1051176.25
21791,U898740,55,-1572.2799999999997,34,21,8153.02,6580.740000000001
21792,U20784,55,-67.6800000000037,49,6,21590.399999999998,21522.719999999994
21793,U31035,55,-1175.1000000000931,14,41,1385757.0,1384581.9
21794,U29623,55,-10426.06,45,10,61188.38,50762.32
21795,U23478,55,-1504.04,50,5,20160.73,18656.69
21796,U34862,55,-1068.5899999999992,51,4,10788.069999999998,9719.48
21797,U42426,55,-216.71000000000413,35,20,75998.58,75781.87
21798,U590121,55,-14364.400000000001,43,12,23302.83,8938.43
21799,U8681,55,-26374.770000000008,40,15,234880.26,208505.49
21800,U31344,55,-243018.4100000001,49,6,302438.4499999999,59420.039999999804
21801,U40642,55,-14453.42,47,8,80778.43,66325.01
21802,U17751,55,6635.37,49,6,21597.06,28232.43
21803,U1176484,55,-412.3299999999999,39,16,14519.35,14107.02
21804,U30077,55,728.3099999999998,53,2,7098.6900000000005,7827.0
21805,U12314,55,512.4700000000005,48,7,12691.42,13203.890000000001
21806,U30925,55,-68835.91,33,22,314261.0799999999,245425.1699999999
21807,U23417,55,5831.510000000002,41,14,188718.6,194550.11000000002
21808,U12279,55,58494.88,47,8,89604.75999999997,148099.63999999996
21809,U33011,55,-1306.1000000000058,35,20,178859.02,177552.91999999998
21810,U991407,55,-496.64,42,13,683.4,186.76
21811,U41578,55,-118806.70000000001,39,16,287602.73,168796.02999999997
21812,U33847,55,-32361.390000000007,31,24,343666.87,311305.48
21813,U41330,55,35727.51000000001,31,24,296274.39,332001.9
21814,U14485,55,949.3200000000033,17,38,78098.93,79048.25
21815,U11092,55,-28336.31,46,9,109740.54000000001,81404.23000000001
21816,U38088,55,2645.3599999999997,32,23,13126.24,15771.599999999999
21817,U32860,55,-1169.1400000000003,51,4,3298.11,2128.97
21818,U27048,55,15114.18,42,13,74197.94,89312.12
21819,U914092,55,-9278.99,33,22,13722.940000000002,4443.950000000003
21820,U32169,55,-4356.639999999999,43,12,78219.61,73862.97
21821,U35968,55,28776.73,45,10,53185.07000000001,81961.8
21822,U20678,55,-5781.550000000003,49,6,20761.969999999994,14980.419999999991
21823,U33682,55,-31397.53,27,28,215714.08,184316.55
21824,U585670,55,101.42000000000007,32,23,6109.580000000001,6211.000000000001
21825,U43122,55,42496.499999999985,31,24,2158065.86,2200562.36
21826,U41958,55,-586.8399999999979,39,16,77599.32,77012.48000000001
21827,U24216,55,5393.920000000002,43,12,45978.10000000001,51372.02000000002
21828,U24755,55,9562.130000000001,50,5,4324.75,13886.880000000001
21829,U15941,55,101539.91,27,28,247754.9,349294.81
21830,U36409,55,39369.33,31,24,231000.58999999997,270369.92
21831,U35511,55,-2236.570000000001,40,15,207769.24999999994,205532.67999999993
21832,U24713,55,-80.53999999999883,45,10,24237.17,24156.63
21833,U32455,55,217.92999999999847,36,19,129886.76,130104.68999999999
21834,U25637,55,-5189.629999999997,41,14,69764.88,64575.25000000001
21835,U31345,55,-70924.51000000001,45,10,117110.69000000002,46186.18000000001
21836,U21977,55,-12959.340000000004,46,9,30346.020000000004,17386.68
21837,U13463,55,828122.01,35,20,658643.59,1486765.6
21838,U33971,55,2738.279999999995,49,6,117518.13999999998,120256.41999999998
21839,U25044,55,-10625.73,37,18,18985.980000000003,8360.250000000004
21840,U41306,55,2140.76,50,5,7966.159999999999,10106.919999999998
21841,U41355,55,-6718.82,50,5,19628.399999999998,12909.579999999998
21842,U36259,55,2514.1499999999996,50,5,9067.550000000001,11581.7
21843,U12921,55,-27012.74,47,8,35660.149999999994,8647.409999999993
21844,U37071,55,-63619.19,44,11,134405.3,70786.10999999999
21845,U10841,55,-11125.96,39,16,36328.08,25202.120000000003
21846,U11022,55,7181.8799999999965,37,18,219559.31000000003,226741.19000000003
21847,U23766,55,2157.840000000011,39,16,127712.18000000001,129870.02000000002
21848,U29380,55,-49602.20000000042,30,25,10057294.36,10007692.159999998
21849,U20537,55,268131.14,49,6,9567.4,277698.54000000004
21850,U28959,55,-108854.63,41,14,365248.1,256393.46999999997
21851,U8038,55,-3118.109999999996,37,18,287164.74,284046.63
21852,U38782,55,8200.140000000007,42,13,149522.06,157722.2
21853,U36348,55,-543.6999999999871,32,23,542879.8200000001,542336.1200000001
21854,U33004,55,-3233.96,40,15,12896.03,9662.07
21855,U18484,55,2388.580000000001,49,6,2395.4199999999996,4784.0
21856,U795906,55,14.620000000002129,29,26,48684.21,48698.83
21857,U10554,55,71692.96000000008,35,20,1121137.0100000002,1192829.9700000002
21858,U1372157,55,-11285.06,43,12,19485.78,8200.72
21859,U32719,55,17282.46,43,12,38800.1,56082.56
21860,U22542,55,2494.6100000000015,43,12,33939.57,36434.18
21861,U15357,55,-8468.110000000095,26,29,4481513.0,4473044.89
21862,U12333,55,-214.7900000000227,33,22,313694.46,313479.67
21863,U42979,55,18.14999999999918,33,22,34968.81,34986.96
21864,U16329,55,3387.260000000004,44,11,10476.380000000001,13863.640000000005
21865,U40237,55,-5845.589999999999,52,3,13172.899999999998,7327.309999999999
21866,U13762,55,15114.000000000016,30,25,146427.51,161541.51000000004
21867,U36883,55,4880.4000000000015,50,5,35194.96,40075.36
21868,U40845,55,173070.95999999996,46,9,87459.05,260530.00999999995
21869,U37078,54,1806.4600000000028,44,10,21061.03,22867.49
21870,U25828,54,3284.99,45,9,25840.899999999998,29125.89
21871,U1194148,54,-821.6199999999953,39,15,184862.29,184040.67
21872,U28063,54,-7872.350000000007,42,12,176137.91,168265.56
21873,U34708,54,-5836.640000000014,43,11,392216.12,386379.48
21874,U39597,54,1870.9399999999987,47,7,6409.349999999998,8280.289999999997
21875,U43179,54,-11762.869999999999,47,7,24845.55,13082.68
21876,U35588,54,49741.189999999995,40,14,217563.51,267304.7
21877,U8242,54,1439.6200000000013,43,11,21739.880000000005,23179.500000000007
21878,U19693,54,3601.2599999999893,27,27,130116.96999999999,133718.22999999998
21879,U30069,54,-5824.62,50,4,27831.940000000002,22007.320000000003
21880,U26516,54,-26323.42,43,11,112215.22,85891.8
21881,U31843,54,-4104.779999999999,30,24,88113.01999999999,84008.23999999999
21882,U19162,54,4299.739999999999,44,10,8610.349999999999,12910.089999999997
21883,U24138,54,-709.8099999999977,41,13,24319.11,23609.300000000003
21884,U28316,54,47743.149999999994,34,20,182504.19,230247.34
21885,U28388,54,1407.4299999999994,35,19,94754.23999999999,96161.66999999998
21886,U28016,54,-4659.340000000002,40,14,41578.939999999995,36919.59999999999
21887,U963458,54,-304.4099999999985,39,15,28604.610000000008,28300.200000000008
21888,U35199,54,67.48000000003009,21,33,755218.0,755285.48
21889,U23978,54,-2902.780000000006,33,21,197244.49,194341.71
21890,U9580,54,14749.209999999997,34,20,35044.56,49793.77
21891,U18197,54,269.7599999999981,30,24,83352.04999999999,83621.80999999998
21892,U20027,54,-5908.59,44,10,24215.15,18306.56
21893,U24144,54,-17792.69,41,13,1102973.9900000002,1085181.3000000003
21894,U15942,54,-591.730000000003,43,11,96145.39000000001,95553.66000000002
21895,U11544,54,-2032.4200000000274,31,23,309902.99,307870.56999999995
21896,U38672,54,16229.679999999942,28,26,650966.16,667195.84
21897,U30106,54,5416.439999999999,44,10,19281.049999999996,24697.489999999994
21898,U13039,54,-1296.5900000000038,34,20,229606.11,228309.52
21899,U15916,54,71129.5,42,12,389572.5199999999,460702.0199999999
21900,U24360,54,2347.1399999999985,37,17,64856.74,67203.87999999999
21901,U17086,54,-6299.850000000001,40,14,35234.84,28934.989999999994
21902,U707111,54,-7755.5599999999995,38,16,34684.66,26929.100000000006
21903,U13396,54,-7310.260000000006,21,33,56819.16000000001,49508.90000000001
21904,U19201,54,60.129999999997075,49,5,60075.660000000025,60135.79000000002
21905,U26063,54,-101656.66,43,11,284098.76,182442.1
21906,U1350207,54,-30218.229999999996,40,14,194195.96999999997,163977.74
21907,U14451,54,-961.3700000000033,30,24,47672.21,46710.84
21908,U41237,54,610.4999999999992,42,12,16240.66,16851.16
21909,U15270,54,972.9000000000004,38,16,12116.23,13089.13
21910,U17823,54,51189.27000000002,39,15,346555.08,397744.35000000003
21911,U25165,54,-1384.44,48,6,6086.949999999998,4702.509999999998
21912,U34283,54,140747.34999999998,34,20,81500.01000000001,222247.36
21913,U42319,54,-1633.5100000000002,43,11,29342.629999999997,27709.119999999995
21914,U32325,54,-11451.179999999998,45,9,54049.229999999996,42598.049999999996
21915,U21278,54,-2601.7099999999946,37,17,212196.77000000002,209595.06000000003
21916,U27917,54,-630.4699999999859,34,20,578911.86,578281.39
21917,U27905,54,3.250000000001137,45,9,35679.76,35683.01
21918,U27173,54,-2239.89,42,12,43661.26,41421.37
21919,U42347,54,18252.810000000078,37,17,443938.01999999996,462190.83
21920,U17247,54,38285.80999999999,40,14,60981.840000000004,99267.65
21921,U19959,54,2707.6299999999974,42,12,126138.50000000001,128846.13
21922,U43511,54,-14415.830000000009,34,20,348208.82,333792.99
21923,U39259,54,3603.820000000048,23,31,581155.94,584759.76
21924,U34232,54,-115.64999999999964,37,17,37338.81,37223.159999999996
21925,U1181049,54,44.21000000000277,39,15,64364.44,64408.65000000001
21926,U19022,54,-87160.62000000001,46,8,104277.41,17116.789999999994
21927,U28909,54,-13546.350000000006,47,7,96064.44,82518.09
21928,U20904,54,1156.5200000000013,49,5,6441.089999999997,7597.609999999999
21929,U39218,54,18700.739999999976,34,20,95689.29000000001,114390.02999999998
21930,U13391,54,5099.619999999999,36,18,136704.5,141804.12
21931,U20332,54,125548.72000000028,41,13,1185616.35,1311165.0700000003
21932,U8847,54,-478.0500000000002,44,10,32090.180000000004,31612.130000000005
21933,U30591,54,-15942.200000000006,37,17,156354.81,140412.61
21934,U39563,54,-42846.419999999984,34,20,229633.35,186786.93000000002
21935,U30033,54,-2164.579999999998,47,7,33309.229999999996,31144.649999999998
21936,U37357,54,-767.96,49,5,3112.169999999999,2344.209999999999
21937,U34530,54,1110162.8899999997,48,6,5397028.710000001,6507191.600000001
21938,U44065,54,-111.7599999999997,47,7,6933.93,6822.170000000001
21939,U34966,54,61503.79000000001,34,20,481417.41000000003,542921.2000000001
21940,U12614,54,3423.840000000001,49,5,6062.95,9486.79
21941,U20849,54,-1342.4400000000007,31,23,16873.43,15530.99
21942,U31287,54,-32978.200000000004,39,15,136513.11,103534.90999999997
21943,U42770,54,1968.9500000000116,27,27,307887.01,309855.96
21944,U25587,54,803.3200000000005,36,18,22366.250000000004,23169.570000000003
21945,U33196,54,-3850.409999999999,44,10,20608.840000000004,16758.430000000004
21946,U31979,54,12848.499999999978,28,26,2589974.8999999994,2602823.3999999994
21947,U40689,54,-40199.569999999905,38,16,611955.86,571756.29
21948,U21486,54,100172.07,47,7,9064.339999999998,109236.41
21949,U12994,54,-200613.40000000008,12,42,1861982.5,1661369.0999999999
21950,U35153,54,-3410.9199999999973,45,9,73384.51999999999,69973.59999999999
21951,U30281,54,1597.6299999999992,48,6,17260.219999999998,18857.85
21952,U40664,54,-7227.419999999998,47,7,23142.420000000002,15915.000000000004
21953,U29262,54,94382.92000000025,34,20,2021698.86,2116081.7800000003
21954,U22694,54,1610.0200000000104,36,18,148409.3,150019.32
21955,U32804,54,-351.2400000000016,35,19,64155.31000000001,63804.07000000001
21956,U35742,54,-13073.360000000004,48,6,34504.62,21431.26
21957,U36535,54,-7457.760000000027,31,23,384455.0,376997.24
21958,U23393,54,-15773.489999999996,36,18,37754.869999999995,21981.379999999997
21959,U1322718,54,1576.779999999996,33,21,96205.01000000001,97781.79000000001
21960,U1185357,54,-527.8199999999961,37,17,76407.23000000001,75879.41000000002
21961,U16024,54,60194.06,41,13,7930.62,68124.68
21962,U26341,54,-1599.549999999999,34,20,25428.36,23828.81
21963,U24779,54,-25832.929999999997,37,17,86136.52999999998,60303.59999999999
21964,U16355,54,13983.659999999989,44,10,230067.06,244050.71999999997
21965,U1087199,54,504.0899999999999,30,24,23053.04,23557.13
21966,U10830,54,-26466.34,39,15,42997.98000000001,16531.64000000001
21967,U33163,54,44.28000000000429,37,17,43582.3,43626.58000000001
21968,U976196,54,-741.1500000000002,32,22,10662.839999999998,9921.689999999999
21969,U35260,54,125.35999999999058,48,6,58367.32000000001,58492.68
21970,U13466,54,-63205.96000000001,32,22,142658.25,79452.29
21971,U38441,54,-44083.66,45,9,63058.310000000005,18974.65
21972,U43451,54,-1682.6099999999997,42,12,14640.680000000002,12958.070000000003
21973,U15511,54,-2296.9,40,14,11685.550000000003,9388.650000000003
21974,U41080,54,-12877.910000000003,38,16,311517.05,298639.14
21975,U34669,54,4837.530000000002,40,14,15726.029999999999,20563.56
21976,U28244,54,6287.330000000001,28,26,115597.66000000002,121884.99000000002
21977,U39629,54,-2032.3999999999992,30,24,60520.51,58488.11
21978,U39582,54,-40233.520000000004,44,10,64988.58000000001,24755.060000000005
21979,U31924,54,-2246.0400000000004,42,12,30367.609999999997,28121.569999999996
21980,U40612,54,-4235.04,49,5,4671.76,436.72000000000025
21981,U29900,54,-343.92999999999995,52,2,8501.929999999998,8157.999999999998
21982,U30610,54,29460.889999999992,40,14,140041.47,169502.36
21983,U39803,54,16629.55,42,12,42938.67999999999,59568.229999999996
21984,U27779,54,190.27999999999975,41,13,33369.35,33559.63
21985,U20647,54,-29.47999999999811,31,23,35195.76,35166.280000000006
21986,U20357,54,-1390.479999999996,39,15,192020.5,190630.02000000002
21987,U9811,54,-2184.960000000001,42,12,56067.19999999999,53882.23999999999
21988,U31241,54,12313.5,42,12,78359.5,90673.0
21989,U15770,54,20401.150000000005,41,13,145767.5,166168.65
21990,U12639,54,64164.280000000006,41,13,81331.03000000003,145495.31000000003
21991,U32063,54,-495.40999999999985,39,15,19710.059999999998,19214.649999999998
21992,U1164545,54,-10.0,28,26,6504.0,6494.0
21993,U9594,54,-46015.14999999999,47,7,70715.01,24699.860000000008
21994,U27535,54,18632.160000000018,30,24,599007.84,617640.0
21995,U21998,54,-116794.78,39,15,272113.4900000001,155318.7100000001
21996,U1122178,54,-1585.4499999999996,45,9,12036.000000000002,10450.550000000003
21997,U1146838,54,603.7099999999999,35,19,17524.530000000002,18128.24
21998,U28308,54,-97737.35999999997,42,12,238195.5,140458.14
21999,U41170,54,114.95000000000006,47,7,7441.3,7556.25
22000,U25389,54,4749.159999999994,31,23,162757.99,167507.15
22001,U38417,54,-30041.6,48,6,31105.439999999995,1063.8399999999965
22002,U19762,54,1961.0700000000188,38,16,542572.4099999999,544533.48
22003,U31687,54,-10119.36,36,18,374266.32999999996,364146.97
22004,U21894,54,-440.85000000000036,40,14,12641.11,12200.26
22005,U41664,54,137064.16999999998,40,14,106742.79000000001,243806.96
22006,U11561,54,20685.65,39,15,118053.83,138739.48
22007,U15354,54,-50320.95000000001,42,12,641681.29,591360.3400000001
22008,U16312,54,-20240.499999999993,42,12,194107.74,173867.24
22009,U43899,54,2334.64,45,9,11617.12,13951.76
22010,U16571,54,-11703.000000000005,41,13,72890.39000000001,61187.39000000001
22011,U12242,54,578.4400000000032,44,10,29777.739999999994,30356.179999999997
22012,U28752,54,-9428.599999999995,32,22,90036.9,80608.3
22013,U39586,54,13867.940000000002,37,17,338436.29,352304.23
22014,U24330,54,-4116.58,46,8,48289.880000000005,44173.3
22015,U10480,54,-110682.48000000004,25,29,798626.0,687943.52
22016,U34006,54,2790.8899999999967,35,19,182898.74,185689.62999999998
22017,U21606,54,1639.0000000000002,30,24,12137.95,13776.95
22018,U18042,54,105494.38999999998,40,14,342789.63,448284.02
22019,U35789,54,-20177.980000000007,42,12,35678.84000000001,15500.860000000004
22020,U13674,54,-13188.539999999999,45,9,54855.77,41667.229999999996
22021,U8312,54,-13134.760000000006,25,29,102623.16,89488.4
22022,U18696,54,-2190.660000000016,34,20,137596.7,135406.04
22023,U34008,54,-127807.73000000001,31,23,234022.06999999998,106214.33999999997
22024,U32318,54,6757.070000000001,41,13,22278.089999999997,29035.159999999996
22025,U597757,54,-316.6899999999996,32,22,8950.25,8633.560000000001
22026,U42483,54,-948.0000000000005,45,9,16315.359999999995,15367.359999999995
22027,U36826,54,-5182.319999999999,47,7,10227.4,5045.080000000001
22028,U41252,54,-962.4499999999985,34,20,174516.55999999997,173554.10999999996
22029,U34016,54,-6879.249999999989,46,8,172776.99,165897.74
22030,U853374,54,0.07000000000061846,32,22,37687.94,37688.01
22031,U10184,54,-2483.980000000003,35,19,83126.9,80642.91999999998
22032,U1252756,54,554.3800000000069,31,23,64483.39,65037.770000000004
22033,U10148,54,-230.5800000000022,32,22,266260.07999999996,266029.49999999994
22034,U28871,54,258931.53999999998,36,18,512884.1,771815.6399999999
22035,U933997,54,-4357.570000000001,38,16,15780.850000000004,11423.280000000002
22036,U32194,54,-3665.5800000000027,37,17,60615.65000000001,56950.07000000001
22037,U33856,54,-1616.6199999999985,48,6,22882.76,21266.14
22038,U10120,54,12128.400000000005,42,12,39992.46,52120.86
22039,U43321,54,-46620.92,42,12,104228.85,57607.93000000001
22040,U588829,54,-24229.33,45,9,39809.01000000002,15579.680000000015
22041,U31416,54,-141991.66999999998,43,11,316015.98000000004,174024.31000000006
22042,U26527,54,-12166.890000000018,29,25,327865.19,315698.3
22043,U15040,54,6527.540000000003,29,25,65767.20999999999,72294.75
22044,U26929,54,-6646.320000000012,32,22,160908.86999999997,154262.54999999996
22045,U43932,54,-1602.8800000000006,45,9,33621.689999999995,32018.809999999994
22046,U31528,54,-2499.8499999999985,38,16,51606.38999999999,49106.53999999999
22047,U34123,54,2845.17000000001,35,19,150839.50999999998,153684.68
22048,U15959,54,-79.55000000000291,26,28,135287.27000000002,135207.72000000003
22049,U12965,54,-4472.650000000009,36,18,344559.51,340086.86
22050,U29966,54,-113.32000000000198,32,22,39536.22,39422.9
22051,U9377,54,-18987.54000000001,28,26,276749.42000000004,257761.88000000003
22052,U23013,54,-5358.150000000001,38,16,92398.75000000001,87040.60000000002
22053,U12070,54,-85052.80999999998,42,12,158278.49,73225.68000000001
22054,U944139,54,-15.980000000000473,31,23,12656.22,12640.239999999998
22055,U36649,54,3992.5599999999986,47,7,34897.04000000001,38889.600000000006
22056,U36642,54,-16575.659999999996,44,10,99210.90999999999,82635.25
22057,U586288,54,2021.8999999999992,43,11,2997.5,5019.4
22058,U24125,54,-24287.239999999816,42,12,2165799.6699999995,2141512.4299999997
22059,U38225,54,268.6200000000005,39,15,7141.019999999998,7409.6399999999985
22060,U19720,54,184.24999999999417,26,28,84993.54,85177.79
22061,U9744,54,9212.830000000002,50,4,2942.5700000000015,12155.400000000003
22062,U31836,54,611.5900000000001,42,12,36293.65,36905.240000000005
22063,U29206,54,3194.1400000000062,25,29,176191.79,179385.93000000002
22064,U20823,54,1667.3900000000083,34,20,158625.07000000004,160292.46000000005
22065,U40459,54,-2612.8999999999996,38,16,187171.29000000004,184558.39000000004
22066,U10764,54,7644.280000000028,37,17,409510.32000000007,417154.6000000001
22067,U17916,54,25938.589999999997,50,4,34082.47,60021.06
22068,U38474,54,66608.65,40,14,208682.91,275291.56
22069,U30708,54,-4903.14,41,13,7966.08,3062.9399999999996
22070,U15865,54,31115.419999999995,32,22,57469.28999999999,88584.70999999999
22071,U42506,54,-303.11000000004265,43,11,427568.3900000001,427265.28
22072,U40350,54,-9388.71,50,4,10758.599999999999,1369.8899999999994
22073,U692716,53,11.099999999999923,31,22,26084.650000000005,26095.750000000004
22074,U32977,53,37229.36000000007,37,16,1203351.51,1240580.87
22075,U15243,53,42935.81,25,28,106033.45999999999,148969.27
22076,U11148,53,11095.12999999999,38,15,184066.24,195161.37
22077,U33948,53,-7810.4299999999985,39,14,136632.34999999998,128821.91999999998
22078,U26085,53,51386.07999999999,35,18,139440.58,190826.65999999997
22079,U32687,53,-15.809999999999814,44,9,5287.94,5272.13
22080,U12339,53,-25036.67,23,30,136232.02000000002,111195.35000000002
22081,U22152,53,1547.0,43,10,21046.53,22593.53
22082,U40308,53,-6831.290000000002,39,14,77261.53000000001,70430.24
22083,U36387,53,2453.339999999996,36,17,74620.51999999999,77073.85999999999
22084,U17625,53,-17959.529999999988,43,10,69838.3,51878.77000000002
22085,U642681,53,-4978.8099999999995,47,6,54627.38,49648.57
22086,U36760,53,8581.96,45,8,14716.570000000003,23298.530000000002
22087,U11169,53,58342.33,35,18,63739.979999999996,122082.31
22088,U9201,53,5776.639999999985,38,15,938695.81,944472.4500000001
22089,U20385,53,6527.660000000002,37,16,38789.0,45316.66
22090,U12479,53,-23191.510000000002,40,13,85484.77,62293.26
22091,U17845,53,1371.3599999999997,42,11,23294.640000000007,24666.000000000007
22092,U30116,53,11324.410000000003,31,22,247744.17,259068.58000000002
22093,U17151,53,-4083443.7799999993,38,15,8359869.67,4276425.890000001
22094,U1250665,53,-175.54000000000036,36,17,8246.59,8071.05
22095,U32347,53,44172.700000000004,38,15,13271.74,57444.44
22096,U23859,53,-2499.4499999999985,48,5,17051.99,14552.540000000003
22097,U43731,53,-3249.759999999998,47,6,18625.989999999998,15376.23
22098,U18951,53,199751.59,36,17,239482.69999999998,439234.29
22099,U9543,53,1104640.15,36,17,257726.5,1362366.65
22100,U22162,53,437.38000000000017,44,9,20173.579999999998,20610.96
22101,U20372,53,-38441.37000000004,39,14,93894.06999999999,55452.69999999995
22102,U14016,53,45726.66999999998,36,17,510901.7099999999,556628.3799999999
22103,U15891,53,291203.98,39,14,68751.26999999999,359955.25
22104,U585652,53,693.3499999999999,30,23,24483.78,25177.129999999997
22105,U38518,53,204015.1,28,25,63851.52,267866.62
22106,U1142812,53,1500.5599999999986,33,20,29559.12,31059.679999999997
22107,U27184,53,-133305.52,35,18,568414.6,435109.07999999996
22108,U18712,53,-36167.46999999999,42,11,281097.0,244929.53000000003
22109,U15271,53,21973.160000000003,45,8,53127.530000000006,75100.69
22110,U19325,53,-14384.289999999995,40,13,46281.53,31897.240000000005
22111,U36440,53,-401.5600000000004,46,7,15532.269999999999,15130.71
22112,U28102,53,-2231.069999999996,46,7,113338.75999999998,111107.68999999999
22113,U12190,53,-547.6299999990151,28,25,2532210.0300000003,2531662.4000000013
22114,U23751,53,-34592.71999999999,34,19,534584.98,499992.26
22115,U905550,53,860.9099999999961,39,14,12571.790000000003,13432.699999999999
22116,U9778,53,-15919.769999999997,42,11,96497.45999999999,80577.69
22117,U23480,53,3013.5800000000054,36,17,235308.68,238322.26
22118,U40790,53,40424.630000000005,32,21,152232.8,192657.43
22119,U31300,53,-491.74000000000024,43,10,3186.6,2694.8599999999997
22120,U25501,53,2242.5799999999995,42,11,53965.92999999999,56208.509999999995
22121,U20128,53,1863.0399999999995,44,9,4387.2,6250.24
22122,U587840,53,-16735.54,37,16,23915.54,7180.0
22123,U21250,53,12244.680000000066,30,23,503740.8,515985.48000000004
22124,U17723,53,-6825.199999999999,41,12,141204.91999999998,134379.71999999997
22125,U36971,53,-3538.3900000000003,47,6,6351.450000000001,2813.0600000000004
22126,U28860,53,16602.879999999994,45,8,21748.28,38351.15999999999
22127,U38413,53,2569.9599999999955,44,9,47570.770000000004,50140.729999999996
22128,U20741,53,-52549.26000000001,46,7,54375.530000000006,1826.2699999999968
22129,U1129606,53,-12.569999999999943,29,24,795.55,782.98
22130,U24732,53,-46238.57000000001,41,12,123641.15,77402.57999999999
22131,U1108690,53,-1923.7100000000005,37,16,12192.489999999998,10268.779999999997
22132,U574643,53,-4548.66,46,7,7714.879999999999,3166.2199999999993
22133,U29747,53,-175.4699999999939,35,18,199816.46,199640.99
22134,U42685,53,51544.49000000002,28,25,75176.19,126720.68000000002
22135,U757007,53,-2748.960000000001,42,11,54217.38,51468.42
22136,U1087831,53,-1898.94,30,23,15511.5,13612.56
22137,U12382,53,445.1700000000001,42,11,18512.11,18957.28
22138,U39510,53,11.179999999996653,28,25,137259.31,137270.49
22139,U38916,53,425334.7899999998,42,11,684648.3899999998,1109983.1799999997
22140,U37014,53,6020.609999999997,43,10,100884.51,106905.12
22141,U30112,53,5152.03,32,21,52562.62,57714.65
22142,U33994,53,-75281.01000000001,46,7,128040.24,52759.229999999996
22143,U20310,53,-8527.430000000004,38,15,180425.93999999997,171898.50999999998
22144,U10756,53,11440.52,39,14,34372.100000000006,45812.62000000001
22145,U41022,53,1288.530000000006,33,20,195586.62,196875.15
22146,U30529,53,-29.229999999995925,37,16,144931.64,144902.41000000003
22147,U25451,53,367.60000000000036,36,17,5481.719999999999,5849.32
22148,U36189,53,-19565.99999999999,32,21,342240.63,322674.63
22149,U21443,53,41275.71,37,16,137991.58999999997,179267.29999999996
22150,U24217,53,299.77000000000044,26,27,331423.45999999996,331723.23
22151,U42031,53,2607.209999999992,27,26,454393.75,457000.95999999996
22152,U1249605,53,48.129999999999995,34,19,7720.299999999999,7768.429999999999
22153,U16291,53,96785.62,34,19,34851.85,131637.47
22154,U39164,53,16080.320000000038,44,9,1708752.51,1724832.83
22155,U42561,53,42371.28,43,10,22283.629999999997,64654.909999999996
22156,U24077,53,3123.470000000001,44,9,90187.25,93310.72
22157,U37818,53,17385.95000000003,41,12,289274.49,306660.44
22158,U21733,53,-4485.840000000002,37,16,34649.55999999999,30163.719999999987
22159,U664687,53,-6678.49,28,25,26911.300000000003,20232.810000000005
22160,U32442,53,12795.410000000003,25,28,392140.5,404935.91000000003
22161,U32401,53,-36199.17,49,4,45540.25,9341.080000000002
22162,U994492,53,-25143.380000000005,50,3,70144.38000000002,45001.000000000015
22163,U24306,53,1564.3700000000008,45,8,11721.19,13285.560000000001
22164,U25789,53,10905.389999999998,34,19,84171.06999999999,95076.45999999999
22165,U11775,53,12613.539999999999,47,6,10148.499999999998,22762.039999999997
22166,U1140382,53,-2093.22,38,15,5440.83,3347.61
22167,U700902,53,-2983.1700000000005,34,19,8684.310000000001,5701.140000000001
22168,U42585,53,-46668.939999999995,31,22,545960.94,499291.99999999994
22169,U11038,53,1513.3200000000004,45,8,12378.390000000005,13891.710000000005
22170,U24001,53,-1162.050000000009,48,5,54626.12999999999,53464.07999999998
22171,U12220,53,-25868.999999999993,29,24,188827.28,162958.28
22172,U31090,53,-79234.43999999999,36,17,194125.24,114890.8
22173,U37046,53,9855.14,50,3,9440.849999999999,19295.989999999998
22174,U36036,53,-2477.42,48,5,18121.050000000003,15643.630000000003
22175,U12037,53,1135.3799999999974,46,7,77179.50999999998,78314.88999999998
22176,U43295,53,16140.429999999997,44,9,32607.859999999997,48748.28999999999
22177,U10456,53,-2689.2499999999995,50,3,5690.36,3001.11
22178,U10485,53,37082.29000000001,42,11,16600.72,53683.01000000001
22179,U26546,53,10185.10999999987,27,26,1307370.59,1317555.7
22180,U11526,53,3234.3599999999624,28,25,1625561.6,1628795.96
22181,U1051443,53,58.60999999999998,33,20,326.73999999999995,385.3499999999999
22182,U30091,53,-1146.4699999999993,44,9,24048.739999999998,22902.269999999997
22183,U24186,53,59561.329999999994,36,17,96201.52999999998,155762.86
22184,U693971,53,-220.75000000000006,28,25,4358.5,4137.75
22185,U42792,53,23153.269999999997,37,16,241015.61,264168.88
22186,U10575,53,-29709.47,45,8,40598.61,10889.14
22187,U29337,53,22725.78,47,6,57988.180000000015,80713.96000000002
22188,U38473,53,543.9399999999985,42,11,37138.39,37682.329999999994
22189,U18134,53,1547.4,48,5,4652.910000000002,6200.310000000001
22190,U21009,53,21873.13000000001,44,9,119904.36999999998,141777.5
22191,U29182,53,-59791.36999999999,43,10,132296.08,72504.70999999999
22192,U15820,53,-105106.56000000001,41,12,285943.67000000004,180837.11000000004
22193,U14938,53,-32532.130000000005,43,10,86450.74000000003,53918.61000000003
22194,U22168,53,8.39000000000101,39,14,9236.789999999999,9245.18
22195,U27940,53,-1301.1799999999957,38,15,113887.12000000001,112585.94000000002
22196,U32239,53,11406.330000000045,29,24,312373.77,323780.1000000001
22197,U32656,53,764.1800000000178,37,16,193733.73999999996,194497.91999999998
22198,U29336,53,19673.510000000013,43,10,168723.78999999998,188397.3
22199,U1192758,53,41778.179999999964,31,22,357037.37999999995,398815.55999999994
22200,U33937,53,6146.490000000002,33,20,85150.88,91297.37000000001
22201,U12379,53,2679.8799999999983,31,22,137162.78999999998,139842.66999999998
22202,U31371,53,-17660.589999999997,44,9,107423.82999999999,89763.23999999999
22203,U21593,53,-2126.6000000000004,46,7,15704.05,13577.449999999999
22204,U41188,53,-69522.35,40,13,102069.41,32547.059999999998
22205,U42362,53,-841.6199999999999,48,5,12919.04,12077.420000000002
22206,U12153,53,59913.31999999999,28,25,243682.04,303595.36
22207,U30046,53,-235.79999999999563,29,24,81246.09,81010.29000000001
22208,U14529,53,20001.800000000003,43,10,100066.32,120068.12000000001
22209,U34143,53,-8313.78999999999,44,9,139084.4,130770.61
22210,U29815,53,-581.6099999999979,47,6,11981.199999999999,11399.59
22211,U25532,53,241357.31999999998,38,15,485988.55,727345.87
22212,U21680,53,-20019.43,33,20,314878.78,294859.35000000003
22213,U20108,53,4477.6100000000015,47,6,3115.93,7593.540000000001
22214,U1275295,53,-894.5200000000002,34,19,12309.769999999999,11415.249999999998
22215,U20548,53,39209.379999999976,31,22,514529.43,553738.8099999999
22216,U19928,53,-556.0000000000009,32,21,97206.05,96650.05
22217,U662412,53,-3864.589999999999,49,4,8636.189999999999,4771.6
22218,U18935,53,-5978.95,35,18,77083.81,71104.86
22219,U14188,53,5417.170000000044,29,24,2614407.99,2619825.16
22220,U14777,53,-2101.8799999999833,37,16,353394.86,351292.98
22221,U22292,53,83815.86000000002,35,18,52907.12000000001,136722.98000000004
22222,U38751,53,3725.3600000000006,21,32,48049.15000000001,51774.51000000001
22223,U31799,53,-392.25,46,7,32101.94,31709.69
22224,U30353,53,2679.110000000001,49,4,6224.46,8903.570000000002
22225,U39182,53,4733.18,42,11,135252.29,139985.47
22226,U14815,53,35694.46000000001,32,21,212478.86000000004,248173.32000000007
22227,U12680,53,-15025.169999999998,46,7,50947.99,35922.82
22228,U12974,53,-3321.8800000000338,30,23,597240.55,593918.67
22229,U22017,53,52296.959999999985,36,17,365063.4,417360.36
22230,U42900,53,-85.90000000000283,45,8,43691.69999999998,43605.79999999998
22231,U38468,53,340.5599999999995,44,9,10210.1,10550.66
22232,U40030,53,-9718.990000000005,41,12,120396.02999999998,110677.03999999998
22233,U24162,53,-16611.08,26,27,221019.9,204408.82
22234,U24137,53,2456.58000000002,31,22,353073.29000000004,355529.87000000005
22235,U31635,53,-34744.25,36,17,110449.43000000001,75705.18000000001
22236,U11613,53,-9910.71,45,8,54134.490000000005,44223.780000000006
22237,U30723,53,17147.18,40,13,41187.770000000004,58334.950000000004
22238,U26878,53,386098.76000000007,32,21,471646.7599999999,857745.52
22239,U26591,53,-51892.32000000001,38,15,212811.59999999998,160919.27999999997
22240,U30187,53,-119.42000000000007,51,2,5121.8,5002.38
22241,U32025,53,153.59999999999877,37,16,41334.15,41487.75
22242,U31584,53,-31322.400000000052,36,17,2586056.27,2554733.87
22243,U30622,53,3936.3299999999995,40,13,15568.58,19504.91
22244,U36457,53,-10219.920000000035,34,19,298352.84,288132.92
22245,U29361,53,-2870.0099999999998,46,7,4224.509999999999,1354.4999999999995
22246,U33147,53,2843.6899999999996,47,6,4143.06,6986.75
22247,U24916,53,25782.079999999984,41,12,45343.31,71125.38999999998
22248,U14603,53,-7200.000000000002,40,13,87820.98000000001,80620.98000000001
22249,U16292,53,62878.51000000002,38,15,76011.47999999998,138889.99
22250,U13131,53,-1246.5500000000004,39,14,26612.080000000005,25365.530000000006
22251,U33591,53,8260.759999999998,35,18,19813.22,28073.98
22252,U9987,53,-1858.8299999999997,41,12,16547.829999999994,14688.999999999995
22253,U33679,53,4226.68,26,27,28668.42,32895.1
22254,U42911,53,-6.366462912410498e-12,26,27,113524.71999999999,113524.71999999999
22255,U24030,53,8094.580000000002,45,8,126656.68,134751.26
22256,U981654,53,19128.430000000015,41,12,33375.59999999999,52504.030000000006
22257,U17333,53,50949.91000000007,29,24,504038.65,554988.56
22258,U24097,53,-114115.27000000005,35,18,643892.69,529777.4199999999
22259,U23988,53,-1668.9000000000015,48,5,20527.2,18858.3
22260,U30968,53,-6995.44,49,4,8527.239999999998,1531.7999999999984
22261,U8212,53,-6131.329999999998,33,20,79496.13,73364.8
22262,U12025,53,-2566.3899999999867,33,20,295529.82,292963.43
22263,U9491,53,-36700.259999999995,41,12,163621.05000000002,126920.79000000002
22264,U13675,53,61199.83000000005,26,27,1912474.84,1973674.6700000002
22265,U37050,53,-567.2700000000004,43,10,22167.289999999997,21600.019999999997
22266,U12280,53,1569.69,47,6,7896.53,9466.22
22267,U37966,53,4583.970000000001,48,5,6528.030000000001,11112.000000000002
22268,U33733,53,2196.1800000000044,34,19,114419.90000000001,116616.08000000002
22269,U12552,53,-87401.83000000002,39,14,184544.63,97142.79999999999
22270,U18201,53,-1107.8000000000043,29,24,143714.39,142606.59
22271,U13879,53,88.55999999999767,26,27,719825.46,719914.02
22272,U38625,53,-17007.97,28,25,659817.8400000001,642809.8700000001
22273,U32051,53,-4866.990000000005,29,24,466330.0,461463.01
22274,U42677,53,-10901.990000000016,42,11,176684.41999999995,165782.42999999993
22275,U42184,53,4575.550000000001,27,26,121602.34999999999,126177.9
22276,U15159,53,31422.65000000001,44,9,60876.770000000004,92299.42000000001
22277,U19680,53,-57.21000000000137,40,13,30513.900000000005,30456.690000000002
22278,U27257,53,35916.849999999984,42,11,71439.59000000001,107356.44
22279,U40168,53,-17545.880000000034,37,16,519015.78,501469.9
22280,U30574,53,18124.589999999997,32,21,58969.31,77093.9
22281,U33109,53,6493.17,43,10,15135.939999999999,21629.11
22282,U988225,53,-2300.07,34,19,12355.92,10055.85
22283,U9598,53,-9133.14,41,12,101157.13,92023.99
22284,U13059,53,-59802.92,37,16,158073.75,98270.83
22285,U38737,53,-155714.52000000002,37,16,1194022.8,1038308.28
22286,U30315,53,947.2399999999998,35,18,95608.66,96555.90000000001
22287,U1307461,53,2.180000000000007,30,23,1125.28,1127.46
22288,U17853,53,27602.36,40,13,58087.689999999995,85690.04999999999
22289,U639414,53,377.6599999999992,31,22,17837.850000000002,18215.510000000002
22290,U23173,53,47482.08,31,22,99900.25999999997,147382.33999999997
22291,U988768,53,-48.270000000001666,25,28,44821.149999999994,44772.87999999999
22292,U21856,53,59964.31,36,17,144516.38,204480.69
22293,U17355,53,-77934.03,32,21,238344.36000000002,160410.33000000002
22294,U20480,53,-388.43000000000137,27,26,49144.3,48755.87
22295,U26324,53,-30.219999999999345,29,24,1046455.43,1046425.2100000001
22296,U17645,53,-397.8899999999994,28,25,287997.0,287599.11
22297,U13717,53,-78363.86999999992,24,29,783016.58,704652.7100000001
22298,U27240,53,5314.7999999999965,41,12,67279.1,72593.90000000001
22299,U22213,53,-19687.33,45,8,30440.499999999996,10753.169999999995
22300,U21311,53,-56239.23000000001,38,15,188489.78,132250.55
22301,U10388,53,5053.319999999983,33,20,1125126.37,1130179.6900000002
22302,U16896,52,-17362.69,35,17,39565.12999999999,22202.43999999999
22303,U26749,52,-3863.1200000000013,46,6,14252.899999999996,10389.779999999995
22304,U33964,52,-15.760000000000135,42,10,43558.11000000001,43542.350000000006
22305,U21153,52,-160026.05000000002,38,14,265012.81,104986.75999999998
22306,U36021,52,-53762.83000000003,32,20,304810.52,251047.69
22307,U21259,52,-240517.98000000007,24,28,2766711.8099999996,2526193.8299999996
22308,U22714,52,405.7500000000007,26,26,85916.36,86322.11
22309,U40758,52,-17186.470000000023,39,13,179242.47000000003,162056.0
22310,U1145958,52,-195.24,45,7,8195.609999999999,8000.369999999999
22311,U37175,52,508.1600000000035,34,18,114605.44,115113.6
22312,U38698,52,78093.71,23,29,163437.50000000003,241531.21000000002
22313,U20478,52,-396081.19,38,14,1254590.67,858509.48
22314,U20311,52,-18214.449999999997,39,13,135941.62,117727.17
22315,U20903,52,-44487.869999999995,45,7,210913.92999999996,166426.05999999997
22316,U33100,52,51386.46000000002,42,10,200772.95,252159.41000000003
22317,U17471,52,-207.5899999999987,37,15,33681.98,33474.39000000001
22318,U13141,52,-678.9599999999991,34,18,224394.75999999998,223715.8
22319,U38980,52,-22584.829999999998,35,17,59283.82,36698.990000000005
22320,U10835,52,26593.95999999999,32,20,142072.85,168666.81
22321,U22308,52,4450.040000000003,46,6,46027.670000000006,50477.71000000001
22322,U9134,52,2061.3300000000017,24,28,360101.35,362162.68
22323,U26678,52,17.139999999999418,32,20,30837.54,30854.68
22324,U17602,52,55100.42999999996,29,23,1304219.8299999998,1359320.2599999998
22325,U30701,52,-5912.750000000001,44,8,24189.44,18276.69
22326,U24227,52,-13954.07,41,11,30429.22,16475.15
22327,U588611,52,-222.8800000000001,38,14,3155.94,2933.06
22328,U8959,52,57497.82000000001,33,19,458027.6,515525.42
22329,U42124,52,-201303.31,37,15,256078.46,54775.149999999994
22330,U34270,52,-1516.0499999999977,46,6,26357.839999999997,24841.789999999997
22331,U14985,52,-1404.4299999999985,31,21,114392.12999999999,112987.7
22332,U36110,52,332.74999999999636,43,9,38390.850000000006,38723.600000000006
22333,U14326,52,-87743.45999999999,41,11,102292.42,14548.960000000006
22334,U39970,52,-502132.99000000005,41,11,666744.3200000001,164611.33000000002
22335,U32571,52,-12720.089999999997,25,27,606678.33,593958.24
22336,U16870,52,91095.81000000004,31,21,402052.7599999999,493148.56999999995
22337,U17294,52,39716.36999999999,31,21,321894.83,361611.2
22338,U18242,52,39590.89,14,38,64929.72999999999,104520.62
22339,U34840,52,-10780.489999999998,35,17,44111.19,33330.700000000004
22340,U15824,52,13129.050000000007,47,5,6961.450000000001,20090.500000000007
22341,U36491,52,-67347.35,39,13,217486.27,150138.91999999998
22342,U12344,52,-12918.569999999998,44,8,20803.899999999998,7885.33
22343,U23917,52,4224.659999999999,43,9,8697.01,12921.669999999998
22344,U782341,52,-112806.48999999999,40,12,133679.16,20872.670000000013
22345,U32048,52,-22399.65000000001,36,16,94721.51000000001,72321.86
22346,U11678,52,-11777.050000000003,35,17,143254.68999999997,131477.63999999996
22347,U36934,52,6974.530000000009,42,10,154785.41999999998,161759.94999999998
22348,U40655,52,8851.359999999997,35,17,66691.12,75542.48
22349,U40907,52,-46002.78000000001,43,9,112792.5,66789.71999999999
22350,U23664,52,8079.580000000007,29,23,1158386.44,1166466.02
22351,U945116,52,2.83,27,25,5629.83,5632.66
22352,U36986,52,-55646.549999999996,34,18,72851.73,17205.18
22353,U42496,52,2923.629999999998,44,8,5656.74,8580.369999999997
22354,U18879,52,29195.460000000006,45,7,44778.979999999996,73974.44
22355,U22646,52,-9013.590000000006,41,11,93831.3,84817.70999999999
22356,U28182,52,1951.89,40,12,22555.509999999995,24507.399999999994
22357,U33319,52,-4835.810000000012,32,20,122363.93999999999,117528.12999999998
22358,U30370,52,1304384.0799999998,23,29,1047109.93,2351494.01
22359,U33294,52,4813.14,46,6,4333.08,9146.220000000001
22360,U32065,52,-1477.1299999999997,38,14,14890.309999999998,13413.179999999998
22361,U34260,52,360.55999999999995,43,9,6010.55,6371.110000000001
22362,U40033,52,-3936750.0799999996,37,15,5011141.9399999995,1074391.8599999999
22363,U29218,52,-12385.499999999995,38,14,175815.86000000002,163430.36000000002
22364,U1374304,52,0.0,26,26,39985.5,39985.5
22365,U39975,52,-3211.9200000000033,30,22,82800.16,79588.24
22366,U31783,52,1842.089999999998,29,23,109444.22,111286.31
22367,U1160108,52,-9262.66,33,19,17136.000000000004,7873.340000000004
22368,U43719,52,714.810000000005,41,11,115331.37,116046.18
22369,U8789,52,-193.8999999999976,33,19,88332.16,88138.26000000001
22370,U14855,52,86092.79999999999,36,16,340309.44000000006,426402.24000000005
22371,U717078,52,-5358.419999999996,33,19,16201.639999999994,10843.219999999998
22372,U29254,52,20361.36,39,13,105876.77,126238.13
22373,U43090,52,52269.84000000002,35,17,265920.05000000005,318189.8900000001
22374,U17162,52,-50684.49,43,9,65795.15999999999,15110.669999999991
22375,U43177,52,6924.060000000007,44,8,58346.30999999999,65270.369999999995
22376,U40874,52,108030.20000000001,32,20,121744.7,229774.90000000002
22377,U9973,52,-14442.330000000009,39,13,670607.37,656165.04
22378,U41409,52,93832.81000000003,39,13,71291.90000000002,165124.71000000005
22379,U13690,52,-73966.85000000002,31,21,244304.88,170338.02999999997
22380,U12475,52,62632.71000000002,25,27,248120.24000000005,310752.95000000007
22381,U33379,52,-422.90999999999985,36,16,29401.45,28978.54
22382,U32992,52,-1638.4500000000003,41,11,17480.48,15842.029999999999
22383,U30447,52,-12622.960000000005,40,12,45993.17,33370.20999999999
22384,U33552,52,-26809.410000000003,41,11,93158.49,66349.08
22385,U27508,52,-13246.429999999978,38,14,141746.49,128500.06000000001
22386,U32303,52,-43338.69000000001,40,12,182903.72999999998,139565.03999999998
22387,U28937,52,2925.8600000000015,42,10,17563.4,20489.260000000002
22388,U9623,52,2551.5200000000004,26,26,25018.989999999998,27570.51
22389,U16270,52,-149845.27,42,10,353321.83,203476.56000000003
22390,U21145,52,3172.8499999999995,41,11,26653.489999999994,29826.339999999993
22391,U766198,52,-3009.94,38,14,15977.349999999999,12967.409999999998
22392,U9993,52,-12731.57,43,9,31661.869999999995,18930.299999999996
22393,U21384,52,260.27000000000277,44,8,40625.73,40886.00000000001
22394,U617350,52,15485.24,37,15,49626.859999999986,65112.099999999984
22395,U32382,52,-60.779999999998836,22,30,100815.6,100754.82
22396,U8447,52,19616.480000000003,38,14,108711.39000000001,128327.87000000002
22397,U17503,52,35523.810000000005,40,12,41512.799999999996,77036.61
22398,U39096,52,-8366.059999999996,46,6,35841.979999999996,27475.92
22399,U19977,52,1857.56,43,9,17690.8,19548.36
22400,U29498,52,1612.5400000000002,33,19,5097.610000000001,6710.150000000001
22401,U23399,52,72915.09,32,20,157441.54,230356.63
22402,U31992,52,-1781.449999999998,40,12,37512.87,35731.420000000006
22403,U976308,52,-46573.01,30,22,63095.57000000001,16522.560000000005
22404,U12832,52,1727.789999999998,42,10,22816.760000000002,24544.55
22405,U20735,52,4299.470000000004,40,12,88865.59000000003,93165.06000000003
22406,U13558,52,-25933.00000000001,31,21,554713.54,528780.54
22407,U20221,52,17733.86,36,16,117246.45999999999,134980.32
22408,U31948,52,4994.760000000002,39,13,71182.36,76177.12
22409,U39006,52,28155.039999999997,40,12,38382.579999999994,66537.62
22410,U33192,52,12013.41,45,7,13536.27,25549.68
22411,U25308,52,7707.719999999999,44,8,33045.19,40752.91
22412,U10238,52,-1971.8499999999995,47,5,17627.42,15655.57
22413,U33293,52,3756.8800000000006,37,15,24587.399999999994,28344.279999999995
22414,U37298,52,2439.919999999996,41,11,29832.120000000003,32272.039999999997
22415,U11555,52,29669.120000000003,43,9,58679.07000000001,88348.19
22416,U15785,52,-12018.580000000142,31,21,3061385.59,3049367.01
22417,U29842,52,-1946.4000000000015,41,11,61439.01,59492.61
22418,U18245,52,51257.77999999991,31,21,1623178.8,1674436.58
22419,U18127,52,9751.759999999995,42,10,315483.76,325235.52
22420,U36798,52,-5349.05000000001,32,20,256340.44,250991.38999999998
22421,U1341629,52,-206.34,33,19,9378.039999999997,9171.699999999997
22422,U34772,52,-133.77999999999986,31,21,26136.070000000003,26002.290000000005
22423,U30765,52,6449.83,41,11,4872.3,11322.130000000001
22424,U30132,52,1789.0200000000555,31,21,1105454.04,1107243.06
22425,U11206,52,41.670000000000186,44,8,6155.92,6197.59
22426,U21543,52,6798.679999999994,29,23,217443.31000000003,224241.99000000002
22427,U44045,52,-45801.389999999985,32,20,132407.8,86606.41
22428,U23402,52,-14777.049999999992,40,12,93105.03,78327.98000000001
22429,U39086,52,-4161.839999999999,42,10,6326.09,2164.250000000001
22430,U27065,52,21705.629999999983,24,28,254428.88,276134.51
22431,U10574,52,28507.71000000002,30,22,619375.89,647883.6000000001
22432,U13317,52,-14014.489999999998,39,13,66430.65,52416.159999999996
22433,U18664,52,-347260.22,26,26,3402308.0,3055047.7800000003
22434,U21001,52,510785.82999999996,44,8,506859.52,1017645.35
22435,U37043,52,-29608.25,7,45,195231.0,165622.75
22436,U27621,52,-4784.649999999996,46,6,18345.760000000002,13561.110000000006
22437,U16220,52,57896.21000000001,31,21,351325.24,409221.45
22438,U35491,52,-2121.6300000000006,44,8,13559.510000000002,11437.880000000001
22439,U40869,52,-116248.57999999999,24,28,253400.71,137152.13
22440,U21111,52,8132.14999999999,33,19,820856.0,828988.15
22441,U29217,52,-53393.530000000006,40,12,226053.02999999997,172659.49999999997
22442,U10636,52,16651.06,36,16,6808.02,23459.08
22443,U30953,52,-1573.0199999999627,33,19,1110186.79,1108613.77
22444,U32826,52,22568.139999999996,45,7,132476.15000000002,155044.29
22445,U23544,52,-1631.069999999996,44,8,41101.74,39470.67
22446,U22986,52,-301.5900000000038,34,18,101583.73,101282.13999999998
22447,U28816,52,7600.160000000005,29,23,45408.9,53009.060000000005
22448,U24601,52,-144613.55,33,19,237121.29,92507.74000000002
22449,U40079,52,607981.9999999999,40,12,254293.9,862275.8999999999
22450,U28136,52,-439789.74000000005,44,8,640122.35,200332.60999999993
22451,U29926,52,-11280.870000000003,28,24,316916.87,305636.0
22452,U10496,52,27.5,19,33,24945.370000000003,24972.870000000003
22453,U31709,52,-7.280000000001053,25,27,17556.77,17549.489999999998
22454,U34055,52,428.5200000000005,42,10,15360.960000000003,15789.480000000003
22455,U24051,52,-152773.4300000001,42,10,207456.9500000001,54683.51999999999
22456,U1334496,52,-3513.1799999999994,39,13,7343.63,3830.4500000000007
22457,U9581,52,-5827.639999999985,34,18,560313.26,554485.62
22458,U20158,52,437.68000000000046,49,3,3284.51,3722.1900000000005
22459,U41914,52,39766.02000000001,34,18,83559.63,123325.65000000002
22460,U29919,52,-58.64000000000715,21,31,1503125.7999999998,1503067.16
22461,U43045,52,18185.3,29,23,100711.95999999999,118897.26
22462,U20088,52,28099.65,36,16,146959.5,175059.15
22463,U31140,52,108323.22000000003,33,19,268117.05,376440.27
22464,U14571,52,80689.11,45,7,44098.510000000024,124787.62000000002
22465,U35548,52,-6433.950000000002,37,15,131091.88999999998,124657.93999999999
22466,U20555,52,-10119.430000000011,44,8,353564.67000000004,343445.24000000005
22467,U18513,52,6168.739999999998,46,6,28476.68,34645.42
22468,U985543,52,980.9900000000007,31,21,30149.009999999995,31129.999999999996
22469,U980584,52,-20186.12,48,4,31466.11999999999,11279.999999999993
22470,U18266,52,201015.44999999998,25,27,179561.16,380576.61
22471,U19804,52,11688.069999999994,40,12,338595.96,350284.03
22472,U12484,52,27097.259999999955,31,21,570532.1599999999,597629.4199999999
22473,U841037,52,-1631.4700000000003,31,21,42940.04999999999,41308.57999999999
22474,U9833,52,21.979999999999876,35,17,117461.64,117483.62
22475,U20882,52,14.20000000000266,36,16,40600.299999999996,40614.5
22476,U39904,52,9831.77,41,11,36559.32000000001,46391.09000000001
22477,U14227,52,-30907.930000000004,28,24,219528.25,188620.32
22478,U1077785,52,6.419999999999391,37,15,4802.1900000000005,4808.61
22479,U43241,52,-8357.549999999994,26,26,278249.5,269891.95
22480,U42316,52,10196.390000000007,24,28,127053.42999999998,137249.81999999998
22481,U38510,52,33.22000000000389,33,19,242312.15,242345.37
22482,U8183,52,-38985.15,44,8,134944.81999999998,95959.66999999998
22483,U17979,52,236.48999999999785,32,20,82944.33,83180.81999999999
22484,U34612,52,44950.91000000002,37,15,66543.32,111494.23000000003
22485,U10059,52,305.44000000000034,34,18,67857.21,68162.65000000001
22486,U31861,52,-2812.600000000004,46,6,24295.509999999995,21482.90999999999
22487,U31854,52,-2029.4599999999925,41,11,166368.5,164339.04
22488,U28494,52,-19182.83,37,15,235757.1,216574.27000000002
22489,U1321516,52,-767.6499999999996,36,16,6378.319999999999,5610.669999999999
22490,U32491,52,507.75,47,5,1710.5100000000004,2218.26
22491,U23565,52,-1477.100000000004,32,20,102493.75,101016.65
22492,U20859,52,2423.1000000000004,39,13,7587.67,10010.77
22493,U33701,52,-2082.6699999999946,45,7,16182.57,14099.900000000005
22494,U18189,52,1833.8900000000576,30,22,1585170.48,1587004.37
22495,U749628,52,-10861.770000000002,39,13,25777.199999999997,14915.429999999995
22496,U17488,52,22122.829999999998,38,14,105392.78,127515.61
22497,U36323,52,6816.48,49,3,2235.81,9052.289999999999
22498,U27013,52,103026.37000000002,27,25,633105.1400000001,736131.5100000001
22499,U43114,52,-45407.08000000084,33,19,9202193.200000003,9156786.120000003
22500,U39785,52,3877.969999999986,43,9,315405.74,319283.70999999996
22501,U637949,52,-24786.66,28,24,108049.87,83263.20999999999
22502,U37623,52,13775.720000000001,24,28,66982.36,80758.08
22503,U39227,52,2518.8900000000003,43,9,19861.979999999996,22380.869999999995
22504,U22618,52,-22818.059999999994,45,7,182211.71,159393.65
22505,U28911,52,-612.8,38,14,33006.909999999996,32394.109999999997
22506,U11186,52,29327.689999999995,26,26,192385.0,221712.69
22507,U31903,52,3331.5099999999875,32,20,212739.82,216071.33
22508,U19796,52,14709.93,40,12,19305.47,34015.4
22509,U41411,52,7036.299999999999,34,18,78765.61999999998,85801.91999999998
22510,U18581,52,-239.62000000000262,35,17,243514.31999999998,243274.69999999998
22511,U30986,52,-21275.880000000016,42,10,176975.86999999994,155699.98999999993
22512,U28626,52,-48922.61,44,8,61838.99,12916.379999999997
22513,U23735,52,-4627.970000000001,45,7,4944.560000000001,316.59000000000015
22514,U30649,52,13565.33,42,10,3395.64,16960.97
22515,U33237,52,588.0200000000007,35,17,10988.530000000002,11576.550000000003
22516,U17302,52,10742.07,35,17,62692.42,73434.48999999999
22517,U43427,52,31259.000000000007,32,20,557653.12,588912.12
22518,U22130,52,10062.67,44,8,23162.02,33224.69
22519,U37813,52,-1175.6100000000006,34,18,127219.43999999999,126043.82999999999
22520,U42528,52,40081.35000000003,40,12,257056.84999999998,297138.2
22521,U1242275,52,-22912.949999999997,39,13,48032.29,25119.340000000004
22522,U21932,52,-4200.110000000003,43,9,76246.17000000003,72046.06000000003
22523,U37432,52,15174.240000000005,32,20,35952.89000000001,51127.13000000001
22524,U31014,52,-141306.7799999999,31,21,731754.4400000001,590447.6600000001
22525,U42746,52,-8319.78,34,18,42000.68,33680.9
22526,U41275,52,5508.479999999937,32,20,661715.27,667223.75
22527,U35626,52,-296.50000000000006,50,2,396.95000000000005,100.44999999999999
22528,U12110,52,-592.4300000000003,44,8,46172.909999999996,45580.479999999996
22529,U28634,52,-16368.79999999999,37,15,127566.93000000001,111198.13000000002
22530,U27688,52,-567.9200000000055,32,20,241679.0,241111.08
22531,U25455,52,-10315.169999999998,31,21,113375.06,103059.89
22532,U24011,52,-5009.5899999999965,28,24,155148.9,150139.31
22533,U36746,52,-14629.73,34,18,63950.6,49320.869999999995
22534,U814575,51,500.71000000000004,36,15,2812.8100000000004,3313.5200000000004
22535,U25059,51,3114.749999999999,43,8,2055.6800000000007,5170.43
22536,U29519,51,-23252.760000000428,37,14,1489173.9,1465921.1399999994
22537,U44062,51,82042.45000000001,36,15,54637.49999999999,136679.95
22538,U43905,51,-2819.2299999999977,43,8,33980.14,31160.910000000003
22539,U30598,51,13508.589999999967,36,15,1412179.56,1425688.15
22540,U40774,51,853.6200000000345,34,17,662848.13,663701.75
22541,U11821,51,-26411.79999999999,34,17,103491.65,77079.85
22542,U21218,51,150.98999999999955,31,20,41071.01000000001,41222.00000000001
22543,U27188,51,-1176.2899999999993,38,13,1360894.5500000003,1359718.2600000002
22544,U40138,51,36022.83,45,6,45818.69,81841.52
22545,U28910,51,-4000.8200000000033,38,13,58180.92000000002,54180.10000000002
22546,U18701,51,-1044.2800000000025,36,15,32023.809999999998,30979.529999999995
22547,U16718,51,-2359.9899999999893,36,15,200270.61999999997,197910.62999999998
22548,U42034,51,15175.090000000007,39,12,137286.12000000002,152461.21000000002
22549,U14523,51,17746.28,22,29,557482.1900000001,575228.4700000001
22550,U27341,51,40654.78000000003,26,25,331986.7,372641.48000000004
22551,U17425,51,-39872.95,33,18,239147.35,199274.40000000002
22552,U9660,51,271.3900000000067,35,16,123866.84,124138.23000000001
22553,U24666,51,-27845.369999999988,27,24,309759.42000000004,281914.05000000005
22554,U39616,51,-4759.749999999997,44,7,45944.170000000006,41184.420000000006
22555,U18076,51,14843.189999999997,43,8,12249.429999999998,27092.619999999995
22556,U26017,51,4290.649999999996,19,32,244303.29,248593.94
22557,U43978,51,-1425351.5099999998,40,11,1628826.3099999996,203474.7999999998
22558,U9696,51,-4960.280000000001,35,16,17686.64,12726.359999999999
22559,U21062,51,-16471.949999999997,30,21,345040.1400000001,328568.19000000006
22560,U28130,51,-956.7299999999996,42,9,30095.61,29138.88
22561,U17927,51,70020.64,40,11,12806.609999999999,82827.25
22562,U13047,51,-21733.250000000015,36,15,948142.54,926409.29
22563,U11450,51,-4147.969999999977,26,25,1100312.06,1096164.09
22564,U37915,51,15814.349999999995,25,26,317396.27,333210.62
22565,U36347,51,134386.43,34,17,46941.14,181327.57
22566,U1136655,51,1718.8200000000008,40,11,2831.4099999999994,4550.2300000000005
22567,U1349089,51,502.85000000000196,33,18,10764.109999999999,11266.960000000001
22568,U39741,51,-214182.94999999995,38,13,310853.30999999994,96670.35999999999
22569,U17783,51,227242.74,38,13,51536.869999999995,278779.61
22570,U917239,51,3177.1299999999997,32,19,5767.040000000001,8944.17
22571,U38159,51,28473.66999999999,44,7,45058.74999999999,73532.41999999998
22572,U32413,51,643.2700000000002,46,5,165.52999999999992,808.8000000000002
22573,U11455,51,-1404.940000000001,38,13,80287.10999999999,78882.16999999998
22574,U13695,51,2108089.4100000006,42,9,1204877.3899999997,3312966.8000000003
22575,U14513,51,79561.97000000002,21,30,504097.0,583658.97
22576,U23027,51,-344.7299999999962,35,16,56664.1,56319.37
22577,U11806,51,21389.059999999998,44,7,29537.5,50926.56
22578,U604228,51,1877.24,30,21,7320.33,9197.57
22579,U17279,51,32725.549999999996,34,17,37539.85000000001,70265.40000000001
22580,U14051,51,19966.780000000006,32,19,123887.44000000002,143854.22000000003
22581,U29065,51,-51474.78,46,5,131803.3,80328.51999999999
22582,U10710,51,-630407.2999999999,41,10,664233.77,33826.47000000009
22583,U14907,51,-28066.820000000007,41,10,134583.81999999995,106516.99999999994
22584,U42543,51,-34521.729999999996,42,9,37626.67,3104.9400000000023
22585,U18396,51,-2602.259999999951,28,23,624462.0,621859.74
22586,U36633,51,23390.600000000002,40,11,67048.56,90439.16
22587,U28964,51,16336.670000000004,34,17,145019.44000000003,161356.11000000004
22588,U23186,51,-6021.76,35,16,28883.07,22861.309999999998
22589,U14889,51,8622.920000000006,37,14,276852.93,285475.85
22590,U15830,51,44168.51000000001,35,16,157740.95,201909.46000000002
22591,U32093,51,-6603.78,43,8,20210.32,13606.54
22592,U10770,51,1271.5299999999995,41,10,4017.5800000000004,5289.11
22593,U16151,51,81599.4,30,21,524172.42,605771.82
22594,U30196,51,-47297.770000000004,31,20,123550.02,76252.25
22595,U42403,51,3606.5199999999986,44,7,40464.74000000001,44071.26000000001
22596,U42933,51,-18234.59,34,17,172981.16000000003,154746.57000000004
22597,U10997,51,-14845.279999999999,39,12,57916.71000000001,43071.43000000001
22598,U29511,51,11391.630000000008,40,11,183378.65,194770.28
22599,U29008,51,50430.18000000001,38,13,63157.61,113587.79000000001
22600,U22600,51,-58827.57000000003,42,9,384522.54000000004,325694.97000000003
22601,U34931,51,27945.320000000007,32,19,351109.49,379054.81
22602,U11825,51,1964.8700000000003,47,4,9077.55,11042.42
22603,U33649,51,-3286.1699999999964,37,14,57457.66999999999,54171.49999999999
22604,U25510,51,-3782.169999999999,43,8,24386.019999999997,20603.85
22605,U17964,51,24598.18,47,4,36823.32000000001,61421.50000000001
22606,U40842,51,-7577.919999999995,34,17,156616.3,149038.38
22607,U29482,51,5845.300000000004,39,12,29878.5,35723.8
22608,U29172,51,-3596.489999999999,42,9,11686.929999999998,8090.44
22609,U41357,51,498.3399999999965,32,19,152371.69,152870.03
22610,U8898,51,30813.699999999997,36,15,90007.94,120821.64
22611,U899695,51,1503.6300000000006,26,25,11845.369999999999,13349.0
22612,U1183526,51,-9505.34,38,13,38755.28999999999,29249.949999999993
22613,U33300,51,504.0199999999968,36,15,106023.4,106527.41999999998
22614,U12313,51,19477.330000000016,22,29,255168.53,274645.86
22615,U35530,51,1121607.4900000002,21,30,5107771.3100000005,6229378.800000001
22616,U31073,51,900.6099999999997,25,26,36309.0,37209.61
22617,U33793,51,-103681.92,43,8,243695.46000000002,140013.54000000004
22618,U33044,51,-19151.779999999995,45,6,58242.22,39090.44
22619,U18838,51,33926.840000000004,44,7,67408.92,101335.76000000001
22620,U18948,51,-1023.7299999999977,47,4,38125.48,37101.75000000001
22621,U38519,51,-180.97000000000014,42,9,1540.58,1359.6099999999997
22622,U33433,51,-369298.43,50,1,369716.11,417.679999999993
22623,U1245209,51,-994.9200000000002,32,19,28773.73,27778.809999999998
22624,U38557,51,-699.5100000000016,44,7,16801.84,16102.329999999998
22625,U15421,51,345.0800000000003,33,18,24142.05,24487.13
22626,U10681,51,178132.86999999988,23,28,151914.64000000004,330047.5099999999
22627,U14959,51,-10.200000000000728,32,19,45391.950000000004,45381.75
22628,U42372,51,863.7999999999996,38,13,6640.9000000000015,7504.700000000001
22629,U38278,51,42932.719999999994,27,24,102033.12000000001,144965.84
22630,U29017,51,6286.5300000000025,35,16,247448.53999999998,253735.06999999998
22631,U42736,51,21054.74,43,8,21661.95,42716.69
22632,U20826,51,17541.930000000037,26,25,349685.51,367227.44000000006
22633,U17692,51,24816.809999999998,33,18,48213.0,73029.81
22634,U35409,51,-10118.699999999999,38,13,39817.06,29698.36
22635,U21140,51,6065.050000000001,48,3,5876.49,11941.54
22636,U12167,51,-2173.4300000000003,37,14,20558.41,18384.98
22637,U25202,51,66029.71999999999,21,30,194629.48,260659.2
22638,U1267561,51,-1781.4199999999996,32,19,40964.96,39183.54
22639,U42221,51,-116127.59999999999,19,32,1208239.2000000002,1092111.6
22640,U40983,51,20034.090000000004,34,17,98961.7,118995.79000000001
22641,U31309,51,6693.999999999994,27,24,91047.15000000001,97741.15000000001
22642,U14766,51,845.0599999999977,46,5,55682.61,56527.67
22643,U35328,51,5192.8300000000045,30,21,47565.920000000006,52758.75000000001
22644,U36225,51,13336.270000000019,35,16,283837.49999999994,297173.76999999996
22645,U29371,51,2723.0000000000305,26,25,1683534.58,1686257.58
22646,U11667,51,29883.7,28,23,102357.73000000001,132241.43000000002
22647,U18447,51,10338.650000000001,32,19,226186.76,236525.41
22648,U35552,51,-76853.46999999999,32,19,386530.94999999995,309677.48
22649,U983013,51,-13586.68,46,5,20826.94,7240.259999999998
22650,U41364,51,-49835.80000000002,30,21,405778.5,355942.69999999995
22651,U25252,51,-30339.999999999993,39,12,413324.89,382984.89
22652,U40505,51,-221678.92000000004,38,13,567228.8700000001,345549.95000000007
22653,U42555,51,14283.930000000015,29,22,746909.8,761193.7300000001
22654,U43077,51,-4864.250000000004,38,13,110004.60999999999,105140.35999999999
22655,U22482,51,23735.399999999994,46,5,26692.690000000002,50428.09
22656,U27354,51,-0.18000000005122274,18,33,2899926.27,2899926.09
22657,U39260,51,-26763.030000000006,36,15,237291.81999999998,210528.78999999998
22658,U34726,51,-4667.179999999999,42,9,19459.260000000002,14792.080000000002
22659,U29437,51,-486046.28,37,14,539146.99,53100.70999999996
22660,U17329,51,21180.829999999976,35,16,212415.2,233596.03
22661,U26505,51,239.48999999999796,24,27,335829.0,336068.49
22662,U32625,51,537.0999999999976,38,13,156670.94,157208.04
22663,U28599,51,9456.59,35,16,33663.770000000004,43120.36
22664,U989728,51,-203.68000000000004,31,20,117843.37999999999,117639.7
22665,U741131,51,21405.460000000006,17,34,12251.33,33656.79000000001
22666,U20193,51,-2595.170000000001,47,4,6070.020000000002,3474.8500000000013
22667,U22845,51,1322052.0399999998,34,17,223880.76,1545932.7999999998
22668,U14671,51,273913.0,23,28,1499938.0,1773851.0
22669,U8715,51,47930.85,38,13,83123.44000000002,131054.29000000001
22670,U36703,51,8152.219999999999,41,10,91329.40000000001,99481.62000000001
22671,U23282,51,-921.6799999999992,35,16,36526.54,35604.86
22672,U22962,51,704.3199999999651,29,22,239186.71,239891.02999999997
22673,U15619,51,16392.759999999937,43,8,186666.79,203059.54999999993
22674,U38528,51,-6870.16,37,14,25154.479999999996,18284.319999999996
22675,U13090,51,-3167.1100000000415,37,14,871309.71,868142.6
22676,U27365,51,-4524.370000000002,47,4,10765.35,6240.979999999999
22677,U34854,51,-3733.4999999999995,49,2,4016.5299999999997,283.0300000000002
22678,U9189,51,381.43000000000075,33,18,26075.52,26456.95
22679,U12442,51,7318.259999999998,37,14,42356.09,49674.34999999999
22680,U22388,51,-3212.600000000012,30,21,461195.46,457982.86
22681,U35500,51,3147.350000000006,21,30,572393.26,575540.61
22682,U42094,51,-112599.11999999998,33,18,454070.35,341471.23
22683,U15693,51,156216.61,25,26,20624.73,176841.34
22684,U9978,51,5478.470000000003,45,6,17906.209999999995,23384.68
22685,U24106,51,25.26000000000009,44,7,9876.0,9901.26
22686,U1069002,51,-8.869999999999948,38,13,2836.21,2827.34
22687,U35157,51,246.87000000000003,49,2,1459.3,1706.17
22688,U42558,51,-138523.24000000005,46,5,242623.33000000005,104100.09
22689,U28092,51,123517.58000000005,20,31,719557.44,843075.02
22690,U32350,51,2153.469999999999,44,7,24648.420000000002,26801.89
22691,U42554,51,1405.999999999999,36,15,53106.799999999996,54512.799999999996
22692,U16065,51,5723.669999999998,33,18,46992.52999999999,52716.19999999999
22693,U31342,51,4372.0400000000045,32,19,119119.37999999999,123491.42
22694,U26972,51,1453.61,42,9,333803.0,335256.61
22695,U40115,51,3195.2599999999948,43,8,107808.22999999998,111003.48999999998
22696,U29753,51,-3182.3699999999963,43,8,22397.350000000002,19214.980000000007
22697,U709440,51,51.24000000000002,33,18,1524.64,1575.88
22698,U35086,51,-8595.800000000001,44,7,116091.98,107496.18
22699,U18599,51,42514.33,33,18,370915.04000000004,413429.37000000005
22700,U18450,51,105769.04,36,15,93727.53,199496.57
22701,U17427,51,2621705.1800000006,27,24,9646408.45,12268113.629999999
22702,U34021,51,-36782.39,37,14,72773.0,35990.61
22703,U1249214,51,7871.600000000001,31,20,14876.119999999997,22747.719999999998
22704,U24352,51,-6034.330000000003,37,14,52540.53,46506.2
22705,U43198,51,-157011.84,39,12,198171.02999999997,41159.18999999997
22706,U35264,51,3654.2999999999993,35,16,25612.8,29267.1
22707,U1347470,51,-70.27999999999997,42,9,5324.639999999999,5254.36
22708,U10236,51,-1636.9700000000012,42,9,43901.810000000005,42264.840000000004
22709,U13105,51,-56529.90999999994,38,13,1429821.7,1373291.79
22710,U40833,51,4392.560000000001,42,9,22559.549999999996,26952.109999999997
22711,U36314,51,603.8900000000062,30,21,53591.219999999994,54195.11
22712,U26891,51,-1560.3699999999953,36,15,141071.89,139511.52000000002
22713,U42765,51,-6034.7800000000025,41,10,51835.21000000001,45800.43000000001
22714,U1359897,51,-5056.000000000001,29,22,25568.4,20512.4
22715,U15554,51,-12647.7,46,5,21376.609999999997,8728.909999999996
22716,U17583,51,-61525.91,39,12,160507.12999999995,98981.21999999994
22717,U8168,51,-2856.7900000000004,38,13,68492.21,65635.42000000001
22718,U10092,51,1166.8000000000009,26,25,112944.15000000001,114110.95000000001
22719,U35722,51,-24235.70999999992,32,19,3486749.0300000003,3462513.3200000003
22720,U33747,51,24610.41000000001,39,12,134929.94,159540.35
22721,U8667,51,12.810000000000228,44,7,1380.36,1393.17
22722,U37586,51,2847.3700000000013,36,15,33812.630000000005,36660.00000000001
22723,U680261,51,151.49999999999946,36,15,7614.729999999999,7766.229999999998
22724,U23575,51,-7795.500000000018,29,22,302410.18,294614.68
22725,U13275,51,-94864.35999999999,37,14,213199.41999999998,118335.06
22726,U8359,51,17500.76,42,9,14689.779999999999,32190.539999999997
22727,U9090,51,-101.38000000000011,44,7,4805.4400000000005,4704.06
22728,U8783,51,-979.5700000000016,38,13,98227.78,97248.20999999999
22729,U27076,51,-4927.070000000005,38,13,47012.880000000005,42085.81
22730,U21497,51,-2590.669999999999,35,16,66314.71999999999,63724.04999999999
22731,U17058,51,-18396.52999999999,42,9,237898.16,219501.63
22732,U18359,51,24755.89,36,15,12693.410000000005,37449.3
22733,U969121,51,99.62999999999874,35,16,29894.600000000002,29994.23
22734,U19376,51,-283.8600000000002,41,10,5784.340000000001,5500.4800000000005
22735,U1098347,51,-1.1368683772161603e-13,30,21,9146.1,9146.1
22736,U31492,51,-931.2000000000007,41,10,20037.989999999998,19106.789999999997
22737,U40490,51,7942.699999999997,46,5,30807.61,38750.31
22738,U615102,51,-17742.189999999995,43,8,20728.479999999996,2986.290000000001
22739,U10332,51,6066.639999999999,43,8,11337.59,17404.23
22740,U38116,51,-277.98999999999614,29,22,115339.34,115061.35
22741,U8857,51,-15858.279999999997,46,5,17181.329999999998,1323.050000000001
22742,U16564,51,23430.190000000002,36,15,118147.88,141578.07
22743,U13331,51,11150.96,29,22,14175.91,25326.87
22744,U22782,51,-391163.6,39,12,544242.56,153078.96000000008
22745,U42180,51,-61.68999999999869,37,14,75282.90999999997,75221.21999999997
22746,U23339,51,1608.029999999997,36,15,70191.88,71799.91
22747,U23746,50,1047.2000000000025,29,21,115805.87999999999,116853.07999999999
22748,U39693,50,4082.2800000000025,37,13,45273.83,49356.11
22749,U20470,50,-31417.650000000016,34,16,261083.53999999998,229665.88999999996
22750,U33734,50,-24203.35,37,13,111371.10999999999,87167.75999999998
22751,U19781,50,-7622.370000000001,28,22,61508.56,53886.189999999995
22752,U11595,50,25003.20000000004,26,24,953800.86,978804.06
22753,U41266,50,-32873.44000000002,44,6,68382.45000000001,35509.009999999995
22754,U1047396,50,-78.97999999999976,39,11,8632.0,8553.02
22755,U17976,50,1053.6699999999983,32,18,160056.5,161110.16999999998
22756,U19006,50,-6131.770000000008,34,16,83155.98000000001,77024.21
22757,U35304,50,-183.7099999999998,36,14,7494.37,7310.66
22758,U17600,50,-6717.750000000013,25,25,451736.13,445018.38
22759,U19346,50,1231.630000000001,39,11,18604.079999999998,19835.71
22760,U944830,50,1.0199999999990903,27,23,21340.03,21341.05
22761,U24204,50,12068.28,41,9,122521.98,134590.26
22762,U965234,50,89.89999999999998,3,47,1000.9200000000001,1090.8200000000002
22763,U14538,50,-5498.830000000008,33,17,112610.89,107112.06
22764,U15212,50,56932.69000000012,32,18,2878541.9699999997,2935474.6599999997
22765,U29805,50,-30789.010000000002,40,10,145144.74000000002,114355.73000000001
22766,U13698,50,-37084.49000000012,25,25,4316220.04,4279135.55
22767,U30702,50,-4865.339999999999,39,11,63983.479999999996,59118.14
22768,U29324,50,-8929.439999999999,45,5,26838.370000000003,17908.930000000004
22769,U31555,50,365.2800000000014,44,6,6515.120000000001,6880.400000000002
22770,U24085,50,18997.82000000004,31,19,581849.58,600847.4
22771,U35076,50,-10000.579999999996,23,27,133813.2,123812.62000000001
22772,U34039,50,-7522.49,32,18,129429.45999999999,121906.96999999999
22773,U31684,50,-91135.68999999997,39,11,322769.21,231633.52000000005
22774,U24958,50,-603.21,34,16,12126.34,11523.130000000001
22775,U37771,50,29609.499999999996,24,26,45163.71,74773.20999999999
22776,U25905,50,29086.780000000013,34,16,127190.06,156276.84000000003
22777,U39549,50,27725.820000000003,30,20,29995.53,57721.350000000006
22778,U24677,50,-71923.19999999998,39,11,99332.05,27408.85000000002
22779,U23498,50,117.89999999999964,32,18,34933.56,35051.46
22780,U35856,50,52111.58,41,9,9518.5,61630.08
22781,U17902,50,-3503.4,40,10,10618.189999999999,7114.789999999999
22782,U16878,50,6762.0199999999895,28,22,1172042.0,1178804.02
22783,U44012,50,-47140.83999999999,35,15,159805.78,112664.94
22784,U16337,50,1081362.19,28,22,1383387.66,2464749.8499999996
22785,U20228,50,18687.609999999997,29,21,36430.76,55118.369999999995
22786,U41243,50,150974.91000000003,26,24,693126.06,844100.9700000001
22787,U35997,50,13088.469999999992,26,24,306187.76000000007,319276.23000000004
22788,U23938,50,2500.5400000000004,39,11,54180.090000000026,56680.63000000003
22789,U38329,50,170193.14,24,26,134401.24,304594.38
22790,U33211,50,-39909.94000000001,42,8,74679.85,34769.909999999996
22791,U35031,50,-33459.009999999995,31,19,134886.18,101427.17
22792,U17276,50,-18253.630000000012,41,9,144562.24,126308.60999999999
22793,U40593,50,-28749.690000000002,43,7,45320.130000000005,16570.440000000002
22794,U37486,50,362.52999999998184,33,17,609121.8,609484.3300000001
22795,U17747,50,6927.889999999996,32,18,48162.0,55089.89
22796,U27577,50,-4331.8099999999995,45,5,12616.81,8285.0
22797,U19170,50,-13018.920000000007,44,6,126119.15999999999,113100.23999999998
22798,U18619,50,-10514.890000000007,29,21,328086.13,317571.24
22799,U27567,50,36135.04,28,22,271250.7700000001,307385.81000000006
22800,U35329,50,-53972.35999999999,42,8,191668.56,137696.2
22801,U26655,50,4323.830000000002,42,8,28053.9,32377.730000000003
22802,U38784,50,-6045.850000000013,41,9,150128.84,144082.99
22803,U34034,50,-3252.330000000001,31,19,136387.68,133135.35
22804,U17947,50,327.46,39,11,30812.940000000002,31140.4
22805,U22939,50,10080.189999999997,35,15,83850.53,93930.72
22806,U27529,50,-1327.279999999992,42,8,37013.340000000004,35686.06000000001
22807,U1354766,50,-9.094947017729282e-13,26,24,40453.36,40453.36
22808,U38561,50,92.80000000000291,29,21,57803.61,57896.41
22809,U707368,50,682.4099999999999,28,22,27365.63,28048.04
22810,U20326,50,648.5600000000013,30,20,85107.97,85756.53
22811,U34893,50,-9341.149999999998,42,8,21280.839999999997,11939.689999999999
22812,U37888,50,-62756.789999999986,35,15,250277.12000000002,187520.33000000005
22813,U10700,50,-195.9399999999987,41,9,20980.32,20784.38
22814,U32473,50,6210.650000000001,14,36,31969.0,38179.65
22815,U643571,50,0.0,27,23,10331.46,10331.46
22816,U22018,50,2576.1100000000006,42,8,9721.650000000001,12297.760000000002
22817,U22812,50,-140211.67,46,4,208156.04000000004,67944.37000000002
22818,U30508,50,-43585.19000000001,39,11,64912.240000000005,21327.049999999996
22819,U974087,50,-150.17999999999847,25,25,42903.03,42752.85
22820,U18162,50,2943.0999999999967,42,8,90048.91,92992.01
22821,U29000,50,-9546.149999999998,44,6,45894.19,36348.04000000001
22822,U15407,50,-3249.2000000000075,31,19,289794.80999999994,286545.6099999999
22823,U35774,50,-40082.43,32,18,447505.00999999995,407422.57999999996
22824,U37178,50,-927.9900000000002,45,5,4768.450000000002,3840.4600000000014
22825,U27616,50,-33592.84,44,6,111613.92,78021.08
22826,U19864,50,14.789999999999964,43,7,19124.5,19139.29
22827,U35143,50,-10392.13,30,20,162257.4,151865.27
22828,U23067,50,-88964.41,40,10,450114.29,361149.88
22829,U43771,50,-4894.32,35,15,39953.22,35058.9
22830,U9301,50,12346.419999999925,25,25,7753416.78,7765763.2
22831,U21052,50,-212890.88999999996,32,18,615065.26,402174.37000000005
22832,U26569,50,-16932.91,38,12,70429.98000000003,53497.07000000002
22833,U27331,50,-15472.420000000002,23,27,330941.56,315469.14
22834,U30786,50,870.0000000000009,42,8,14582.080000000004,15452.080000000005
22835,U25669,50,-1723.96,38,12,97557.68000000001,95833.72
22836,U28683,50,58.620000000009895,28,22,227984.0,228042.62
22837,U18534,50,18242.43,44,6,5367.640000000001,23610.07
22838,U34338,50,-114450.09000000003,40,10,586429.6499999999,471979.5599999999
22839,U1205627,50,-3180.69,32,18,21198.590000000004,18017.900000000005
22840,U42069,50,-1320.3199999999997,38,12,36775.350000000006,35455.030000000006
22841,U36732,50,-418.61000000000007,37,13,9085.46,8666.849999999999
22842,U41169,50,-199.98999999999978,25,25,29420.699999999997,29220.71
22843,U12041,50,-73584.98999999999,24,26,896179.8599999999,822594.8699999999
22844,U706797,50,-1328.490000000001,33,17,11747.98,10419.489999999998
22845,U27029,50,1123.8300000000006,42,8,4294.17,5418.000000000001
22846,U30906,50,-385690.62999999995,28,22,958584.41,572893.78
22847,U14479,50,-432.67999999998256,24,26,1575211.25,1574778.57
22848,U18454,50,13463.950000000003,35,15,83473.69999999998,96937.64999999998
22849,U25730,50,-200.00000000000185,41,9,24616.039999999983,24416.03999999998
22850,U32203,50,20829.009999999973,28,22,635932.79,656761.8
22851,U30412,50,-3708.8299999999995,46,4,7594.700000000001,3885.8700000000013
22852,U33279,50,22379.329999999987,30,20,654816.46,677195.7899999999
22853,U33303,50,12027.040000000034,22,28,395843.3,407870.34
22854,U1166853,50,4000.010000000002,28,22,61760.96,65760.97
22855,U38378,50,-3497.7799999999434,16,34,1133137.99,1129640.21
22856,U43111,50,50.07000000000153,28,22,98290.0,98340.07
22857,U26464,50,7892.849999999977,33,17,137346.51,145239.36
22858,U42038,50,-6224.969999999999,27,23,45259.979999999996,39035.009999999995
22859,U43280,50,-28276.230000000338,33,17,3543207.6399999997,3514931.409999999
22860,U13874,50,21806.539999999994,28,22,399164.61,420971.14999999997
22861,U32718,50,-646.0800000000017,40,10,41525.83,40879.75
22862,U30600,50,213.38999999999592,22,28,712691.9199999999,712905.3099999999
22863,U36843,50,-179.59000000000015,33,17,20547.45,20367.86
22864,U39309,50,480.39000000000067,42,8,8406.119999999999,8886.51
22865,U26658,50,38540.41,35,15,686580.02,725120.43
22866,U40305,50,14332.090000000011,36,14,109694.34999999999,124026.44
22867,U25246,50,41.86000000000422,23,27,321515.45999999996,321557.31999999995
22868,U14323,50,-518.7700000000186,18,32,844457.48,843938.71
22869,U1275303,50,3806.9500000000044,30,20,140403.92,144210.87000000002
22870,U41407,50,6011.749999999996,26,24,150979.85,156991.6
22871,U23147,50,167551.12000000002,35,15,390842.79000000004,558393.91
22872,U39917,50,6283.759999999995,44,6,78714.32,84998.08
22873,U36830,50,426.68000000000063,39,11,20997.199999999997,21423.879999999997
22874,U27294,50,-21513.949999999986,37,13,423358.74999999994,401844.79999999993
22875,U21579,50,-603.409999999999,39,11,38411.36,37807.950000000004
22876,U14871,50,-249.99999999999966,43,7,12195.570000000005,11945.570000000005
22877,U32441,50,-6091.770000000012,31,19,234780.5,228688.72999999998
22878,U25542,50,-33.95000000000291,32,18,214030.51,213996.56
22879,U43102,50,884.6200000000017,38,12,92084.84,92969.45999999999
22880,U39321,50,9097.27,32,18,37023.119999999995,46120.39
22881,U38295,50,2378.94,32,18,77552.98999999999,79931.93
22882,U43928,50,1592.1100000004144,9,41,1341495.59,1343087.7000000004
22883,U25691,50,16873.739999999994,44,6,43114.39,59988.12999999999
22884,U779290,50,-6935.260000000006,34,16,59251.450000000004,52316.19
22885,U18307,50,1980.8900000000035,39,11,13964.420000000002,15945.310000000005
22886,U29174,50,1052.5099999999998,35,15,10297.890000000001,11350.400000000001
22887,U22841,50,-13585.579999999996,44,6,81977.78999999998,68392.20999999998
22888,U18220,50,482.1900000000007,38,12,48374.590000000004,48856.780000000006
22889,U27556,50,-5982.03,49,1,6581.520000000001,599.4900000000016
22890,U34456,50,352.62000000000074,33,17,57827.82000000001,58180.44000000001
22891,U15706,50,-156332.6000000001,32,18,919489.28,763156.6799999999
22892,U43139,50,2552.4900000000016,33,17,81741.68000000001,84294.17000000001
22893,U17613,50,-66258.98999999999,32,18,89933.07,23674.080000000016
22894,U24041,50,-561.349999999984,30,20,685548.9700000001,684987.6200000001
22895,U22728,50,-1182.99,37,13,29752.589999999997,28569.599999999995
22896,U8214,50,-59138.960000000014,38,12,119889.77000000002,60750.810000000005
22897,U31228,50,6566.950000000002,36,14,48853.97,55420.920000000006
22898,U31526,50,-71743.28999999998,42,8,107033.84999999999,35290.56000000001
22899,U13017,50,-22716.54,35,15,147883.03999999998,125166.49999999997
22900,U29403,50,4061.140000000003,40,10,103226.59,107287.73
22901,U23412,50,80813.72999999997,39,11,311471.78999999986,392285.51999999984
22902,U17779,50,-3440.310000000044,29,21,754862.52,751422.21
22903,U40724,50,261471.62999999998,33,17,381702.58,643174.21
22904,U23930,50,90848.55,31,19,30789.08,121637.63
22905,U23696,50,-13970.239999999994,24,26,74944.07,60973.830000000016
22906,U35375,50,198.48999999999796,44,6,20320.7,20519.19
22907,U12666,50,-20120.799999999996,32,18,81372.51,61251.71
22908,U36663,50,11217.900000000001,34,16,43236.64000000001,54454.54000000001
22909,U9626,50,240557.77999999994,28,22,527549.89,768107.6699999999
22910,U12575,50,-14376.830000000002,38,12,112393.49,98016.66
22911,U1341379,50,-7.379999999999967,27,23,12228.5,12221.12
22912,U960287,50,4.200000000000728,32,18,63175.17,63179.369999999995
22913,U32149,50,1472.2099999999698,41,9,514785.68,516257.88999999996
22914,U29752,50,3938.920000000001,39,11,41430.30000000001,45369.22000000001
22915,U15637,50,-32707.29000000003,30,20,868401.29,835694.0
22916,U29145,50,-4435.860000000001,41,9,25712.94,21277.079999999998
22917,U972904,50,-236.72000000000088,35,15,9423.83,9187.109999999999
22918,U8522,50,13280.54,32,18,28299.0,41579.54
22919,U38735,50,-3729.5699999999997,37,13,156128.74,152399.16999999998
22920,U42569,50,-63656.17,39,11,163756.47,100100.3
22921,U30826,50,-190838.17,27,23,621958.82,431120.6499999999
22922,U31365,50,4895.330000000004,36,14,79124.68000000002,84020.01000000002
22923,U33145,50,79988.09000000001,40,10,15885.880000000001,95873.97000000002
22924,U14630,50,42390.53999999998,22,28,598209.87,640600.4099999999
22925,U15589,50,-7549.309999999999,38,12,45071.090000000004,37521.780000000006
22926,U18011,50,6441.639999999992,17,33,79103.5,85545.13999999998
22927,U17862,50,89.7500000000003,27,23,82408.40000000001,82498.15000000001
22928,U13171,50,-133214.80999999997,36,14,294567.72,161352.91
22929,U43043,50,33215.630000000005,32,18,135363.0,168578.63
22930,U12927,50,-237.79999999999973,32,18,17197.48,16959.68
22931,U1338508,50,73.28,29,21,636.38,709.66
22932,U36193,50,-350.52000000000044,42,8,6939.32,6588.799999999999
22933,U40081,50,-29190.64999999999,35,15,167612.48,138421.83000000002
22934,U37189,50,-88809.39,33,17,983069.5900000001,894260.2000000001
22935,U17113,50,455624.27999999997,28,22,458463.2100000002,914087.4900000002
22936,U32758,50,-6702.07,41,9,49281.69,42579.62
22937,U41533,50,-2405.53,38,12,53530.03999999999,51124.509999999995
22938,U32531,50,8511.400000000003,37,13,8230.12,16741.520000000004
22939,U23385,50,-3448.69,49,1,3456.9,8.210000000000036
22940,U36411,50,0.02999999992607627,26,24,1414107.38,1414107.41
22941,U9006,50,2670321.5500000007,38,12,5255.439999999999,2675576.9900000007
22942,U13672,50,4107.539999999963,23,27,2354551.0,2358658.54
22943,U42041,50,8.140000000000327,31,19,68412.29999999999,68420.43999999999
22944,U10760,50,11599.89,41,9,134967.78,146567.66999999998
22945,U23290,50,-674.0900000000003,44,6,25913.210000000006,25239.120000000006
22946,U40861,50,-1759.5300000000116,24,26,109206.54000000001,107447.01
22947,U35020,50,1.8189894035458565e-12,27,23,30383.1,30383.1
22948,U40838,50,-17628.950000000004,28,22,284184.91000000003,266555.96
22949,U9802,50,-3219.8700000000085,35,15,258009.88,254790.01
22950,U26452,50,10877.909999999998,39,11,140370.98,151248.89
22951,U28786,50,61764.65000000002,38,12,177489.57,239254.22000000003
22952,U23219,50,-149183.75999999998,38,12,163930.97999999998,14747.220000000001
22953,U42291,50,6232.219999999999,43,7,9218.359999999999,15450.579999999998
22954,U36226,50,200747.61,37,13,30198.049999999996,230945.65999999997
22955,U13943,50,-9574.770000000002,39,11,119386.77,109812.0
22956,U10105,50,-16096.080000000002,31,19,68965.07999999999,52868.999999999985
22957,U16013,50,26991.889999999985,28,22,227827.44999999998,254819.33999999997
22958,U25194,50,34409.170000000006,40,10,39875.24999999999,74284.42
22959,U16212,50,3289.8299999999995,40,10,13243.050000000001,16532.88
22960,U1140176,50,1100.71,30,20,10365.900000000001,11466.61
22961,U35286,50,10159.350000000042,21,29,1953453.77,1963613.12
22962,U11472,50,-3605.420000000042,31,19,1553160.7,1549555.2799999998
22963,U28874,50,5868.2699999999495,35,15,438032.68,443900.94999999995
22964,U42628,50,-10818.789999999999,41,9,27008.770000000004,16189.980000000005
22965,U29331,50,-1487.329999999998,23,27,689173.4800000001,687686.1500000001
22966,U29188,50,-6831.579999999996,25,25,124736.53,117904.95
22967,U13084,50,-2462.6100000000024,36,14,48011.799999999996,45549.189999999995
22968,U35205,50,895919.7599999999,35,15,1211683.5599999998,2107603.32
22969,U34823,50,-4024.29,36,14,35569.71,31545.42
22970,U20993,50,-745.1700000005203,28,22,7040911.859999999,7040166.689999999
22971,U41729,50,1721.3200000000052,41,9,61292.09,63013.41
22972,U27258,50,-101402.32,36,14,242088.28000000003,140685.96000000002
22973,U43057,50,2207.6000000000095,37,13,115197.57,117405.17000000001
22974,U24141,50,-151.7799999999968,32,18,146312.18,146160.4
22975,U20595,49,-39549.88999999992,26,23,1768737.46,1729187.57
22976,U32038,49,53319.99,40,9,57762.840000000004,111082.83
22977,U758463,49,3492.7599999999975,34,15,7088.790000000001,10581.55
22978,U1088383,49,-641.2400000000004,43,6,8030.3,7389.0599999999995
22979,U29264,49,12514.270000000002,38,11,31240.17,43754.44
22980,U37232,49,99017.66999999998,36,13,116481.60000000002,215499.27000000002
22981,U29007,49,-10812.199999999995,24,25,217747.83999999997,206935.63999999998
22982,U20114,49,-10959.109999999999,35,14,115200.25,104241.14
22983,U18300,49,11624.290000000005,30,19,112352.66,123976.95000000001
22984,U29183,49,42358.14000000013,40,9,689050.13,731408.2700000001
22985,U41568,49,-14450.31,39,10,87583.56999999999,73133.26
22986,U15722,49,-29024.15999999998,32,17,243638.33000000002,214614.17000000004
22987,U978241,49,-2885.1800000000007,31,18,68282.43000000001,65397.25000000001
22988,U8985,49,-496.05000000000007,37,12,6667.410000000001,6171.360000000001
22989,U16677,49,-5338.249999999996,42,7,35298.99,29960.74
22990,U16162,49,-923.7500000000014,33,16,20549.100000000002,19625.350000000002
22991,U936666,49,13140.09,30,19,19880.319999999992,33020.40999999999
22992,U40572,49,2600.319999999997,23,26,381323.0,383923.32
22993,U15721,49,5086.87,22,27,274719.62,279806.49
22994,U1052506,49,-42.760000000000126,45,4,4042.94,4000.18
22995,U34385,49,21092.539999999997,32,17,61859.82,82952.36
22996,U27351,49,34785.38,24,25,86464.72,121250.1
22997,U22603,49,-4208.719999999999,29,20,53682.77999999999,49474.05999999999
22998,U11273,49,1529.8500000000004,32,17,99381.66,100911.51000000001
22999,U25638,49,-3888.520000000004,34,15,172504.65,168616.13
23000,U21693,49,-4998.6600000000035,37,12,99987.28,94988.62
23001,U11979,49,-8948.37,45,4,9157.53,209.15999999999985
23002,U43549,49,-575.2299999999977,41,8,41935.93,41360.700000000004
23003,U22019,49,2849.59,43,6,15523.689999999999,18373.28
23004,U24844,49,-43530.6,46,3,74130.6,30600.000000000007
23005,U19956,49,-16.639999999999276,41,8,44704.520000000004,44687.880000000005
23006,U737116,49,-548.1900000000002,40,9,8038.120000000001,7489.93
23007,U8080,49,-13398.910000000002,37,12,41592.53999999999,28193.62999999999
23008,U17925,49,522.7700000000001,43,6,3443.0,3965.77
23009,U13962,49,42314.140000000014,28,21,281330.46,323644.60000000003
23010,U12658,49,-170925.05000000002,37,12,225077.67999999996,54152.62999999995
23011,U38464,49,69.49000000002525,26,23,660367.21,660436.7
23012,U27174,49,3169.4799999999996,41,8,7013.39,10182.869999999999
23013,U14639,49,60067.6,36,13,108085.36000000002,168152.96000000002
23014,U34651,49,-334.99,40,9,112815.31000000001,112480.32
23015,U1118445,49,371.88999999999805,27,22,46834.49,47206.38
23016,U21727,49,-958.1599999999598,25,24,781835.42,780877.2600000001
23017,U14062,49,-84.36000000000055,40,9,47146.85999999999,47062.49999999999
23018,U30086,49,-631.2100000000012,32,17,128270.03000000001,127638.82
23019,U37126,49,21784.35000000001,30,19,516465.9099999999,538250.2599999999
23020,U36602,49,-1571.12,43,6,17158.089999999997,15586.969999999998
23021,U31917,49,297.40000000000146,36,13,9697.51,9994.910000000002
23022,U39995,49,239125.29,23,26,428869.19999999995,667994.49
23023,U19841,49,0.0,24,25,50957.3,50957.3
23024,U20875,49,-24370.129999999976,43,6,97875.43999999997,73505.31
23025,U14094,49,-8806.28000000001,37,12,219176.96999999997,210370.68999999997
23026,U31459,49,4252.539999999999,44,5,4355.37,8607.91
23027,U9789,49,-1096174.8800000004,32,17,6695241.75,5599066.869999999
23028,U18367,49,-1205.0000000000016,32,17,62951.000000000015,61746.000000000015
23029,U26156,49,23999.5,25,24,129277.26999999999,153276.77
23030,U41672,49,-1176.6800000000003,40,9,44652.14000000001,43475.46000000001
23031,U18921,49,-3268.5200000000013,41,8,24971.720000000005,21703.200000000004
23032,U1368912,49,567.9099999999994,32,17,38622.719999999994,39190.62999999999
23033,U41376,49,158404.4400000001,22,27,1494781.51,1653185.9500000002
23034,U30634,49,-6668.029999999998,40,9,15730.3,9062.27
23035,U582748,49,-2698.5699999999997,33,16,10630.829999999998,7932.259999999998
23036,U40766,49,53770.33,41,8,82915.76000000001,136686.09000000003
23037,U29988,49,-11782.279999999999,32,17,142858.53,131076.25
23038,U37101,49,-2237.7199999999984,39,10,31633.59,29395.870000000003
23039,U15114,49,-2312314.1699999995,29,20,4111527.1799999997,1799213.0100000002
23040,U21561,49,4923.660000000038,29,20,287571.97,292495.63
23041,U42396,49,1540.4799999999964,28,21,42216.26000000001,43756.740000000005
23042,U26223,49,-1510.740000000002,36,13,34696.21,33185.469999999994
23043,U37267,49,6174.549999999999,41,8,42861.4,49035.95
23044,U29390,49,588.040000000017,26,23,106356.21,106944.25000000003
23045,U29675,49,-9016.879999999996,25,24,177696.45,168679.57
23046,U41855,49,-21852.51,41,8,57803.53999999998,35951.029999999984
23047,U37812,49,-45429.07,35,14,102443.91,57014.840000000004
23048,U17636,49,189807.30000000002,17,32,333992.0,523799.30000000005
23049,U20240,49,-18097.560000000005,46,3,32853.05000000001,14755.490000000005
23050,U982549,49,-14032.900000000009,33,16,70701.24999999999,56668.34999999998
23051,U1132203,49,-2539.7200000000007,41,8,4620.660000000001,2080.94
23052,U36351,49,-4459.4,30,19,17412.14,12952.74
23053,U21285,49,15435.91,42,7,27323.239999999994,42759.149999999994
23054,U15735,49,1099.38,23,26,4733.3,5832.68
23055,U21233,49,1015.3100000000086,36,13,61183.07,62198.380000000005
23056,U1150398,49,-22390.649999999987,42,7,34190.65,11800.000000000015
23057,U15954,49,15319.579999999998,47,2,9692.21,25011.789999999997
23058,U33391,49,-301.07000000000517,31,18,58765.71,58464.63999999999
23059,U38864,49,-70380.61999999997,42,7,651476.56,581095.9400000001
23060,U28824,49,-238471.64,18,31,510663.10000000003,272191.46
23061,U26814,49,-29436.78000000001,43,6,119458.75000000001,90021.97
23062,U26890,49,-72.97000000001279,34,15,240852.44,240779.47
23063,U33469,49,4005.620000000015,24,25,191817.96,195823.58000000002
23064,U18775,49,-65855.90000000001,42,7,129185.54999999999,63329.64999999998
23065,U19342,49,-1962.3499999999988,42,7,34343.55,32381.200000000004
23066,U12675,49,-3803.5999999999976,30,19,141483.07,137679.47
23067,U580726,49,77.17000000000007,29,20,3425.09,3502.26
23068,U30273,49,40468.42999999999,27,22,125661.5,166129.93
23069,U14281,49,5471.269999999999,32,17,77082.13999999998,82553.40999999999
23070,U38308,49,-14986.809999999998,44,5,49598.200000000004,34611.39000000001
23071,U41291,49,-38012.35,39,10,190301.88000000003,152289.53000000003
23072,U39490,49,-8797.420000000002,41,8,43089.229999999996,34291.81
23073,U37290,49,-81561.90999999996,19,30,833422.75,751860.8400000001
23074,U22496,49,-26894.280000000006,35,14,157604.22999999998,130709.94999999998
23075,U10304,49,122.95000000000027,26,23,3789.0,3911.9500000000003
23076,U34672,49,-13474.24,47,2,23500.0,10025.76
23077,U13468,49,55.7199999999998,28,21,26303.920000000002,26359.640000000003
23078,U13757,49,-4924.0599999999995,35,14,12488.8,7564.74
23079,U22158,49,-517.5900000000024,34,15,49309.200000000004,48791.61
23080,U26849,49,-5804.07,34,15,51155.14,45351.07
23081,U34084,49,69419.07,22,27,120732.93000000001,190152.0
23082,U19380,49,17430.120000000017,37,12,249129.65,266559.77
23083,U18282,49,2169.0699999999997,42,7,16877.47,19046.54
23084,U34994,49,53386.15000000002,35,14,238251.37,291637.52
23085,U35550,49,-86.69000000000733,37,12,482952.36,482865.67
23086,U13688,49,-2613063.0900000003,26,23,29724942.279999997,27111879.189999998
23087,U34504,49,-20431.159999999993,28,21,345848.17000000004,325417.01000000007
23088,U18311,49,24034.34,30,19,45072.12000000002,69106.46000000002
23089,U1124564,49,5382.4300000000085,35,14,19294.649999999998,24677.080000000005
23090,U42616,49,-13476.779999999999,37,12,82719.84000000001,69243.06000000001
23091,U12712,49,1307.8900000000008,27,22,25001.29,26309.18
23092,U10785,49,38875.27999999997,33,16,66193.41999999998,105068.69999999995
23093,U12040,49,1120.0599999999947,29,20,106980.72,108100.78
23094,U37853,49,-89936.54000000004,35,14,721033.6100000001,631097.0700000001
23095,U40226,49,235710.15999999997,23,26,329131.52,564841.6799999999
23096,U18287,49,117268.77000000002,29,20,186534.62000000002,303803.39
23097,U31065,49,-48.23999999999963,44,5,2272.4799999999996,2224.24
23098,U21736,49,-158798.57,29,20,534716.8700000001,375918.3000000001
23099,U19678,49,48571.46999999998,17,32,387583.54000000004,436155.01
23100,U757260,49,-24855.820000000007,48,1,24856.820000000007,1.0
23101,U43620,49,5198.079999999998,33,16,74494.29,79692.37
23102,U32433,49,77361.49,31,18,383811.85,461173.33999999997
23103,U1026898,49,7.149999999999636,44,5,9394.380000000001,9401.53
23104,U40406,49,27577.679999999993,32,17,277182.4099999999,304760.0899999999
23105,U723354,49,-2.189999999999884,28,21,5716.120000000001,5713.930000000001
23106,U39538,49,2907.76,36,13,25502.12,28409.879999999997
23107,U32269,49,17630.82,41,8,21549.81,39180.630000000005
23108,U13818,49,-58417.45999999999,32,17,113649.27,55231.81000000001
23109,U9127,49,-5241.15000000002,29,20,360580.25000000006,355339.10000000003
23110,U11042,49,-7745.64,31,18,49911.420000000006,42165.780000000006
23111,U21368,49,1381.0100000000016,41,8,12199.129999999992,13580.139999999994
23112,U37672,49,3275.3100000000304,7,42,366723.39,369998.70000000007
23113,U30029,49,-7148.58,42,7,8234.59,1086.0100000000002
23114,U39763,49,-1900.3799999999999,38,11,26386.3,24485.92
23115,U27701,49,-15932.269999999997,37,12,69431.0,53498.73
23116,U18335,49,-19099.339999999997,45,4,47491.00000000001,28391.66000000001
23117,U10158,49,8766.460000000001,38,11,19971.27,28737.730000000003
23118,U34237,49,5784.140000000001,27,22,155493.59999999998,161277.74
23119,U36063,49,41135.27000000001,40,9,61845.73999999999,102981.01000000001
23120,U40950,49,3.450000000003996,33,16,34252.78,34256.23
23121,U13921,49,-270870.42000000004,31,18,698289.4600000001,427419.04000000004
23122,U37011,49,-9572.320000000012,30,19,282185.51,272613.19
23123,U39691,49,-32622.879999999997,37,12,59049.520000000004,26426.640000000007
23124,U38023,49,3514.770000000004,35,14,82724.54000000001,86239.31000000001
23125,U37086,49,-256.6500000000028,29,20,35043.71,34787.06
23126,U23093,49,-17896.490000000005,36,13,178742.05999999997,160845.56999999995
23127,U22574,49,17136.800000000003,36,13,65283.49999999999,82420.29999999999
23128,U40200,49,40819.67999999999,28,21,600254.0,641073.6799999999
23129,U26856,49,-16811.299999999996,26,23,164087.08,147275.78
23130,U15969,49,25701.63,44,5,152447.41999999998,178149.05
23131,U764175,49,241.8900000000038,30,19,118930.55,119172.44
23132,U12284,49,3508.2400000000007,32,17,61498.44,65006.68
23133,U13898,49,271.4400000000023,38,11,310672.8,310944.24
23134,U9439,49,1365.619999999999,23,26,111961.51,113327.12999999999
23135,U17199,49,-64878.30000000002,30,19,218746.53,153868.22999999998
23136,U13381,49,4233.790000000001,37,12,35000.62,39234.41
23137,U42597,49,-3077.63,30,19,7061.979999999999,3984.3499999999985
23138,U25299,49,14565.259999999984,23,26,382229.81,396795.07
23139,U19584,49,-4215.179999999997,38,11,82315.93,78100.75
23140,U22550,49,-16316.999999999993,42,7,112410.43,96093.43
23141,U34656,49,-2102.9000000000015,35,14,36488.28999999999,34385.38999999999
23142,U20856,49,-55.460000000002196,46,3,11805.470000000001,11750.009999999998
23143,U642372,49,254.38000000000102,29,20,22411.62,22666.0
23144,U42157,49,-256074.62,38,11,333004.0,76929.38
23145,U1209876,49,-113.90999999999882,33,16,13041.499999999998,12927.59
23146,U27256,49,-134.59000000000188,19,30,150461.07,150326.48
23147,U24508,49,-1792.0300000000025,38,11,85390.83000000002,83598.80000000002
23148,U19544,49,29.63000000000011,32,17,26709.18,26738.81
23149,U11350,49,-2999.63,30,19,34213.38,31213.749999999996
23150,U11621,49,259205.3000000001,39,10,238437.87999999998,497643.18000000005
23151,U1180923,49,1002.8299999999997,33,16,6475.410000000001,7478.240000000001
23152,U37240,49,-3554.43,42,7,9357.93,5803.5
23153,U31750,49,43.01000000000931,26,23,752849.33,752892.34
23154,U8248,49,-28997.83,32,17,225299.44,196301.61
23155,U27788,49,-11288.450000000006,37,12,98796.12,87507.66999999998
23156,U1021167,49,1303.9199999999996,44,5,12448.98,13752.9
23157,U26458,49,-41402.310000000005,40,9,65615.83000000002,24213.52000000001
23158,U42605,49,1315.2299999999998,41,8,7875.1,9190.33
23159,U26001,49,46079.12,33,16,68861.62,114940.73999999999
23160,U814198,49,382.96000000000004,36,13,7646.92,8029.88
23161,U21608,49,-72.63999999999987,43,6,15495.539999999999,15422.9
23162,U19311,49,-2271.0800000000004,26,23,11236.57,8965.49
23163,U30158,49,60449.13000000001,28,21,174495.06,234944.19
23164,U25919,49,41289.55999999999,32,17,13143.550000000001,54433.10999999999
23165,U24064,49,-53437.330000000075,29,20,1056972.3599999999,1003535.0299999998
23166,U36272,49,3306.7600000000107,24,25,229836.85000000003,233143.61000000004
23167,U37928,49,29866.910000000003,41,8,106650.06,136516.97
23168,U922532,49,45.559999999999945,27,22,9289.170000000002,9334.730000000001
23169,U40240,49,-5466.959999999999,40,9,41455.53999999999,35988.579999999994
23170,U10741,49,15612.550000000012,34,15,337264.4,352876.95
23171,U34063,49,-3555.25,29,20,22022.190000000002,18466.940000000002
23172,U10589,49,47435.19000000001,39,10,96215.25,143650.44
23173,U23179,49,3733.629999999993,34,15,209046.50999999998,212780.13999999998
23174,U22799,49,8080.029999999994,30,19,9410.32,17490.349999999995
23175,U27997,49,-30640.410000000007,40,9,89274.56,58634.149999999994
23176,U19561,49,-5507.03,42,7,15556.939999999993,10049.909999999993
23177,U35790,49,-3508.4299999999857,24,25,149127.88999999998,145619.46
23178,U37761,49,-2270.739999999997,44,5,13257.159999999998,10986.420000000002
23179,U34343,49,-1517.5099999999998,41,8,32620.75,31103.24
23180,U10533,49,-369.79999999999995,41,8,10162.75,9792.95
23181,U34411,49,-1953.9099999999999,44,5,7177.76,5223.85
23182,U38134,49,-4854.690000000002,32,17,488872.0,484017.31
23183,U10852,49,-252496.9,42,7,365851.97000000003,113355.07000000004
23184,U17675,49,6015.069999999985,21,28,243028.39,249043.46
23185,U17342,49,63162.23999999999,38,11,31190.72,94352.95999999999
23186,U31328,49,-35170.28,37,12,116280.29000000001,81110.01000000001
23187,U17476,49,-42750.11,37,12,113456.08,70705.97
23188,U21753,49,26554.9,36,13,163129.96999999997,189684.86999999997
23189,U32236,49,-1201.6099999999985,40,9,24290.53,23088.920000000002
23190,U17138,49,210842.69,22,27,204790.97,415633.66000000003
23191,U31832,49,4327.82,36,13,20696.660000000003,25024.480000000003
23192,U988047,49,-10829.330000000002,36,13,14268.700000000003,3439.370000000001
23193,U34624,49,-1188.929999999998,33,16,24286.100000000006,23097.17000000001
23194,U21093,49,420.9000000000033,32,17,116307.45,116728.35
23195,U22209,49,1707.3399999999983,40,9,19983.41,21690.75
23196,U38438,49,1301.7199999999996,29,20,13899.95,15201.67
23197,U23554,48,-183947.44000000003,29,19,602974.36,419026.9199999999
23198,U40512,48,18637.969999999998,38,10,57341.86,75979.83
23199,U15847,48,-31484.90999999999,32,16,134936.0,103451.09000000001
23200,U30253,48,9.430000000004668,33,15,209575.68000000002,209585.11000000002
23201,U30669,48,5907.76999999996,31,17,511657.68,517565.44999999995
23202,U35106,48,-1217.9899999999998,40,8,22426.72,21208.730000000003
23203,U43888,48,-21122.270000000004,37,11,60610.69,39488.42
23204,U8240,48,124.38999999999669,30,18,39879.32,40003.71
23205,U39011,48,-152841.33,34,14,849679.7,696838.37
23206,U20450,48,-434.1099999999998,41,7,434.3799999999997,0.26999999999992497
23207,U32407,48,8662.530000000028,20,28,228346.24,237008.77000000002
23208,U43162,48,15282.6,42,6,11122.259999999997,26404.859999999997
23209,U36184,48,-4.099999999976717,22,26,1298297.0,1298292.9
23210,U40170,48,1359.6500000000065,31,17,317578.08,318937.73000000004
23211,U21112,48,-55531.63,41,7,77237.05000000002,21705.42000000002
23212,U11785,48,26486.620000000006,37,11,72770.75000000001,99257.37000000002
23213,U36445,48,1214.6800000000003,40,8,118694.09000000001,119908.77000000002
23214,U37334,48,50934.19,36,12,2153.1500000000005,53087.340000000004
23215,U28098,48,-14960.190000000011,38,10,43230.119999999995,28269.929999999986
23216,U1328593,48,-278.2800000000001,37,11,2856.3999999999996,2578.1199999999994
23217,U40760,48,78.85000000000196,26,22,30805.300000000003,30884.150000000005
23218,U10564,48,20555.479999999836,28,20,7212269.88,7232825.359999999
23219,U16827,48,-862.6200000000008,40,8,14634.02,13771.4
23220,U19880,48,-72631.13,41,7,117879.17000000001,45248.04000000001
23221,U36413,48,192655.4,23,25,252541.0,445196.4
23222,U21641,48,-290.1000000000349,25,23,1030736.6,1030446.5
23223,U36774,48,76.18999999999869,20,28,44904.31,44980.5
23224,U15210,48,-5497.350000000008,39,9,47592.490000000005,42095.14
23225,U18717,48,3684.8599999999997,42,6,20826.870000000003,24511.730000000003
23226,U8684,48,-7991.68,43,5,28842.01,20850.329999999998
23227,U20752,48,21985.35,34,14,36479.020000000004,58464.37
23228,U21183,48,2042.7999999999993,23,25,288813.03,290855.83
23229,U37125,48,14800.869999999999,42,6,7527.0,22327.87
23230,U11977,48,16280.979999999996,30,18,84898.44,101179.42
23231,U1192461,48,-13100.000000000002,41,7,22695.420000000002,9595.42
23232,U11882,48,-102463.79999999999,31,17,240925.83,138462.03
23233,U23773,48,-453.40000000000146,30,18,124278.98000000001,123825.58000000002
23234,U19023,48,-12501.159999999945,31,17,463285.50999999995,450784.35
23235,U37877,48,-1418.67,24,24,37643.24,36224.57
23236,U31929,48,-23.999999999956344,20,28,490149.21,490125.2100000001
23237,U1103406,48,391.7199999999998,25,23,13519.430000000002,13911.150000000001
23238,U898755,48,232.00999999999988,39,9,1739.4000000000003,1971.4100000000003
23239,U43156,48,14469.550000000001,41,7,17498.52,31968.07
23240,U19056,48,2228.380000000007,27,21,116614.70999999999,118843.09
23241,U13333,48,-39638.31999999995,30,18,656679.75,617041.43
23242,U22436,48,-144.75000000000261,32,16,23020.95,22876.199999999997
23243,U28724,48,-103272.32999999999,32,16,549174.4299999998,445902.09999999986
23244,U16482,48,-78793.01999999999,38,10,102660.95999999999,23867.940000000002
23245,U26787,48,-5493.629999999997,32,16,43717.07000000001,38223.44000000001
23246,U12987,48,14711.519999999955,27,21,1388366.7099999997,1403078.2299999997
23247,U20693,48,-1937.210000000001,31,17,96563.74999999999,94626.53999999998
23248,U31753,48,37295.36999999999,29,19,83819.67000000001,121115.04000000001
23249,U33952,48,172086.48,28,20,377369.88,549456.36
23250,U27829,48,-566.8000000000006,38,10,32367.850000000002,31801.050000000003
23251,U35261,48,787.3799999999974,28,20,67862.0,68649.38
23252,U35268,48,-1302.4000000000017,22,26,42710.189999999995,41407.78999999999
23253,U8054,48,61053.18000000001,31,17,52625.579999999994,113678.76000000001
23254,U9045,48,18196.69,34,14,124763.35,142960.04
23255,U16199,48,-249904.66000000003,32,16,693312.8,443408.14
23256,U42055,48,-20802.70000000001,40,8,326617.13,305814.43
23257,U659916,48,-694.8799999999999,29,19,13036.72,12341.84
23258,U16466,48,59157.1,16,32,408612.0,467769.1
23259,U32459,48,-39399.09,30,18,384828.92000000004,345429.8300000001
23260,U44064,48,8195.660000000002,38,10,11676.109999999999,19871.77
23261,U948041,48,-226.12000000000057,32,16,21525.549999999996,21299.429999999997
23262,U8810,48,-320.0899999999987,27,21,168157.84,167837.75
23263,U36758,48,11792.819999999992,34,14,117046.79000000001,128839.61
23264,U27783,48,399.4599999999998,44,4,7472.339999999999,7871.799999999999
23265,U22358,48,-1614.020000000009,36,12,153567.98,151953.96
23266,U9190,48,-3427.4400000000005,43,5,14931.409999999998,11503.969999999998
23267,U11736,48,63346.520000000004,36,12,196860.78,260207.3
23268,U26842,48,14464.89,45,3,4035.109999999999,18500.0
23269,U9934,48,-42096.78,39,9,134161.97,92065.19
23270,U18617,48,103808.99999999994,16,32,306285.79000000004,410094.79
23271,U18153,48,52554.91000000001,40,8,75365.31,127920.22
23272,U35109,48,-17518.549999999985,21,27,303052.81000000006,285534.26000000007
23273,U33282,48,-886.5299999999988,33,15,49214.2,48327.67
23274,U11772,48,-3339.3500000000004,37,11,30877.609999999993,27538.259999999995
23275,U21955,48,-54620.02000000001,38,10,306086.56,251466.53999999998
23276,U28313,48,3851.630000000002,27,21,31971.64,35823.270000000004
23277,U20508,48,7350.73,41,7,24376.65,31727.38
23278,U28870,48,-24692.59999999999,30,18,215215.65000000002,190523.05000000005
23279,U624049,48,-222.06,31,17,10260.09,10038.03
23280,U12341,48,-15990.110000000008,39,9,304719.16999999987,288729.0599999999
23281,U8754,48,12844.35,33,15,178694.26,191538.61000000002
23282,U14696,48,2156.020000000006,31,17,85335.93000000001,87491.95000000001
23283,U1139495,48,8.9300000000001,27,21,1765.9199999999998,1774.85
23284,U41128,48,-26942.38999999997,25,23,735660.7400000001,708718.3500000001
23285,U623573,48,-233.73999999999992,36,12,898.9899999999999,665.25
23286,U15576,48,8604.51,30,18,28270.730000000003,36875.240000000005
23287,U14634,48,22040.929999999993,34,14,257520.8,279561.73
23288,U17681,48,69274.02000000002,27,21,156177.94999999998,225451.97
23289,U32995,48,729.9999999999991,34,14,17576.75,18306.75
23290,U22692,48,211866.19999999998,37,11,18615.07,230481.27
23291,U30878,48,-4142.959999999992,39,9,63455.7,59312.740000000005
23292,U15898,48,-11807.77,42,6,18669.25,6861.48
23293,U29038,48,69719.72,15,33,204121.16,273840.88
23294,U39042,48,-92347.53,29,19,415803.66000000003,323456.13
23295,U43906,48,-47801.25000000001,39,9,49807.3,2006.0499999999956
23296,U10078,48,-290118.9199999999,19,29,2274560.0,1984441.08
23297,U13749,48,-41944.74,39,9,249980.62999999998,208035.88999999998
23298,U40470,48,6037.0599999999995,36,12,41152.14,47189.2
23299,U964836,48,-2998.850000000001,27,21,21702.320000000007,18703.470000000005
23300,U38741,48,4526.990000000009,25,23,184251.53,188778.52000000002
23301,U25885,48,27332.64999999999,27,21,328498.95999999996,355831.6099999999
23302,U34602,48,36.21000000000777,36,12,123260.80000000002,123297.01000000002
23303,U36223,48,-33606.549999999996,43,5,66843.05000000002,33236.50000000002
23304,U21642,48,31494.850000000002,29,19,67064.92,98559.77
23305,U16531,48,88148.01999999999,34,14,89596.78,177744.8
23306,U15723,48,-960696.02,14,34,2316643.1599999997,1355947.1399999997
23307,U40124,48,-8904.11,44,4,21829.780000000002,12925.670000000002
23308,U14044,48,-32331.059999999998,37,11,552912.3,520581.24000000005
23309,U29277,48,-8065.26,42,6,15425.65,7360.389999999999
23310,U43897,48,373.6400000000002,24,24,850569.13,850942.77
23311,U15302,48,-4458.160000000004,32,16,60595.13999999999,56136.97999999999
23312,U35821,48,283106.06,34,14,317387.4,600493.46
23313,U34553,48,186.66999999999996,28,20,22048.42,22235.089999999997
23314,U9637,48,-21219.550000000003,23,25,55595.64,34376.09
23315,U43097,48,477.1700000000002,36,12,13093.37,13570.54
23316,U27833,48,2250.290000000001,36,12,13109.35,15359.640000000001
23317,U30131,48,20888.56,40,8,46045.84,66934.4
23318,U8208,48,-1085.8,47,1,1085.86,0.05999999999994543
23319,U1204284,48,-11562.989999999998,32,16,49701.66,38138.670000000006
23320,U24507,48,3853.709999999999,34,14,23502.510000000002,27356.22
23321,U9686,48,327.9400000000005,32,16,142608.62,142936.56
23322,U12125,48,-906.3400000000007,31,17,30364.35,29458.01
23323,U43710,48,-356.7200000000018,31,17,54799.12,54442.4
23324,U31844,48,-17293.400000000005,43,5,28925.649999999998,11632.249999999993
23325,U23640,48,-3070.9800000000014,42,6,95795.45,92724.47
23326,U37254,48,111.42999999999893,31,17,35098.549999999996,35209.979999999996
23327,U29768,48,-107020.97000000002,43,5,188148.4299999999,81127.45999999989
23328,U22657,48,-1121.8500000000022,39,9,120380.55,119258.7
23329,U19676,48,-63738.83,44,4,153976.05,90237.21999999999
23330,U40343,48,-12133.329999999998,40,8,37670.91,25537.580000000005
23331,U13836,48,-3398.510000000004,31,17,321425.57,318027.06
23332,U41151,48,1611.7100000000005,21,27,87149.23,88760.94
23333,U27601,48,-19390.839999999997,30,18,57148.68,37757.840000000004
23334,U40001,48,-30815.46999999998,31,17,2928032.65,2897217.1799999997
23335,U22398,48,167.900000000001,24,24,39257.1,39425.0
23336,U9673,48,-378.2099999999983,40,8,39086.189999999995,38707.979999999996
23337,U620417,48,4223.080000000002,29,19,10377.880000000005,14600.960000000006
23338,U36310,48,-92990.0399999999,41,7,160807.1699999999,67817.12999999999
23339,U28728,48,-6182.09,30,18,59472.08,53289.990000000005
23340,U24104,48,-133.11000000000058,34,14,227451.5,227318.39
23341,U18633,48,203701.54,40,8,23877.63,227579.17
23342,U26036,48,2668.61,40,8,7751.68,10420.29
23343,U35571,48,1608.3199999999988,29,19,25197.789999999997,26806.109999999997
23344,U38343,48,73342.64000000003,41,7,60275.41000000001,133618.05000000005
23345,U22247,48,-23913.319999999996,30,18,122819.18999999999,98905.87
23346,U19338,48,35520.61000000001,24,24,185392.16999999998,220912.78
23347,U780666,48,-52.01000000000204,33,15,48783.97,48731.96
23348,U15115,48,33658.12999999993,10,38,7000219.11,7033877.24
23349,U40917,48,-9561.14,35,13,68717.28,59156.14
23350,U11082,48,-3852.8800000000033,43,5,104324.31,100471.43
23351,U32619,48,-671.8700000000003,34,14,10400.02,9728.15
23352,U37212,48,5074.910000000002,29,19,64327.06,69401.97
23353,U897211,48,-7004.92,30,18,41622.79,34617.87
23354,U1246287,48,-7122.579999999999,40,8,31289.859999999997,24167.28
23355,U13270,48,-78866.18,30,18,236234.08000000002,157367.90000000002
23356,U25260,48,216014.47999999998,27,21,495955.31,711969.79
23357,U37435,48,236.17999999999998,45,3,4317.920000000001,4554.100000000001
23358,U26969,48,1147.2200000000012,29,19,563225.4,564372.62
23359,U25766,48,108.30000000000037,45,3,9759.3,9867.6
23360,U27209,48,638648.96,18,30,1473623.2,2112272.16
23361,U15804,48,26199.350000000006,32,16,14886.15,41085.50000000001
23362,U1273930,48,-4502.400000000001,30,18,15192.550000000001,10690.150000000001
23363,U14909,48,-10209.310000000027,36,12,263234.79,253025.47999999995
23364,U22181,48,2185.9500000000007,39,9,6339.6,8525.550000000001
23365,U13073,48,-2384.75,23,25,115148.61,112763.86
23366,U30339,48,-2639.2700000000004,20,28,84033.0,81393.73
23367,U22533,48,-10158.859999999997,32,16,80158.01999999999,69999.15999999999
23368,U37147,48,38530.58,35,13,329876.26,368406.84
23369,U9426,48,-421.130000000001,33,15,32425.42,32004.289999999997
23370,U19672,48,4521.049999999999,40,8,29508.27,34029.32
23371,U28025,48,72.18000000000029,29,19,82698.5,82770.68
23372,U18325,48,31029.899999999994,40,8,13972.77,45002.67
23373,U43837,48,143.33000000000163,32,16,40856.64,40999.97
23374,U41192,48,-15784.270000000019,35,13,116700.92,100916.64999999998
23375,U979466,48,256.70000000000005,26,22,6283.360000000001,6540.06
23376,U39157,48,-16923.04,32,16,70471.98999999999,53548.94999999999
23377,U18109,48,77182.70999999998,24,24,251047.69,328230.39999999997
23378,U37552,48,-2817.0599999999977,42,6,242935.00999999998,240117.94999999998
23379,U15075,48,394.5200000000017,44,4,29020.240000000005,29414.760000000006
23380,U18097,48,-3022.8100000000013,39,9,18521.9,15499.09
23381,U28844,48,30.479999999998597,35,13,24866.99,24897.47
23382,U28618,48,9656.050000000001,29,19,22335.26,31991.309999999998
23383,U9512,48,-644.0600000000013,31,17,18559.739999999998,17915.679999999997
23384,U12243,48,-277.729999999998,35,13,41413.78,41136.05
23385,U30485,48,84234.07,38,10,190722.49,274956.56
23386,U24366,48,14.360000000001492,31,17,52319.9,52334.26
23387,U29710,48,2730.1599999999944,25,23,121100.98000000001,123831.14
23388,U34258,48,-9757.729999999996,34,14,45474.93,35717.200000000004
23389,U10109,48,24873.2,37,11,24927.770000000004,49800.97
23390,U26124,48,-2000.629999999999,40,8,69643.91,67643.28
23391,U40219,48,124666.28999999994,35,13,566675.59,691341.8799999999
23392,U16175,48,-1929.8899999999994,43,5,69940.1,68010.21
23393,U36064,48,10055.049999999994,22,26,85342.64,95397.68999999999
23394,U33563,48,-8797.09,33,15,75389.01999999999,66591.93
23395,U33165,48,79549.37000000005,18,30,1261510.0,1341059.37
23396,U35197,48,6629.23,31,17,81304.0,87933.23
23397,U12669,48,1615.3999999999999,44,4,1280.6100000000001,2896.01
23398,U18930,48,-82.46000000000276,35,13,155908.78999999998,155826.33
23399,U9910,48,29283.660000000007,43,5,23773.579999999998,53057.240000000005
23400,U15928,48,-2011.3999999999983,28,20,161233.14000000004,159221.74000000005
23401,U24846,48,70.87000000000002,43,5,1505.1399999999996,1576.0099999999998
23402,U33521,48,215052.60000000003,18,30,1179760.0,1394812.6
23403,U34221,48,-566801.02,35,13,783338.3300000001,216537.31000000006
23404,U1191584,48,-2040.8700000000003,34,14,14547.410000000002,12506.54
23405,U31598,48,-4053.639999999941,22,26,593798.9099999999,589745.27
23406,U8147,48,1026.4600000000014,42,6,14154.539999999999,15181.0
23407,U15132,48,-180230.27000000002,31,17,1772756.0,1592525.73
23408,U28602,48,216.440000000003,33,15,111664.00000000001,111880.44000000002
23409,U37627,48,-1001.2900000000009,41,7,9235.5,8234.21
23410,U40123,48,20004.410000000003,30,18,299790.08999999997,319794.5
23411,U27245,48,26.969999999999345,26,22,26506.330000000005,26533.300000000003
23412,U9015,48,-18416.230000000003,41,7,32603.95,14187.719999999998
23413,U24535,48,-16496.879999999997,29,19,101526.80999999998,85029.93
23414,U1214427,48,-15346.829999999998,40,8,23151.140000000003,7804.310000000005
23415,U15994,48,-5399.459999999998,12,36,162732.61,157333.15
23416,U40728,48,-109585.32999999999,30,18,821019.56,711434.2300000001
23417,U42903,48,198026.86,31,17,117689.77999999998,315716.63999999996
23418,U15493,48,-195.65999999999622,33,15,188795.13000000003,188599.47000000003
23419,U20802,48,2353.5,39,9,8251.029999999999,10604.529999999999
23420,U30145,48,-50086.85000000006,40,8,929975.1699999999,879888.3199999998
23421,U23558,48,1447.48,36,12,4491.56,5939.040000000001
23422,U9897,48,384.0500000000003,42,6,7560.700000000001,7944.750000000001
23423,U884517,48,-4094.89,33,15,15069.04,10974.150000000001
23424,U662607,48,-1232.54,41,7,4373.26,3140.7200000000003
23425,U24361,48,80798.95,16,32,816269.88,897068.83
23426,U13299,48,330318.67000000004,33,15,416346.24999999994,746664.9199999999
23427,U27540,48,-11129.979999999998,38,10,11806.679999999998,676.7000000000007
23428,U24495,48,-4207.369999999995,31,17,139211.3,135003.93
23429,U760104,48,-14.799999999998041,29,19,12167.0,12152.200000000003
23430,U13649,48,322125.65,31,17,63811.630000000005,385937.28
23431,U12655,48,-5752.209999999994,37,11,238810.98,233058.77000000002
23432,U35916,48,10959.009999999998,38,10,14498.190000000002,25457.2
23433,U26986,48,-613.7400000000009,35,13,19226.82,18613.079999999998
23434,U12884,48,51216.740000000005,40,8,12300.630000000003,63517.37000000001
23435,U15077,48,1892.8900000000003,40,8,11442.28,13335.170000000002
23436,U9305,48,-3400.59999999998,25,23,546589.6500000001,543189.0500000002
23437,U26974,48,-76396.51000000001,43,5,102836.67000000001,26440.160000000003
23438,U28131,48,-7678.899999999999,38,10,102594.80000000002,94915.90000000002
23439,U16989,48,-19155.250000000007,27,21,77947.5,58792.24999999999
23440,U31537,48,1306.0199999999988,41,7,20692.260000000002,21998.280000000002
23441,U34619,48,305340.84,38,10,135663.59,441004.43000000005
23442,U36858,48,-30904.999999999993,33,15,127672.26999999999,96767.26999999999
23443,U39830,47,468.050000000012,31,16,172874.14,173342.19000000003
23444,U12315,47,43730.869999999995,35,12,32871.740000000005,76602.61
23445,U16418,47,391.5300000000001,41,6,6556.17,6947.7
23446,U20758,47,-3207.0300000000007,24,23,96050.90999999999,92843.87999999999
23447,U600007,47,-11400.970000000001,37,10,21791.120000000003,10390.150000000001
23448,U933356,47,-1725.9000000000005,38,9,24729.850000000002,23003.95
23449,U11137,47,-32502.239999999998,37,10,73891.81,41389.57
23450,U39631,47,-20233.68,44,3,28893.5,8659.82
23451,U42318,47,53051.77,35,12,43875.5,96927.26999999999
23452,U42169,47,11126.050000000001,34,13,43030.00000000001,54156.05000000001
23453,U30944,47,-350.7699999999996,35,12,47800.79000000001,47450.02000000001
23454,U1184389,47,18.7,22,25,56.56,75.26
23455,U11733,47,-547.3199999999996,40,7,8701.94,8154.620000000001
23456,U968413,47,8.78000000000302,26,21,73438.65,73447.43
23457,U16943,47,33900.93000000001,38,9,134209.59999999998,168110.52999999997
23458,U18471,47,4853.87000000001,23,24,140038.24,144892.11
23459,U35240,47,-3216.659999999996,39,8,103938.9,100722.23999999999
23460,U31996,47,6586.75,37,10,36329.57,42916.32
23461,U40434,47,664.3500000000001,36,11,3781.07,4445.42
23462,U34660,47,8794.350000000035,40,7,206170.87999999998,214965.23
23463,U36238,47,268465.32999999996,28,19,466124.49999999994,734589.8299999998
23464,U17740,47,-4291.189999999999,29,18,40175.14000000001,35883.95000000001
23465,U10917,47,15215.919999999998,31,16,29732.079999999998,44948.0
23466,U11238,47,-1283.4200000000003,43,4,23279.34,21995.92
23467,U17893,47,-6149.680000000051,29,18,821345.38,815195.7
23468,U11857,47,10653.010000000006,38,9,45091.94,55744.95000000001
23469,U28394,47,-685.5900000000001,33,14,81813.0,81127.41
23470,U1237387,47,-457.1000000000001,42,5,1160.8799999999997,703.7799999999995
23471,U40454,47,4021.9399999999305,32,15,568724.1400000001,572746.0800000001
23472,U20247,47,-12218.579999999996,26,21,106707.87000000004,94489.29000000004
23473,U29738,47,42027.119999999995,27,20,65612.23999999999,107639.35999999999
23474,U9631,47,-58.28999999999962,33,14,5848.11,5789.82
23475,U939092,47,-759.36,30,17,9618.590000000002,8859.230000000001
23476,U26980,47,10493.580000000002,21,26,141879.45,152373.03000000003
23477,U36012,47,-1128.7800000000032,24,23,97071.87,95943.09
23478,U18159,47,1134.579999999982,25,22,405698.06,406832.63999999996
23479,U23801,47,-225407.53999999995,30,17,310235.8400000001,84828.30000000013
23480,U1056210,47,-2.6900000000000754,27,20,2979.7999999999997,2977.1099999999997
23481,U20428,47,-39667.72,39,8,94002.80000000002,54335.080000000016
23482,U41250,47,-2129.380000000007,30,17,83578.40000000001,81449.02
23483,U27839,47,56851.62999999999,32,15,252964.7,309816.33
23484,U38435,47,5008.37,34,13,16168.3,21176.67
23485,U29185,47,-9791.999999999964,31,16,603672.71,593880.71
23486,U32700,47,13365.380000000003,36,11,61519.700000000004,74885.08
23487,U13823,47,749.1600000000321,19,28,505374.67,506123.83
23488,U19149,47,-764.9799999999977,24,23,62123.0,61358.020000000004
23489,U40865,47,-65.10000000004948,23,24,898562.0800000001,898496.98
23490,U14665,47,124629.55000000005,21,26,712729.61,837359.16
23491,U12179,47,2911.8700000000026,38,9,23246.63,26158.500000000004
23492,U21186,47,-6326.6600000000035,39,8,85872.2,79545.54
23493,U9955,47,391.7399999999993,26,21,53598.68,53990.42
23494,U11728,47,16623.010000000002,34,13,77339.73000000001,93962.74000000002
23495,U14487,47,7710.510000000002,33,14,130515.29,138225.8
23496,U32618,47,-13410.79,37,10,61368.73,47957.94
23497,U38832,47,14615.929999999986,26,21,304169.97,318785.89999999997
23498,U42376,47,-3179.690000000008,38,9,55140.48,51960.78999999999
23499,U12412,47,-333687.6699999999,35,12,535666.0,201978.33000000007
23500,U42891,47,-15407.130000000001,42,5,41408.220000000016,26001.090000000015
23501,U26798,47,1142.9400000000037,37,10,89115.93999999999,90258.87999999999
23502,U11684,47,-332.10000000000036,40,7,19235.41,18903.309999999998
23503,U25770,47,-5571.450000000001,36,11,120398.38999999998,114826.93999999999
23504,U34223,47,-2692.060000000012,26,21,336670.7,333978.64
23505,U1171215,47,0.8500000000004547,24,23,4704.27,4705.120000000001
23506,U30832,47,0.23,24,23,81490.0,81490.23
23507,U43787,47,-9770.810000000001,41,6,32298.96,22528.149999999998
23508,U859114,47,-1659.599999999997,41,6,19022.289999999997,17362.69
23509,U29410,47,15887.830000000002,31,16,90074.66,105962.49
23510,U43065,47,4818.13,26,21,33486.58,38304.71
23511,U10075,47,-8254.029999999999,38,9,69870.73999999999,61616.70999999999
23512,U8562,47,16272.059999999992,20,27,104856.53,121128.59
23513,U19414,47,-10089.400000000007,23,24,2315092.3000000003,2305002.9000000004
23514,U38958,47,88313.72,30,17,249254.72,337568.44
23515,U13572,47,-421.31000000000495,26,21,202894.33000000002,202473.02000000002
23516,U27353,47,34710.33999999998,37,10,46654.380000000005,81364.71999999999
23517,U21068,47,-1400.3899999999996,35,12,46599.469999999994,45199.079999999994
23518,U20352,47,-25939.300000000007,38,9,640892.9000000001,614953.6000000001
23519,U25081,47,43938.9100000002,26,21,1418172.3200000003,1462111.2300000004
23520,U575668,47,-1231.2099999999991,33,14,14326.73,13095.52
23521,U27357,47,-1535.070000000007,33,14,115205.9,113670.82999999999
23522,U33932,47,-1210.8399999999992,39,8,5628.15,4417.31
23523,U14917,47,-74.9300000000001,27,20,17291.61,17216.68
23524,U27606,47,9200.290000000003,42,5,14897.42,24097.710000000003
23525,U23830,47,2874.630000000001,20,27,96052.02,98926.65000000001
23526,U22320,47,589.0000000000001,40,7,9745.87,10334.87
23527,U8753,47,3858.4799999999996,40,7,10139.7,13998.18
23528,U35592,47,4571.22,43,4,6879.9,11451.119999999999
23529,U29684,47,-1244.2600000000084,17,30,1598646.58,1597402.32
23530,U23837,47,-8543.91,41,6,18183.079999999998,9639.169999999998
23531,U17857,47,88238.06,27,20,118533.0,206771.06
23532,U19440,47,30476.160000000003,25,22,442027.55,472503.70999999996
23533,U33197,47,-53672.520000000004,44,3,56831.57000000001,3159.050000000003
23534,U13643,47,248539.44999999998,32,15,105828.56999999998,354368.01999999996
23535,U20817,47,-17813.88,35,12,114979.1,97165.22
23536,U746144,47,-93.07999999999987,28,19,1910.1500000000003,1817.0700000000004
23537,U10987,47,-635.3399999999995,40,7,28096.11,27460.77
23538,U40107,47,-151452.98,35,12,368758.66000000003,217305.68000000002
23539,U1057985,47,176.65999999999997,27,20,5205.92,5382.58
23540,U13811,47,-109986.75,35,12,235434.87000000002,125448.12000000002
23541,U27650,47,5187.410000000002,37,10,18956.730000000003,24144.140000000007
23542,U14079,47,2114.78,21,26,13395.58,15510.36
23543,U884066,47,-26531.54,31,16,46561.869999999995,20030.329999999994
23544,U42529,47,-3221.98,41,6,4265.639999999999,1043.6599999999994
23545,U10660,47,380.48999999999995,41,6,3545.8,3926.29
23546,U33462,47,-78.48999999999887,37,10,17618.65,17540.160000000003
23547,U34477,47,-30933.56000000002,36,11,128951.82000000002,98018.26000000001
23548,U19194,47,275.79000000000167,42,5,12002.379999999997,12278.169999999998
23549,U36427,47,148606.53000000003,32,15,65172.89,213779.42000000004
23550,U24823,47,610.64,35,12,5194.51,5805.150000000001
23551,U41100,47,47394.450000000004,34,13,11313.11,58707.560000000005
23552,U18327,47,37406.97000000001,21,26,96100.22,133507.19
23553,U40178,47,388989.26000000007,27,20,15624.1,404613.36000000004
23554,U39701,47,30727.749999999993,33,14,210171.66000000003,240899.41000000003
23555,U21906,47,-25723.469999999972,42,5,512609.95,486886.48000000004
23556,U12323,47,-6716.1500000000015,26,21,90643.58,83927.43
23557,U13427,47,-411.820000000001,23,24,116439.37,116027.54999999999
23558,U42823,47,-8726.870000000003,33,14,110935.97,102209.1
23559,U38258,47,-16423.19000000002,25,22,186794.06,170370.86999999997
23560,U21609,47,-25262.909999999996,36,11,77215.48999999999,51952.579999999994
23561,U10614,47,-289.52000000000226,35,12,95278.04,94988.51999999999
23562,U23643,47,-3355.0999999999904,23,24,736375.9400000002,733020.8400000002
23563,U1094817,47,-1595.999999999999,39,8,7509.42,5913.420000000001
23564,U12743,47,6396.869999999999,29,18,48904.83,55301.7
23565,U10857,47,-11596.009999999998,26,21,57930.61000000001,46334.600000000006
23566,U15906,47,72703.15,23,24,121306.15000000002,194009.30000000002
23567,U15182,47,-7907.289999999959,29,18,426912.89999999997,419005.61
23568,U23065,47,14743.389999999996,38,9,22169.98,36913.369999999995
23569,U32330,47,22196.03,22,25,40811.96,63007.99
23570,U13633,47,-17315.16,31,16,460104.42,442789.26
23571,U18417,47,17652.259999999995,36,11,126488.5,144140.76
23572,U26948,47,695378.66,29,18,2246139.3000000003,2941517.9600000004
23573,U27197,47,10510485.239999998,31,16,349453.77,10859939.009999998
23574,U11842,47,-6943.699999999997,26,21,804953.91,798010.2100000001
23575,U36901,47,-14028.680000000011,40,7,74519.41,60490.729999999996
23576,U31075,47,-50387.270000000004,45,2,50430.21,42.93999999999505
23577,U41006,47,8156.36,35,12,61433.97,69590.33
23578,U28757,47,6218.1100000000015,36,11,12233.14,18451.25
23579,U10371,47,-48737.749999999985,31,16,397694.41,348956.66
23580,U24940,47,-2840.0199999999973,33,14,452387.58999999997,449547.56999999995
23581,U1250628,47,-3924.840000000001,43,4,9895.619999999999,5970.779999999998
23582,U25433,47,5274.659999999996,45,2,3363.2500000000036,8637.91
23583,U27016,47,-3887.39,41,6,9013.39,5126.0
23584,U39946,47,-7861.330000000004,40,7,161122.0,153260.66999999998
23585,U34457,47,4615.27,39,8,8026.3,12641.57
23586,U41272,47,1686.8400000000038,31,16,59685.05,61371.89000000001
23587,U12312,47,11229.009999999995,31,16,86543.84999999999,97772.85999999999
23588,U38934,47,271.56999999999834,26,21,25936.44,26208.01
23589,U15465,47,79095.91999999995,28,19,987343.01,1066438.93
23590,U21092,47,21053.33999999985,23,24,27711563.64,27732616.98
23591,U600788,47,-2502.969999999998,27,20,57413.85,54910.88
23592,U34738,47,4957.9100000000035,37,10,53321.43,58279.340000000004
23593,U10283,47,26.969999999942388,22,25,437027.80000000005,437054.76999999996
23594,U670469,47,-912.2799999999996,38,9,13104.79,12192.510000000002
23595,U1198073,47,-2364.149999999998,31,16,120283.92000000001,117919.77000000002
23596,U1310128,47,-9.86999999999989,42,5,8678.42,8668.55
23597,U38649,47,-29867.18,29,18,180387.02999999997,150519.84999999998
23598,U35045,47,-21639.56,38,9,77015.17000000001,55375.610000000015
23599,U40638,47,1486.74,36,11,3815.630000000001,5302.370000000001
23600,U19765,47,15624.65,23,24,101485.81999999999,117110.46999999999
23601,U25284,47,3852.6500000001165,32,15,709492.9299999999,713345.5800000001
23602,U23986,47,-3193.4499999999994,35,12,72786.29000000001,69592.84000000001
23603,U28614,47,-168.81000000000122,28,19,10947.809999999998,10778.999999999996
23604,U21376,47,-1470.4200000000128,23,24,533613.8300000001,532143.41
23605,U663028,47,-764.9299999999993,28,19,12200.079999999998,11435.15
23606,U12214,47,-29085.429999999997,33,14,63872.8,34787.37000000001
23607,U36573,47,3270.0199999999927,31,16,135872.87,139142.88999999998
23608,U39367,47,39.38000000001455,36,11,140502.86,140542.24
23609,U31816,47,820.5299999999988,23,24,58876.57,59697.1
23610,U24226,47,-296737.31999999995,31,16,726377.2,429639.88
23611,U694095,47,-13178.740000000002,36,11,40909.55,27730.81
23612,U30542,47,-5467.690000000002,22,25,446494.39,441026.7
23613,U41101,47,-6772.3399999999965,34,13,88690.73,81918.39
23614,U13856,47,7313.610000000001,29,18,19639.82,26953.43
23615,U21216,47,2777.32999999998,23,24,410361.66000000003,413138.99
23616,U34066,47,-3725.0899999999992,34,13,68577.85,64852.76000000001
23617,U35875,47,-717.679999999993,27,20,125221.56999999999,124503.89
23618,U11270,47,915147.32,31,16,424318.65,1339465.97
23619,U39443,47,-132128.10999999987,38,9,677121.49,544993.3800000001
23620,U1227229,47,-389.6500000000001,34,13,11264.33,10874.68
23621,U22023,47,5238.4400000000005,25,22,13529.14,18767.58
23622,U20554,47,743.0800000000006,38,9,15381.66,16124.74
23623,U17265,47,6796.160000000149,24,23,5401617.34,5408413.5
23624,U20466,47,-31280.23999999999,41,6,496258.75000000006,464978.51000000007
23625,U8327,47,10261.379999999992,38,9,131889.83,142151.21
23626,U41969,47,-5537.959999999999,34,13,20592.53,15054.57
23627,U44023,47,4031.9400000000014,37,10,56280.8,60312.740000000005
23628,U37782,47,-4378.069999999999,34,13,26678.760000000002,22300.690000000002
23629,U32494,47,-71.53999999999996,36,11,4913.560000000001,4842.020000000001
23630,U40474,47,74919.42000000004,31,16,694274.63,769194.05
23631,U41213,47,-57940.07000000002,24,23,256323.17,198383.09999999998
23632,U1345891,47,-7707.209999999999,30,17,84802.72,77095.51000000001
23633,U33914,47,9754.910000000556,21,26,2917168.98,2926923.8900000006
23634,U10776,47,3999.979999999996,23,24,99397.01999999999,103396.99999999999
23635,U21498,47,-5959.7300000000105,26,21,357651.35,351691.62
23636,U43666,47,6974.049999999995,32,15,130067.06,137041.11
23637,U30551,47,36856.11,40,7,17481.0,54337.11
23638,U24835,47,-321.6900000000023,32,15,80451.20000000001,80129.51000000001
23639,U19927,47,-12618.860000000002,35,12,89345.98,76727.12
23640,U38880,47,1151.909999999965,35,12,974454.7999999999,975606.7099999998
23641,U37776,47,-2509.4799999999977,39,8,25999.44,23489.96
23642,U38396,47,-182827.32,32,15,325435.18,142607.86
23643,U38089,47,3761.3599999999988,33,14,51696.88,55458.24
23644,U8526,47,-5850.989999999996,30,17,253289.94,247438.95
23645,U28849,47,-10487.520000000002,39,8,22296.52,11808.999999999998
23646,U33595,47,2399.320000000019,32,15,1166896.1700000002,1169295.4900000002
23647,U21767,47,4101.720000000022,40,7,910503.99,914605.71
23648,U40976,47,-11724.230000000003,38,9,40042.479999999996,28318.249999999993
23649,U18412,47,13942.61,35,12,92613.2,106555.81
23650,U38995,47,-9864.82,33,14,527447.98,517583.16
23651,U34916,47,-1041.3200000000002,31,16,29163.339999999997,28122.019999999997
23652,U20665,47,-3917.300000000001,39,8,12184.509999999997,8267.209999999995
23653,U37688,47,-33959.44,37,10,90651.03,56691.59
23654,U36617,47,60741.19000000002,31,16,80414.81,141156.0
23655,U25771,47,-115590.77000000003,33,14,169689.7,54098.92999999998
23656,U27193,47,24548.659999999996,33,14,263260.02,287808.68
23657,U38855,47,-1473.1799999999985,29,18,58479.01,57005.83
23658,U9163,47,173074.72000000003,35,12,65706.4,238781.12000000002
23659,U40564,47,43446.9,36,11,30425.940000000002,73872.84
23660,U38242,47,2671.320000000007,32,15,44286.96,46958.280000000006
23661,U14186,47,-994060.8599999999,31,16,1102019.3999999997,107958.5399999998
23662,U21759,47,-905.3399999999954,38,9,102358.56,101453.22
23663,U18823,47,7633.3099999999995,38,9,8708.220000000001,16341.53
23664,U17988,47,5975.659999999999,41,6,14651.339999999998,20626.999999999996
23665,U43742,47,5176.46,33,14,8089.74,13266.2
23666,U1272982,47,5451.84,33,14,20473.29,25925.13
23667,U16427,47,28905.879999999997,27,20,33806.61000000001,62712.490000000005
23668,U18991,47,-14146.1,35,12,25181.649999999998,11035.549999999997
23669,U17843,47,14940.03,26,21,735065.36,750005.39
23670,U10861,47,-11832.07,34,13,195798.27,183966.19999999998
23671,U18842,47,-1148.3000000000013,33,14,15267.729999999996,14119.429999999995
23672,U29464,47,15305.629999999997,23,24,239686.04,254991.67
23673,U26272,47,-1612.8100000000013,41,6,2876.750000000001,1263.9399999999996
23674,U36628,47,1156.94,42,5,12152.52,13309.460000000001
23675,U21737,46,-1214.199999999999,33,13,93398.16999999998,92183.96999999999
23676,U27489,46,-7832.5599999999995,33,13,29962.569999999996,22130.009999999995
23677,U16125,46,-11670.64,39,7,19707.799999999996,8037.159999999996
23678,U25614,46,1983.6800000000014,32,14,56277.470000000016,58261.150000000016
23679,U1101756,46,-2328.8600000000083,28,18,199100.0,196771.13999999998
23680,U10621,46,-17226.279999999995,36,10,53516.509999999995,36290.229999999996
23681,U42556,46,27697.420000000002,20,26,64350.71,92048.13
23682,U19648,46,-3858.3199999999997,30,16,34497.73,30639.410000000003
23683,U19136,46,-9388.179999999997,29,17,76180.29,66792.11
23684,U8635,46,-31362.349999999995,29,17,91448.81,60086.46000000001
23685,U38580,46,-5873.949999999996,41,5,24322.75,18448.800000000003
23686,U22028,46,0.0,27,19,298537.65,298537.65
23687,U11831,46,-372527.1000000005,14,32,16144174.36,15771647.26
23688,U17010,46,-46449.00000000001,27,19,87588.41,41139.409999999996
23689,U29387,46,-153.76000000003842,22,24,588471.62,588317.86
23690,U23570,46,-3717.7400000000007,37,9,57128.16,53410.420000000006
23691,U11267,46,-373.92000000002326,10,36,941506.94,941133.0199999999
23692,U1221687,46,-1000.0899999999997,36,10,40443.26,39443.170000000006
23693,U16137,46,-4439.600000000001,23,23,34794.72,30355.12
23694,U20518,46,1553.1299999999987,36,10,60429.86000000001,61982.990000000005
23695,U19145,46,-6914.779999999999,29,17,98460.3,91545.52
23696,U18670,46,-8790.529999999999,32,14,181475.87,172685.34
23697,U1326415,46,-490.2100000000005,36,10,8605.98,8115.769999999999
23698,U10909,46,2029.4799999999893,27,19,137008.32000000004,139037.80000000002
23699,U27206,46,896121.7100000002,29,17,711372.22,1607493.9300000002
23700,U36723,46,-10027.61,27,19,61526.59000000001,51498.98000000001
23701,U1248061,46,7971.3600000000015,26,20,17515.22,25486.58
23702,U33599,46,-1801.1000000000008,32,14,11014.339999999998,9213.239999999998
23703,U41136,46,1659.2399999999998,14,32,49394.0,51053.24
23704,U10806,46,-2997.2200000000125,18,28,230230.12,227232.9
23705,U28980,46,-49334.12000000001,35,11,183157.09,133822.96999999997
23706,U23767,46,10926.790000000006,38,8,40178.25,51105.04000000001
23707,U8420,46,-5536.2,30,16,64999.1,59462.9
23708,U36060,46,320.4800000000005,32,14,8216.14,8536.619999999999
23709,U28157,46,-3720.68,36,10,34331.52,30610.839999999997
23710,U43388,46,13917.630000000005,41,5,54946.189999999995,68863.82
23711,U25798,46,-1358.22,32,14,37313.16,35954.94
23712,U12435,46,-7615.330000000009,35,11,661464.6899999998,653849.3599999999
23713,U8951,46,16522.64,31,15,61696.619999999995,78219.26
23714,U13351,46,-3876.91,35,11,24700.22,20823.31
23715,U32424,46,-9709.850000000006,30,16,115366.29000000001,105656.44
23716,U10811,46,-2861.13,42,4,4237.169999999999,1376.039999999999
23717,U9081,46,-14741.920000000004,32,14,130082.6,115340.68000000001
23718,U1343625,46,-1493.3,34,12,6080.689999999999,4587.3899999999985
23719,U24553,46,2594.2000000000003,39,7,14294.049999999996,16888.249999999996
23720,U32458,46,14.87,39,7,280.01,294.88
23721,U18486,46,976650.9000000003,35,11,2084568.11,3061219.0100000002
23722,U43586,46,-9504.289999999999,34,12,32537.719999999998,23033.43
23723,U10383,46,-142684.66999999993,33,13,607442.81,464758.14000000013
23724,U29946,46,1090857.34,8,38,1308668.2899999998,2399525.63
23725,U1184962,46,661.0499999999988,35,11,21734.469999999998,22395.519999999997
23726,U36292,46,326.4300000000003,35,11,12066.859999999999,12393.289999999999
23727,U19099,46,6043.510000000002,32,14,78767.25,84810.76000000001
23728,U40232,46,-7000.409999999998,16,30,130481.08999999998,123480.67999999998
23729,U1127652,46,-8481.709999999997,30,16,20680.409999999996,12198.699999999999
23730,U28632,46,-16.30000000000109,17,29,88636.91,88620.61
23731,U9240,46,-5041.7099999999955,25,21,1112426.92,1107385.21
23732,U39179,46,1897.0799999999986,33,13,158643.44999999998,160540.52999999997
23733,U15927,46,574.7599999999982,24,22,190105.80999999997,190680.56999999998
23734,U22506,46,-292.80000000000814,29,17,170641.11,170348.30999999997
23735,U15715,46,-12492.489999999874,17,29,1375822.2,1363329.71
23736,U41249,46,-12204.529999999992,28,18,89077.49999999999,76872.97
23737,U18590,46,229.6699999999939,41,5,96348.85,96578.52
23738,U28331,46,1404.4699999999114,43,3,1002596.3,1004000.7699999999
23739,U32101,46,-1830.7100000000064,20,26,590756.5700000001,588925.8600000001
23740,U8599,46,-1725.3900000000003,36,10,13691.109999999997,11965.719999999998
23741,U10392,46,816.6299999999991,38,8,10375.460000000017,11192.090000000017
23742,U30117,46,22780.559999999998,26,20,63007.350000000006,85787.91
23743,U15353,46,-27633.640000000014,37,9,49507.52000000001,21873.879999999997
23744,U15652,46,-108632.07,17,29,513289.0,404656.93
23745,U32698,46,-13186.899999999996,38,8,52951.28,39764.380000000005
23746,U27660,46,353.83000000000175,31,15,80858.93,81212.76
23747,U1250423,46,-9733.890000000001,42,4,16289.19,6555.299999999999
23748,U25544,46,-28420.500000000007,34,12,146977.69999999998,118557.19999999998
23749,U35869,46,3718.4699999999984,36,10,24055.04,27773.51
23750,U17531,46,-211215.02999999994,37,9,681845.4499999998,470630.4199999999
23751,U9685,46,10443.81,28,18,21002.6,31446.409999999996
23752,U34407,46,3236.8300000000017,37,9,107978.36000000002,111215.19000000002
23753,U29414,46,865.6299999999956,37,9,72229.77,73095.4
23754,U29201,46,11767.470000000001,21,25,47741.25,59508.72
23755,U26015,46,10140.730000000001,29,17,49156.15,59296.880000000005
23756,U20939,46,-8163.089999999998,36,10,31744.61,23581.520000000004
23757,U39363,46,-69904.46999999997,23,23,287070.89999999997,217166.43
23758,U1218845,46,-8385.69,35,11,16867.899999999998,8482.209999999997
23759,U40295,46,8676.219999999998,36,10,21910.34,30586.559999999998
23760,U29591,46,3804.609999999996,39,7,50374.32999999999,54178.93999999998
23761,U36418,46,-6501.72,37,9,111601.53,105099.81
23762,U39050,46,-5555.990000000001,32,14,14476.540000000005,8920.550000000003
23763,U29582,46,366.99000000000035,38,8,54028.040000000015,54395.03000000001
23764,U31525,46,-356.7499999999982,31,15,217432.51999999996,217075.76999999996
23765,U21510,46,-2982.8900000000012,37,9,33791.14000000001,30808.250000000007
23766,U28830,46,93657.54999999999,31,15,67963.17000000001,161620.72
23767,U35931,46,-2826.5800000000045,34,12,67532.14,64705.56
23768,U821944,46,-0.43000000000046157,29,17,7873.71,7873.28
23769,U41688,46,599989.3,38,8,40386.289999999986,640375.5900000001
23770,U9900,46,20104.190000000024,27,19,721756.4,741860.5900000001
23771,U18016,46,-5731.530000000001,37,9,49291.31000000001,43559.78000000001
23772,U11457,46,1316.1399999999912,33,13,193009.22999999995,194325.36999999994
23773,U14883,46,2366.769999999978,23,23,650620.72,652987.49
23774,U15156,46,-2986.540000000001,24,22,212768.28,209781.74
23775,U35891,46,59.880000000001964,33,13,8156.87,8216.750000000002
23776,U14986,46,-39774.73,29,17,117837.5,78062.76999999999
23777,U28616,46,174800.56,18,28,256578.58000000002,431379.14
23778,U26869,46,97173.91,33,13,4366.4400000000005,101540.35
23779,U798915,46,-2634.93,35,11,9371.340000000002,6736.410000000002
23780,U23174,46,-384.6099999999991,39,7,14257.56,13872.95
23781,U761108,46,-9462.09,27,19,64423.67,54961.58
23782,U1038697,46,-0.06000000000005912,29,17,1229.5,1229.44
23783,U31498,46,-11774.400000000001,33,13,76848.22999999998,65073.82999999998
23784,U23017,46,27556.580000000016,32,14,451546.21,479102.79000000004
23785,U20860,46,32157.31,37,9,183643.0,215800.31
23786,U22491,46,-225.0800000000001,31,15,2572.3000000000006,2347.2200000000007
23787,U622752,46,-11653.140000000001,32,14,62833.170000000006,51180.030000000006
23788,U37675,46,5997.049999999999,36,10,35027.240000000005,41024.29000000001
23789,U30935,46,10490.980000000005,31,15,289283.7099999999,299774.6899999999
23790,U33205,46,642.9799999999987,40,6,18985.190000000002,19628.170000000002
23791,U30433,46,2238.5899999999992,28,18,16278.550000000001,18517.14
23792,U23775,46,-1143.68,37,9,8989.75,7846.07
23793,U1037521,46,1.1368683772161603e-13,32,14,2752.01,2752.01
23794,U20763,46,-196226.91999999998,40,6,268776.98,72550.06
23795,U30005,46,143.9499999998218,38,8,1137934.33,1138078.2799999998
23796,U18924,46,-56732.66000000003,25,21,222755.12,166022.45999999996
23797,U16910,46,-222.0699999999997,29,17,45353.83,45131.76
23798,U39420,46,1919.7199999999993,31,15,18644.42,20564.14
23799,U41035,46,-2474.420000000002,36,10,69876.82,67402.40000000001
23800,U1247839,46,-29022.369999999995,33,13,78159.04000000001,49136.67000000001
23801,U15665,46,-1653.5899999999924,27,19,140247.59,138594.0
23802,U40919,46,25299.41,28,18,1034.8,26334.21
23803,U31640,46,2396.9500000000007,34,12,40355.600000000006,42752.55
23804,U23671,46,-1493.840000000011,32,14,120104.53000000003,118610.69000000002
23805,U17875,46,-3933.7,41,5,5502.579999999999,1568.8799999999992
23806,U38706,46,887.2100000000004,42,4,49130.16,50017.37
23807,U28709,46,-119.32000000000062,40,6,30263.16,30143.84
23808,U21522,46,-129.51000000000204,31,15,190048.49,189918.97999999998
23809,U33726,46,4102.55999999999,30,16,87533.15000000001,91635.70999999999
23810,U37444,46,2600.9000000000015,35,11,24590.53,27191.43
23811,U38601,46,73826.08,32,14,1824372.8499999999,1898198.93
23812,U33672,46,-64.36000000000013,42,4,3464.66,3400.2999999999997
23813,U18081,46,-81.33999999997832,27,19,756236.34,756155.0
23814,U39695,46,25626.820000000007,20,26,240425.51,266052.33
23815,U35516,46,-1.3642420526593924e-12,29,17,83444.54000000001,83444.54000000001
23816,U40297,46,11625.74,35,11,19655.029999999995,31280.769999999997
23817,U22348,46,-100194.79999999999,30,16,351119.07999999996,250924.27999999997
23818,U39526,46,1113.589999999998,31,15,24956.1,26069.689999999995
23819,U38450,46,-1448.8600000000013,38,8,13022.779999999999,11573.919999999998
23820,U745843,46,0.08000000000003382,36,10,514.94,515.0200000000001
23821,U27286,46,6463.43,36,10,6864.630000000001,13328.060000000001
23822,U9185,46,-154.9800000000023,22,24,45203.15,45048.17
23823,U1141366,46,-2394.6899999999996,38,8,5262.45,2867.76
23824,U28198,46,-1675.5000000000014,28,18,102141.99,100466.49
23825,U27781,46,-178.35000000000107,41,5,9586.969999999998,9408.619999999997
23826,U42489,46,48951.14,32,14,55144.0,104095.14
23827,U18171,46,5340.6299999999965,30,16,49438.37000000001,54779.00000000001
23828,U19644,46,24475.48,19,27,50808.16,75283.64
23829,U37130,46,-57856.56,31,15,117511.38,59654.82000000001
23830,U11310,46,8581.569999999996,40,6,28061.11,36642.67999999999
23831,U990874,46,760.2599999999998,20,26,30772.81,31533.07
23832,U27727,46,-935.74,41,5,2896.2000000000007,1960.4600000000007
23833,U19740,46,1657.0999999999985,29,17,63898.640000000014,65555.74000000002
23834,U20246,46,19.590000000000327,39,7,4003.3300000000004,4022.9200000000005
23835,U34775,46,58498.27000000002,22,24,855456.78,913955.05
23836,U32177,46,1142.160000000001,37,9,44173.96,45316.12
23837,U37911,46,-6925.670000000003,26,20,107732.25,100806.58
23838,U1341504,46,-2117.52,29,17,4588.11,2470.5899999999997
23839,U41841,46,-8432.16,37,9,35239.22000000001,26807.06000000001
23840,U16524,46,-3728.989999999998,35,11,119137.39,115408.4
23841,U1374749,46,-9078.75,31,15,16569.02,7490.27
23842,U31543,46,-80863.14,38,8,123495.13,42631.990000000005
23843,U14298,46,-12058.740000000018,31,15,143147.65999999997,131088.91999999995
23844,U35446,46,-9057.770000000002,22,24,121681.00000000001,112623.23000000001
23845,U16050,46,-13047.849999999999,39,7,15863.460000000001,2815.6100000000024
23846,U25215,46,-67926.34999999998,31,15,250302.85,182376.50000000003
23847,U43119,46,3414.0999999999985,40,6,12396.17,15810.269999999999
23848,U39451,46,-30358.56,30,16,48143.39999999999,17784.839999999986
23849,U27036,46,33330.909999999996,23,23,106619.70000000001,139950.61000000002
23850,U13455,46,466934.54,34,12,152672.0,619606.54
23851,U27881,46,8019.119999999997,35,11,13267.119999999999,21286.239999999998
23852,U9644,46,-17591.949999999964,35,11,359103.71,341511.76000000007
23853,U1160121,46,820.5599999999996,31,15,8041.169999999999,8861.73
23854,U40516,46,-1173.8099999999995,38,8,64245.64,63071.83
23855,U8539,46,-7683.3099999999995,38,8,15602.05,7918.74
23856,U28336,46,-30754.25,40,6,58968.409999999996,28214.159999999996
23857,U19752,46,-61562.81,40,6,122759.69,61196.880000000005
23858,U27300,46,13840.980000000001,34,12,7614.299999999997,21455.28
23859,U11824,46,10359.289999999999,28,18,47897.049999999996,58256.34
23860,U37140,46,122219.73999999999,31,15,136324.75,258544.49
23861,U9650,46,-280556.6900000004,20,26,3806180.3000000003,3525623.61
23862,U9227,46,-5305.8499999999985,34,12,21132.63,15826.780000000002
23863,U21209,46,2260.5299999999984,26,20,118994.25,121254.78
23864,U27903,46,259.1499999999978,34,12,47345.310000000005,47604.46000000001
23865,U26474,46,938.700000000001,34,12,93716.56999999999,94655.26999999999
23866,U39220,46,-4994.250000000003,34,12,69200.22,64205.97
23867,U17122,46,12751.789999999997,35,11,99272.97,112024.76
23868,U19986,46,-51874.73000000001,29,17,139811.87,87937.13999999998
23869,U35939,46,6449.4100000000035,20,26,469027.0,475476.41000000003
23870,U13004,46,-37617.61,39,7,112511.69999999998,74894.08999999998
23871,U25858,46,10202.889999999992,30,16,254539.78,264742.67
23872,U10209,46,51119.34,34,12,138072.75,189192.09
23873,U18728,46,-700793.48,24,22,4014858.0500000003,3314064.5700000003
23874,U25660,46,2952.92,33,13,9184.18,12137.1
23875,U30531,46,1555.2300000000032,28,18,243813.87,245369.1
23876,U24830,46,54864.490000000005,32,14,1703500.97,1758365.46
23877,U26070,46,39166.77,31,15,82962.84999999999,122129.62
23878,U19126,46,10000.359999999993,41,5,14144.75000000001,24145.11
23879,U16191,46,-4193.7099999999955,31,15,259400.45999999996,255206.74999999997
23880,U14517,46,250.69999999999936,36,10,11730.26,11980.96
23881,U14204,46,-13615.779999999997,33,13,161766.27000000002,148150.49000000002
23882,U960910,46,234.25999999999976,30,16,8974.77,9209.03
23883,U1350080,46,-6869.1900000000005,43,3,12869.190000000002,6000.000000000002
23884,U26641,46,2638.519999999998,31,15,158673.9,161312.41999999998
23885,U14971,46,121912.77999999991,21,25,2092839.56,2214752.34
23886,U29405,46,-5738.459999999999,36,10,11656.99,5918.530000000001
23887,U594438,46,-3360.13,36,10,23086.78,19726.649999999998
23888,U12510,46,1298.4300000000003,31,15,23746.82,25045.25
23889,U11041,46,1153.5900000000001,34,12,12129.669999999998,13283.259999999998
23890,U29425,46,65678.54999999999,35,11,8230.7,73909.24999999999
23891,U17794,46,-8654.669999999998,33,13,548177.6300000001,539522.9600000001
23892,U31690,46,5051.260000000003,30,16,71192.02,76243.28000000001
23893,U35001,46,-127423.15000000015,31,15,1914933.6800000002,1787510.53
23894,U1245459,46,-11520.979999999998,33,13,14667.469999999998,3146.49
23895,U1047681,46,48.48000000000005,26,20,2523.17,2571.65
23896,U24471,46,-15535.59,30,16,108987.83000000003,93452.24000000003
23897,U14292,46,-7298.690000000002,29,17,218411.44,211112.75
23898,U9854,46,985245.4100000001,24,22,4125227.38,5110472.79
23899,U25984,46,-2831.239999999999,32,14,100219.55,97388.31
23900,U747918,46,14.0,27,19,17106.559999999998,17120.559999999998
23901,U34348,46,-1226.0199999999986,40,6,17878.17,16652.15
23902,U29229,46,2621.7800000000043,30,16,100244.99,102866.77
23903,U15346,46,-7155.999999999996,26,20,205255.08999999997,198099.08999999997
23904,U22382,46,-55.67000000001879,36,10,57817.11000000001,57761.43999999999
23905,U1110290,46,-427.320000000001,35,11,7725.33,7298.009999999999
23906,U24060,46,-70718.13,28,18,361067.97000000003,290349.84
23907,U42595,46,-799.789999999996,28,18,154682.05,153882.25999999998
23908,U39820,46,36626.56999999999,21,25,187579.62,224206.19
23909,U27012,46,-846.030000000004,39,7,100847.22000000002,100001.19000000002
23910,U9505,46,3840.930000000001,21,25,60248.73,64089.66
23911,U14053,46,110474.00999999994,27,19,1306390.84,1416864.85
23912,U38991,46,-9024.130000000005,24,22,173585.26,164561.13
23913,U9180,46,-11919.990000000002,41,5,27304.239999999998,15384.249999999996
23914,U9233,46,27333.61999999999,26,20,132037.66000000003,159371.28000000003
23915,U31475,46,-28878.120000000006,40,6,69178.62999999998,40300.509999999966
23916,U39578,46,-707.12,38,8,16272.26,15565.14
23917,U39659,45,14572.079999999987,25,20,248264.4,262836.48
23918,U840147,45,-8320.82,38,7,13972.600000000002,5651.7800000000025
23919,U24232,45,-2491.7599999999975,28,17,89165.78,86674.02
23920,U39037,45,49122.09,35,10,21571.96,70694.04999999999
23921,U27362,45,1399.3500000000004,33,12,10939.69,12339.04
23922,U1256745,45,41.37000000000119,24,21,7820.349999999999,7861.72
23923,U42804,45,-8291.36,33,12,54432.47,46141.11
23924,U39892,45,4415.860000000001,33,12,96392.48999999999,100808.34999999999
23925,U23835,45,6464.490000000002,27,18,334648.21,341112.7
23926,U42689,45,745.0099999999973,35,10,27120.460000000006,27865.470000000005
23927,U13221,45,1707.3900000000003,39,6,4392.07,6099.46
23928,U627899,45,-7293.700000000001,28,17,42358.93,35065.229999999996
23929,U26951,45,-883.7199999999993,25,20,98614.0,97730.28
23930,U14220,45,-69700.30999999998,31,14,350569.08999999997,280868.77999999997
23931,U28538,45,-38665.70999999999,33,12,106608.14999999998,67942.43999999999
23932,U20439,45,182.43000000000006,40,5,1717.76,1900.19
23933,U15971,45,-562.7600000000057,35,10,42767.1,42204.34
23934,U37167,45,-5270.69,35,10,10887.229999999998,5616.539999999998
23935,U23733,45,73816.69999999998,32,13,227690.55000000002,301507.25
23936,U28484,45,-6198.200000000004,35,10,96832.32,90634.12
23937,U32077,45,-23611.11,31,14,66825.41,43214.3
23938,U9558,45,1669.88,30,15,278548.53,280218.41000000003
23939,U18143,45,4395.119999999999,35,10,40938.59,45333.70999999999
23940,U14310,45,-60175.12,36,9,127698.21,67523.09
23941,U27969,45,18157.930000000008,24,21,345760.44,363918.37
23942,U34190,45,-52.68000000000015,39,6,15555.0,15502.32
23943,U678033,45,-9521.37,29,16,62834.51,53313.14
23944,U12411,45,8696.219999999987,30,15,240013.31000000003,248709.53000000003
23945,U20349,45,2211.510000000002,40,5,104992.71,107204.22
23946,U14605,45,-5914.099999999995,27,18,138974.12,133060.02
23947,U24796,45,42331.89,33,12,37991.87999999999,80323.76999999999
23948,U25180,45,-57.649999999999885,42,3,1858.2299999999998,1800.58
23949,U24824,45,-128969.88999999993,37,8,907936.1899999998,778966.2999999999
23950,U28596,45,27253.5,24,21,149122.13,176375.63
23951,U15741,45,-98.64999999999952,38,7,7810.31,7711.660000000001
23952,U26607,45,10754.759999999998,28,17,62287.869999999995,73042.62999999999
23953,U36270,45,-6171.789999999999,38,7,19691.9,13520.110000000002
23954,U25555,45,6071.1900000000005,37,8,4589.64,10660.830000000002
23955,U35362,45,-185149.64999999997,33,12,451549.0499999998,266399.39999999985
23956,U27134,45,5861.139999999981,19,26,2898496.91,2904358.0500000003
23957,U680255,45,-2443.3900000000003,28,17,20959.379999999997,18515.989999999998
23958,U25307,45,-6631.879999999999,33,12,58018.799999999996,51386.92
23959,U724060,45,-9174.1,34,11,29406.930000000008,20232.83000000001
23960,U28783,45,-4965.709999999999,38,7,23191.019999999997,18225.309999999998
23961,U26854,45,10031.77,34,11,9893.9,19925.67
23962,U14596,45,21681.68,27,18,163030.68000000002,184712.36000000002
23963,U25619,45,15731.489999999998,33,12,78867.98999999999,94599.47999999998
23964,U36626,45,-419.2799999999993,26,19,43152.86000000001,42733.58000000001
23965,U40334,45,7524.6500000000015,31,14,36595.62,44120.270000000004
23966,U12803,45,-4095.0600000000018,28,17,35725.68000000001,31630.620000000006
23967,U21204,45,94564.23000000001,33,12,7056.87,101621.1
23968,U40010,45,-273741.98,41,4,273742.05,0.07000000000698492
23969,U23875,45,-849.769999999999,36,9,36378.850000000006,35529.08000000001
23970,U36805,45,196612.78000000003,39,6,54592.8,251205.58000000002
23971,U33302,45,-16334.810000000027,33,12,854565.11,838230.2999999999
23972,U39579,45,-1887.6700000000149,24,21,433576.62,431688.94999999995
23973,U31031,45,21326.16,31,14,28234.17,49560.33
23974,U42727,45,1087.0799999999945,18,27,154243.0,155330.08
23975,U40723,45,956.6199999999999,36,9,21256.620000000003,22213.24
23976,U9111,45,-638.15,33,12,42726.979999999996,42088.829999999994
23977,U33298,45,5405.450000000001,36,9,29044.059999999994,34449.509999999995
23978,U20509,45,-1277.87,42,3,6324.2,5046.33
23979,U12856,45,2250.700000000006,38,7,50115.78999999999,52366.49
23980,U9079,45,34.539999999999736,38,7,10163.99,10198.529999999999
23981,U33915,45,-2982.4900000000057,36,9,71316.05999999998,68333.56999999998
23982,U40677,45,-1685.1200000000076,37,8,102898.85,101213.73
23983,U32014,45,-676.4000000000028,28,17,39311.74,38635.34
23984,U10993,45,-72105.52,27,18,215046.20999999996,142940.68999999994
23985,U1113437,45,-1714.9999999999995,32,13,13369.130000000001,11654.130000000001
23986,U29986,45,2351.519999999997,36,9,64769.23,67120.75
23987,U8677,45,9776.839999999998,30,15,41933.23,51710.07
23988,U10275,45,-3942.8800000000338,34,11,282570.55,278627.6699999999
23989,U32726,45,57588.460000000014,35,10,42744.50999999999,100332.97
23990,U9849,45,1529.8500000000006,31,14,15540.610000000002,17070.460000000003
23991,U1111169,45,-3043.0799999999995,37,8,13811.0,10767.92
23992,U8256,45,-1328.77,43,2,1344.5900000000001,15.820000000000164
23993,U31109,45,3894.5399999999927,32,13,147257.6,151152.13999999998
23994,U16118,45,-99856.95999999999,29,16,325222.38,225365.42
23995,U36415,45,40523.16,21,24,134272.55,174795.71
23996,U18021,45,-19211.350000000002,42,3,21460.06,2248.709999999999
23997,U42562,45,-5168.530000000001,30,15,17390.8,12222.269999999999
23998,U9998,45,6139.050000000002,28,17,35589.14,41728.19
23999,U33415,45,-53189.16,38,7,61610.280000000006,8421.120000000003
24000,U8041,45,-1827.9700000000012,35,10,10325.17,8497.199999999999
24001,U28790,45,-109297.50999999998,28,17,304868.61000000004,195571.10000000006
24002,U28078,45,-121.11000000000001,38,7,1025.38,904.2700000000001
24003,U16966,45,-2476.0200000000004,32,13,43474.36,40998.34
24004,U42161,45,-884.2800000000001,34,11,11321.869999999999,10437.589999999998
24005,U12806,45,2090.5500000000015,36,9,35783.65,37874.200000000004
24006,U38790,45,-52979.29,30,15,93830.68,40851.38999999999
24007,U30548,45,623.5899999999992,41,4,15048.91,15672.5
24008,U33156,45,5532.1500000000015,32,13,22541.760000000002,28073.910000000003
24009,U39581,45,6855.619999999982,34,11,687797.34,694652.96
24010,U34390,45,-15800.670000000002,40,5,40013.049999999996,24212.379999999994
24011,U35569,45,6178.590000000001,43,2,3084.98,9263.570000000002
24012,U16489,45,12.410000000010768,36,9,178738.99,178751.4
24013,U17574,45,-2035825.6199999999,29,16,2510432.21,474606.5900000001
24014,U13527,45,16690.25,32,13,21026.489999999998,37716.74
24015,U15596,45,1392.8400000000017,24,21,131271.59,132664.43
24016,U30921,45,-68553.78000000003,27,18,365313.0,296759.22
24017,U33166,45,-33475.09,29,16,135329.59,101854.5
24018,U1236301,45,10769.480000000001,28,17,67730.65,78500.12999999999
24019,U39004,45,12273.490000000007,33,12,93593.93000000001,105867.42000000001
24020,U43750,45,-22327.34000000001,37,8,47022.51,24695.16999999999
24021,U11828,45,-40666.32,22,23,76075.12999999999,35408.80999999999
24022,U27666,45,9703.13,31,14,60921.670000000006,70624.8
24023,U23487,45,394.8700000000026,23,22,108926.28,109321.15
24024,U38069,45,-23714.769999999997,30,15,116097.18,92382.41
24025,U40467,45,-17448.54,30,15,56421.47,38972.93
24026,U31860,45,37789.75999999998,27,18,207688.8,245478.55999999997
24027,U35904,45,1599.7500000000005,35,10,10568.27,12168.02
24028,U10855,45,131313.13,30,15,628529.56,759842.6900000001
24029,U759261,45,0.7100000000092166,31,14,159906.28999999998,159907.0
24030,U18477,45,-423318.6,26,19,1288317.15,864998.5499999999
24031,U18708,45,55835.19000000003,20,25,379305.69,435140.88
24032,U34220,45,-3247.760000000002,34,11,20276.54,17028.78
24033,U42194,45,-504.8899999999994,40,5,6054.39,5549.500000000001
24034,U43795,45,19921.87,36,9,106040.64000000003,125962.51000000002
24035,U8704,45,-23195.299999999996,38,7,64686.50000000001,41491.20000000001
24036,U24547,45,62.7899999999961,37,8,62051.26999999998,62114.059999999976
24037,U37373,45,-43454.82000000001,29,16,1138059.26,1094604.44
24038,U36131,45,-3641.9100000000053,25,20,190885.72,187243.81
24039,U42248,45,-9003.570000000002,28,17,160664.12999999998,151660.55999999997
24040,U18119,45,513.1100000000001,32,13,12568.95,13082.060000000001
24041,U850310,45,238.65999999999818,33,12,32526.760000000002,32765.420000000002
24042,U41742,45,10930.429999999975,20,25,211587.11,222517.53999999995
24043,U1053244,45,277.0,39,6,14489.0,14766.0
24044,U29320,45,-3669.1599999997215,34,11,2009693.57,2006024.4100000004
24045,U41689,45,-60952.90999999996,34,11,403443.2799999999,342490.36999999994
24046,U42474,45,30223.93,23,22,75939.35,106163.28
24047,U30831,45,815.4599999999627,25,20,581340.6499999999,582156.1099999999
24048,U14717,45,33952.729999999996,34,11,82945.09000000001,116897.82
24049,U12693,45,-17510.27,38,7,41023.32000000001,23513.050000000007
24050,U36687,45,-20252.15999999998,31,14,346421.18,326169.02
24051,U29228,45,-18075.719999999994,35,10,625685.9200000002,607610.2000000002
24052,U41158,45,-14918.240000000005,29,16,142306.72,127388.48
24053,U11553,45,251.79999999999978,34,11,37628.03,37879.83
24054,U14136,45,29649.840000000004,27,18,131696.28,161346.12
24055,U589156,45,-3.149999999999636,26,19,14001.390000000001,13998.240000000002
24056,U39728,45,28130.839999999993,30,15,49356.420000000006,77487.26
24057,U16202,45,89288.86000000002,37,8,284576.31,373865.17000000004
24058,U1019705,45,0.5699999999998404,29,16,2553.46,2554.0299999999997
24059,U39183,45,-341568.91000000003,28,17,973176.41,631607.5
24060,U18029,45,-20907.44,30,15,37157.05,16249.610000000004
24061,U10665,45,1373.8000000000002,37,8,11728.0,13101.8
24062,U29674,45,31.500000000014552,26,19,212378.92,212410.42000000004
24063,U21343,45,36.780000000000655,24,21,42496.68,42533.46
24064,U25791,45,-2308.239999999999,30,15,29436.0,27127.760000000002
24065,U17339,45,-26111.27,28,17,161474.33,135363.06
24066,U17126,45,-9048.67,40,5,16727.170000000002,7678.500000000002
24067,U22571,45,-470753.7099999999,27,18,1446938.52,976184.81
24068,U28738,45,7100.870000000001,42,3,3448.08,10548.95
24069,U38929,45,5595.310000000003,26,19,80372.6,85967.91
24070,U903422,45,-42030.579999999994,29,16,72665.16,30634.58000000001
24071,U25673,45,17223.379999999997,27,18,159561.00000000003,176784.38000000003
24072,U27720,45,-13400.529999999999,27,18,186510.16,173109.63
24073,U31099,45,19944.58,33,12,144925.99999999997,164870.57999999996
24074,U24758,45,-8629.829999999994,35,10,82417.43000000001,73787.6
24075,U19326,45,16564.73,37,8,29468.850000000006,46033.58
24076,U25020,45,210.8299999999988,33,12,13909.480000000001,14120.31
24077,U15729,45,-26083.71999999997,31,14,524552.59,498468.87
24078,U15787,45,-23743.26,38,7,97081.00000000001,73337.74000000002
24079,U35325,45,-3275.759999999973,26,19,203904.42999999996,200628.66999999998
24080,U19183,45,-9769.129999999994,20,25,181799.71999999997,172030.58999999997
24081,U9177,45,-5674.75,38,7,20809.59,15134.84
24082,U39240,45,127.15999999999943,38,7,35025.090000000004,35152.25
24083,U35145,45,-34.84999999999985,26,19,29631.719999999998,29596.87
24084,U622383,45,-907.3699999999999,27,18,9610.02,8702.650000000001
24085,U21837,45,3918.029999999995,32,13,108247.41,112165.44
24086,U43696,45,67631.0,34,11,26570.069999999996,94201.06999999999
24087,U37571,45,4474.519999999997,35,10,12343.659999999996,16818.179999999993
24088,U27464,45,-6008.460000000004,29,16,90717.54000000001,84709.08
24089,U1246276,45,-5698.210000000001,31,14,18691.320000000003,12993.110000000002
24090,U15874,45,-42767.0300000001,26,19,825359.6699999999,782592.6399999998
24091,U24628,45,56056.78999999974,31,14,2748620.39,2804677.1799999997
24092,U25143,45,1985.3899999999994,33,12,30823.709999999995,32809.09999999999
24093,U24222,45,-10650.459999999988,26,19,319159.33,308508.87000000005
24094,U18653,45,-1016.4699999999984,37,8,27195.09,26178.620000000003
24095,U29142,45,-619386.14,33,12,641480.03,22093.890000000014
24096,U8418,45,5097.989999999999,29,16,70711.28,75809.27
24097,U22848,45,-81481.67,25,20,363129.47,281647.8
24098,U19869,45,-45460.39,18,27,280797.32,235336.93
24099,U43559,45,-1229.850000000001,29,16,39361.83000000001,38131.98000000001
24100,U8025,45,965069.28,27,18,941643.8599999999,1906713.14
24101,U40017,45,-18453.169999999995,41,4,89547.17,71094.0
24102,U38209,45,2082.3899999999985,37,8,9524.169999999998,11606.559999999998
24103,U34245,45,-125708.08000000002,29,16,859171.0,733462.9199999999
24104,U38755,45,290.2299999999991,27,18,60870.33,61160.56
24105,U15496,45,-53657.19000000002,32,13,204712.91,151055.71999999997
24106,U33924,45,29329.25,30,15,178749.0,208078.25
24107,U22417,45,-31918.62,42,3,37512.89,5594.27
24108,U27035,45,-7996.689999999999,34,11,51568.94,43572.25
24109,U28852,45,-150030.13999999998,27,18,343130.01,193099.87000000002
24110,U34378,45,-168.3399999999965,32,13,491824.64,491656.30000000005
24111,U13348,45,6944.740000000042,22,23,405770.62,412715.36000000004
24112,U41510,45,-241753.55000000002,32,13,280762.42,39008.869999999966
24113,U1212264,45,2723.31,27,18,10821.21,13544.519999999999
24114,U902130,45,-1466.1499999999965,33,12,35491.28,34025.130000000005
24115,U8913,45,-7742.65,32,13,90906.62000000002,83163.97000000003
24116,U16873,45,128808.61000000003,25,20,1119113.7999999998,1247922.41
24117,U19233,45,-26240.17,37,8,62764.8,36524.630000000005
24118,U23142,45,31655.699999999997,31,14,292526.08999999997,324181.79
24119,U36908,45,-191747.73000000004,16,29,231899.9,40152.169999999955
24120,U43308,45,14000.0,18,27,433256.82,447256.82
24121,U40881,45,-11955.230000000001,37,8,96005.12999999999,84049.9
24122,U28620,45,9023.679999999997,37,8,20284.90999999999,29308.589999999986
24123,U43744,45,525.8099999999831,28,17,1749088.51,1749614.32
24124,U9792,45,25966.159999999996,36,9,1029517.0199999999,1055483.18
24125,U20910,45,-6415.960000000005,27,18,131207.0,124791.04
24126,U14704,45,1886.0800000000345,16,29,2563871.4299999997,2565757.51
24127,U25895,45,2840.6300000000047,31,14,38174.19,41014.82000000001
24128,U23667,45,-1219.9200000000003,35,10,3180.7200000000003,1960.8
24129,U23182,45,-18552.73,40,5,52160.69,33607.96000000001
24130,U9335,45,-21.640000000007376,35,10,55896.65000000001,55875.01
24131,U41610,45,6990.059999999996,40,5,24321.759999999995,31311.819999999992
24132,U11453,45,3903.9400000000023,24,21,77713.9,81617.84
24133,U775437,45,-5598.36,40,5,8945.529999999999,3347.169999999999
24134,U37904,45,2727.4699999999993,32,13,15453.019999999999,18180.489999999998
24135,U14913,45,-7761.780000000001,39,6,29861.920000000002,22100.14
24136,U42339,45,-158944.40999999997,39,6,217991.36000000002,59046.95000000004
24137,U43852,45,780.6799999999994,31,14,38374.34999999999,39155.02999999999
24138,U32266,45,9013.180000000088,30,15,1359974.7900000003,1368987.9700000004
24139,U43395,45,2142.1300000000265,31,14,331881.8300000001,334023.9600000001
24140,U17571,45,-84399.14000000003,30,15,601913.21,517514.06999999995
24141,U34689,45,231.38999999999942,24,21,1400682.48,1400913.8699999999
24142,U8462,45,369.070000000007,28,17,265487.5,265856.57
24143,U35369,45,-4844.390000000001,36,9,40805.39,35961.0
24144,U13753,45,21763.2,34,11,66347.6,88110.8
24145,U19792,45,-1498.0100000000002,41,4,1520.38,22.36999999999989
24146,U12821,45,17740.98,38,7,44831.77999999999,62572.759999999995
24147,U15213,45,465.14999999999645,30,15,108714.33999999998,109179.48999999998
24148,U15019,45,54888.450000000004,29,16,198785.70999999996,253674.15999999997
24149,U11138,45,-10004.269999999917,26,19,1222898.31,1212894.04
24150,U577428,45,2704.560000000002,25,20,111192.91999999998,113897.47999999998
24151,U21017,45,-2872.4399999999987,28,17,82756.85,79884.41
24152,U44070,45,132446.54,24,21,76765.42,209211.96000000002
24153,U39973,45,119629.1,25,20,184940.0,304569.1
24154,U33001,45,-5128.879999999999,14,31,169091.1,163962.22
24155,U1221157,45,0.34000000000082764,23,22,8018.929999999999,8019.27
24156,U1333318,45,34.24000000000003,27,18,9124.080000000002,9158.320000000002
24157,U36449,45,3000.7999999999993,30,15,53303.95999999999,56304.759999999995
24158,U13500,45,-291.3699999999999,26,19,23473.960000000003,23182.590000000004
24159,U12228,45,-25110.910000000007,38,7,43154.6,18043.68999999999
24160,U8367,45,-15990.75,30,15,784036.0,768045.25
24161,U42282,45,12016.14,41,4,7803.42,19819.559999999998
24162,U24941,45,1463.0800000000017,27,18,282268.0,283731.08
24163,U42360,45,2786.4999999999964,25,20,77741.23,80527.73
24164,U683443,45,21319.839999999993,34,11,45784.18,67104.01999999999
24165,U15768,45,-1383.2899999999995,23,22,20596.15,19212.86
24166,U1344695,45,-10638.960000000003,37,8,14736.350000000002,4097.389999999999
24167,U27655,45,32234.979999999992,27,18,64173.91000000001,96408.89
24168,U19953,45,526408.05,24,21,667486.38,1193894.4300000002
24169,U38647,45,749.0999999999999,42,3,2481.79,3230.89
24170,U28823,45,-110.35000000000286,34,11,70311.5,70201.15
24171,U11504,45,779.1799999999903,23,22,234663.59,235442.77
24172,U42119,44,-353.2799999999984,26,18,50702.65,50349.37
24173,U24852,44,2355.82,42,2,1144.18,3500.0
24174,U9521,44,17875.70000000001,18,26,509986.0,527861.7
24175,U12226,44,30287.380000000005,32,12,183176.91999999998,213464.3
24176,U1319886,44,-2139.6699999999996,28,16,5009.389999999999,2869.72
24177,U8354,44,-48030.47,36,8,99891.02,51860.55
24178,U36175,44,-1901.5799999999995,23,21,12503.480000000003,10601.900000000003
24179,U34539,44,5926.510000000002,29,15,29857.56,35784.07000000001
24180,U795638,44,-5422.39,34,10,10046.44,4624.05
24181,U8494,44,1315.8499999999995,39,5,4200.580000000004,5516.430000000003
24182,U692307,44,-155.9300000000003,33,11,16160.11,16004.18
24183,U21264,44,297.7300000000004,30,14,2213.27,2511.0000000000005
24184,U12013,44,-19962.309999999994,39,5,33795.49,13833.180000000004
24185,U43651,44,20311.160000000003,34,10,16706.8,37017.96000000001
24186,U10241,44,-11347.279999999997,35,9,19200.739999999998,7853.460000000001
24187,U26453,44,-23905.32,34,10,50922.0,27016.68
24188,U42501,44,18786.25,25,19,26388.89,45175.14
24189,U19159,44,-5716.180000000005,33,11,37872.96000000001,32156.780000000002
24190,U36014,44,1379.0000000000002,39,5,8693.34,10072.34
24191,U16197,44,-940.0400000000018,29,15,130980.61,130040.56999999999
24192,U21060,44,-1440.0399999999918,24,20,294490.75,293050.71
24193,U17773,44,-10958.809999999998,26,18,71041.81999999999,60083.009999999995
24194,U27561,44,-17765.12,40,4,19106.12,1341.0
24195,U40679,44,78956.74,36,8,7707.2699999999995,86664.01000000001
24196,U22942,44,29497.979999999996,21,23,302712.67,332210.64999999997
24197,U35218,44,8309.369999999999,35,9,16347.4,24656.769999999997
24198,U30830,44,0.2800000000000602,33,11,2702.16,2702.44
24199,U42940,44,-4141.2300000000005,31,13,17645.32,13504.09
24200,U26776,44,-13185.689999999999,40,4,13970.919999999998,785.2299999999996
24201,U33645,44,-749.97,39,5,867.94,117.97000000000003
24202,U35985,44,662.0600000000003,34,10,14197.099999999999,14859.159999999998
24203,U31363,44,-1834.5499999999997,35,9,13155.519999999999,11320.97
24204,U1012913,44,-187.65,41,3,423.84,236.18999999999997
24205,U22635,44,-4846.719999999994,23,21,164226.03,159379.31
24206,U17551,44,1521.400000000012,25,19,116525.37000000001,118046.77000000002
24207,U38133,44,-154.47999999999774,22,22,146120.1,145965.62
24208,U16800,44,-2601.5499999999847,38,6,74302.64,71701.09000000001
24209,U21724,44,-11012.41,40,4,21517.33,10504.920000000002
24210,U36884,44,-34023.84,30,14,181630.06999999995,147606.22999999995
24211,U23983,44,-54658.53000000006,26,18,541717.6599999999,487059.1299999999
24212,U39739,44,-440.4899999999995,20,24,4131.999999999999,3691.5099999999998
24213,U31561,44,44.56000000000131,34,10,19564.800000000003,19609.360000000004
24214,U625424,44,-17132.059999999998,27,17,44893.380000000005,27761.320000000007
24215,U43319,44,-44721.68000000002,26,18,265074.98,220353.29999999996
24216,U24890,44,-513.9199999999998,43,1,2013.92,1500.0000000000002
24217,U9338,44,1345.340000000001,23,21,25174.53,26519.87
24218,U39428,44,-3014.15,29,15,9011.670000000002,5997.520000000002
24219,U12048,44,-9087.049999999997,37,7,32883.619999999995,23796.57
24220,U20622,44,-154.70999999999978,34,10,7707.19,7552.48
24221,U32299,44,-9783.369999999999,32,12,20779.07,10995.7
24222,U14679,44,112264.93999999997,32,12,109849.15000000001,222114.08999999997
24223,U27936,44,3395.4800000000014,34,10,49519.99,52915.47
24224,U30272,44,-709.3700000000105,20,24,401022.5,400313.13
24225,U27057,44,-3809.5500000000175,33,11,265810.49,262000.93999999997
24226,U586515,44,-444.97000000000116,23,21,78211.0,77766.03
24227,U43089,44,-5316.679999999998,16,28,1496169.04,1490852.36
24228,U14086,44,-3515.809999999999,33,11,63942.189999999995,60426.38
24229,U13109,44,2967.040000000001,35,9,21685.73,24652.77
24230,U42705,44,1608.5599999999988,30,14,19095.199999999997,20703.759999999995
24231,U12782,44,746.269999999979,26,18,203445.91999999998,204192.18999999997
24232,U11506,44,815.1399999999985,34,10,12697.489999999998,13512.629999999997
24233,U777128,44,-1727.1099999999992,25,19,21430.719999999994,19703.609999999993
24234,U17876,44,-16198.79,32,12,80667.03,64468.24
24235,U36761,44,11500.79,36,8,68520.04999999999,80020.84
24236,U31165,44,-294.20000000000056,26,18,13150.5,12856.3
24237,U31195,44,3188.2400000000052,29,15,214906.84,218095.08000000002
24238,U41051,44,18766.44,20,24,52950.479999999996,71716.92
24239,U14635,44,20647.65999999999,31,13,240546.62,261194.27999999997
24240,U20881,44,76663.03000000001,24,20,107003.25000000001,183666.28000000003
24241,U21669,44,703.0999999999958,32,12,113814.89999999998,114517.99999999997
24242,U11227,44,5367.380000000004,36,8,33114.729999999996,38482.11
24243,U8866,44,497.49000000000035,34,10,8172.87,8670.36
24244,U1221214,44,-956.4799999999996,33,11,12676.220000000001,11719.740000000002
24245,U594753,44,-36029.62,35,9,38899.630000000005,2870.010000000002
24246,U29532,44,85019.92000000003,37,7,25553.33,110573.25000000003
24247,U40640,44,-23721.97,28,16,465625.64,441903.67000000004
24248,U20337,44,-42930.700000000004,31,13,144978.91999999998,102048.21999999997
24249,U31747,44,-2675.8799999999974,24,20,89428.0,86752.12
24250,U35698,44,-70260.89,35,9,127460.9,57200.009999999995
24251,U17318,44,-4170.809999999989,12,32,960560.0,956389.1900000001
24252,U35640,44,-285.0100000000001,37,7,12983.36,12698.35
24253,U23209,44,3397.220000000001,32,12,32629.47,36026.69
24254,U13008,44,-2157.6499999999996,42,2,2986.4399999999996,828.79
24255,U12091,44,7758.1900000000005,39,5,1537.9099999999999,9296.1
24256,U26483,44,3222.080000000008,31,13,179711.34999999998,182933.43
24257,U10094,44,29782.82,29,15,51819.37,81602.19
24258,U36188,44,-3202.6800000000203,24,20,264285.63,261082.94999999998
24259,U12644,44,5948.890000000036,27,17,227106.98999999996,233055.88
24260,U9140,44,274695.52,31,13,43159.82,317855.34
24261,U39465,44,12005.929999999968,21,23,679619.2300000001,691625.16
24262,U38507,44,-666.4100000000001,34,10,3058.49,2392.08
24263,U1071738,44,-3258.9,35,9,4873.69,1614.7899999999995
24264,U1360209,44,6644.98,32,12,19111.660000000007,25756.640000000007
24265,U35753,44,1293.949999999997,29,15,49534.05,50828.0
24266,U42522,44,-32333.160000000003,30,14,117463.56,85130.4
24267,U18104,44,-14180.660000000003,36,8,71829.91,57649.25
24268,U32767,44,-15010.130000000016,33,11,118458.3,103448.16999999998
24269,U23181,44,-1299.4800000000062,37,7,124533.38,123233.9
24270,U40050,44,-985555.16,31,13,1784478.8,798923.64
24271,U42020,44,-3982.0600000000013,35,9,40334.21000000001,36352.15000000001
24272,U741763,44,-3591.14,22,22,21882.559999999998,18291.42
24273,U11437,44,14781.08,29,15,65182.00000000001,79963.08
24274,U33223,44,-477.9999999999998,37,7,4900.2,4422.2
24275,U38331,44,67.41000000000022,30,14,14206.630000000001,14274.04
24276,U1124689,44,-4830.630000000001,34,10,9993.630000000001,5163.0
24277,U22951,44,8443.2,35,9,17513.109999999997,25956.309999999998
24278,U30994,44,3974.3799999999983,28,16,20289.22,24263.6
24279,U9269,44,-127972.86999999997,26,18,302161.18000000005,174188.31000000008
24280,U17836,44,3399.6699999999955,31,13,273386.55,276786.22
24281,U23625,44,-129326.81999999993,32,12,428657.46,299330.6400000001
24282,U21144,44,32907.28999999999,33,11,315167.88,348075.17
24283,U30395,44,-6813.049999999999,34,10,70850.88,64037.83
24284,U25898,44,-371605.04000000004,40,4,719118.79,347513.75
24285,U26864,44,5530.8199999999915,27,17,274072.92,279603.74
24286,U15463,44,-5602.810000000002,25,19,206856.22000000003,201253.41000000003
24287,U29627,44,-7796.98,28,16,29021.980000000003,21225.000000000004
24288,U39154,44,-909.0600000000004,39,5,5773.54,4864.48
24289,U25906,44,-2218.27,34,10,15245.82,13027.55
24290,U24664,44,-998.0500000000011,37,7,8161.420000000001,7163.37
24291,U34262,44,-24220.36999999999,33,11,116365.28,92144.91
24292,U17611,44,-11486.15,28,16,28293.35,16807.199999999997
24293,U14342,44,-30971.430000000008,35,9,469121.92,438150.49
24294,U1294711,44,-666.48,33,11,3750.9100000000003,3084.4300000000003
24295,U37557,44,-832.99,40,4,2086.26,1253.2700000000002
24296,U20226,44,-27177.63,39,5,49827.21,22649.579999999998
24297,U41523,44,2911.3799999999974,34,10,103272.42,106183.79999999999
24298,U43539,44,16401.5,38,6,22520.710000000003,38922.21000000001
24299,U43929,44,12086.929999999995,38,6,13747.359999999999,25834.289999999994
24300,U42054,44,-110838.72000000002,31,13,707773.61,596934.89
24301,U28138,44,2355.429999999998,26,18,126811.84999999999,129167.27999999998
24302,U9688,44,285862.7600000001,33,11,574713.8800000001,860576.6400000002
24303,U1107663,44,-1210.0100000000002,26,18,4240.680000000001,3030.670000000001
24304,U28802,44,-140597.05999999997,33,11,184684.93,44087.870000000024
24305,U34905,44,682.2,33,11,9977.679999999998,10659.88
24306,U31009,44,-18474.649999999998,27,17,110862.93000000001,92388.28000000001
24307,U30459,44,-0.7999999999959251,25,19,319115.66000000003,319114.86000000004
24308,U24528,44,52.97000000000003,32,12,29002.28,29055.25
24309,U41059,44,196882.11,31,13,535982.97,732865.08
24310,U9758,44,-7.410000000032596,22,22,1210364.0,1210356.5899999999
24311,U16471,44,-680.830000000009,20,24,164652.27,163971.43999999997
24312,U35857,44,257.98000000000553,29,15,76214.04,76472.02
24313,U29216,44,-1522.6699999999914,24,20,126321.77,124799.1
24314,U31889,44,-884.6799999999995,33,11,56451.34,55566.659999999996
24315,U32607,44,6493.210000000001,33,11,19633.32,26126.53
24316,U23505,44,-802.0899999999908,32,12,269064.02,268261.93000000005
24317,U27765,44,5433.070000000001,41,3,4836.93,10270.0
24318,U23506,44,707.9,39,5,2265.15,2973.05
24319,U40169,44,40558.19000000001,29,15,116039.02999999998,156597.22
24320,U23980,44,-138535.25,36,8,231337.34000000003,92802.09000000003
24321,U9554,44,-14216.180000000095,28,16,1127208.14,1112991.9599999997
24322,U19989,44,142.3599999999983,36,8,56137.4,56279.76
24323,U31093,44,-112409.27999999993,25,19,2778176.3000000003,2665767.0200000005
24324,U28546,44,-7105.40999999996,25,19,377884.64,370779.23000000004
24325,U35233,44,-3836.0899999999983,31,13,21710.730000000007,17874.640000000007
24326,U25151,44,825.6899999999996,30,14,21558.579999999994,22384.269999999993
24327,U31324,44,-10836.590000000004,26,18,63594.469999999994,52757.87999999999
24328,U15660,44,-982.8899999999976,36,8,15996.66,15013.770000000002
24329,U25537,44,-2995.96,36,8,22218.729999999996,19222.769999999997
24330,U15347,44,-2741.230000000003,33,11,31536.640000000003,28795.41
24331,U24013,44,-7670.289999999995,35,9,88243.15999999999,80572.87
24332,U13082,44,-373261.7199999999,25,19,3915024.6,3541762.8800000004
24333,U13018,44,-1118976.97,33,11,2102616.79,983639.8200000001
24334,U917618,44,-4769.800000000001,36,8,26042.590000000004,21272.79
24335,U16143,44,31527.879999999994,26,18,173592.28,205120.16
24336,U796823,44,14.27000000000055,27,17,9193.649999999998,9207.919999999998
24337,U35928,44,-4349.88,40,4,15472.67,11122.79
24338,U899090,44,-30.479999999999563,30,14,43918.270000000004,43887.79000000001
24339,U11622,44,14097.510000000002,34,10,21289.370000000003,35386.880000000005
24340,U41656,44,5719.990000000001,34,10,11528.609999999999,17248.6
24341,U16635,44,155498.59999999998,25,19,933449.17,1088947.77
24342,U18718,44,25841.910000000007,35,9,192752.38999999993,218594.29999999993
24343,U9290,44,-26307.77,33,11,43638.28,17330.51
24344,U18875,44,2754.7300000000005,30,14,12694.489999999998,15449.219999999998
24345,U11860,44,-15759.69,40,4,24133.699999999997,8374.009999999997
24346,U39382,44,-26445.699999999997,39,5,69942.3,43496.600000000006
24347,U8618,44,596.0400000000002,33,11,39944.19,40540.23
24348,U43098,44,-67021.48000000004,21,23,1148379.5299999998,1081358.0499999998
24349,U20649,44,-14604.490000000009,35,9,152704.22,138099.72999999998
24350,U42524,44,-793.3199999999997,21,23,44712.759999999995,43919.439999999995
24351,U42154,44,-4522.11,35,9,12528.41,8006.3
24352,U20152,44,64.91000000000031,30,14,17231.16,17296.07
24353,U623563,44,-4294.53,36,8,13310.5,9015.970000000001
24354,U748473,44,1451.56,35,9,7696.32,9147.88
24355,U43523,44,-19702.68,35,9,104862.44,85159.76000000001
24356,U33887,44,-9338.139999999998,35,9,112897.17999999996,103559.03999999996
24357,U32692,44,-1429.879999999997,40,4,209367.07,207937.19
24358,U8792,44,-50.27000000000021,36,8,24421.54,24371.27
24359,U30582,44,80582.17,28,16,338947.45,419529.62
24360,U11392,44,-728.6000000000003,29,15,14789.200000000003,14060.600000000002
24361,U41488,44,-3400.1900000000005,33,11,15322.339999999998,11922.149999999998
24362,U38471,44,-479.1999999999999,28,16,653.18,173.98000000000008
24363,U29989,44,-16130.68,27,17,43681.61,27550.93
24364,U37375,44,-7070.0,35,9,20975.489999999998,13905.489999999998
24365,U579532,44,-8024.140000000001,30,14,24945.38,16921.239999999998
24366,U18344,44,8386.14,37,7,45283.740000000005,53669.880000000005
24367,U30298,44,-466438.69999999995,25,19,2359945.0,1893506.3
24368,U12268,44,-675.2499999999982,31,13,81578.27999999998,80903.02999999998
24369,U28687,44,60919.759999999995,12,32,193185.11,254104.87
24370,U30209,44,-3078.299999999994,31,13,102677.17,99598.87000000001
24371,U19248,44,-22012.93,34,10,72855.8,50842.87
24372,U10491,44,1.8189894035458565e-12,22,22,49185.39,49185.39
24373,U8373,44,18407.2,31,13,63004.64000000001,81411.84000000001
24374,U40816,44,-11538.210000000001,23,21,186617.16,175078.95
24375,U15440,44,9431.149999999987,18,26,256394.03,265825.18
24376,U43817,44,-149726.80999999994,30,14,672011.63,522284.82000000007
24377,U29312,44,-1216.930000000002,22,22,54670.68,53453.75
24378,U34444,44,-22.06,32,12,189759.03000000003,189736.97000000003
24379,U23599,44,-3493.01,31,13,90163.29,86670.28
24380,U969270,44,48.43999999999996,24,20,796.66,845.0999999999999
24381,U1073882,44,9.689999999999998,33,11,513.55,523.24
24382,U34949,44,2420.1000000000004,38,6,13262.929999999998,15683.029999999999
24383,U24288,44,732.3299999999996,18,26,88136.0,88868.33
24384,U977555,44,-9472.14,35,9,52972.14,43500.0
24385,U40351,44,9161.78000000002,24,20,214268.92999999996,223430.71
24386,U43362,44,-26700.999999999996,30,14,102938.46,76237.46
24387,U28017,44,65565.54000000001,31,13,554343.3500000001,619908.8900000001
24388,U822893,44,-11.840000000000003,37,7,1215.23,1203.39
24389,U16425,44,-4659.269999999995,24,20,131412.05,126752.78
24390,U968761,44,-6358.68,39,5,7744.719999999999,1386.039999999999
24391,U30955,44,-1359.7500000000014,25,19,244555.1,243195.35
24392,U953164,44,-551.7999999999994,23,21,20475.410000000003,19923.610000000004
24393,U33041,44,-19600.11000000001,36,8,125416.86999999995,105816.75999999994
24394,U9124,44,106.06999999999968,34,10,48148.60999999999,48254.67999999999
24395,U19565,44,-4211.539999999999,41,3,39498.13000000002,35286.59000000002
24396,U36355,44,-335.93999999999977,38,6,15962.029999999999,15626.089999999998
24397,U29733,44,20668.520000000008,23,21,211418.65000000002,232087.17000000004
24398,U22232,44,-439.68000000000075,27,17,27116.729999999996,26677.049999999996
24399,U32297,44,-5021.689999999997,33,11,50985.32,45963.630000000005
24400,U12894,44,477.9999999999982,19,25,1573987.49,1574465.49
24401,U796085,43,87.93000000000028,25,18,7017.179999999999,7105.11
24402,U689971,43,89072.95000000003,30,13,53198.28000000001,142271.23000000004
24403,U1368352,43,-6924.9400000000005,22,21,17273.39,10348.449999999999
24404,U31548,43,5588.309999999998,24,19,50659.46,56247.77
24405,U18464,43,-940.2600000000001,32,11,14162.400000000001,13222.140000000001
24406,U12660,43,-25335.379999999997,34,9,54595.36999999999,29259.98999999999
24407,U25206,43,-203.88000000000005,36,7,11744.73,11540.85
24408,U24175,43,175050.61999999988,16,27,1328892.0,1503942.6199999999
24409,U37751,43,5781.300000000001,24,19,75976.31999999999,81757.62
24410,U9946,43,-220007.66,24,19,266045.0,46037.34
24411,U39026,43,-18495.54,38,5,20706.3,2210.7599999999984
24412,U39833,43,13325.779999999992,31,12,117826.45,131152.22999999998
24413,U24514,43,46.789999999999864,37,6,374.4299999999996,421.21999999999946
24414,U13861,43,-485.3399999999997,37,6,25686.79,25201.45
24415,U8141,43,779.8300000000017,36,7,20156.52,20936.350000000002
24416,U11030,43,79268.77000000002,24,19,277003.97000000003,356272.74000000005
24417,U23176,43,6475.699999999997,26,17,35787.31,42263.009999999995
24418,U36693,43,3361.9100000000003,36,7,8843.15,12205.06
24419,U19303,43,-2270.420000000002,27,16,172226.62999999998,169956.20999999996
24420,U41391,43,20087.36,34,9,416940.24000000005,437027.60000000003
24421,U34339,43,-44101.19,23,20,185054.64,140953.45
24422,U9853,43,-213786.18000000002,33,10,240026.38,26240.199999999983
24423,U37279,43,6120.779999999999,28,15,253834.34,259955.12
24424,U20308,43,96491.50999999992,31,12,843027.6400000002,939519.1500000001
24425,U11838,43,-9591.71999999999,34,9,257739.45000000004,248147.73000000004
24426,U12643,43,-10072.649999999998,33,10,58601.57,48528.92
24427,U29950,43,66915.86,28,15,177836.13999999996,244751.99999999994
24428,U28019,43,608981.7300000001,15,28,150412.58000000002,759394.31
24429,U17661,43,-13154.580000000016,32,11,341939.7399999999,328785.15999999986
24430,U10486,43,-53561.44,28,15,121268.60000000002,67707.16000000002
24431,U39932,43,9719.949999999999,33,10,22802.14,32522.089999999997
24432,U34787,43,-15880.970000000001,40,3,29218.019999999997,13337.049999999996
24433,U31074,43,-43728.64,33,10,114441.04000000001,70712.40000000001
24434,U28376,43,9311.570000000002,34,9,34681.0,43992.57
24435,U22963,43,-135622.07,35,8,222986.33000000002,87364.26000000001
24436,U41593,43,-16489.17,29,14,70693.95,54204.78
24437,U11039,43,-80197.85,23,20,437382.75,357184.9
24438,U41779,43,70.59000000002561,29,14,411415.39999999997,411485.99
24439,U36299,43,2773.1399999999994,32,11,12189.31,14962.449999999999
24440,U32986,43,0.020000000000436557,21,22,66100.0,66100.02
24441,U16739,43,-1731.819999999997,27,16,86859.56,85127.74
24442,U9129,43,1000.1500000000306,28,15,604008.9400000002,605009.0900000002
24443,U28847,43,6753.340000000003,27,16,85230.2,91983.54
24444,U9398,43,143515.63,30,13,57807.41999999999,201323.05
24445,U12248,43,-70411.02,31,12,318206.44,247795.41999999998
24446,U17760,43,-7803.82,38,5,13933.289999999999,6129.469999999999
24447,U33578,43,10945.26999999999,29,14,467003.10000000003,477948.37
24448,U19473,43,20954.050000000003,31,12,90084.55,111038.6
24449,U41588,43,-14352.509999999993,36,7,116708.97,102356.46
24450,U40731,43,-65968.21999999997,23,20,346853.73000000004,280885.51000000007
24451,U33164,43,720.9900000000018,26,17,53605.560000000005,54326.55000000001
24452,U16438,43,-24778.12,34,9,73406.63,48628.51000000001
24453,U1154390,43,448.4399999999996,13,30,38446.69,38895.130000000005
24454,U944741,43,645.2900000000006,31,12,13068.91,13714.2
24455,U1375258,43,50.01000000000113,23,20,15054.5,15104.510000000002
24456,U28242,43,2916.2999999999993,35,8,20268.089999999986,23184.389999999985
24457,U34396,43,1747.5099999999966,37,6,115949.20999999999,117696.71999999999
24458,U26486,43,-2777.2200000000003,35,8,14578.95,11801.73
24459,U991623,43,10.13000000000011,28,15,14558.8,14568.93
24460,U13399,43,8821.590000000002,35,8,20158.74,28980.33
24461,U20313,43,629.869999999999,37,6,30102.36,30732.23
24462,U39302,43,1714.8199999999997,34,9,16017.05,17731.87
24463,U23862,43,-490.9400000000003,38,5,13614.119999999999,13123.179999999998
24464,U20176,43,4699.95,26,17,24394.78,29094.73
24465,U1251821,43,5647.529999999996,19,24,27107.559999999998,32755.089999999993
24466,U43621,43,-1093.0400000000006,29,14,13253.120000000003,12160.080000000002
24467,U30148,43,-4436.160000000001,36,7,15566.49,11130.329999999998
24468,U21838,43,-5928.8600000000015,22,21,84423.33,78494.47
24469,U40788,43,1953.3000000000002,37,6,1960.1000000000004,3913.4000000000005
24470,U13041,43,-98304.91999999993,30,13,2849193.5,2750888.58
24471,U32250,43,111348.63,28,15,46475.990000000005,157824.62
24472,U8688,43,-6600.379999999996,28,15,108111.01999999996,101510.63999999997
24473,U12269,43,-540.6000000000026,27,16,156079.2,155538.6
24474,U29289,43,-17754.110000000004,36,7,49064.32000000001,31310.210000000003
24475,U35852,43,-727.4999999999854,22,21,734969.46,734241.96
24476,U25993,43,1260.6200000000026,32,11,37274.9,38535.520000000004
24477,U31639,43,-1410.8699999999953,30,13,407678.0,406267.13
24478,U16597,43,-11041.930000000002,29,14,92537.40000000002,81495.47000000002
24479,U19480,43,-6905.5599999999995,36,7,37197.649999999994,30292.089999999997
24480,U41613,43,19679.96,24,19,37565.25,57245.21
24481,U25004,43,746.2499999999995,34,9,65916.0,66662.25
24482,U11905,43,23392.43,35,8,54896.15,78288.58
24483,U1323859,43,707.4900000000005,28,15,9031.349999999999,9738.839999999998
24484,U36069,43,828.9199999999995,34,9,19748.569999999992,20577.48999999999
24485,U30882,43,13378.020000000002,38,5,113224.87000000001,126602.89000000001
24486,U28612,43,1434.0000000000055,24,19,98417.59,99851.59
24487,U15021,43,1452.8799999999947,22,21,65737.63,67190.51
24488,U37747,43,13428.659999999987,36,7,80694.18,94122.83999999998
24489,U1217399,43,1710.86,26,17,6803.43,8514.29
24490,U41457,43,-1792.2799999999952,12,31,282666.66000000003,280874.38000000006
24491,U19891,43,-10263.42,26,17,41108.64,30845.22
24492,U9351,43,-17157.45999999999,30,13,170688.36,153530.9
24493,U1161066,43,-4560.04,27,16,21586.239999999998,17026.199999999997
24494,U42777,43,-7229.229999999997,31,12,87509.37999999998,80280.14999999998
24495,U19433,43,-20258.829999999998,28,15,112667.37999999999,92408.54999999999
24496,U10331,43,-28968.870000000003,38,5,32078.789999999997,3109.9199999999946
24497,U8092,43,16092.32,35,8,15132.960000000001,31225.28
24498,U43109,43,93.50999999999931,35,8,14107.31,14200.82
24499,U44055,43,9775.859999999997,27,16,53754.25999999999,63530.11999999998
24500,U13991,43,2882.749999999989,23,20,214371.72,217254.47
24501,U19546,43,201273.76000000004,32,11,98207.61,299481.37000000005
24502,U35538,43,1146.02,38,5,1855.41,3001.4300000000003
24503,U10542,43,-6103.800000000001,19,24,109889.50000000001,103785.70000000001
24504,U38975,43,10578.02,28,15,50994.729999999996,61572.75
24505,U37155,43,-16957.829999999998,40,3,17243.1,285.27000000000044
24506,U9885,43,-1658.5599999999886,28,15,337086.39,335427.83
24507,U966172,43,7.600000000000364,22,21,19253.6,19261.199999999997
24508,U34774,43,43272.92999999998,35,8,162140.9,205413.82999999996
24509,U26205,43,-1674.1699999999987,38,5,8075.569999999999,6401.4
24510,U28914,43,13637.440000000002,36,7,175083.5,188720.94
24511,U894698,43,-2769.84,33,10,6613.840000000001,3844.000000000001
24512,U35173,43,-8524.749999999985,19,24,2162013.58,2153488.83
24513,U1085967,43,-1059.7199999999998,36,7,3410.9200000000005,2351.2000000000007
24514,U17745,43,1126.6300000000028,24,19,97899.55000000002,99026.18000000002
24515,U33692,43,-2119.0099999999998,25,18,34014.490000000005,31895.480000000007
24516,U18910,43,7331.5599999999995,33,10,31976.480000000003,39308.04
24517,U8830,43,-865.4399999999941,37,6,132866.85,132001.41
24518,U10697,43,2186.429999999999,25,18,128961.34,131147.77
24519,U40752,43,-1662.19,39,4,3786.2,2124.0099999999998
24520,U38140,43,406467.99,18,25,3117335.31,3523803.3
24521,U10630,43,20753.649999999998,32,11,83172.52,103926.17
24522,U19070,43,-11911.509999999987,33,10,57975.34999999999,46063.840000000004
24523,U20283,43,1339.5099999999986,27,16,34587.56,35927.07
24524,U17657,43,-17648.459999999995,8,35,70161.8,52513.34000000001
24525,U30104,43,2364.5000000000027,29,14,65861.24,68225.74
24526,U38970,43,21969.639999999665,20,23,4677429.07,4699398.71
24527,U30208,43,-3930.939999999995,30,13,38867.17,34936.23
24528,U34900,43,-224.90000000000026,29,14,9597.47,9372.57
24529,U704616,43,-823.27,24,19,4329.16,3505.89
24530,U38257,43,-33680.91000000003,38,5,1308000.0,1274319.0899999999
24531,U1118172,43,-8133.619999999999,34,9,20830.549999999996,12696.929999999997
24532,U19978,43,-33846.07,39,4,40519.08,6673.010000000002
24533,U656670,43,296.4700000000001,40,3,948.5300000000001,1245.0000000000002
24534,U41953,43,3349.5,35,8,6013.5599999999995,9363.06
24535,U1073946,43,-3442.8300000000017,28,15,131944.72999999998,128501.89999999998
24536,U798381,43,-19881.510000000002,42,1,19882.210000000003,0.7000000000007276
24537,U43066,43,-233311.13000000003,24,19,905043.78,671732.65
24538,U17253,43,129883.20000000003,22,21,704202.0,834085.2000000001
24539,U28782,43,-10394.230000000001,25,18,95559.6,85165.37000000001
24540,U39909,43,-3394.4999999999927,31,12,96674.65,93280.15
24541,U23957,43,-2.0099999999947613,27,16,343055.37,343053.36
24542,U33443,43,-10738.77,33,10,18735.989999999998,7997.2199999999975
24543,U9348,43,4138.790000000015,26,17,100297.59999999999,104436.39000000001
24544,U32118,43,-3162.6099999999997,31,12,3426.9500000000003,264.3400000000006
24545,U12087,43,-13641.65,36,7,16290.53,2648.880000000001
24546,U15124,43,-50027.41,24,19,225066.13,175038.72
24547,U24047,43,-5933.64,26,17,43500.590000000004,37566.950000000004
24548,U24989,43,-333489.96,30,13,628581.3599999999,295091.39999999985
24549,U39211,43,9001.450000000006,27,16,201302.16999999998,210303.62
24550,U1195383,43,-2032.96,42,1,2052.96,20.0
24551,U9176,43,-413.0599999999995,31,12,24246.26,23833.199999999997
24552,U36111,43,-3514.1699999999973,31,12,130721.16,127206.99
24553,U9407,43,-6722.57,36,7,31118.78,24396.21
24554,U9199,43,-3392.2800000000007,30,13,108844.59,105452.31
24555,U19111,43,128920.43999999999,25,18,63599.920000000006,192520.36
24556,U18907,43,90856.37999999999,30,13,16865.7,107722.07999999999
24557,U28199,43,-67446.0,25,18,403967.55,336521.55
24558,U11354,43,-38192.67000000002,33,10,389852.66,351659.98999999993
24559,U10062,43,5361.58,38,5,2040.3000000000002,7401.88
24560,U1350430,43,1311.9399999999998,37,6,4564.160000000001,5876.1
24561,U15185,43,15275.479999999996,20,23,255334.52000000002,270610.0
24562,U18377,43,13045.930000000002,21,22,9986.429999999998,23032.36
24563,U10805,43,-17987.260000000006,25,18,184513.5,166526.24
24564,U10981,43,-11744.459999999994,31,12,48054.33,36309.87000000001
24565,U34488,43,50735.159999999996,30,13,90117.93,140853.09
24566,U15061,43,-45002.68000000001,30,13,110245.26000000001,65242.58
24567,U1171193,43,-6600.780000000001,34,9,6645.6,44.81999999999971
24568,U34953,43,19665.06000000001,27,16,134220.83999999997,153885.89999999997
24569,U44011,43,-16306.190000000017,12,31,357702.04,341395.85
24570,U37496,43,257.62999999999965,34,9,11463.19,11720.82
24571,U1195956,43,-6651.700000000001,29,14,17308.520000000004,10656.820000000003
24572,U28529,43,-58.83000000000129,31,12,36677.189999999995,36618.35999999999
24573,U32558,43,1811.0699999999993,21,22,32190.63,34001.7
24574,U14183,43,27735.48,29,14,199140.84000000003,226876.32000000004
24575,U12870,43,11184.339999999997,35,8,37166.229999999996,48350.56999999999
24576,U34589,43,7699.090000000002,37,6,9966.5,17665.590000000004
24577,U35706,43,-24863.690000000002,23,20,71961.26000000001,47097.57000000001
24578,U1370063,43,23.659999999999854,25,18,35137.33,35160.990000000005
24579,U30164,43,3085.09,17,26,47692.9,50777.990000000005
24580,U28358,43,1894.7699999999986,31,12,90565.77,92460.54000000001
24581,U9659,43,-709.169999999999,29,14,19285.88,18576.710000000003
24582,U41965,43,-6723.270000000001,37,6,190459.37000000002,183736.10000000003
24583,U23976,43,8460.429999999995,26,17,231634.35,240094.78
24584,U33430,43,-1728.47,38,5,4700.3,2971.83
24585,U35554,43,-1199.05,34,9,44865.03,43665.979999999996
24586,U35906,43,-15796.029999999964,34,9,395277.76,379481.73000000004
24587,U903445,43,8749.560000000001,25,18,20050.3,28799.86
24588,U32847,43,-20441.729999999996,23,20,125092.45,104650.72
24589,U36688,43,-3430.8599999999997,30,13,53257.149999999994,49826.28999999999
24590,U15557,43,-13498.990000000003,34,9,37743.799999999996,24244.80999999999
24591,U19374,43,298633.8500000001,20,23,145031.41999999998,443665.2700000001
24592,U1218393,43,-2318.25,27,16,17523.68,15205.43
24593,U12068,43,-29040.52000000008,13,30,2452018.66,2422978.14
24594,U16273,43,-239992.74999999997,20,23,746180.2,506187.44999999995
24595,U38985,43,-3332.2400000000084,27,16,155826.69,152494.44999999998
24596,U38903,43,690.7499999999991,33,10,18360.92,19051.67
24597,U19470,43,241.1699999999987,38,5,13249.73,13490.899999999998
24598,U35223,43,9762.18999999999,29,14,109902.84,119665.02999999998
24599,U13149,43,37487.96,25,18,37600.86,75088.82
24600,U35273,43,33216.67,19,24,295420.24,328636.91
24601,U25359,43,200256.31999999998,40,3,5109.6799999999985,205365.99999999997
24602,U26575,43,4896.86,37,6,2689.37,7586.23
24603,U37854,43,-2895.550000000003,35,8,62906.7,60011.149999999994
24604,U27047,43,-861.9100000000008,28,15,50400.659999999996,49538.74999999999
24605,U10393,43,667.7299999999599,37,6,199438.91,200106.63999999996
24606,U29062,43,12997.83,30,13,29195.180000000004,42193.01
24607,U16261,43,-10601.109999999995,25,18,232731.49999999997,222130.38999999998
24608,U1270001,43,-3671.3,26,17,11997.3,8326.0
24609,U14269,43,64319.110000000015,27,16,452125.01999999996,516444.13
24610,U10353,43,-24089.0,38,5,79869.67999999996,55780.679999999964
24611,U19282,43,658.2600000000017,39,4,7442.039999999999,8100.300000000001
24612,U9484,43,3889.660000000001,31,12,19891.059999999994,23780.719999999994
24613,U38846,43,-4637.1500000000015,32,11,67604.0,62966.85
24614,U16998,43,45249.360000000015,27,16,226078.58,271327.94
24615,U26498,43,-412681.70999999996,20,23,565936.5100000001,153254.80000000016
24616,U988237,43,85350.20000000001,20,23,42920.02,128270.22
24617,U18402,43,4868.96,36,7,2998.3,7867.26
24618,U16599,43,47796.159999999996,23,20,169053.53999999998,216849.69999999998
24619,U28216,43,25694.889999999996,20,23,262258.94,287953.83
24620,U17904,43,-318.81999999999846,34,9,25919.95,25601.13
24621,U36779,43,1874.0700000000088,21,22,92693.98999999999,94568.06
24622,U12034,43,46.480000000009426,27,16,176212.78000000003,176259.26000000004
24623,U1345979,43,1020.1300000000012,34,9,12553.729999999998,13573.859999999999
24624,U12408,43,-92.15999999999744,30,13,71598.68,71506.51999999999
24625,U23882,43,-4620.079999999999,28,15,65860.6,61240.520000000004
24626,U37834,43,-30462.010000000006,29,14,217299.30000000002,186837.29
24627,U18787,43,322.1400000001304,22,21,8116100.0,8116422.140000001
24628,U28819,43,-5205.71,35,8,7167.08,1961.37
24629,U27536,43,-628.4199999999928,26,17,126318.06,125689.64
24630,U35841,43,-132.88999999999942,36,7,12754.11,12621.220000000001
24631,U12020,43,-32188.029999999995,31,12,100015.04999999999,67827.01999999999
24632,U30417,43,1523.6100000000006,27,16,15761.05,17284.66
24633,U41882,43,926.3300000000004,36,7,3312.140000000001,4238.470000000001
24634,U38721,43,-13556.490000000018,24,19,798067.7000000001,784511.2100000001
24635,U39908,43,65368.2,29,14,148253.97000000006,213622.17000000004
24636,U30377,43,-17964.469999999998,33,10,110068.56,92104.09
24637,U25596,43,-27505.590000000015,26,17,367096.42,339590.82999999996
24638,U36357,43,14628.349999999999,33,10,6658.67,21287.019999999997
24639,U40654,43,-0.4499999999998181,22,21,6751.93,6751.4800000000005
24640,U36811,43,25191.290000000008,33,10,78827.31999999999,104018.61
24641,U1188179,43,-16734.969999999998,30,13,29505.739999999998,12770.77
24642,U13775,43,31473.49999999999,22,21,117845.83,149319.33
24643,U24372,43,1488.8399999999983,31,12,31012.27,32501.11
24644,U37073,43,-10513.059999999998,28,15,122142.34,111629.28
24645,U1194645,43,-4834.109999999996,28,15,96291.35,91457.24
24646,U17066,43,59009.410000000076,26,17,1077699.5999999999,1136709.01
24647,U26047,43,548.7800000000007,36,7,35644.35999999999,36193.13999999999
24648,U36709,43,4577.5199999999995,21,22,82250.86,86828.38
24649,U14956,43,5320.189999999958,28,15,434244.6599999999,439564.84999999986
24650,U15504,43,-7170.100000000007,27,16,506522.55,499352.44999999995
24651,U39717,43,4834.860000000001,27,16,41695.149999999994,46530.009999999995
24652,U23779,43,-7276.629999999979,22,21,220584.10000000003,213307.47000000006
24653,U40707,43,-108.36999999999533,34,9,62481.59,62373.22
24654,U32703,43,-127071.11999999995,35,8,341714.24999999994,214643.13
24655,U13731,42,13703.810000000001,33,9,59357.30999999999,73061.12
24656,U590584,42,-5004.81,36,6,11738.2,6733.39
24657,U32251,42,17230.55,32,10,89301.51999999999,106532.06999999999
24658,U1374419,42,-6752.340000000001,39,3,8589.54,1837.1999999999998
24659,U23132,42,-2781.4300000000117,27,15,144481.53999999998,141700.10999999996
24660,U1151136,42,-4147.33,32,10,6423.88,2276.55
24661,U32212,42,71188.98999999999,19,23,323497.96,394686.95
24662,U37960,42,337.62,34,8,2268.53,2606.15
24663,U27987,42,-586.1500000000007,30,12,15268.239999999998,14682.089999999997
24664,U29667,42,-3953.940000000002,21,21,79900.55,75946.61
24665,U38220,42,37146.09,23,19,73086.5,110232.59
24666,U31708,42,60613.64999999998,20,22,346534.57,407148.22
24667,U32289,42,48875.01999999999,23,19,163752.16,212627.18
24668,U27908,42,-1210.6199999999953,14,28,252036.0,250825.38
24669,U1124723,42,-1473.48,28,14,8868.120000000003,7394.640000000003
24670,U19966,42,-32422.670000000002,31,11,60778.399999999994,28355.729999999992
24671,U11961,42,8860.52,32,10,53233.87,62094.39
24672,U18814,42,101364.23,23,19,142814.5,244178.72999999998
24673,U18460,42,4613.7300000000005,32,10,21520.470000000005,26134.200000000004
24674,U16108,42,11264.609999999957,35,7,197127.78,208392.38999999996
24675,U38400,42,32539.21,25,17,3531.6200000000003,36070.83
24676,U33613,42,10440.070000000002,34,8,13240.3,23680.370000000003
24677,U39588,42,4806.460000000028,27,15,637805.28,642611.7400000001
24678,U15490,42,-104236.70999999951,15,27,13151140.0,13046903.290000001
24679,U1273300,42,-4469.409999999998,29,13,26824.230000000003,22354.820000000007
24680,U13724,42,1446.4600000000028,26,16,25088.12,26534.58
24681,U23852,42,-265962.42,35,7,763055.9099999999,497093.48999999993
24682,U642938,42,-5114.5,33,9,17713.14,12598.64
24683,U23557,42,4158.530000000001,23,19,7682.880000000001,11841.410000000002
24684,U9874,42,51838.53,27,15,166554.0,218392.53
24685,U17028,42,-12506.160000000033,20,22,1215487.55,1202981.3900000001
24686,U33749,42,-390.04000000000013,35,7,7027.02,6636.9800000000005
24687,U9065,42,432056.59,37,5,599188.0199999999,1031244.6099999999
24688,U692071,42,-2163.37,38,4,5699.17,3535.8
24689,U13071,42,67.16000000000085,28,14,20028.459999999992,20095.61999999999
24690,U25795,42,-5861.620000000001,39,3,14863.52,9001.9
24691,U11235,42,-8.409999999999854,25,17,73205.48000000001,73197.07
24692,U18274,42,259.15999999999667,25,17,120687.11000000002,120946.27000000002
24693,U34200,42,-538.4799999999999,39,3,7377.44,6838.96
24694,U25230,42,69989.74,18,24,193025.80000000002,263015.54000000004
24695,U21574,42,-2774.6500000000015,35,7,102775.0,100000.35
24696,U26032,42,-7401.910000000002,38,4,18744.16,11342.249999999998
24697,U39128,42,362224.07999999996,20,22,1023132.0,1385356.08
24698,U10663,42,28468.360000000004,29,13,203141.41,231609.77000000002
24699,U20843,42,-8.0,41,1,42.0,34.0
24700,U30750,42,-8443.29,30,12,108741.41,100298.12
24701,U17005,42,-65224.21999999999,16,26,867131.1399999999,801906.9199999999
24702,U32553,42,3650.500000000009,32,10,217061.72,220712.22
24703,U14559,42,3019.8300000000017,21,21,175146.93,178166.76
24704,U20571,42,-2156.020000000003,30,12,19761.62,17605.599999999995
24705,U38925,42,13183.01000000001,34,8,301094.37,314277.38
24706,U38036,42,97529.78,18,24,153918.13999999998,251447.91999999998
24707,U17978,42,891.5999999999976,23,19,156355.37,157246.97
24708,U615860,42,563.0000000000005,28,14,15886.13,16449.13
24709,U24926,42,1102.1200000000026,28,14,214501.64,215603.76
24710,U41336,42,-4044.489999999999,27,15,31661.550000000003,27617.060000000005
24711,U14063,42,2967.6899999999987,35,7,77666.74,80634.43000000001
24712,U17749,42,96598.02,24,18,127510.65,224108.66999999998
24713,U13461,42,-403.7099999999998,36,6,9429.630000000001,9025.920000000002
24714,U40975,42,89242.01999999997,18,24,344262.76,433504.77999999997
24715,U16173,42,-84144.71,34,8,111499.69,27354.979999999996
24716,U1104441,42,2546.4700000000003,23,19,29704.120000000003,32250.590000000004
24717,U14065,42,-4383.329999999999,31,11,48317.149999999994,43933.81999999999
24718,U15187,42,302291.13999999984,27,15,361573.57,663864.7099999998
24719,U29811,42,-82128.07,28,14,329331.55,247203.47999999998
24720,U8730,42,-384214.1799999999,22,20,2348625.39,1964411.2100000002
24721,U15815,42,262443.91000000003,33,9,399828.80000000005,662272.7100000001
24722,U35209,42,-3515.630000000001,33,9,67087.20000000001,63571.57000000001
24723,U21729,42,-176.21999999998366,39,3,75237.98999999998,75061.76999999999
24724,U37470,42,3415.7299999999877,28,14,94274.35,97690.07999999999
24725,U9694,42,24461.729999999996,24,18,141901.99,166363.71999999997
24726,U29835,42,8333.070000000003,33,9,30994.41,39327.48
24727,U35029,42,-905.9000000000008,38,4,6662.390000000002,5756.490000000002
24728,U41722,42,53024.78,33,9,35300.65,88325.43
24729,U10492,42,-50194.780000000006,38,4,50819.42,624.6399999999921
24730,U19790,42,23422.069999999992,26,16,361265.05999999994,384687.12999999995
24731,U9927,42,-11396.339999999998,36,6,23292.58,11896.240000000003
24732,U892632,42,-48.49999999999841,23,19,29451.65,29403.15
24733,U8293,42,148561.25999999998,19,23,561800.76,710362.02
24734,U30243,42,-83312.00000000023,32,10,3268218.47,3184906.4699999997
24735,U40497,42,2448.2999999999993,30,12,44476.44,46924.740000000005
24736,U12482,42,-22257.87,24,18,144508.5,122250.63
24737,U29624,42,43193.43999999999,27,15,291185.1,334378.54
24738,U42414,42,-24253.84,29,13,144395.71999999997,120141.87999999998
24739,U41464,42,24171.449999999968,29,13,226185.56,250357.00999999995
24740,U38870,42,-3801.7499999999973,37,5,35468.8,31667.050000000007
24741,U1145932,42,-3855.7899999999995,34,8,11008.48,7152.6900000000005
24742,U41438,42,13055.37,23,19,81677.53,94732.9
24743,U12989,42,48411.41999999999,31,11,67260.3,115671.72
24744,U42717,42,8632.059999999998,33,9,21066.489999999998,29698.549999999996
24745,U29977,42,-10882.110000000002,32,10,44194.3,33312.19
24746,U18099,42,-27.839999999999673,29,13,6647.019999999999,6619.179999999999
24747,U17139,42,-11676.310000000001,37,5,32124.6,20448.289999999997
24748,U36605,42,53937.17999999999,20,22,98521.87999999999,152459.06
24749,U38332,42,-6396.290000000001,27,15,108392.3,101996.01000000001
24750,U28409,42,221.15999999999994,33,9,54203.149999999994,54424.31
24751,U43694,42,9998.47,34,8,16683.139999999996,26681.609999999993
24752,U25050,42,67.97000000000126,20,22,134317.18,134385.15
24753,U17563,42,-95498.21000000011,14,28,651006.98,555508.7699999999
24754,U1022307,42,-3516.5399999999995,36,6,20770.270000000008,17253.730000000007
24755,U8564,42,-8961.14,25,17,30094.819999999996,21133.679999999997
24756,U24585,42,-22451.969999999994,22,20,453517.1,431065.13
24757,U39821,42,-6734.839999999998,36,6,15120.739999999998,8385.9
24758,U1350905,42,26.059999999998386,23,19,20325.14,20351.199999999997
24759,U39085,42,90.47999999999456,18,24,83824.9,83915.37999999999
24760,U22392,42,-3929.289999999999,32,10,24434.000000000004,20504.710000000006
24761,U41311,42,-360819.10999999987,33,9,2453272.98,2092453.87
24762,U25300,42,-5162.169999999999,22,20,61702.62,56540.450000000004
24763,U759013,42,-4.029999999998154,27,15,16201.399999999998,16197.369999999999
24764,U1059284,42,1195.08,28,14,52499.16,53694.240000000005
24765,U38667,42,27275.009999999995,26,16,180993.35,208268.36
24766,U22424,42,181749.64,22,20,937849.61,1119599.25
24767,U1204384,42,684.6599999999994,26,16,28176.0,28860.66
24768,U28425,42,-9523.89,25,17,65664.64,56140.75
24769,U32199,42,-2665.2299999999977,33,9,72128.48,69463.25
24770,U26535,42,-32.4199999999837,21,21,827279.0,827246.5800000001
24771,U42610,42,2741.2100000000005,39,3,3861.48,6602.6900000000005
24772,U10734,42,-1566737.03,28,14,2494812.2299999995,928075.1999999995
24773,U21758,42,-7192.779999999999,38,4,18306.309999999998,11113.529999999999
24774,U8128,42,-212.34000000000003,34,8,4051.2799999999997,3838.9399999999996
24775,U26333,42,-2563.989999999999,37,5,14121.69,11557.7
24776,U12652,42,13692.239999999998,25,17,17741.76,31433.999999999996
24777,U36879,42,29847.510000000002,35,7,46155.61000000001,76003.12000000001
24778,U34334,42,-9448.499999999995,33,9,54546.86,45098.36000000001
24779,U753208,42,-812.2099999999994,25,17,10742.249999999998,9930.039999999999
24780,U35456,42,-10123.749999999996,33,9,30452.579999999994,20328.829999999998
24781,U13454,42,-268177.04,25,17,609441.13,341264.09
24782,U39059,42,21865.980000000018,27,15,67136.73000000001,89002.71000000002
24783,U19250,42,-19169.97,28,14,62803.32000000001,43633.350000000006
24784,U23841,42,-3723.619999999999,27,15,164112.83000000002,160389.21000000002
24785,U31586,42,-1180.8600000000001,37,5,10183.25,9002.39
24786,U33755,42,-27280.350000000006,31,11,69136.34,41855.98999999999
24787,U28653,42,-1970499.62,14,28,8114800.0,6144300.38
24788,U26178,42,-177.8199999999979,29,13,21681.329999999998,21503.510000000002
24789,U37258,42,1892.08,36,6,10479.98,12372.06
24790,U24511,42,-51445.72999999998,28,14,491015.12000000005,439569.3900000001
24791,U15909,42,7449.0,29,13,160737.3,168186.3
24792,U22432,42,-3285.9600000000005,34,8,4978.650000000001,1692.69
24793,U31576,42,-14901.72,26,16,40512.4,25610.68
24794,U12072,42,-14349.629999999997,33,9,45669.490000000005,31319.860000000008
24795,U27251,42,1861.9500000000007,25,17,21569.050000000003,23431.000000000004
24796,U12215,42,-526.6099999999988,37,5,33885.10999999999,33358.49999999999
24797,U27393,42,13334.490000000007,25,17,108410.65999999999,121745.15
24798,U26748,42,35743.10000000001,24,18,293502.37,329245.47000000003
24799,U42534,42,85.89999999999958,39,3,6898.79,6984.69
24800,U1165758,42,16396.15999999999,26,16,111692.02999999998,128088.18999999997
24801,U1344168,42,-4835.78,36,6,16360.419999999998,11524.64
24802,U41226,42,-14118.590000000011,26,16,94383.85999999997,80265.26999999996
24803,U14390,42,25654.46000000001,28,14,214395.16,240049.62000000002
24804,U11608,42,-16159.47999999999,33,9,266331.33999999997,250171.86
24805,U19948,42,121.20999999999185,27,15,197003.32,197124.53
24806,U1090487,42,-561.78,24,18,6493.78,5932.0
24807,U21545,42,60718.51000000002,29,13,92344.61000000002,153063.12000000002
24808,U24065,42,4476.720000000002,25,17,33771.73,38248.450000000004
24809,U19423,42,20152.78999999999,33,9,245311.90000000002,265464.69
24810,U43975,42,-25527.59,36,6,37681.189999999995,12153.599999999995
24811,U1121652,42,1394.5200000000007,31,11,17945.950000000004,19340.470000000005
24812,U1086398,42,-1074.88,25,17,2231.7200000000003,1156.8400000000001
24813,U37376,42,874.0800000000036,30,12,37236.38,38110.46
24814,U34545,42,-50047.86000000003,17,25,535768.3,485720.44
24815,U24778,42,-78.97999999999956,30,12,21350.780000000002,21271.800000000003
24816,U18862,42,37694.54,38,4,3786.67,41481.21
24817,U40436,42,-1747.3600000000006,31,11,371762.0,370014.64
24818,U31156,42,1121.8300000000017,21,21,38963.89,40085.72
24819,U27850,42,924.6600000000017,24,18,41182.81,42107.47
24820,U10625,42,1470.250000000003,23,19,71550.58,73020.83
24821,U21559,42,922.9300000000001,34,8,22688.71,23611.64
24822,U14655,42,-69303.39999999998,35,7,273212.04000000004,203908.64000000007
24823,U30767,42,5468.680000000001,33,9,2244.3200000000006,7713.000000000002
24824,U25709,42,-78.39999999999998,35,7,31590.400000000005,31512.000000000004
24825,U14589,42,-24306.25,30,12,151707.9,127401.65
24826,U13787,42,-77.15999999999926,36,6,7988.700000000001,7911.540000000002
24827,U22125,42,860.0000000000009,25,17,52186.91,53046.91
24828,U15963,42,36906.480000000025,19,23,711901.77,748808.25
24829,U27787,42,-1407.9600000000003,38,4,2188.17,780.2099999999998
24830,U29039,42,-13430.18,34,8,23166.649999999998,9736.469999999998
24831,U38838,42,-17675.880000000005,29,13,155842.91,138167.03
24832,U15968,42,28614.260000000006,23,19,142511.44999999998,171125.71
24833,U10672,42,3236.5800000000013,26,16,15310.98,18547.56
24834,U23719,42,1695.9899999999989,26,16,24944.500000000004,26640.49
24835,U43371,42,-11262.69,36,6,27006.34,15743.65
24836,U18145,42,99.61999999999898,20,22,32288.670000000002,32388.29
24837,U842958,42,-2219.6100000000006,34,8,10869.220000000001,8649.61
24838,U14078,42,-1957.890000000005,37,5,262792.13000000006,260834.24000000005
24839,U16612,42,-7581.999999999993,29,13,653068.18,645486.18
24840,U17485,42,34334.56,29,13,288502.93,322837.49
24841,U31295,42,-746.9199999999255,27,15,318839.60000000003,318092.6800000001
24842,U975748,42,-287.1700000000003,22,20,8801.79,8514.62
24843,U33200,42,-5458.609999999942,23,19,344728.83999999997,339270.23000000004
24844,U15345,42,90589.06,30,12,491769.82,582358.88
24845,U34305,42,-3480.8099999999995,33,9,26164.149999999998,22683.339999999997
24846,U23321,42,-76499.84999999999,15,27,200995.13,124495.28000000001
24847,U14359,42,9076.46,23,19,85179.75000000001,94256.21000000002
24848,U28108,42,-6026.519999999997,34,8,53913.80000000002,47887.28000000002
24849,U34980,42,-7111.580000000002,26,16,56590.000000000015,49478.42000000001
24850,U660928,42,-9903.289999999997,34,8,27542.72,17639.430000000004
24851,U1272590,42,-108.92000000000019,21,21,3732.74,3623.8199999999997
24852,U16796,42,272302.8400000001,23,19,253953.47000000003,526256.31
24853,U42579,42,-93886.7,36,6,228032.82,134146.12
24854,U16627,42,-1466.6600000000326,26,16,493140.92,491674.25999999995
24855,U43908,42,-5853.129999999946,27,15,903317.54,897464.4100000001
24856,U31522,42,-24374.540000000317,18,24,5681748.0,5657373.46
24857,U856707,42,-1441.1599999999999,32,10,27238.28,25797.12
24858,U11918,42,-83706.38,17,25,216316.08,132609.69999999998
24859,U35061,42,1284.83,26,16,27508.96,28793.79
24860,U23718,42,-3029.7499999999995,20,22,5258.96,2229.2100000000005
24861,U680510,42,3683.5899999999997,29,13,9538.01,13221.6
24862,U16095,42,55790.749999999956,34,8,745732.6099999998,801523.3599999998
24863,U22304,42,3244.79,29,13,7014.96,10259.75
24864,U34481,42,-3.3600000000000207,34,8,4902.71,4899.35
24865,U23074,42,-200281.8,29,13,1516700.9899999998,1316419.1899999997
24866,U36005,42,-5216.4900000000025,25,17,222038.65999999997,216822.16999999998
24867,U29729,42,42155.030000000006,32,10,18259.34,60414.37000000001
24868,U23424,42,308.8899999999976,37,5,27034.990000000005,27343.880000000005
24869,U582667,42,-9514.64,29,13,50441.020000000004,40926.380000000005
24870,U19510,42,-859.8199999999991,32,10,24512.28,23652.46
24871,U20704,42,-3892.9900000000007,39,3,12111.15,8218.16
24872,U18861,42,-18858.48,29,13,86622.64000000001,67764.16000000002
24873,U13933,42,-30998.54000000001,25,17,268419.31,237420.77
24874,U15894,42,1993.2400000000207,17,25,204157.93,206151.17
24875,U42662,42,15233.33,31,11,19305.069999999996,34538.399999999994
24876,U16008,42,-17788.979999999996,25,17,134371.19,116582.21
24877,U41156,42,1771.13,31,11,37087.090000000004,38858.22
24878,U9608,42,87250.38,30,12,23451.5,110701.88
24879,U38921,42,162868.19,26,16,107744.63999999998,270612.82999999996
24880,U40304,42,-22868.980000000007,34,8,69151.18000000001,46282.2
24881,U25961,42,5291.810000000001,35,7,8497.039999999999,13788.85
24882,U27390,42,-26942.840000000015,30,12,76972.65000000001,50029.81
24883,U15425,42,51980.95999999996,22,20,1082127.2,1134108.16
24884,U41067,42,-1041.8700000000013,35,7,19103.800000000003,18061.93
24885,U30296,42,-17884.030000000002,24,18,120728.19,102844.16
24886,U10260,42,-12919.239999999994,31,11,54557.07,41637.83
24887,U20173,42,-171.29000000000087,35,7,34198.47,34027.18
24888,U38062,42,18926.790000000037,28,14,388423.37,407350.16000000003
24889,U26292,41,-2595.8199999999997,37,4,10909.279999999999,8313.46
24890,U38670,41,25534.790000000008,31,10,30143.27,55678.06000000001
24891,U40313,41,-1642.1100000000006,27,14,117089.28,115447.17
24892,U35356,41,282504.73,32,9,158429.93,440934.66
24893,U19348,41,3122.24,31,10,65837.2,68959.44
24894,U43135,41,-3824.46,36,5,17297.53,13473.07
24895,U10551,41,78.02999999999884,22,19,248892.0899999999,248970.1199999999
24896,U25038,41,-2205.24,25,16,31587.51,29382.269999999997
24897,U16317,41,16177.740000000002,25,16,3894.170000000001,20071.910000000003
24898,U36043,41,38492.26,33,8,143443.18,181935.44
24899,U35470,41,-10325.070000000002,26,15,33322.93,22997.86
24900,U27359,41,45.78000000000043,34,7,5195.3099999999995,5241.09
24901,U42515,41,-2860.58,33,8,19589.280000000002,16728.700000000004
24902,U11727,41,2316.770000000001,29,12,10701.99,13018.76
24903,U11140,41,389.0200000000041,21,20,71043.08,71432.1
24904,U15975,41,21055.220000000016,24,17,560530.6,581585.82
24905,U36689,41,-10939.770000000008,21,20,218835.5,207895.72999999998
24906,U33653,41,5172.289999999999,31,10,15141.929999999998,20314.219999999998
24907,U26071,41,7521.399999999938,29,12,510000.0,517521.39999999997
24908,U32421,41,100409.95000000004,30,11,572640.93,673050.8800000001
24909,U8264,41,6142.07,34,7,14975.19,21117.260000000002
24910,U1275585,41,2374.19,2,39,4130.0,6504.1900000000005
24911,U31238,41,-1057.8999999999999,29,12,5044.429999999999,3986.5299999999997
24912,U42627,41,289.08999999999963,29,12,25074.630000000005,25363.720000000005
24913,U13054,41,116296.95999999999,31,10,12481.53,128778.48999999999
24914,U27115,41,-1292.4199999999964,29,12,47656.62,46364.200000000004
24915,U29014,41,7976.930000000003,28,13,50060.0,58036.93
24916,U8692,41,22399.070000000065,29,12,3034602.3000000003,3057001.37
24917,U41117,41,-143.23999999999967,35,6,6202.490000000001,6059.250000000001
24918,U17408,41,-142588.97,21,20,387595.23,245006.25999999998
24919,U11256,41,3852.789999999999,22,19,72811.18000000001,76663.97
24920,U36563,41,785.799999999999,22,19,106219.47999999998,107005.27999999998
24921,U625757,41,-20.149999999999807,28,13,11331.920000000002,11311.770000000002
24922,U10615,41,5177.550000000047,35,6,1170329.44,1175506.99
24923,U22384,41,-13274.539999999994,29,12,321887.32,308612.78
24924,U21741,41,637967.2,30,11,3607182.7299999995,4245149.93
24925,U23876,41,178150.24999999814,24,17,13848360.72,14026510.969999999
24926,U16023,41,3855.150000000001,25,16,27159.239999999998,31014.39
24927,U29421,41,2838.209999999998,33,8,13966.300000000001,16804.51
24928,U36074,41,2483.7400000000007,31,10,20419.56,22903.300000000003
24929,U28298,41,-5355.540000000001,27,14,50386.869999999995,45031.329999999994
24930,U23624,41,-623.9599999999998,37,4,5312.26,4688.3
24931,U21402,41,16935.3,25,16,38295.0,55230.3
24932,U17907,41,-666.46,37,4,6692.860000000001,6026.400000000001
24933,U29239,41,5769.9699999999975,34,7,33824.939999999995,39594.90999999999
24934,U14118,41,34475.09999999999,36,5,23586.230000000007,58061.33
24935,U906415,41,-1122.1900000000005,28,13,11886.71,10764.519999999999
24936,U30461,41,-1013.1000000001491,26,15,1393552.77,1392539.67
24937,U15116,41,-1671.4300000000012,19,22,43641.189999999995,41969.759999999995
24938,U16820,41,123758.10999999997,27,14,467300.87000000005,591058.98
24939,U40857,41,1180.1900000000023,31,10,42983.4,44163.590000000004
24940,U19903,41,-43.35000000001449,31,10,287653.4600000001,287610.11000000004
24941,U30317,41,-2561.2,26,15,28976.920000000002,26415.72
24942,U20504,41,0.44999999999976126,26,15,6176.159999999999,6176.609999999999
24943,U16807,41,-277218.88999999996,30,11,811133.6199999999,533914.73
24944,U38948,41,31395.92,32,9,186579.03,217974.95
24945,U21325,41,7006.830000000051,17,24,968718.3899999999,975725.22
24946,U24789,41,137.69999999999945,33,8,28985.539999999997,29123.239999999998
24947,U35163,41,8086.490000000002,37,4,1941.7799999999997,10028.27
24948,U40059,41,-2555.729999999996,16,25,100394.28,97838.55
24949,U20471,41,-3275.2699999999995,34,7,124094.70000000001,120819.43000000001
24950,U24037,41,12218.530000000002,30,11,109754.34,121972.87
24951,U32903,41,-374257.56,33,8,469110.52,94852.96000000002
24952,U34894,41,4670.99,34,7,22927.760000000002,27598.75
24953,U14425,41,23228.559999999998,26,15,227629.19,250857.75
24954,U28502,41,-1145.7899999999954,31,10,36852.35,35706.560000000005
24955,U1324231,41,0.46000000000001684,28,13,2215.84,2216.3
24956,U17131,41,1378.7300000001956,18,23,8254513.58,8255892.3100000005
24957,U21927,41,1853.7499999999927,25,16,85752.66,87606.41
24958,U902481,41,-496.74999999999983,25,16,13805.489999999998,13308.739999999998
24959,U43306,41,363.44000000000347,24,17,44555.229999999996,44918.67
24960,U10258,41,532925.2600000001,28,13,181055.82,713981.0800000001
24961,U13488,41,-88823.66000000005,26,15,2165372.92,2076549.2599999998
24962,U580992,41,316.8399999999999,30,11,1284.17,1601.01
24963,U15635,41,-6845.079999999999,24,17,24222.120000000003,17377.040000000005
24964,U40103,41,-8537.040000000023,34,7,1039072.23,1030535.19
24965,U13478,41,2933.6899999999996,26,15,43015.130000000005,45948.82000000001
24966,U43000,41,-4768.510000000003,30,11,39304.84,34536.329999999994
24967,U1190713,41,-53428.98999999999,26,15,71703.70000000001,18274.71000000002
24968,U16192,41,291473.87,31,10,212571.36,504045.23
24969,U30895,41,6069.190000000001,26,15,42945.25,49014.44
24970,U25740,41,-123.39000000000046,22,19,14439.699999999999,14316.309999999998
24971,U30393,41,-723.0300000000025,34,7,55042.25,54319.22
24972,U31916,41,20.170000000000016,25,16,28730.35,28750.519999999997
24973,U9807,41,-5034.639999999999,27,14,25232.800000000003,20198.160000000003
24974,U959803,41,-4092.659999999999,32,9,15120.93,11028.27
24975,U38899,41,19575.069999999978,25,16,189596.66999999995,209171.73999999993
24976,U17704,41,77882.92,5,36,30933.9,108816.82
24977,U10858,41,344000.31,28,13,612121.7399999999,956122.0499999998
24978,U32271,41,-1317.15,33,8,5814.78,4497.629999999999
24979,U27505,41,-1803.1700000000055,24,17,92009.19999999998,90206.02999999997
24980,U12497,41,-23539.709999999995,37,4,51699.66000000001,28159.950000000015
24981,U975251,41,0.9999999999981025,25,16,8577.26,8578.259999999998
24982,U13339,41,10345.779999999795,24,17,5364973.27,5375319.049999999
24983,U15892,41,-3957.380000000001,27,14,172350.92000000004,168393.54000000004
24984,U32514,41,-47876.21999999996,19,22,368871.55999999994,320995.33999999997
24985,U25731,41,2037.6000000000076,28,13,192452.09999999998,194489.69999999998
24986,U23004,41,-9797.43,38,3,11249.979999999998,1452.5499999999975
24987,U31847,41,45854.75,22,19,46967.03,92821.78
24988,U25470,41,8369.83,31,10,16000.28,24370.11
24989,U8095,41,40674.98999999999,23,18,267153.37,307828.36
24990,U16664,41,6168.670000000003,33,8,9850.11,16018.780000000002
24991,U18898,41,13972.890000000003,25,16,51288.520000000004,65261.41
24992,U8656,41,60463.52000000001,31,10,95968.92,156432.44
24993,U30154,41,3497.3199999999993,33,8,49754.23999999998,53251.55999999998
24994,U42258,41,-5255.020000000003,37,4,13111.880000000001,7856.859999999998
24995,U14886,41,215498.04999999996,20,21,492780.19999999995,708278.2499999999
24996,U18020,41,-3061.34,37,4,8305.33,5243.99
24997,U30740,41,-48435.31,28,13,140405.0,91969.69
24998,U31878,41,-39466.200000000004,27,14,280696.69,241230.49
24999,U42596,41,14141.21,31,10,3995.190000000001,18136.4
25000,U19241,41,675.78,25,16,8619.19,9294.970000000001
25001,U23776,41,-37.37999999999995,36,5,105.04000000000009,67.66000000000014
25002,U33425,41,-20362.78999999999,29,12,95678.36,75315.57
25003,U15574,41,62662.520000000004,16,25,173167.90000000002,235830.42000000004
25004,U28066,41,6095.570000000007,26,15,194263.2,200358.77000000002
25005,U39368,41,18670.9,27,14,84342.65999999999,103013.56
25006,U757240,41,-7390.040000000003,28,13,53326.21000000001,45936.170000000006
25007,U43048,41,-12260.009999999998,40,1,12286.419999999998,26.409999999999854
25008,U11687,41,38100.03,30,11,76468.52000000002,114568.55000000002
25009,U28649,41,-7190.400000000023,24,17,267025.03,259834.63
25010,U1136002,41,-4837.899999999998,24,17,42394.399999999994,37556.5
25011,U41811,41,2026.949999999997,23,18,482325.8500000001,484352.8000000001
25012,U1149117,41,38820.13,30,11,86202.68000000001,125022.81
25013,U27927,41,-5625.029999999999,31,10,34542.79,28917.760000000002
25014,U11088,41,18901.71,10,31,14995.239999999998,33896.95
25015,U12741,41,-28753.63,32,9,34732.9,5979.27
25016,U992592,41,-672.61,33,8,3044.4200000000005,2371.8100000000004
25017,U18401,41,-536.43,33,8,16138.0,15601.57
25018,U1041318,41,-3.269999999999982,28,13,1907.3,1904.03
25019,U1174543,41,1606.61,32,9,3681.88,5288.49
25020,U31471,41,-82846.32999999999,29,12,212258.61000000002,129412.28000000003
25021,U24421,41,165.22999999999956,33,8,11670.999999999995,11836.229999999994
25022,U28490,41,2112.7800000000016,33,8,34105.08000000001,36217.86000000001
25023,U22057,41,106.09999999999955,27,14,15361.8,15467.9
25024,U23637,41,40169.859999999935,27,14,435241.67000000004,475411.52999999997
25025,U14013,41,209.35000000000025,30,11,62045.33,62254.68
25026,U40568,41,-291214.23999999993,25,16,1172635.4200000002,881421.1800000002
25027,U19843,41,-22970.559999999998,39,2,39989.51,17018.950000000004
25028,U18732,41,-7334.54,34,7,23991.61,16657.07
25029,U38863,41,9340.080000000005,34,7,52460.04,61800.12000000001
25030,U24613,41,32409.5499999998,17,24,3410176.37,3442585.92
25031,U38465,41,3370.2099999999996,33,8,8710.460000000001,12080.67
25032,U9746,41,14975.38,33,8,45933.54,60908.92
25033,U19174,41,686.2999999999989,31,10,14903.32,15589.619999999999
25034,U23778,41,16350.390000000007,31,10,29384.509999999984,45734.899999999994
25035,U19778,41,38486.83,32,9,5124.849999999999,43611.68
25036,U37380,41,-201954.66000000003,32,9,212803.19000000003,10848.529999999999
25037,U1300895,41,-120.77000000000044,20,21,20120.99,20000.22
25038,U28003,41,-84621.91000000003,32,9,137243.13000000003,52621.22
25039,U31738,41,18639.09,29,12,58282.59,76921.68
25040,U29606,41,43.30999999999767,11,30,75051.52,75094.83
25041,U34680,41,-500.86,31,10,10265.599999999999,9764.739999999998
25042,U36933,41,8806.309999999998,30,11,22343.160000000003,31149.47
25043,U36559,41,-92649.1,36,5,96713.27999999998,4064.1799999999785
25044,U31851,41,-670.1199999999997,30,11,15290.260000000002,14620.140000000003
25045,U14731,41,8836.310000000005,27,14,173835.56000000003,182671.87000000002
25046,U17214,41,31310.070000000014,28,13,329776.65,361086.72000000003
25047,U17245,41,-10111.530000000002,31,10,45860.21,35748.67999999999
25048,U9202,41,-9646.870000000003,32,9,71885.28999999998,62238.41999999998
25049,U23199,41,-121619.42999999998,17,24,456289.0900000001,334669.6600000001
25050,U31589,41,-2224.15,39,2,9466.919999999998,7242.769999999999
25051,U31336,41,-5634.599999999997,33,8,93087.4,87452.8
25052,U35308,41,-114.36000000000604,34,7,155210.90000000002,155096.54
25053,U40903,41,37394.10000000056,31,10,5133928.16,5171322.260000001
25054,U19996,41,-94736.42000000001,33,8,166956.48,72220.06
25055,U33340,41,6925.620000000001,22,19,40910.29,47835.91
25056,U10325,41,6521.050000000034,20,21,658607.12,665128.17
25057,U26511,41,-6034.52,32,9,13927.119999999999,7892.5999999999985
25058,U38645,41,1341.23,35,6,5454.3,6795.530000000001
25059,U38836,41,156523.13,7,34,225976.81,382499.94
25060,U8422,41,1599.4199999999998,28,13,13205.43,14804.85
25061,U36935,41,103818.14000000001,28,13,9567.529999999999,113385.67000000001
25062,U15999,41,-1801.6399999999994,23,18,137157.0,135355.36
25063,U20261,41,29430.079999999994,23,18,12704.730000000003,42134.81
25064,U38851,41,-227716.39,27,14,284065.76,56349.369999999995
25065,U15885,41,-475.79999999999984,34,7,4977.299999999998,4501.499999999998
25066,U40105,41,-3578.5200000000004,31,10,12410.160000000002,8831.640000000001
25067,U16546,41,-25217.46,36,5,36578.45,11360.989999999998
25068,U14802,41,151241.07999999996,23,18,929502.4800000001,1080743.56
25069,U14901,41,10529.48,34,7,47058.2,57587.67999999999
25070,U987370,41,-1356.5400000000006,28,13,35662.04,34305.5
25071,U16221,41,85077.03,34,7,38970.70999999999,124047.73999999999
25072,U17331,41,-15977.470000000001,30,11,54512.889999999985,38535.419999999984
25073,U10644,41,-9983.88,21,20,15208.779999999997,5224.899999999998
25074,U18792,41,8518.300000000017,25,16,379483.17,388001.47
25075,U31048,41,-240.04000000001406,32,9,231933.21,231693.16999999998
25076,U22069,41,-28942.33,23,18,3269600.11,3240657.78
25077,U42109,41,16517.75,25,16,86180.80000000002,102698.55000000002
25078,U32578,41,8785.420000000002,31,10,49213.76,57999.18000000001
25079,U23037,41,15838.780000000002,36,5,4461.220000000001,20300.000000000004
25080,U11749,41,-2356.0600000000004,26,15,6356.92,4000.8599999999997
25081,U19816,41,-1609.2600000000061,23,18,259109.21000000002,257499.95
25082,U43010,41,-9967.549999999996,34,7,22501.370000000003,12533.820000000007
25083,U11968,41,1027.8400000000001,37,4,6103.190000000001,7131.030000000002
25084,U15733,41,15896.410000000003,29,12,64049.57,79945.98000000001
25085,U11563,41,-131.1000000000007,33,8,24530.649999999998,24399.549999999996
25086,U25015,41,443.4500000000003,25,16,54172.33,54615.78
25087,U42166,41,610.8500000000004,24,17,10185.34,10796.19
25088,U39539,41,11865.06,23,18,11771.880000000001,23636.940000000002
25089,U20749,41,972636.0500000003,33,8,967258.04,1939894.0900000003
25090,U27190,41,-4151.149999999994,24,17,269023.26,264872.11
25091,U18536,41,3841.019999999996,29,12,43101.96,46942.979999999996
25092,U17743,41,21263.600000000002,30,11,69082.58,90346.18000000001
25093,U34922,41,6541.0999999999985,35,6,312483.47,319024.56999999995
25094,U18061,41,1119.8199999999997,34,7,24423.04,25542.86
25095,U17775,41,6464.200000000001,32,9,14799.6,21263.800000000003
25096,U27479,41,1241.1699999999964,20,21,229420.89,230662.06
25097,U33363,41,46086.26,33,8,63878.76,109965.02
25098,U41327,41,23225.27,31,10,135776.48,159001.75
25099,U31590,41,23058.709999999992,29,12,48005.83000000001,71064.54000000001
25100,U19705,41,29738.65999999999,33,8,98180.1,127918.76
25101,U739198,41,-24230.010000000002,28,13,28462.06,4232.049999999999
25102,U28667,41,28783.59,20,21,32865.07,61648.66
25103,U23869,41,-1654.3399999999892,22,19,275859.85,274205.51
25104,U12784,41,-68951.0,34,7,81252.9,12301.899999999994
25105,U26729,41,20568.53,33,8,76093.32,96661.85
25106,U12731,41,3.6099999999833017,19,22,197213.39,197217.0
25107,U33560,41,-147.4799999999998,28,13,33243.18,33095.7
25108,U35479,41,-10030.569999999996,20,21,97242.66,87212.09000000001
25109,U27235,41,1850.3800000000074,26,15,41962.659999999996,43813.04
25110,U32833,41,-19984.210000000006,29,12,172701.74999999997,152717.53999999998
25111,U25567,41,-54237.48999999999,18,23,277210.9,222973.41000000003
25112,U41270,41,-2612.399999999998,21,20,140552.36000000002,137939.96000000002
25113,U31070,41,-333190.14,28,13,550094.36,216904.21999999997
25114,U18165,41,-14608.819999999963,32,9,684020.7200000001,669411.9000000001
25115,U42193,41,-11279.609999999997,31,10,105239.04000000001,93959.43000000001
25116,U24116,41,-345.31999999999994,19,22,3166.8700000000003,2821.55
25117,U34555,41,-53666.85999999995,22,19,513082.0,459415.1400000001
25118,U26934,41,-76778.51999999999,20,21,333593.73,256815.21
25119,U43973,41,-6472.95000000003,33,8,568993.7000000003,562520.7500000002
25120,U23910,41,18526.109999999993,30,11,77918.44999999992,96444.55999999991
25121,U21468,41,1914.07000000001,26,15,150468.69000000003,152382.76000000004
25122,U43477,41,10697.390000000007,22,19,178638.19,189335.58000000002
25123,U36814,41,17492.93,32,9,101970.33,119463.26000000001
25124,U576351,41,1573.97,31,10,1131.66,2705.63
25125,U753164,41,3171.9900000000034,25,16,31948.02,35120.01
25126,U26130,41,59738.64000000002,33,8,37086.209999999985,96824.85
25127,U26825,41,1267.4199999999905,24,17,1114561.9399999997,1115829.3599999996
25128,U37413,41,-2290909.8000000007,19,22,2816893.75,525983.9499999993
25129,U23993,41,-2509.029999999999,35,6,31718.18,29209.15
25130,U14445,41,12982.990000000002,28,13,30156.02,43139.01
25131,U28436,41,-958.8099999999977,23,18,67163.56,66204.75
25132,U24740,41,538.5699999999888,18,23,233967.56,234506.12999999998
25133,U19118,41,-1806.5199999999998,28,13,15770.509999999997,13963.989999999996
25134,U40419,41,-4577.419999999998,17,24,389696.7,385119.28
25135,U35824,41,-9919.409999999996,28,13,20757.380000000005,10837.970000000008
25136,U14947,41,1210.1099999999979,31,10,6112.130000000002,7322.24
25137,U14534,41,-241385.72999999986,18,23,1257797.73,1016412.0000000001
25138,U588825,40,-1379.85,29,11,5265.72,3885.8700000000003
25139,U36461,40,5573.419999999998,24,16,100583.60000000002,106157.02000000002
25140,U31364,40,15863.349999999999,26,14,112836.79999999999,128700.15
25141,U818182,40,1410.150000000001,20,20,38368.47,39778.62
25142,U27576,40,19250.62,26,14,151755.34000000003,171005.96000000002
25143,U8220,40,6687.209999999954,17,23,480239.3900000001,486926.60000000003
25144,U38434,40,-76762.28,24,16,112995.48,36233.2
25145,U36250,40,-6479.790000000001,35,5,9603.2,3123.41
25146,U18806,40,-4201.499999999998,36,4,16101.509999999998,11900.01
25147,U10230,40,399.6699999999995,34,6,10501.400000000001,10901.070000000002
25148,U29139,40,5440.96,32,8,27561.21,33002.17
25149,U1348491,40,-2142.95,22,18,14727.19,12584.240000000002
25150,U9490,40,-0.649999999992815,28,12,99701.13000000002,99700.48000000003
25151,U38239,40,-667.58,35,5,3606.61,2939.03
25152,U19642,40,-4321.289999999999,34,6,9641.73,5320.4400000000005
25153,U12825,40,30066.849999999995,35,5,10443.140000000001,40509.99
25154,U39366,40,115765.53,24,16,129835.46999999999,245601.0
25155,U39749,40,5105.5499999999965,10,30,299602.15,304707.7
25156,U21313,40,-7089.440000000002,22,18,108948.68,101859.23999999999
25157,U12115,40,20405.600000000006,23,17,267921.57,288327.17000000004
25158,U35188,40,-22698.500000000004,19,21,147384.51,124686.01000000001
25159,U34737,40,119410.88999999998,30,10,81264.0,200674.88999999998
25160,U988271,40,-3695.9399999999996,30,10,35973.78,32277.84
25161,U13055,40,-250303.40000000002,36,4,255802.26,5498.859999999986
25162,U8122,40,-192.99000000000012,24,16,5522.34,5329.35
25163,U21708,40,4830.5599999999995,32,8,22305.890000000003,27136.450000000004
25164,U588192,40,-856.4200000000004,38,2,4257.08,3400.6599999999994
25165,U23086,40,-32291.58,29,11,282552.0,250260.41999999998
25166,U37983,40,3065.7200000000003,19,21,10609.91,13675.630000000001
25167,U10985,40,-1946.8699999999944,33,7,51274.99,49328.12
25168,U1268978,40,-0.12000000000011823,26,14,2090.27,2090.1499999999996
25169,U13135,40,36.79000000000087,29,11,92074.0,92110.79000000001
25170,U1299382,40,150.17000000000033,21,19,4900.17,5050.34
25171,U8816,40,2.5100000000020373,19,21,117608.82,117611.33000000002
25172,U42081,40,39649.240000000005,29,11,57504.36,97153.6
25173,U595193,40,-4236.4400000000005,21,19,18264.81,14028.37
25174,U34816,40,2050.8700000000244,27,13,501770.65,503821.52
25175,U40888,40,44666.670000000006,27,13,67887.77,112554.44
25176,U32068,40,-441.6600000000035,20,20,82231.51000000001,81789.85
25177,U42140,40,24606.690000000002,36,4,19151.510000000002,43758.200000000004
25178,U26103,40,-527733.2,31,9,1045529.31,517796.1100000001
25179,U35934,40,-46201.97000000002,32,8,463775.25000000006,417573.28
25180,U12267,40,0.3900000000098953,19,21,451204.0,451204.39
25181,U33676,40,13308.220000000001,29,11,194351.77,207659.99
25182,U40452,40,-3510.180000000002,26,14,42330.619999999995,38820.439999999995
25183,U20979,40,-16185.550000000001,32,8,93072.0,76886.45
25184,U30217,40,-65755.91999999997,34,6,286936.56,221180.64
25185,U33426,40,-1964.1899999999996,37,3,31897.85,29933.66
25186,U41354,40,1641.5500000000002,25,15,60146.85000000001,61788.400000000016
25187,U36793,40,-1095.0400000000013,18,22,17057.89,15962.849999999999
25188,U37282,40,-84446.48,17,23,204238.0,119791.52
25189,U27942,40,67299.98,34,6,1350.9599999999998,68650.94
25190,U42503,40,-2434.3399999999997,30,10,20475.22,18040.88
25191,U20053,40,-24534.920000000006,32,8,92980.29000000001,68445.37
25192,U44026,40,-1391.7799999999925,23,17,118421.35,117029.57
25193,U37335,40,7000.260000000001,27,13,3131.3999999999996,10131.66
25194,U1169957,40,3.410605131648481e-13,24,16,5104.110000000001,5104.110000000001
25195,U17422,40,-735.72,25,15,46911.7,46175.979999999996
25196,U19873,40,-349.47999999999956,20,20,47107.04000000001,46757.56000000001
25197,U29170,40,-95322.78,27,13,116571.22,21248.440000000002
25198,U21314,40,-31198.299999999996,28,12,166226.0,135027.7
25199,U13290,40,-53569.06999999998,28,12,171689.69999999998,118120.63
25200,U8364,40,33266.06999999998,22,18,260282.46,293548.52999999997
25201,U24881,40,11377.210000000003,29,11,42435.95999999999,53813.17
25202,U19691,40,964.2399999999998,22,18,15691.4,16655.64
25203,U9034,40,-31713.35,31,9,164665.61,132952.25999999998
25204,U39858,40,-6487.1799999999985,31,9,31339.07,24851.89
25205,U17939,40,6.989999999999782,24,16,31886.499999999996,31893.489999999998
25206,U973304,40,-5803.27,34,6,17822.960000000003,12019.690000000002
25207,U1375001,40,-748.2900000000008,31,9,22680.869999999995,21932.579999999994
25208,U20266,40,-1408.700000000002,33,7,14130.780000000002,12722.08
25209,U30718,40,16833.920000000006,26,14,112489.02,129322.94
25210,U954989,40,-5241.75,23,17,12049.41,6807.66
25211,U32055,40,-1969.6800000000003,34,6,27970.48,26000.8
25212,U22611,40,5177.579999999998,33,7,54762.14000000001,59939.72
25213,U1146187,40,-751.6699999999998,25,15,7086.740000000001,6335.070000000001
25214,U37082,40,-20647.34,35,5,26999.960000000003,6352.620000000003
25215,U37848,40,1564.93,30,10,14521.659999999998,16086.589999999998
25216,U30288,40,-5029.250000000001,31,9,70618.62000000001,65589.37000000001
25217,U1247956,40,-21729.070000000003,30,10,22524.070000000003,795.0
25218,U37368,40,-2072.96,28,12,21076.65,19003.690000000002
25219,U13340,40,-45670.079999999994,26,14,192442.88999999998,146772.81
25220,U14739,40,743.3499999999949,26,14,132186.14,132929.49000000002
25221,U34591,40,-1976.92,29,11,21251.63,19274.71
25222,U720649,40,748.8999999999996,19,21,70098.45,70847.34999999999
25223,U15642,40,-101615.07999999997,28,12,297194.13,195579.05000000005
25224,U29474,40,-1167.7899999999936,32,8,404850.33,403682.54000000004
25225,U38289,40,-1066.2999999999938,23,17,122020.13999999998,120953.84
25226,U35121,40,5205.479999999987,24,16,272343.0,277548.48
25227,U10789,40,-42613.93,28,12,101660.23999999999,59046.30999999999
25228,U1098187,40,-2938.1,35,5,3662.7,724.5999999999999
25229,U43364,40,410.6800000000001,19,21,3114.4,3525.0800000000004
25230,U14300,40,7029.829999999996,37,3,37841.180000000015,44871.01000000001
25231,U30035,40,62183.12999999999,21,19,250695.96999999997,312879.1
25232,U1187103,40,-5078.410000000001,30,10,15772.539999999999,10694.129999999997
25233,U21678,40,183253.78,31,9,218796.84,402050.62
25234,U1015817,40,-10.349999999999973,23,17,1013.63,1003.28
25235,U8382,40,-11225.29999999998,25,15,215819.3,204594.0
25236,U24509,40,8589.139999999998,29,11,24017.809999999994,32606.94999999999
25237,U34702,40,272367.93,16,24,549849.9299999999,822217.8599999999
25238,U33446,40,33799.44,26,14,107300.56,141100.0
25239,U40711,40,304.2599999999984,33,7,28867.48,29171.739999999998
25240,U16298,40,-3113.7300000000014,36,4,9468.730000000001,6355.0
25241,U948699,40,91.42999999999995,23,17,2779.1,2870.5299999999997
25242,U25030,40,17879.98000000001,25,15,183356.06000000003,201236.04000000004
25243,U991036,40,-932.0699999999979,23,17,41305.100000000006,40373.030000000006
25244,U32200,40,240.70999999999708,18,22,280278.99,280519.7
25245,U18790,40,47171.04000000001,24,16,425709.14,472880.18000000005
25246,U29378,40,-2691.629999999998,37,3,16901.609999999997,14209.98
25247,U34712,40,-6.279999999995653,19,21,51346.759999999995,51340.479999999996
25248,U17830,40,779.930000000001,25,15,36994.71,37774.64
25249,U37524,40,7015.66,35,5,917.54,7933.2
25250,U24384,40,31877.660000000113,26,14,2103721.3800000004,2135599.0400000005
25251,U28710,40,-6285.359999999979,24,16,333895.23,327609.87
25252,U40754,40,-2612.3099999999995,29,11,34019.36,31407.050000000003
25253,U12633,40,-3267.3500000000013,33,7,21217.109999999997,17949.759999999995
25254,U11966,40,-32639.1,34,6,52517.17,19878.07
25255,U32338,40,219.5299999999999,22,18,9527.76,9747.29
25256,U42021,40,-17375.989999999998,32,8,55763.29,38387.3
25257,U12157,40,-7366.23,29,11,24667.27,17301.04
25258,U962936,40,-2894.95,34,6,11425.029999999999,8530.079999999998
25259,U16790,40,-1882898.5399999996,29,11,3964161.1400000006,2081262.600000001
25260,U760474,40,577.1400000000007,29,11,22227.86,22805.0
25261,U11762,40,2703562.2,23,17,285072.91,2988635.1100000003
25262,U1110467,40,680.9300000000003,28,12,8539.08,9220.01
25263,U9415,40,-28694.77999999998,16,24,401452.57,372757.79000000004
25264,U20871,40,-2720.3000000000006,24,16,17969.280000000002,15248.980000000001
25265,U21308,40,7847.200000000001,33,7,10696.080000000002,18543.280000000002
25266,U35453,40,252076.71999999994,21,19,124314.62999999999,376391.3499999999
25267,U16708,40,-6336.6999999999,23,17,1119824.02,1113487.32
25268,U42724,40,58926.30999999999,31,9,41397.65000000001,100323.95999999999
25269,U28944,40,65816.98000000039,14,26,3236410.5,3302227.4800000004
25270,U31594,40,-3825.1400000000012,33,7,10227.1,6401.959999999999
25271,U22761,40,2051.6500000000115,26,14,412235.79999999993,414287.44999999995
25272,U24748,40,6306.049999999994,32,8,59236.42000000002,65542.47000000002
25273,U41695,40,-104881.12000000001,31,9,274216.52999999997,169335.40999999997
25274,U36102,40,2363.1800000000017,30,10,29417.49,31780.670000000002
25275,U976999,40,-3529.42,31,9,16333.119999999999,12803.699999999999
25276,U25402,40,-18.870000000000967,25,15,7459.830000000002,7440.960000000001
25277,U35595,40,-10231.590000000018,26,14,855109.87,844878.28
25278,U20082,40,-6791.0999999999985,36,4,18370.28,11579.18
25279,U37832,40,-73406.47,22,18,412201.2,338794.73
25280,U29549,40,-86198.03,29,11,156241.24999999997,70043.21999999997
25281,U33688,40,12777.740000000005,22,18,173759.28,186537.02000000002
25282,U32621,40,1250.4599999999973,28,12,29995.97,31246.43
25283,U35684,40,-38866.030000000006,36,4,44787.509999999995,5921.479999999989
25284,U18573,40,50.00000000000364,20,20,113087.40000000001,113137.40000000001
25285,U1184786,40,-16803.309999999998,33,7,21539.1,4735.790000000001
25286,U1356096,40,-5337.18,35,5,6647.179999999999,1309.999999999999
25287,U26191,40,-2631.6100000000024,31,9,52999.49999999998,50367.88999999998
25288,U30429,40,-340.3899999999994,22,18,209194.41,208854.02000000002
25289,U820926,40,0.3200000000002774,30,10,3791.6399999999994,3791.9599999999996
25290,U23223,40,5514.310000000003,25,15,109200.03,114714.34
25291,U32769,40,-1265.159999999986,29,11,310139.77999999997,308874.62
25292,U32456,40,-9035.560000000001,34,6,28459.149999999998,19423.589999999997
25293,U1230019,40,-477.0000000000001,20,20,1704.31,1227.31
25294,U38431,40,21341.28,24,16,115804.44999999998,137145.72999999998
25295,U1166513,40,-7304.0999999999985,26,14,25039.120000000003,17735.020000000004
25296,U41871,40,8150.240000000004,30,10,8906.649999999996,17056.89
25297,U20833,40,1984.9400000000005,27,13,43399.600000000006,45384.54000000001
25298,U20710,40,809.2100000000005,29,11,31809.13,32618.34
25299,U43854,40,4777.300000000001,21,19,18550.960000000003,23328.260000000002
25300,U26901,40,3766.2300000000414,28,12,1421450.67,1425216.9
25301,U34899,40,3050.510000000004,30,10,81592.02,84642.53000000001
25302,U33594,40,1111.5099999999993,34,6,8930.93,10042.439999999999
25303,U34723,40,-14504.330000000002,24,16,221214.9,206710.57
25304,U25554,40,1264.8099999999934,33,7,72118.53000000001,73383.34000000001
25305,U36295,40,-172687.29,36,4,183595.48,10908.190000000002
25306,U32386,40,20890.65000000001,32,8,9664.1,30554.750000000007
25307,U35520,40,48297.16,26,14,182724.56,231021.72
25308,U40514,40,-525.639999999988,29,11,155619.23,155093.59000000003
25309,U17290,40,-5704.620000000004,31,9,32786.32,27081.699999999997
25310,U22080,40,-22678.780000000006,32,8,75892.48,53213.69999999999
25311,U15367,40,-12202.760000000007,30,10,54114.97999999999,41912.21999999998
25312,U35645,40,-4460.87,26,14,55797.15,51336.28
25313,U25047,40,-190909.09,33,7,198217.49,7308.399999999994
25314,U35067,40,80014.15000000001,28,12,98618.43000000001,178632.58000000002
25315,U23341,40,-5041.360000000006,27,13,73352.54,68311.18
25316,U24567,40,-329.8300000000012,29,11,8064.19,7734.359999999999
25317,U10143,40,-9334.839999999997,26,14,125069.41999999998,115734.57999999999
25318,U32423,40,-2618.5699999999997,36,4,4720.75,2102.1800000000003
25319,U41058,40,87.70000000000073,27,13,28942.24,29029.940000000002
25320,U1258890,40,3218.1899999999982,21,19,14134.76,17352.949999999997
25321,U15979,40,-342.7999999999857,17,23,323527.33999999997,323184.54
25322,U10590,40,65.2299999999998,35,5,4878.929999999999,4944.159999999999
25323,U640892,40,-3159.179999999999,26,14,21934.84,18775.66
25324,U26320,40,8366.880000000041,26,14,2967871.5200000005,2976238.4000000004
25325,U8748,40,77492.64000000001,34,6,88972.3,166464.94
25326,U26189,40,432714.48999999993,12,28,2120789.42,2553503.9099999997
25327,U29227,40,-26360.11,31,9,53365.78,27005.67
25328,U41513,40,26192.320000000007,27,13,90897.07,117089.39000000001
25329,U750569,40,-10211.120000000003,35,5,19330.34,9119.219999999998
25330,U43455,40,1663.6899999999996,33,7,11015.939999999999,12679.629999999997
25331,U31052,40,13117.21,27,13,18530.72,31647.93
25332,U15327,40,-2220.459999999999,27,13,34311.44,32090.980000000003
25333,U36207,40,2398.709999999999,33,7,29348.62,31747.329999999998
25334,U41524,40,-2868.2199999999993,29,11,35520.520000000004,32652.300000000003
25335,U40000,40,-22571.75,20,20,413655.13000000006,391083.38000000006
25336,U24652,40,1597271.4900000002,28,12,1049343.0600000003,2646614.5500000007
25337,U39353,40,-2969.8599999999988,21,19,136991.73,134021.87000000002
25338,U1256729,40,-9301.8,33,7,23944.94,14643.14
25339,U25540,40,-754.0600000000079,35,5,38056.43,37302.369999999995
25340,U37363,40,-231.05999999999992,14,26,12960.1,12729.04
25341,U17884,40,173480.20000000007,30,10,232460.34,405940.54000000004
25342,U33448,40,392.6399999999999,30,10,25949.97,26342.61
25343,U29603,40,146.35000000000025,33,7,2338.93,2485.28
25344,U19658,40,1602.9300000000005,31,9,10949.879999999997,12552.809999999998
25345,U9555,40,-26493.679999999986,32,8,156730.66,130236.98000000001
25346,U25259,40,-98784.84000000004,18,22,643508.45,544723.6099999999
25347,U28402,40,-54796.66999999999,23,17,343891.48,289094.81
25348,U878110,40,96.2400000000002,24,16,7916.089999999999,8012.329999999999
25349,U41108,40,4706.049999999999,34,6,8126.080000000001,12832.130000000001
25350,U34475,40,1091.5600000000018,30,10,38650.090000000004,39741.65000000001
25351,U965894,40,-2119.5599999999995,25,15,13227.85,11108.29
25352,U22010,40,41865.490000000005,27,13,36687.7,78553.19
25353,U8179,40,1275.79,30,10,14745.230000000003,16021.020000000004
25354,U34595,40,14349.55,29,11,21684.729999999996,36034.28
25355,U26788,40,33612.61000000001,31,9,2678.3,36290.91000000001
25356,U38076,40,902.390000000014,21,19,1007481.89,1008384.28
25357,U33700,40,-8881.509999999998,34,6,9277.859999999999,396.35000000000036
25358,U15555,40,57724.159999999996,29,11,29863.6,87587.76
25359,U29123,40,-51082.0,23,17,497847.20999999973,446765.20999999973
25360,U38906,40,-7111.59,33,7,17964.62,10853.029999999999
25361,U22188,40,36706.95999999999,25,15,44051.3,80758.26
25362,U35804,40,-21216.5,35,5,30928.06,9711.560000000001
25363,U24016,40,-4772.119999999981,25,15,288665.56,283893.44
25364,U41918,40,13148.489999999994,22,18,439368.74,452517.23
25365,U41844,40,397.17000000000394,30,10,71212.55999999998,71609.72999999998
25366,U10578,40,-116.38999999999987,31,9,17868.01,17751.62
25367,U17737,40,-1463.8300000000008,31,9,22840.02,21376.19
25368,U10725,40,-48166.520000000004,33,7,81789.03000000001,33622.51000000001
25369,U25752,40,1334.1,31,9,9873.199999999999,11207.3
25370,U29291,40,223837.90999999997,27,13,78099.12999999999,301937.04
25371,U29925,40,-24712.29999999999,25,15,1390088.0,1365375.7
25372,U9443,40,779.9599999999964,27,13,82715.14,83495.09999999999
25373,U23786,40,-1251.4399999999991,28,12,10491.039999999999,9239.6
25374,U35732,40,18165.96,31,9,8949.82,27115.78
25375,U32734,40,-7225.1700000000055,23,17,213814.03,206588.86
25376,U30520,40,16064.690000000002,22,18,91875.42,107940.11
25377,U42722,40,29963.07999999999,27,13,23979.83,53942.90999999999
25378,U21249,40,26074.45000000001,26,14,204973.49,231047.94
25379,U23356,40,-250.9200000000009,38,2,40262.76,40011.840000000004
25380,U19815,40,-112122.26000000002,25,15,159440.73,47318.46999999999
25381,U1310188,40,327.1800000000002,27,13,9379.54,9706.720000000001
25382,U19999,40,1863.999999999999,19,21,47044.02,48908.02
25383,U30313,40,1151.510000000003,24,16,52485.47000000001,53636.98000000001
25384,U33110,40,-22240.31,24,16,83048.54000000001,60808.23000000001
25385,U23311,40,20195.909999999996,25,15,118076.0,138271.91
25386,U708545,40,608.05,24,16,1610.0,2218.05
25387,U21315,40,-43177.52,31,9,154542.91999999998,111365.4
25388,U26436,40,-1189.1599999999999,26,14,8347.76,7158.6
25389,U24747,40,2112.8300000000004,35,5,6344.629999999999,8457.46
25390,U13259,40,-3354.8799999999997,36,4,83398.0,80043.12
25391,U20570,40,-1640.920000000001,31,9,11061.65,9420.73
25392,U578393,40,-4251.2699999999995,38,2,4901.279999999999,650.0099999999993
25393,U1132409,40,1.760000000000109,21,19,1980.8,1982.5600000000002
25394,U21083,40,204404.40999999997,28,12,35774.06,240178.46999999997
25395,U1056917,40,590.2100000000002,22,18,838.0599999999998,1428.27
25396,U1000216,40,1689.5,35,5,3003.24,4692.74
25397,U29933,40,698.6299999999983,27,13,38205.2,38903.829999999994
25398,U28801,40,2252.26,21,19,437416.91,439669.17
25399,U15012,40,98735.35999999994,16,24,536463.77,635199.13
25400,U36070,40,-1373.2700000000034,35,5,14594.070000000003,13220.8
25401,U28290,40,-50697.58,35,5,80352.88,29655.300000000003
25402,U16969,40,-8779.049999999988,15,25,531287.7400000001,522508.6900000001
25403,U16367,40,36506.92,18,22,275031.03,311537.95
25404,U11244,40,-5384.100000000001,34,6,258522.77,253138.66999999998
25405,U1344138,40,-2.869999999999152,24,16,11562.880000000001,11560.010000000002
25406,U1252460,40,-3053.55,32,8,15828.519999999999,12774.969999999998
25407,U19512,40,1202.36,36,4,7298.490000000001,8500.85
25408,U42901,40,-9120.910000000003,31,9,49452.62,40331.71
25409,U24054,40,2863.39,27,13,5170.65,8034.039999999999
25410,U1122267,40,334.88000000000056,21,19,30599.719999999998,30934.6
25411,U992241,40,3481.3100000000004,26,14,14380.81,17862.12
25412,U22456,40,-299.4800000000001,29,11,2384.32,2084.84
25413,U920066,40,-10.120000000000118,23,17,5379.75,5369.63
25414,U19246,40,9.029999999999745,19,21,56699.17,56708.2
25415,U26062,40,235.8600000000015,27,13,46924.53,47160.39
25416,U44037,40,-2699.1899999999996,33,7,34890.00000000001,32190.81000000001
25417,U27842,40,9868.610000000002,19,21,158255.13,168123.74000000002
25418,U11803,40,-368.5,31,9,24790.95,24422.45
25419,U9564,40,2445.29,33,7,5220.74,7666.03
25420,U9812,39,-1757.1599999999978,32,7,57675.6,55918.44
25421,U965748,39,486.99000000000024,21,18,8207.95,8694.94
25422,U19975,39,-26187.879999999997,27,12,99998.02,73810.14000000001
25423,U29503,39,2191.6599999999953,35,4,39701.2,41892.85999999999
25424,U41097,39,1106.7799999999957,20,19,42346.75,43453.53
25425,U23107,39,9684.779999999999,20,19,33221.94,42906.72
25426,U14830,39,-26621.959999999995,28,11,61246.08,34624.12000000001
25427,U14628,39,-4679.360000000066,25,14,1008255.8800000001,1003576.52
25428,U22921,39,9328.720000000001,22,17,101710.0,111038.72
25429,U43385,39,1057893.4,15,24,3386277.2099999995,4444170.609999999
25430,U34858,39,48524.46000000001,30,9,9663.35,58187.810000000005
25431,U24588,39,-61562.33000000001,28,11,423281.58,361719.25
25432,U746315,39,-4678.160000000002,20,19,33090.92,28412.759999999995
25433,U819180,39,45.52000000000001,22,17,1102.14,1147.66
25434,U42527,39,-6122.790000000001,33,6,62181.240000000005,56058.450000000004
25435,U31274,39,-47998.50000000001,23,16,141319.24999999997,93320.74999999997
25436,U25775,39,-6193.31,28,11,8510.98,2317.669999999999
25437,U17967,39,-34938.640000000014,31,8,222191.05000000002,187252.41
25438,U33652,39,5609.180000000006,24,15,297953.19999999995,303562.37999999995
25439,U29525,39,-842.3600000000001,23,16,25174.48,24332.12
25440,U29048,39,-35.89000000000146,22,17,36721.399999999994,36685.509999999995
25441,U25483,39,48148.52,19,20,258443.88,306592.4
25442,U22389,39,2569.859999999996,29,10,60580.71,63150.56999999999
25443,U22221,39,155516.56,26,13,527869.78,683386.3400000001
25444,U32197,39,-2119.8999999999855,22,17,327657.14,325537.24000000005
25445,U20811,39,-6290.480000000001,33,6,20889.87,14599.389999999998
25446,U38010,39,-836.7599999999984,31,8,56368.17,55531.41
25447,U20878,39,8717.220000000001,34,5,147858.34999999998,156575.56999999998
25448,U12232,39,14241.07,28,11,22537.88,36778.95
25449,U37682,39,838.2299999999963,15,24,232141.3,232979.53
25450,U22695,39,-14985.02,31,8,68406.0,53420.979999999996
25451,U17079,39,3106891.3499999996,27,12,4102302.96,7209194.31
25452,U21255,39,-8312.06,23,16,8513.279999999999,201.21999999999935
25453,U28076,39,7194.849999999995,27,12,114671.83999999998,121866.68999999997
25454,U34855,39,3534.080000000001,31,8,8297.539999999999,11831.619999999999
25455,U9747,39,-16384.670000000002,10,29,117000.0,100615.33
25456,U32689,39,8781.189999999999,27,12,11105.449999999999,19886.64
25457,U20361,39,-41277.490000000005,26,13,49497.81,8220.319999999992
25458,U19488,39,-878.6700000000006,26,13,21585.370000000006,20706.700000000004
25459,U15480,39,86037.1,26,13,83509.47,169546.57
25460,U17814,39,-1082.8599999999988,29,10,24183.85,23100.989999999998
25461,U22751,39,-10081.949999999999,32,7,27951.079999999998,17869.129999999997
25462,U29773,39,-13627.519999999991,30,9,1045048.9299999999,1031421.4099999999
25463,U23834,39,587.5499999999993,28,11,23147.01,23734.559999999998
25464,U27426,39,-2086.3000000000015,35,4,18811.64,16725.339999999997
25465,U19711,39,2002.1500000000015,27,12,3883.709999999999,5885.860000000001
25466,U41009,39,-3837.7400000000025,27,12,117063.75000000001,113226.01000000001
25467,U1367464,39,-1522.79,35,4,5603.610000000001,4080.8200000000006
25468,U42853,39,-19967.22999999999,30,9,131585.63,111618.40000000002
25469,U26576,39,228703.02000000005,20,19,567945.52,796648.54
25470,U38868,39,53.88999999999578,30,9,57056.29,57110.17999999999
25471,U31774,39,7974.090000000064,18,21,1006792.9,1014766.9900000001
25472,U42880,39,-5943.830000000004,18,21,82217.45000000001,76273.62000000001
25473,U20494,39,-454.62000000000353,23,16,106836.47999999998,106381.85999999997
25474,U21194,39,-8960.740000000002,19,20,73965.04000000001,65004.3
25475,U24991,39,9183.85000000001,24,15,227373.46999999997,236557.31999999998
25476,U39136,39,-37399.62,28,11,75346.0,37946.38
25477,U894907,39,1228.23,21,18,3648.5299999999997,4876.76
25478,U37592,39,-5429.139999999999,30,9,24294.11,18864.97
25479,U1063964,39,-582.0600000000001,27,12,7980.069999999999,7398.009999999998
25480,U34568,39,-6587.2,31,8,9035.630000000003,2448.430000000003
25481,U29127,39,-184352.15,30,9,200394.72,16042.570000000007
25482,U17873,39,-15601.009999999997,29,10,49376.81999999999,33775.81
25483,U23958,39,-2171.159999999999,19,20,144045.8,141874.63999999998
25484,U636909,39,11819.48,26,13,26480.539999999997,38300.02
25485,U9169,39,7309.0,26,13,67082.92,74391.92
25486,U18516,39,5044.069999999999,28,11,89047.61,94091.68
25487,U34115,39,15483.080000000002,29,10,15250.550000000001,30733.630000000005
25488,U24382,39,-20897.65999999998,13,26,438036.49,417138.83
25489,U39585,39,-10259.160000000033,19,20,998651.5,988392.34
25490,U27182,39,13081.420000000004,16,23,54304.03,67385.45
25491,U32948,39,-3790.2399999999975,35,4,18384.269999999997,14594.029999999999
25492,U25294,39,-100.08999999999995,36,3,2185.27,2085.18
25493,U38096,39,-15556.559999999998,25,14,85709.09,70152.53
25494,U14280,39,1787.5700000000097,24,15,155233.74,157021.31
25495,U682797,39,232.26999999999782,25,14,22174.490000000005,22406.760000000002
25496,U29052,39,-2760.95,32,7,6990.580000000001,4229.630000000001
25497,U40252,39,-526.2899999999981,32,7,25557.55,25031.260000000002
25498,U11233,39,2836.0300000000007,21,18,42081.740000000005,44917.770000000004
25499,U22894,39,-20573.399999999994,21,18,150956.06000000003,130382.66000000003
25500,U30390,39,-37913.43000000005,26,13,1877631.83,1839718.4
25501,U1330627,39,-112.58999999999833,22,17,27842.03,27729.440000000002
25502,U42287,39,18022.76,22,17,56939.78999999999,74962.54999999999
25503,U591795,39,6577.21,21,18,89560.05,96137.26000000001
25504,U17580,39,9997.420000000006,28,11,182296.65999999995,192294.07999999996
25505,U43376,39,52114.719999999994,26,13,126898.68,179013.4
25506,U658150,39,-19.539999999999793,24,15,3763.43,3743.89
25507,U21676,39,-2023.7700000000002,27,12,13273.73,11249.96
25508,U9515,39,-45840.32,29,10,558120.0499999999,512279.7299999999
25509,U21053,39,47516.55999999999,18,21,53823.16000000001,101339.72
25510,U37469,39,52845.149999999994,23,16,110776.40999999999,163621.56
25511,U30745,39,-11254.870000000003,20,19,65827.04000000001,54572.170000000006
25512,U1110990,39,-13563.380000000005,27,12,43623.72,30060.339999999997
25513,U10478,39,12582.970000000001,30,9,72170.51999999999,84753.48999999999
25514,U12781,39,50083.570000000014,23,16,403140.7,453224.27
25515,U13628,39,1132.0400000000009,19,20,221684.78,222816.82
25516,U33180,39,-4986.5199999999995,25,14,26530.899999999998,21544.379999999997
25517,U27605,39,-6970.480000000007,29,10,307173.03,300202.55000000005
25518,U9677,39,103281.53000000001,23,16,72077.49000000002,175359.02000000002
25519,U12283,39,576.4999999999997,22,17,7221.04,7797.54
25520,U21719,39,-268.08000000000175,19,20,384347.58,384079.5
25521,U1363879,39,-1044.7700000000002,27,12,13735.099999999999,12690.329999999998
25522,U21884,39,1144.5600000000004,20,19,37481.93,38626.49
25523,U40442,39,-4514.740000000001,28,11,17187.239999999998,12672.499999999996
25524,U39452,39,55368.52000000002,25,14,1926707.02,1982075.54
25525,U27867,39,7140.139999999999,25,14,164869.83000000002,172009.97000000003
25526,U14897,39,3339.010000000002,25,14,41724.52,45063.53
25527,U32276,39,2181.139999999995,19,20,90627.54000000001,92808.68000000001
25528,U26507,39,-3371.180000000144,19,20,896531.23,893160.0499999998
25529,U42557,39,-19020.69,32,7,57155.700000000004,38135.01000000001
25530,U34755,39,-5202.329999999999,33,6,11805.469999999996,6603.139999999997
25531,U31621,39,-3891.4900000000002,35,4,5242.85,1351.3600000000001
25532,U42651,39,-5608.870000000006,32,7,38461.98,32853.11
25533,U10684,39,-174.61000000000058,35,4,6377.120000000001,6202.51
25534,U37166,39,-9644.680000000033,26,13,1228282.0,1218637.32
25535,U30571,39,2236.7799999999993,34,5,4103.01,6339.789999999999
25536,U24124,39,11124.109999999953,27,12,834930.42,846054.53
25537,U30021,39,62429.63000000001,29,10,71928.18,134357.81
25538,U660603,39,83.58000000000004,26,13,3228.22,3311.7999999999997
25539,U24297,39,-205.58000000000004,19,20,2636.0899999999997,2430.5099999999998
25540,U31562,39,750.9600000000023,27,12,38636.090000000004,39387.05
25541,U13386,39,4223.4800000000005,30,9,23048.69,27272.17
25542,U23576,39,-474.2499999999998,32,7,7754.249999999999,7279.999999999999
25543,U42763,39,1388.1400000000003,25,14,11883.48,13271.619999999999
25544,U39172,39,13114.64,26,13,110824.6,123939.24
25545,U36212,39,12333.040000000003,23,16,505741.47000000003,518074.51
25546,U29093,39,2905.16,36,3,8346.1,11251.26
25547,U26109,39,-38645.53000000001,30,9,102095.26999999999,63449.739999999976
25548,U12697,39,14847.939999999999,24,15,26822.36,41670.3
25549,U28252,39,18344.6,27,12,16253.859999999997,34598.45999999999
25550,U20605,39,-348.5799999999999,33,6,1215.55,866.97
25551,U43208,39,1505.1100000000008,30,9,9336.31,10841.42
25552,U12932,39,181992.58999999997,15,24,190893.49000000005,372886.08
25553,U18937,39,38822.18,26,13,93174.7,131996.88
25554,U37538,39,1743.7700000000004,27,12,80798.52000000002,82542.29000000002
25555,U966413,39,-9.02999999999993,20,19,1397.96,1388.93
25556,U1151471,39,-0.32999999999991303,21,18,6648.45,6648.12
25557,U37512,39,9002.030000000002,26,13,9928.019999999997,18930.05
25558,U24185,39,-59936.11,30,9,59961.9,25.790000000000873
25559,U23673,39,-4172.459999999999,31,8,98600.32,94427.86000000002
25560,U13402,39,402460.26,18,21,133183.74,535644.0
25561,U22457,39,-618326.27,24,15,1693690.2,1075363.93
25562,U17300,39,1490.9299999999996,31,8,22710.259999999995,24201.189999999995
25563,U11277,39,1793.789999999984,28,11,443255.71,445049.5
25564,U13700,39,119703.00999999995,16,23,85969.74,205672.74999999994
25565,U43503,39,628.81,29,10,10892.21,11521.019999999999
25566,U13936,39,-12407.690000000002,29,10,41378.619999999995,28970.929999999993
25567,U22549,39,-3186.560000000056,22,17,1173762.44,1170575.88
25568,U33843,39,-100361.48000000001,25,14,171705.81,71344.32999999999
25569,U38588,39,11.120000000004438,24,15,80686.6,80697.72000000002
25570,U12717,39,31386.739999999994,33,6,70233.27,101620.01
25571,U36976,39,10128.730000000003,28,11,158394.99,168523.72
25572,U36067,39,-5396.439999999999,33,6,29547.75,24151.31
25573,U42459,39,6435.730000000001,26,13,10954.129999999997,17389.86
25574,U8206,39,15700.109999999991,19,20,297375.58999999997,313075.69999999995
25575,U41733,39,714.7500000000002,30,9,3342.080000000002,4056.8300000000027
25576,U28421,39,52861.43,34,5,29013.170000000002,81874.6
25577,U35673,39,-11925.510000000002,29,10,47063.17,35137.659999999996
25578,U42803,39,82730.56,27,12,128024.48,210755.03999999998
25579,U12132,39,-4402.36,29,10,38741.85,34339.49
25580,U20287,39,-8407.320000000002,37,2,8488.960000000003,81.64000000000124
25581,U12520,39,-2278.72,28,11,9058.1,6779.380000000001
25582,U43705,39,-1582.4800000000068,23,16,91319.5,89737.01999999999
25583,U668157,39,-233.68,23,16,1730.2999999999997,1496.6199999999997
25584,U41777,39,210.19000000000375,24,15,31690.670000000002,31900.860000000004
25585,U35860,39,-4381.3299999999745,22,17,234987.11,230605.78
25586,U15719,39,35881.01,30,9,107376.43000000001,143257.44
25587,U9859,39,55049.670000000006,26,13,294565.9,349615.57
25588,U24489,39,-1546.8,32,7,2347.91,801.1099999999999
25589,U27417,39,-6352.2199999999975,28,11,29974.050000000003,23621.830000000005
25590,U14614,39,-324843.73,32,7,441017.12,116173.39000000001
25591,U13235,39,125560.72999999995,26,13,409613.79000000004,535174.52
25592,U29499,39,-28049.189999999995,26,13,145937.03999999998,117887.84999999998
25593,U31550,39,357.1399999999967,28,11,30427.88,30785.019999999997
25594,U31557,39,6853.32,20,19,85232.0,92085.32
25595,U9121,39,7458.95,27,12,25126.66,32585.61
25596,U25552,39,14592.440000000002,34,5,19907.670000000002,34500.11
25597,U14049,39,12758.750000000007,17,22,116738.7,129497.45000000001
25598,U8457,39,7861.629999999997,20,19,90752.23000000001,98613.86000000002
25599,U21867,39,66.42000000000012,35,4,3743.9800000000005,3810.4000000000005
25600,U11572,39,-2864.9199999999782,19,20,255404.75,252539.83000000002
25601,U9044,39,17452.31999999999,16,23,136627.32,154079.63999999998
25602,U639463,39,838.3399999999997,24,15,15252.720000000001,16091.060000000001
25603,U33320,39,51452.15999999998,32,7,10956.43,62408.58999999998
25604,U35800,39,30220.539999999997,30,9,4134.110000000001,34354.649999999994
25605,U16255,39,-7691.459999999999,31,8,20984.73,13293.27
25606,U39781,39,95.12000000000661,25,14,106186.77999999996,106281.89999999997
25607,U11049,39,-51.27999999999645,22,17,83841.19999999998,83789.91999999998
25608,U20948,39,-16112.249999999998,19,20,113169.0,97056.75
25609,U15150,39,-54225.30000000002,21,18,333837.48,279612.17999999993
25610,U21219,39,-20586.01000000002,22,17,502038.56,481452.55
25611,U26548,39,-897.3499999999779,30,9,327483.84,326586.49000000005
25612,U22150,39,338.689999999993,31,8,106264.24,106602.93
25613,U33762,39,7848.110000000001,29,10,2452.6200000000003,10300.730000000001
25614,U22202,39,-90244.06000000003,27,12,128589.96,38345.89999999998
25615,U43529,39,2678.690000000006,31,8,66479.65000000001,69158.34000000001
25616,U41400,39,964.7499999999927,28,11,2017717.47,2018682.22
25617,U23370,39,-7540.079999999988,21,18,133135.26000000004,125595.18000000005
25618,U13224,39,2426.8999999999924,34,5,200438.19000000003,202865.09000000003
25619,U15902,39,501.4399999999987,26,13,53259.29,53760.729999999996
25620,U12396,39,4040.6100000000024,32,7,16971.399999999998,21012.010000000002
25621,U17597,39,-1388.6399999999996,36,3,3003.9,1615.2600000000004
25622,U36700,39,-4384.090000000004,23,16,68426.67,64042.579999999994
25623,U24671,39,-83.87000000000012,27,12,12302.690000000002,12218.820000000002
25624,U24768,39,-41079.42,26,13,144051.71,102972.29
25625,U38408,39,-4015.290000000001,29,10,56008.82,51993.53
25626,U19332,39,-11025.36,37,2,11325.51,300.14999999999964
25627,U676681,39,-6.269999999999868,27,12,3018.7200000000003,3012.4500000000003
25628,U22030,39,15816.480000000003,31,8,110605.28,126421.76000000001
25629,U38108,39,-17492.260000000013,26,13,201622.47000000003,184130.21000000002
25630,U21992,39,-9712.52,32,7,36065.42,26352.899999999998
25631,U26224,39,19522.45000000001,30,9,124306.98,143829.43
25632,U32379,39,2218.830000000001,22,17,16391.42,18610.25
25633,U40176,39,13177.649999999952,26,13,4150308.98,4163486.63
25634,U16517,39,141.85000000007688,21,18,767463.5800000001,767605.4300000002
25635,U11985,39,6355.760000000005,22,17,109371.37,115727.13
25636,U32528,39,270327.66000000003,16,23,810484.01,1080811.67
25637,U37104,39,-4593.150000000009,31,8,96880.91,92287.76
25638,U30743,39,97.98000000000047,31,8,7956.009999999999,8053.99
25639,U31022,39,-758.0499999999952,20,19,36502.07000000001,35744.02000000001
25640,U15757,39,-7140.169999999998,22,17,102470.18,95330.01
25641,U41150,39,-102.17999999998938,27,12,208462.71,208360.53
25642,U29949,39,-1049010.51,26,13,3139004.1,2089993.59
25643,U9692,39,-214702.0000000001,23,16,1613130.2899999998,1398428.2899999998
25644,U25916,39,2041.170000000001,28,11,62330.310000000005,64371.48
25645,U37234,39,-6439.4800000000005,33,6,21121.11,14681.630000000001
25646,U20615,39,-193.1099999999999,27,12,6695.219999999999,6502.11
25647,U37916,39,-310.1200000000002,36,3,3519.62,3209.4999999999995
25648,U18238,39,231.27000000000544,28,11,55893.68,56124.950000000004
25649,U24764,39,239.62999999999965,28,11,8670.95,8910.58
25650,U23304,39,-5677.750000000002,28,11,42066.01,36388.26
25651,U24875,39,27682.3,30,9,15604.470000000003,43286.770000000004
25652,U19147,39,154.0899999999997,25,14,7333.01,7487.1
25653,U39251,39,-19454.860000000026,29,10,603257.49,583802.63
25654,U18940,39,-1422.2300000000032,34,5,48950.45,47528.219999999994
25655,U36734,39,10507.220000000001,16,23,185924.56,196431.78
25656,U40397,39,35505.11,26,13,102263.21,137768.32
25657,U22257,39,-14876.839999999995,24,15,209872.56000000006,194995.72000000006
25658,U43117,39,9965.659999999998,27,12,59725.530000000006,69691.19
25659,U28188,39,-2731.1999999999994,36,3,12697.84,9966.640000000001
25660,U13443,39,-12752.84,20,19,39330.869999999995,26578.029999999995
25661,U23203,39,-5553.9400000000005,32,7,14048.75,8494.81
25662,U14127,39,-1932.0200000000032,22,17,115340.66,113408.64
25663,U27054,39,13181.430000000028,25,14,461147.85000000003,474329.2800000001
25664,U41182,39,416.44000000000005,26,13,6936.45,7352.889999999999
25665,U40034,39,-14729.559999999998,34,5,63284.97,48555.41
25666,U20338,39,-6686.700000000001,26,13,38967.82,32281.12
25667,U28792,39,-10404.270000000004,22,17,102202.98999999999,91798.71999999999
25668,U18714,39,4847.4800000000005,32,7,1942.62,6790.1
25669,U1254871,39,-1081.9399999999998,23,16,12046.24,10964.3
25670,U26475,39,849.7899999999983,23,16,113601.78,114451.56999999999
25671,U611409,39,-9678.850000000002,29,10,20293.129999999997,10614.279999999995
25672,U27691,39,11014.439999999991,28,11,124661.15,135675.59
25673,U40979,39,-5812.490000000002,30,9,48699.810000000005,42887.32000000001
25674,U23500,39,-27427.440000000002,34,5,40081.81,12654.369999999995
25675,U9788,39,42.45999999999003,18,21,153290.45,153332.91
25676,U1199037,39,4479.860000000001,22,17,12478.360000000002,16958.22
25677,U42215,39,140.79999999999984,34,5,3043.2799999999997,3184.0799999999995
25678,U8180,39,-5574.64,36,3,9480.829999999998,3906.189999999998
25679,U33286,39,722.4800000000009,33,6,6857.239999999999,7579.719999999999
25680,U12146,39,2544.800000000001,22,17,47720.600000000006,50265.40000000001
25681,U41323,39,65775.06000000004,28,11,936522.0500000002,1002297.1100000002
25682,U19057,39,316391.97,29,10,105363.0,421754.97
25683,U1031042,39,1721.57,24,15,742.34,2463.91
25684,U16139,39,71946.51,23,16,161089.97999999998,233036.49
25685,U24680,39,2934.3699999999994,30,9,19615.310000000005,22549.680000000004
25686,U13067,39,-4225.269999999997,33,6,41338.11000000001,37112.84000000001
25687,U15617,39,-86523.43999999996,4,35,200600.0,114076.56000000004
25688,U12536,39,-26095.09000000001,30,9,61787.71000000001,35692.619999999995
25689,U35203,39,-7199.469999999999,32,7,22770.49,15571.020000000002
25690,U15420,39,-1133.8899999999999,28,11,47376.16,46242.270000000004
25691,U33248,39,52.01000000000022,27,12,12346.380000000001,12398.390000000001
25692,U36903,39,-62184.63000000002,24,15,283526.61,221341.97999999998
25693,U42992,38,-29023.64,30,8,63998.06,34974.42
25694,U34531,38,7931.100000000004,30,8,23668.32,31599.420000000006
25695,U29202,38,-3752.199999999996,26,12,52825.450000000004,49073.25000000001
25696,U22093,38,-882.45,34,4,1120.3599999999997,237.90999999999963
25697,U1267902,38,-40337.9,19,19,51785.08,11447.18
25698,U23114,38,2325.7400000000125,28,10,58499.28000000003,60825.02000000004
25699,U9951,38,-4883.339999999998,27,11,75152.61000000002,70269.27000000002
25700,U1273324,38,449.8000000000002,27,11,4423.78,4873.58
25701,U19216,38,-184.53000000000065,19,19,19965.559999999998,19781.03
25702,U8484,38,-2167.790000000004,26,12,81460.44999999998,79292.65999999997
25703,U22972,38,-1176.6999999999982,25,13,67464.23,66287.53
25704,U39972,38,-40368.41,24,14,291054.77999999997,250686.36999999997
25705,U10297,38,16.659999999998718,27,11,59930.06,59946.719999999994
25706,U35224,38,27397.100000000013,28,10,398650.18999999994,426047.29
25707,U13923,38,-13.24999999999909,24,14,48859.98,48846.73
25708,U11532,38,-3152.4700000000003,28,10,27652.2,24499.73
25709,U41042,38,-25484.909999999993,28,10,299354.81,273869.9
25710,U15252,38,977190.7700000001,33,5,790374.1099999999,1767564.88
25711,U43457,38,-21766.530000000006,26,12,133561.27,111794.73999999999
25712,U19907,38,4469.620000000003,20,18,243326.46000000002,247796.08000000002
25713,U26982,38,-20172.0,22,16,90537.0,70365.0
25714,U35632,38,-736.1299999999951,19,19,66743.16,66007.03000000001
25715,U27158,38,-4299.229999999998,34,4,22195.43,17896.200000000004
25716,U18112,38,-18917.560000000012,24,14,171756.74999999997,152839.18999999994
25717,U22067,38,-29552.57,30,8,93154.45,63601.88
25718,U29881,38,54728.549999999996,20,18,130597.47,185326.02
25719,U23689,38,26022.119999999988,19,19,215963.77000000002,241985.89
25720,U36656,38,85425.89,16,22,303339.5,388765.39
25721,U25636,38,4051.8999999999974,28,10,22512.599999999984,26564.49999999998
25722,U1185925,38,-6315.649999999999,29,9,9929.649999999998,3613.999999999999
25723,U27904,38,0.0,19,19,57755.76,57755.76
25724,U18985,38,101688.79000000002,19,19,855926.79,957615.5800000001
25725,U13147,38,49806.63,16,22,106990.75,156797.38
25726,U1199720,38,1064.9300000000005,21,17,5872.57,6937.5
25727,U14547,38,4678.789999999996,23,15,268625.42,273304.20999999996
25728,U8318,38,23839.979999999974,17,21,512001.33999999997,535841.32
25729,U23044,38,4102.31000000001,23,15,155419.52,159521.83
25730,U31624,38,1167.0499999999975,20,18,95099.3,96266.35
25731,U25324,38,-7840.609999999995,31,7,92734.13,84893.52
25732,U1171116,38,-159.33999999999995,30,8,2247.75,2088.41
25733,U21295,38,-9786.420000000002,20,18,58893.44,49107.020000000004
25734,U15774,38,176.24999999999454,29,9,297607.7,297783.95
25735,U35677,38,-14758.979999999998,33,5,55049.98,40291.00000000001
25736,U16346,38,-73200.59,21,17,168006.09,94805.5
25737,U29285,38,-32567.260000000006,28,10,123089.92000000001,90522.66
25738,U669336,38,-2534.7299999999996,31,7,3773.7799999999993,1239.0499999999997
25739,U29608,38,14758.810000000003,26,12,56296.5,71055.31
25740,U9531,38,-1667.7599999999998,30,8,60189.950000000004,58522.19
25741,U14861,38,-556265.6800000002,23,15,1126799.54,570533.8599999999
25742,U948521,38,-126.30000000000005,37,1,400.57000000000005,274.27
25743,U8555,38,11144.43,20,18,33714.71,44859.14
25744,U40530,38,6342.000000000002,29,9,27656.320000000003,33998.32000000001
25745,U13516,38,-36002.43999999999,27,11,547238.5900000001,511236.1500000001
25746,U14722,38,10057.7,27,11,27828.809999999998,37886.509999999995
25747,U42873,38,-1548.4099999999999,21,17,63953.270000000004,62404.86
25748,U24782,38,-0.720000000005939,17,21,42802.240000000005,42801.52
25749,U26011,38,-12057.089999999998,26,12,28659.290000000005,16602.200000000004
25750,U29095,38,8602.33,26,12,37998.24,46600.57
25751,U33792,38,-943.8099999999977,25,13,40808.7,39864.89
25752,U23922,38,-52738.989999999976,29,9,253334.3,200595.31
25753,U37360,38,4570.049999999999,28,10,44032.1,48602.149999999994
25754,U42539,38,271.58999999999645,23,15,210944.0,211215.59
25755,U1176656,38,-1801.939999999998,26,12,29334.75,27532.81
25756,U18049,38,10394.859999999977,30,8,531234.1600000001,541629.0200000001
25757,U40571,38,-3935.999999999998,28,10,78315.19,74379.19
25758,U673875,38,564.5400000000002,21,17,7701.250000000001,8265.79
25759,U22555,38,-175997.03000000003,28,10,244687.31,68690.27999999997
25760,U37305,38,10290.760000000006,27,11,89994.3,100285.06000000001
25761,U707269,38,108.48000000000033,21,17,37471.060000000005,37579.54000000001
25762,U20528,38,-32248.14,30,8,53561.740000000005,21313.600000000006
25763,U18986,38,188720.18000000005,21,17,1666529.43,1855249.6099999999
25764,U8277,38,13480.509999999893,22,16,3133666.9,3147147.4099999997
25765,U967093,38,-7857.429999999999,24,14,12580.470000000001,4723.040000000002
25766,U8157,38,30468.750000000004,26,12,30920.88,61389.630000000005
25767,U21700,38,-5063.84,36,2,10545.32,5481.48
25768,U617954,38,2457.7699999999995,24,14,24613.04,27070.81
25769,U17774,38,2297.1899999999923,24,14,116191.33000000002,118488.52
25770,U18871,38,-75887.94000000006,17,21,669501.2,593613.2599999999
25771,U42343,38,53502.21000000001,19,19,140330.5,193832.71000000002
25772,U43492,38,3026.959999999999,33,5,21710.740000000005,24737.700000000004
25773,U24120,38,34036.810000000005,29,9,40096.9,74133.71
25774,U33881,38,11089.269999999999,31,7,173098.20999999993,184187.47999999992
25775,U36055,38,-3615.350000000093,30,8,564195.42,560580.07
25776,U31921,38,14433.380000000001,25,13,80990.7,95424.08
25777,U37115,38,-16473.22,32,6,30449.109999999997,13975.889999999996
25778,U30535,38,11721.689999999988,23,15,1010091.8000000002,1021813.4900000001
25779,U23092,38,-732.399999999993,26,12,286332.72,285600.32
25780,U12873,38,13848.799999999987,28,10,137483.06,151331.86
25781,U31136,38,489.1100000000001,27,11,10303.57,10792.68
25782,U12504,38,-26686.600000000013,17,21,221137.09,194450.49
25783,U36134,38,7440.860000000001,27,11,43474.98,50915.840000000004
25784,U39127,38,30695.809999999998,24,14,51531.17,82226.98
25785,U39145,38,10813.680000000002,25,13,16672.96,27486.64
25786,U16068,38,4000.919999999997,26,12,43903.729999999996,47904.649999999994
25787,U15272,38,19562.100000000002,33,5,30451.05,50013.15
25788,U32998,38,395610.52,33,5,145296.0,540906.52
25789,U19899,38,46839.030000000006,30,8,101371.0,148210.03
25790,U20911,38,2046.28,35,3,3720.01,5766.29
25791,U13513,38,-12495.219999999998,24,14,115515.05,103019.83
25792,U38841,38,-5211.64,28,10,37385.100000000006,32173.460000000006
25793,U37008,38,-105.33999999999988,34,4,10306.1,10200.76
25794,U16905,38,-51743.88,22,16,105868.84,54124.96
25795,U43985,38,17607.95,24,14,4100.07,21708.02
25796,U9112,38,9.050000000000217,33,5,70383.75000000001,70392.80000000002
25797,U20318,38,-3258.810000000004,23,15,76805.58,73546.77
25798,U10842,38,12539.539999999999,26,12,11136.42,23675.96
25799,U16154,38,-3281.7599999999984,24,14,29979.61,26697.850000000002
25800,U13044,38,8079.200000000011,22,16,248694.71000000002,256773.91000000003
25801,U36720,38,40533.79000000001,21,17,191811.13000000003,232344.92000000004
25802,U17076,38,9685.869999999999,23,15,66726.49,76412.36
25803,U21644,38,63519.32999999999,26,12,136726.29,200245.62
25804,U36436,38,20449.91,28,10,104829.66,125279.57
25805,U24169,38,4043.850000000006,22,16,82508.35,86552.20000000001
25806,U42092,38,36170.02,21,17,129130.37000000001,165300.39
25807,U22756,38,-2739.08,24,14,37924.0,35184.92
25808,U34794,38,1716.6800000000057,24,14,59573.54,61290.22000000001
25809,U40045,38,-2935.680000000001,32,6,14239.499999999995,11303.819999999992
25810,U29342,38,137.68999999999994,23,15,1892.9100000000003,2030.6000000000004
25811,U16696,38,-55442.27999999985,14,24,1006963.3799999999,951521.1000000001
25812,U13536,38,-85478.39,24,14,161332.0,75853.61
25813,U21488,38,-1746.3099999998185,19,19,2706412.0,2704665.6900000004
25814,U40247,38,4240.359999999999,20,18,44011.89,48252.25
25815,U42226,38,-59.269999999999676,34,4,4455.87,4396.6
25816,U11401,38,-13304.91,32,6,18621.85,5316.939999999999
25817,U41657,38,-10063.720000000008,22,16,156129.63,146065.91
25818,U14150,38,2574.1399999999976,26,12,148856.27,151430.40999999997
25819,U13000,38,14961.229999999994,26,12,42272.349999999984,57233.57999999998
25820,U9735,38,-18519.840000000084,28,10,570520.0,552000.1599999999
25821,U35417,38,-613.2999999999998,31,7,2509.5400000000004,1896.2400000000007
25822,U31755,38,85169.40000000001,19,19,508333.20999999996,593502.61
25823,U11147,38,607.5900000000014,32,6,21259.759999999995,21867.349999999995
25824,U38990,38,26869.700000000008,31,7,197081.32,223951.02000000002
25825,U33850,38,-1453.2800000000002,24,14,23622.77,22169.49
25826,U34497,38,25858.180000000004,10,28,155337.57,181195.75
25827,U32927,38,-23536.920000000002,29,9,49245.520000000004,25708.600000000002
25828,U1382445,38,-2437.2500000000036,22,16,20111.190000000002,17673.94
25829,U26824,38,2279.340000000003,23,15,30540.930000000008,32820.27000000001
25830,U14636,38,-198.10000000000582,14,24,225878.37,225680.27
25831,U28982,38,-179540.49999999997,24,14,222427.16999999998,42886.67000000001
25832,U37477,38,-11044.05,31,7,35954.3,24910.250000000004
25833,U14084,38,-18267.26,28,10,58444.96000000001,40177.70000000001
25834,U18414,38,22282.739999999998,17,21,111701.20999999999,133983.94999999998
25835,U8234,38,4990.639999999999,24,14,18405.199999999997,23395.839999999997
25836,U13378,38,4291.5099999999975,29,9,91133.28,95424.79
25837,U21346,38,10061.759999999997,28,10,10518.040000000003,20579.8
25838,U604859,38,3035.49,24,14,14476.630000000001,17512.120000000003
25839,U620193,38,-29015.149999999998,30,8,40671.78,11656.630000000001
25840,U16512,38,-51135.64,24,14,171731.8,120596.15999999999
25841,U13024,38,1710.6100000000006,28,10,12131.349999999999,13841.96
25842,U42757,38,8811.470000000001,27,11,137210.84,146022.31
25843,U22268,38,-317926.9,31,7,352030.05,34103.149999999965
25844,U32313,38,-279599.0800000001,24,14,2028636.8199999998,1749037.7399999998
25845,U34278,38,-4399.039999999999,29,9,18614.88,14215.840000000002
25846,U24866,38,6043.360000000001,31,7,28767.35,34810.71
25847,U37930,38,82523.81,15,23,195217.96000000002,277741.77
25848,U42931,38,0.41000000000008185,20,18,89250.0,89250.41
25849,U42281,38,-3709.7699999999986,28,10,31131.200000000004,27421.430000000008
25850,U31734,38,-113906.37999999998,27,11,150693.27999999997,36786.899999999994
25851,U35234,38,-204.35999999999967,31,7,14931.0,14726.64
25852,U27977,38,-1111.989999999998,23,15,128014.34999999999,126902.35999999999
25853,U10104,38,-1426.409999999999,20,18,80816.62,79390.20999999999
25854,U31231,38,2.842170943040401e-14,19,19,37859.32,37859.32
25855,U18429,38,25924.27,23,15,68878.64000000001,94802.91000000002
25856,U27082,38,-259211.47999999998,30,8,557097.5,297886.02
25857,U18418,38,23900.430000000004,26,12,15236.97,39137.4
25858,U31041,38,-597058.7100000001,24,14,702107.8,105049.08999999997
25859,U900457,38,-0.029999999999267862,26,12,21973.57,21973.54
25860,U12150,38,3998.4700000000034,31,7,85069.41,89067.88
25861,U9173,38,-5026.039999999945,19,19,946291.3099999999,941265.27
25862,U627694,38,-108189.90999999999,36,2,108789.90999999999,600.0
25863,U41404,38,-41544.20000000001,33,5,160547.63,119003.43
25864,U16359,38,612.9900000000004,32,6,11087.150000000001,11700.140000000001
25865,U1344461,38,-1485.6600000000003,29,9,11002.41,9516.75
25866,U39199,38,21311.440000000006,25,13,72038.37000000001,93349.81000000001
25867,U41168,38,-1566.8500000000008,19,19,31449.21,29882.359999999997
25868,U31255,38,88049.99,23,15,863094.0,951143.99
25869,U17750,38,1518.3799999999999,34,4,5126.58,6644.96
25870,U1214054,38,67.21000000000008,18,20,1659.1,1726.31
25871,U26605,38,-17780.870000000006,27,11,330632.07,312851.2
25872,U25167,38,-1190.5700000000265,25,13,54417.36000000003,53226.79
25873,U39103,38,-56873.98,31,7,126884.02,70010.04000000001
25874,U9373,38,-18611.89,21,17,66417.53,47805.64
25875,U30481,38,10929.060000000005,23,15,40945.24,51874.3
25876,U13605,38,-22171.640000000127,20,18,728084.1499999999,705912.5099999998
25877,U1272691,38,-31.579999999999163,27,11,75080.66,75049.08
25878,U41214,38,12206.279999999999,15,23,412000.0,424206.28
25879,U37529,38,62533.42999999997,14,24,561508.76,624042.19
25880,U38643,38,-1299.8400000000015,30,8,21723.530000000002,20423.690000000002
25881,U23111,38,33696.96999999998,16,22,3252381.64,3286078.6100000003
25882,U30074,38,-4602.409999999999,33,5,15795.7,11193.29
25883,U21334,38,1632.2499999999995,29,9,22272.07,23904.32
25884,U40830,38,-486.06000000000347,30,8,68916.05999999998,68429.99999999999
25885,U20725,38,67356.23000000003,18,20,468043.7,535399.93
25886,U33436,38,5868.8600000000015,28,10,29314.800000000003,35183.66
25887,U40931,38,-48764.78999999999,26,12,148944.5,100179.71
25888,U13194,38,-78325.04000000001,16,22,350700.0,272374.95999999996
25889,U19585,38,-4039.010000000002,23,15,43833.36,39794.35
25890,U27267,38,5503.489999999999,30,8,25522.300000000003,31025.79
25891,U24008,38,-3930.2500000000055,26,12,40231.53,36301.27999999999
25892,U38972,38,24507.069999999996,27,11,25113.030000000002,49620.1
25893,U40853,38,44839.68999999998,31,7,85829.16999999997,130668.85999999996
25894,U24073,38,4590.710000000004,27,11,78807.4,83398.11
25895,U25088,38,42945.959999999985,32,6,43044.03,85989.98999999999
25896,U43631,38,39612.7,18,20,17401.489999999998,57014.189999999995
25897,U19012,38,-10329.039999999999,29,9,39783.21000000001,29454.170000000006
25898,U8304,38,104350.6,24,14,28237.609999999997,132588.21
25899,U596342,38,-1148.75,25,13,5934.84,4786.09
25900,U15188,38,-17204.099999999977,25,13,411559.76999999996,394355.67
25901,U38961,38,2098.3200000000015,27,11,67367.67,69465.99
25902,U11932,38,-484.8400000000001,35,3,4197.63,3712.79
25903,U14005,38,-35754.45,33,5,39972.76,4218.310000000005
25904,U29134,38,8206.760000000002,31,7,17275.2,25481.960000000003
25905,U1100019,38,13975.11,24,14,34964.93,48940.04
25906,U33520,38,18671.6,28,10,100381.89,119053.48999999999
25907,U20090,38,498.49000000000024,34,4,3301.76,3800.2500000000005
25908,U42969,38,-4647.590000000002,20,18,35815.46000000001,31167.870000000003
25909,U20708,38,-428.52999999999884,32,6,13481.96,13053.43
25910,U19466,38,-19890.940000000002,29,9,50039.36,30148.42
25911,U10843,38,2205.739999999999,32,6,30574.850000000006,32780.590000000004
25912,U34209,38,-12158.890000000001,28,10,77182.13999999997,65023.24999999997
25913,U38149,38,-399.85000000000014,30,8,9842.060000000001,9442.210000000001
25914,U14339,38,22198.36,24,14,34110.38,56308.74
25915,U37401,38,-20492.000000000007,20,18,253676.50999999998,233184.50999999998
25916,U19253,38,-1067.46,23,15,15347.0,14279.54
25917,U43757,38,-26963.609999999997,30,8,136152.98,109189.37000000001
25918,U11816,38,-1532.8499999999988,26,12,52897.87,51365.020000000004
25919,U37678,38,2018.5000000000027,21,17,130770.05,132788.55000000002
25920,U12060,38,-1294.8900000000103,20,18,113572.39,112277.49999999999
25921,U31840,38,-778.17,34,4,3809.4300000000007,3031.2600000000007
25922,U10550,38,-6696.25000000001,27,11,167350.15000000002,160653.90000000002
25923,U16823,38,6324.720000000001,20,18,110947.43,117272.15
25924,U42145,38,48206.12999999999,23,15,53007.409999999996,101213.53999999998
25925,U32488,38,11185.639999999998,22,16,149314.27999999997,160499.91999999995
25926,U23388,38,7019.6500000000015,25,13,70241.15,77260.79999999999
25927,U14458,38,-4079.699999999998,28,10,39882.41,35802.71000000001
25928,U9088,38,-3704.8599999999988,23,15,23712.440000000002,20007.58
25929,U34884,38,-5988.379999999999,31,7,16776.979999999996,10788.599999999997
25930,U777297,38,36726.27,18,20,5944.9,42671.17
25931,U8906,38,-36010.53,33,5,78496.89000000001,42486.360000000015
25932,U11100,38,-395.7999999999997,21,17,36824.68,36428.88
25933,U23538,38,-193.13999999999987,35,3,2857.2199999999993,2664.0799999999995
25934,U20397,38,1190.9799999999998,31,7,32576.659999999996,33767.64
25935,U35132,38,-3110.29,31,7,8339.36,5229.070000000001
25936,U18073,38,41701.59,29,9,87833.39,129534.98
25937,U34835,38,-2061.0899999999965,25,13,39565.0,37503.91
25938,U1077542,38,7.339999999999918,19,19,3872.04,3879.38
25939,U17738,38,6043.6799999999985,17,21,22193.28,28236.96
25940,U35066,38,-616.9899999999992,32,6,16163.24,15546.25
25941,U12576,38,-1144.5999999999995,30,8,16730.82,15586.220000000001
25942,U38655,38,-3198.4699999999984,31,7,29386.23,26187.760000000002
25943,U27636,38,1444.7400000000002,30,8,120036.34999999999,121481.09
25944,U1121679,38,-15078.79,28,10,24501.1,9422.309999999998
25945,U9886,38,-3275.3199999999997,25,13,11161.300000000001,7885.980000000001
25946,U41677,38,1224.4000000000397,21,17,394583.0,395807.4
25947,U11930,38,-3554.359999999995,34,4,22926.64,19372.280000000006
25948,U24785,38,-4330.230000000001,29,9,29384.56,25054.33
25949,U27148,38,3463.4199999999983,22,16,95066.31999999999,98529.73999999999
25950,U12734,38,-34072.62999999999,14,24,411983.76999999996,377911.13999999996
25951,U9671,38,-15431.89,34,4,27150.920000000002,11719.030000000002
25952,U26573,38,7618.060000000002,21,17,94353.61000000002,101971.67000000001
25953,U41137,38,10794.220000000001,24,14,40998.979999999996,51793.2
25954,U12663,38,-4877.69,27,11,10987.97,6110.28
25955,U11792,38,130698.05999999997,23,15,208996.42000000004,339694.48
25956,U42201,38,-8061.170000000016,22,16,370299.85,362238.67999999993
25957,U10849,38,9503.469999999994,29,9,55721.170000000006,65224.64
25958,U705559,38,-120.93000000000023,20,18,6731.73,6610.799999999999
25959,U18560,37,30656.630000000012,24,13,26914.410000000003,57571.040000000015
25960,U10588,37,56592.26999999996,15,22,819776.4500000001,876368.72
25961,U31649,37,-5724.980000000002,32,5,51672.94000000001,45947.96000000001
25962,U24082,37,-124942.75000000001,17,20,233750.0,108807.24999999999
25963,U35579,37,3812.2799999999997,29,8,9495.69,13307.970000000001
25964,U19288,37,-7956.6,25,12,101921.32999999999,93964.72999999998
25965,U9610,37,-95494.06,31,6,250290.37999999998,154796.31999999998
25966,U41379,37,963.4600000000064,29,8,87639.36,88602.82
25967,U38844,37,-202.95999999999992,28,9,15366.7,15163.740000000002
25968,U38701,37,-85531.61999999998,30,7,314031.82,228500.2
25969,U34834,37,23443.820000000003,21,16,65919.42,89363.24
25970,U36079,37,-1450.2399999999984,31,6,7211.610000000001,5761.370000000003
25971,U14095,37,3821.749999999991,25,12,73319.56999999999,77141.31999999998
25972,U38772,37,-19753.409999999974,21,16,964981.1100000001,945227.7000000002
25973,U38256,37,-231.09000000000015,20,17,120694.0,120462.91
25974,U42962,37,5055.950000000001,29,8,13263.970000000001,18319.920000000002
25975,U26930,37,44055.98999999999,22,15,174686.0,218741.99
25976,U8741,37,11964.6,29,8,28379.040000000005,40343.64000000001
25977,U13947,37,-532.6099999999997,23,14,6946.0,6413.39
25978,U37804,37,11876.08000000003,19,18,337758.29000000004,349634.37000000005
25979,U31210,37,-4415.209999999999,31,6,6082.4299999999985,1667.2199999999993
25980,U32880,37,281.48999999999967,23,14,3172.18,3453.6699999999996
25981,U22157,37,3770.1100000000006,20,17,89435.05,93205.16
25982,U42043,37,-35.71999999999389,27,10,75419.43,75383.70999999999
25983,U11090,37,307.1099999999997,27,10,27459.170000000002,27766.280000000002
25984,U20225,37,-15186.619999999992,30,7,136266.78,121080.16
25985,U35187,37,8497.510000000002,28,9,10338.669999999998,18836.18
25986,U38568,37,-2877.700000000005,24,13,164057.18,161179.47999999998
25987,U32420,37,370.86999999999125,18,19,47730.520000000004,48101.38999999999
25988,U30048,37,-6336.000000000002,25,12,195145.75999999995,188809.75999999995
25989,U40091,37,-133256.78,26,11,343479.05,210222.27
25990,U13413,37,-11519.73,23,14,92979.05,81459.32
25991,U10565,37,-403.90000000000146,21,16,45472.35,45068.45
25992,U10577,37,930.329999999993,16,21,282705.3,283635.63
25993,U671647,37,-9.999999999999957,32,5,5210.01,5200.01
25994,U27090,37,-1306.6200000000001,34,3,1928.0,621.3799999999999
25995,U12217,37,39800.109999999986,22,15,243996.5,283796.61
25996,U31419,37,59389.44,20,17,3275032.2199999997,3334421.6599999997
25997,U577630,37,-30349.019999999997,26,11,64785.100000000006,34436.08000000001
25998,U24617,37,-2244.869999999949,27,10,2172273.229999999,2170028.359999999
25999,U618203,37,-5117.139999999999,24,13,9077.16,3960.0200000000004
26000,U25106,37,856.9300000000001,24,13,16798.51,17655.44
26001,U19077,37,9283.1,34,3,2448.23,11731.33
26002,U612423,37,-10500.520000000002,27,10,21724.800000000003,11224.28
26003,U26653,37,16828.960000000003,32,5,10442.019999999999,27270.980000000003
26004,U10444,37,-9955.650000000001,31,6,33777.7,23822.049999999996
26005,U34761,37,-1730.4099999999992,33,4,15038.42,13308.01
26006,U8742,37,-4745.020000000008,26,11,172839.41,168094.38999999998
26007,U39609,37,85201.6,13,24,230392.98,315594.58
26008,U28413,37,-269.7399999999998,33,4,5370.020000000002,5100.2800000000025
26009,U34541,37,-106.16000000000076,19,18,40552.020000000004,40445.86
26010,U23305,37,28892.499999999996,25,12,25594.47,54486.97
26011,U13123,37,15440.139999999998,26,11,223443.76,238883.9
26012,U29173,37,-30856.62,33,4,61237.19,30380.570000000003
26013,U15194,37,-9323.35,28,9,67487.73,58164.38
26014,U38223,37,1753.2700000000004,28,9,19074.43,20827.7
26015,U1297599,37,-26.74000000000005,22,15,2712.71,2685.97
26016,U29232,37,-227548.72000000003,22,15,717718.0,490169.27999999997
26017,U31339,37,-6518.490000000002,30,7,32752.760000000002,26234.27
26018,U15923,37,-2659.7900000001537,17,20,3800234.42,3797574.63
26019,U21810,37,68.80000000000146,27,10,51571.68,51640.48
26020,U38214,37,34106.599999999955,30,7,502516.63999999996,536623.2399999999
26021,U12878,37,2420.7800000000007,32,5,37280.94999999999,39701.72999999999
26022,U700206,37,840.1000000000001,17,20,3619.84,4459.9400000000005
26023,U27836,37,-782.52,31,6,4901.55,4119.030000000001
26024,U25471,37,-5461.579999999998,29,8,44152.17,38690.59
26025,U41008,37,1494.02,23,14,19274.42,20768.44
26026,U14460,37,-6550.18,31,6,14250.83,7700.65
26027,U19774,37,6151.800000000001,19,18,157422.6,163574.4
26028,U21098,37,12708.21,27,10,7705.15,20413.36
26029,U585239,37,-10703.95,36,1,10928.95,225.0
26030,U21403,37,14288.899999999998,24,13,29130.070000000003,43418.97
26031,U39871,37,-1830281.71,21,16,2822697.0,992415.29
26032,U14003,37,-33210.4,29,8,37976.66,4766.260000000002
26033,U17314,37,38863.87,23,14,220365.17999999996,259229.04999999996
26034,U22255,37,12009.549999999994,23,14,167191.6,179201.15
26035,U11209,37,36385.649999999994,27,10,54409.86,90795.51
26036,U29225,37,-182139.0,21,16,2738031.49,2555892.49
26037,U35705,37,-18625.739999999998,32,5,23979.12,5353.380000000001
26038,U27918,37,1109.9900000000007,32,5,9792.500000000002,10902.490000000002
26039,U18312,37,-1302.3800000000083,30,7,90536.70000000003,89234.32000000002
26040,U26893,37,19272.96,28,9,14017.64,33290.6
26041,U22141,37,0.0,18,19,32424.879999999997,32424.879999999997
26042,U17223,37,57667.10000000001,25,12,155756.59000000003,213423.69000000003
26043,U32102,37,55819.779999999984,18,19,79547.0,135366.77999999997
26044,U27447,37,23942.680000000008,20,17,108157.63,132100.31
26045,U30632,37,1178.2800000000002,31,6,17764.88,18943.16
26046,U30458,37,2134.85,15,22,1571.56,3706.41
26047,U33632,37,9775.560000000001,30,7,45859.3,55634.86
26048,U1323847,37,-2174.88,22,15,12052.599999999999,9877.719999999998
26049,U19115,37,-1572.6299999999815,22,15,510774.5,509201.87
26050,U900592,37,713.9200000000001,17,20,44763.0,45476.92
26051,U20451,37,-37513.10999999999,27,10,64895.15999999999,27382.049999999996
26052,U39397,37,-36632.52000000001,17,20,380525.5,343892.98
26053,U22112,37,-13954.19999999999,29,8,242479.09000000003,228524.89000000004
26054,U40430,37,-930.4100000000017,15,22,360820.14,359889.73000000004
26055,U25276,37,73761.85,16,21,76466.0,150227.85
26056,U9386,37,-40045.92999999999,25,12,156811.94000000003,116766.01000000004
26057,U11329,37,-245949.5,33,4,268746.19,22796.690000000002
26058,U29002,37,-51.159999999999854,26,11,30969.23,30918.07
26059,U39735,37,-208686.69,32,5,260843.06,52156.369999999995
26060,U9188,37,-46428.71999999997,27,10,519234.72000000003,472806.00000000006
26061,U43193,37,-125.61999999999898,29,8,11671.08,11545.460000000001
26062,U30303,37,-764.9400000000023,29,8,267576.63999999996,266811.69999999995
26063,U13729,37,10444.419999999998,24,13,54969.85,65414.27
26064,U831861,37,-376.41999999999916,28,9,21283.170000000002,20906.750000000004
26065,U25112,37,-885.5700000000004,21,16,6062.199999999999,5176.629999999998
26066,U25994,37,17725.030000000024,26,11,321350.91,339075.94
26067,U26513,37,-18912.55,25,12,82591.98000000001,63679.43000000001
26068,U42991,37,-1961.360000000002,25,12,36362.59,34401.229999999996
26069,U1206758,37,-287.9799999999999,26,11,2259.12,1971.1399999999999
26070,U37288,37,868.5900000000005,30,7,10143.699999999999,11012.289999999999
26071,U8426,37,32042.769999999993,23,14,137743.71999999997,169786.48999999996
26072,U20805,37,-6886.59,31,6,20539.65,13653.060000000001
26073,U21781,37,-3799.7199999999975,25,12,42029.770000000004,38230.05
26074,U37416,37,-320.3500000000001,31,6,9815.409999999994,9495.059999999994
26075,U28922,37,4527.809999999999,27,10,46986.37,51514.18
26076,U23748,37,2214.969999999999,16,21,28338.200000000004,30553.170000000002
26077,U30090,37,-5595.949999999997,25,12,75384.06,69788.11
26078,U24672,37,1028.6499999999824,20,17,1793378.93,1794407.5799999998
26079,U38337,37,23186.11000000003,26,11,366505.87,389691.98000000004
26080,U17712,37,5295.920000000028,18,19,812048.46,817344.38
26081,U15670,37,48483.779999999824,24,13,1100484.44,1148968.2199999997
26082,U36388,37,193253.22999999995,23,14,742469.76,935722.99
26083,U9888,37,-37739.810000000005,32,5,86893.14000000001,49153.33000000001
26084,U37913,37,19830.28999999998,24,13,172866.75999999998,192697.04999999996
26085,U1375538,37,-7201.62,30,7,8116.68,915.0600000000004
26086,U30613,37,-2099.4700000000003,32,5,6895.650000000001,4796.18
26087,U34313,37,-269504.93999999994,27,10,3397362.85,3127857.91
26088,U26340,37,113.90000000000002,31,6,536.2099999999998,650.1099999999998
26089,U20219,37,2044.1899999999923,26,11,67365.12000000002,69409.31000000001
26090,U15974,37,23856.470000000005,25,12,138397.0,162253.47
26091,U819573,37,113.03999999999974,23,14,4374.28,4487.32
26092,U38571,37,-502937.34,32,5,553497.2800000003,50559.940000000235
26093,U37814,37,484880.07,21,16,569737.93,1054618.0
26094,U30314,37,1363.7600000000007,28,9,11125.46,12489.22
26095,U8287,37,3225.6100000000006,19,18,215009.09,218234.7
26096,U20978,37,-18300.17,29,8,41492.880000000005,23192.710000000006
26097,U22249,37,2236.1699999999983,26,11,23014.780000000002,25250.95
26098,U43531,37,-2527.5299999999997,26,11,15031.83,12504.3
26099,U12589,37,-24690.18,27,10,145553.42,120863.24000000002
26100,U21221,37,582.820000000007,34,3,74618.9,75201.72
26101,U31271,37,10.91999999999939,19,18,20459.219999999998,20470.139999999996
26102,U31367,37,-866.3,29,8,4305.02,3438.7200000000003
26103,U16844,37,1021194.9100000001,20,17,404878.69999999995,1426073.61
26104,U22833,37,-4654.729999999995,29,8,107884.2,103229.47
26105,U27906,37,-1805.0699999999997,28,9,16731.010000000002,14925.940000000002
26106,U43922,37,12695.74,24,13,51795.82,64491.56
26107,U18515,37,6335.519999999998,30,7,60326.0,66661.52
26108,U9655,37,1824.29,24,13,26017.33,27841.620000000003
26109,U21586,37,315.96000000000004,22,15,5507.029999999999,5822.989999999999
26110,U27975,37,4474.239999999998,17,20,47423.2,51897.439999999995
26111,U41800,37,-4692.360000000001,28,9,127773.57,123081.21
26112,U43452,37,-11.089999999992415,20,17,63649.5,63638.41000000001
26113,U18911,37,93.25,32,5,10740.769999999999,10834.019999999999
26114,U25226,37,1590.8300000000163,13,24,916985.8300000001,918576.6600000001
26115,U42275,37,250.45000000000016,24,13,3861.85,4112.3
26116,U35002,37,-1581.990000000002,27,10,50583.409999999996,49001.41999999999
26117,U8702,37,14149.229999999996,24,13,97418.61,111567.84
26118,U30905,37,-833.23,35,2,2333.76,1500.5300000000002
26119,U36247,37,10720.139999999998,25,12,69852.11,80572.25
26120,U22822,37,967.2799999999994,26,11,18276.86,19244.14
26121,U41402,37,-18768.550000000003,29,8,80186.64,61418.09
26122,U28154,37,-72527.25,30,7,240607.28999999998,168080.03999999998
26123,U24057,37,-4026.140000000003,24,13,48453.310000000005,44427.17
26124,U18086,37,-2005344.2999999998,15,22,13378000.0,11372655.7
26125,U15773,37,-19837.120000000003,29,8,42465.420000000006,22628.300000000003
26126,U1203823,37,-13933.699999999999,34,3,13933.73,0.030000000000654836
26127,U1170580,37,-7104.120000000003,25,12,18429.09,11324.969999999998
26128,U43264,37,-51.09999999999708,29,8,39312.17000000001,39261.070000000014
26129,U736473,37,282.67,32,5,3632.8999999999996,3915.5699999999997
26130,U28203,37,13707.970000000001,34,3,1880.8300000000002,15588.800000000001
26131,U35970,37,125.62000000000297,24,13,51159.020000000004,51284.64000000001
26132,U17444,37,-2987319.02,29,8,6041674.3999999985,3054355.3799999985
26133,U1146828,37,200.03000000000043,21,16,11830.930000000002,12030.960000000003
26134,U1035488,37,-453.7299999999999,29,8,3328.75,2875.02
26135,U977731,37,-791.1500000000001,26,11,7203.929999999999,6412.779999999999
26136,U34560,37,-1256.1799999999942,28,9,91818.59,90562.41
26137,U21125,37,964.3500000000004,25,12,20255.46,21219.809999999998
26138,U22659,37,-70.53000000000088,26,11,23713.4,23642.87
26139,U26563,37,5206.7699999999895,19,18,230413.87999999998,235620.64999999997
26140,U31729,37,9930.649999999998,22,15,41989.69,51920.34
26141,U38447,37,305.7600000000069,19,18,767799.85,768105.61
26142,U579551,37,-8735.63,30,7,16860.63,8125.000000000002
26143,U23153,37,50.88999999999794,22,15,288708.1599999999,288759.04999999993
26144,U21169,37,-1719.7799999999968,29,8,33832.29000000001,32112.510000000013
26145,U25291,37,5409.589999999997,21,16,326077.35,331486.94
26146,U21271,37,-7134.720000000001,26,11,11101.71,3966.989999999998
26147,U40987,37,-9506.670000000002,33,4,24252.319999999996,14745.649999999994
26148,U11293,37,-11842.369999999997,26,11,38578.700000000004,26736.33000000001
26149,U43485,37,-15439.150000000001,28,9,55414.18,39975.03
26150,U22173,37,-916.76,33,4,3938.55,3021.79
26151,U31491,37,-10993.419999999998,26,11,182564.01999999993,171570.59999999992
26152,U17103,37,-908.3499999999939,24,13,101169.04,100260.69
26153,U26693,37,-3871.2700000000186,17,20,514823.92000000004,510952.65
26154,U14247,37,-167.6200000000058,21,16,365690.54000000004,365522.92000000004
26155,U31276,37,-7005.539999999999,29,8,28677.640000000003,21672.100000000006
26156,U29937,37,43365.81,26,11,153470.41,196836.22
26157,U22044,37,27.980000000000018,27,10,46406.76000000001,46434.74000000001
26158,U17641,37,-10425.789999999994,28,9,108062.0,97636.21
26159,U23555,37,-32.38999999999942,25,12,104652.51999999999,104620.12999999999
26160,U1162360,37,-2030.8699999999985,26,11,15245.79,13214.920000000002
26161,U9168,37,14651.97,29,8,24886.87,39538.84
26162,U40639,37,-3389.81,37,0,3389.81,0.0
26163,U9058,37,1.8189894035458565e-12,18,19,132784.54,132784.54
26164,U17013,37,43054.450000000026,16,21,870436.04,913490.4900000001
26165,U34203,37,-10699.729999999992,30,7,48205.979999999996,37506.25
26166,U8998,37,1372.1800000000003,31,6,5302.16,6674.34
26167,U12754,37,-36433.95,32,5,50156.53,13722.580000000002
26168,U27282,37,-2110.8500000000004,31,6,11088.509999999998,8977.659999999998
26169,U23846,37,-25916.699999999997,26,11,91903.20000000001,65986.50000000001
26170,U20422,37,8610.699999999997,26,11,67665.31,76276.01
26171,U42882,37,1218.9500000000012,30,7,19870.399999999998,21089.35
26172,U25175,37,-526.2200000000001,30,7,2749.9100000000017,2223.6900000000014
26173,U25182,37,6329.820000000007,24,13,268349.66000000003,274679.48000000004
26174,U17506,37,326824.3199999999,25,12,24656.61,351480.9299999999
26175,U39915,37,2797.019999999999,31,6,24380.559999999998,27177.579999999998
26176,U17216,37,-175524.2,29,8,555658.8,380134.60000000003
26177,U14952,37,-4832.170000000002,25,12,19105.5,14273.329999999998
26178,U12276,37,636.5799999999999,26,11,7521.869999999999,8158.449999999999
26179,U40051,37,10478.539999999977,18,19,1971979.1399999997,1982457.6799999997
26180,U16282,37,13450.51999999999,28,9,131576.6,145027.12
26181,U15535,37,23986.249999999985,21,16,184094.81,208081.06
26182,U32976,37,3794.0199999999986,24,13,11783.68,15577.699999999999
26183,U28606,37,311.49999999999955,26,11,22669.59,22981.09
26184,U9588,37,-105408.73000000001,19,18,509751.42,404342.68999999994
26185,U14009,37,78711.85000000003,18,19,351494.56,430206.41000000003
26186,U17147,37,621550.26,10,27,175229.0,796779.26
26187,U9832,37,-1356.5300000000002,35,2,2416.5300000000007,1060.0000000000005
26188,U41532,37,-2493.369999999999,29,8,21501.62,19008.25
26189,U38136,37,14569.780000000059,20,17,642923.78,657493.56
26190,U1249729,37,-3244.069999999999,24,13,16413.510000000002,13169.440000000002
26191,U991967,37,196.46999999999866,20,17,40672.850000000006,40869.32000000001
26192,U27780,37,-27429.63,30,7,78052.48999999999,50622.859999999986
26193,U607202,37,-1646.3700000000026,27,10,74048.49,72402.12
26194,U31691,37,-7585.62,30,7,28712.91,21127.29
26195,U900222,37,-2463.739999999999,25,12,18898.61,16434.870000000003
26196,U36627,37,-4656.4699999999975,24,13,50109.240000000005,45452.770000000004
26197,U35337,37,16593.700000000004,24,13,36624.82,53218.520000000004
26198,U9367,37,8872.409999999916,15,22,1543552.17,1552424.5799999998
26199,U24389,37,-2385.829999999958,15,22,3154063.35,3151677.52
26200,U1103118,37,-15004.43,20,17,21067.83,6063.4000000000015
26201,U21057,37,-163647.85000000015,30,7,973281.3900000002,809633.54
26202,U25071,37,4422.230000000003,25,12,48891.45999999999,53313.689999999995
26203,U29071,37,291197.69999999995,19,18,463429.3,754627.0
26204,U21791,37,-4015.37,32,5,17377.76,13362.39
26205,U23293,37,-38563.92000000001,25,12,353722.0,315158.07999999996
26206,U41099,37,-3374.59,33,4,35293.45,31918.859999999997
26207,U41027,37,-37505.54,30,7,54136.08,16630.54
26208,U20189,37,290.56999999999874,28,9,41003.73999999998,41294.30999999998
26209,U26894,37,-6601.420000000015,27,10,315889.37,309287.94999999995
26210,U39811,37,6925.9,27,10,9716.460000000001,16642.36
26211,U37948,37,-2644.18,31,6,9226.28,6582.1
26212,U27363,37,63108.909999999996,16,21,130031.71000000002,193140.62000000002
26213,U38915,37,104.06000000000257,20,17,50464.060000000005,50568.12000000001
26214,U32723,37,-8489.410000000003,26,11,195534.64,187045.23
26215,U29626,37,51267.11,22,15,89906.14,141173.25
26216,U23266,37,-47269.39,23,14,196416.81,149147.41999999998
26217,U25127,37,-1707.4299999999994,32,5,27446.260000000002,25738.83
26218,U15819,37,-826.7300000000026,23,14,78565.80999999998,77739.07999999999
26219,U12487,37,-3700.6500000000015,26,11,29893.579999999998,26192.929999999997
26220,U33427,37,2837.1500000000005,24,13,20117.43,22954.58
26221,U33233,37,-115.19999999999942,27,10,15285.429999999998,15170.23
26222,U28976,37,-70113.63,20,17,400723.68000000005,330610.05000000005
26223,U978031,37,-2472.3300000000004,30,7,16908.14,14435.81
26224,U21430,37,1663.88,16,21,1632.79,3296.67
26225,U34139,37,-40592.49,26,11,102652.79999999999,62060.30999999999
26226,U8395,37,3286.7899999999995,23,14,60500.700000000004,63787.490000000005
26227,U22048,37,651.5799999999999,28,9,55747.759999999995,56399.34
26228,U1141961,37,102.07999999999937,21,16,12981.789999999999,13083.869999999999
26229,U9060,37,273.0799999999963,22,15,78434.62,78707.7
26230,U42255,37,-8897.470000000054,28,9,336130.31000000006,327232.84
26231,U973268,37,49389.229999999996,13,24,8760.1,58149.329999999994
26232,U43064,37,11159.179999999997,29,8,28713.310000000005,39872.490000000005
26233,U18625,37,928.4299999999348,24,13,2467873.94,2468802.37
26234,U9684,37,74911.49,27,10,85161.03,160072.52000000002
26235,U16049,37,1540.3799999999983,20,17,120229.20999999999,121769.59
26236,U34388,37,-246.4400000000005,31,6,10915.699999999999,10669.259999999998
26237,U748665,37,-4288.95,23,14,8369.62,4080.670000000001
26238,U27211,37,-59909.67000000001,24,13,228766.83,168857.15999999997
26239,U24905,37,57216.05000000001,16,21,112853.02,170069.07
26240,U27960,37,754.2799999999988,14,23,397514.0,398268.28
26241,U1059876,37,-3743.66,20,17,12947.679999999998,9204.019999999999
26242,U1341328,37,-5354.109999999999,25,12,27744.17,22390.059999999998
26243,U31067,37,29756.74000000001,21,16,197134.6,226891.34000000003
26244,U20906,37,-5430.53,28,9,39510.299999999996,34079.77
26245,U34236,37,-6889.239999999991,17,20,823096.0199999999,816206.7799999999
26246,U9781,37,-3128.4199999999996,22,15,104419.95999999999,101291.54
26247,U1098258,37,189.55999999999995,26,11,4060.4399999999996,4250.0
26248,U30812,37,-1060.620000000001,29,8,9791.29,8730.67
26249,U31081,37,-49525.899999999994,28,9,92073.1,42547.20000000001
26250,U22726,37,1401618.75,19,18,1912971.7600000002,3314590.5100000002
26251,U40318,37,-1936.550000000001,33,4,7998.76,6062.209999999999
26252,U23672,37,66446.36999999995,7,30,480855.1,547301.47
26253,U15223,37,0.5700000000012722,25,12,19785.180000000004,19785.750000000004
26254,U26640,37,-75667.11,31,6,176370.75,100703.64
26255,U39295,37,3132.5299999999997,34,3,1868.68,5001.21
26256,U28640,37,7804.210000000005,30,7,15409.299999999997,23213.510000000002
26257,U26886,37,-29249.469999999877,16,21,2913050.0,2883800.5300000003
26258,U1329024,37,92.76999999999771,23,14,49505.520000000004,49598.29
26259,U25434,37,11810.060000000009,28,9,277424.47,289234.52999999997
26260,U25877,37,-42837.94000000001,16,21,654161.3600000001,611323.42
26261,U32710,37,-1889.45,32,5,23955.31,22065.86
26262,U18571,37,-2870.5300000000034,32,5,22391.86999999999,19521.33999999999
26263,U11694,37,-48091.30999999999,25,12,212656.48999999996,164565.17999999996
26264,U29049,37,21807.890000000003,24,13,64628.399999999994,86436.29
26265,U30641,37,-496.84000000000003,25,12,2900.77,2403.93
26266,U22976,37,-23391.75,20,17,98723.5,75331.75
26267,U20546,36,1511.1400000000012,21,15,112511.81,114022.95
26268,U33558,36,-45044.979999999996,28,8,53093.34999999999,8048.369999999995
26269,U21936,36,-107001.72000000002,20,16,594211.4199999999,487209.6999999999
26270,U17447,36,-58872.27999999851,19,17,30176302.72,30117430.44
26271,U900382,36,15.740000000000009,23,13,753.74,769.48
26272,U10106,36,1156.0500000000002,32,4,17555.55,18711.6
26273,U36276,36,-31348.680000000008,18,18,113423.06,82074.37999999999
26274,U35285,36,-6427.389999999998,29,7,36256.240000000005,29828.850000000006
26275,U28233,36,-42132.45,25,11,88039.3,45906.850000000006
26276,U23308,36,17378.100000000006,17,19,141458.49000000002,158836.59000000003
26277,U16413,36,74.29999999999745,21,15,76479.37,76553.67
26278,U28432,36,-27.57000000000164,26,10,25287.379999999997,25259.809999999994
26279,U1203179,36,-637.9000000000001,31,5,3938.399999999999,3300.499999999999
26280,U18144,36,1326.1300000000003,24,12,18203.89,19530.02
26281,U29531,36,64233.25999999995,12,24,1108872.45,1173105.71
26282,U34600,36,-776.3100000000076,22,14,159321.78000000003,158545.47000000003
26283,U31333,36,45519.080000000016,22,14,161644.0,207163.08000000002
26284,U1101679,36,-5200.299999999998,29,7,9547.009999999998,4346.71
26285,U38803,36,-2660.780000000028,19,17,366384.5,363723.72
26286,U35301,36,-57.70000000000023,27,9,3823.76,3766.06
26287,U17761,36,-5859.599999999999,30,6,14518.660000000002,8659.060000000001
26288,U31040,36,-55638.48000000001,17,19,230833.93000000002,175195.45
26289,U41040,36,205679.34999999998,22,14,434445.16,640124.51
26290,U12369,36,636.4000000000005,31,5,5535.19,6171.59
26291,U42189,36,-36255.61999999999,16,20,406690.48000000004,370434.86000000004
26292,U10231,36,-26115.219999999998,25,11,213202.0,187086.78
26293,U42644,36,-30.049999999999272,23,13,24886.4,24856.350000000002
26294,U41297,36,256924.15000000002,13,23,331536.0,588460.15
26295,U19148,36,500.74000000000524,16,20,286394.2,286894.94
26296,U29552,36,2007.5200000000013,27,9,11468.49,13476.010000000002
26297,U42566,36,11633.059999999998,25,11,32753.340000000004,44386.4
26298,U37992,36,-48017.67000000001,19,17,557603.8499999999,509586.1799999998
26299,U33419,36,371.3100000000004,27,9,27196.03,27567.34
26300,U10245,36,-6438.329999999998,21,15,36428.79,29990.460000000003
26301,U11598,36,15440.170000000002,16,20,51127.350000000006,66567.52
26302,U14573,36,-517.5399999999986,23,13,57885.93,57368.39
26303,U33642,36,-1999.9999999999982,25,11,51116.06,49116.06
26304,U33997,36,-41054.94,32,4,93084.52,52029.58
26305,U26772,36,11620.98000000001,21,15,201845.69000000006,213466.67000000007
26306,U40038,36,212419.53000000003,21,15,204496.07000000004,416915.6000000001
26307,U18984,36,-255787.35,15,21,528670.58,272883.23
26308,U35528,36,25501.350000000006,33,3,27832.51,53333.86
26309,U16033,36,9002.359999999997,20,16,138008.56,147010.91999999998
26310,U10740,36,309.67999999999967,31,5,5772.12,6081.799999999999
26311,U30042,36,233.30999999999904,32,4,4404.4400000000005,4637.75
26312,U27501,36,26205.89,27,9,58261.82000000001,84467.71
26313,U1270008,36,313.14999999999964,30,6,7330.9400000000005,7644.09
26314,U30356,36,-57876.09,24,12,280003.91,222127.81999999998
26315,U35700,36,102664.11000000002,23,13,153345.41,256009.52000000002
26316,U31320,36,855490.98,32,4,916652.56,1772143.54
26317,U40660,36,340753.17,17,19,765469.69,1106222.8599999999
26318,U20371,36,1551.3299999999995,27,9,26113.1,27664.429999999997
26319,U40342,36,279173.6599999998,17,19,929109.22,1208282.88
26320,U14988,36,-3079.519999999994,22,14,193886.97999999995,190807.45999999996
26321,U28009,36,3038.569999999995,31,5,48889.21,51927.77999999999
26322,U1044661,36,53.379999999999995,20,16,1692.5,1745.88
26323,U598969,36,514.7699999999998,14,22,5272.32,5787.089999999999
26324,U19615,36,16794.27999999997,20,16,576487.95,593282.23
26325,U37810,36,-1108.27,27,9,9757.429999999998,8649.159999999998
26326,U36576,36,8760.239999999998,28,8,63959.0,72719.23999999999
26327,U30367,36,9226.5,30,6,55921.61,65148.11
26328,U14878,36,-5699.180000000008,26,10,149894.62000000002,144195.44
26329,U43312,36,-29029.31,30,6,42025.6,12996.289999999997
26330,U38933,36,-111880.29,31,5,163735.58,51855.28999999999
26331,U41218,36,1405.4299999999992,29,7,25932.54,27337.97
26332,U14294,36,-1779.7099999999978,18,18,53290.0,51510.29
26333,U41976,36,14341.629999999997,17,19,137029.8,151371.43
26334,U29634,36,-79.32000000000016,30,6,6344.2,6264.879999999999
26335,U32925,36,-4107.58,33,3,18916.729999999996,14809.149999999996
26336,U11321,36,4334.759999999999,21,15,54447.22,58781.98
26337,U37727,36,6905.449999999998,30,6,9707.429999999998,16612.879999999997
26338,U23024,36,-46158.89000000001,31,5,109764.12999999999,63605.23999999998
26339,U43667,36,-4925.799999999996,26,10,145691.96000000002,140766.16000000003
26340,U35533,36,-984990.57,27,9,1054176.77,69186.20000000007
26341,U29028,36,-250556.94000000003,27,9,476390.29,225833.34999999995
26342,U34129,36,-10348.75,33,3,20948.78,10600.029999999999
26343,U43169,36,-72609.3,30,6,152123.63,79514.33
26344,U743295,36,0.0,18,18,16785.0,16785.0
26345,U9569,36,-59277.969999999994,24,12,100712.97,41435.00000000001
26346,U16634,36,-15870.959999999995,18,18,297510.84,281639.88
26347,U21493,36,-40238.55999999959,25,11,4314088.68,4273850.12
26348,U26125,36,-2358.0399999999977,25,11,38886.2,36528.159999999996
26349,U34346,36,375.7599999999986,27,9,12238.800000000001,12614.56
26350,U13062,36,-2659.1199999999994,27,9,5987.199999999999,3328.0799999999995
26351,U32716,36,3561.8599999999997,19,17,16861.5,20423.36
26352,U20100,36,-234728.8,24,12,324441.54,89712.73999999999
26353,U19173,36,-4270.210000000004,25,11,79644.25,75374.04
26354,U13793,36,654.3999999999999,24,12,21564.489999999998,22218.89
26355,U23626,36,31317.049999999992,26,10,3004.2600000000007,34321.30999999999
26356,U10193,36,31888.11,27,9,33361.8,65249.91
26357,U40827,36,3852.1499999999996,31,5,9707.27,13559.42
26358,U13138,36,1461.6499999999994,31,5,43604.119999999995,45065.77
26359,U29708,36,47486.50999999999,26,10,65541.8,113028.31
26360,U38436,36,1293.7600000000011,24,12,163463.06999999998,164756.83
26361,U28885,36,-1026.7000000000003,33,3,4286.719999999999,3260.019999999999
26362,U26182,36,-92532.68,28,8,344618.44,252085.76
26363,U42358,36,202844.13,26,10,231132.94,433977.07
26364,U8653,36,-7796.159999999996,20,16,56794.619999999995,48998.46
26365,U20747,36,-9204.949999999997,31,5,25374.149999999998,16169.2
26366,U35232,36,-2933.0900000000015,30,6,74133.49,71200.40000000001
26367,U35780,36,-3491.2400000000034,29,7,511462.3,507971.06
26368,U38445,36,6527.989999999998,19,17,55943.93,62471.92
26369,U37532,36,-918.099999999999,22,14,156428.07000000007,155509.97000000006
26370,U1052279,36,-2047.260000000001,30,6,9498.529999999999,7451.269999999998
26371,U30741,36,-1306.7599999999948,24,12,44986.979999999996,43680.22
26372,U38613,36,116705.04000000001,17,19,173759.32,290464.36
26373,U25244,36,11209.15,30,6,18560.87,29770.019999999997
26374,U22823,36,-9854.229999999996,31,5,60755.100000000006,50900.87000000001
26375,U8554,36,-17190.32,28,8,51134.990000000005,33944.670000000006
26376,U23754,36,-4011.2799999999997,31,5,5561.13,1549.8500000000004
26377,U23528,36,680.75,19,17,3797.3499999999995,4478.099999999999
26378,U41908,36,19744.600000000024,19,17,944395.07,964139.6699999999
26379,U39048,36,-4265.879999999997,20,16,242805.0,238539.12
26380,U35210,36,-1960.4899999999907,27,9,329877.6,327917.11
26381,U31660,36,105372.1599999998,21,15,3816000.0,3921372.1599999997
26382,U25289,36,-27503.490000000005,18,18,199554.06999999998,172050.57999999996
26383,U16836,36,-1105.8299999999972,28,8,57849.07,56743.240000000005
26384,U32941,36,-4313.63,35,1,4316.9,3.269999999999527
26385,U1347784,36,-282.3699999999999,34,2,4059.5,3777.13
26386,U29345,36,209.11999999999898,18,18,157988.64,158197.76
26387,U35434,36,50158.14000000001,26,10,87719.58,137877.72
26388,U33644,36,6821.480000000001,24,12,4956.59,11778.070000000002
26389,U43292,36,-2552.029999999995,24,12,106449.0,103896.97
26390,U707312,36,2.1600000000001884,21,15,8057.76,8059.92
26391,U34800,36,-996.3899999999993,23,13,32048.07,31051.68
26392,U41770,36,75439.56999999999,25,11,31905.829999999998,107345.4
26393,U11460,36,1318.8000000000002,29,7,4446.83,5765.63
26394,U20777,36,5753.559999999998,30,6,28355.29,34108.85
26395,U16781,36,-2706.3999999999796,22,14,804159.72,801453.32
26396,U38280,36,7423.310000000007,18,18,135427.10000000003,142850.41000000003
26397,U42612,36,-61238.750000000015,21,15,184723.39,123484.64
26398,U38055,36,276.39000000000215,21,15,157207.65999999997,157484.05
26399,U43440,36,52518.37000000001,22,14,268780.18,321298.55
26400,U39385,36,50222.199999999975,21,15,354140.2,404362.39999999997
26401,U40985,36,-36723.94,23,13,245875.0,209151.06
26402,U40552,36,-1485.0900000000001,21,15,3923.23,2438.14
26403,U37856,36,6137.580000000002,22,14,334718.78,340856.36000000004
26404,U22697,36,5290.820000000001,23,13,28002.7,33293.520000000004
26405,U28213,36,922.3400000000038,15,21,75355.50000000001,76277.84000000003
26406,U36685,36,-112.76000000000113,25,11,60042.81,59930.049999999996
26407,U28764,36,11677.669999999998,27,9,4077.0400000000013,15754.71
26408,U37034,36,-3556.3199999999997,20,16,63600.66,60044.340000000004
26409,U12583,36,-204.4599999999988,21,15,307047.39,306842.93
26410,U18644,36,1823.5400000000009,27,9,31113.65,32937.19
26411,U14850,36,3819.32000000001,26,10,146185.0,150004.32
26412,U29864,36,3412.7700000000186,19,17,825935.0,829347.77
26413,U43652,36,272.4500000000007,23,13,35156.96,35429.41
26414,U42983,36,-3.730000000000018,23,13,18883.74,18880.010000000002
26415,U41778,36,95179.64,27,9,457454.38999999996,552634.0299999999
26416,U40949,36,-70065.43,31,5,108587.04,38521.61
26417,U42288,36,-1603.9700000000012,30,6,28562.879999999997,26958.909999999996
26418,U32630,36,2140.6100000000006,29,7,217028.96999999997,219169.57999999996
26419,U24063,36,-6595.789999999997,30,6,40226.01,33630.22
26420,U904793,36,-19936.779999999995,28,8,21258.98,1322.2000000000044
26421,U30015,36,-416.32000000000045,28,8,5455.7699999999995,5039.449999999999
26422,U21003,36,2387.789999999979,22,14,463182.58999999997,465570.37999999995
26423,U20786,36,357.119999999999,28,8,31818.25,32175.37
26424,U10774,36,1404.3499999999985,15,21,328262.12,329666.47
26425,U1073192,36,-6531.75,32,4,7482.76,951.0100000000002
26426,U36946,36,2821.8599999999997,26,10,81777.16,84599.02
26427,U28523,36,-3253.4100000000003,27,9,6292.87,3039.4599999999996
26428,U11813,36,-15660.369999999994,25,11,198348.22,182687.85
26429,U18330,36,7280.859999999998,30,6,28181.55,35462.409999999996
26430,U13439,36,-14604.129999999994,28,8,118673.73,104069.6
26431,U8185,36,1171.0099999999993,27,9,6332.9800000000005,7503.99
26432,U30547,36,-2550.309999999958,26,10,1044680.38,1042130.0700000001
26433,U30103,36,-8233.04,28,8,44340.520000000004,36107.48
26434,U38019,36,-3492.6499999999974,18,18,1548237.5,1544744.85
26435,U21538,36,3646.799999999993,24,12,180557.39999999997,184204.19999999995
26436,U26078,36,-1029.6599999999999,32,4,5346.699999999999,4317.039999999999
26437,U37393,36,-635.8999999999999,33,3,1496.2599999999998,860.3599999999999
26438,U9916,36,-2540.1000000000004,27,9,37881.83,35341.73
26439,U26398,36,-3371.260000000002,26,10,74281.92,70910.66
26440,U27167,36,11363.769999999995,28,8,171242.57,182606.34
26441,U28997,36,-4501.84,31,5,11751.9,7250.0599999999995
26442,U20828,36,18392.21,21,15,73480.26999999999,91872.47999999998
26443,U10581,36,-10754.619999999999,20,16,203311.37999999998,192556.75999999998
26444,U10809,36,-489.57000000000016,25,11,10162.17,9672.6
26445,U33252,36,-42228.13000000001,24,12,178707.84,136479.71
26446,U17429,36,-2201.0700000000024,20,16,533268.52,531067.4500000001
26447,U34932,36,7096.529999999997,20,16,200325.09,207421.62
26448,U37239,36,-60291.12,30,6,66140.3,5849.18
26449,U34805,36,7513.040000000003,28,8,65206.27,72719.31
26450,U11002,36,-2835.5399999999972,23,13,251839.31999999998,249003.77999999997
26451,U23853,36,24223.49,30,6,30569.580000000005,54793.07000000001
26452,U31683,36,6939.6,32,4,19467.359999999993,26406.959999999992
26453,U1281618,36,-232.8499999999997,21,15,10339.220000000001,10106.37
26454,U27740,36,17.389999999998537,20,16,54111.57,54128.96
26455,U38642,36,891.7500000000002,21,15,22774.2,23665.95
26456,U39049,36,92999.97,13,23,521576.4,614576.37
26457,U15940,36,10078.600000000002,26,10,89484.24999999999,99562.84999999999
26458,U43608,36,-7862.910000000001,30,6,29567.25,21704.34
26459,U26956,36,-9741.629999999996,24,12,46516.47,36774.840000000004
26460,U21133,36,113293.76,22,14,752807.2499999999,866101.0099999999
26461,U12021,36,-731.1400000000014,29,7,46030.240000000005,45299.100000000006
26462,U1179068,36,4093.6400000000003,25,11,16823.230000000003,20916.870000000003
26463,U1188928,36,-22611.449999999997,28,8,32308.379999999997,9696.93
26464,U29238,36,14949.249999999998,28,8,49737.25,64686.5
26465,U25535,36,-31.5099999999984,18,18,141202.5,141170.99
26466,U710143,36,-6243.95,30,6,17563.54,11319.59
26467,U15400,36,82404.96,12,24,118708.23,201113.19
26468,U15997,36,23869.52,25,11,124842.56,148712.08
26469,U43174,36,9989.580000000002,30,6,10027.92,20017.5
26470,U37009,36,-6956.379999999999,30,6,36255.369999999995,29298.989999999998
26471,U10567,36,-441.75,22,14,278104.5,277662.75
26472,U25871,36,-3094.4699999999993,30,6,13843.08,10748.61
26473,U44067,36,-7709.779999999999,31,5,15626.92,7917.140000000001
26474,U26724,36,54486.53,28,8,170192.01,224678.54
26475,U577445,36,3725.38,20,16,38762.36,42487.74
26476,U19381,36,-54110.590000000004,28,8,54315.630000000005,205.04000000000087
26477,U15842,36,-146637.94999999998,25,11,192459.07,45821.120000000024
26478,U38692,36,-29836.320000000007,19,17,180008.44,150172.12
26479,U11144,36,-3987.0000000000036,25,11,84580.31,80593.31
26480,U12430,36,1097566.2199999997,19,17,1151893.4,2249459.6199999996
26481,U18566,36,5341.69,31,5,14504.679999999997,19846.369999999995
26482,U42934,36,-4661.160000000001,14,22,58373.09,53711.92999999999
26483,U13583,36,53460.17,27,9,34948.61,88408.78
26484,U37379,36,-1795.0400000000016,30,6,22383.74,20588.7
26485,U20169,36,18535.22,24,12,35389.07,53924.29
26486,U8261,36,9587.24,28,8,12816.939999999999,22404.18
26487,U41351,36,102393.28000000001,23,13,299291.92,401685.2
26488,U25818,36,-1828.9900000000016,26,10,32095.730000000003,30266.74
26489,U40854,36,-1520.6500000000035,25,11,155094.74,153574.09
26490,U37726,36,11320.45,17,19,25709.55,37030.0
26491,U1190365,36,618.1700000000001,22,14,2825.250000000001,3443.420000000001
26492,U32100,36,2767.2599999999998,20,16,20234.969999999998,23002.229999999996
26493,U25722,36,-8102.280000000001,29,7,19096.859999999997,10994.579999999996
26494,U33201,36,-13493.719999999994,25,11,65433.01000000001,51939.290000000015
26495,U20156,36,-7161.460000000001,31,5,25466.309999999998,18304.85
26496,U18519,36,154149.99,19,17,154760.63000000003,308910.62
26497,U13894,36,28083.240000000005,15,21,392236.89,420320.13
26498,U39956,36,2489.78,27,9,8190.32,10680.1
26499,U30675,36,-9971.320000000002,26,10,16075.400000000001,6104.08
26500,U15798,36,4530155.56,9,27,753477.45,5283633.01
26501,U33296,36,-1125.9599999999996,30,6,10080.7,8954.740000000002
26502,U10165,36,1066.8700000000003,27,9,3194.4700000000007,4261.340000000001
26503,U23597,36,-838.6199999999955,31,5,74342.4,73503.78
26504,U39150,36,-21857.719999999972,22,14,626145.8600000001,604288.1400000001
26505,U35578,36,2301.670000000002,27,9,24437.94,26739.61
26506,U23359,36,2144.5300000000043,27,9,80851.43999999997,82995.96999999997
26507,U15315,36,17828.68,25,11,28007.340000000004,45836.020000000004
26508,U778266,36,-52.61999999999989,19,17,21956.22,21903.600000000002
26509,U17039,36,449.1200000000108,16,20,321077.41,321526.52999999997
26510,U23812,36,-66.44,26,10,505.76,439.32
26511,U13502,36,-224877.86000000002,26,10,381577.98000000004,156700.12000000002
26512,U11988,36,1695.4299999999994,25,11,12849.7,14545.130000000001
26513,U22825,36,-41517.53,30,6,47427.31999999999,5909.789999999994
26514,U29802,36,-34874.55,29,7,56309.08,21434.53
26515,U22200,36,-121.38000000000011,31,5,2587.05,2465.67
26516,U11558,36,565.6000000000005,25,11,20457.959999999995,21023.559999999998
26517,U16296,36,1422.6300000000003,28,8,3862.46,5285.09
26518,U21885,36,17771.26000000001,29,7,690718.31,708489.5700000001
26519,U42664,36,-945.3200000000023,22,14,134169.24,133223.91999999998
26520,U1348150,36,-4659.84,28,8,16459.9,11800.060000000001
26521,U20507,36,6132.740000000004,22,14,35198.00000000001,41330.74000000001
26522,U38193,36,-3190.09,27,9,35768.119999999995,32578.029999999995
26523,U39010,36,2617.6100000000006,29,7,18824.4,21442.010000000002
26524,U1043791,36,329.0899999999999,25,11,2693.85,3022.9399999999996
26525,U1381299,36,-3225.3899999999994,21,15,9801.9,6576.51
26526,U30900,36,2793.7799999999347,12,24,2311000.0,2313793.78
26527,U22361,36,4936.990000000001,26,10,8412.019999999997,13349.009999999998
26528,U18105,36,-179795.51,24,12,273975.74,94180.22999999998
26529,U8308,36,184.08000000000027,28,8,14698.769999999999,14882.849999999999
26530,U29128,36,34209.500000000015,20,16,955035.9,989245.4
26531,U42293,36,-66491.65,27,9,281984.52,215492.87000000002
26532,U16786,36,-17352.770000000004,18,18,86428.27999999997,69075.50999999997
26533,U15807,36,223.9399999999996,26,10,15922.62,16146.560000000001
26534,U17144,36,-42014.59,34,2,42020.299999999996,5.709999999999127
26535,U31050,36,-2571.0000000000005,32,4,5727.14,3156.14
26536,U32284,36,12513.609999999933,22,14,975071.9700000002,987585.5800000002
26537,U31784,36,-348.5199999999983,29,7,9019.83,8671.310000000001
26538,U41134,36,11989.0,21,15,32704.11,44693.11
26539,U37492,36,-294131.3599999998,18,18,1083630.44,789499.0800000001
26540,U34697,36,38027.15000000001,18,18,130345.51000000001,168372.66000000003
26541,U38901,36,-74799.48999999999,20,16,366282.0,291482.51
26542,U20377,36,44844.45999999999,19,17,67500.42,112344.87999999999
26543,U861132,36,-4994.170000000001,30,6,29446.17,24451.999999999996
26544,U587511,36,-335.3399999999999,23,13,6618.82,6283.48
26545,U13417,36,3800.6899999999987,27,9,37740.159999999996,41540.84999999999
26546,U14602,36,-9175.98,32,4,14093.48,4917.5
26547,U39679,36,-463.49,25,11,1349.99,886.5
26548,U13254,36,-66.99000000000001,31,5,373.86999999999995,306.87999999999994
26549,U11740,36,1.1599999999998545,23,13,18036.809999999998,18037.969999999998
26550,U40771,35,301.7999999999993,22,13,42074.0,42375.8
26551,U42563,35,-24742.84,21,14,76651.82,51908.98000000001
26552,U32083,35,-2495.29,30,5,6543.319999999999,4048.029999999999
26553,U33913,35,-5212.590000000003,16,19,92270.09999999999,87057.51
26554,U36033,35,-21440.090000000004,22,13,222954.54,201514.45
26555,U9906,35,-94468.25,16,19,297357.0,202888.75
26556,U615500,35,-17916.48,32,3,18066.21,149.72999999999956
26557,U38236,35,-24379.839999999997,24,11,53019.75,28639.910000000003
26558,U37870,35,-4027.2999999999997,30,5,11665.56,7638.26
26559,U43704,35,7831.559999999998,18,17,75422.20999999999,83253.76999999999
26560,U17538,35,-16995.959999999995,23,12,217086.0,200090.04
26561,U22020,35,12178.299999999988,26,9,294352.1,306530.39999999997
26562,U29088,35,9449.93,28,7,10720.43,20170.36
26563,U20492,35,-4938.290000000006,32,3,5467.8800000000065,529.5900000000001
26564,U30753,35,11475.290000000003,30,5,56767.25000000001,68242.54000000001
26565,U11157,35,13816.169999999998,21,14,182363.0,196179.16999999998
26566,U1220257,35,-4.419999999999671,30,5,8734.58,8730.16
26567,U8579,35,-4247.380000000005,19,16,342760.33,338512.95
26568,U988906,35,347.03,20,15,2343.8900000000003,2690.92
26569,U19477,35,-492.89,22,13,163393.0,162900.11
26570,U1243111,35,44.29000000000002,24,11,2328.2000000000003,2372.4900000000002
26571,U43443,35,114.33000000000006,31,4,1365.75,1480.0800000000002
26572,U39100,35,-22564.949999999997,26,9,31456.670000000002,8891.720000000005
26573,U16555,35,3886.9000000000083,21,14,169534.32,173421.22
26574,U29758,35,18930.65,28,7,16002.139999999998,34932.79
26575,U39125,35,880.1399999999994,18,17,175152.64,176032.78000000003
26576,U20521,35,5862.820000000001,30,5,11497.65,17360.47
26577,U14560,35,-13493.589999999995,18,17,81330.90000000001,67837.31000000001
26578,U40444,35,-841.4299999999998,19,16,56558.0,55716.57
26579,U776192,35,-1918.5599999999995,24,11,9995.06,8076.5
26580,U1189738,35,-6134.15,21,14,7318.41,1184.2600000000002
26581,U35254,35,594.2700000000002,31,4,2511.3700000000003,3105.6400000000003
26582,U22066,35,12770.809999999994,20,15,73975.07999999999,86745.88999999998
26583,U39318,35,-9683.05,26,9,31699.0,22015.95
26584,U38446,35,-11564.269999999999,24,11,38399.04,26834.770000000004
26585,U39093,35,369.70000000000005,27,8,1965.7299999999998,2335.43
26586,U25258,35,22288.87000000001,23,12,72684.25000000001,94973.12000000002
26587,U21871,35,-35941.09,21,14,1745228.85,1709287.76
26588,U12445,35,17199.74,27,8,34316.48,51516.22
26589,U23512,35,-8672.440000000002,23,12,51072.11,42399.67
26590,U31012,35,-2952.610000000001,25,10,21625.03,18672.42
26591,U39297,35,-64.26000000000022,27,8,4836.5,4772.24
26592,U43187,35,210805.91999999975,24,11,8399651.559999999,8610457.479999999
26593,U24979,35,86.07999999999731,23,12,22202.840000000007,22288.920000000006
26594,U11375,35,-201.80000000000018,21,14,22667.95,22466.15
26595,U23032,35,-250.0200000000002,31,4,3641.62,3391.5999999999995
26596,U16646,35,-3108.320000000004,25,10,20887.17,17778.849999999995
26597,U28834,35,81684.53,17,18,50348.53,132033.06
26598,U33351,35,74916.81,25,10,46010.1,120926.91
26599,U21664,35,-1012.1399999999994,20,15,147495.98,146483.84000000003
26600,U10035,35,-75251.91,21,14,143979.31,68727.4
26601,U43751,35,21822.110000000062,22,13,1191529.8899999994,1213351.9999999995
26602,U29043,35,6797.1900000000005,20,15,13522.6,20319.79
26603,U26060,35,69.19999999999986,27,8,1759.8000000000002,1829.0
26604,U41865,35,-8191.0799999999945,24,11,173255.3,165064.22
26605,U1168447,35,-6.548095399239173e-13,22,13,12114.390000000001,12114.390000000001
26606,U35508,35,-25776.209999999995,27,8,86686.52,60910.31000000001
26607,U33637,35,0.0,21,14,345691.80999999994,345691.80999999994
26608,U37068,35,-19185.92000000001,28,7,27491.92000000001,8306.0
26609,U15374,35,15659.820000000065,10,25,2085011.9100000001,2100671.7300000004
26610,U40614,35,-204.35999999999933,33,2,13597.360000000004,13393.000000000005
26611,U26079,35,5363.89999999998,21,14,114305.19,119669.08999999998
26612,U13462,35,1458.8800000000017,27,8,60960.43000000001,62419.31000000001
26613,U34240,35,-7524.379999999997,23,12,38160.39,30636.010000000002
26614,U15861,35,-830.4600000000002,31,4,7230.860000000001,6400.400000000001
26615,U10503,35,14966.370000000112,26,9,1205881.73,1220848.1
26616,U21082,35,103822.14999999997,20,15,1002032.6900000002,1105854.84
26617,U38652,35,7642.789999999997,26,9,25371.94,33014.729999999996
26618,U28281,35,-9373.26000000001,17,18,724595.09,715221.83
26619,U591637,35,-515.46,27,8,8518.48,8003.0199999999995
26620,U37120,35,13279.509999999997,24,11,109592.09,122871.59999999999
26621,U36745,35,707.6699999999983,18,17,67288.13,67995.8
26622,U32764,35,-19376.320000000007,22,13,494667.0,475290.68
26623,U32815,35,-96.87999999999913,27,8,39375.119999999995,39278.24
26624,U41868,35,20790.309999999998,26,9,3845.76,24636.07
26625,U17543,35,24482.920000000013,20,15,110405.31000000001,134888.23000000004
26626,U20220,35,62834.469999999994,32,3,13184.380000000001,76018.84999999999
26627,U37287,35,3702.46,19,16,6087.28,9789.74
26628,U40687,35,-22806.76999999999,29,6,65347.219999999994,42540.450000000004
26629,U18089,35,-3651.0999999999995,31,4,20583.32,16932.22
26630,U23187,35,27.04999999999999,32,3,44.360000000000014,71.41
26631,U8613,35,-34669.8,27,8,99749.14000000001,65079.34000000001
26632,U37480,35,79555.72999999998,27,8,146069.54,225625.27
26633,U9824,35,-32686.489999999994,27,8,113162.38999999997,80475.89999999998
26634,U12253,35,-300289.82,28,7,314530.73,14240.909999999974
26635,U18520,35,-13509.080000000002,24,11,61773.990000000005,48264.91
26636,U12347,35,-4122.590000000004,24,11,76472.28,72349.69
26637,U641434,35,-109.73999999999987,20,15,5251.74,5142.0
26638,U29963,35,-2376.4199999999983,26,9,85378.70000000001,83002.28000000001
26639,U35130,35,28169.220000000005,26,9,31422.69,59591.91
26640,U23083,35,-11865.71999999999,22,13,1399245.9000000001,1387380.1800000002
26641,U9884,35,33731.49999999999,19,16,35600.049999999996,69331.54999999999
26642,U992036,35,-1499.6100000000006,24,11,24953.71,23454.1
26643,U18435,35,-139.73000000000002,30,5,5321.52,5181.790000000001
26644,U1185855,35,0.07000000000005002,21,14,4336.46,4336.53
26645,U703932,35,0.9899999999999818,28,7,9364.03,9365.02
26646,U42675,35,-1459.1000000000004,30,5,5772.299999999999,4313.199999999999
26647,U36296,35,1912.139999999999,20,15,25072.890000000003,26985.030000000002
26648,U43419,35,-9765.599999999995,18,17,50477.12,40711.520000000004
26649,U33265,35,37644.39,13,22,131894.0,169538.39
26650,U9303,35,-0.47999999999847454,27,8,22041.710000000003,22041.230000000003
26651,U43578,35,28752.020000000004,22,13,166456.91999999995,195208.93999999994
26652,U35416,35,-36973.99999999997,25,10,1228767.4600000002,1191793.4600000002
26653,U9211,35,-7122.4000000000015,21,14,86538.28,79415.88
26654,U959916,35,303.0100000000007,19,16,6906.77,7209.780000000001
26655,U34095,35,51.40999999999673,25,10,49251.56,49302.969999999994
26656,U20475,35,-5531.670000000001,28,7,26075.6,20543.929999999997
26657,U25209,35,3965.040000000001,19,16,155892.47999999998,159857.52
26658,U1088759,35,81.38,25,10,1978.29,2059.67
26659,U21341,35,-25896.350000000006,30,5,63371.18,37474.829999999994
26660,U12619,35,-10647.66,30,5,26055.68,15408.02
26661,U40633,35,32583.6,23,12,76943.8,109527.4
26662,U23150,35,-4469.169999999999,29,6,10216.079999999998,5746.909999999999
26663,U30469,35,21988.380000000005,21,14,639947.75,661936.13
26664,U43886,35,4441.840000000002,27,8,14262.91,18704.75
26665,U19710,35,-131.67000000000178,19,16,89510.39,89378.72
26666,U33668,35,-86.80999999999933,27,8,15797.82,15711.01
26667,U14074,35,5433.680000000002,27,8,65105.54,70539.22
26668,U30457,35,703.9800000000013,26,9,40093.47000000001,40797.45000000001
26669,U36571,35,4607.140000000001,17,18,36450.78,41057.92
26670,U11057,35,16879.66,21,14,66007.04,82886.7
26671,U38508,35,2573.670000000007,19,16,60261.229999999996,62834.9
26672,U31810,35,42.94999999999982,30,5,9010.57,9053.52
26673,U36194,35,1635.0400000000004,28,7,17408.26,19043.3
26674,U39313,35,-71.46999999999987,21,14,33934.99,33863.52
26675,U1323678,35,50.68000000000029,29,6,9552.1,9602.78
26676,U40804,35,8122.230000000005,19,16,261334.8,269457.02999999997
26677,U28559,35,-796.9700000000003,28,7,6130.8,5333.83
26678,U23577,35,324154.7900000001,22,13,1584308.2,1908462.99
26679,U34296,35,72018.23999999999,13,22,78493.84,150512.08
26680,U10884,35,14506.839999999995,16,19,151731.61,166238.44999999998
26681,U17287,35,-6168.420000000006,18,17,1191451.0,1185282.58
26682,U15232,35,1720.8099999999995,26,9,50393.09,52113.899999999994
26683,U36356,35,-51896.380000000005,25,10,97531.43999999999,45635.05999999998
26684,U1133999,35,-1816.0000000000002,32,3,5876.29,4060.29
26685,U9880,35,-1891.3399999999983,24,11,46237.630000000005,44346.29000000001
26686,U34986,35,3515.3899999999994,25,10,164700.0,168215.39
26687,U15625,35,3211.559999999995,18,17,70454.88999999998,73666.44999999998
26688,U38792,35,919.8000000000009,25,10,69165.14,70084.94
26689,U32165,35,883613.81,23,12,174291.95000000004,1057905.76
26690,U870437,35,3.410605131648481e-13,21,14,8692.77,8692.77
26691,U9174,35,-24471.779999999995,21,14,1665640.7400000002,1641168.9600000002
26692,U36769,35,-584.8200000000007,17,18,105462.41999999998,104877.59999999998
26693,U32846,35,13068.74,19,16,18465.55,31534.29
26694,U39060,35,-2318.6100000000006,22,13,9202.36,6883.75
26695,U36472,35,7175.9100000000035,26,9,103125.38,110301.29000000001
26696,U38700,35,4381.2699999999995,30,5,528.64,4909.91
26697,U19675,35,-775.7000000000007,27,8,72208.98,71433.28
26698,U24911,35,-9.979999999999563,17,18,66720.07,66710.09000000001
26699,U38702,35,1461276.17,24,11,225852.50000000003,1687128.67
26700,U17672,35,-12298.039999999995,28,7,42788.06999999999,30490.03
26701,U23827,35,10133.660000000003,18,17,98288.62,108422.28
26702,U43884,35,7817.610000000001,20,15,23144.059999999998,30961.67
26703,U31484,35,315.34000000000015,25,10,4557.57,4872.91
26704,U34930,35,11742.500000000002,20,15,8205.689999999999,19948.190000000002
26705,U42428,35,-1119.8799999999999,28,7,3056.29,1936.41
26706,U1071340,35,-5781.81,26,9,10050.33,4268.5199999999995
26707,U40748,35,23063.119999999988,20,15,242027.99,265091.11
26708,U21004,35,-19206.46,27,8,65673.87000000001,46467.41000000001
26709,U34386,35,-287.7599999999999,19,16,3497.8700000000003,3210.1100000000006
26710,U9868,35,-13641.950000000003,30,5,20494.409999999996,6852.459999999994
26711,U24853,35,11640.749999999996,31,4,22241.4,33882.149999999994
26712,U23226,35,-2800.959999999999,22,13,70106.85,67305.89000000001
26713,U13782,35,-16269.269999999997,23,12,123704.27999999998,107435.00999999998
26714,U16543,35,-35776.87,25,10,108151.12000000001,72374.25
26715,U8410,35,1458.7100000000012,23,12,19340.399999999998,20799.11
26716,U20829,35,11489.620000000004,31,4,2324.27,13813.890000000005
26717,U970572,35,2444.589999999998,29,6,13147.4,15591.989999999998
26718,U1031429,35,-3566.7000000000003,31,4,8854.710000000003,5288.010000000002
26719,U17286,35,-2134.21,23,12,7803.16,5668.95
26720,U27397,35,4514.489999999998,16,19,16520.23,21034.719999999998
26721,U19079,35,-77526.19,22,13,156254.95,78728.76000000001
26722,U41661,35,-49645.84,26,9,2591441.8,2541795.96
26723,U25786,35,2103.1499999999996,25,10,27640.44,29743.589999999997
26724,U35277,35,-927.380000000001,25,10,69711.27,68783.89
26725,U13428,35,14909.249999999956,25,10,847103.5599999999,862012.8099999999
26726,U33698,35,-31793.970000000005,27,8,50839.94,19045.969999999998
26727,U43124,35,10378.16,18,17,31095.030000000002,41473.19
26728,U27338,35,-349460.91,24,11,402943.4,53482.49000000005
26729,U22752,35,9357.57,27,8,11604.56,20962.129999999997
26730,U40630,35,3602.0600000000013,25,10,32482.549999999996,36084.61
26731,U12118,35,-7154.07,27,8,14231.859999999999,7077.789999999999
26732,U37784,35,5500.37,18,17,25905.210000000003,31405.58
26733,U9646,35,-1028.2199999999998,32,3,1549.45,521.2300000000002
26734,U19186,35,-94708.71999999999,26,9,128380.29,33671.57000000001
26735,U25469,35,72566.68,29,6,96366.19,168932.87
26736,U31901,35,-0.019999999997235562,31,4,12701.29,12701.270000000004
26737,U761850,35,-2396.4799999999996,20,15,4268.65,1872.17
26738,U39614,35,11535.019999999997,22,13,44378.67,55913.689999999995
26739,U1200003,35,33.669999999997984,18,17,31351.890000000003,31385.56
26740,U28524,35,29076.47,21,14,111422.01000000001,140498.48
26741,U9229,35,428.4500000000003,24,11,1118.81,1547.2600000000002
26742,U19004,35,1268253.3399999999,20,15,143668.93000000002,1411922.2699999998
26743,U39203,35,8209.53,23,12,12913.060000000001,21122.590000000004
26744,U28865,35,1242.6599999999944,23,12,619146.2100000001,620388.8700000001
26745,U40287,35,752.1300000000001,24,11,23026.04,23778.170000000002
26746,U10783,35,11804.409999999996,15,20,128687.54,140491.94999999998
26747,U25116,35,2371.8600000000006,26,9,38595.899999999994,40967.759999999995
26748,U27623,35,-1985.3399999999988,20,15,31738.95999999999,29753.619999999988
26749,U37271,35,-6931.740000000003,21,14,275545.69000000006,268613.95000000007
26750,U9992,35,-34677.5,31,4,38700.78,4023.279999999999
26751,U31378,35,17.799999999997226,17,18,69741.08,69758.88
26752,U36137,35,8736.759999999997,26,9,10749.039999999999,19485.799999999996
26753,U13064,35,7106.249999999998,16,19,118537.92000000001,125644.17000000001
26754,U28475,35,7832.530000000006,21,14,193636.65,201469.18
26755,U41476,35,19362.890000000003,19,16,59163.53,78526.42
26756,U40289,35,2596.41,23,12,24609.36,27205.77
26757,U36478,35,12823.8,29,6,21624.88,34448.68
26758,U42549,35,481.4599999999991,31,4,37674.85,38156.31
26759,U35688,35,1418.6000000000006,29,6,7565.3200000000015,8983.920000000002
26760,U26473,35,123068.63999999997,15,20,352145.1,475213.73999999993
26761,U29273,35,398.53999999999905,20,15,23055.82,23454.36
26762,U32342,35,-272.48000000000025,25,10,40574.58,40302.1
26763,U788301,35,-8854.4,31,4,11904.72,3050.3199999999997
26764,U18999,35,457.2800000000002,24,11,14856.02,15313.300000000001
26765,U34107,35,23801.15,23,12,85330.23999999999,109131.38999999998
26766,U22077,35,1319.050000000003,21,14,572751.12,574070.17
26767,U19625,35,-47.869999999998505,29,6,9423.979999999998,9376.109999999999
26768,U19587,35,-962.7400000000009,23,12,22846.670000000002,21883.93
26769,U14144,35,-43166.53,26,9,244567.89999999997,201401.36999999997
26770,U32166,35,274075.63,10,25,12000.0,286075.63
26771,U10408,35,-66.24000000000024,20,15,17986.519999999997,17920.279999999995
26772,U11836,35,-1511.4299999999998,33,2,1514.5899999999997,3.1599999999998545
26773,U14994,35,31833.899999999892,18,17,4284900.16,4316734.06
26774,U19769,35,6944.239999999999,22,13,48405.92,55350.159999999996
26775,U43391,35,-891.4899999999998,28,7,9092.53,8201.04
26776,U25734,35,-28677.280000000002,28,7,54888.45999999999,26211.17999999999
26777,U34333,35,4837.579999999999,18,17,41106.39,45943.97
26778,U13888,35,37525.2,21,14,186730.71000000002,224255.91000000003
26779,U26804,35,-120.56999999999984,33,2,9073.57,8953.0
26780,U11037,35,68442.15999999999,25,10,33917.97,102360.12999999999
26781,U43493,35,5160.429999999998,24,11,72148.68,77309.10999999999
26782,U9668,35,-1153252.8599999999,27,8,6796726.550000001,5643473.690000001
26783,U38745,35,131942.99,13,22,509953.64,641896.63
26784,U20303,35,-3093.710000000001,23,12,27049.11,23955.4
26785,U35118,35,-24599.290000000008,27,8,114862.53,90263.23999999999
26786,U44024,35,3149.960000000001,25,10,35556.44999999999,38706.40999999999
26787,U901576,35,-12445.009999999998,24,11,15588.429999999997,3143.4199999999983
26788,U16109,35,-1337.7499999999995,32,3,32437.760000000002,31100.010000000002
26789,U29647,35,-3090.5099999999993,25,10,65410.509999999995,62319.99999999999
26790,U11629,35,-67.91000000000167,13,22,267752.0,267684.09
26791,U42774,35,6448.79,26,9,16799.53,23248.32
26792,U34868,35,7863.450000000003,25,10,19785.879999999997,27649.33
26793,U23247,35,47390.03999999998,20,15,875704.38,923094.4199999999
26794,U35455,35,1794.219999999994,23,12,129309.79,131104.00999999998
26795,U20483,35,-84987.38999999998,23,12,142361.08000000002,57373.69000000003
26796,U10566,35,6116.839999999982,21,14,389886.22000000003,396003.06
26797,U31129,35,140448.31,18,17,647981.7,788430.01
26798,U37045,35,48910.35000000001,16,19,257922.0,306832.35000000003
26799,U27803,35,13334.359999999999,24,11,64915.259999999995,78249.62
26800,U10085,35,-908.2900000000004,30,5,5076.25,4167.959999999999
26801,U1154778,35,1064.5500000000002,20,15,10752.310000000001,11816.86
26802,U24234,35,-30589.050000000003,32,3,37676.83,7087.779999999999
26803,U39473,35,4777.600000000012,16,19,118794.83,123572.43000000001
26804,U17336,35,634.7999999997778,27,8,4121666.59,4122301.3899999997
26805,U36838,35,-39743.06,30,5,75748.62999999998,36005.56999999998
26806,U23252,35,-70773.98,21,14,362186.57999999996,291412.6
26807,U20339,35,7.740000000000464,19,16,12896.32,12904.06
26808,U9451,35,-7422.779999999921,19,16,1775508.4000000001,1768085.62
26809,U20499,35,7079.129999999999,24,11,45258.350000000006,52337.48
26810,U1213590,35,-365.54,20,15,1796.6200000000003,1431.0800000000004
26811,U22905,35,-3394.2600000000075,23,12,331516.48000000004,328122.22000000003
26812,U42786,35,3987.6099999999856,20,15,1244195.5899999999,1248183.1999999997
26813,U42838,34,-10880.109999999999,25,9,32687.1,21806.989999999998
26814,U24574,34,-1534.0900000000022,22,12,49904.420000000006,48370.33
26815,U19631,34,-5274.840000000002,30,4,19103.68,13828.839999999998
26816,U40469,34,-334.9100000000001,22,12,17291.05,16956.14
26817,U28283,34,-1215.5999999999972,23,11,44717.13,43501.53
26818,U22598,34,53.13999999999942,28,6,23870.100000000002,23923.24
26819,U703255,34,49.26000000000022,20,14,11585.369999999999,11634.63
26820,U16685,34,-6087.579999999996,26,8,107424.36,101336.78
26821,U29137,34,-12750.810000000005,25,9,228911.71000000002,216160.90000000002
26822,U27228,34,91664.75,32,2,972.25,92637.0
26823,U20688,34,1743.1999999999975,28,6,33911.29,35654.49
26824,U40896,34,-12697.25,23,11,84552.20000000001,71854.95000000001
26825,U10274,34,1559.0100000000007,28,6,21684.170000000002,23243.180000000004
26826,U13133,34,24971.81,22,12,195705.22,220677.03
26827,U10701,34,-50231.56,26,8,156035.94,105804.38
26828,U8063,34,-10606.399999999998,30,4,11313.119999999997,706.7199999999993
26829,U22585,34,-219.90999999998894,21,13,366093.99,365874.08
26830,U9043,34,-2199.119999999999,24,10,43332.44,41133.32000000001
26831,U38777,34,456177.63000000006,25,9,2573865.4899999998,3030043.1199999996
26832,U9583,34,-90785.1,21,13,138718.0,47932.899999999994
26833,U21280,34,2658.7800000000016,24,10,8108.15,10766.93
26834,U17346,34,11932.819999999985,23,11,146097.18,158029.99999999997
26835,U22763,34,5586.520000000004,13,21,69292.73999999999,74879.26
26836,U851496,34,-8.84999999999998,22,12,1047.35,1038.5
26837,U19755,34,38777.46,26,8,66495.93,105273.38999999998
26838,U1090303,34,0.4299999999998647,18,16,1437.3400000000001,1437.77
26839,U1313117,34,2.580000000000041,19,15,3680.0,3682.58
26840,U13363,34,-895.5099999999999,27,7,312998.9,312103.39
26841,U41450,34,-1018.9099999999733,17,17,384452.45999999996,383433.55
26842,U1178784,34,-1405.0,19,15,102500.03,101095.03
26843,U26211,34,21571.649999999987,28,6,170844.62,192416.27
26844,U18257,34,127273.93,24,10,93612.70999999999,220886.63999999998
26845,U30498,34,-1171.6099999999985,23,11,99345.20000000001,98173.59000000001
26846,U8707,34,-20370.43,31,3,22546.44,2176.0099999999984
26847,U30664,34,28.190000000000055,21,13,6033.679999999999,6061.869999999999
26848,U21590,34,4301.04,28,6,17635.680000000004,21936.720000000005
26849,U36729,34,-86183.69,17,17,319588.76,233405.07
26850,U41985,34,3085.8099999999995,16,18,21934.319999999996,25020.129999999997
26851,U25615,34,137.91999999999996,32,2,3243.23,3381.15
26852,U25684,34,-117.45999999999913,26,8,33049.719999999994,32932.259999999995
26853,U34298,34,6676.36,30,4,929.0999999999999,7605.459999999999
26854,U25065,34,-7868.280000000004,25,9,59210.17,51341.88999999999
26855,U19018,34,244.76999999999663,27,7,45282.09999999996,45526.86999999996
26856,U17864,34,14896.669999999995,20,14,16391.57,31288.239999999994
26857,U43759,34,-9792.96,27,7,44025.41,34232.450000000004
26858,U14737,34,193.28000000000077,10,24,150971.24000000005,151164.52000000005
26859,U38430,34,-32454.42000000002,23,11,453540.3,421085.87999999995
26860,U1319977,34,-992.6300000000003,31,3,4792.73,3800.0999999999995
26861,U20167,34,-482.39,28,6,5444.529999999999,4962.1399999999985
26862,U903211,34,2792.2699999999986,25,9,10884.289999999999,13676.559999999998
26863,U1323570,34,12107.93,24,10,2644.17,14752.1
26864,U43160,34,-14847.320000000005,26,8,53661.04,38813.719999999994
26865,U23069,34,-467.1600000000003,23,11,30762.730000000003,30295.570000000003
26866,U36621,34,17023.99,25,9,13489.82,30513.81
26867,U1298436,34,-19622.960000000003,26,8,33068.12999999999,13445.169999999987
26868,U19085,34,83593.06000000001,19,15,80556.0,164149.06
26869,U35159,34,1945.449999999997,25,9,37686.469999999994,39631.91999999999
26870,U32080,34,13780.809999999998,23,11,34686.59,48467.399999999994
26871,U39198,34,-10078.01,26,8,41363.979999999996,31285.969999999994
26872,U39573,34,-372.11999999999944,28,6,8934.22,8562.1
26873,U40450,34,9610.05,10,24,83923.1,93533.15000000001
26874,U37753,34,19811.49000000001,17,17,288125.99999999994,307937.48999999993
26875,U28993,34,1406.760000000002,16,18,68719.68,70126.44
26876,U14288,34,1220.2899999999995,21,13,9947.779999999999,11168.069999999998
26877,U764972,34,-1644.6800000000003,22,12,5859.09,4214.41
26878,U712587,34,-2630.5899999999992,27,7,8028.4800000000005,5397.890000000001
26879,U20680,34,-126292.28,16,18,439798.3,313506.02
26880,U17072,34,-18458.99999999999,23,11,77090.24999999999,58631.25
26881,U31507,34,1244.9699999999998,22,12,10750.79,11995.76
26882,U43046,34,51264.919999999984,11,23,750681.62,801946.54
26883,U43512,34,221205.77000000002,14,20,251325.05,472530.82
26884,U21714,34,1173.739999999998,20,14,62127.5,63301.24
26885,U34707,34,6321.429999999998,18,16,47489.46000000001,53810.89000000001
26886,U26406,34,-248349.03999999995,15,19,522994.95,274645.91000000003
26887,U40700,34,-14319.81,31,3,14888.809999999998,568.9999999999982
26888,U40674,34,5.469999999997981,22,12,64212.01,64217.48
26889,U11009,34,-14831.030000000002,27,7,61753.92999999999,46922.899999999994
26890,U32765,34,-3694.2100000000196,25,9,412504.67000000004,408810.46
26891,U34974,34,7680.93,24,10,13951.35,21632.28
26892,U1132386,34,5711.89,24,10,50788.52000000001,56500.41000000001
26893,U43037,34,1062.6800000000017,24,10,18538.38,19601.06
26894,U21872,34,-7230.389999999998,28,6,55292.05999999999,48061.66999999999
26895,U29463,34,27927.43999999999,24,10,10020.469999999996,37947.90999999999
26896,U41796,34,3733.150000000001,23,11,27999.099999999995,31732.249999999996
26897,U33587,34,-206.51999999999998,28,6,3425.69,3219.17
26898,U14887,34,469423.79000000004,25,9,127554.40999999999,596978.2000000001
26899,U35994,34,42642.73,14,20,111175.6,153818.33000000002
26900,U30205,34,65.3299999999872,21,13,1300300.0,1300365.33
26901,U16680,34,-4018.970000000001,27,7,9030.04,5011.07
26902,U31724,34,12802.240000000002,30,4,9697.769999999999,22500.010000000002
26903,U43923,34,-1.8189894035458565e-12,17,17,36873.91,36873.91
26904,U29299,34,420611.56999999983,29,5,2229930.65,2650542.2199999997
26905,U15226,34,39269.56,24,10,12595.859999999999,51865.42
26906,U43614,34,-9144.11,30,4,23491.469999999998,14347.359999999997
26907,U30787,34,4.879999999999921,24,10,1476.3500000000001,1481.23
26908,U42363,34,-28677.630000000005,18,16,310818.20999999996,282140.57999999996
26909,U43237,34,26970.679999999997,25,9,126793.42,153764.1
26910,U33612,34,-52481.81,19,15,153132.0,100650.19
26911,U19047,34,-8525.880000000001,25,9,61859.66,53333.78
26912,U31254,34,10815.869999999995,18,16,189444.35,200260.22
26913,U1092938,34,8.670000000000243,15,19,11410.0,11418.67
26914,U44042,34,-2570.960000000001,23,11,24730.96,22160.0
26915,U24052,34,-176.0899999999674,19,15,1424581.62,1424405.5300000003
26916,U973881,34,317.89000000000016,20,14,7028.0,7345.89
26917,U30480,34,-208.25,29,5,19597.2,19388.95
26918,U22989,34,-619.4700000000012,19,15,412697.97,412078.5
26919,U19687,34,-4000.0,20,14,23194.309999999998,19194.309999999998
26920,U37005,34,-589.5400000000002,28,6,1803.06,1213.5199999999998
26921,U1125930,34,6989.29,31,3,6801.98,13791.27
26922,U42966,34,-3531.6899999999996,29,5,6654.57,3122.88
26923,U36381,34,-25294.03,27,7,58803.549999999996,33509.52
26924,U16551,34,-463555.61,26,8,973551.4299999999,509995.81999999995
26925,U38377,34,879.1099999999988,21,13,57248.97,58128.08
26926,U35414,34,-10063.849999999999,26,8,49304.32,39240.47
26927,U42735,34,-13754.620000000003,19,15,71908.11,58153.49
26928,U41817,34,8612.680000000002,26,8,14443.490000000002,23056.170000000006
26929,U39994,34,-11416.07,24,10,49343.32000000001,37927.25000000001
26930,U36606,34,39450.44,15,19,130629.63,170080.07
26931,U9024,34,-8156.769999999999,28,6,24619.24,16462.47
26932,U37437,34,-5822.489999999997,27,7,32075.269999999997,26252.78
26933,U694712,34,-989.5899999999995,25,9,10907.759999999998,9918.169999999998
26934,U720700,34,-49.69999999999982,30,4,5129.700000000001,5080.000000000001
26935,U43896,34,4345.23,21,13,13391.76,17736.989999999998
26936,U11706,34,3852.66,26,8,64322.72,68175.38
26937,U14629,34,-27169.300000000003,19,15,210960.65999999997,183791.36
26938,U37860,34,-4878.699999999999,26,8,5926.599999999999,1047.9000000000005
26939,U33999,34,-20023.859999999997,21,13,54566.990000000005,34543.130000000005
26940,U17615,34,14787.13,25,9,26408.060000000005,41195.19
26941,U38881,34,-2935.9999999999927,20,14,50781.909999999996,47845.91
26942,U36964,34,7040.97,28,6,20534.260000000006,27575.230000000007
26943,U20733,34,-20388.649999999998,21,13,27632.559999999998,7243.91
26944,U35347,34,346420.1700000001,18,16,175592.41999999998,522012.5900000001
26945,U13318,34,-51764.479999999996,23,11,422079.47000000003,370314.99000000005
26946,U19619,34,381.10999999999274,13,21,713932.7,714313.8099999999
26947,U18880,34,-17578.160000000003,28,6,26390.440000000006,8812.280000000002
26948,U21310,34,13615.469999999996,25,9,14022.480000000001,27637.949999999997
26949,U17487,34,-12180.349999999933,16,18,1089399.4700000002,1077219.1200000003
26950,U21372,34,15.220000000000912,24,10,21313.07,21328.29
26951,U36242,34,868.9099999999996,20,14,79841.35,80710.26000000001
26952,U13604,34,511.300000000002,21,13,41149.32999999999,41660.62999999999
26953,U22174,34,24879.739999999998,12,22,16599.87,41479.61
26954,U29106,34,54158.52999999997,14,20,1197941.5,1252100.03
26955,U19228,34,2977.6399999999994,20,14,20839.39,23817.03
26956,U28367,34,-1132.5900000000001,19,15,34724.25000000001,33591.66
26957,U31153,34,977.1399999999994,26,8,14449.5,15426.64
26958,U24356,34,34.73000000001747,3,31,270365.57,270400.30000000005
26959,U33375,34,15001.86,25,9,35726.41,50728.270000000004
26960,U8258,34,671.4099999999999,25,9,7205.650000000001,7877.06
26961,U19714,34,-2870.1499999999996,30,4,3459.06,588.9100000000003
26962,U39165,34,-3179.6499999999996,27,7,19203.5,16023.85
26963,U33002,34,-125.1499999999985,24,10,57595.16999999999,57470.01999999999
26964,U888720,34,9533.010000000004,14,20,36291.09,45824.1
26965,U21946,34,5397.179999999999,28,6,2536.8999999999996,7934.079999999999
26966,U27919,34,-39125.78,16,18,239904.05000000002,200778.27000000002
26967,U30604,34,593.5100000000239,28,6,116757.84000000001,117351.35000000003
26968,U16963,34,-5754.350000000004,16,18,96822.59,91068.23999999999
26969,U32108,34,-10545.369999999999,27,7,96257.01000000001,85711.64000000001
26970,U11568,34,33261.17999999999,31,3,10268.83,43530.009999999995
26971,U29149,34,-20725.300000000007,23,11,458021.26,437295.96
26972,U39958,34,-23532.51,27,7,31556.53,8024.02
26973,U12681,34,9486.370000000003,29,5,25543.440000000002,35029.810000000005
26974,U40013,34,114238.53000000003,21,13,577815.7200000001,692054.2500000001
26975,U10529,34,62734.72000000001,16,18,32503.23,95237.95000000001
26976,U19156,34,-221817.62000000002,31,3,222969.01000000004,1151.390000000014
26977,U13032,34,-5058.299999999997,24,10,58707.92,53649.62
26978,U1249759,34,175.01000000000067,20,14,15329.079999999998,15504.089999999998
26979,U37919,34,-3461.99,19,15,121867.0,118405.01
26980,U20018,34,966920.6699999999,26,8,51028.649999999994,1017949.32
26981,U29680,34,75610.40999999997,22,12,752349.23,827959.6399999999
26982,U8440,34,74857.79999999996,24,10,595914.0599999999,670771.8599999999
26983,U24705,34,-2188.7099999999673,26,8,374993.01999999996,372804.31
26984,U15530,34,-5437.750000000007,20,14,83456.0,78018.25
26985,U27504,34,1967.7799999999997,31,3,5035.38,7003.16
26986,U16521,34,-22841.729999999923,19,15,937093.87,914252.1400000001
26987,U12585,34,17189.77999999999,24,10,63557.57000000001,80747.35
26988,U9425,34,-15762.160000000002,29,5,30545.269999999997,14783.109999999995
26989,U27149,34,-15417.569999999945,17,17,3041390.0,3025972.43
26990,U34996,34,-6397.210000000001,20,14,47001.51999999999,40604.30999999999
26991,U42618,34,-206883.16999999998,26,8,279362.58999999997,72479.41999999998
26992,U10012,34,24150.000000000004,20,14,44011.21,68161.21
26993,U26002,34,594.1099999999999,29,5,6872.17,7466.28
26994,U17966,34,2887.2699999999963,23,11,128965.90000000001,131853.17
26995,U38041,34,-15195.799999999988,17,17,171590.37,156394.57
26996,U27644,34,14601.39,19,15,68319.65000000001,82921.04000000001
26997,U21861,34,29661.019999999997,25,9,41543.08,71204.1
26998,U10150,34,794.779999999999,20,14,112049.0,112843.78
26999,U1326930,34,71.65999999999997,21,13,4238.35,4310.01
27000,U39029,34,17900.67,26,8,25895.48,43796.149999999994
27001,U43003,34,-19437.05,25,9,65601.76000000001,46164.71000000001
27002,U899273,34,35.339999999999975,19,15,979.62,1014.96
27003,U32042,34,-16776.72,14,20,186848.0,170071.28
27004,U39799,34,1.3642420526593924e-12,17,17,38997.649999999994,38997.649999999994
27005,U11404,34,-4170.590000000009,24,10,129174.78,125004.18999999999
27006,U40937,34,1153.5999999999995,20,14,10355.85,11509.45
27007,U40054,34,-1142.2700000000098,19,15,225773.0,224630.72999999998
27008,U22716,34,-109.27999999999997,25,9,8821.57,8712.289999999999
27009,U19724,34,-140706.31,26,8,277633.9,136927.59000000003
27010,U17982,34,27703.71,11,23,28213.94,55917.649999999994
27011,U40359,34,-573.81,30,4,2622.310000000001,2048.500000000001
27012,U40062,34,15452.76000000003,17,17,305075.96,320528.72000000003
27013,U39067,34,-23113.489999999998,22,12,133627.74,110514.25
27014,U9630,34,-9507.150000000001,24,10,71134.78,61627.63
27015,U18349,34,2646.779999999999,32,2,97354.0,100000.78
27016,U37839,34,1634.7100000000003,24,10,2781.96,4416.67
27017,U29113,34,-91341.88999999998,21,13,247239.33000000002,155897.44000000003
27018,U37629,34,4507.320000000002,23,11,108931.85999999999,113439.18
27019,U27490,34,63.76999999999907,22,12,145132.27,145196.03999999998
27020,U10335,34,-7585.1,16,18,111684.0,104098.9
27021,U28184,34,0.019999999998617568,18,16,86006.33999999998,86006.35999999999
27022,U29110,34,35664.46999999992,12,22,505217.8,540882.2699999999
27023,U42614,34,-2121.1800000000007,27,7,9676.96,7555.779999999999
27024,U22810,34,80450.74,17,17,321585.18,402035.92
27025,U23317,34,23086.999999999996,16,18,58594.819999999985,81681.81999999998
27026,U19094,34,-3185.9500000000025,28,6,73021.53,69835.58
27027,U1119144,34,-429.44000000000005,24,10,3114.54,2685.1
27028,U10370,34,2557.150000000004,19,15,80429.90000000001,82987.05000000002
27029,U36928,34,292280.63,17,17,647819.3800000001,940100.0100000001
27030,U11422,34,-3907.0099999999966,18,16,111676.41,107769.40000000001
27031,U668456,34,2208.5099999999993,28,6,4551.419999999999,6759.9299999999985
27032,U12270,34,-2168.5800000000054,20,14,185533.10000000003,183364.52000000002
27033,U1163904,34,-94.18999999999997,21,13,2751.8799999999997,2657.6899999999996
27034,U21033,34,-2963.069999999999,29,5,21165.94,18202.87
27035,U17328,34,-352135.14,23,11,431642.5299999999,79507.3899999999
27036,U9975,34,-1870.5700000000002,27,7,11817.309999999998,9946.739999999998
27037,U17972,34,-72.09,27,7,8115.040000000001,8042.950000000001
27038,U11964,34,-7070.2899999999645,18,16,155923.03,148852.74000000005
27039,U32856,34,6.150000000009641,22,12,95234.1,95240.25000000001
27040,U42205,34,4296.87,25,9,1040.79,5337.66
27041,U22054,34,4640.76,24,10,25483.43,30124.190000000002
27042,U33583,34,-2136.0,19,15,100798.85,98662.85
27043,U28841,34,-59823.29,28,6,100208.27,40384.98
27044,U31429,34,-19638.09999999999,22,12,58560.61,38922.51000000001
27045,U35231,34,-5288.970000000003,25,9,387447.95999999996,382158.98999999993
27046,U21839,34,-2869.8800000000015,29,5,9551.830000000002,6681.950000000001
27047,U23331,34,-9144.42,22,12,76273.46999999997,67129.04999999997
27048,U10520,34,-84896.04000000001,19,15,1822327.2,1737431.16
27049,U17741,34,-1296.6099999999988,25,9,15278.0,13981.390000000001
27050,U9609,34,124.30999999998619,22,12,63396.08000000001,63520.38999999999
27051,U35196,34,4347.769999999998,27,7,8877.689999999999,13225.459999999995
27052,U33919,34,-107880.65999999997,20,14,753474.52,645593.8600000001
27053,U23701,34,-106.93000000000485,21,13,35793.40999999999,35686.47999999998
27054,U34776,34,2362.6,18,16,103010.76000000001,105373.36000000002
27055,U32452,34,-394.78,29,5,1795.5400000000002,1400.7600000000002
27056,U24939,34,157730.59999999998,18,16,90263.95999999999,247994.55999999997
27057,U25855,34,-270.11000000000047,31,3,3625.7200000000016,3355.610000000001
27058,U36558,34,-6452.540000000001,30,4,8057.960000000001,1605.42
27059,U662541,34,10.810000000000043,19,15,2045.0,2055.81
27060,U1063512,34,3.2400000000000952,17,17,3957.5099999999998,3960.75
27061,U26952,34,6781.989999999994,25,9,54850.520000000004,61632.509999999995
27062,U12613,34,-1454.6899999999987,21,13,106715.47,105260.78
27063,U10070,34,23424.420000000006,21,13,116597.6,140022.02000000002
27064,U33731,34,282.88,25,9,560.61,843.49
27065,U1067677,34,-2852.9800000000005,21,13,23544.809999999998,20691.829999999998
27066,U28253,34,-1702.4899999999998,25,9,34547.74,32845.25
27067,U1356300,34,-14.779999999999063,26,8,5335.04,5320.260000000001
27068,U26512,34,-19805.77000000005,24,10,1674997.04,1655191.27
27069,U12723,34,-2222.5400000000022,23,11,19693.89,17471.35
27070,U761432,34,-4951.360000000001,22,12,16347.95,11396.59
27071,U23877,34,-12957.29,27,7,20519.63,7562.34
27072,U777919,34,1290.3399999999979,23,11,43789.76,45080.1
27073,U39003,34,11231.71000000002,24,10,115838.59999999998,127070.31
27074,U32027,34,12049.740000000003,30,4,53650.299999999996,65700.04
27075,U18791,34,453458.5399999999,29,5,53795.78999999999,507254.3299999999
27076,U40485,34,84.07999999999515,14,20,214396.85,214480.93
27077,U13812,34,79043.39,22,12,493786.82999999996,572830.22
27078,U38945,34,-1023022.5900000001,25,9,1033009.64,9987.04999999993
27079,U38028,34,489657.9,21,13,568860.0,1058517.9
27080,U12559,34,12823.46,17,17,23449.68,36273.14
27081,U37791,34,4505.499999999991,17,17,354150.38000000006,358655.88000000006
27082,U11645,34,-6914.98,23,11,19246.98,12332.0
27083,U17450,34,4638.0199999999995,23,11,13896.669999999998,18534.69
27084,U666777,33,-1312.4,32,1,1612.4000000000005,300.00000000000045
27085,U25622,33,972.4500000000007,25,8,22344.65,23317.100000000002
27086,U17096,33,1553.51,25,8,2317.4800000000005,3870.9900000000007
27087,U1082456,33,-3848.259999999999,30,3,4954.259999999998,1105.9999999999995
27088,U18028,33,399.030000000002,19,14,42966.100000000006,43365.130000000005
27089,U37392,33,-16177.18,25,8,99008.25,82831.07
27090,U35849,33,-60511.770000000004,15,18,348002.85,287491.07999999996
27091,U33635,33,1538.5600000000002,29,4,7187.990000000001,8726.550000000001
27092,U30731,33,-303.10000000000105,20,13,35797.36,35494.26
27093,U31352,33,-536.7999999999913,20,13,130771.29999999999,130234.5
27094,U26048,33,323.78,29,4,2199.83,2523.6099999999997
27095,U33078,33,4389.080000000005,26,7,123156.1,127545.18000000001
27096,U18185,33,90722.84999999999,22,11,29839.5,120562.34999999999
27097,U1235783,33,-503.69000000000005,24,9,2111.32,1607.63
27098,U10556,33,-41996.24000000008,21,12,1196864.48,1154868.24
27099,U35692,33,-2131.6799999999994,27,6,10638.7,8507.02
27100,U8701,33,-5074.479999999993,27,6,147209.44000000003,142134.96000000005
27101,U24342,33,891.9899999999907,15,18,882200.0,883091.99
27102,U34535,33,-3807.220000000001,25,8,77549.47,73742.25
27103,U20395,33,-28205.509999999995,25,8,91991.35,63785.84000000001
27104,U15763,33,-2865.760000000001,23,10,38014.61,35148.85
27105,U37439,33,28386.14,27,6,11691.23,40077.369999999995
27106,U37519,33,77.67000000000053,28,5,8969.74,9047.41
27107,U37967,33,3408.100000000003,21,12,13090.24,16498.340000000004
27108,U29010,33,86454.32,22,11,105373.17,191827.49
27109,U675747,33,2.299999999999991,23,10,2729.3,2731.6000000000004
27110,U43062,33,-1303.87,22,11,18268.199999999997,16964.329999999998
27111,U39041,33,127772.47000000003,11,22,611671.0,739443.47
27112,U1056484,33,-20.0,21,12,19460.809999999998,19440.809999999998
27113,U30328,33,-15232.21,15,18,142811.90000000002,127579.69000000003
27114,U31959,33,108860.32000000002,23,10,112438.26999999999,221298.59000000003
27115,U12967,33,3331.660000000001,17,16,24759.68,28091.34
27116,U34725,33,-228.9100000000003,25,8,9758.439999999999,9529.529999999999
27117,U17700,33,21307.6,29,4,11100.42,32408.019999999997
27118,U23887,33,4466.769999999995,20,13,30803.420000000002,35270.189999999995
27119,U24283,33,-13039.269999999982,27,6,47651.83999999998,34612.57
27120,U1159266,33,-4019.0,27,6,8860.15,4841.15
27121,U10782,33,-11627.480000000047,18,15,1426347.8,1414720.32
27122,U27673,33,331.3600000000001,26,7,3230.8,3562.1600000000003
27123,U24370,33,40088.000000000386,21,12,21203729.16,21243817.16
27124,U38160,33,389.12999999999914,22,11,14294.96,14684.089999999998
27125,U32332,33,-11811.839999999997,24,9,159864.36000000002,148052.52000000002
27126,U30888,33,7949.510000000004,23,10,92127.04999999999,100076.56
27127,U30305,33,40540.590000000004,28,5,19870.020000000004,60410.61000000001
27128,U1112568,33,-526.06,26,7,3554.65,3028.59
27129,U691101,33,199.99999999999977,17,16,50865.0,51065.0
27130,U31148,33,114.5600000000017,20,13,23345.79,23460.350000000002
27131,U1063102,33,-2113.75,30,3,3605.7200000000003,1491.9700000000003
27132,U18298,33,3733.9199999999996,29,4,5311.2300000000005,9045.15
27133,U8584,33,-52815.65000000001,28,5,86932.93000000001,34117.28
27134,U10666,33,3181.999999999998,20,13,55744.78,58926.78
27135,U22283,33,-875.25,20,13,3086431.73,3085556.48
27136,U36940,33,2428.229999999996,17,16,122178.72,124606.95
27137,U21120,33,-778.2600000000002,27,6,32797.840000000004,32019.58
27138,U40077,33,-73574.64,24,9,240772.66999999998,167198.02999999997
27139,U17317,33,5978.180000000015,22,11,85211.89,91190.07
27140,U27298,33,-12573.429999999998,27,6,31722.49,19149.060000000005
27141,U9203,33,99198.98000000001,20,13,645234.03,744433.01
27142,U27713,33,-1382.0800000000004,28,5,3618.6000000000004,2236.52
27143,U33473,33,-1820.3500000000001,27,6,7897.759999999999,6077.409999999999
27144,U30838,33,226.25000000000009,28,5,8551.210000000001,8777.460000000001
27145,U29555,33,-67147.12,12,21,372976.5,305829.38
27146,U39482,33,-25785.85,22,11,91802.56,66016.70999999999
27147,U37872,33,8142.73,27,6,16862.920000000002,25005.65
27148,U21618,33,7700.409999999945,16,17,606817.2,614517.6099999999
27149,U23265,33,-5055.67,28,5,21526.570000000003,16470.9
27150,U39764,33,5258.029999999984,21,12,323404.62,328662.64999999997
27151,U36170,33,492.77000000000044,14,19,63730.2,64222.97
27152,U1359542,33,-11203.269999999993,27,6,16064.099999999995,4860.830000000002
27153,U13080,33,-6289.98000000001,20,13,130890.59999999999,124600.61999999998
27154,U1034623,33,-11.209999999999908,23,10,2107.99,2096.7799999999997
27155,U34426,33,-462.1299999999992,25,8,28011.459999999992,27549.329999999994
27156,U28499,33,-8213.379999999997,25,8,55893.11,47679.73
27157,U10192,33,-11295.560000000001,20,13,31570.660000000003,20275.100000000002
27158,U15864,33,-121240.24,20,13,460476.12999999995,339235.88999999996
27159,U34752,33,56802.44,27,6,4790.7,61593.14
27160,U27622,33,-1712.21,21,12,130123.37000000001,128411.16
27161,U39222,33,213591.47999999998,24,9,218961.56,432553.04
27162,U14073,33,7357.620000000006,24,9,88934.47000000003,96292.09000000004
27163,U1071339,33,31.669999999999867,20,13,4934.009999999999,4965.679999999999
27164,U30585,33,16464.29,22,11,19070.210000000003,35534.5
27165,U594920,33,-7.399999999999977,21,12,1283.4,1276.0
27166,U20170,33,-865.5999999999985,23,10,67191.82,66326.22
27167,U29701,33,-4212.040000000001,24,9,32497.86,28285.82
27168,U32022,33,494.91000000000565,25,8,111842.21,112337.12000000001
27169,U38791,33,3303.2400000000157,14,19,304520.5300000001,307823.7700000001
27170,U43647,33,1741.3600000000001,20,13,19873.43,21614.79
27171,U20325,33,-36791.88,21,12,69208.0,32416.120000000003
27172,U16450,33,16754.85,29,4,2216.5800000000004,18971.43
27173,U41371,33,468.16000000002396,16,17,218156.0,218624.16000000003
27174,U1209029,33,5844.56,26,7,2866.6000000000004,8711.16
27175,U21888,33,-13991.470000000001,28,5,50103.55999999999,36112.08999999999
27176,U21297,33,-3623.3200000000006,26,7,6263.55,2640.2299999999996
27177,U29766,33,87607.04999999999,22,11,341629.51,429236.56
27178,U30378,33,-2688.0999999999767,25,8,285004.91000000003,282316.81000000006
27179,U17186,33,-26647.699999999662,21,12,5056771.65,5030123.950000001
27180,U30451,33,-20941.870000000006,22,11,86749.0,65807.12999999999
27181,U12899,33,-12340.610000000002,18,15,35717.14,23376.53
27182,U8968,33,4618.260000000003,26,7,6988.029999999996,11606.289999999999
27183,U36008,33,-1193.6600000000035,3,30,15158.0,13964.339999999997
27184,U35010,33,-175754.18999999994,16,17,623511.0,447756.81000000006
27185,U23165,33,-731.4800000000007,22,11,31284.36,30552.88
27186,U25710,33,43809.549999999996,17,16,102300.65000000001,146110.2
27187,U23152,33,7183.059999999989,14,19,221091.99,228275.05
27188,U15200,33,41733.490000000005,19,14,36252.58,77986.07
27189,U37989,33,6355.280000000001,20,13,38503.32,44858.6
27190,U29629,33,-11536.03,27,6,50441.44,38905.41
27191,U585300,33,-56.3100000000004,20,13,9292.85,9236.54
27192,U974890,33,-8458.98,27,6,15327.839999999997,6868.859999999997
27193,U1378622,33,-6.970000000000255,25,8,4480.0,4473.03
27194,U39207,33,121543.21,19,14,146827.42,268370.63
27195,U32909,33,14084.510000000002,24,9,26771.53,40856.04
27196,U18422,33,-203191.88,28,5,208406.89,5215.010000000009
27197,U43175,33,37.090000000000146,16,17,180633.2,180670.29
27198,U11700,33,-4084.800000000003,18,15,327066.0,322981.2
27199,U40550,33,6824.809999999998,16,17,203520.1,210344.91
27200,U42752,33,34016.31,18,15,57035.100000000006,91051.41
27201,U17691,33,-6780.420000000002,25,8,57583.72,50803.3
27202,U18036,33,-69096.07999999999,16,17,315243.97,246147.88999999998
27203,U8417,33,974.4200000000019,20,13,56961.100000000006,57935.520000000004
27204,U18938,33,6719.179999999935,28,5,2011284.79,2018003.97
27205,U27743,33,-1460.4199999999994,20,13,19625.850000000002,18165.430000000004
27206,U26902,33,25850.910000000003,26,7,8284.45,34135.36
27207,U14058,33,-10890.41,25,8,48919.52,38029.11
27208,U18894,33,-7607.0,27,6,16246.95,8639.95
27209,U22343,33,10695.379999999997,16,17,72880.69,83576.07
27210,U25562,33,-2948.7200000000007,29,4,10481.429999999998,7532.709999999997
27211,U11149,33,10775.299999999932,25,8,714634.7300000001,725410.03
27212,U33191,33,16905.54,26,7,23947.97,40853.51
27213,U42935,33,-617762.5499999999,18,15,2030242.5999999999,1412480.0499999998
27214,U34345,33,21940.41,16,17,167211.03,189151.44
27215,U10154,33,164772.7,26,7,135544.0,300316.7
27216,U38008,33,30558.44,8,25,144376.55,174934.99
27217,U975767,33,1335.4199999999996,26,7,16249.509999999997,17584.929999999997
27218,U14829,33,-139089.27,17,16,401018.20000000007,261928.93000000008
27219,U13521,33,-2217.540000000001,23,10,24105.1,21887.559999999998
27220,U39507,33,79668.05,17,16,33451.920000000006,113119.97
27221,U30513,33,-141289.88999999998,16,17,367294.67000000004,226004.78000000006
27222,U9041,33,-8532.370000000003,27,6,26480.350000000006,17947.980000000003
27223,U27928,33,-1535.480000000001,28,5,59257.35,57721.869999999995
27224,U38729,33,1334.02,24,9,10221.95,11555.970000000001
27225,U30628,33,19015.349999999977,27,6,1108908.3,1127923.65
27226,U36206,33,-197274.77,23,10,607577.78,410303.01
27227,U15624,33,15123.76,22,11,12005.38,27129.14
27228,U35098,33,7487.040000000001,27,6,2588.84,10075.880000000001
27229,U14117,33,-5728.029999999984,19,14,279551.25,273823.22000000003
27230,U27263,33,-20694.849999999995,27,6,69371.17,48676.32000000001
27231,U821642,33,7685.12,10,23,14740.119999999999,22425.239999999998
27232,U32928,33,-1276.500000000001,19,14,34003.14,32726.64
27233,U37798,33,3186.380000000001,16,17,18493.93,21680.31
27234,U14083,33,-5.0700000000006185,20,13,7220.110000000001,7215.04
27235,U29879,33,-11175.909999999998,26,7,22057.620000000003,10881.710000000005
27236,U20935,33,-4044.029999999999,22,11,25075.98,21031.95
27237,U32057,33,511.9899999999998,25,8,35201.0,35712.99
27238,U1163961,33,-936.2700000000002,26,7,10024.32,9088.05
27239,U31250,33,35055.84000000001,27,6,127449.48,162505.32
27240,U29923,33,90022.44000000002,20,13,132500.89,222523.33000000002
27241,U38039,33,1991.5999999999995,28,5,1470.9500000000003,3462.5499999999997
27242,U42761,33,-114687.47999999998,26,7,208233.51999999996,93546.03999999998
27243,U25111,33,-642.1899999999874,24,9,123061.45999999999,122419.27
27244,U37214,33,-995.98,22,11,6517.7,5521.719999999999
27245,U30122,33,-126476.03000000004,25,8,681973.62,555497.59
27246,U16975,33,-543.3099999999998,22,11,29325.700000000004,28782.390000000003
27247,U39445,33,-5016.62,28,5,13875.679999999998,8859.059999999998
27248,U18472,33,-22325.76,28,5,29340.64,7014.880000000001
27249,U34935,33,5342.720000000001,20,13,147934.69999999998,153277.41999999998
27250,U35055,33,101000.77,15,18,473705.0,574705.77
27251,U17110,33,-24689.080000000016,8,25,7202137.97,7177448.89
27252,U33465,33,7576.510000000009,17,16,136336.0,143912.51
27253,U1080709,33,-1056.979999999998,31,2,1356.989999999998,300.01
27254,U32127,33,-5172.19,23,10,37782.56,32610.37
27255,U39454,33,-165504.9,30,3,166322.94999999998,818.0499999999884
27256,U26375,33,-40597.56999999999,21,12,147767.88,107170.31000000001
27257,U20445,33,243.74000000000024,26,7,6506.4800000000005,6750.220000000001
27258,U1154455,33,-193.39999999999998,17,16,6575.8899999999985,6382.489999999999
27259,U21635,33,418943.37,24,9,159121.89,578065.26
27260,U590788,33,1614.2800000000009,27,6,8013.300000000001,9627.580000000002
27261,U33289,33,4807.25,30,3,10069.02,14876.27
27262,U36561,33,198010.57,13,20,5969.2300000000005,203979.80000000002
27263,U37787,33,-556.05,30,3,6629.339999999999,6073.289999999999
27264,U14132,33,49862.429999999986,22,11,139856.41,189718.84
27265,U38850,33,-8026.010000000009,18,15,452018.14,443992.13
27266,U37160,33,530.3000000000004,24,9,4509.410000000001,5039.710000000001
27267,U26728,33,-1493.8300000000017,24,9,87643.29,86149.45999999999
27268,U1105105,33,-28914.9,20,13,124127.9,95213.0
27269,U29012,33,-43011.56,24,9,163372.63,120361.07
27270,U32911,33,28302.839999999997,25,8,36482.83,64785.67
27271,U30976,33,384147.3,24,9,517259.01,901406.31
27272,U29613,33,1147.4499999999994,24,9,23720.68,24868.13
27273,U15441,33,-4427.559999999998,26,7,62022.2,57594.64
27274,U43558,33,-960.1600000000326,6,27,1097666.0,1096705.8399999999
27275,U35900,33,891.7399999999998,22,11,14759.02,15650.76
27276,U15707,33,-546475.56,25,8,1236496.0,690020.44
27277,U1321787,33,907.1799999999998,28,5,6335.66,7242.84
27278,U669511,33,-178.65999999999997,22,11,3248.0,3069.34
27279,U18267,33,690.8499999999982,24,9,23096.499999999996,23787.349999999995
27280,U32278,33,-1439.3199999999997,27,6,9055.78,7616.460000000001
27281,U43276,33,25285.940000000017,25,8,181560.0,206845.94
27282,U30359,33,2147.8099999999995,21,12,59065.03,61212.84
27283,U14521,33,276688.5800000001,23,10,298508.48,575197.06
27284,U43072,33,19208.780000000013,22,11,151535.12,170743.90000000002
27285,U755710,33,-2494.0100000000007,31,2,2794.0300000000007,300.02
27286,U24643,33,1.5,19,14,473106.50999999995,473108.00999999995
27287,U26222,33,-4892.069999999999,22,11,22711.440000000002,17819.370000000003
27288,U32737,33,-100199.13,21,12,294722.0,194522.87
27289,U24999,33,-10338.73,29,4,28909.5,18570.77
27290,U18369,33,-632.7799999999972,23,10,60395.71000000001,59762.93000000001
27291,U35803,33,-1496.089999999998,21,12,65273.02,63776.93
27292,U37562,33,4130.43,15,18,20387.010000000002,24517.440000000002
27293,U35747,33,-9502.960000000003,30,3,48200.100000000006,38697.14
27294,U1190182,33,-1255.6199999999997,22,11,23509.96,22254.34
27295,U8655,33,-13517.439999999999,28,5,32638.36,19120.920000000002
27296,U42084,33,3309.5999999999767,21,12,335632.62,338942.22
27297,U38869,33,-78076.62,14,19,272990.98,194914.36
27298,U8598,33,841.7199999999999,22,11,2279.070000000001,3120.790000000001
27299,U24581,33,57196.67999999999,25,8,28058.45,85255.12999999999
27300,U41529,33,-191694.59999999998,18,15,222273.0,30578.400000000023
27301,U1226418,33,-6541.439999999999,27,6,23623.660000000003,17082.220000000005
27302,U31000,33,187.21999999999997,29,4,269.04,456.26
27303,U25680,33,2117.319999999999,20,13,55307.969999999994,57425.28999999999
27304,U22985,33,-3255.8999999999996,22,11,85854.43,82598.53
27305,U24285,33,985.1800000000001,22,11,11637.38,12622.56
27306,U41543,33,13586.279999999999,15,18,82165.74,95752.02
27307,U13691,33,-19386.109999999928,10,23,1717000.0,1697613.8900000001
27308,U19747,33,19860.560000000005,22,11,11979.239999999998,31839.800000000003
27309,U23865,33,-294.829999999998,21,12,116675.68,116380.84999999999
27310,U25579,33,-5247.25,29,4,6754.01,1506.7600000000002
27311,U37218,33,371.6999999999977,18,15,40128.07,40499.77
27312,U29397,33,-385.59999999999854,22,11,65800.89,65415.29
27313,U31827,33,5999.670000000001,27,6,8970.260000000002,14969.930000000004
27314,U35607,33,-125.6400000000001,22,11,9695.41,9569.77
27315,U9222,33,15474.539999999994,24,9,68498.91,83973.45
27316,U43720,33,1216.9199999999985,23,10,72986.26,74203.18
27317,U42980,33,-5440.179999999995,15,18,206979.42,201539.24000000002
27318,U9909,33,-4139.540000000002,24,9,175804.41,171664.87
27319,U36015,33,-211.50999999999988,18,15,87634.02,87422.51000000001
27320,U9062,33,1534.739999999998,28,5,47851.18,49385.92
27321,U1273716,33,-15822.119999999999,16,17,84327.0,68504.88
27322,U37722,33,-4175.880000000001,22,11,23361.350000000002,19185.47
27323,U26029,33,14978.339999999851,16,17,3120574.79,3135553.13
27324,U16960,33,-65799.94,21,12,1045907.5299999999,980107.5899999999
27325,U14170,33,371.33000000000084,23,10,48493.33,48864.66
27326,U36553,33,-1366.0900000000004,21,12,10907.34,9541.25
27327,U36554,33,6276.370000000001,24,9,2867.9300000000003,9144.300000000001
27328,U13740,33,4476.26,20,13,267339.49000000005,271815.75000000006
27329,U1271120,33,-662.9300000000006,25,8,5212.36,4549.429999999999
27330,U40939,33,115216.14000000001,20,13,191997.47999999998,307213.62
27331,U22136,33,-24335.04,25,8,82627.28,58292.24
27332,U17835,33,226.92999999997852,14,19,233527.30000000002,233754.23
27333,U26654,33,10986.509999999998,28,5,6622.6,17609.11
27334,U25946,33,14341.929999999998,22,11,39082.76000000001,53424.69000000001
27335,U31289,33,14928.159999999993,19,14,331635.37999999995,346563.5399999999
27336,U40498,33,3251.5600000000004,23,10,5311.820000000001,8563.380000000001
27337,U31882,33,7877.1,25,8,21985.920000000002,29863.020000000004
27338,U31661,33,-24963.35,18,15,128827.78000000001,103864.43000000002
27339,U20701,33,5963.28,16,17,59604.329999999994,65567.61
27340,U1270629,33,-416.6000000000002,22,11,13276.37,12859.77
27341,U10328,33,-27835.75,25,8,85783.77999999998,57948.029999999984
27342,U956690,33,-406.41000000000014,21,12,2585.28,2178.87
27343,U14398,33,2187.329999999998,17,16,55640.93,57828.259999999995
27344,U1029457,33,-9.947598300641403e-14,21,12,1510.43,1510.43
27345,U27872,33,797.9000000000233,15,18,313752.72,314550.62
27346,U1324075,33,759.8599999999997,22,11,16581.22,17341.08
27347,U15988,33,-7604.16,27,6,16358.240000000002,8754.080000000002
27348,U899450,33,-96.78000000000003,30,3,519.38,422.59999999999997
27349,U21030,33,-2726.8900000000212,18,15,281283.52,278556.63
27350,U24865,33,-1006.4300000000003,23,10,112280.83,111274.4
27351,U25222,33,33976.02,24,9,81757.41,115733.43
27352,U10327,33,206944.86999999997,22,11,51504.36,258449.22999999998
27353,U9113,33,6985.789999999997,23,10,185863.99,192849.78
27354,U12477,33,-371.23,30,3,1239.9,868.6700000000001
27355,U11108,33,3016.1499999999974,26,7,92491.51000000001,95507.66
27356,U1095048,33,0.609999999999909,19,14,5602.76,5603.37
27357,U21157,33,-1697.1800000000076,17,16,227381.63,225684.45
27358,U19124,33,-4729.689999999999,31,2,4797.5999999999985,67.90999999999985
27359,U15539,33,-389.82000000000573,14,19,61469.770000000004,61079.95
27360,U39712,33,371.08000000000015,15,18,36956.49,37327.57
27361,U19800,33,6568.459999999997,20,13,42858.57,49427.03
27362,U10922,32,691.5200000000013,13,19,61690.0,62381.520000000004
27363,U992915,32,3.7800000000001637,19,13,10876.11,10879.890000000001
27364,U18626,32,8060.9000000000015,18,14,17454.23,25515.13
27365,U20768,32,-1379.9600000000355,24,8,228380.8,227000.83999999997
27366,U21452,32,415.97999999999956,28,4,20456.39,20872.37
27367,U685922,32,1.3300000000008367,18,14,16934.4,16935.730000000003
27368,U10794,32,1169.4799999999998,25,7,4481.3899999999985,5650.869999999998
27369,U1351260,32,10.539999999999793,21,11,5720.29,5730.83
27370,U37844,32,-4922.490000000005,19,13,189172.0,184249.51
27371,U23411,32,-1926.2900000000027,18,14,58548.759999999995,56622.469999999994
27372,U17994,32,27184.88,21,11,14605.989999999998,41790.869999999995
27373,U13792,32,6445.719999999999,22,10,2606.87,9052.59
27374,U33849,32,1943.8699999999994,17,15,55691.53,57635.4
27375,U25366,32,-32809.01,20,12,151520.56,118711.54999999999
27376,U16188,32,80329.19999999998,21,11,331720.47,412049.6699999999
27377,U13892,32,21993.09,14,18,140824.63,162817.72
27378,U39056,32,-1107.829999999999,25,7,91722.29000000001,90614.46
27379,U823144,32,935.020000000005,17,15,152647.96000000002,153582.98000000004
27380,U25346,32,570.5099999999993,21,11,18620.79,19191.3
27381,U28995,32,2302.84,29,3,8955.71,11258.55
27382,U1069495,32,-894.1699999999994,23,9,99380.78000000003,98486.61000000003
27383,U32040,32,-98822.74999999999,26,6,190109.21,91286.46
27384,U34519,32,-2277.069999999996,20,12,102288.04000000001,100010.97000000002
27385,U1076192,32,-4065.0699999999997,27,5,6189.74,2124.67
27386,U28977,32,0.23999999999796273,14,18,169054.0,169054.24
27387,U33810,32,-9463.640000000001,29,3,10028.4,564.7599999999984
27388,U1373355,32,-6920.720000000001,23,9,13883.26,6962.539999999999
27389,U27819,32,-8600.060000000001,23,9,58928.37999999999,50328.31999999999
27390,U27738,32,12126.239999999998,20,12,15665.58,27791.82
27391,U14750,32,-1400.7700000000011,22,10,42052.10999999998,40651.339999999975
27392,U18818,32,-29413.340000000004,22,10,145823.34,116410.0
27393,U14976,32,4323.860000000001,28,4,9077.03,13400.890000000001
27394,U36426,32,11324.039999999999,22,10,13154.739999999998,24478.78
27395,U22688,32,12617.099999999997,24,8,5172.839999999999,17789.939999999995
27396,U35730,32,3343.2499999999995,25,7,6877.17,10220.42
27397,U18917,32,-2082.7500000000045,15,17,275859.3,273776.55
27398,U592831,32,-5700.780000000002,25,7,14438.910000000002,8738.130000000001
27399,U24309,32,69523.78999999998,13,19,1064356.8599999999,1133880.65
27400,U34342,32,5216.54,26,6,12369.5,17586.04
27401,U986501,32,206.94999999999845,19,13,18849.72,19056.67
27402,U22971,32,1017.9600000000028,16,16,62585.21,63603.17
27403,U26221,32,-17769.940000000006,27,5,19434.32000000001,1664.3800000000047
27404,U31421,32,9179.75,25,7,11900.160000000002,21079.910000000003
27405,U33160,32,-78.54000000000087,18,14,33301.75000000001,33223.21000000001
27406,U26080,32,-3412.8700000000013,21,11,40830.130000000005,37417.26
27407,U16913,32,-96.1399999999976,17,15,96076.56000000001,95980.42000000001
27408,U959245,32,-936.4299999999987,22,10,14557.539999999999,13621.11
27409,U15711,32,-1717.440000000042,17,15,1631545.0,1629827.56
27410,U1300433,32,-0.21000000000003383,20,12,5536.469999999999,5536.259999999999
27411,U1136104,32,-14345.36,32,0,14345.36,0.0
27412,U28525,32,1551.8799999999999,29,3,2449.6800000000003,4001.5600000000004
27413,U32633,32,-89460.25,20,12,359100.0,269639.75
27414,U31551,32,4654.750000000001,20,12,7508.41,12163.16
27415,U1205942,32,-13865.820000000002,22,10,19631.5,5765.6799999999985
27416,U31998,32,-3840.2500000000114,22,10,160189.01,156348.76
27417,U29491,32,-2436.659999999998,26,6,25505.760000000002,23069.100000000006
27418,U36164,32,42664.869999999995,12,20,144421.06,187085.93
27419,U1135544,32,9600.020000000004,15,17,56600.020000000004,66200.04000000001
27420,U25859,32,-94401.33,19,13,176370.0,81968.67
27421,U43491,32,1730.809999999999,21,11,20865.050000000003,22595.86
27422,U11236,32,-5837.260000000002,25,7,26476.56,20639.3
27423,U42762,32,95.83000000000065,29,3,9552.6,9648.43
27424,U16676,32,3137.7899999999886,20,12,112561.14000000004,115698.93000000004
27425,U21355,32,-29038.579999999994,26,6,33729.54,4690.960000000006
27426,U31187,32,-999.7299999999976,16,16,196055.52,195055.78999999998
27427,U43313,32,21774.08,20,12,12291.719999999996,34065.799999999996
27428,U44010,32,-248362.55000000002,23,9,464270.4,215907.85
27429,U40126,32,-709623.6699999999,8,24,1523943.5,814319.8300000001
27430,U11610,32,-7759.719999999999,26,6,59086.259999999995,51326.53999999999
27431,U25444,32,19225.280000000006,18,14,66122.28000000001,85347.56000000003
27432,U20770,32,-1275.5299999999675,19,13,628890.02,627614.4900000001
27433,U971417,32,-6142.629999999999,24,8,8288.789999999999,2146.16
27434,U11017,32,-5830.02,23,9,39199.0,33368.979999999996
27435,U27414,32,-1172.020000000001,26,6,21376.120000000006,20204.100000000006
27436,U32717,32,-140124.20999999996,18,14,197323.18,57198.97000000003
27437,U18186,32,76026.64,20,12,5187.16,81213.8
27438,U18837,32,-683.2599999999998,22,10,5379.0199999999995,4695.76
27439,U1131890,32,-6202.449999999997,24,8,61487.53999999999,55285.09
27440,U1237203,32,0.33999999999997504,19,13,1171.94,1172.28
27441,U28260,32,-35352.25000000007,17,15,688928.4600000001,653576.21
27442,U20315,32,534.4699999999943,23,9,111987.59,112522.06
27443,U1201478,32,-3174.7799999999997,28,4,4043.96,869.1800000000003
27444,U8345,32,19321.409999999993,19,13,321263.87,340585.27999999997
27445,U43285,32,-43313.76,16,16,177924.34,134610.58
27446,U1183218,32,255.95000000000087,16,16,10905.66,11161.61
27447,U8515,32,798.0199999999968,17,15,71494.20999999999,72292.22999999998
27448,U20530,32,31580.529999999995,19,13,4122.97,35703.49999999999
27449,U30387,32,296.81999999999607,26,6,64652.54,64949.36
27450,U12763,32,-57370.12,20,12,120802.3,63432.18
27451,U29570,32,-4081.0699999999997,22,10,37872.280000000006,33791.21000000001
27452,U1188977,32,2346.16,19,13,19556.310000000005,21902.470000000005
27453,U8111,32,-4725.539999999997,23,9,42608.69,37883.15000000001
27454,U34947,32,574.1299999999965,15,17,266465.94,267040.07
27455,U39234,32,-4957.7,24,8,19950.16,14992.46
27456,U975833,32,-0.8100000000001728,18,14,9231.26,9230.45
27457,U30082,32,701.9199999999998,24,8,3856.67,4558.59
27458,U25913,32,-13203.68,25,7,35311.299999999996,22107.619999999995
27459,U33331,32,-276.4500000000007,23,9,22776.34,22499.89
27460,U38887,32,-7487.07,21,11,51918.950000000004,44431.880000000005
27461,U15920,32,-207186.96000000002,18,14,361201.68000000005,154014.72000000003
27462,U663593,32,-6984.74,29,3,12582.960000000001,5598.220000000001
27463,U32870,32,12764.47,21,11,16686.300000000003,29450.770000000004
27464,U20582,32,10956.27,23,9,23216.5,34172.770000000004
27465,U12289,32,20645.34,20,12,122202.23,142847.57
27466,U41416,32,-8230.97,23,9,86496.61,78265.64
27467,U979336,32,-6361.779999999999,14,18,33122.95,26761.17
27468,U24858,32,-1229.1200000000026,20,12,94379.83,93150.70999999999
27469,U26593,32,-13925.53,19,13,90562.69,76637.16
27470,U26730,32,2732.480000000005,16,16,70202.56,72935.04000000001
27471,U32071,32,-63542.41,25,7,161244.08,97701.66999999998
27472,U38359,32,9894.169999999998,15,17,122018.05,131912.22
27473,U983342,32,7.7199999999999935,24,8,228.29,236.01
27474,U33484,32,136907.89000000004,25,7,89467.93999999999,226375.83000000002
27475,U20288,32,9405.410000000002,20,12,66790.69,76196.1
27476,U27083,32,-5752.779999999999,23,9,196286.15,190533.37
27477,U1146947,32,194.5799999999998,23,9,2495.92,2690.5
27478,U10696,32,-484.3,25,7,1355.2099999999998,870.9099999999999
27479,U27219,32,-1006.4300000000001,28,4,6706.529999999999,5700.0999999999985
27480,U40894,32,-8593.019999999997,28,4,9606.579999999996,1013.5599999999995
27481,U14620,32,59345.78999999998,17,15,94709.41,154055.19999999998
27482,U41691,32,-605248.0700000001,26,6,963058.01,357809.93999999994
27483,U43803,32,-2514.250000000001,17,15,89618.14,87103.89
27484,U19073,32,-78264.29999999999,26,6,89837.43,11573.130000000005
27485,U1013375,32,-3223.22,27,5,5826.5,2603.28
27486,U32997,32,-3169.9299999999967,23,9,106987.46,103817.53000000001
27487,U18783,32,-4946.110000000013,19,13,164323.10999999996,159376.99999999994
27488,U17739,32,-1305.01,25,7,20393.819999999996,19088.809999999998
27489,U32612,32,838.079999999999,23,9,18936.920000000002,19775.0
27490,U691395,32,0.0,16,16,20704.82,20704.82
27491,U27728,32,-3035.0200000000013,15,17,137135.64,134100.62000000002
27492,U35583,32,-20662.059999999998,27,5,51273.92,30611.86
27493,U26993,32,-222596.40999999992,12,20,1217708.16,995111.75
27494,U8883,32,6125.230000000001,15,17,26071.68,32196.910000000003
27495,U42256,32,6265.830000000001,23,9,9855.199999999999,16121.029999999999
27496,U20354,32,-43614.590000000004,20,12,99590.79999999999,55976.209999999985
27497,U30152,32,16.989999999998645,27,5,9083.27,9100.259999999998
27498,U39797,32,127151.34000000003,6,26,10328.03,137479.37000000002
27499,U21815,32,34099.98999999999,17,15,210504.55,244604.53999999998
27500,U880858,32,-14688.209999999995,23,9,95251.55,80563.34000000001
27501,U37407,32,623.9300000000418,17,15,936553.96,937177.89
27502,U42674,32,-1930.04,17,15,55801.0,53870.96
27503,U43987,32,6383.05,22,10,62004.4,68387.45
27504,U1173856,32,100.00000000000028,18,14,5057.0,5157.0
27505,U40960,32,-598.9300000000003,24,8,25014.309999999998,24415.379999999997
27506,U40905,32,-150.19999999999936,22,10,30709.099999999995,30558.899999999994
27507,U40241,32,-72666.68000000001,23,9,168753.34000000003,96086.66000000002
27508,U11512,32,-125872.96000000002,20,12,383039.07,257166.11
27509,U31758,32,13806.669999999998,15,17,588231.57,602038.24
27510,U1082407,32,-1.1700000000000728,16,16,4001.2,4000.0299999999997
27511,U33978,32,-9274.91,22,10,23307.54,14032.630000000001
27512,U15096,32,-3013.4799999999996,25,7,13237.52,10224.04
27513,U10266,32,-277.59999999996506,16,16,325133.85,324856.25
27514,U23131,32,2127.5700000000033,25,7,54255.1,56382.67
27515,U12900,32,15087.569999999996,20,12,11587.77,26675.339999999997
27516,U23287,32,931.6999999999971,24,8,29822.84,30754.539999999997
27517,U28895,32,-2522.390000000005,23,9,91007.37999999999,88484.98999999999
27518,U32076,32,15187.459999999994,22,10,53350.560000000005,68538.02
27519,U28659,32,9337.070000000007,25,7,15158.959999999995,24496.030000000002
27520,U15481,32,-89816.85999999999,24,8,170557.41999999995,80740.55999999997
27521,U40604,32,-20927.17000000001,27,5,48689.909999999974,27762.739999999965
27522,U13293,32,-138780.34,12,20,278648.0,139867.66
27523,U21631,32,702630.8400000001,18,14,556237.0,1258867.84
27524,U22298,32,-20820.12,25,7,41601.36,20781.24
27525,U40004,32,-411.08000000000084,22,10,21350.499999999996,20939.419999999995
27526,U20113,32,-3690.3199999999997,28,4,8491.4,4801.08
27527,U37303,32,-2877.9,29,3,3578.46,700.56
27528,U31770,32,-53021.98,26,6,64169.82,11147.839999999997
27529,U22088,32,7274.919999999998,23,9,26249.700000000004,33524.62
27530,U16909,32,454.4099999999987,26,6,18783.819999999996,19238.229999999996
27531,U19091,32,1822.25,22,10,9511.0,11333.25
27532,U16920,32,441.95999999999833,23,9,105503.8,105945.76
27533,U31192,32,-2544.1199999999762,20,12,672276.07,669731.95
27534,U15032,32,34688.6,21,11,65531.43,100220.03
27535,U31026,32,11764.800000000003,14,18,103465.0,115229.8
27536,U9438,32,-12434.07999999999,17,15,178775.94,166341.86000000002
27537,U577439,32,-13382.729999999998,29,3,16832.739999999998,3450.01
27538,U10455,32,-775.9400000000005,14,18,59480.0,58704.06
27539,U28350,32,-25720.86,20,12,133785.6,108064.74
27540,U27609,32,-7921.29,28,4,26186.579999999998,18265.289999999997
27541,U24403,32,1243.5999999999985,20,12,214017.5,215261.1
27542,U18278,32,-8767.320000000002,23,9,10380.110000000002,1612.7900000000009
27543,U32188,32,-2039.180000000001,30,2,24592.18,22553.0
27544,U33895,32,-2542.999999999999,24,8,15803.63,13260.630000000001
27545,U13901,32,16328.910000000009,21,11,242845.80000000002,259174.71000000002
27546,U43403,32,-35859.340000000004,26,6,59572.96,23713.619999999995
27547,U8127,32,-308.6399999999999,23,9,5151.78,4843.139999999999
27548,U35614,32,-8072.76,18,14,29087.58,21014.82
27549,U41390,32,-25774.670000000002,26,6,36591.049999999996,10816.379999999994
27550,U42089,32,-76587.76000000001,28,4,99382.3,22794.539999999994
27551,U34505,32,2496.8199999999947,21,11,203489.91,205986.73
27552,U34336,32,-34399.909999999996,27,5,93464.43,59064.52
27553,U23959,32,-2979.929999999966,10,22,309591.18,306611.25
27554,U19298,32,-2285.1000000000004,22,10,22889.94,20604.839999999997
27555,U20107,32,3279.7600000000016,17,15,43129.33,46409.090000000004
27556,U27094,32,74895.59,25,7,74348.85999999999,149244.44999999998
27557,U1178315,32,-28923.0,22,10,39660.61,10737.61
27558,U20493,32,5176.509999999998,19,13,35098.16,40274.67
27559,U43380,32,1462.7900000000093,23,9,225191.06,226653.85
27560,U32131,32,-543388.39,22,10,595565.05,52176.66000000003
27561,U31775,32,-2062.7200000000116,21,11,330750.64,328687.92
27562,U12227,32,-3609.4400000000005,25,7,24902.6,21293.159999999996
27563,U8949,32,7305.560000000001,26,6,6108.469999999999,13414.03
27564,U40786,32,-5167.8399999999965,17,15,179093.38,173925.54
27565,U35612,32,-208719.69999999998,18,14,471536.61999999994,262816.9199999999
27566,U31010,32,-172.72000000000003,22,10,3409.200000000001,3236.4800000000014
27567,U28174,32,-8584.300000000005,26,6,218598.0,210013.69999999998
27568,U1213343,32,1950.21,17,15,3879.5600000000004,5829.77
27569,U28048,32,-1948.5899999999992,25,7,18158.21,16209.619999999999
27570,U11097,32,32089.759999999987,21,11,53995.69,86085.44999999998
27571,U958499,32,-1207.0599999999995,26,6,7807.07,6600.01
27572,U39323,32,152511.44000000003,16,16,70745.35,223256.79000000004
27573,U25174,32,3881.2000000000007,22,10,16718.05,20599.25
27574,U25153,32,6742.889999999999,28,4,11360.550000000001,18103.440000000002
27575,U19278,32,22302.160000000003,18,14,205350.0,227652.16
27576,U19000,32,-126.0799999999972,25,7,16467.280000000002,16341.200000000004
27577,U11221,32,-38446.46,18,14,105653.18,67206.72
27578,U39889,32,1437.8799999999987,26,6,16808.28,18246.159999999996
27579,U20727,32,-21470.019999999997,25,7,43331.06,21861.04
27580,U23215,32,-5617.51999999996,20,12,493000.0,487382.48000000004
27581,U35117,32,-20878.560000000005,15,17,120774.4,99895.84
27582,U37044,32,-10971.699999999999,24,8,31916.199999999997,20944.5
27583,U25169,32,-47737.67999999998,23,9,291551.39999999997,243813.71999999997
27584,U40060,32,-71575.20999999999,24,8,116839.6,45264.390000000014
27585,U29993,32,11568.500000000002,26,6,78600.6,90169.1
27586,U29868,32,17317.94,16,16,73854.82999999999,91172.76999999999
27587,U23300,32,162406.61999999997,21,11,252250.32,414656.93999999994
27588,U23881,32,5667.020000000004,25,7,20483.6,26150.620000000003
27589,U18847,32,-18235.58,18,14,43161.65,24926.07
27590,U13668,32,-37603.119999999995,26,6,41735.07,4131.950000000004
27591,U12924,32,-6379.800000000001,21,11,67807.20999999999,61427.40999999999
27592,U1321036,32,-1308.4500000000003,25,7,4403.47,3095.02
27593,U23166,32,6491.33,25,7,24789.8,31281.129999999997
27594,U38731,32,-45664.06000000003,19,13,814218.26,768554.2
27595,U43712,32,-16336.39,7,25,54263.4,37927.01
27596,U19205,32,-64782.490000000005,29,3,90368.79000000001,25586.300000000003
27597,U38081,32,-42071.060000000005,23,9,76516.25,34445.189999999995
27598,U38374,32,-2341.7400000000002,29,3,6260.91,3919.1699999999996
27599,U28517,32,5037.16,19,13,26516.609999999997,31553.769999999997
27600,U29921,32,6099.6900000000005,26,6,37336.81000000001,43436.500000000015
27601,U9806,32,-599.9299999999993,23,9,39993.51000000001,39393.58000000001
27602,U25845,32,-5446.710000000003,27,5,43806.12,38359.41
27603,U38362,32,-2768.5800000000004,21,11,16992.27,14223.69
27604,U19950,32,12986.01999999999,18,14,128891.8,141877.82
27605,U960063,32,644.5900000000004,26,6,19425.939999999995,20070.529999999995
27606,U30079,32,674.569999999999,23,9,19070.870000000003,19745.440000000002
27607,U26759,32,3872.110000000006,25,7,55859.399999999994,59731.51
27608,U31546,32,16950.909999999993,13,19,3550696.2800000003,3567647.1900000004
27609,U21595,32,3319.8500000000013,22,10,43130.69,46450.54
27610,U38346,32,11548.42,26,6,21340.119999999995,32888.53999999999
27611,U984017,32,-589.1400000000003,22,10,8917.210000000001,8328.07
27612,U38190,32,-4280.8600000000015,26,6,45146.31,40865.45
27613,U10314,32,-20112.310000000012,24,8,62682.33,42570.01999999999
27614,U14264,32,-43212.81,22,10,132679.97999999998,89467.16999999998
27615,U15537,32,77820.29,20,12,378757.06,456577.35
27616,U42944,32,-89872.10999999999,18,14,385214.93999999994,295342.82999999996
27617,U35534,32,1479.7099999999982,22,10,45079.63,46559.34
27618,U9254,32,31190.399999999987,18,14,549029.9400000001,580220.3400000001
27619,U880115,32,-704.1700000000003,25,7,4256.41,3552.24
27620,U30159,32,-3760.49,22,10,35450.119999999995,31689.629999999997
27621,U43632,32,4041.3500000000013,24,8,7597.359999999999,11638.71
27622,U22690,32,-2132.8,27,5,3900.84,1768.04
27623,U43133,32,12400.400000000001,25,7,4924.19,17324.59
27624,U35074,32,-1781.1100000000008,28,4,16385.17,14604.059999999998
27625,U35309,32,-7271.07,26,6,24757.66,17486.59
27626,U14191,32,-1388.84,29,3,3789.9,2401.0600000000004
27627,U19746,32,97683.21999999999,24,8,63562.18,161245.4
27628,U968163,32,-855.1500000000001,30,2,855.1700000000001,0.01999999999998181
27629,U19618,32,-12752.36,24,8,34487.0,21734.64
27630,U23649,32,-9846.95,25,7,90828.93,80981.98
27631,U612366,32,-30110.66,20,12,30136.72,26.06000000000131
27632,U35451,32,-1117.3599999999992,24,8,17613.15,16495.79
27633,U37053,32,8994.7,16,16,108191.18,117185.87999999999
27634,U26099,32,148814.35,16,16,161604.04,310418.39
27635,U15598,32,-2672.9000000000015,21,11,91632.90000000002,88960.00000000003
27636,U1125483,32,1.879999999999967,16,16,669.22,671.1
27637,U13305,32,8404.610000000008,22,10,71563.46,79968.07
27638,U41870,32,-160376.37000000002,19,13,415657.84,255281.47
27639,U13126,32,-5569.229999999974,23,9,410891.66,405322.43
27640,U34613,32,-5372.839999999999,25,7,6043.239999999999,670.3999999999996
27641,U43858,32,-13529.250000000004,27,5,24356.640000000003,10827.39
27642,U39350,32,-18583.99,11,21,345834.0,327250.01
27643,U23422,32,4240.0,17,15,172760.0,177000.0
27644,U37144,32,-34.25999999999976,26,6,5578.27,5544.01
27645,U27786,32,38.60000000000001,23,9,17428.10000000001,17466.700000000008
27646,U15640,32,49435.80000000003,23,9,416348.0,465783.80000000005
27647,U21774,32,-15271.870000000004,17,15,96548.62,81276.74999999999
27648,U21950,32,331.1299999999934,24,8,134390.63,134721.76
27649,U41484,32,-272.95000000000255,28,4,23869.61,23596.659999999996
27650,U39954,32,126501.5700000003,17,15,14656870.1,14783371.67
27651,U11366,32,478.0700000000015,20,12,18225.86,18703.93
27652,U39702,32,-185176.75999999995,12,20,316921.03,131744.27000000008
27653,U29276,32,-7656.739999999997,21,11,40136.76,32480.020000000004
27654,U800182,32,-1309.4000000000015,17,15,30574.369999999995,29264.969999999994
27655,U15015,32,91166.19999999998,15,17,158606.33,249772.52999999997
27656,U27108,32,193591.2,23,9,46079.95,239671.15000000002
27657,U19798,32,-3429.1200000000076,22,10,60140.03999999999,56710.919999999984
27658,U38689,32,710.8499999999999,30,2,2888.5499999999997,3599.3999999999996
27659,U37894,32,-6601.6500000000115,24,8,91009.84,84408.18999999999
27660,U40112,32,-2847.8100000000004,24,8,40627.89,37780.08
27661,U26634,32,-4021.51,18,14,34640.64,30619.129999999997
27662,U10291,31,3524.3900000000044,21,10,237353.53999999998,240877.93
27663,U972506,31,-1134.6100000000001,23,8,8280.57,7145.959999999999
27664,U21040,31,11525.409999999998,20,11,75613.37,87138.78
27665,U22207,31,-7303.369999999998,25,6,46362.49,39059.12
27666,U19742,31,-19314.489999999994,23,8,199777.31999999998,180462.83
27667,U1115690,31,-970.6699999999997,27,4,8245.939999999999,7275.269999999999
27668,U22505,31,-66574.47000000004,21,10,659949.7200000001,593375.25
27669,U19685,31,-5057.28,27,4,11554.32,6497.04
27670,U35546,31,534.3800000000019,21,10,38791.329999999994,39325.71
27671,U36320,31,21874.929999999993,14,17,289833.9,311708.83
27672,U15307,31,1971.7000000000003,22,9,17647.55,19619.25
27673,U23968,31,440.01000000000295,13,18,470985.0,471425.01
27674,U15866,31,-3464.2999999999993,22,9,20535.61,17071.31
27675,U27512,31,9.509999999991859,19,12,218844.92,218854.43
27676,U43190,31,-17471.33,27,4,23893.23999999999,6421.909999999989
27677,U20024,31,-286942.18,21,10,465449.27,178507.09000000003
27678,U38357,31,-10319.149999999994,13,18,191212.05,180892.9
27679,U26589,31,-3467.119999999996,20,11,81766.40999999999,78299.29
27680,U31282,31,14851.119999999997,22,9,49125.4,63976.52
27681,U33008,31,-57.85000000000127,15,16,71778.51999999999,71720.66999999998
27682,U35980,31,-128735.25,20,11,199368.91,70633.66
27683,U1009153,31,-491.28999999999996,20,11,7251.11,6759.82
27684,U25979,31,-19654.640000000043,20,11,840019.6799999999,820365.0399999999
27685,U706211,31,-5175.660000000001,21,10,14839.94,9664.279999999999
27686,U29558,31,1022.4200000000001,25,6,5977.96,7000.38
27687,U18585,31,-5408.27,22,9,11894.63,6486.359999999999
27688,U26004,31,3.969999999999345,19,12,10217.53,10221.5
27689,U43560,31,-4933.019999999997,16,15,30422.300000000003,25489.280000000006
27690,U13680,31,577926.5999999999,15,16,1211305.94,1789232.5399999998
27691,U8283,31,2123.4200000000005,15,16,38678.49,40801.909999999996
27692,U43138,31,5189.170000000003,18,13,30581.82,35770.990000000005
27693,U24766,31,79908.40999999999,18,13,60187.549999999996,140095.96
27694,U30780,31,76092.28,24,7,154278.85,230371.13
27695,U25171,31,2195.41,28,3,14210.93,16406.34
27696,U29543,31,-12699.819999999998,13,18,57192.24,44492.42
27697,U17870,31,16605.730000000003,22,9,16869.579999999998,33475.31
27698,U37657,31,-595383.18,23,8,627638.8,32255.619999999995
27699,U27866,31,-2976.5200000000004,21,10,11102.36,8125.84
27700,U31177,31,-219.72999999999996,16,15,78067.41,77847.68000000001
27701,U24444,31,17.520000000000437,13,18,34665.55,34683.07000000001
27702,U27972,31,-13407.400000000001,21,10,137507.4,124100.0
27703,U22517,31,8075.130000000002,19,12,116913.56,124988.69
27704,U29523,31,33792.30999999999,24,7,107611.12999999999,141403.43999999997
27705,U10129,31,-36942.149999999994,12,19,413000.0,376057.85
27706,U35125,31,-561.58,24,7,1696.24,1134.6599999999999
27707,U42802,31,19916.679999999997,22,9,11310.810000000001,31227.489999999998
27708,U35741,31,3720.5099999999998,22,9,60961.49,64682.0
27709,U23615,31,15697.11,17,14,85320.9,101018.01
27710,U783282,31,-10290.619999999999,25,6,27280.640000000007,16990.020000000008
27711,U9786,31,-215288.36,24,7,1724558.82,1509270.46
27712,U27518,31,-479.330000000009,16,15,235745.36,235266.02999999997
27713,U39351,31,230464.08000000002,12,19,200477.02999999997,430941.11
27714,U41864,31,-760.1199999999999,25,6,7360.0199999999995,6599.9
27715,U9022,31,-1864.8100000000013,24,7,32632.94,30768.129999999997
27716,U26395,31,8711.900000000001,22,9,11790.78,20502.68
27717,U39250,31,5551.5900000000165,13,18,599250.87,604802.46
27718,U38477,31,526.8200000000008,20,11,14853.279999999999,15380.1
27719,U36412,31,202776.07000000007,12,19,345366.0,548142.0700000001
27720,U899139,31,0.010000000000227374,15,16,15844.01,15844.02
27721,U40705,31,-20436.44,28,3,20923.42,486.97999999999956
27722,U34859,31,4549.5199999999995,15,16,23984.47,28533.99
27723,U38248,31,-2687.1900000000005,25,6,7138.290000000001,4451.1
27724,U19041,31,-1416.1299999999983,23,8,27881.920000000002,26465.790000000005
27725,U942775,31,-2556.95,20,11,6882.47,4325.52
27726,U25757,31,2157.1199999999994,24,7,9383.91,11541.029999999999
27727,U11761,31,-12419.850000000002,18,13,127309.36,114889.51
27728,U720798,31,-574.62,16,15,19067.47,18492.850000000002
27729,U23742,31,-7315.279999999991,20,11,100133.43999999999,92818.16
27730,U30590,31,-4284.139999999968,9,22,1093000.0,1088715.86
27731,U28564,31,-9414.529999999999,24,7,58495.78,49081.25
27732,U35901,31,413120.54000000004,8,23,1714800.0,2127920.54
27733,U12823,31,11679.690000000006,16,15,40331.09,52010.78
27734,U16074,31,-13634.100000000006,18,13,106505.46,92871.36
27735,U33438,31,613.8299999999963,24,7,62913.72,63527.549999999996
27736,U38768,31,-34852.049999999996,7,24,89552.98,54700.93
27737,U17222,31,195117.98000000004,20,11,43311.06000000001,238429.04000000004
27738,U28446,31,-303453.4199999999,16,15,2549786.0700000003,2246332.6500000004
27739,U43907,31,125921.13,11,20,183959.05000000002,309880.18000000005
27740,U25843,31,17.910000000000224,28,3,8480.98,8498.89
27741,U31183,31,9346.550000000003,19,12,62898.39,72244.94
27742,U1350689,31,-3.4799999999995634,17,14,26170.079999999998,26166.6
27743,U24071,31,-1437.5700000000027,26,5,28087.859999999997,26650.289999999994
27744,U36354,31,1462.9099999999999,22,9,9889.99,11352.9
27745,U33532,31,1189.9199999999998,26,5,7152.53,8342.449999999999
27746,U13725,31,1466.3700000000003,16,15,11765.48,13231.85
27747,U657766,31,-197.32,18,13,2144.9300000000003,1947.6100000000004
27748,U19471,31,-9140.279999999999,29,2,9691.98,551.7000000000007
27749,U41550,31,-5289.580000000002,26,5,32561.620000000003,27272.04
27750,U11438,31,1424.4699999999998,18,13,7729.3099999999995,9153.779999999999
27751,U33621,31,365.44999999999993,22,9,2670.49,3035.9399999999996
27752,U1245890,31,-13255.970000000001,29,2,13256.470000000001,0.5
27753,U24417,31,-168.95000000000005,16,15,4644.0,4475.05
27754,U41737,31,-63441.43,21,10,482239.16000000003,418797.73000000004
27755,U28733,31,13432.529999999997,23,8,1803.55,15236.079999999996
27756,U29112,31,24218.67999999999,19,12,551530.2000000001,575748.88
27757,U16190,31,55723.15000000002,23,8,753197.8,808920.9500000001
27758,U8672,31,257688.83,23,8,43594.93,301283.76
27759,U25166,31,5369.38,21,10,4551.67,9921.05
27760,U30064,31,-4168.280000000002,19,12,72268.14,68099.86
27761,U42646,31,1487.4200000000005,24,7,8545.980000000001,10033.400000000001
27762,U24980,31,4853.590000000015,16,15,227690.59,232544.18000000002
27763,U1349229,31,-109.50999999999993,24,7,744.53,635.02
27764,U21345,31,-43717.07,23,8,261595.23999999996,217878.16999999995
27765,U37639,31,476.9100000000004,17,14,6111.449999999999,6588.36
27766,U19304,31,7810.730000000003,27,4,106852.15,114662.88
27767,U27930,31,15110.07,19,12,39467.93,54578.0
27768,U39075,31,-1460.96,17,14,10215.4,8754.439999999999
27769,U42959,31,-508602.66,23,8,586935.3,78332.64000000007
27770,U9523,31,-413252.7799999999,19,12,1387781.7,974528.92
27771,U20340,31,-5282.790000000004,11,20,102491.5,97208.70999999999
27772,U17974,31,-110464.82,20,11,521866.48,411401.66
27773,U31220,31,-2756.0599999999995,26,5,6747.200000000001,3991.1400000000012
27774,U39396,31,5108.880000000025,6,25,246650.89,251759.77000000005
27775,U22750,31,-107310.98000000001,23,8,278969.68,171658.69999999998
27776,U38540,31,-31668.910000000003,20,11,405326.54000000004,373657.63
27777,U40220,31,39603.02000000039,8,23,4379723.61,4419326.630000001
27778,U42429,31,80686.97,20,11,144465.5,225152.47
27779,U39091,31,-10663.300000000001,20,11,54388.20000000001,43724.90000000001
27780,U10851,31,9483.80999999997,20,11,786985.84,796469.6499999999
27781,U22885,31,6619.999999999978,16,15,351208.56999999995,357828.56999999995
27782,U33322,31,702.9800000000002,25,6,6266.910000000001,6969.890000000001
27783,U41751,31,-46656.630000000005,21,10,54031.57,7374.939999999995
27784,U28882,31,409.43000000000245,25,6,9937.68,10347.110000000002
27785,U30545,31,873.1100000000006,20,11,14106.01,14979.12
27786,U11106,31,-4690.329999999998,22,9,39125.17,34434.84
27787,U716909,31,-10628.320000000007,23,8,96761.23,86132.90999999999
27788,U31837,31,-5453.34,21,10,57184.380000000005,51731.04000000001
27789,U22954,31,-19458.9,26,5,26482.639999999996,7023.739999999994
27790,U39479,31,-312393.92,22,9,417855.06,105461.14000000001
27791,U39612,31,-1026.8199999999997,25,6,14195.33,13168.51
27792,U37972,31,3520.7599999999998,25,6,7997.23,11517.99
27793,U10952,31,4997.359999999995,15,16,197568.26,202565.62
27794,U36059,31,7541.350000000001,21,10,38434.549999999996,45975.899999999994
27795,U43690,31,21952.76,8,23,58116.0,80068.76
27796,U19153,31,59398.350000000006,28,3,621.58,60019.93000000001
27797,U14052,31,-247561.93,19,12,316785.24999999994,69223.31999999995
27798,U27081,31,-1142.2899999999988,21,10,23257.93,22115.640000000003
27799,U22408,31,8993.71,17,14,67603.28,76596.98999999999
27800,U11782,31,-7361.639999999985,10,21,1210524.13,1203162.49
27801,U33833,31,-149425.85,17,14,246364.0,96938.15
27802,U43941,31,761.4799999999996,24,7,30291.66,31053.14
27803,U10847,31,-6945.9699999999975,19,12,57806.5,50860.53
27804,U34537,31,-6363.229999999981,22,9,1386238.1600000001,1379874.9300000002
27805,U20852,31,261079.22999999998,20,11,154039.59,415118.81999999995
27806,U8356,31,3400.8900000000003,25,6,28931.61,32332.5
27807,U21526,31,20350.440000000002,18,13,111963.15,132313.59
27808,U25126,31,-1505.48,24,7,30186.710000000003,28681.230000000003
27809,U33674,31,3450.3599999999997,23,8,15051.85,18502.21
27810,U637534,31,-430.65999999999804,25,6,45932.170000000006,45501.51000000001
27811,U26023,31,70215.34,13,18,15988.0,86203.34
27812,U18752,31,47858.61,20,11,16746.600000000002,64605.21000000001
27813,U19517,31,5005.570000000007,19,12,107931.97,112937.54000000001
27814,U31560,31,12000.0,15,16,169119.12,181119.12
27815,U35926,31,1083.3899999999994,20,11,113086.98,114170.37
27816,U1083987,31,-799.2600000000002,27,4,10959.259999999998,10159.999999999998
27817,U29114,31,-23.139999999999418,18,13,57285.89,57262.75
27818,U15605,31,2760.0,20,11,4112.64,6872.64
27819,U36103,31,2021.2499999999995,22,9,8611.94,10633.19
27820,U34425,31,17313.05,23,8,156257.43999999997,173570.48999999996
27821,U14773,31,-20212.85,22,9,41687.15,21474.300000000003
27822,U39239,31,-41989.03999999998,22,9,226902.0,184912.96000000002
27823,U37964,31,-3911.8400000000183,12,19,534466.19,530554.35
27824,U1235615,31,-52.0,19,12,15653.0,15601.0
27825,U29840,31,-4765.729999999996,17,14,425361.87,420596.14
27826,U21188,31,-8013.470000000001,14,17,69211.2,61197.729999999996
27827,U982327,31,-7900.430000000001,25,6,9273.32,1372.8899999999985
27828,U32178,31,284957.97,18,13,433905.39,718863.36
27829,U20996,31,-2751.250000000012,18,13,160119.68,157368.43
27830,U25393,31,-2000.71,23,8,4690.740000000001,2690.0300000000007
27831,U626428,31,1.0200000000001523,26,5,7861.69,7862.71
27832,U8032,31,-13167.62,24,7,41464.45,28296.829999999994
27833,U670783,31,575.0700000000004,21,10,4762.46,5337.530000000001
27834,U26739,31,-896.1699999999998,26,5,7836.03,6939.86
27835,U39152,31,13696.110000000004,20,11,204217.32,217913.43000000002
27836,U41414,31,29163.549999999996,21,10,42803.49,71967.04
27837,U17940,31,-363.3199999999997,24,7,3716.6800000000003,3353.3600000000006
27838,U8987,31,-8521.889999999989,24,7,1018537.3400000001,1010015.4500000001
27839,U12169,31,25749.87,11,20,13337.949999999999,39087.82
27840,U10100,31,223.89999999999964,18,13,17345.0,17568.9
27841,U26558,31,2248.9,20,11,24371.77,26620.670000000002
27842,U36169,31,-303557.55999999994,22,9,313410.8,9853.240000000049
27843,U16087,31,70.77999999998428,15,16,584088.0,584158.78
27844,U1357328,31,-4677.07,24,7,22027.67,17350.6
27845,U897682,31,8680.25,17,14,19712.29,28392.54
27846,U28512,31,2392.6600000000008,19,12,38384.52,40777.18
27847,U36623,31,-32944.8,22,9,111720.22999999998,78775.42999999998
27848,U21502,31,-285.92000000001167,23,8,172142.55000000002,171856.63
27849,U16713,31,15095.960000000001,20,11,16178.78,31274.74
27850,U35246,31,-7082.159999999996,16,15,495237.0,488154.84
27851,U22212,31,-8754.900000000001,28,3,11702.940000000002,2948.040000000001
27852,U32011,31,-3818.850000000023,25,6,905354.47,901535.62
27853,U39415,31,133850.32,16,15,121448.0,255298.32
27854,U19033,31,-1766.0999999999985,15,16,78490.48000000001,76724.38
27855,U40120,31,16528.78,22,9,26300.9,42829.68
27856,U25410,31,-22763.25,28,3,30691.38,7928.130000000001
27857,U43332,31,29013.679999999993,20,11,230110.5,259124.18
27858,U8563,31,994.619999999999,21,10,22410.81,23405.43
27859,U577403,31,1258.3299999999995,20,11,14823.669999999998,16081.999999999998
27860,U31572,31,-90897.53000000001,24,7,153374.61000000004,62477.08000000003
27861,U29470,31,93.21999999999954,25,6,6461.659999999999,6554.879999999998
27862,U1101817,31,628.8400000000001,18,13,11254.21,11883.05
27863,U9130,31,-4555.45,29,2,4859.53,304.0799999999999
27864,U22390,31,-184.80999999999995,24,7,3433.71,3248.9
27865,U24167,31,10037.15,20,11,36905.0,46942.15
27866,U591104,31,13.889999999999816,17,14,3908.78,3922.67
27867,U34748,31,-10992.099999999999,23,8,21038.34,10046.240000000002
27868,U40244,31,-2280.829999999998,15,16,100802.76000000001,98521.93000000001
27869,U38506,31,-3484.0599999999954,18,13,82638.89,79154.83
27870,U8192,31,-395.04999999999995,23,8,14493.640000000003,14098.590000000004
27871,U1120438,31,-6727.910000000001,20,11,13252.16,6524.249999999999
27872,U1380807,31,-25260.030000000002,19,12,66009.45999999999,40749.42999999999
27873,U14135,31,-4006.700000000005,21,10,129698.53000000001,125691.83
27874,U14448,31,-44706.65,27,4,44949.560000000005,242.9100000000035
27875,U28020,31,-262155.26999999996,15,16,854850.5499999999,592695.28
27876,U26881,31,32209.3,4,27,30001.0,62210.3
27877,U16254,31,-1785.0400000000004,19,12,22337.01,20551.969999999998
27878,U18964,31,-716.9200000000003,25,6,3095.2900000000004,2378.37
27879,U37837,31,1186.849999999975,16,15,650510.93,651697.78
27880,U36437,31,-76368.61,24,7,111088.0,34719.39
27881,U26765,31,79761.87000000001,21,10,35163.9,114925.77000000002
27882,U31172,31,-2193.210000000063,14,17,735443.12,733249.9099999999
27883,U23520,31,-61869.45000000001,23,8,194340.36000000002,132470.91
27884,U779392,31,-1119.5300000000002,19,12,12926.86,11807.33
27885,U13847,31,-664014.1199999999,23,8,671385.94,7371.820000000065
27886,U18542,31,139.3999999999999,21,10,3875.09,4014.4900000000002
27887,U30759,31,19996.059999999998,14,17,86150.04,106146.09999999999
27888,U706100,31,-7289.0599999999995,24,7,9291.060000000001,2002.0000000000018
27889,U35073,31,31695.210000000006,12,19,38538.49,70233.70000000001
27890,U41634,31,-8005.93,20,11,49863.8,41857.87
27891,U24354,31,-4065.689999999973,14,17,964686.0,960620.31
27892,U20161,31,3273.650000000005,20,11,106658.38,109932.03000000001
27893,U23519,31,-95581.13,19,12,121962.92000000001,26381.790000000008
27894,U26800,31,-8049.440000000002,27,4,18038.660000000003,9989.220000000001
27895,U1087621,31,-3644.500000000001,25,6,5638.009999999999,1993.5099999999984
27896,U11921,31,5027.23,19,12,8105.5599999999995,13132.789999999999
27897,U28920,31,-1102.1299999999983,14,17,36397.11,35294.98
27898,U11435,31,-3505.2499999999995,24,7,23548.259999999995,20043.009999999995
27899,U25235,31,-22465.65,25,6,29569.050000000003,7103.4000000000015
27900,U16560,31,-3940.149999999999,21,10,10554.029999999999,6613.879999999999
27901,U22570,31,8.640000000000361,23,8,18743.209999999995,18751.849999999995
27902,U36590,31,-1110.9100000000035,19,12,60300.35,59189.439999999995
27903,U26378,31,-0.7700000000004366,16,15,25575.940000000002,25575.170000000002
27904,U37344,31,4212.51,25,6,9435.769999999999,13648.279999999999
27905,U41792,31,-32374.799999999967,16,15,911893.1999999998,879518.3999999999
27906,U32576,31,1401.8500000000004,22,9,5319.18,6721.030000000001
27907,U33154,31,3965.560000000005,15,16,126263.26999999999,130228.82999999999
27908,U983562,31,-26032.880000000005,30,1,26032.910000000003,0.029999999998835847
27909,U12761,31,3249.4299999999994,29,2,2750.57,6000.0
27910,U679058,31,-171.7800000000002,22,9,8957.95,8786.17
27911,U28684,31,5524.81,14,17,31189.86,36714.67
27912,U38713,31,-3470.7499999999854,22,9,254985.22999999998,251514.47999999998
27913,U35712,31,-369.43000000000006,27,4,1397.54,1028.11
27914,U714274,31,-1308.3599999999994,17,14,8403.68,7095.320000000001
27915,U27979,31,77062.54999999999,16,15,64970.4,142032.94999999998
27916,U42906,31,-3378.1099999999997,24,7,36817.47,33439.36
27917,U12266,31,-36.899999999999565,20,11,66427.94999999998,66391.04999999999
27918,U1079923,31,-4748.0,22,9,13613.28,8865.28
27919,U32799,31,-97284.12,27,4,138324.6,41040.48000000001
27920,U37075,31,-1974.1399999999994,24,7,16789.23,14815.09
27921,U31051,31,85959.65999999997,20,11,234927.75999999998,320887.4199999999
27922,U10376,31,19248.279999999984,21,10,622951.87,642200.15
27923,U26827,31,-201939.74000000002,23,8,202665.27000000005,725.5300000000279
27924,U8852,31,-65397.83,24,7,72489.86,7092.029999999999
27925,U865212,31,26593.33,19,12,45464.0,72057.33
27926,U20139,31,12618.150000000001,19,12,61251.369999999995,73869.51999999999
27927,U42304,31,403293.56,9,22,35145.0,438438.56
27928,U20184,31,-7914.67,20,11,29681.9,21767.230000000003
27929,U31152,31,-265.7399999999903,13,18,98439.44,98173.70000000001
27930,U23446,31,1685.8600000000029,19,12,210723.0,212408.86000000002
27931,U8151,31,-1619.280000000006,18,13,139700.65,138081.37
27932,U18355,31,140837.48,12,19,52758.96000000001,193596.44
27933,U37874,31,-897.96,24,7,20209.46,19311.5
27934,U24970,31,-174.44999999999948,18,13,23212.899999999998,23038.449999999997
27935,U36100,31,-26379.870000000003,25,6,56944.18,30564.309999999998
27936,U16141,31,-50148.57,20,11,84051.40999999999,33902.83999999999
27937,U32117,31,31.12999999999994,25,6,689.3099999999998,720.4399999999998
27938,U31884,31,-3191.0700000000006,25,6,8198.85,5007.78
27939,U32743,31,128727.76999999999,24,7,30293.88,159021.65
27940,U42265,31,-300.8999999999997,22,9,1894.5699999999997,1593.67
27941,U33989,31,6603.42,19,12,63519.52999999999,70122.95
27942,U15602,31,853.0499999999979,20,11,10253.9,11106.949999999997
27943,U43976,31,308.14,24,7,1728.8399999999997,2036.9799999999996
27944,U27521,31,-6041.52,23,8,14934.34,8892.82
27945,U41697,31,-18248.289999999804,20,11,4860074.84,4841826.55
27946,U27444,31,3215.380000000001,26,5,16207.9,19423.28
27947,U27764,31,6472.550000000003,18,13,65856.07999999999,72328.62999999999
27948,U18485,31,4767.34,27,4,5960.9,10728.24
27949,U32622,31,5949.649999999994,17,14,406416.61,412366.26
27950,U39862,31,-14976.310000000003,29,2,40414.810000000005,25438.5
27951,U27157,31,-5279.869999999998,23,8,33117.83,27837.960000000003
27952,U39342,31,11337.389999999996,25,6,26073.9,37411.28999999999
27953,U29131,31,28955.36000000004,9,22,829014.74,857970.1
27954,U25353,31,843.530000000007,21,10,49338.79,50182.32000000001
27955,U967765,31,-5488.869999999999,24,7,9202.409999999998,3713.539999999999
27956,U30270,31,-99680.83,25,6,127190.88,27510.050000000003
27957,U43272,31,-8657.67,18,13,76477.15,67819.48
27958,U33928,31,-1174.4299999999987,19,12,84111.69000000002,82937.26000000002
27959,U37206,31,-2703.6100000000006,23,8,16676.480000000003,13972.870000000003
27960,U1280754,31,-607.3899999999996,27,4,13589.9,12982.51
27961,U26669,31,-6080.130000000001,23,8,16404.91,10324.779999999999
27962,U41026,31,174.48999999999978,23,8,5233.6900000000005,5408.18
27963,U10633,31,2985.2,23,8,12528.31,15513.509999999998
27964,U26194,31,-194032.81,23,8,260587.94,66555.13
27965,U18174,30,5352.050000000003,14,16,320408.96,325761.01
27966,U14682,30,-4168.22,21,9,60436.92,56268.7
27967,U14388,30,-1338.8399999999997,19,11,39738.93,38400.090000000004
27968,U22244,30,10.029999999999745,16,14,23027.07,23037.1
27969,U26291,30,-40889.44,24,6,41303.16,413.72000000000116
27970,U18195,30,-3882.25,23,7,11899.93,8017.68
27971,U32800,30,5717.089999999999,16,14,1811.0500000000002,7528.139999999999
27972,U23603,30,7828.600000000002,22,8,86986.12000000002,94814.72000000003
27973,U14939,30,4803.089999999998,24,6,10218.980000000003,15022.070000000002
27974,U27218,30,3613.639999999996,19,11,45969.74999999999,49583.389999999985
27975,U39338,30,-940.5199999999999,21,9,3069.3599999999997,2128.8399999999997
27976,U18504,30,12225.090000000004,22,8,38303.15000000001,50528.24000000001
27977,U22650,30,-2262.7400000000007,21,9,25635.47,23372.73
27978,U41298,30,-8981.199999999999,26,4,10426.900000000001,1445.7000000000025
27979,U43165,30,-28863.649999999994,22,8,406700.0,377836.35
27980,U22334,30,-33852.450000000004,23,7,60036.630000000005,26184.18
27981,U12361,30,-842.5099999999973,25,5,53943.17999999999,53100.67
27982,U43953,30,-152.45000000000073,27,3,3865.3100000000013,3712.8600000000006
27983,U38240,30,4119.860000000001,16,14,16316.0,20435.86
27984,U23440,30,5447.140000000001,20,10,32341.0,37788.14
27985,U35138,30,-1051.6799999999985,18,12,30105.79,29054.11
27986,U40925,30,4769.319999999999,25,5,35896.78,40666.1
27987,U11880,30,2148.2999999999993,17,13,39671.29,41819.59
27988,U746992,30,-1668.7700000000004,18,12,25629.519999999997,23960.749999999996
27989,U694794,30,902.7700000000011,23,7,8858.45,9761.220000000001
27990,U19722,30,-1372.0500000000002,19,11,14938.0,13565.95
27991,U43050,30,600.4400000000005,24,6,12779.58,13380.02
27992,U21938,30,-1411.7500000000014,23,7,42522.799999999996,41111.049999999996
27993,U775271,30,0.6599999999999113,15,15,5897.17,5897.83
27994,U29635,30,1405.77,24,6,5036.12,6441.889999999999
27995,U754700,30,-0.4100000000001387,16,14,10774.01,10773.6
27996,U27778,30,7051.739999999998,12,18,33070.44,40122.18
27997,U25198,30,-880.2799999999968,21,9,23851.039999999997,22970.760000000002
27998,U29101,30,9421.880000000005,17,13,80700.4,90122.28
27999,U1130654,30,-1947.6600000000003,21,9,13099.82,11152.16
28000,U16941,30,5050.5199999999995,22,8,18738.45,23788.97
28001,U927791,30,30.08,14,16,127.67,157.75
28002,U37238,30,-127.28000000000013,19,11,4122.25,3994.97
28003,U37410,30,223572.86999999997,16,14,92638.29000000001,316211.16
28004,U15736,30,-8782.779999999995,23,7,51307.299999999996,42524.520000000004
28005,U11036,30,297.9900000000016,18,12,69583.52,69881.51000000001
28006,U37483,30,-2524.0000000000005,15,15,214670.38999999998,212146.38999999998
28007,U24497,30,18065.469999999998,21,9,70734.10999999999,88799.57999999999
28008,U24033,30,-1029.9700000000012,15,15,115000.0,113970.03
28009,U21470,30,5.9100000000016735,16,14,78388.58,78394.49
28010,U960152,30,-378.90999999999934,16,14,3263.27,2884.3600000000006
28011,U9629,30,-6776.910000000033,18,12,1185405.4,1178628.4899999998
28012,U34145,30,-3284.1000000000495,11,19,858655.0,855370.8999999999
28013,U15553,30,-25705.870000000003,18,12,88166.88,62461.01
28014,U29728,30,0.0,23,7,2154.8499999999995,2154.8499999999995
28015,U1348405,30,-929.2900000000003,26,4,9172.359999999999,8243.069999999998
28016,U32786,30,0.0,12,18,973279.2300000001,973279.2300000001
28017,U1081021,30,-1496.9199999999998,23,7,11292.279999999999,9795.359999999999
28018,U8113,30,73153.15999999999,18,12,45794.0,118947.15999999999
28019,U37687,30,1999.969999999998,20,10,21877.530000000002,23877.5
28020,U9907,30,-2207.3899999999994,22,8,60961.50000000001,58754.11000000001
28021,U9272,30,-7382.809999999995,19,11,111993.29999999997,104610.48999999998
28022,U32901,30,5900.0899999999965,21,9,76316.81999999999,82216.90999999999
28023,U16939,30,-73.37000000000171,20,10,48146.49999999999,48073.12999999999
28024,U9050,30,652.1399999999999,19,11,16321.239999999998,16973.379999999997
28025,U27147,30,971.8500000000058,21,9,82562.8,83534.65000000001
28026,U1311959,30,-9648.38,26,4,16032.400000000001,6384.020000000002
28027,U682755,30,-4428.659999999999,23,7,7800.749999999999,3372.09
28028,U28929,30,142161.83,21,9,81898.3,224060.13
28029,U29133,30,7253.369999999999,11,19,4151.51,11404.88
28030,U29456,30,-13105.2,28,2,13605.24,500.03999999999905
28031,U11549,30,-361.4800000000005,24,6,14923.95,14562.470000000001
28032,U23113,30,990.3199999999979,17,13,58344.42,59334.74
28033,U855536,30,-5217.750000000001,25,5,12910.7,7692.95
28034,U13117,30,-2233.46,18,12,17067.239999999998,14833.779999999999
28035,U9533,30,49810.92999999999,14,16,212175.44,261986.37
28036,U37487,30,24563.850000000002,12,18,34973.07,59536.92
28037,U17519,30,-9970.7,26,4,11577.130000000001,1606.4300000000003
28038,U15337,30,94990.95,17,13,26353.19,121344.14
28039,U32934,30,-743.6900000000032,16,14,99601.44,98857.75
28040,U18411,30,797094.66,27,3,450940.0,1248034.6600000001
28041,U42056,30,-2289.3900000000026,22,8,41211.71000000001,38922.32000000001
28042,U41983,30,-9384.330000000022,24,6,239782.43000000002,230398.1
28043,U10294,30,-9660.740000000009,17,13,580350.87,570690.13
28044,U29301,30,-9258.439999999999,22,8,61731.2,52472.759999999995
28045,U35202,30,8301.350000000006,22,8,257678.93,265980.28
28046,U35796,30,975.1899999999989,23,7,12430.270000000002,13405.460000000001
28047,U29745,30,23562.239999999998,18,12,33477.579999999994,57039.81999999999
28048,U13201,30,17156.19,22,8,108283.62000000001,125439.81000000001
28049,U748582,30,7827.1500000000015,11,19,15575.420000000002,23402.570000000003
28050,U18517,30,-1094168.57,21,9,1146076.99,51908.419999999925
28051,U8094,30,-4998.17,20,10,21991.800000000003,16993.630000000005
28052,U18392,30,-403.22,27,3,2983.75,2580.5299999999997
28053,U21438,30,-19833.219999999998,21,9,140440.0,120606.78
28054,U14333,30,1544.9899999998697,18,12,1579629.0,1581173.9899999998
28055,U11877,30,4144.339999999998,22,8,12199.039999999999,16343.379999999997
28056,U17544,30,-8629.31,25,5,9553.04,923.7300000000014
28057,U15950,30,-524472.39,20,10,891016.14,366543.75
28058,U10983,30,108379.28,22,8,36120.259999999995,144499.53999999998
28059,U1171887,30,390.5600000000013,18,12,13884.939999999999,14275.5
28060,U17168,30,-869.5999999999985,20,10,71570.95,70701.35
28061,U37584,30,-6948.11,22,8,22286.0,15337.89
28062,U626725,30,-6475.66,17,13,17856.72,11381.060000000001
28063,U9749,30,-15701.819999999992,23,7,94132.40999999999,78430.59
28064,U24590,30,-10891.730000000001,16,14,216008.16,205116.43
28065,U8650,30,48506.74,21,9,17081.34999999999,65588.09
28066,U9823,30,5041.040000000001,13,17,20408.0,25449.04
28067,U22349,30,1715.3399999999992,27,3,3839.0800000000004,5554.42
28068,U984820,30,-2314.7599999999998,23,7,3932.7700000000004,1618.0100000000007
28069,U38687,30,-14327.050000000005,20,10,92371.13999999998,78044.08999999998
28070,U26106,30,-19290.83000000002,25,5,61213.38000000002,41922.55
28071,U21668,30,-491.6300000000008,22,8,17918.91,17427.28
28072,U21477,30,677.0400000000051,21,9,39403.2,40080.240000000005
28073,U1120758,30,185.11000000000024,15,15,9140.31,9325.42
28074,U23099,30,1413.0300000000007,26,4,11230.729999999996,12643.759999999997
28075,U21109,30,-408.9799999999997,23,7,6210.16,5801.18
28076,U35044,30,-31430.829999999998,17,13,48331.38,16900.55
28077,U8756,30,-803.9500000000029,23,7,57845.78,57041.829999999994
28078,U15105,30,-3377674.69,19,11,3853019.0,475344.31000000006
28079,U36474,30,-20271.060000000005,17,13,352368.67000000004,332097.61000000004
28080,U34163,30,-47372.3,28,2,49978.3,2606.0
28081,U18733,30,598797.72,11,19,1814267.42,2413065.1399999997
28082,U31452,30,-2121.17,15,15,17205.79,15084.62
28083,U19548,30,4902.34,21,9,31972.81,36875.15
28084,U22553,30,-65183.36000000002,24,6,111465.07000000004,46281.710000000014
28085,U28861,30,-8101.839999999998,24,6,22313.83,14211.990000000003
28086,U21788,30,-347.3700000000006,21,9,70448.18,70100.81
28087,U36646,30,1017.0499999999997,21,9,8972.41,9989.46
28088,U35280,30,-21968.9,15,15,88708.0,66739.1
28089,U19667,30,-1948.9800000000002,24,6,12426.839999999998,10477.859999999999
28090,U9551,30,1861.920000000002,18,12,79327.34,81189.26
28091,U36905,30,-8222.260000000018,18,12,373461.68,365239.42
28092,U22416,30,-2253.05,21,9,9842.689999999999,7589.6399999999985
28093,U28797,30,2598.8899999998976,17,13,1912728.58,1915327.47
28094,U899169,30,-389.3299999999999,24,6,3539.78,3150.4500000000003
28095,U10419,30,-40691.46999999998,22,8,560986.64,520295.17000000004
28096,U20847,30,19442.940000000002,22,8,16310.02,35752.96000000001
28097,U24464,30,11786.619999999994,16,14,36007.36,47793.979999999996
28098,U969766,30,-945.9300000000003,18,12,42081.630000000005,41135.700000000004
28099,U31500,30,30268.490000000103,17,13,1506174.2,1536442.69
28100,U18434,30,4569.54,20,10,5398.18,9967.720000000001
28101,U28023,30,401.6099999999989,17,13,92182.12,92583.73
28102,U25016,30,-101928.98,19,11,240177.31,138248.33000000002
28103,U41292,30,21293.289999999994,17,13,9082098.35,9103391.639999999
28104,U839376,30,-16.25,18,12,14795.770000000002,14779.520000000002
28105,U1357102,30,1484.5400000000009,19,11,18435.28,19919.82
28106,U32281,30,-51112.32,26,4,72185.59000000001,21073.27000000001
28107,U37569,30,728.1700000000004,20,10,47634.17,48362.34
28108,U1098236,30,-6683.950000000001,21,9,38820.68,32136.73
28109,U30923,30,-1117.5,21,9,15823.8,14706.3
28110,U42352,30,33507.04,10,20,26601.0,60108.04
28111,U40058,30,59276.630000000005,15,15,73081.52999999998,132358.15999999997
28112,U42584,30,11454.560000000001,18,12,8160.999999999999,19615.56
28113,U22086,30,-210608.67,11,19,341152.47,130543.79999999996
28114,U16247,30,-104478.34,15,15,631383.2899999999,526904.95
28115,U29383,30,-20390.43,22,8,38047.0,17656.57
28116,U37575,30,-2318.0299999999993,17,13,56027.170000000006,53709.14000000001
28117,U35335,30,557.61,26,4,1519.7900000000002,2077.4
28118,U1222277,30,-2811.34,22,8,6173.24,3361.8999999999996
28119,U35318,30,-3632.549999999999,26,4,9936.34,6303.790000000001
28120,U16446,30,49560.33,20,10,48285.87,97846.20000000001
28121,U13181,30,40613.149999999994,16,14,58178.46,98791.60999999999
28122,U12642,30,-13705.039999999994,25,5,110534.23000000001,96829.19000000002
28123,U35689,30,-4354.19,24,6,14777.48,10423.29
28124,U31247,30,418.67999999999995,22,8,1142.4799999999998,1561.1599999999999
28125,U950762,30,0.45000000000003837,15,15,2040.55,2041.0
28126,U9285,30,-6988.969999999999,27,3,14394.99,7406.02
28127,U11266,30,-5444.429999999999,25,5,7900.69,2456.26
28128,U20010,30,2798.55,22,8,5123.73,7922.28
28129,U13158,30,1495.429999999999,22,8,7212.000000000002,8707.43
28130,U42533,30,0.9199999999980975,21,9,38108.29,38109.21
28131,U13217,30,126929.86000000003,13,17,2376449.37,2503379.23
28132,U13578,30,-353.03,21,9,2801.2000000000003,2448.17
28133,U35678,30,-24924.530000000002,19,11,112872.09,87947.56
28134,U10497,30,39539.03,24,6,54635.45,94174.48
28135,U32550,30,-14357.57,27,3,67066.5,52708.93
28136,U40500,30,-972.5300000000001,25,5,3573.14,2600.6099999999997
28137,U42386,30,-108.51000000000057,18,12,23984.670000000002,23876.16
28138,U39196,30,10518.3,23,7,19849.120000000003,30367.420000000002
28139,U36833,30,-3488.960000000021,14,16,306553.88,303064.92
28140,U11410,30,-10561.029999999999,18,12,84362.49,73801.46
28141,U41668,30,-2590.730000000002,16,14,38702.55,36111.82
28142,U26520,30,-6284.700000000002,25,5,7535.540000000001,1250.8399999999992
28143,U30749,30,10472.009999999984,14,16,429911.81,440383.82
28144,U15428,30,-2379.85,25,5,5838.739999999999,3458.889999999999
28145,U10600,30,-25736.679999999986,21,9,220789.5,195052.82
28146,U13267,30,-130078.90000000002,14,16,404501.51999999996,274422.61999999994
28147,U758340,30,4000.7200000000003,16,14,9095.31,13096.029999999999
28148,U28674,30,2348.6599999999994,23,7,10778.539999999999,13127.199999999999
28149,U14099,30,-7782.280000000001,13,17,35467.0,27684.72
28150,U29727,30,2230.4799999999996,22,8,14287.68,16518.16
28151,U1106079,30,521.5999999999995,19,11,21241.340000000004,21762.940000000002
28152,U12362,30,467.72000000000935,22,8,128277.56999999999,128745.29000000001
28153,U13444,30,61004.32000000001,17,13,137077.06,198081.38
28154,U9537,30,29475.670000000002,14,16,46403.78,75879.45
28155,U36485,30,-106405.75,18,12,136480.96000000002,30075.21000000002
28156,U1276044,30,84777.47000000003,18,12,70654.17,155431.64
28157,U33332,30,-219952.59999999992,12,18,1165800.0,945847.4000000001
28158,U9540,30,-3285.3900000000003,22,8,7127.839999999999,3842.449999999999
28159,U1307564,30,-598.46,27,3,638.7,40.24000000000001
28160,U1185448,30,-16983.99,21,9,35087.07000000001,18103.080000000005
28161,U42733,30,-3524.7199999999984,21,9,17997.94,14473.220000000001
28162,U31003,30,-834.4699999999997,23,7,7587.71,6753.240000000001
28163,U26459,30,-100.0000000000007,26,4,5684.150000000001,5584.15
28164,U1191895,30,108.39999999999993,17,13,5291.9,5400.299999999999
28165,U31663,30,-9916.370000000014,20,10,138229.10000000003,128312.73000000003
28166,U21766,30,2.9557953307168816e-13,15,15,5984.0700000000015,5984.0700000000015
28167,U26241,30,-265362.09,25,5,280614.0,15251.909999999974
28168,U10182,30,17680.14,21,9,13982.59,31662.73
28169,U35662,30,31153.830000000104,12,18,765196.0,796349.8300000001
28170,U42307,30,-23.46000000000001,10,20,218.3,194.84
28171,U26942,30,6289.840000000004,19,11,133439.08000000002,139728.92
28172,U1242187,30,-785.3399999999995,19,11,18702.82,17917.48
28173,U27700,30,-4985.080000000004,18,12,31380.080000000005,26395.0
28174,U28206,30,-4179.830000000001,22,8,8825.55,4645.719999999998
28175,U9027,30,2340.0100000000093,19,11,53918.35,56258.36000000001
28176,U38380,30,-329.6800000000003,25,5,11287.0,10957.32
28177,U11043,30,801.8400000000001,23,7,22706.64,23508.48
28178,U28693,30,-6237.91,19,11,65980.39,59742.479999999996
28179,U8518,30,3092.4299999999903,15,15,119155.14,122247.56999999999
28180,U30476,30,-817.3600000000002,23,7,5190.760000000001,4373.400000000001
28181,U31256,30,-57993.269999999975,21,9,451978.5400000001,393985.27000000014
28182,U41175,30,647.5100000000004,13,17,6233.620000000001,6881.130000000001
28183,U1147608,30,199.15999999999985,17,13,12282.5,12481.66
28184,U43199,30,-8126.359999999999,19,11,163119.18000000005,154992.82000000007
28185,U684925,30,3984.8900000000012,16,14,28706.22,32691.11
28186,U35102,30,-590.6400000000001,20,10,6326.799999999999,5736.159999999999
28187,U31880,30,-2740.79999999993,12,18,726201.84,723461.04
28188,U30661,30,-2282.3699999999985,10,20,44342.5,42060.130000000005
28189,U42269,30,-4660.429999999999,29,1,4663.989999999999,3.5599999999994907
28190,U11446,30,455.0100000000002,18,12,27076.9,27531.910000000003
28191,U39315,30,-3063.760000000001,20,10,41183.97,38120.21
28192,U11121,30,-3307.49,17,13,44849.47,41541.98
28193,U17254,30,253848.25,10,20,32793.6,286641.85
28194,U19949,30,-15.32000000000044,23,7,12420.960000000001,12405.640000000001
28195,U30936,30,-10195.15,24,6,17000.739999999998,6805.589999999998
28196,U34863,30,20716.38,17,13,27621.670000000002,48338.05
28197,U11283,30,-1014.840000000002,23,7,42301.740000000005,41286.9
28198,U8665,30,-24067.28,22,8,163969.66,139902.38
28199,U30939,30,4659.700000000001,18,12,22840.050000000003,27499.750000000004
28200,U1310637,30,-2520.26,27,3,2520.8500000000004,0.5900000000001455
28201,U890225,30,-1714.7500000000002,17,13,12102.170000000002,10387.420000000002
28202,U34491,30,229470.56999999995,17,13,256232.7,485703.26999999996
28203,U20977,30,-90418.59,23,7,110329.65000000002,19911.060000000027
28204,U20236,30,502.119999999999,25,5,15092.09,15594.21
28205,U11586,30,-8304.63,25,5,27807.649999999998,19503.019999999997
28206,U11564,30,-25043.739999999994,21,9,51266.36,26222.620000000006
28207,U1292585,30,-268.05,26,4,415.0899999999999,147.0399999999999
28208,U18587,30,-20310.64,22,8,92804.08,72493.44
28209,U13231,30,3689.0300000000025,19,11,18305.96,21994.99
28210,U20416,30,200.14999999999964,19,11,55291.020000000004,55491.170000000006
28211,U41760,30,47280.830000000016,16,14,507400.6,554681.4299999999
28212,U25438,30,31607.410000000003,22,8,47631.48,79238.89000000001
28213,U41648,30,7027.37000000001,12,18,380738.49,387765.86
28214,U34538,30,-537.4099999999992,25,5,77250.56999999998,76713.15999999997
28215,U580982,30,374.11,18,12,1658.7300000000002,2032.8400000000001
28216,U19208,30,-42563.829999999994,24,6,62196.969999999994,19633.14
28217,U8978,30,6045.540000000002,21,9,57493.25999999999,63538.79999999999
28218,U23303,30,4967.129999999973,16,14,236617.58,241584.70999999996
28219,U658831,30,-244.0999999999999,16,14,8602.94,8358.84
28220,U25624,30,9984.379999999996,17,13,68402.6,78386.98
28221,U12688,30,-5077.999999999996,18,12,37592.19,32514.190000000006
28222,U31595,30,-3724.2400000000002,24,6,17483.63,13759.390000000001
28223,U23400,30,2904.25,26,4,1616.88,4521.13
28224,U41520,30,2240.1400000000012,22,8,20465.56,22705.700000000004
28225,U18920,30,2044.63,22,8,35850.42,37895.049999999996
28226,U39981,30,-44468.479999999974,14,16,197870.0,153401.52000000002
28227,U26045,30,-10638.699999999997,25,5,22448.370000000006,11809.67000000001
28228,U14347,30,12258.889999999998,26,4,14492.320000000002,26751.21
28229,U36572,30,-938.9199999999983,19,11,64869.899999999994,63930.979999999996
28230,U9597,30,-6828.4600000000055,21,9,113973.95,107145.48999999999
28231,U25888,30,-11890.260000000006,18,12,124408.65,112518.38999999998
28232,U8587,30,59110.37,16,14,175558.82,234669.19
28233,U14181,30,49712.07999999996,19,11,898107.4,947819.48
28234,U23722,30,-90579.15000000002,20,10,201319.49,110740.33999999997
28235,U40499,30,-2787.630000000002,22,8,38732.98999999998,35945.35999999998
28236,U18163,30,180.10999999999999,17,13,591.04,771.15
28237,U25253,30,-632.03,27,3,1099.69,467.6600000000001
28238,U43859,30,-2485.9699999999984,27,3,7995.009999999998,5509.04
28239,U9330,30,0.049999999995843605,19,11,36825.97000000001,36826.020000000004
28240,U35749,30,45347.689999999995,18,12,65790.0,111137.69
28241,U35471,30,45.909999999999854,13,17,60714.0,60759.91
28242,U21662,30,-11488.439999999995,22,8,111825.89,100337.45000000001
28243,U1138148,30,2030.9699999999998,16,14,22851.749999999996,24882.719999999998
28244,U1174627,30,-1790.5,20,10,5349.379999999999,3558.879999999999
28245,U27078,30,-47460.23999999999,19,11,160368.15,112907.91
28246,U34729,30,-4788.49,29,1,4807.28,18.789999999999964
28247,U36496,30,-626.8600000000007,27,3,1627.100000000001,1000.2400000000004
28248,U21726,30,-1498.9099999999987,19,11,54560.57,53061.66
28249,U14501,30,40226.49000000008,15,15,200921.6,241148.09000000008
28250,U11252,30,-8944.010000000002,24,6,50734.700000000004,41790.69
28251,U14287,30,36997.67,18,12,67920.98000000001,104918.65000000001
28252,U26554,30,-3777.9500000000007,18,12,76626.32999999999,72848.37999999999
28253,U34514,30,9748.39,24,6,3112.94,12861.33
28254,U30506,30,-5245.869999999991,22,8,101700.14000000001,96454.27000000002
28255,U35087,30,15579.46,22,8,2509.0,18088.46
28256,U21812,30,-5417.860000000001,20,10,29225.29,23807.43
28257,U14895,30,-3289.7300000000055,21,9,80225.39999999998,76935.66999999997
28258,U1351116,30,-461.49,19,11,859.7099999999999,398.2199999999999
28259,U41446,30,90.18000000000211,17,13,254435.53999999998,254525.71999999997
28260,U26822,30,-9511.2,17,13,21091.17,11579.969999999998
28261,U35220,30,-6319.7800000000025,14,16,110145.9,103826.12
28262,U1142951,30,-650.06,21,9,3281.9300000000003,2631.8700000000003
28263,U27771,30,2050.159999999995,18,12,112198.19,114248.34999999999
28264,U13124,30,22353.560000000005,22,8,54311.92,76665.48000000001
28265,U40531,30,1081.9099999999814,7,23,774462.0,775543.91
28266,U22122,30,5202.96,25,5,25496.100000000002,30699.06
28267,U17161,30,95.57000000000062,18,12,17405.17,17500.739999999998
28268,U26895,30,-8.809999999962884,18,12,903707.2,903698.39
28269,U9405,30,46070.78,21,9,18651.010000000002,64721.79
28270,U42923,30,-13.219999999999345,23,7,14828.000000000002,14814.780000000002
28271,U33074,30,-28003.64,23,7,79511.0,51507.36
28272,U43301,30,-433.8499999999997,22,8,8417.88,7984.03
28273,U9518,30,-9267.730000000003,15,15,47274.93,38007.2
28274,U22335,30,-83028.86999999992,14,16,676563.8,593534.9300000002
28275,U9003,30,-4824.219999999999,26,4,25146.600000000002,20322.380000000005
28276,U9142,30,80057.56000000001,8,22,29700.0,109757.56000000001
28277,U37572,30,12251.810000000001,23,7,32517.0,44768.81
28278,U36199,30,-4494.04,24,6,26927.360000000004,22433.320000000003
28279,U22872,30,273387.43000000005,16,14,103815.20999999999,377202.64
28280,U967637,30,-3007.1500000000005,19,11,20850.030000000002,17842.88
28281,U1373188,30,432.2599999999998,21,9,6688.96,7121.22
28282,U22554,30,-69.43999999999983,24,6,3770.2799999999997,3700.84
28283,U35877,30,87568.01000000001,15,15,541198.0,628766.01
28284,U8923,30,11328.699999999999,21,9,34319.420000000006,45648.12
28285,U37613,30,41831.8,17,13,57378.87999999999,99210.68
28286,U30414,30,4135.9,15,15,36681.93,40817.83
28287,U15817,30,-527.4000000000046,16,14,163011.5,162484.1
28288,U27879,30,1411.32,25,5,1909.5800000000002,3320.9
28289,U22917,30,1851.560000000005,12,18,71662.12000000001,73513.68000000002
28290,U31102,30,-23465.789999999994,12,18,468291.0,444825.21
28291,U28104,30,933.6500000000001,25,5,1984.6499999999996,2918.2999999999997
28292,U31413,30,45425.57000000002,14,16,335126.0,380551.57
28293,U33536,30,1999.9899999999998,25,5,9479.81,11479.8
28294,U21683,30,-148648.15000000002,13,17,1346541.56,1197893.4100000001
28295,U1189931,30,-635.7199999999996,20,10,4450.19,3814.4700000000003
28296,U11152,30,97813.75,18,12,35031.12,132844.87
28297,U43436,30,19238.35,15,15,39768.53,59006.88
28298,U15812,29,196.4699999999999,18,11,63535.71,63732.18
28299,U40856,29,-13124.68,19,10,34787.99,21663.309999999998
28300,U21148,29,4517.71,25,4,4895.12,9412.83
28301,U25559,29,-307.1100000000001,23,6,11296.4,10989.289999999999
28302,U40324,29,-22087.41,15,14,173998.38,151910.97
28303,U10476,29,-32971.70000000001,14,15,90907.79000000001,57936.09
28304,U36219,29,1476.2299999999996,23,6,34224.54,35700.770000000004
28305,U21982,29,-23.030000000000598,16,13,106473.56999999999,106450.54
28306,U18813,29,1938.430000000034,12,17,542263.8,544202.2300000001
28307,U42783,29,700.7499999999982,23,6,19112.85,19813.6
28308,U30933,29,-3352.33,23,6,4950.65,1598.3199999999997
28309,U35393,29,4685.260000000002,23,6,39271.14,43956.4
28310,U42091,29,527.3399999999998,19,10,10072.98,10600.32
28311,U30409,29,-540.1799999999985,19,10,33776.6,33236.42
28312,U680670,29,-1651.5600000000009,21,8,15055.31,13403.749999999998
28313,U30904,29,-583.3000000000001,22,7,3654.95,3071.6499999999996
28314,U27600,29,52369.93,20,9,95622.14,147992.07
28315,U32919,29,-14227.419999999998,18,11,108082.6,93855.18000000001
28316,U32159,29,3600.210000000001,21,8,28446.31,32046.520000000004
28317,U43536,29,16897.739999999998,23,6,8389.25,25286.989999999998
28318,U29290,29,-343534.99,20,9,525448.78,181913.79000000004
28319,U31862,29,-20073.46,21,8,43812.9,23739.440000000002
28320,U599017,29,437.9999999999995,17,12,4292.0199999999995,4730.019999999999
28321,U19788,29,15357.080000000005,17,12,108173.62,123530.7
28322,U782085,29,-5717.9800000000005,24,5,11553.0,5835.0199999999995
28323,U42824,29,-64443.350000000006,26,3,234498.14,170054.79
28324,U25027,29,87.75,15,14,33081.35,33169.1
28325,U29516,29,-142.18000000000094,21,8,19378.239999999998,19236.059999999998
28326,U33945,29,88248.69,21,8,17189.7,105438.39
28327,U36406,29,-1048.3599999999992,17,12,78430.07999999999,77381.71999999999
28328,U8984,29,-36596.630000000005,21,8,81609.12,45012.48999999999
28329,U32066,29,81.18000000000083,17,12,31359.930000000004,31441.110000000004
28330,U36198,29,-21558.839999999997,20,9,43390.65,21831.810000000005
28331,U23026,29,758.3000000000117,23,6,503017.80000000005,503776.10000000003
28332,U42740,29,-2745.2999999999997,16,13,14169.029999999999,11423.73
28333,U36503,29,-6723.470000000001,14,15,28417.0,21693.53
28334,U42714,29,161029.13999999996,14,15,53124.7,214153.83999999997
28335,U35750,29,-6071.790000000001,19,10,126323.4,120251.60999999999
28336,U764186,29,75.24000000000018,19,10,4750.07,4825.3099999999995
28337,U24468,29,35967.8,18,11,49098.76,85066.56
28338,U13192,29,-14736.279999999999,16,13,148347.70999999996,133611.42999999996
28339,U42750,29,-1972.930000000002,19,10,38487.509999999995,36514.579999999994
28340,U15513,29,31184.94,20,9,18475.89,49660.83
28341,U981048,29,-3273.819999999998,23,6,25758.19,22484.370000000003
28342,U29419,29,11619.599999999999,13,16,70440.9,82060.5
28343,U30576,29,2206.4399999999955,9,20,63079.020000000004,65285.46
28344,U36893,29,662.4300000000001,20,9,3156.6000000000004,3819.0300000000007
28345,U1100974,29,3214.5099999999993,20,9,18086.850000000002,21301.36
28346,U982937,29,-11357.330000000002,19,10,22836.75,11479.419999999998
28347,U36486,29,-1580.2200000000075,19,10,158765.0,157184.78
28348,U39072,29,-284858.29,12,17,609399.8300000001,324541.5400000001
28349,U14033,29,2397.210000000001,24,5,38875.86,41273.07
28350,U24040,29,-869.7700000000009,24,5,12794.97,11925.199999999999
28351,U19218,29,-132345.36,21,8,196911.93999999997,64566.57999999999
28352,U17877,29,-1019.889999999999,25,4,37028.409999999996,36008.52
28353,U37589,29,-107716.68000000001,9,20,730149.0,622432.32
28354,U1293125,29,-3459.97,26,3,6169.969999999999,2709.9999999999995
28355,U11823,29,2935.390000000002,16,13,81453.13,84388.52
28356,U24107,29,-717.869999999999,27,2,11061.869999999999,10344.0
28357,U43159,29,4217.84,22,7,3951.2999999999997,8169.139999999999
28358,U41818,29,3052.5300000000025,14,15,278864.45,281916.98000000004
28359,U23806,29,73377.31999999999,17,12,131459.95,204837.27000000002
28360,U37289,29,-107476.95999999999,23,6,116355.84999999999,8878.89
28361,U13066,29,-566.639999999998,20,9,51164.2,50597.56
28362,U28926,29,4842.509999999999,22,7,12993.59,17836.1
28363,U8475,29,-28340.67,23,6,86933.2,58592.53
28364,U23482,29,-682.0800000000309,14,15,164391.25000000003,163709.16999999998
28365,U31265,29,-585.5299999999999,26,3,885.1799999999996,299.64999999999975
28366,U25367,29,14601.980000000003,13,16,133567.38,148169.36000000002
28367,U28754,29,2105.560000000002,11,18,70939.96,73045.52
28368,U1373032,29,2300.6799999999994,23,6,2299.1200000000003,4599.799999999999
28369,U27269,29,-81.65000000000146,21,8,21912.87,21831.219999999998
28370,U33573,29,-1504.839999999999,20,9,24657.2,23152.36
28371,U43762,29,1383.1599999999999,20,9,20502.18,21885.34
28372,U36823,29,9104.57,20,9,23252.489999999998,32357.059999999998
28373,U39630,29,3296.8099999999995,18,11,27903.21,31200.019999999997
28374,U30683,29,-4998.98,22,7,8161.37,3162.3900000000003
28375,U23479,29,6686.92,20,9,27478.370000000003,34165.29
28376,U28444,29,22288.460000000003,15,14,3174.88,25463.340000000004
28377,U1074438,29,-1108.8000000000002,25,4,10009.029999999999,8900.23
28378,U28831,29,-51.45999999999992,24,5,1495.82,1444.3600000000001
28379,U30922,29,981.8899999999907,12,17,442649.11,443631.0
28380,U36702,29,40065.859999999964,20,9,565292.8,605358.66
28381,U781316,29,406.10000000000036,18,11,16149.400000000001,16555.5
28382,U22210,29,19200.08,13,16,80494.0,99694.08
28383,U43271,29,331.2800000000001,24,5,1270.86,1602.1399999999999
28384,U22377,29,37.450000000000315,25,4,2379.99,2417.44
28385,U34376,29,2341.56,23,6,17080.64,19422.2
28386,U1129039,29,-11531.230000000003,21,8,15953.230000000003,4422.0
28387,U1272720,29,344.9299999999996,18,11,9640.08,9985.01
28388,U24149,29,-37.969999999999956,18,11,299.8799999999999,261.9099999999999
28389,U895885,29,180.08999999999963,21,8,10126.43,10306.52
28390,U23591,29,-2053.040000000001,23,6,8963.050000000001,6910.01
28391,U42427,29,0.16000000003305104,13,16,561914.55,561914.7100000001
28392,U16177,29,-6744.010000000009,15,14,482093.66000000003,475349.65
28393,U39900,29,2856.7700000000004,18,11,25355.299999999996,28212.069999999996
28394,U22366,29,104.56,20,9,5029.5,5134.06
28395,U39861,29,-26467.12,25,4,47661.25,21194.13
28396,U24575,29,-1322.3299999999988,22,7,45010.51,43688.18
28397,U30689,29,18847.45,20,9,16266.630000000001,35114.08
28398,U43653,29,-6946.52,25,4,26075.300000000003,19128.780000000002
28399,U34155,29,3967.1099999999983,24,5,6956.410000000001,10923.519999999999
28400,U39783,29,-37432.67,15,14,128106.61,90673.94
28401,U13103,29,61703.340000000004,20,9,395374.94,457078.28
28402,U1172389,29,2676.4199999999996,16,13,8891.93,11568.35
28403,U16031,29,31285.09,12,17,85051.39,116336.48
28404,U583958,29,-8738.289999999999,17,12,16922.300000000003,8184.010000000004
28405,U22477,29,-24125.119999999995,16,13,111751.20999999999,87626.09
28406,U11947,29,84.49999999999989,26,3,8475.800000000001,8560.300000000001
28407,U13269,29,2124.96,20,9,98360.76999999999,100485.73
28408,U18370,29,-18376.690000000002,23,6,60280.0,41903.31
28409,U23901,29,376.5200000000003,15,14,13926.9,14303.42
28410,U10950,29,-1512.3000000000002,27,2,1759.7400000000002,247.44000000000005
28411,U8790,29,1298.92,16,13,31450.38,32749.300000000003
28412,U1076585,29,-569.17,21,8,1793.14,1223.9700000000003
28413,U20239,29,34411.19,20,9,19362.53,53773.72
28414,U37395,29,899.5299999999977,17,12,181397.64,182297.17
28415,U40323,29,271.6399999999999,22,7,11116.73,11388.369999999999
28416,U27799,29,24238.69,14,15,59395.33,83634.02
28417,U1131017,29,1444.909999999999,19,10,14846.89,16291.8
28418,U35364,29,-4392.66,21,8,19888.660000000003,15496.000000000004
28419,U35752,29,46074.3,22,7,39608.03,85682.33
28420,U9911,29,51.409999999999854,17,12,41313.08,41364.490000000005
28421,U17771,29,-13493.63,25,4,45376.27,31882.64
28422,U29141,29,42616.1,14,15,106363.82,148979.92
28423,U37970,29,-48483.479999999996,25,4,125009.0,76525.52
28424,U31325,29,1255.6800000000012,11,18,291284.0,292539.68
28425,U34575,29,-1398.3500000000008,22,7,14508.3,13109.949999999999
28426,U1156017,29,1628.23,17,12,7575.01,9203.24
28427,U29604,29,4456.8,23,6,5085.0,9541.8
28428,U626831,29,-15042.070000000002,22,7,15396.840000000002,354.77000000000044
28429,U35462,29,10366.720000000005,14,15,34656.8,45023.520000000004
28430,U27071,29,-12030.489999999965,18,11,1026509.5199999999,1014479.0299999999
28431,U15371,29,10851.710000000001,14,15,39120.05,49971.76
28432,U36557,29,6905.200000000001,18,11,22833.239999999998,29738.44
28433,U29280,29,-32991.72,24,5,68860.12,35868.399999999994
28434,U28951,29,-11628.819999999998,23,6,42727.149999999994,31098.329999999994
28435,U1344469,29,-4049.3999999999987,20,9,9110.069999999998,5060.669999999999
28436,U16389,29,9787.920000000027,20,9,266558.35,276346.27
28437,U37879,29,-3392.040000000008,25,4,156323.35,152931.31
28438,U14827,29,23603.11,12,17,545599.32,569202.4299999999
28439,U1102426,29,-1304.6799999999998,22,7,1395.47,90.79000000000019
28440,U10704,29,-24521.620000000003,27,2,24587.16,65.53999999999724
28441,U20659,29,-8621.79,18,11,41501.01,32879.22
28442,U10036,29,-11666.550000000003,19,10,107682.4,96015.84999999999
28443,U15358,29,7079.020000004768,20,9,38522294.660000004,38529373.68000001
28444,U44073,29,1490.5200000000002,17,12,14438.210000000003,15928.730000000003
28445,U37255,29,-2688.88,18,11,9660.93,6972.05
28446,U1336706,29,-12790.57,19,10,14025.08,1234.5100000000002
28447,U638511,29,-288.4699999999999,19,10,3285.66,2997.19
28448,U37474,29,49302.95000000001,19,10,113797.14,163100.09000000003
28449,U18629,29,2371.7000000000007,21,8,20551.0,22922.7
28450,U27890,29,-21800.0,12,17,80202.35,58402.350000000006
28451,U41621,29,11991.870000000003,12,17,98852.98999999999,110844.85999999999
28452,U35589,29,-907.81,21,8,5011.78,4103.969999999999
28453,U31426,29,28247.990000000013,21,8,50317.299999999996,78565.29000000001
28454,U39138,29,-2042.3499999999967,12,17,78731.62,76689.27
28455,U41575,29,5704.749999999999,25,4,28484.980000000003,34189.73
28456,U1218330,29,111.21,19,10,604.34,715.5500000000001
28457,U22293,29,268.81000000000006,26,3,1675.9500000000005,1944.7600000000007
28458,U937442,29,140.85000000000002,21,8,1627.15,1768.0
28459,U965724,29,-104.38,16,13,5377.700000000001,5273.320000000001
28460,U8807,29,-1340.3499999999985,23,6,15567.91,14227.560000000001
28461,U41130,29,-461.71999999999764,23,6,41970.259999999995,41508.53999999999
28462,U36260,29,917.6200000000002,13,16,27733.450000000004,28651.070000000003
28463,U39348,29,205079.20999999996,19,10,30443.240000000005,235522.44999999995
28464,U40177,29,-697.3199999999997,16,13,51012.31999999999,50314.99999999999
28465,U18196,29,-1790.4299999999998,20,9,2644.53,854.1000000000004
28466,U42267,29,-74.9300000000004,25,4,3499.75,3424.8199999999997
28467,U14575,29,111118.87000000001,19,10,25240.660000000007,136359.53000000003
28468,U26336,29,-8133.389999999981,15,14,297455.82,289322.43000000005
28469,U33215,29,-500.1199999999999,20,9,26100.719999999998,25600.6
28470,U37802,29,-8863.2,12,17,31914.7,23051.5
28471,U1159132,29,-17.139999999999134,17,12,17782.22,17765.08
28472,U12019,29,-108770.90999999999,21,8,316192.99999999994,207422.08999999997
28473,U23110,29,-106.9900000000016,16,13,44697.26,44590.270000000004
28474,U23362,29,-14541.260000000002,25,4,62937.26,48396.0
28475,U36045,29,-148339.76,12,17,263129.68,114789.91999999998
28476,U37556,29,8552.020000000002,24,5,10543.25,19095.270000000004
28477,U43649,29,244.30999999999767,19,10,198122.11999999997,198366.42999999996
28478,U21095,29,36279.94999999999,12,17,123941.53,160221.47999999998
28479,U1269549,29,116.39000000000001,13,16,2448.2,2564.5899999999997
28480,U20576,29,-1521.550000000023,15,14,591879.7200000001,590358.17
28481,U37765,29,-13764.41,25,4,23473.1,9708.689999999999
28482,U34813,29,-4154.109999999999,20,9,33222.53,29068.42
28483,U32797,29,8748.29,22,7,14776.629999999997,23524.92
28484,U42463,29,-13468.900000000001,19,10,77976.0,64507.1
28485,U14251,29,-11153.279999999999,17,12,73650.2,62496.92
28486,U23322,29,2237005.0699999994,5,24,2120000.0,4357005.069999999
28487,U991096,29,-27259.269999999993,25,4,27413.569999999992,154.29999999999927
28488,U28439,29,5018.79,23,6,15184.329999999998,20203.12
28489,U29990,29,-3127.5899999999997,24,5,3611.85,484.2600000000002
28490,U13752,29,912.98,21,8,64953.79,65866.77
28491,U12209,29,-9971.579999999998,19,10,39350.38,29378.8
28492,U34751,29,-10361.44,25,4,15253.519999999999,4892.079999999998
28493,U36098,29,24328.809999999998,19,10,14212.0,38540.81
28494,U43020,29,2391.2199999999993,20,9,167936.6,170327.82
28495,U27747,29,-71048.78000000004,16,13,1613970.5,1542921.72
28496,U21920,29,124537.17000000001,13,16,266807.62,391344.79000000004
28497,U22606,29,-4735.880000000003,24,5,25136.370000000003,20400.489999999998
28498,U8963,29,-12736.45,23,6,55725.01,42988.56
28499,U33406,29,4629.739999999998,18,11,34509.26,39139.0
28500,U24562,29,-5660.24,26,3,6045.45,385.21000000000004
28501,U33088,29,4847.280000000001,13,16,8808.5,13655.78
28502,U37105,29,-56463.28,20,9,506526.0,450062.72
28503,U34246,29,-8364.440000000002,24,5,23864.18,15499.739999999998
28504,U1153421,29,297.18,25,4,1795.9,2093.08
28505,U34119,29,-1979.219999999988,21,8,111332.82000000002,109353.60000000003
28506,U37445,29,-3226.1100000000006,17,12,46647.31,43421.2
28507,U36135,29,530.4500000000007,18,11,73031.2,73561.65
28508,U33617,29,15763.030000000002,23,6,4983.049999999999,20746.08
28509,U1346955,29,30914.999999999996,13,16,38939.93,69854.93
28510,U24749,29,2725.5000000000005,19,10,2854.34,5579.84
28511,U24470,29,-9914.720000000003,26,3,26772.62,16857.899999999994
28512,U42285,29,-80617.36000000002,17,12,103006.0,22388.639999999985
28513,U658718,29,-11.709999999999987,19,10,1267.51,1255.8
28514,U37963,29,-46635.54,19,10,117816.23,71180.69
28515,U30337,29,-145295.46000000008,14,15,1274663.0,1129367.54
28516,U41267,29,-78.97000000000116,17,12,47569.0,47490.03
28517,U15197,29,-1779.4499999999994,23,6,6805.079999999999,5025.629999999999
28518,U32320,29,1916.3000000000002,8,21,9635.8,11552.099999999999
28519,U10315,29,-1491.1399999999999,21,8,10966.65,9475.51
28520,U29250,29,-25347.509999999915,10,19,554567.6900000001,529220.1800000002
28521,U24028,29,8976.339999999998,16,13,45198.270000000004,54174.61
28522,U16228,29,-4045.9499999999534,11,18,2964311.0300000003,2960265.08
28523,U23816,29,-20734.140000000014,20,9,227446.38,206712.24
28524,U36898,29,47872.96999999999,20,9,25965.46,73838.43
28525,U12326,29,-1101.8299999999986,18,11,57890.42999999999,56788.59999999999
28526,U35580,29,-2718.0299999999993,23,6,16095.029999999999,13377.0
28527,U1132638,29,2.7200000000005815,19,10,5680.0,5682.72
28528,U1102546,29,1.1999999999998294,19,10,3204.2000000000003,3205.4
28529,U15344,29,-627.6200000000026,13,16,124563.15000000001,123935.53
28530,U1219816,29,1498.99,23,6,3541.8200000000006,5040.81
28531,U38309,29,-35516.399999999994,24,5,244324.0,208807.6
28532,U24925,29,28235.370000000003,19,10,53198.97,81434.34
28533,U40934,29,-17.950000000186265,13,16,2255941.32,2255923.3699999996
28534,U29098,29,156608.66999999998,18,11,40657.0,197265.66999999998
28535,U41653,29,18263.669999999984,18,11,419584.14,437847.81
28536,U26664,29,-44.0200000000001,26,3,2367.0100000000007,2322.9900000000007
28537,U31162,29,3622.379999999999,21,8,6777.160000000001,10399.54
28538,U744135,29,5700.36,16,13,6468.08,12168.439999999999
28539,U27841,29,2987.56,20,9,1202.4099999999996,4189.969999999999
28540,U9767,29,666.8600000000001,20,9,25760.38,26427.24
28541,U27024,29,-4508.229999999981,17,12,442529.85000000003,438021.62000000005
28542,U11879,29,-58132.560000000005,22,7,81357.53,23224.969999999994
28543,U1214190,29,-254.51999999999998,20,9,646.5,391.98
28544,U12953,29,-10765.410000000007,19,10,103958.56,93193.15
28545,U33015,29,2324.13,20,9,5591.530000000001,7915.660000000001
28546,U21887,29,7612.16,17,12,4960.56,12572.720000000001
28547,U29152,29,-1342.199999999999,13,16,279837.92,278495.72
28548,U31418,29,203196.43,23,6,226413.57,429610.0
28549,U31657,29,-408.45000000000164,23,6,8282.71,7874.2599999999975
28550,U31453,29,-390.380000000001,16,13,71391.0,71000.62
28551,U43765,29,-12265.02,23,6,20449.35,8184.329999999998
28552,U30785,29,7402.75,21,8,5607.34,13010.09
28553,U16148,29,218.14,24,5,32852.94,33071.08
28554,U24526,29,-67456.40999999997,18,11,224281.76000000004,156825.35000000006
28555,U19716,29,-355.7400000000007,18,11,106291.18999999997,105935.44999999997
28556,U41654,29,-1022.41,20,9,2964.46,1942.0500000000002
28557,U27683,29,-432.2999999999995,23,6,14999.619999999999,14567.32
28558,U38986,29,-111083.58,21,8,209145.99,98062.40999999999
28559,U17307,29,63645.320000000014,14,15,130501.24,194146.56000000003
28560,U30729,29,-9500.079999999989,21,8,147093.49000000002,137593.41000000003
28561,U40302,29,-30183.61,18,11,96104.83,65921.22
28562,U21518,29,22874.200000000004,17,12,239815.56,262689.76
28563,U1339112,29,2723.6399999999994,24,5,8007.23,10730.869999999999
28564,U35413,29,-537.47,23,6,6398.29,5860.82
28565,U18302,29,-1365.2799999999988,14,15,57227.14,55861.86
28566,U30851,29,355229.2100000001,14,15,1251396.0,1606625.21
28567,U1100395,29,23.10000000000001,17,12,1654.7799999999997,1677.8799999999997
28568,U28960,29,20491.079999999998,20,9,147474.37,167965.44999999998
28569,U24202,29,-43474.27,28,1,43566.299999999996,92.02999999999884
28570,U33543,29,-18302.410000000003,19,10,27687.559999999998,9385.149999999994
28571,U12135,29,10587.02,16,13,104143.57,114730.59000000001
28572,U9941,29,-17361.629999999997,20,9,62433.25,45071.62
28573,U30867,29,-2853.3900000000003,21,8,14170.269999999999,11316.879999999997
28574,U29672,29,314.51000000000204,13,16,77432.52,77747.03
28575,U38179,29,57593.58,9,20,512112.11,569705.69
28576,U42890,29,3626.3899999999985,13,16,19975.26,23601.649999999998
28577,U31677,29,-11860.809999999958,18,11,730693.23,718832.42
28578,U1358064,29,-505.00000000000045,22,7,5035.980000000001,4530.980000000001
28579,U18725,29,-121724.98999999995,12,17,2471892.0,2350167.0100000002
28580,U32741,29,5576.889999999999,17,12,38176.649999999994,43753.53999999999
28581,U23381,29,-1421.62000000001,12,17,198683.86,197262.24
28582,U12230,29,443.80999999999995,21,8,32816.86,33260.67
28583,U15313,29,3948.869999999999,18,11,20863.100000000002,24811.97
28584,U38797,29,0.0,16,13,18006.28,18006.28
28585,U673990,29,-1378.949999999999,21,8,14920.41,13541.460000000001
28586,U30483,29,51352.16999999999,23,6,51927.67,103279.84
28587,U30285,29,-1045.2700000000018,16,13,54554.60999999999,53509.33999999999
28588,U23539,29,-1099.6299999999974,21,8,101831.0,100731.37
28589,U27915,29,-1460.0500000000002,19,10,67826.86,66366.81
28590,U34447,29,6236.450000000001,22,7,30259.53,36495.979999999996
28591,U19905,29,40299.0,24,5,52792.770000000004,93091.77
28592,U29809,29,135.8399999999997,21,8,20507.78,20643.62
28593,U38188,29,-12237.91,24,5,17060.47,4822.560000000001
28594,U9519,29,6831.8500000000095,16,13,196850.26,203682.11000000002
28595,U32445,29,5381.940000000002,18,11,60429.63,65811.57
28596,U23202,29,-6900.67,23,6,22800.47,15899.800000000001
28597,U14459,29,31256.04999999999,17,12,187491.02000000002,218747.07
28598,U38093,29,62.56,27,2,345.0,407.56
28599,U38287,29,771.860000000001,23,6,10446.35,11218.210000000001
28600,U18467,29,9682.900000000029,16,13,357718.83999999997,367401.74
28601,U8377,29,26239.149999999998,13,16,62096.86,88336.01
28602,U43912,29,50117.68999999992,16,13,844825.44,894943.1299999999
28603,U27708,29,-10218.209999999997,23,6,28546.65,18328.440000000002
28604,U14752,29,-107286.80999999994,16,13,1000444.98,893158.17
28605,U32836,29,2296.6099999999997,23,6,3608.86,5905.469999999999
28606,U17646,29,-30688.36,23,6,88305.43000000001,57617.07000000001
28607,U39918,29,-779.4000000000015,20,9,33592.270000000004,32812.87
28608,U22686,29,126.57999999999949,20,9,13373.439999999999,13500.019999999999
28609,U35543,29,17328.51,22,7,8097.82,25426.329999999998
28610,U23521,29,10005.500000000005,11,18,103072.58,113078.08
28611,U936066,29,502.98,15,14,10997.02,11500.0
28612,U918349,29,197.47000000000003,26,3,1202.63,1400.1000000000001
28613,U10711,29,3006.01,23,6,15040.17,18046.18
28614,U1237521,29,766.5,21,8,2023.7600000000002,2790.26
28615,U34828,29,6338.950000000001,16,13,30740.64,37079.59
28616,U33123,29,137395.16000000024,6,23,4560000.0,4697395.16
28617,U16003,29,-14195.689999999999,17,12,34219.08,20023.390000000003
28618,U1351774,29,1157.3399999999992,16,13,49356.950000000004,50514.29
28619,U16944,29,-182.05000000004657,11,18,4295297.0,4295114.95
28620,U23052,28,54427.58,10,18,33075.16,87502.74
28621,U41153,28,-506.9899999999999,23,5,1285.4099999999999,778.42
28622,U21597,28,13848.920000000011,13,15,224734.22999999998,238583.15
28623,U30083,28,-15839.489999999996,19,9,40300.52,24461.03
28624,U11677,28,-5922.679999999999,19,9,16083.99,10161.310000000001
28625,U953921,28,2621.5199999999995,21,7,4339.849999999999,6961.369999999999
28626,U36201,28,0.00999999999476131,17,11,118637.0,118637.01
28627,U33742,28,20894.000000000015,11,17,446596.0,467490.0
28628,U41612,28,-257.18000000000006,21,7,4185.24,3928.0599999999995
28629,U32156,28,-174816.97,14,14,591441.62,416624.65
28630,U28170,28,5184.040000000001,20,8,14347.900000000001,19531.940000000002
28631,U24780,28,-848.9100000000004,25,3,7582.84,6733.929999999999
28632,U33927,28,13337.469999999998,21,7,19140.609999999997,32478.079999999994
28633,U25397,28,-186.31999999996273,16,12,3660876.36,3660690.04
28634,U27870,28,-17604.54,24,4,25005.02,7400.48
28635,U825007,28,-5892.53,18,10,21347.950000000004,15455.420000000006
28636,U27957,28,-6051.289999999999,23,5,10257.320000000002,4206.0300000000025
28637,U15964,28,16173.55,17,11,7026.469999999999,23200.019999999997
28638,U24250,28,143.82999999999998,20,8,9936.98,10080.81
28639,U17837,28,13066.730000000001,11,17,73897.0,86963.73
28640,U26076,28,-23336.82,12,16,308170.27999999997,284833.45999999996
28641,U38762,28,1501.6200000000006,21,7,1771.2099999999998,3272.8300000000004
28642,U18000,28,12067.350000000002,21,7,478.82,12546.170000000002
28643,U21007,28,-287.76999999999987,16,12,8885.87,8598.1
28644,U38998,28,-124520.25000000003,17,11,470478.15,345957.9
28645,U36307,28,-12809.13,22,6,16663.97,3854.840000000002
28646,U28305,28,23662.539999999994,19,9,627292.9999999999,650955.5399999999
28647,U17593,28,43995.85999999978,16,12,1053578.79,1097574.65
28648,U21037,28,-521.3199999999997,20,8,11443.8,10922.48
28649,U36772,28,403.47000000000025,24,4,3359.42,3762.8900000000003
28650,U35527,28,7399.540000000001,20,8,10328.5,17728.04
28651,U26197,28,-2983.78,19,9,10240.769999999999,7256.989999999998
28652,U42530,28,-1591.46,22,6,6547.58,4956.12
28653,U35908,28,2931.8099999999995,24,4,25196.28,28128.089999999997
28654,U948627,28,-4788.959999999999,21,7,5695.44,906.4800000000005
28655,U13642,28,1513.5999999999985,21,7,108404.5,109918.1
28656,U23687,28,3685.15,23,5,1946.56,5631.71
28657,U30160,28,7038.939999999995,18,10,94284.11,101323.04999999999
28658,U15169,28,-22473.199999999997,25,3,159555.4,137082.2
28659,U42590,28,2026.5700000000008,20,8,25982.760000000002,28009.33
28660,U42609,28,-7820.950000000001,17,11,38580.1,30759.149999999998
28661,U11066,28,497059.79999999993,14,14,566415.98,1063475.7799999998
28662,U18045,28,-25002.5,22,6,143837.0,118834.5
28663,U31680,28,-164630.22,23,5,206653.54,42023.32000000001
28664,U1164940,28,12031.380000000001,13,15,5896.53,17927.91
28665,U30566,28,30172.549999999996,20,8,50651.78000000001,80824.33000000002
28666,U986297,28,9300.0,9,19,8704.54,18004.54
28667,U12750,28,92.44999999999999,25,3,180.18,272.63
28668,U32336,28,-28975.409999999996,21,7,122003.64,93028.23000000001
28669,U25629,28,-45.139999999998835,21,7,22346.4,22301.260000000002
28670,U35009,28,189970.43999999994,19,9,768996.26,958966.7
28671,U9160,28,-137471.22,15,13,263397.9,125926.68000000002
28672,U27127,28,256736.0,19,9,109690.3,366426.3
28673,U36035,28,-97788.51000000001,16,12,327027.0,229238.49
28674,U41020,28,-2260.8499999999995,19,9,41236.97,38976.12
28675,U36382,28,183.7200000000002,24,4,13319.22,13502.939999999999
28676,U29855,28,-174308.74,17,11,510697.7,336388.96
28677,U36112,28,-148.79000000000232,16,12,32079.59,31930.8
28678,U9032,28,7926.250000000002,22,6,6267.46,14193.710000000003
28679,U18420,28,-468.5799999999999,23,5,46233.03,45764.45
28680,U43872,28,11725.209999999997,17,11,232122.99,243848.19999999998
28681,U27584,28,-529.1599999999962,11,17,106260.47999999998,105731.31999999998
28682,U23535,28,967.3500000000001,20,8,3117.3999999999996,4084.75
28683,U14215,28,27456.870000000003,15,13,141550.55999999997,169007.42999999996
28684,U18558,28,82.20000000000016,22,6,3007.17,3089.3700000000003
28685,U16882,28,789.8600000000125,16,12,199768.31999999998,200558.18
28686,U28384,28,3414.6100000000015,21,7,5600.13,9014.740000000002
28687,U39537,28,-16220.060000000007,12,16,84683.94,68463.87999999999
28688,U11522,28,9090.899999999994,19,9,164397.77,173488.66999999998
28689,U15833,28,19812.820000000007,18,10,27598.809999999998,47411.630000000005
28690,U25505,28,10709.369999999999,17,11,71688.95999999998,82398.32999999997
28691,U43258,28,1143.7799999999995,18,10,15965.9,17109.68
28692,U9857,28,11441.149999999994,19,9,360514.37,371955.52
28693,U35779,28,5987.099999999995,14,14,130869.4,136856.5
28694,U20746,28,-4108.64,26,2,10030.649999999994,5922.009999999994
28695,U26445,28,-1877.1299999999746,15,13,324664.2,322787.07000000007
28696,U31963,28,2337.9700000000053,16,12,209200.0,211537.97
28697,U34114,28,377.1199999999999,23,5,4468.18,4845.3
28698,U23207,28,28706.240000000005,6,22,36441.06,65147.3
28699,U42448,28,3791.8399999999983,13,15,37378.82,41170.659999999996
28700,U43678,28,-46205.520000000004,20,8,128343.31,82137.79
28701,U21738,28,3599.1299999999974,23,5,28408.76,32007.889999999996
28702,U11429,28,19903.64,15,13,98128.02000000002,118031.66000000002
28703,U36532,28,-20741.280000000002,13,15,90515.52,69774.24
28704,U39939,28,-641092.5400000002,18,10,850556.7100000001,209464.16999999993
28705,U1009243,28,-3666.1800000000007,20,8,4907.68,1241.4999999999995
28706,U24994,28,-40054.56,20,8,49087.880000000005,9033.320000000007
28707,U33190,28,966.2299999999987,23,5,30301.86,31268.09
28708,U20792,28,1.2200000000125328,11,17,141162.41999999998,141163.63999999998
28709,U23007,28,-206.7099999999191,20,8,186411.81999999998,186205.11000000004
28710,U10662,28,-996.5000000000002,23,5,4257.62,3261.12
28711,U12349,28,667.8500000000004,20,8,8104.099999999999,8771.95
28712,U26162,28,-17060.599999999995,24,4,58046.2,40985.600000000006
28713,U1133965,28,-146.66000000000008,21,7,4553.3,4406.64
28714,U19955,28,-424.8299999999999,22,6,37728.08,37303.25
28715,U29274,28,1918.6399999999994,15,13,8343.5,10262.14
28716,U15065,28,-10415.040000000008,11,17,482428.71,472013.67000000004
28717,U9427,28,-1941.0499999999997,16,12,40029.49,38088.439999999995
28718,U8841,28,16144.159999999996,14,14,52768.62,68912.78
28719,U42441,28,25832.809999999998,10,18,39935.45,65768.26
28720,U42497,28,1028.4500000000003,19,9,16223.199999999999,17251.649999999998
28721,U30938,28,5021.749999999998,14,14,557018.01,562039.76
28722,U1142587,28,-25641.49,19,9,44808.39,19166.899999999998
28723,U29602,28,-525.330000000002,19,9,29466.050000000003,28940.72
28724,U36582,28,-0.819999999999709,13,15,62723.0,62722.18
28725,U1139581,28,-9683.43,22,6,14033.640000000001,4350.210000000001
28726,U583910,28,-2933.0,21,7,7547.43,4614.43
28727,U10802,28,-1322.5999999999995,20,8,34449.54,33126.94
28728,U30657,28,-8764.270000000004,20,8,35657.37,26893.1
28729,U28219,28,238.86000000000058,16,12,19039.27,19278.13
28730,U12363,28,41815.58999999989,19,9,575010.7000000001,616826.2899999999
28731,U17970,28,581.71,22,6,8483.439999999999,9065.149999999998
28732,U42943,28,-1688.4800000000005,15,13,31695.9,30007.420000000002
28733,U20388,28,-19722.219999999994,22,6,72288.7,52566.48
28734,U31801,28,-41035.17,19,9,458426.41000000003,417391.24000000005
28735,U22012,28,-451.6800000000003,19,9,16839.879999999997,16388.199999999997
28736,U1195876,28,-3574.859999999997,21,7,87138.59000000001,83563.73000000001
28737,U19230,28,3908.8500000000004,20,8,66740.9,70649.75
28738,U23018,28,-899.1800000000003,20,8,73565.7,72666.51999999999
28739,U30003,28,-277567.61,18,10,611687.87,334120.26
28740,U14372,28,1828.719999999999,18,10,120225.2,122053.92
28741,U10223,28,-35980.12999999989,10,18,6695005.0,6659024.87
28742,U741324,28,-0.46999999999985675,15,13,4914.47,4914.0
28743,U22793,28,-38177.03,19,9,51321.47,13144.440000000002
28744,U23758,28,21873.070000000065,15,13,1403139.0,1425012.07
28745,U20243,28,-650.9100000000108,17,11,402990.02,402339.11
28746,U23523,28,7346.020000000019,15,13,454835.08999999997,462181.11
28747,U43600,28,-1200.31,17,11,36394.25,35193.94
28748,U41079,28,-62857.94,18,10,90005.72,27147.78
28749,U31446,28,-86.05000000000001,24,4,363.21,277.15999999999997
28750,U32808,28,-520.8499999999985,20,8,75392.0,74871.15
28751,U18233,28,959.1499999999999,26,2,2649.2200000000003,3608.37
28752,U983617,28,-7393.699999999999,16,12,26166.899999999998,18773.199999999997
28753,U35475,28,-102937.13,20,8,312210.2,209273.07
28754,U38003,28,8809.850000000002,12,16,152231.06,161040.91
28755,U38900,28,41004.73,8,20,11500.0,52504.73
28756,U14549,28,86287.53999999976,11,17,3236187.9899999998,3322475.5299999993
28757,U1097779,28,925.4999999999991,23,5,8347.41,9272.91
28758,U23685,28,2266.56,23,5,6743.04,9009.6
28759,U21666,28,1500.0800000000004,17,11,5797.629999999999,7297.709999999999
28760,U16668,28,2.0000000000000924,13,15,9620.49,9622.49
28761,U10057,28,12432.25,19,9,31843.36,44275.61
28762,U42939,28,-1213.0800000000017,13,15,56651.6,55438.52
28763,U22522,28,1665.160000000041,17,11,432666.61,434331.77
28764,U26515,28,192999.78999999998,16,12,100211.0,293210.79
28765,U10966,28,-4340.660000000001,22,6,38374.590000000004,34033.93
28766,U25374,28,156.02999999998838,18,10,159457.96999999997,159613.99999999997
28767,U13910,28,-1198870.5,15,13,2044586.85,845716.3500000001
28768,U37415,28,609.8699999999976,15,13,177683.1,178292.97
28769,U10121,28,219568.03,19,9,70531.5,290099.53
28770,U13091,28,47184.35999999999,13,15,403225.49,450409.85
28771,U18354,28,78901.51999999999,17,11,104471.11,183372.63
28772,U26217,28,-11831.25,15,13,136361.90000000002,124530.65000000002
28773,U24130,28,-12168.9,22,6,34780.87,22611.97
28774,U811273,28,-563.92,20,8,3378.69,2814.77
28775,U21943,28,-6647.72,22,6,23648.85,17001.129999999997
28776,U704608,28,-7.130000000000109,17,11,18575.5,18568.37
28777,U970720,28,-2687.7400000000002,24,4,5018.17,2330.43
28778,U41738,28,-7861.279999999999,14,14,118895.24,111033.96
28779,U19067,28,16716.85,13,15,37447.3,54164.15
28780,U23750,28,-280.97999999999956,15,13,87793.0,87512.02
28781,U30784,28,-5733.5,21,7,19031.41,13297.91
28782,U35680,28,2758.2000000000003,24,4,2723.2400000000002,5481.4400000000005
28783,U38177,28,4688.439999999997,16,12,232421.0,237109.44
28784,U11053,28,55269.26000000001,9,19,81624.5,136893.76
28785,U14685,28,-29436.450000000004,19,9,121249.21999999997,91812.76999999996
28786,U22586,28,-1256.99,25,3,2303.6400000000003,1046.6500000000003
28787,U22813,28,2769.33,22,6,5243.5,8012.83
28788,U42521,28,4543.96,20,8,71011.18,75555.14
28789,U37165,28,-965.2799999999991,16,12,21222.56,20257.280000000002
28790,U593081,28,3153.87,14,14,11161.14,14315.009999999998
28791,U703919,28,0.05999999999994543,12,16,4650.0,4650.0599999999995
28792,U717007,28,-57301.149999999994,26,2,60117.799999999996,2816.6500000000015
28793,U31888,28,-10127.800000000003,16,12,222109.61000000002,211981.81
28794,U18963,28,7993.58,17,11,4017.5200000000004,12011.1
28795,U37741,28,-3717.7000000000007,21,7,6947.3,3229.5999999999995
28796,U37528,28,-532.1900000000005,20,8,20142.75,19610.559999999998
28797,U20402,28,108756.39000000001,16,12,138336.00999999995,247092.39999999997
28798,U24336,28,-10012.190000000002,13,15,137935.0,127922.81
28799,U19165,28,27839.04,21,7,13350.91,41189.95
28800,U37862,28,9315.439999999999,14,14,53190.3,62505.740000000005
28801,U42237,28,-28.24000000000001,21,7,2348.29,2320.05
28802,U35496,28,5780.629999999997,19,9,34851.65,40632.28
28803,U11633,28,-1604.25,25,3,3549.9100000000003,1945.6600000000003
28804,U39704,28,-2225.41,19,9,11760.24,9534.83
28805,U39291,28,-255015.59999999998,14,14,521079.56,266063.96
28806,U35907,28,-83.05000000000058,19,9,19786.259999999987,19703.20999999999
28807,U13321,28,7885.000000000002,16,12,30942.98,38827.98
28808,U11993,28,-6810.59,21,7,21232.31,14421.720000000001
28809,U37324,28,-3315.0,19,9,663951.25,660636.25
28810,U20159,28,-68533.44,19,9,181645.46,113112.01999999999
28811,U42192,28,-288.12,21,7,2498.8,2210.6800000000003
28812,U19434,28,-54879.44,25,3,88203.74,33324.3
28813,U16325,28,-110848.10999999997,12,16,414244.98999999993,303396.87999999995
28814,U31944,28,-6.449999999999989,14,14,58852.8,58846.350000000006
28815,U23954,28,-29.519999999999982,4,24,53330.0,53300.48
28816,U33150,28,-6351.43,20,8,31956.13,25604.7
28817,U30081,28,0.0099999999965803,18,10,49229.64,49229.649999999994
28818,U22266,28,-5119.360000000005,17,11,49768.130000000005,44648.77
28819,U16440,28,-1227.029999999997,22,6,20225.6,18998.57
28820,U36865,28,-41948.680000000015,21,7,118425.95999999999,76477.27999999997
28821,U25732,28,16469.979999999996,15,13,222350.67,238820.65000000002
28822,U43178,28,-20160.91,25,3,21177.33,1016.4200000000019
28823,U23700,28,641.3900000000026,21,7,29970.18999999999,30611.579999999994
28824,U38467,28,65491.999999999985,15,13,100988.99,166480.99
28825,U33710,28,20524.659999999996,20,8,100791.54,121316.19999999998
28826,U40964,28,14021.130000000005,19,9,719586.25,733607.38
28827,U25370,28,12993.73000000004,9,19,423109.92,436103.65
28828,U27221,28,1578.0199999999766,17,11,161057.13000000006,162635.15000000005
28829,U9999,28,1717.5900000000001,19,9,61221.920000000006,62939.51000000001
28830,U1111840,28,-9136.369999999999,21,7,18440.879999999997,9304.509999999998
28831,U18136,28,-39644.840000000004,13,15,89997.23999999998,50352.39999999997
28832,U11990,28,-56653.94000000006,12,16,3814705.0,3758051.06
28833,U13872,28,6257.43,21,7,31440.41,37697.84
28834,U36149,28,2218.5700000000015,20,8,37858.049999999996,40076.619999999995
28835,U37858,28,31.590000000000146,18,10,24381.150000000005,24412.740000000005
28836,U1333182,28,-328.1800000000016,18,10,29021.28,28693.1
28837,U12117,28,284350.6700000001,20,8,2105634.5999999996,2389985.2699999996
28838,U31521,28,9577.449999999832,12,16,3092010.79,3101588.2399999998
28839,U28789,28,6421.210000000001,19,9,17424.600000000002,23845.810000000005
28840,U1108492,28,47.67000000000026,21,7,8261.789999999999,8309.46
28841,U39480,28,-2720.6000000000204,11,17,11850000.0,11847279.4
28842,U21316,28,3441.4400000000005,19,9,10540.489999999998,13981.929999999998
28843,U29567,28,4465.69,22,6,10689.6,15155.29
28844,U33239,28,6771.84,20,8,22883.77,29655.61
28845,U1187519,28,-7003.47,23,5,26341.719999999994,19338.249999999993
28846,U23071,28,-19002.24,21,7,87092.25,68090.01
28847,U37952,28,2033.8799999999976,18,10,35945.01,37978.89
28848,U27132,28,-617.3599999999934,14,14,120710.44,120093.08
28849,U17455,28,-1012.9499999999534,13,15,3503974.6,3502961.6500000004
28850,U31313,28,-592.9300000000005,24,4,6998.089999999999,6405.159999999999
28851,U28005,28,1468.35,19,9,17900.02,19368.37
28852,U751951,28,-492.7099999999998,16,12,8507.34,8014.63
28853,U26793,28,279.8699999999808,12,16,342344.82000000007,342624.69000000006
28854,U27435,28,-5579.33,23,5,25808.94,20229.61
28855,U43083,28,-2349.9900000000007,19,9,34665.040000000015,32315.050000000014
28856,U20561,28,3670.49,22,6,22921.800000000003,26592.29
28857,U13768,28,167844.38999999998,8,20,181684.06,349528.44999999995
28858,U28650,28,5784.430000000011,22,6,27277.259999999987,33061.69
28859,U10767,28,350.40999999999985,17,11,62281.36,62631.770000000004
28860,U1092549,28,-1448.42,14,14,7889.299999999999,6440.879999999999
28861,U17888,28,2706.2700000000036,11,17,466429.73,469136.0
28862,U38428,28,-100506.92,19,9,258291.89,157784.97000000003
28863,U15339,28,858682.36,18,10,105729.59,964411.95
28864,U39668,28,-26645.180000000008,18,10,471308.39,444663.21
28865,U38624,28,45720.39,15,13,293831.27,339551.66000000003
28866,U14533,28,23792.639999999956,19,9,546740.0199999999,570532.6599999999
28867,U34047,28,16703.920000000002,19,9,51811.0,68514.92
28868,U8358,28,-9096.889999999983,16,12,82175.5,73078.61000000002
28869,U20406,28,4205.800000000001,23,5,20292.55,24498.35
28870,U1182104,28,-25855.459999999995,25,3,37755.67999999999,11900.219999999998
28871,U1075042,28,-1714.5299999999988,25,3,10415.609999999999,8701.08
28872,U20602,28,27819.319999999992,15,13,174469.86,202289.18
28873,U8029,28,-324.87999999999965,17,11,22168.500000000004,21843.620000000003
28874,U26299,28,-7471.239999999998,20,8,39590.240000000005,32119.000000000007
28875,U41617,28,0.05,12,16,140001.83000000002,140001.88
28876,U38383,28,-110.26999999999589,9,19,516846.52,516736.25
28877,U26495,28,-37471.49999999999,23,5,68820.51,31349.010000000002
28878,U15849,28,49771.920000000006,16,12,286368.51999999996,336140.43999999994
28879,U40139,28,-43501.24000000038,9,19,23736574.830000002,23693073.59
28880,U578597,28,1607.9799999999996,19,9,8623.41,10231.39
28881,U36575,28,-157.91000000000008,18,10,1606.07,1448.1599999999999
28882,U10299,28,519.7999999999965,25,3,9580.200000000003,10100.0
28883,U20204,28,-43698.380000000005,22,6,144735.38,101037.0
28884,U19602,28,-13739.979999999996,18,10,110151.40999999999,96411.43
28885,U34950,28,-11904.370000000006,19,9,223943.49000000002,212039.12000000002
28886,U27569,28,-155.36999999999898,17,11,50730.8,50575.43000000001
28887,U662807,28,0.019999999999666045,18,10,5719.8200000000015,5719.840000000001
28888,U28600,28,2639.66,20,8,19653.1,22292.76
28889,U9170,28,-29968.059999999998,22,6,59900.06999999999,29932.009999999995
28890,U9384,28,-24848.909999999996,19,9,46947.40000000001,22098.490000000013
28891,U18508,28,-1573.0799999999927,11,17,917767.6,916194.52
28892,U32007,28,2015.079999999999,16,12,12302.999999999998,14318.079999999998
28893,U42485,28,42420.19000000006,18,10,1277659.78,1320079.9700000002
28894,U42240,28,4250.949999999997,18,10,67282.39000000001,71533.34000000001
28895,U27912,28,9808.390000000001,12,16,63334.950000000004,73143.34000000001
28896,U41047,28,144228.77,20,8,109696.03000000001,253924.8
28897,U750475,28,-8200.650000000001,22,6,16654.4,8453.75
28898,U584370,28,3.080000000000325,16,12,8381.93,8385.01
28899,U8482,28,11013.199999999997,11,17,22075.819999999992,33089.01999999999
28900,U43249,28,18.71000000000032,19,9,5994.87,6013.58
28901,U22065,28,-2745.6700000000037,13,15,31886.9,29141.229999999996
28902,U22838,28,856.1999999999996,16,12,41273.020000000004,42129.22
28903,U18793,28,-39914.49000000004,16,12,2105828.0,2065913.51
28904,U29886,28,-38771.200000000004,22,6,165356.46,126585.25999999998
28905,U777235,28,-2339.1799999999994,19,9,27278.27,24939.09
28906,U13045,28,-1221.8900000000006,17,11,14721.26,13499.369999999999
28907,U8990,28,-2995.939999999995,19,9,57259.44,54263.50000000001
28908,U1121416,28,1819.1199999999994,16,12,15111.240000000002,16930.36
28909,U38878,28,4081.540000000001,17,11,26981.99,31063.530000000002
28910,U30840,28,-17222.8,21,7,111996.8,94774.0
28911,U33470,28,809.23,17,11,21818.0,22627.23
28912,U23254,28,-14327.700000000003,7,21,55411.93,41084.229999999996
28913,U39392,28,-94293.56,15,13,136033.09000000003,41739.53000000003
28914,U43038,27,5308.210000000068,17,10,675730.33,681038.54
28915,U22042,27,30798.2,20,7,209626.45,240424.65000000002
28916,U39527,27,14165.969999999998,16,11,67566.4,81732.37
28917,U35149,27,1077.5399999999984,14,13,102856.53000000001,103934.07
28918,U34369,27,6412.370000000001,20,7,11124.16,17536.53
28919,U37501,27,-518.5999999999999,19,8,2614.3099999999995,2095.7099999999996
28920,U1103879,27,2194.7800000000007,16,11,12898.0,15092.78
28921,U17989,27,7986.91,15,12,6524.419999999999,14511.329999999998
28922,U41717,27,-4877.4,21,6,7373.38,2495.9800000000005
28923,U16249,27,61545.34,15,12,290970.0,352515.33999999997
28924,U24976,27,36365.74000000001,16,11,42737.149999999994,79102.89000000001
28925,U39545,27,-17212.21,12,15,83204.70000000001,65992.49000000002
28926,U28817,27,-478.5400000000001,22,5,20769.199999999997,20290.659999999996
28927,U31266,27,145106.28,7,20,515059.02,660165.3
28928,U725523,27,3837.8200000000006,19,8,9682.18,13520.0
28929,U18190,27,23132.099999999977,15,12,616062.96,639195.0599999999
28930,U18856,27,-1715.75,21,6,4870.48,3154.7299999999996
28931,U22516,27,-6350.01,20,7,15144.89,8794.88
28932,U26343,27,95101.28999999998,11,16,318285.37,413386.66
28933,U8253,27,-4103.33,22,5,7705.91,3602.58
28934,U38598,27,-2871.0800000000017,11,16,109325.0,106453.92
28935,U40199,27,21873.629999999997,15,12,41632.0,63505.63
28936,U33249,27,-47833.63000000001,14,13,383546.54,335712.91
28937,U17018,27,1586.979999999989,14,13,496223.8399999999,497810.8199999999
28938,U24521,27,9155.02,18,9,49145.0,58300.020000000004
28939,U17932,27,2605.7200000000025,16,11,1621541.7,1624147.42
28940,U1153841,27,-16446.989999999998,21,6,19205.319999999996,2758.329999999998
28941,U37219,27,-35983.17999999999,23,4,37645.21,1662.030000000006
28942,U25331,27,-18854.989999999994,16,11,85657.71,66802.72000000002
28943,U32356,27,34950.81999999999,19,8,31568.979999999996,66519.79999999999
28944,U13822,27,4041.529999999998,17,10,96464.15999999999,100505.68999999999
28945,U16592,27,-682.2799999999986,20,7,20450.14,19767.86
28946,U23609,27,6837.8399999999965,23,4,343169.02,350006.86
28947,U21473,27,44023.69,16,11,45993.76,90017.45000000001
28948,U35282,27,-189.11000000000013,20,7,4258.98,4069.8699999999994
28949,U19309,27,15088.229999999996,19,8,128153.56999999999,143241.8
28950,U40201,27,2084.279999999999,18,9,74822.16,76906.44
28951,U43078,27,-25738.189999999995,20,7,60275.82000000001,34537.63000000001
28952,U971835,27,14787.380000000001,10,17,18717.0,33504.380000000005
28953,U16648,27,-1632.67,22,5,9869.699999999999,8237.029999999999
28954,U28774,27,1569.2000000000007,21,6,12274.82,13844.02
28955,U27527,27,4913.179999999997,19,8,21039.919999999995,25953.09999999999
28956,U36922,27,-9714.609999999999,18,9,32720.77,23006.160000000003
28957,U20617,27,-222.09000000000015,20,7,11587.39,11365.3
28958,U690116,27,829.22,9,18,1005.6600000000001,1834.88
28959,U32152,27,165.51,16,11,1114.93,1280.44
28960,U41459,27,51115.869999999995,12,15,63887.84,115003.70999999999
28961,U21397,27,634.1999999999989,19,8,13921.469999999998,14555.669999999996
28962,U14148,27,-11920.979999999998,17,10,45277.64,33356.66
28963,U16994,27,-27167.540000000008,15,12,236380.75,209213.21
28964,U26465,27,-1209.8799999999974,11,16,69980.3,68770.42000000001
28965,U672026,27,-1373.54,17,10,8939.23,7565.69
28966,U36938,27,-38629.96000000001,22,5,41386.96000000001,2757.0
28967,U26238,27,-54369.84999999999,17,10,174846.13,120476.28000000001
28968,U42504,27,7143.4400000000005,22,5,1529.5199999999998,8672.960000000001
28969,U17516,27,-14234.930000000002,17,10,123902.40000000001,109667.47
28970,U11356,27,46911.96,20,7,3668.4,50580.36
28971,U41574,27,3824.2800000000007,22,5,6310.67,10134.95
28972,U22217,27,3158.880000000001,22,5,4037.4500000000003,7196.330000000002
28973,U41509,27,9338.80999999973,23,4,2580000.0000000005,2589338.81
28974,U37449,27,124434.60000000002,11,16,23387.0,147821.60000000003
28975,U20592,27,-1576.8499999999997,16,11,87811.78,86234.93
28976,U32148,27,-54886.55000000002,13,14,297552.5,242665.94999999998
28977,U27296,27,-485.4100000000001,22,5,6888.889999999999,6403.48
28978,U43149,27,8405.18,15,12,60378.5,68783.68
28979,U42550,27,-17494.329999999998,21,6,55181.0,37686.67
28980,U29980,27,-202885.96,15,12,231220.03,28334.070000000007
28981,U17054,27,-69464.09999999999,14,13,4319946.18,4250482.08
28982,U38375,27,1175.7500000000005,20,7,6650.4800000000005,7826.230000000001
28983,U8173,27,-48342.69,15,12,92221.34,43878.649999999994
28984,U15269,27,9700.940000000004,18,9,154790.5,164491.44
28985,U12945,27,-7786.459999999997,18,9,24657.81,16871.350000000006
28986,U1248019,27,-4397.449999999999,17,10,51750.31,47352.86
28987,U17717,27,826.8199999999983,23,4,9380.279999999999,10207.099999999997
28988,U38053,27,-102549.87,14,13,158174.79,55624.92000000001
28989,U16594,27,47089.78,13,14,579226.82,626316.6
28990,U14542,27,-31142.049999999996,11,16,133677.15,102535.1
28991,U957599,27,-2360.42,24,3,3761.3,1400.88
28992,U13798,27,-1304.57,19,8,8506.83,7202.26
28993,U26954,27,-66890.98999999999,19,8,81933.86,15042.87000000001
28994,U13022,27,301981.47,10,17,9520236.0,9822217.47
28995,U24678,27,11584.939999999997,13,14,10204.880000000001,21789.82
28996,U22118,27,-3945.540000000008,16,11,262930.37,258984.83
28997,U20814,27,-1984.8300000000002,25,2,2303.2200000000003,318.3900000000001
28998,U24287,27,-480245.1199999998,12,15,1650420.7200000002,1170175.6000000003
28999,U22893,27,-16019.389999999998,22,5,55203.79,39184.4
29000,U41179,27,37024.79000000001,23,4,130902.1,167926.89
29001,U37382,27,1315.2699999999986,21,6,22969.04,24284.309999999998
29002,U28393,27,-24901.760000000002,13,14,79954.45,55052.689999999995
29003,U38939,27,8450.080000000009,21,6,173315.33,181765.41
29004,U29376,27,238.42000000000007,16,11,9126.05,9364.47
29005,U29620,27,6516.650000000001,22,5,10886.95,17403.600000000002
29006,U18933,27,7369.259999999995,13,14,160127.48,167496.74
29007,U34944,27,-763.3900000000049,11,16,333254.7,332491.31
29008,U40402,27,144359.52000000002,5,22,94300.0,238659.52000000002
29009,U20769,27,-3407.7800000000275,16,11,528586.0,525178.22
29010,U37337,27,-107455.92,21,6,115038.12999999999,7582.209999999992
29011,U18584,27,-745.58,20,7,2136.2,1390.62
29012,U23942,27,87476.99,20,7,10886.39,98363.38
29013,U26314,27,-140.03999999999996,21,6,2400.21,2260.17
29014,U41805,27,15638.94,21,6,42942.33,58581.270000000004
29015,U41140,27,-56989.24,22,5,73452.35,16463.110000000008
29016,U20534,27,24303.070000000003,12,15,44932.0,69235.07
29017,U15915,27,-301280.01,18,9,1031690.0,730409.99
29018,U21776,27,8143.5999999999985,19,8,65364.0,73507.6
29019,U1323037,27,10.640000000001237,18,9,13175.469999999998,13186.109999999999
29020,U33203,27,-4084.279999999999,16,11,43023.0,38938.72
29021,U10763,27,16564.920000000013,17,10,304849.33999999997,321414.26
29022,U29589,27,1474.9700000000003,20,7,11708.03,13183.0
29023,U11830,27,50975.099999999984,12,15,153296.52000000002,204271.62
29024,U33257,27,1116.100000000002,17,10,22584.78,23700.88
29025,U636331,27,-291.77,15,12,830.89,539.12
29026,U42875,27,3328.1600000000008,14,13,11483.039999999999,14811.2
29027,U41129,27,-15178.899999999994,25,2,44324.0,29145.100000000006
29028,U13584,27,-277.56999999999243,15,12,151483.55,151205.97999999998
29029,U1134090,27,-72.41,20,7,343.23,270.82000000000005
29030,U21557,27,4646.029999999999,15,12,403668.3,408314.32999999996
29031,U21220,27,59072.92999999999,22,5,98312.06999999999,157385.0
29032,U22371,27,-24557.539999999997,19,8,42991.84,18434.3
29033,U32790,27,1569.23,15,12,36547.24,38116.47
29034,U23063,27,4462.959999999999,18,9,17631.68,22094.64
29035,U16573,27,58581.72000000003,9,18,118145.14,176726.86000000004
29036,U32406,27,-579.9999999999987,18,9,21594.459999999995,21014.459999999995
29037,U28639,27,4800.5,17,10,29609.62,34410.119999999995
29038,U28181,27,-15231.639999999998,16,11,77200.0,61968.36
29039,U29744,27,-11373.269999999999,19,8,38887.200000000004,27513.930000000008
29040,U39344,27,-10676.899999999954,9,18,2603500.86,2592823.96
29041,U1323741,27,-0.9100000000180444,16,11,118154.72000000002,118153.81
29042,U1335740,27,-4087.7499999999995,24,3,4721.310000000001,633.5600000000018
29043,U986150,27,27030.300000000017,23,4,10153.87,37184.17000000002
29044,U38270,27,3313.87000000001,12,15,95726.0,99039.87000000001
29045,U12728,27,100.27999999999884,15,12,69190.0,69290.28
29046,U8710,27,-26210.639999999992,18,9,177116.13999999998,150905.5
29047,U40796,27,8073.889999999998,17,10,33440.880000000005,41514.770000000004
29048,U13352,27,-2832.2999999999997,22,5,7735.59,4903.290000000001
29049,U14918,27,-118222.02000000002,20,7,280260.61,162038.58999999997
29050,U26504,27,-216033.43999999997,22,5,238173.08,22139.640000000014
29051,U39558,27,9307.809999999996,21,6,112301.0,121608.81
29052,U8139,27,7337.330000000001,17,10,18389.270000000004,25726.600000000006
29053,U15134,27,-355683.13999999996,16,11,399270.31999999995,43587.17999999999
29054,U21954,27,-12377.25,19,8,25847.969999999994,13470.719999999994
29055,U39236,27,17584.389999999996,13,14,33202.04,50786.42999999999
29056,U25751,27,-10190.420000000002,21,6,64036.32000000001,53845.90000000001
29057,U32457,27,-1835.9999999999998,15,12,3753.56,1917.5600000000002
29058,U19801,27,99288.4,17,10,183700.0,282988.4
29059,U37365,27,-6517.43,20,7,30134.34,23616.91
29060,U1250183,27,-45.590000000000146,18,9,17952.35,17906.76
29061,U1135467,27,161.27999999999997,23,4,339.52,500.79999999999995
29062,U42598,27,-149716.69000000003,12,15,220690.46000000002,70973.76999999999
29063,U25981,27,8530.839999999993,11,16,101345.93,109876.76999999999
29064,U11578,27,122.40999999999099,19,8,57898.17999999999,58020.58999999998
29065,U41673,27,-100684.27999999998,11,16,1119783.0,1019098.72
29066,U9943,27,5415.700000000001,19,8,13363.310000000003,18779.010000000002
29067,U34073,27,5642.42,19,8,4354.98,9997.4
29068,U24630,27,-83.04000000000126,20,7,11882.780000000006,11799.740000000005
29069,U30407,27,57596.409999999996,13,14,300314.07,357910.48
29070,U16649,27,-1011.209999999993,20,7,111371.59999999999,110360.39
29071,U32789,27,36.56000000000131,18,9,18992.2,19028.760000000002
29072,U10329,27,-364.0300000000001,23,4,3014.8700000000013,2650.840000000001
29073,U22405,27,-4853.82,24,3,14553.18,9699.36
29074,U20268,27,8860.64,15,12,35339.369999999995,44200.009999999995
29075,U9950,27,2128.650000000009,10,17,437328.35,439457.0
29076,U11534,27,-0.2899999999990541,16,11,17729.82,17729.53
29077,U43957,27,494.4099999999744,17,10,494700.0,495194.41
29078,U29875,27,-2977.42,19,8,11677.699999999997,8700.279999999997
29079,U35842,27,-179.84999999997672,15,12,478160.89999999997,477981.05
29080,U19741,27,-6704.059999999999,19,8,49643.11000000001,42939.05000000001
29081,U27991,27,-5659.259999999999,25,2,10067.289999999999,4408.03
29082,U30597,27,1952.38,21,6,7136.17,9088.55
29083,U34506,27,-5836.13,25,2,10186.17,4350.04
29084,U18988,27,79913.12,10,17,159431.54,239344.66
29085,U22674,27,-160742.4,22,5,170860.97,10118.570000000007
29086,U16085,27,26024.820000000003,12,15,8126.389999999999,34151.21000000001
29087,U41428,27,16257.93,16,11,13772.109999999999,30030.04
29088,U34621,27,2866.1800000000003,19,8,26567.36,29433.54
29089,U19663,27,-58804.850000000006,17,10,233689.12,174884.27
29090,U10571,27,32.030000000000655,16,11,27428.34,27460.370000000003
29091,U26031,27,-13318.939999999999,23,4,15412.71,2093.7700000000004
29092,U12491,27,-3673.62,22,5,16479.749999999996,12806.129999999997
29093,U20488,27,829.9000000000001,20,7,25129.660000000003,25959.560000000005
29094,U41204,27,-307.6600000000017,22,5,36491.26,36183.6
29095,U26992,27,-380.3600000000006,17,10,23339.13,22958.77
29096,U990239,27,-11606.470000000003,20,7,16950.48,5344.009999999997
29097,U1200950,27,76.63000000000011,17,10,10167.439999999999,10244.07
29098,U12672,27,723.4100000000001,23,4,1724.1899999999998,2447.6
29099,U26686,27,-37305.19,19,8,79241.04,41935.84999999999
29100,U8535,27,-9391.640000000001,23,4,30346.37,20954.729999999996
29101,U9379,27,-2143.33,22,5,7228.160000000001,5084.830000000001
29102,U641540,27,220.90999999999997,20,7,6310.02,6530.93
29103,U15957,27,-10123.759999999998,19,8,71982.04000000001,61858.28000000001
29104,U10298,27,2290.79,22,5,9691.130000000001,11981.920000000002
29105,U11347,27,-1292.67,19,8,7960.889999999998,6668.2199999999975
29106,U28506,27,-14709.14,14,13,106685.34,91976.2
29107,U28537,27,-1382.0600000000022,19,8,46768.1,45386.03999999999
29108,U30803,27,10943.730000000001,24,3,4378.08,15321.810000000001
29109,U710154,27,-11231.19,19,8,25381.300000000003,14150.110000000002
29110,U20791,27,-50.3100000000004,13,14,28190.0,28139.69
29111,U9948,27,-4207.760000000002,19,8,38675.03,34467.27
29112,U17527,27,17789.010000000013,20,7,66778.60999999999,84567.62
29113,U39453,27,-42866.679999999986,11,16,671228.04,628361.3600000001
29114,U30651,27,48227.39999999994,16,11,342531.2,390758.6
29115,U20936,27,46250.95999999999,18,9,28639.129999999997,74890.09
29116,U10264,27,-2423.6499999999996,24,3,10880.130000000001,8456.480000000001
29117,U22394,27,-29886.11,22,5,52491.21,22605.1
29118,U29150,27,1605.9300000000003,19,8,10926.759999999998,12532.689999999999
29119,U19240,27,451.44000000000153,17,10,13872.73,14324.170000000002
29120,U34253,27,17051.04,16,11,54851.450000000004,71902.49
29121,U30238,27,12252.07,20,7,24039.91,36291.979999999996
29122,U31508,27,-6260.25,24,3,6969.25,709.0
29123,U25621,27,-2476.0499999999884,19,8,702557.46,700081.4099999999
29124,U664832,27,-0.6300000000000132,19,8,1499.6799999999998,1499.0499999999997
29125,U700105,27,-222.75999999999993,15,12,1607.0099999999998,1384.2499999999998
29126,U27116,27,-84645.05000000008,21,6,596460.2,511815.1499999999
29127,U23979,27,3035.2399999999993,11,16,5644984.609999999,5648019.85
29128,U8379,27,-53400.439999999995,12,15,130598.56,77198.12
29129,U825720,27,-1339.21,20,7,9901.87,8562.66
29130,U19270,27,653.7499999999964,17,10,59410.61000000001,60064.36
29131,U746918,27,2660.41,14,13,960.8299999999999,3621.24
29132,U607861,27,3719.5199999999995,14,13,18760.89,22480.41
29133,U20732,27,-2738.1,13,14,31728.690000000002,28990.590000000004
29134,U11843,27,-728.8900000000092,22,5,93206.56999999999,92477.67999999998
29135,U34898,27,5839.480000000003,16,11,46178.74,52018.22
29136,U666942,27,0.690000000000083,18,9,2131.8999999999996,2132.5899999999997
29137,U23468,27,-6024.810000000051,17,10,518355.95,512331.13999999996
29138,U10524,27,-3411.029999999998,19,8,39372.46,35961.43
29139,U898753,27,-9.759999999999991,21,6,1303.5,1293.74
29140,U22737,27,-125.41000000000008,20,7,11968.49,11843.08
29141,U1028815,27,57.330000000000155,14,13,4089.4300000000003,4146.76
29142,U14069,27,-10423.949999999953,18,9,887577.6000000001,877153.6500000001
29143,U10769,27,-16601.019999999993,13,14,100854.25000000001,84253.23000000003
29144,U27306,27,9778.25,20,7,9155.96,18934.21
29145,U10475,27,-12651.989999999998,17,10,87602.08,74950.09
29146,U9264,27,28418.399999999983,19,8,120466.99999999999,148885.39999999997
29147,U40056,27,7.06999999996653,15,12,426744.99,426752.05999999994
29148,U42669,27,31028.699999999983,15,12,221956.36,252985.05999999997
29149,U16053,27,3506.3400000000015,17,10,73598.40999999999,77104.74999999999
29150,U19980,27,100.54999999999927,16,11,29500.0,29600.55
29151,U9089,27,-25064.57,22,5,44298.090000000004,19233.520000000004
29152,U715805,27,1417.71,15,12,15116.59,16534.3
29153,U19418,27,-12019.189999999999,15,12,52940.229999999996,40921.03999999999
29154,U10137,27,250.42000000000388,14,13,66315.04000000001,66565.46
29155,U14174,27,-23268.359999999993,21,6,28676.389999999996,5408.0300000000025
29156,U25335,27,-369048.2000000001,19,8,403221.8100000001,34173.609999999986
29157,U1122335,27,-4131.75,25,2,4161.8,30.050000000000182
29158,U15263,27,7712.459999999963,15,12,2404572.52,2412284.98
29159,U28201,27,-1119.8999999999874,18,9,108329.59,107209.69
29160,U9566,27,-614.4699999999999,20,7,1011.2899999999998,396.81999999999994
29161,U29079,27,-13396.780000000002,16,11,45039.08,31642.3
29162,U34679,27,-20112.62999999991,8,19,2021204.98,2001092.35
29163,U12076,27,-16201.020000000004,16,11,93150.0,76948.98
29164,U20664,27,-87867.34999999999,17,10,250239.94,162372.59000000003
29165,U9603,27,-327.0700000000058,14,13,579413.97,579086.9
29166,U37785,27,2067.640000000001,14,13,98776.9,100844.54
29167,U1160852,27,-5066.91,19,8,9980.58,4913.67
29168,U13980,27,493.1200000000008,21,6,11889.5,12382.62
29169,U29443,27,7021.9100000000035,17,10,64393.74,71415.65
29170,U27434,27,14.640000000000235,23,4,7402.199999999999,7416.839999999999
29171,U28139,27,820.6299999999993,16,11,27052.140000000003,27872.770000000004
29172,U1168765,27,-617.7399999999998,17,10,14720.480000000001,14102.740000000002
29173,U591773,27,-4172.98,18,9,4987.83,814.8500000000004
29174,U33516,27,293.1700000000001,18,9,25840.45,26133.620000000003
29175,U22854,27,845.4400000000005,14,13,27844.86,28690.300000000003
29176,U36902,27,-75992.05,23,4,89807.9,13815.849999999991
29177,U902725,27,-6594.31,20,7,10234.310000000001,3640.000000000001
29178,U27635,27,-2290.6400000000003,17,10,26630.47,24339.83
29179,U22135,27,10071.270000000002,22,5,30387.59,40458.86
29180,U37568,27,-1247.9700000000037,15,12,77828.21,76580.24
29181,U15321,27,-1535.9199999999987,18,9,32083.75,30547.83
29182,U26597,27,-271.17,14,13,2984.0800000000004,2712.9100000000003
29183,U27667,27,-6193.589999999991,23,4,211790.0,205596.41
29184,U33095,27,956.0100000000002,12,15,28622.0,29578.010000000002
29185,U25278,27,-175.23999999999978,19,8,5389.4400000000005,5214.200000000001
29186,U40697,27,-635.1800000000003,15,12,116636.34999999999,116001.16999999998
29187,U11433,27,-571586.72,18,9,1027611.8699999999,456025.1499999999
29188,U37595,27,991.8800000000001,13,14,12144.5,13136.380000000001
29189,U27086,27,-38.260000000000105,13,14,3672.5299999999997,3634.2699999999995
29190,U37647,27,4747.589999999999,19,8,5749.820000000001,10497.41
29191,U15479,27,193196.17000000004,13,14,764447.52,957643.6900000001
29192,U38574,27,-43247.84999999999,22,5,54721.51999999999,11473.669999999998
29193,U21050,27,18573.74,16,11,31096.620000000003,49670.36
29194,U26302,27,-5065.25,18,9,17302.34,12237.09
29195,U779252,27,-2118.6499999999996,20,7,7518.0599999999995,5399.41
29196,U33496,27,4651.669999999999,22,5,14600.62,19252.29
29197,U43294,27,-4009.019999999994,21,6,102598.08999999998,98589.06999999999
29198,U25000,27,-917.3700000000026,12,15,132376.0,131458.63
29199,U40699,27,38762.579999999994,18,9,22518.859999999997,61281.43999999999
29200,U20703,27,128108.15,23,4,4285.37,132393.52
29201,U10052,27,15162.96,23,4,5295.82,20458.78
29202,U27709,27,-35805.74,22,5,65833.29,30027.549999999996
29203,U21171,27,-12436.140000000001,19,8,15808.4,3372.2599999999984
29204,U18554,27,-9698.160000000002,19,8,63003.0,53304.84
29205,U38781,27,-55983.979999999996,16,11,213166.0,157182.02000000002
29206,U36222,27,-340.9799999999959,15,12,145271.0,144930.02000000002
29207,U32551,27,-1228.5999999999913,15,12,102495.31,101266.71
29208,U31719,27,-6445.339999999999,21,6,20851.9,14406.560000000001
29209,U33553,27,-193153.21,21,6,198338.17999999996,5184.969999999972
29210,U31251,27,3005.6199999999994,19,8,7620.9400000000005,10626.56
29211,U23992,27,18050.339999999997,20,7,8400.779999999999,26451.119999999995
29212,U12014,27,1181.3500000000008,15,12,48246.5,49427.85
29213,U8083,27,-7829.47000000003,12,15,713939.6499999999,706110.1799999999
29214,U43735,27,10294.520000000019,15,12,494113.0,504407.52
29215,U37783,27,-4254.269999999999,22,5,23254.80999999999,19000.539999999994
29216,U1267965,27,0.9100000000005366,20,7,12849.8,12850.71
29217,U1078343,27,-0.7399999999997817,18,9,7086.4,7085.66
29218,U37317,27,-369.2599999999911,14,13,205757.05000000002,205387.79000000004
29219,U11482,27,5743.420000000002,14,13,38398.07,44141.490000000005
29220,U25085,27,-100.91000000000003,22,5,1997.66,1896.75
29221,U18294,27,-3037.98,20,7,12943.9,9905.92
29222,U35503,27,-3790.8600000000006,18,9,39401.54,35610.68
29223,U26514,27,-4505.5,21,6,5794.78,1289.2799999999997
29224,U32242,27,522.6900000000011,17,10,35554.50000000001,36077.19000000001
29225,U20245,27,15556.279999999993,22,5,29076.56,44632.84
29226,U39466,27,-34922.369999999995,21,6,218614.4,183692.03
29227,U18729,27,-39133.82000000001,17,10,100401.76000000001,61267.94
29228,U930105,27,-893.9800000000001,24,3,1392.9700000000003,498.9900000000001
29229,U32586,27,6401.610000000001,19,8,25517.260000000002,31918.870000000003
29230,U25701,27,-3660.7799999999993,21,6,29651.800000000007,25991.020000000008
29231,U637524,27,-10903.43,19,8,21013.21,10109.779999999999
29232,U24105,27,-3310.349999999999,23,4,9336.92,6026.5700000000015
29233,U17288,27,-8794.429999999998,22,5,14512.639999999998,5718.209999999999
29234,U26694,27,4057.69,19,8,19818.319999999996,23876.009999999995
29235,U30751,27,18226.71,18,9,93977.78,112204.48999999999
29236,U22940,27,6937.01,16,11,28065.410000000003,35002.420000000006
29237,U23365,27,-811.7700000000001,24,3,2431.0600000000004,1619.2900000000004
29238,U1070785,27,5420.280000000001,13,14,4901.42,10321.7
29239,U10906,27,-126671.74000000002,22,5,157556.75,30885.00999999998
29240,U1197759,27,-2860.3900000000003,16,11,22823.66,19963.27
29241,U13636,27,10268.599999999999,18,9,41386.03,51654.63
29242,U16459,27,2574.07,21,6,8114.16,10688.23
29243,U36463,27,125462.6,11,16,77819.0,203281.6
29244,U37463,27,-2185.539999999999,21,6,20686.6,18501.059999999998
29245,U23682,27,-2484.0899999999992,16,11,14557.21,12073.119999999999
29246,U33622,27,-50438.70999999999,22,5,102589.6,52150.890000000014
29247,U30473,27,55865.99999999986,21,6,1651954.8699999999,1707820.8699999996
29248,U40356,27,9067.259999999998,14,13,33152.39,42219.649999999994
29249,U35637,27,32924.02,18,9,32326.11,65250.13
29250,U15351,27,-118966.94,21,6,145856.25,26889.309999999998
29251,U8332,27,-10500.61,16,11,42781.64,32281.03
29252,U41531,26,-30010.119999999995,17,9,77743.48999999999,47733.369999999995
29253,U1172049,26,-15255.580000000002,26,0,15255.580000000002,0.0
29254,U10301,26,17.57999999999629,11,15,337255.0,337272.58
29255,U11296,26,467452.11,14,12,440592.93000000005,908045.04
29256,U13977,26,1604.2399999999907,14,12,1026879.47,1028483.71
29257,U40597,26,-151.5399999999995,20,6,22248.300000000003,22096.760000000002
29258,U32024,26,2788.1600000000017,21,5,39574.229999999996,42362.39
29259,U38315,26,60908.15000000001,11,15,35919.94,96828.09000000001
29260,U43223,26,138.98000000000025,20,6,3360.3999999999996,3499.38
29261,U41012,26,7834.95,20,6,4139.79,11974.74
29262,U31601,26,15922.989999999998,16,10,57153.12,73076.11
29263,U12506,26,-29390.870000000003,19,7,142638.1,113247.23000000001
29264,U24631,26,-802.0999999999999,13,13,6946.990000000001,6144.890000000001
29265,U14548,26,-8121.070000000001,20,6,8990.0,868.9299999999994
29266,U9731,26,-7317.430000000008,21,5,115543.5,108226.06999999999
29267,U38805,26,1791.1100000000001,15,11,4284.2,6075.3099999999995
29268,U8921,26,-9425.149999999998,21,5,40334.38,30909.23
29269,U34445,26,-4719.49,18,8,49915.030000000006,45195.54000000001
29270,U30396,26,1599.0,18,8,11601.0,13200.0
29271,U30443,26,-808478.0500000002,12,14,1226926.61,418448.55999999994
29272,U31596,26,2856.78,16,10,5619.109999999999,8475.89
29273,U23410,26,-10737.489999999976,19,7,417882.54999999993,407145.05999999994
29274,U20379,26,-237830.21999999997,10,16,485890.0,248059.78000000003
29275,U8031,26,1925.4099999999996,21,5,6137.8,8063.21
29276,U26414,26,-1054.7800000000007,20,6,29107.519999999997,28052.739999999998
29277,U23987,26,-10185.009999999998,18,8,26203.61,16018.600000000002
29278,U1183419,26,-5849.879999999999,20,6,20010.16,14160.28
29279,U32544,26,-633.269999999999,18,8,32083.300000000007,31450.030000000006
29280,U18236,26,5023.31,20,6,15697.689999999999,20721.0
29281,U26120,26,-6951.79,20,6,11540.769999999999,4588.979999999999
29282,U9294,26,28194.960000000003,14,12,14323.2,42518.16
29283,U31977,26,150.3099999999999,23,3,5850.7,6001.009999999999
29284,U27971,26,-3758.0099999999975,12,14,294421.14,290663.13
29285,U705906,26,65.51999999999998,17,9,5311.71,5377.23
29286,U28416,26,9975.449999999999,15,11,15481.0,25456.449999999997
29287,U31139,26,-98.28000000000156,18,8,20648.62,20550.339999999997
29288,U8106,26,-772.0700000000027,17,9,87672.84,86900.76999999999
29289,U993546,26,-8420.509999999998,19,7,22461.399999999998,14040.89
29290,U31269,26,164270.19999999995,15,11,58962.5,223232.69999999995
29291,U1364010,26,-4847.849999999999,24,2,6071.030000000001,1223.1800000000012
29292,U43672,26,-4921.16,19,7,31035.93,26114.77
29293,U42434,26,-21019.34,20,6,74772.53999999998,53753.19999999998
29294,U43173,26,5959.909999999999,15,11,16150.94,22110.85
29295,U42619,26,-92.47000000000507,13,13,251215.8,251123.33
29296,U43703,26,52580.08999999998,12,14,170198.03,222778.12
29297,U34517,26,7504.22,19,7,10036.390000000001,17540.61
29298,U27457,26,-16649.690000000002,16,10,57551.86,40902.17
29299,U8319,26,-4069.919999999999,18,8,28851.699999999997,24781.78
29300,U36784,26,-56627.87,16,10,61529.02,4901.149999999994
29301,U16912,26,6668.519999999995,10,16,407002.9,413671.42000000004
29302,U32557,26,-1492.3599999999992,22,4,7440.31,5947.950000000001
29303,U30059,26,-74.60999999999967,14,12,14934.08,14859.470000000001
29304,U1149862,26,107.72000000000003,20,6,2406.22,2513.9399999999996
29305,U13707,26,-8192.399999999998,20,6,50955.42,42763.020000000004
29306,U13487,26,30634.24,15,11,47682.01,78316.25
29307,U1342165,26,-47104.99999999999,20,6,47885.049999999996,780.0500000000029
29308,U1206341,26,-8327.85,22,4,9827.86,1500.0100000000002
29309,U11093,26,-1757.42,19,7,20358.010000000002,18600.590000000004
29310,U31547,26,-133574.87,19,7,261099.83000000002,127524.96000000002
29311,U42162,26,-4421.12,15,11,51899.189999999995,47478.06999999999
29312,U36344,26,-8669.329999999984,8,18,136000.0,127330.67000000001
29313,U29246,26,4756.889999999956,16,10,547482.9,552239.79
29314,U43329,26,-3880.85,22,4,10361.03,6480.18
29315,U27564,26,7323.59,17,9,31391.27,38714.86
29316,U40670,26,240.41999999999916,15,11,92165.42,92405.84
29317,U35392,26,432.5199999999968,22,4,54820.48,55253.0
29318,U39476,26,2019.880000000001,12,14,73125.71999999999,75145.59999999999
29319,U39940,26,5102.659999999995,19,7,33303.6,38406.259999999995
29320,U15338,26,11593.5,17,9,133438.06,145031.56
29321,U36834,26,-18551.97999999999,10,16,384000.0,365448.02
29322,U19237,26,-1178.76,21,5,2350.59,1171.8300000000002
29323,U14232,26,10676.220000000001,20,6,54448.77,65124.99
29324,U33336,26,-1359.63,20,6,10354.57,8994.939999999999
29325,U38562,26,-17828.56000000002,11,15,801461.37,783632.8099999999
29326,U36691,26,101.04,16,10,99811.0,99912.04
29327,U29592,26,-8084.510000000001,21,5,19504.63,11420.119999999999
29328,U16986,26,-11870.25,16,10,48927.37,37057.12
29329,U38255,26,337.06999999999925,14,12,27564.57,27901.64
29330,U41904,26,17677.13,19,7,82205.48,99882.61
29331,U664334,26,4299.91,17,9,880.0600000000001,5179.97
29332,U42508,26,3784.7100000000005,17,9,968.56,4753.27
29333,U17930,26,-19603.179999999993,15,11,170689.19999999998,151086.02
29334,U36171,26,61969.60000000009,16,10,1217809.08,1279778.6800000002
29335,U41403,26,27463.949999999997,16,10,85666.35,113130.3
29336,U25874,26,-162265.0,22,4,172324.82,10059.820000000007
29337,U694832,26,3300.2299999999996,14,12,20655.59,23955.82
29338,U26941,26,2255.93,21,5,4184.62,6440.549999999999
29339,U36698,26,38051.92999999999,19,7,3939.95,41991.87999999999
29340,U29819,26,-11455.51,15,11,82745.64999999998,71290.13999999998
29341,U23151,26,6858.720000000001,15,11,276926.83999999997,283785.55999999994
29342,U40914,26,-76398.81,12,14,123797.34,47398.53
29343,U25014,26,1779.0499999999984,20,6,25605.2,27384.25
29344,U36652,26,627.9200000000005,18,8,8278.43,8906.35
29345,U33554,26,2384.76,21,5,7904.39,10289.150000000001
29346,U17316,26,22311.82,15,11,95632.66,117944.48000000001
29347,U28026,26,6589.709999999998,8,18,106500.83,113090.54
29348,U14506,26,-113342.12999999999,22,4,165862.67,52520.54000000002
29349,U33487,26,254.17999999999597,12,14,43677.520000000004,43931.7
29350,U23612,26,-95812.34999999998,13,13,1602946.3,1507133.9500000002
29351,U1137855,26,-3746.4399999999996,24,2,4001.6999999999994,255.25999999999976
29352,U804456,26,-6019.26,15,11,26611.34,20592.08
29353,U33546,26,-381.9100000000005,20,6,12003.2,11621.29
29354,U1140272,26,4.059999999999931,19,7,904.96,909.02
29355,U18264,26,560.2099999999971,16,10,73612.47000000002,74172.68000000001
29356,U36006,26,23464.21999999999,23,3,56028.780000000006,79493.0
29357,U32402,26,11181.99,19,7,7977.039999999999,19159.03
29358,U28541,26,1419.9099999999999,14,12,24206.96,25626.87
29359,U22638,26,14887.57,22,4,14196.389999999998,29083.96
29360,U18681,26,-900.310000000007,13,13,340869.0,339968.69
29361,U12292,26,287.9899999999993,16,10,7217.459999999999,7505.449999999999
29362,U24268,26,5980.14,19,7,7476.950000000001,13457.09
29363,U31245,26,-758.42,22,4,1877.6599999999999,1119.2399999999998
29364,U30896,26,-9088.02,13,13,76632.0,67543.98
29365,U30835,26,7467.160000000002,19,7,35779.729999999996,43246.89
29366,U1095114,26,-509.38000000000034,16,10,3242.3300000000004,2732.95
29367,U34618,26,-14920.279999999999,19,7,20790.67,5870.389999999999
29368,U16567,26,-6739.2699999999895,12,14,439657.92,432918.65
29369,U18376,26,9999.719999999992,13,13,170107.0,180106.72
29370,U748984,26,-1568.23,16,10,31946.460000000003,30378.230000000003
29371,U38543,26,-43687.39000000002,9,17,482890.8,439203.41
29372,U30829,26,26824.43,14,12,25398.98,52223.41
29373,U21129,26,2945279.930000001,14,12,2223545.169999999,5168825.1
29374,U34081,26,2344.9500000000007,12,14,27136.64,29481.59
29375,U38066,26,2010.9900000000052,18,8,191971.82,193982.81
29376,U31978,26,-33756.31,19,7,85324.13,51567.82000000001
29377,U21864,26,2960.9299999999994,24,2,10247.52,13208.45
29378,U16251,26,-13938.620000000003,19,7,68502.13,54563.51
29379,U35289,26,-14312.849999999999,15,11,62067.01,47754.16
29380,U21357,26,-1398.5199999999895,12,14,571000.0,569601.48
29381,U31527,26,-1169.8899999999999,18,8,10640.86,9470.970000000001
29382,U31645,26,-27372.830000000016,10,16,579316.4,551943.5700000001
29383,U8324,26,-1925.12,13,13,6353.85,4428.7300000000005
29384,U38585,26,439.8000000000004,12,14,8316.27,8756.070000000002
29385,U21039,26,-25348.96000000001,23,3,36405.810000000005,11056.849999999995
29386,U12394,26,-145192.63999999998,19,7,198095.68,52903.04000000001
29387,U27396,26,74.01999999999877,17,9,32058.930000000004,32132.950000000004
29388,U1096457,26,-4.2999999999999545,15,11,3114.3199999999997,3110.0199999999995
29389,U35398,26,-4267.139999999994,19,7,67575.12999999999,63307.99
29390,U35541,26,-2832.5899999999965,15,11,138864.75,136032.16
29391,U13613,26,7031.039999999997,10,16,32902.14,39933.17999999999
29392,U1140611,26,5465.25,18,8,6654.780000000001,12120.03
29393,U42033,26,-40411.34999999999,19,7,221336.71,180925.36
29394,U1246280,26,-3452.59,18,8,13460.77,10008.18
29395,U26767,26,62.86000000000127,15,11,153229.19,153292.05000000002
29396,U33841,26,14714.840000000006,16,10,9272.549999999997,23987.390000000003
29397,U26025,26,27667.839999999997,16,10,34352.64,62020.479999999996
29398,U22098,26,5713.47,23,3,3171.54,8885.01
29399,U31463,26,-504582.3,20,6,529393.4099999999,24811.109999999928
29400,U1376146,26,23.210000000000036,14,12,4610.0,4633.21
29401,U9400,26,-1200.2100000000073,14,12,89712.56999999999,88512.35999999999
29402,U43282,26,-29849.02000000002,12,14,864313.0,834463.98
29403,U9291,26,147659.82,14,12,44924.43,192584.25
29404,U29560,26,-10289.23,17,9,41171.5,30882.27
29405,U851503,26,7.719999999998436,15,11,16227.49,16235.21
29406,U20980,26,1936.52,21,5,95044.0,96980.52
29407,U32255,26,2450.17,14,12,20116.0,22566.17
29408,U40602,26,-1169.6000000000001,23,3,4960.07,3790.4699999999993
29409,U42326,26,-15052.26,12,14,45310.85,30258.589999999997
29410,U934495,26,-5837.09,17,9,19141.260000000002,13304.170000000002
29411,U9820,26,-571.6800000000003,18,8,48550.36,47978.68
29412,U28888,26,136.0699999999993,16,10,6649.94,6786.009999999999
29413,U8899,26,-18236.61,14,12,176000.0,157763.39
29414,U23819,26,4383.05,20,6,25618.94,30001.989999999998
29415,U28807,26,-17032.16,11,15,56965.06,39932.899999999994
29416,U19938,26,-13938.130000000001,18,8,36629.56,22691.429999999997
29417,U17676,26,-1056.8999999999978,18,8,69835.06999999999,68778.17
29418,U20229,26,-37424.31000000001,9,17,422425.36,385001.05
29419,U28014,26,-12875.639999999998,14,12,40112.170000000006,27236.530000000006
29420,U36402,26,906.8700000000099,12,14,268699.1,269605.97
29421,U42412,26,-195.8300000000018,12,14,64454.72,64258.89
29422,U38412,26,-923.3600000000001,18,8,4809.6,3886.2400000000002
29423,U28597,26,1290.9000000000015,21,5,22342.679999999993,23633.579999999994
29424,U869304,26,2196.18,12,14,1089.2399999999998,3285.4199999999996
29425,U22227,26,25035.739999999998,10,16,85734.79999999999,110770.53999999998
29426,U17518,26,15275.570000000003,20,6,19483.250000000004,34758.82000000001
29427,U32778,26,-35581.01,22,4,39730.59,4149.5799999999945
29428,U14862,26,24.25999999999991,19,7,11460.810000000001,11485.070000000002
29429,U31742,26,8680.880000000168,11,15,5501481.43,5510162.31
29430,U32331,26,-42703.16,23,3,52603.31,9900.149999999994
29431,U13916,26,-869.0399999999998,16,10,47661.33,46792.29
29432,U36963,26,-2699.63,18,8,12514.089999999998,9814.46
29433,U32585,26,-32561.360000000004,18,8,38969.6,6408.239999999994
29434,U637177,26,2.0000000000009095,14,12,25138.0,25140.0
29435,U41339,26,-869.9300000000003,16,10,39331.97,38462.04
29436,U20894,26,-3298.449999999999,16,10,52107.0,48808.55
29437,U25574,26,17900.35,9,17,18933.780000000002,36834.130000000005
29438,U28644,26,-12825.529999999999,20,6,27312.28,14486.75
29439,U761246,26,-0.15999999999985448,15,11,11962.18,11962.02
29440,U37340,26,1883.0799999999986,21,5,23695.79,25578.87
29441,U11094,26,-1343.4499999999998,21,5,21011.159999999996,19667.709999999995
29442,U22099,26,632.2099999999974,18,8,31981.190000000002,32613.4
29443,U19854,26,-76687.81999999999,8,18,323882.08999999997,247194.26999999996
29444,U35923,26,34480.439999999944,14,12,717092.5,751572.94
29445,U1320131,26,449.3300000000006,16,10,13859.04,14308.37
29446,U22497,26,-268.53000000000003,22,4,4581.130000000001,4312.600000000001
29447,U22869,26,-7056.389999999999,18,8,35613.15,28556.760000000002
29448,U35346,26,-1120.19,19,7,13188.89,12068.699999999999
29449,U39642,26,-9774.310000000001,17,9,70226.18000000001,60451.87000000001
29450,U37530,26,0.959999999982756,12,14,125654.16,125655.11999999998
29451,U39816,26,49817.350000000006,19,7,23922.489999999998,73739.84
29452,U898658,26,-9434.47,13,13,10764.529999999999,1330.0599999999995
29453,U28414,26,-7252.299999999997,12,14,43114.560000000005,35862.26000000001
29454,U11999,26,3685.1900000000005,19,7,16653.8,20338.989999999998
29455,U27674,26,57.82999999999993,21,5,4129.46,4187.29
29456,U1192959,26,0.0,13,13,6084.0,6084.0
29457,U18922,26,-2131.25,24,2,2581.629999999999,450.3799999999992
29458,U15249,26,-19245.830000000005,21,5,96981.24999999999,77735.41999999998
29459,U40609,26,-48251.240000000005,20,6,85718.13999999998,37466.89999999998
29460,U1351474,26,0.0,16,10,875.9699999999999,875.9699999999999
29461,U26044,26,99903.52999999998,14,12,304233.11,404136.63999999996
29462,U26959,26,1112.4999999999995,17,9,33958.09,35070.59
29463,U29212,26,-94501.61,13,13,141425.75999999998,46924.14999999998
29464,U11692,26,-6749.440000000002,14,12,28412.13,21662.69
29465,U37828,26,12436.609999999999,12,14,206729.09999999998,219165.70999999996
29466,U18755,26,-1606.129999999988,7,19,139749.8,138143.67
29467,U17865,26,-4680.18,16,10,27375.800000000003,22695.620000000003
29468,U15525,26,5647.08,19,7,2203.8199999999997,7850.9
29469,U40063,26,1821.820000000007,19,7,128380.29999999999,130202.12
29470,U37129,26,-620.3399999999995,19,7,8302.14,7681.8
29471,U39326,26,111234.55,7,19,543407.29,654641.8400000001
29472,U23477,26,26465.770000000004,13,13,19985.800000000003,46451.57000000001
29473,U40825,26,-244.12999999999928,19,7,145430.6,145186.47
29474,U16063,26,40893.060000000005,20,6,8427.27,49320.33
29475,U14111,26,5489.169999999999,15,11,47666.96000000001,53156.130000000005
29476,U28437,26,1114.7899999999956,7,19,47625.11000000001,48739.9
29477,U12170,26,-19828.030000000006,14,12,98771.5,78943.47
29478,U25744,26,15990.769999999999,18,8,192270.16000000003,208260.93000000002
29479,U1292807,26,-1919.9099999999999,19,7,9082.019999999999,7162.109999999999
29480,U1335616,26,-10.290000000000077,16,10,2519.92,2509.63
29481,U17711,26,-5574.76,15,11,24964.690000000002,19389.93
29482,U19155,26,2214.01,13,13,5454.0,7668.01
29483,U12766,26,8148.209999999999,16,10,29108.99,37257.2
29484,U38187,26,5055.57,16,10,10827.42,15882.99
29485,U18769,26,4479.1600000000035,21,5,33527.409999999996,38006.57
29486,U12954,26,-393.83000000000004,17,9,778.5500000000001,384.72
29487,U16642,26,-8295.3,21,5,15526.09,7230.790000000001
29488,U32655,26,-1841.6200000000001,22,4,5902.610000000001,4060.9900000000007
29489,U25342,26,-2969.7400000000002,21,5,31992.760000000002,29023.02
29490,U12905,26,-14981.690000000002,18,8,82140.78,67159.09
29491,U23536,26,-6093.219999999994,15,11,107781.0,101687.78
29492,U43879,26,678.1799999999712,13,13,252421.14999999997,253099.32999999993
29493,U43211,26,-672.7900000000009,15,11,53889.399999999994,53216.60999999999
29494,U21904,26,8678.13,18,8,11027.869999999997,19705.999999999996
29495,U27652,26,-31784.799999999996,12,14,157802.57,126017.77000000002
29496,U34582,26,630.95,14,12,5303.820000000001,5934.77
29497,U36235,26,5378.96,11,15,18290.94,23669.899999999998
29498,U1142652,26,14287.240000000007,17,9,24425.43,38712.670000000006
29499,U8336,26,11710.629999999997,21,5,78459.0,90169.63
29500,U16256,26,711120.7999999999,10,16,114759.81,825880.6099999999
29501,U23236,26,-4867.959999999963,13,13,602456.8,597588.8400000001
29502,U38720,26,3724431.6,13,13,584762.2,4309193.8
29503,U13864,26,-10221.169999999998,16,10,53398.0,43176.83
29504,U31931,26,3978.87,21,5,16139.51,20118.38
29505,U40478,26,1300.6399999999696,15,11,386603.15,387903.79
29506,U32322,26,4410.36,21,5,1823.7099999999998,6234.07
29507,U26172,26,2671.81,18,8,2367.370000000001,5039.18
29508,U13597,26,12804.79,18,8,60562.81,73367.6
29509,U16803,26,-5170.830000000002,20,6,47494.82,42323.99
29510,U26016,26,11573.159999999973,10,16,1975114.16,1986687.3199999998
29511,U41619,26,-3428.04,19,7,9197.0,5768.96
29512,U26014,26,4.279999999998722,20,6,12933.119999999997,12937.399999999996
29513,U41506,26,17171.55,16,10,36950.84,54122.39
29514,U14195,26,-9846.619999999999,20,6,88639.84,78793.22
29515,U39766,26,2713.399999999999,19,7,12006.559999999998,14719.959999999997
29516,U19547,26,-3412.0500000000025,19,7,63936.0,60523.95
29517,U37905,26,-22264.09,16,10,165584.31000000003,143320.22000000003
29518,U32773,26,-34897.72,21,5,141091.41,106193.69
29519,U10090,26,5866.8600000000015,20,6,19583.120000000003,25449.980000000003
29520,U11174,26,-307.00000000000034,23,3,19727.28,19420.28
29521,U35253,26,-3390.720000000001,21,5,26924.48,23533.76
29522,U21066,26,45539.11,14,12,213077.92,258617.03000000003
29523,U24675,26,147.14000000000078,24,2,46102.48,46249.62
29524,U16577,26,-46714.759999999995,16,10,135931.52,89216.76
29525,U12879,26,94519.51000000001,20,6,21321.609999999997,115841.12000000001
29526,U35606,26,4501.65,20,6,1228.1,5729.75
29527,U28383,26,-1728.4300000000003,21,5,27531.86,25803.43
29528,U18923,26,-33444.21,22,4,128478.0,95033.79000000001
29529,U15381,26,16884.080000000005,11,15,166140.8,183024.88
29530,U12736,26,8430.519999999997,16,10,45904.79,54335.31
29531,U28881,26,-384417.42,18,8,536122.1799999999,151704.75999999995
29532,U28598,26,-9993.500000000002,20,6,15786.130000000001,5792.629999999999
29533,U29171,26,-71475.33000000007,20,6,1000902.42,929427.09
29534,U641679,26,-4299.120000000001,20,6,12999.35,8700.23
29535,U38586,26,-990.9799999999959,12,14,73726.76000000001,72735.78000000001
29536,U39225,26,-104483.21999999997,17,9,149593.22,45110.00000000003
29537,U16077,26,-1629.41,19,7,5016.109999999999,3386.699999999999
29538,U29573,26,6116.569999999992,13,13,160431.16999999998,166547.74
29539,U19235,26,18.550000000005298,13,13,257234.89,257253.44000000003
29540,U12304,26,-28981.160000000003,19,7,106094.49,77113.33
29541,U23462,26,-37129.71,14,12,145542.18,108412.47
29542,U43336,26,-636.5100000000002,12,14,39453.0,38816.49
29543,U623069,26,286.03999999999996,9,17,2652.3,2938.34
29544,U1274913,26,-2969.87,19,7,4204.48,1234.6099999999997
29545,U22670,26,-19873.820000000007,14,12,146793.91,126920.09
29546,U29965,26,-3555.13,17,9,66029.2,62474.07
29547,U18318,26,8640.309999999998,12,14,712723.0,721363.31
29548,U43842,26,-14735.87,15,11,43925.64,29189.769999999997
29549,U32432,26,92846.11000000002,17,9,156865.36000000002,249711.47000000003
29550,U41215,26,-23547.959999999992,15,11,399296.95000000007,375748.9900000001
29551,U22444,26,-9497.259999999998,17,9,67046.69,57549.43000000001
29552,U18673,26,182.37000000000262,16,10,22230.83,22413.200000000004
29553,U40231,26,966.0800000000002,21,5,1490.67,2456.75
29554,U41947,26,5627.129999999999,15,11,34123.09,39750.219999999994
29555,U23256,26,4358.709999999999,17,9,124897.81,129256.51999999999
29556,U36136,26,565.79,22,4,1370.77,1936.56
29557,U30280,26,61.20000000000033,23,3,4349.870000000001,4411.0700000000015
29558,U31147,26,-3676.129999999999,17,9,30434.059999999998,26757.93
29559,U22458,26,-9969.729999999998,17,9,68058.53,58088.8
29560,U19364,26,-18151.08,13,13,75857.13,57706.05
29561,U10289,26,-1723.6500000000005,16,10,20518.31,18794.66
29562,U20552,26,9855.630000000001,21,5,3230.46,13086.09
29563,U39933,26,18011.759999999995,17,9,103620.31999999998,121632.07999999997
29564,U37607,26,4465.469999999997,14,12,51910.58,56376.049999999996
29565,U16568,26,18234.52,16,10,41694.57,59929.09
29566,U14027,26,1136.270000000004,13,13,122988.18,124124.45
29567,U22733,26,7929.700000000004,16,10,57364.64000000001,65294.34000000001
29568,U26271,26,-993.3699999999997,13,13,28274.75,27281.38
29569,U899573,26,-952.2000000000004,17,9,8223.14,7270.939999999999
29570,U17436,26,143.13999999999942,14,12,32276.03,32419.17
29571,U28140,26,10888.279999999999,22,4,6194.7699999999995,17083.05
29572,U38282,26,-2014.7400000000057,16,10,48557.200000000004,46542.46
29573,U32555,26,-84719.66,24,2,108746.64,24026.979999999996
29574,U38674,26,-16111.809999999994,18,8,327284.55,311172.74
29575,U39349,26,2303.550000000003,17,9,125807.3,128110.85
29576,U28359,26,29.829999999985375,16,10,266526.26,266556.08999999997
29577,U32333,26,-7492.629999999992,13,13,188095.99,180603.36
29578,U19598,26,47852.880000000005,18,8,41253.85,89106.73000000001
29579,U38130,26,-130429.01999999999,12,14,278607.16,148178.13999999998
29580,U11154,26,10330.230000000041,15,11,690070.77,700401.0000000001
29581,U22045,26,31325.66000000001,21,5,11078.639999999998,42404.30000000001
29582,U27612,26,-7030.989999999998,19,7,39485.22,32454.230000000003
29583,U682455,26,121.01999999999998,14,12,4750.02,4871.040000000001
29584,U24102,26,-81.74000000000001,15,11,11664.14,11582.4
29585,U13179,26,-4021.5599999999995,17,9,30267.16,26245.6
29586,U19931,26,-7140.869999999999,17,9,28671.289999999997,21530.42
29587,U25261,26,1519.9400000000003,17,9,13649.26,15169.2
29588,U26456,26,-73494.16,17,9,154521.14,81026.98000000001
29589,U41104,26,-6492.4400000000005,18,8,17724.48,11232.039999999999
29590,U15486,26,12444.380000000001,14,12,23020.3,35464.68
29591,U1311543,26,6190.77,13,13,9547.879999999997,15738.649999999998
29592,U28100,26,42798.549999999996,17,9,73360.29000000001,116158.84
29593,U21257,26,365.15000000000055,19,7,9828.71,10193.86
29594,U35096,26,434.62000000002445,13,13,239800.90000000002,240235.52000000005
29595,U24938,26,-3098.699999999998,10,16,16349.750000000002,13251.050000000003
29596,U31751,26,17524.95,13,13,51559.39000000001,69084.34000000001
29597,U25589,26,173.1800000000021,17,9,22821.8,22994.980000000003
29598,U643135,26,-5895.5599999999995,18,8,18095.57,12200.01
29599,U31122,25,7036.880000000001,19,6,9946.4,16983.28
29600,U23423,25,-36055.08,21,4,48261.200000000004,12206.120000000003
29601,U21806,25,23821.040000000015,14,11,369324.99,393146.03
29602,U24213,25,-4183.700000000001,19,6,18245.049999999996,14061.349999999995
29603,U17662,25,-715.1100000000006,19,6,106722.0,106006.89
29604,U30068,25,23002.82,14,11,33488.1,56490.92
29605,U14001,25,30529.870000000003,16,9,79762.82,110292.69
29606,U37035,25,5105.499999999999,13,12,10496.9,15602.399999999998
29607,U27205,25,-31163.140000000014,12,13,691714.0,660550.86
29608,U30819,25,1971.6299999999997,21,4,13402.479999999998,15374.109999999997
29609,U43032,25,-14352.58,20,5,20127.5,5774.92
29610,U29995,25,3936.969999999983,12,13,240403.00000000003,244339.97
29611,U42849,25,-5231.13,17,8,16130.66,10899.529999999999
29612,U30763,25,13947.22,12,13,15485.6,29432.82
29613,U30870,25,27777.180000000004,17,8,10820.28,38597.46000000001
29614,U34241,25,10115.96,22,3,413.44,10529.4
29615,U39870,25,-5194.320000000001,20,5,16496.0,11301.68
29616,U32385,25,1791.7000000000007,14,11,47185.79000000001,48977.490000000005
29617,U9728,25,-229.6399999999985,15,10,24216.67,23987.03
29618,U31205,25,4251.0599999999995,17,8,9363.330000000002,13614.390000000001
29619,U9320,25,-5589.4,19,6,17210.9,11621.500000000002
29620,U35894,25,5682.129999999999,12,13,36383.28,42065.409999999996
29621,U29936,25,-620.4699999999991,15,10,79402.0,78781.53
29622,U40441,25,856.3500000000004,13,12,35578.19,36434.54
29623,U20964,25,6188.070000000001,11,14,35546.63,41734.7
29624,U11459,25,-120641.84999999999,15,10,311571.92000000004,190930.07000000007
29625,U29462,25,125021.54,15,10,280835.63,405857.17
29626,U27404,25,-5100.14,22,3,16527.190000000002,11427.050000000003
29627,U25601,25,-51656.44000000001,17,8,207996.27,156339.83
29628,U36166,25,-9528.099999999999,19,6,32497.0,22968.9
29629,U24883,25,-8244.600000000002,17,8,42052.229999999996,33807.62999999999
29630,U42297,25,-1359.0000000000002,18,7,3203.17,1844.1699999999998
29631,U1111257,25,2875.830000000001,12,13,5014.89,7890.720000000001
29632,U8043,25,-2030.04,17,8,26462.949999999997,24432.909999999996
29633,U23448,25,161378.41,19,6,27437.5,188815.91
29634,U20679,25,644.319999999998,15,10,42052.31,42696.63
29635,U761992,25,-14947.080000000002,17,8,15674.7,727.619999999999
29636,U13555,25,-1363.8799999999983,14,11,58910.5,57546.62
29637,U935034,25,-6664.25,12,13,50391.25,43727.0
29638,U22996,25,2264.0299999999997,16,9,7188.81,9452.84
29639,U823425,25,1209.85,20,5,4524.19,5734.039999999999
29640,U40852,25,591.4000000000001,20,5,1015.66,1607.06
29641,U33136,25,3907.009999999999,14,11,25659.120000000003,29566.13
29642,U23792,25,0.0,12,13,50461.0,50461.0
29643,U34186,25,-6645.689999999999,18,7,25917.57,19271.88
29644,U24763,25,9122.17,20,5,1239.8400000000001,10362.01
29645,U19818,25,60469.799999999996,14,11,85696.09000000001,146165.89
29646,U37032,25,-5155.290000000001,17,8,98573.38,93418.09
29647,U12468,25,-5775.659999999999,17,8,29201.479999999996,23425.819999999996
29648,U34207,25,-96939.89000000001,15,10,130615.55,33675.65999999999
29649,U18496,25,-55224.07,19,6,117539.0,62314.93
29650,U34049,25,5394.909999999998,15,10,10304.66,15699.569999999998
29651,U39461,25,-1142979.0400000003,7,18,2263614.0,1120634.9599999997
29652,U19034,25,-1941.750000000001,20,5,3363.150000000001,1421.4
29653,U11365,25,1511.2199999999991,11,14,20704.3,22215.519999999997
29654,U24490,25,32187.91999999999,21,4,43224.84,75412.75999999998
29655,U22730,25,-30465.37,20,5,84508.0,54042.630000000005
29656,U35713,25,5921.08,17,8,5081.26,11002.34
29657,U42531,25,3176.3,18,7,11979.199999999999,15155.5
29658,U1347929,25,-5.869999999999891,18,7,8545.67,8539.8
29659,U905123,25,192.13000000000002,8,17,54.87,247.00000000000003
29660,U23600,25,15551.57999999998,11,14,149520.0,165071.58
29661,U42791,25,227936.57,10,15,76525.64,304462.21
29662,U36613,25,4847.509999999995,17,8,149155.01,154002.52000000002
29663,U34085,25,-5838.110000000001,13,12,54240.01,48401.9
29664,U34581,25,-14822.880000000005,14,11,54964.64,40141.759999999995
29665,U1184745,25,598.4200000000001,14,11,5737.0,6335.42
29666,U31422,25,1483.6599999999999,15,10,31158.91,32642.57
29667,U34380,25,1.610000000021828,12,13,619486.23,619487.84
29668,U42244,25,20555.460000000006,13,12,96925.29,117480.75
29669,U920493,25,-817.9900000000005,18,7,6491.52,5673.53
29670,U26803,25,3536.840000000001,22,3,13379.130000000001,16915.97
29671,U32225,25,14388.12,19,6,74886.56,89274.68
29672,U43324,25,8194.640000000003,16,9,65618.85,73813.49
29673,U32411,25,13270.810000000001,10,15,206010.99999999994,219281.80999999994
29674,U1112367,25,-5886.969999999999,22,3,7635.34,1748.3700000000008
29675,U22040,25,-529.5,11,14,53873.0,53343.5
29676,U15186,25,-3907.4400000000005,19,6,11829.490000000002,7922.050000000001
29677,U19730,25,22.9800000000032,15,10,255784.23,255807.21000000002
29678,U19641,25,8425.800000000003,14,11,8843.99,17269.79
29679,U1122033,25,-1606.2300000000018,18,7,17782.36,16176.13
29680,U37108,25,-3981.2800000000007,18,7,41281.51,37300.23
29681,U39457,25,107462.45999999999,16,9,6359.639999999999,113822.09999999999
29682,U15276,25,4377.860000000002,14,11,29545.08,33922.94
29683,U34851,25,4270.640000000003,18,7,104938.91,109209.55
29684,U33291,25,-147.03999999999996,18,7,5627.63,5480.59
29685,U25794,25,-8561.0,16,9,73100.95999999999,64539.95999999999
29686,U16379,25,-4889.6900000000005,18,7,25917.0,21027.309999999998
29687,U9875,25,110.48000000000395,18,7,85082.32,85192.80000000002
29688,U43815,25,4030.000000000002,17,8,62081.84,66111.84
29689,U38478,25,-6902.740000000003,16,9,56598.54,49695.799999999996
29690,U38183,25,-15153.7,19,6,20598.45,5444.75
29691,U23334,25,-4922.660000000002,5,20,90500.0,85577.34
29692,U36390,25,-3575.709999999999,12,13,166810.07,163234.36000000002
29693,U20684,25,6145.979999999999,20,5,25392.46,31538.44
29694,U16214,25,-2114.98,22,3,2186.0,71.01999999999998
29695,U9697,25,-800.6700000000002,21,4,5277.05,4476.38
29696,U11255,25,3240.0000000000005,21,4,8773.350000000002,12013.350000000002
29697,U17363,25,9778.230000000003,13,12,1160569.0,1170347.23
29698,U37041,25,-4052.289999999999,20,5,17752.9,13700.610000000002
29699,U9087,25,18300.29,16,9,49826.5,68126.79000000001
29700,U35791,25,-92680.01999999999,16,9,195142.68,102462.66
29701,U25057,25,54466.07,18,7,116303.48,170769.55
29702,U20612,25,-402.7099999999996,12,13,266407.65,266004.94
29703,U42450,25,3954.359999999998,14,11,58551.490000000005,62505.850000000006
29704,U44041,25,15216.099999999999,16,9,48896.200000000004,64112.3
29705,U42559,25,-265.8699999999999,23,2,2654.4,2388.53
29706,U19005,25,124868.48999999998,11,14,13748.949999999999,138617.43999999997
29707,U38789,25,880338.4600000001,5,20,1690000.0,2570338.46
29708,U33876,25,-3386.360000000004,11,14,294891.6,291505.24
29709,U18537,25,1880.6100000000001,21,4,1960.71,3841.32
29710,U12910,25,5387.470000000001,13,12,411195.0,416582.47
29711,U12064,25,2147.7499999999986,20,5,19858.5,22006.25
29712,U9553,25,-12477.83,22,3,14025.28,1547.4500000000007
29713,U1157827,25,4.263256414560601e-14,15,10,682.6,682.6
29714,U43186,25,148679.91999999998,16,9,411918.6,560598.52
29715,U41016,25,12988.580000000002,17,8,103319.31999999999,116307.9
29716,U9164,25,10474.520000000004,19,6,27425.96,37900.48
29717,U15189,25,8080.699999999997,13,12,80104.26000000001,88184.96
29718,U39104,25,3990.209999999999,15,10,25259.13,29249.34
29719,U20895,25,-1293.9500000000007,22,3,44594.27,43300.31999999999
29720,U13665,25,75702.44000000003,17,8,125563.53,201265.97000000003
29721,U39404,25,417275.2799999999,20,5,2188.59,419463.86999999994
29722,U40160,25,-59924.42000000003,9,16,448723.0,388798.57999999996
29723,U9693,25,1500.869999999999,13,12,22740.0,24240.87
29724,U36278,25,243.64,13,12,10895.779999999999,11139.419999999998
29725,U11841,25,-8913.47,21,4,27477.47,18564.0
29726,U36173,25,-1077.9000000000015,15,10,70486.0,69408.1
29727,U750976,25,515.1399999999933,12,13,126297.53,126812.67
29728,U21584,25,10289.400000000001,17,8,14201.619999999999,24491.02
29729,U28273,25,-2664.269999999999,20,5,33789.51,31125.24
29730,U36399,25,4843.659999999993,7,18,368985.0,373828.66
29731,U26440,25,8535.96,15,10,20505.390000000003,29041.350000000002
29732,U36488,25,35404.84999999999,19,6,12114.389999999998,47519.23999999999
29733,U1220412,25,3552.6799999999994,19,6,12276.11,15828.79
29734,U16651,25,6029.5599999999995,20,5,4797.46,10827.02
29735,U34375,25,-2013.329999999997,22,3,210517.77,208504.44
29736,U39380,25,-369.53,20,5,5063.53,4694.0
29737,U35585,25,83.76000000000022,14,11,7179.860000000001,7263.620000000001
29738,U40956,25,69.77999999999975,12,13,27391.0,27460.78
29739,U24411,25,104970.97000000003,12,13,321109.49,426080.46
29740,U12673,25,-635.5399999999994,22,3,17171.500000000004,16535.960000000003
29741,U20637,25,98802.19,11,14,105833.97,204636.16
29742,U1253781,25,-4284.6,19,6,15694.689999999995,11410.089999999995
29743,U40268,25,-461.33000000000004,16,9,5693.43,5232.1
29744,U29433,25,5541.219999999999,22,3,1428.7999999999997,6970.019999999999
29745,U29914,25,-16796.780000000006,18,7,41595.11999999999,24798.339999999982
29746,U20772,25,0.2600000000000864,21,4,774.1899999999998,774.4499999999999
29747,U36182,25,56744.22,16,9,92200.4,148944.62
29748,U34368,25,-25255.0,14,11,54087.479999999996,28832.479999999996
29749,U34836,25,-3329.1599999999908,12,13,195459.76,192130.6
29750,U28836,25,317312.11,15,10,24545.84,341857.95
29751,U1273839,25,-32.309999999999945,16,9,4074.73,4042.42
29752,U17372,25,-2404.7599999999948,15,10,57242.62,54837.86000000001
29753,U28662,25,1871.9000000000142,10,15,248623.54,250495.44000000003
29754,U8275,25,-1296.3400000000006,14,11,42662.460000000014,41366.12000000001
29755,U15732,25,48818.38,17,8,11586.470000000001,60404.85
29756,U27921,25,-3340.1400000000003,22,3,15741.560000000001,12401.420000000002
29757,U38356,25,-569.870000000001,18,7,62058.7,61488.829999999994
29758,U12990,25,122120.56000000001,7,18,41432.48999999999,163553.05
29759,U1263876,25,1235.5,14,11,17447.11,18682.61
29760,U41186,25,21483.309999999998,17,8,68773.41,90256.72
29761,U28918,25,9765.61,19,6,17463.66,27229.27
29762,U23663,25,3902.0599999999986,19,6,11864.86,15766.919999999998
29763,U25066,25,-7853.900000000014,15,10,659785.83,651931.9299999999
29764,U705995,25,-4799.409999999999,21,4,18005.199999999997,13205.789999999997
29765,U1215044,25,351.5999999999999,17,8,6736.42,7088.02
29766,U22664,25,8874.37000000001,15,10,237479.38,246353.75
29767,U26037,25,-4398.729999999996,16,9,110448.79,106050.06
29768,U40963,25,-5994.699999999997,16,9,80416.37000000001,74421.67000000001
29769,U26539,25,90821.95000000003,15,10,32505.54,123327.49000000002
29770,U22544,25,467.14999999999986,19,6,1752.5,2219.6499999999996
29771,U758650,25,0.8599999999994363,15,10,15948.23,15949.089999999998
29772,U642230,25,-2831.4799999999996,15,10,9932.49,7101.01
29773,U42143,25,-1500.5300000000007,13,12,7074.0,5573.469999999999
29774,U1331928,25,-50.94999999999999,15,10,341.62,290.67
29775,U1120233,25,2141.2299999999996,14,11,8682.86,10824.09
29776,U25118,25,382.26000000000016,16,9,5002.46,5384.72
29777,U21786,25,100.59999999999854,13,12,49999.82,50100.42
29778,U13274,25,18482.589999999993,14,11,56188.56,74671.15
29779,U33670,25,2020.9100000000005,20,5,2607.9400000000005,4628.850000000001
29780,U36325,25,-28214.55,24,1,28369.34,154.79000000000087
29781,U37781,25,-11958.82,20,5,19212.95,7254.130000000001
29782,U34954,25,7028.34,12,13,68969.91,75998.25
29783,U42996,25,-182.18,21,4,657.8,475.61999999999995
29784,U19078,25,-29682.50999999995,15,10,148081.47999999998,118398.97000000003
29785,U42300,25,967.6600000000003,22,3,5459.039999999999,6426.699999999999
29786,U24689,25,-1789.7400000000002,21,4,1919.2000000000003,129.46000000000004
29787,U888382,25,-295.4800000000001,19,6,1605.13,1309.65
29788,U14066,25,-8249.080000000016,14,11,235366.40000000002,227117.32
29789,U974307,25,-217.01000000000204,12,13,221540.2,221323.19
29790,U41344,25,2693.3599999999997,21,4,3024.1099999999997,5717.469999999999
29791,U14945,25,-9863.97,15,10,32453.739999999998,22589.769999999997
29792,U27966,25,-626.9100000000001,21,4,1585.6,958.6899999999998
29793,U28488,25,-7376.109999999999,16,9,46630.9,39254.79
29794,U19738,25,1442.1899999999987,10,15,89491.92,90934.11
29795,U20260,25,-353.0699999999997,14,11,8603.46,8250.39
29796,U27223,25,47122.67999999999,21,4,99746.19,146868.87
29797,U19537,25,-375.7900000000036,15,10,62118.100000000006,61742.310000000005
29798,U20387,25,1277.5699999999997,21,4,19104.21,20381.78
29799,U33151,25,-339.99999999999994,18,7,2261.9100000000003,1921.9100000000003
29800,U18758,25,-196218.22,22,3,208309.93,12091.709999999992
29801,U969923,25,602.1599999999999,14,11,11089.0,11691.16
29802,U25199,25,1011.01,15,10,16085.01,17096.02
29803,U656800,25,-2.96,17,8,34.86,31.9
29804,U18126,25,-18178.79,15,10,56950.07,38771.28
29805,U19847,25,-6372.42,20,5,8646.86,2274.4400000000005
29806,U39102,25,32811.18000000001,15,10,150646.56,183457.74
29807,U32189,25,1774.0,13,12,119836.0,121610.0
29808,U986785,25,-5895.41,23,2,7101.210000000001,1205.800000000001
29809,U39656,25,-6743.769999999979,17,8,453574.2,446830.43000000005
29810,U25034,25,21258.4,19,6,12256.38,33514.78
29811,U42814,25,-643.8500000000075,16,9,151934.05,151290.19999999998
29812,U39938,25,-91151.16,19,6,91868.13,716.9700000000012
29813,U9340,25,-8923.32,14,11,119190.13999999998,110266.81999999998
29814,U32104,25,358.5999999999981,14,11,56348.05,56706.65
29815,U41888,25,-1747.2400000000002,18,7,15646.409999999998,13899.169999999998
29816,U9517,25,9771.09,16,9,16909.93,26681.02
29817,U25666,25,22840.11,13,12,1078.26,23918.37
29818,U39156,25,-648.4400000000023,9,16,61237.87,60589.43
29819,U24117,25,1516.670000000002,15,10,48265.86,49782.53
29820,U9307,25,-2328.3599999999997,17,8,5753.02,3424.6600000000008
29821,U12738,25,2844.25,18,7,18364.190000000002,21208.440000000002
29822,U34259,25,15.910000000001673,18,7,15498.509999999998,15514.42
29823,U21123,25,-2499.890000000003,13,12,113720.37999999999,111220.48999999999
29824,U36396,25,639.7900000000009,11,14,58696.270000000004,59336.060000000005
29825,U21588,25,1158.6600000000035,7,18,290000.0,291158.66000000003
29826,U1286614,25,488.0300000000005,22,3,2807.8100000000004,3295.840000000001
29827,U19596,25,-1225.23,20,5,4394.030000000001,3168.8000000000006
29828,U665212,25,5.7500000000000995,14,11,2708.0899999999997,2713.8399999999997
29829,U27459,25,-14639.069999999992,13,12,540220.72,525581.65
29830,U39035,25,85424.94000000002,9,16,332694.67,418119.61
29831,U32290,25,3205.970000000001,13,12,78959.0,82164.97
29832,U10061,25,11865.150000000003,18,7,21564.92,33430.07
29833,U8211,25,-53.0,18,7,21669.16,21616.16
29834,U27427,25,-66492.58,17,8,83480.74,16988.160000000003
29835,U580097,25,-6899.87,19,6,17942.22,11042.350000000002
29836,U19795,25,201.32000000000815,11,14,300000.5,300201.82
29837,U42097,25,-14093.670000000006,17,8,118333.37999999999,104239.70999999999
29838,U779699,25,-0.8700000000010732,15,10,27714.99,27714.12
29839,U1027589,25,271.1,18,7,2758.1800000000003,3029.28
29840,U1229141,25,110.66999999999983,14,11,6640.24,6750.91
29841,U40666,25,-2734.6,16,9,28133.35,25398.75
29842,U15168,25,825796.97,14,11,740854.9600000001,1566651.9300000002
29843,U22676,25,319209.37,14,11,685674.69,1004884.0599999999
29844,U33488,25,5019.799999999999,19,6,81976.0,86995.8
29845,U41345,25,1982.4900000000002,19,6,2624.61,4607.1
29846,U18592,25,444.2499999999991,15,10,25280.59,25724.84
29847,U20880,25,-477.62999999999965,18,7,13652.64,13175.01
29848,U19595,25,-14260.68,20,5,20042.24,5781.560000000001
29849,U25655,25,-1854.2799999999997,11,14,18216.370000000003,16362.090000000004
29850,U34181,25,-645.140000000014,13,12,189729.22999999998,189084.08999999997
29851,U10338,25,-330.6799999999985,13,12,25058.0,24727.32
29852,U36053,25,19554.32999999984,8,17,2127508.83,2147063.16
29853,U20794,25,10660.910000000003,17,8,48745.5,59406.41
29854,U8793,25,78.59999999999985,17,8,27385.100000000002,27463.7
29855,U21213,25,327.60000000000036,12,13,24902.18,25229.78
29856,U1058500,25,5339.0999999999985,18,7,26570.030000000002,31909.13
29857,U33669,25,-12983.250000000004,21,4,23423.14,10439.889999999996
29858,U27711,25,3478.2,20,5,15650.0,19128.2
29859,U13155,25,-5160.810000000001,21,4,105268.17,100107.36
29860,U31433,25,29403.510000000002,20,5,54703.55,84107.06
29861,U985601,25,1007.7299999999998,15,10,4866.62,5874.349999999999
29862,U25851,25,-2893.71,20,5,4438.66,1544.9499999999998
29863,U28400,25,-4777.69,18,7,21667.16,16889.47
29864,U15430,25,36025.270000000004,19,6,47177.64,83202.91
29865,U27854,25,-95257.92,22,3,152600.0,57342.08
29866,U21275,25,-17262.82,20,5,42420.479999999996,25157.659999999996
29867,U43463,25,2220.130000000003,10,15,62045.13,64265.26
29868,U34599,25,22698.62,10,15,132001.0,154699.62
29869,U16237,25,38067.17,14,11,103286.1,141353.27000000002
29870,U37370,25,-15317.24000000002,13,12,306515.55,291198.30999999994
29871,U42397,25,14027.639999999998,18,7,81397.38,95425.02
29872,U43279,25,-4202.88,15,10,42277.26,38074.380000000005
29873,U29909,25,2131.46,12,13,230435.13,232566.59
29874,U39039,25,29352.45,18,7,5856.67,35209.12
29875,U10016,25,0.00999999999476131,14,11,339258.8,339258.81
29876,U13494,25,171.6899999999996,16,9,10547.89,10719.579999999998
29877,U11343,25,-5383.420000000001,18,7,12256.75,6873.329999999999
29878,U14996,25,2224.3400000000033,13,12,66422.56999999999,68646.90999999999
29879,U8735,25,-13661.73999999999,18,7,706809.0800000001,693147.3400000001
29880,U23755,25,-630.0500000000029,13,12,45818.0,45187.95
29881,U27192,25,-86766.46999999999,11,14,318938.03,232171.56000000006
29882,U36632,25,-60149.810000000005,20,5,86325.6,26175.79
29883,U32886,25,7181.610000000001,17,8,12398.239999999998,19579.85
29884,U20583,25,-2599.860000000001,15,10,17115.730000000003,14515.870000000003
29885,U24147,25,-5908.150000000023,13,12,936450.0,930541.85
29886,U13785,25,111688.22000000002,12,13,261103.04,372791.26
29887,U19209,25,2895.8800000000033,20,5,14504.279999999999,17400.160000000003
29888,U25137,25,-780.5900000000163,14,11,93717.31,92936.71999999999
29889,U12120,25,-15.829999999998781,16,9,26219.8,26203.97
29890,U966593,25,-2007.92,17,8,6313.160000000001,4305.240000000001
29891,U34882,25,-548.2099999999963,16,9,105921.36,105373.15000000001
29892,U1304527,25,1.1199999999998953,13,12,5420.51,5421.63
29893,U41348,25,26123.75,12,13,10749.68,36873.43
29894,U29714,25,-53966.7,12,13,143799.9,89833.2
29895,U31867,25,-325.96000000000004,19,6,8289.0,7963.04
29896,U21208,25,2628.7,12,13,32913.2,35541.899999999994
29897,U11994,25,40896.06,15,10,100750.0,141646.06
29898,U20183,25,-1480.4099999999999,12,13,47692.0,46211.59
29899,U38228,25,-5932.9699999999975,16,9,24816.2,18883.230000000003
29900,U13364,25,-3264.2400000000002,14,11,5227.91,1963.6699999999996
29901,U10975,25,77351.35999999997,15,10,272663.31,350014.67
29902,U39130,25,-392.1399999999999,20,5,5925.310000000001,5533.170000000002
29903,U31169,25,160.82000000000085,12,13,90476.0,90636.82
29904,U31850,25,67.59,18,7,543.44,611.0300000000001
29905,U44007,25,50753.380000000005,14,11,63855.36000000001,114608.74000000002
29906,U13076,25,57776.36000000003,13,12,350151.36,407927.72000000003
29907,U13721,25,76720.09000000004,12,13,513427.49,590147.5800000001
29908,U574582,25,259.45000000000005,12,13,2614.88,2874.33
29909,U20954,25,28.019999999999563,16,9,21372.76,21400.78
29910,U18337,25,-152278.24000000002,18,7,159655.26,7377.0199999999895
29911,U31016,25,43334.109999999986,10,15,317022.9,360357.01
29912,U31974,25,-46028.530000000144,13,12,574202.9,528174.3699999999
29913,U26339,25,2538.959999999497,14,11,13622446.92,13624985.879999999
29914,U21294,25,-2977.83,19,6,4641.32,1663.4899999999998
29915,U18092,25,-26237.480000000003,12,13,73726.28,47488.799999999996
29916,U39971,25,-4209.0,14,11,48007.69,43798.69
29917,U36311,25,9653.65,13,12,14858.0,24511.65
29918,U15919,25,-937.0200000000004,21,4,12425.02,11488.0
29919,U29168,25,33.430000000000035,20,5,328.87,362.30000000000007
29920,U22083,25,508.6200000000008,15,10,45991.16,46499.780000000006
29921,U22192,25,-2498.3099999999995,18,7,6348.360000000001,3850.050000000001
29922,U709345,25,-2636.1799999999994,20,5,8888.729999999998,6252.549999999998
29923,U23593,25,-52854.28999999999,17,8,156347.39,103493.10000000002
29924,U18194,25,-15548.100000000011,19,6,317935.0,302386.89999999997
29925,U22414,25,130001.98000000001,13,12,221074.0,351075.98
29926,U31600,25,2548.429999999999,20,5,34300.67,36849.1
29927,U28272,25,100132.15000000002,17,8,520023.0,620155.15
29928,U33951,25,-144499.61,10,15,394662.0,250162.39
29929,U40164,25,-3203.23,14,11,12564.89,9361.66
29930,U30623,25,162847.8600000001,12,13,1682124.17,1844972.03
29931,U947895,25,0.0,16,9,394.03999999999996,394.03999999999996
29932,U33758,25,-216.97000000000054,20,5,9673.14,9456.169999999998
29933,U14625,25,87054.5,16,9,98411.0,185465.5
29934,U27679,25,-5780.8499999999985,12,13,145234.0,139453.15
29935,U23848,25,-1517.0900000000083,14,11,299763.29000000004,298246.2
29936,U1187671,25,-2616.06,17,8,10448.480000000001,7832.420000000002
29937,U41293,25,-48605.86,12,13,102397.0,53791.14
29938,U38013,25,-31.439999999999145,16,9,22722.479999999996,22691.039999999997
29939,U19340,25,676.25,11,14,49379.69,50055.94
29940,U10955,25,-194462.53,17,8,535496.24,341033.70999999996
29941,U913209,25,-9570.05,16,9,23421.05,13851.0
29942,U22273,25,295.97999999999956,18,7,4344.48,4640.459999999999
29943,U13617,25,117.51000000000248,12,13,69778.68000000001,69896.19000000002
29944,U24462,25,-10451.11,15,10,26534.859999999993,16083.749999999993
29945,U32329,25,-98.73999999999978,15,10,5524.3,5425.56
29946,U34170,25,7388.26,20,5,7729.29,15117.55
29947,U34991,25,-1900.0000000000036,15,10,48245.39,46345.39
29948,U43848,25,-37105.07999999999,13,12,133358.0,96252.92000000001
29949,U14946,25,-967.369999999972,9,16,747914.9500000001,746947.5800000001
29950,U38203,25,-874.3699999999994,11,14,8484.49,7610.120000000001
29951,U37098,25,61110.44,11,14,391622.16,452732.6
29952,U32638,25,456.90000000000055,17,8,25608.14,26065.04
29953,U14295,25,-567.2100000000003,21,4,11715.149999999998,11147.939999999997
29954,U32652,25,2720.4299999999985,14,11,13069.550000000001,15789.98
29955,U41992,25,1592.9000000000044,18,7,197249.97,198842.87
29956,U21552,25,12348.92,19,6,25784.84,38133.76
29957,U16219,25,-194099.55000000002,10,15,728867.0,534767.45
29958,U16837,25,-10242.439999999999,20,5,12896.96,2654.5200000000004
29959,U24545,25,1.4210854715202004e-14,22,3,780.51,780.51
29960,U26668,25,-6352.1600000000035,17,8,113329.4,106977.23999999999
29961,U41825,25,-68105.58,22,3,99866.40999999999,31760.829999999987
29962,U30197,24,4061.580000000001,19,5,9568.869999999999,13630.45
29963,U23205,24,-9416.140000000003,7,17,323300.0,313883.86
29964,U32642,24,-264818.92,18,6,278179.13999999996,13360.219999999972
29965,U25096,24,7909.379999999999,2,22,11955.16,19864.54
29966,U752348,24,29497.66,13,11,40873.03000000001,70370.69000000002
29967,U38057,24,-227.04000000000002,18,6,2125.8199999999997,1898.7799999999997
29968,U26492,24,14040.579999999998,13,11,136534.21,150574.78999999998
29969,U12827,24,23449.13,10,14,34467.0,57916.130000000005
29970,U26446,24,-22282.000000000007,16,8,70659.41,48377.409999999996
29971,U37580,24,4744.549999999999,9,15,32234.589999999997,36979.14
29972,U16432,24,-1750.9400000000023,20,4,83754.0,82003.06
29973,U21124,24,-52018.97000000002,11,13,945639.02,893620.05
29974,U30949,24,16680.36,16,8,335230.5,351910.86
29975,U18057,24,-10440.66,16,8,45452.36,35011.7
29976,U32709,24,10057.68,14,10,67460.62,77518.29999999999
29977,U35302,24,-1940.9999999999989,18,6,12748.789999999999,10807.79
29978,U640089,24,-4790.48,17,7,9010.49,4220.01
29979,U25212,24,-5002.219999999994,11,13,224736.59,219734.37
29980,U24572,24,782844.42,10,14,778647.0,1561491.42
29981,U40555,24,110377.85,14,10,659822.37,770200.22
29982,U679570,24,46.12999999999994,21,3,3443.4900000000002,3489.6200000000003
29983,U33390,24,-17146.65,19,5,27000.0,9853.349999999999
29984,U17784,24,344.4300000000003,16,8,9985.66,10330.09
29985,U37020,24,-384.74999999999966,15,9,6112.7699999999995,5728.0199999999995
29986,U43475,24,-2808.109999999999,12,12,29848.0,27039.89
29987,U24456,24,-51313.60000000001,12,12,194115.34,142801.74
29988,U19416,24,-49046.59000000002,12,12,797303.81,748257.2200000001
29989,U36121,24,447.87,19,5,9013.359999999999,9461.23
29990,U39674,24,5554.1,18,6,1788.0,7342.1
29991,U31291,24,17711.519999999993,20,4,17297.5,35009.01999999999
29992,U24742,24,6271.84,14,10,21686.2,27958.04
29993,U22323,24,-1201.150000000001,19,5,5775.469999999999,4574.319999999998
29994,U34195,24,36093.119999999995,15,9,23377.0,59470.119999999995
29995,U15247,24,4489.1900000000005,19,5,37604.009999999995,42093.2
29996,U34271,24,15099.71,16,8,56909.77,72009.48
29997,U21972,24,-224.45999999999776,15,9,59675.76,59451.3
29998,U667602,24,-0.029999999998835847,12,12,19543.15,19543.120000000003
29999,U34780,24,-1711.23,20,4,3283.46,1572.23
30000,U27756,24,12910.74,20,4,3670.4100000000003,16581.15
30001,U21907,24,-1441.8500000000004,18,6,9849.28,8407.43
30002,U27996,24,2076.2899999999995,19,5,2522.48,4598.7699999999995
30003,U14503,24,-41164.119999999966,9,15,524366.32,483202.19999999995
30004,U702146,24,-3452.1,23,1,4088.74,636.6399999999999
30005,U29203,24,-8233.800000000001,17,7,44217.90000000001,35984.100000000006
30006,U38545,24,43840.39999999999,12,12,304801.0,348641.39999999997
30007,U28716,24,8.290000000000873,17,7,20377.87,20386.16
30008,U26692,24,117.07999999999767,13,11,47761.55,47878.63
30009,U38342,24,-404.14999999999964,14,10,35354.16,34950.01
30010,U26482,24,6980.38,11,13,72667.87,79648.25
30011,U24201,24,-365.6199999999652,12,12,758015.93,757650.31
30012,U38084,24,47980.41,15,9,202903.99,250884.4
30013,U15745,24,1536.33,18,6,6236.86,7773.19
30014,U36891,24,-47749.159999999996,21,3,87471.36,39722.200000000004
30015,U10127,24,54524.02000000002,15,9,287093.68,341617.7
30016,U37773,24,3321.41,14,10,27902.12,31223.53
30017,U27899,24,-42372.28,19,5,48282.0,5909.720000000001
30018,U752653,24,0.44000000000039563,15,9,14954.61,14955.050000000001
30019,U638937,24,9.419999999999973,16,8,1684.82,1694.24
30020,U29234,24,-7243.93,10,14,53765.79,46521.86
30021,U37248,24,-2781.79,23,1,2789.8,8.010000000000218
30022,U25927,24,12643.77,18,6,16051.09,28694.86
30023,U24644,24,-1272.78,22,2,1634.67,361.8900000000001
30024,U21151,24,-3220.9399999999996,13,11,16586.01,13365.07
30025,U18100,24,22445.18,14,10,39043.24999999999,61488.42999999999
30026,U21381,24,5592.050000000001,20,4,6784.139999999999,12376.19
30027,U24924,24,153.41999999999825,9,15,42166.0,42319.42
30028,U26201,24,2705.0099999999948,13,11,203076.78000000003,205781.79000000004
30029,U24604,24,417.51000000000045,13,11,26055.0,26472.510000000002
30030,U43446,24,8.590000000001055,18,6,20834.860000000004,20843.450000000004
30031,U11463,24,-3594.3300000000017,18,6,62094.659999999996,58500.329999999994
30032,U23956,24,606.1800000000023,20,4,10044.939999999997,10651.119999999999
30033,U25075,24,637.4200000000013,15,9,33601.009999999995,34238.42999999999
30034,U1105581,24,-5797.4400000000005,22,2,5871.47,74.02999999999975
30035,U593347,24,1049.2499999999995,15,9,6123.21,7172.459999999999
30036,U25398,24,-677.7,22,2,1587.0700000000002,909.3700000000001
30037,U8182,24,133.32999999999993,18,6,2476.23,2609.56
30038,U34468,24,-221307.40000000002,16,8,535132.5,313825.1
30039,U36338,24,12905.280000000002,12,12,66362.7,79267.98
30040,U11155,24,-6833.120000000001,21,3,7493.340000000002,660.2200000000012
30041,U37994,24,-19566.53000000001,16,8,125042.41,105475.87999999999
30042,U22317,24,282.85000000000036,10,14,37514.42,37797.27
30043,U34089,24,-18242.810000000027,14,10,330196.0,311953.18999999994
30044,U28195,24,-4888.4,21,3,17082.5,12194.1
30045,U1219788,24,618.7299999999999,16,8,1646.1799999999998,2264.91
30046,U40913,24,7421.889999999999,17,7,16533.800000000003,23955.690000000002
30047,U39021,24,6368.02,14,10,128748.20999999999,135116.22999999998
30048,U26121,24,2823.0999999999995,17,7,28077.670000000002,30900.77
30049,U34961,24,271.52000000000044,21,3,26225.3,26496.82
30050,U43835,24,47138.39,20,4,7002.22,54140.61
30051,U42452,24,-1269.7099999999973,17,7,28160.070000000003,26890.360000000008
30052,U38338,24,-847.3900000000001,12,12,8342.65,7495.259999999999
30053,U24345,24,-11291.670000000002,16,8,28461.22,17169.55
30054,U1322703,24,600.01,8,16,600.01,1200.02
30055,U20096,24,2234.689999999999,14,10,5728.829999999999,7963.519999999999
30056,U36615,24,-5340.229999999996,16,8,113892.0,108551.77
30057,U41440,24,-11952.04,16,8,44889.36,32937.32
30058,U598245,24,3000.42,11,13,18279.42,21279.839999999997
30059,U14036,24,12677.890000000003,16,8,53448.66,66126.55
30060,U41032,24,497291.88999999996,9,15,209548.0,706839.8899999999
30061,U32195,24,2387.0,19,5,3176.4399999999996,5563.44
30062,U15829,24,32546.78999999999,16,8,21878.57,54425.359999999986
30063,U16769,24,43548.73999999999,13,11,115009.86,158558.59999999998
30064,U16462,24,6969.370000000009,13,11,270980.81,277950.18
30065,U15751,24,-5922.030000000001,20,4,42939.75,37017.72
30066,U690260,24,-8994.300000000001,16,8,12525.410000000002,3531.1100000000006
30067,U1245716,24,108.60999999999997,9,15,352.12,460.72999999999996
30068,U1361226,24,-5433.06,19,5,11442.2,6009.14
30069,U35581,24,15759.68,18,6,10974.98,26734.66
30070,U23879,24,80758.79,11,13,110250.25,191009.03999999998
30071,U37163,24,3954.8000000000006,20,4,5543.920000000001,9498.720000000001
30072,U30715,24,4.069999999999936,15,9,1684.0,1688.07
30073,U22767,24,201453.67000000007,5,19,1000600.0,1202053.6700000002
30074,U33431,24,-36080.219999999994,13,11,70787.4,34707.18
30075,U18207,24,-491.27000000000055,20,4,31496.54,31005.27
30076,U948485,24,5992.519999999999,12,12,7560.04,13552.559999999998
30077,U25942,24,-99359.34,20,4,128066.19,28706.850000000006
30078,U20057,24,3735.7900000000004,16,8,5659.620000000002,9395.410000000002
30079,U22524,24,-94560.08999999978,16,8,1341856.28,1247296.1900000002
30080,U992643,24,-9708.689999999999,20,4,12599.279999999999,2890.59
30081,U14759,24,-35688.85,16,8,56787.560000000005,21098.710000000006
30082,U11889,24,-8494.15,15,9,20026.72,11532.570000000002
30083,U25100,24,-85.09999999999964,11,13,21896.5,21811.4
30084,U33828,24,-2592.3200000000056,16,8,256489.26,253896.94
30085,U15151,24,-294326.60000000003,15,9,1257123.8900000001,962797.29
30086,U971220,24,2637.34,11,13,3176.0,5813.34
30087,U10031,24,-137956.25,18,6,843187.91,705231.66
30088,U29313,24,151824.25000000003,11,13,286211.64999999997,438035.9
30089,U37829,24,192.83000000000462,17,7,207388.75999999998,207581.59
30090,U43352,24,-550.500000000005,17,7,90656.51000000001,90106.01000000001
30091,U30203,24,244194.67999999996,20,4,278097.08999999997,522291.7699999999
30092,U1294173,24,-3868.93,18,6,4665.599999999999,796.6699999999996
30093,U18138,24,-587756.58,14,10,1293097.0,705340.42
30094,U968823,24,-3938.91,16,8,5615.18,1676.2700000000004
30095,U29568,24,3892.689999999999,21,3,5209.000000000001,9101.69
30096,U39230,24,-10709.27,21,3,30641.07,19931.8
30097,U10721,24,-17046.45,16,8,34186.37,17139.920000000002
30098,U43779,24,1952.0400000000013,15,9,82916.02,84868.06000000001
30099,U716124,24,15.230000000000473,11,13,6874.78,6890.01
30100,U712974,24,3090.99,13,11,7672.650000000001,10763.64
30101,U24921,24,41579.880000000005,10,14,29714.86,71294.74
30102,U28010,24,-11703.810000000001,17,7,55970.020000000004,44266.21000000001
30103,U13616,24,302475.63,8,16,312760.54,615236.1699999999
30104,U16201,24,-470.75,19,5,5912.33,5441.58
30105,U13652,24,4496912.880000001,10,14,2590417.9599999995,7087330.84
30106,U30466,24,-706.9099999999987,18,6,12790.8,12083.890000000001
30107,U12703,24,-143387.74,12,12,1400400.0,1257012.26
30108,U43774,24,-699.9799999999991,14,10,21729.339999999997,21029.359999999997
30109,U17803,24,5470.21,11,13,10854.0,16324.21
30110,U30570,24,23119.440000000006,16,8,154001.93,177121.37
30111,U30184,24,-622.8099999999981,18,6,19863.56,19240.750000000004
30112,U962944,24,-602.3799999999999,19,5,2027.2399999999998,1424.86
30113,U1097668,24,1404.2100000000005,14,10,9905.73,11309.94
30114,U36753,24,2375.76,17,7,6794.75,9170.51
30115,U27820,24,-344.19,20,4,656.41,312.21999999999997
30116,U11226,24,-11905.31,20,4,14227.09,2321.7800000000007
30117,U39899,24,-35909.54000000001,16,8,80431.15000000001,44521.61
30118,U14237,24,-167924.11,16,8,193971.33,26047.22
30119,U25304,24,-181.25999999999993,23,1,181.32999999999993,0.06999999999999318
30120,U9213,24,20869.72999999998,13,11,179279.7,200149.43
30121,U9563,24,-619734.7200000001,14,10,1201052.86,581318.14
30122,U20835,24,883.5600000000001,20,4,678.02,1561.58
30123,U30966,24,33031.20999999999,15,9,174749.55,207780.75999999998
30124,U36262,24,1759.64,17,7,7150.01,8909.65
30125,U43770,24,-25954.53,18,6,51517.280000000006,25562.750000000007
30126,U34956,24,-5018.830000000002,12,12,85905.0,80886.17
30127,U39405,24,-6269.2100000000155,13,11,251941.91,245672.69999999998
30128,U22998,24,1976.6700000000012,10,14,42113.590000000004,44090.26
30129,U26215,24,87658.51,17,7,20745.5,108404.01
30130,U11790,24,-216811.07000000004,14,10,742847.6,526036.5299999999
30131,U23581,24,124178.53000000001,16,8,79752.80999999997,203931.33999999997
30132,U37567,24,-4362.9499999999925,10,14,132105.46,127742.51
30133,U29417,24,-30478.83,18,6,103281.73999999999,72802.90999999999
30134,U28255,24,8087.0199999999895,9,15,322590.6,330677.62
30135,U16947,24,18433.46,14,10,17573.72,36007.18
30136,U22314,24,-2996.95,18,6,10419.52,7422.570000000001
30137,U36050,24,2587.6099999999997,20,4,10553.79,13141.400000000001
30138,U22988,24,3431.570000000001,16,8,112519.26000000001,115950.83000000002
30139,U36640,24,49321.100000000006,8,16,22452.809999999998,71773.91
30140,U39223,24,-1082273.7,4,20,1326560.0,244286.30000000005
30141,U39012,24,831374.8699999999,11,13,1120045.2999999998,1951420.1699999997
30142,U19686,24,-1624.0800000000002,18,6,5360.82,3736.74
30143,U32235,24,64731.000000000015,9,15,53022.0,117753.00000000001
30144,U15285,24,-15038.81,19,5,38622.64,23583.83
30145,U31997,24,1610.9199999999992,15,9,21916.510000000002,23527.43
30146,U1240855,24,-1681.55,19,5,3785.23,2103.6800000000003
30147,U10310,24,-3931.629999999999,19,5,8356.539999999999,4424.91
30148,U19403,24,-4580.92,16,8,23395.86,18814.940000000002
30149,U598518,24,4925.86,18,6,7686.270000000001,12612.130000000001
30150,U975113,24,-59257.0,19,5,114637.0,55380.0
30151,U36024,24,3742.7200000000003,15,9,10088.49,13831.21
30152,U36218,24,-2163.69,21,3,2979.64,815.9499999999998
30153,U17021,24,2.819999999999709,14,10,118703.0,118705.82
30154,U1213476,24,-6420.8099999999995,20,4,14784.720000000001,8363.910000000002
30155,U917703,24,486.19000000000017,16,8,10327.36,10813.550000000001
30156,U788502,24,0.010000000000218279,11,13,24275.7,24275.71
30157,U40928,24,63937.76000000001,14,10,56397.82,120335.58000000002
30158,U27408,24,-1389.42,18,6,3997.47,2608.0499999999997
30159,U40898,24,12193.96,19,5,23566.280000000002,35760.240000000005
30160,U39241,24,-214818.13,8,16,441103.82999999996,226285.69999999995
30161,U37131,24,-1152.4900000000002,12,12,147287.38,146134.89
30162,U21895,24,1182.8899999999849,13,11,674209.19,675392.08
30163,U15521,24,-431327.01000000024,11,13,12569979.6,12138652.59
30164,U1021053,24,-18304.339999999997,17,7,29916.649999999994,11612.309999999998
30165,U27202,24,15908.71,14,10,31625.6,47534.31
30166,U31489,24,-4360.120000000001,23,1,4404.4400000000005,44.31999999999971
30167,U38556,24,-192120.69999999998,16,8,210726.21,18605.51000000001
30168,U15584,24,2718.709999999999,16,8,20808.08,23526.79
30169,U1042195,24,-632.95,19,5,1845.9599999999996,1213.0099999999995
30170,U23764,24,8900.150000000001,16,8,189607.0,198507.15
30171,U39897,24,5198.41,20,4,5011.549999999999,10209.96
30172,U9028,24,-1693.0399999999997,20,4,18197.28,16504.239999999998
30173,U11285,24,9409.740000000002,13,11,35662.46,45072.2
30174,U9388,24,103200.67000000001,12,12,103408.16,206608.83000000002
30175,U1131392,24,-2148.11,15,9,3491.12,1343.0099999999998
30176,U1106500,24,864.5699999999999,18,6,2506.85,3371.42
30177,U9616,24,2639.1600000000326,17,7,341304.9,343944.06000000006
30178,U43935,24,-21817.98,15,9,33783.3,11965.320000000003
30179,U43288,24,-1618.92,14,10,3502.3199999999997,1883.3999999999996
30180,U28088,24,-360.40999999999985,19,5,1282.0,921.5900000000001
30181,U28375,24,-210.8800000000004,21,3,5124.590000000002,4913.710000000002
30182,U1247927,24,-12.489999999999782,19,5,3331.96,3319.4700000000003
30183,U19003,24,-28.4899999999966,17,7,20429.83,20401.340000000004
30184,U27002,24,-47819.21000000001,20,4,60740.05,12920.839999999997
30185,U39937,24,2944.269999999976,14,10,409692.1,412636.36999999994
30186,U16205,24,-4831.75,21,3,6202.64,1370.8900000000003
30187,U37188,24,552170.5800000003,13,11,1852310.4000000001,2404480.9800000004
30188,U8893,24,3041.2499999999973,11,13,59947.5,62988.75
30189,U11348,24,34117.02,14,10,243586.46,277703.48
30190,U29303,24,-60367.570000000014,13,11,153898.9,93531.32999999999
30191,U10587,24,1152.4900000000002,19,5,2812.0,3964.4900000000002
30192,U9795,24,9694.27,12,12,4160.68,13854.95
30193,U1140381,24,1135.1999999999998,10,14,8998.23,10133.43
30194,U38653,24,110253.48999999999,6,18,15559.0,125812.48999999999
30195,U715369,24,-12006.870000000003,17,7,19252.850000000002,7245.98
30196,U24965,24,129956.32000000002,10,14,203567.31,333523.63
30197,U22463,24,-33471.08,15,9,119929.85999999999,86458.77999999998
30198,U14482,24,-221591.35,20,4,231943.2,10351.850000000006
30199,U634125,24,-2080.229999999999,21,3,10380.390000000003,8300.160000000003
30200,U28386,24,-258.0999999999949,18,6,48323.0,48064.90000000001
30201,U15879,24,-209162.31999999998,17,7,333936.64000000013,124774.32000000015
30202,U32182,24,10657.91,18,6,17084.18,27742.09
30203,U43255,24,-26590.46,12,12,314341.79000000004,287751.33
30204,U32317,24,-2048.4699999999993,21,3,16294.81,14246.34
30205,U34358,24,10782.33,15,9,17171.569999999996,27953.899999999994
30206,U23335,24,39709.079999999994,14,10,163589.14,203298.22
30207,U17576,24,135908.57,9,15,158218.92,294127.49
30208,U32105,24,10642.269999999999,12,12,16636.53,27278.799999999996
30209,U37471,24,34.13999999999953,12,12,14997.67,15031.81
30210,U18959,24,171374.03000000003,19,5,350514.0,521888.03
30211,U11689,24,-1011.5200000000023,19,5,19019.380000000005,18007.86
30212,U21640,24,24255.72000000001,14,10,279581.12,303836.84
30213,U19108,24,4453.779999999999,14,10,2864.15,7317.9299999999985
30214,U23551,24,5126.969999999999,14,10,53875.0,59001.97
30215,U26552,24,6272.51,13,11,15735.5,22008.010000000002
30216,U12106,24,-583.8399999999997,16,8,8270.080000000002,7686.240000000002
30217,U1114883,24,-2729.7,24,0,2729.7,0.0
30218,U39987,24,-9534.089999999997,9,15,40100.91,30566.820000000007
30219,U40457,24,-40739.10999999999,20,4,62515.759999999995,21776.65
30220,U15776,24,18298.71,11,13,63076.98,81375.69
30221,U24075,24,9585.759999999998,15,9,24531.0,34116.759999999995
30222,U10423,24,-2466.2700000000004,15,9,23090.480000000003,20624.210000000003
30223,U17953,24,3126.540000000001,12,12,56809.46,59936.0
30224,U43746,24,814.0699999999997,12,12,19752.58,20566.65
30225,U12753,24,1659.65,13,11,42184.14,43843.79
30226,U35873,24,-1050.2999999999965,13,11,167567.15000000002,166516.85000000003
30227,U10718,24,-7535.939999999999,16,8,25740.729999999996,18204.789999999997
30228,U29349,24,55.44000000000002,20,4,966.2699999999999,1021.7099999999999
30229,U43940,24,-61010.14,17,7,117529.68,56519.53999999999
30230,U18295,24,71434.56000000001,16,8,33414.8,104849.36000000002
30231,U1124309,24,7442.040000000003,16,8,16359.219999999998,23801.260000000002
30232,U17564,24,-15705.509999999997,13,11,233481.65,217776.13999999998
30233,U43381,24,5955.239999999998,10,14,109204.04000000001,115159.28
30234,U21135,24,25.180000000000064,18,6,3517.32,3542.5
30235,U29869,24,4423.25,2,22,4444.44,8867.689999999999
30236,U843696,24,375.1800000000003,20,4,6554.870000000001,6930.050000000001
30237,U1272101,24,1801.5599999999995,14,10,5028.9400000000005,6830.5
30238,U21358,24,0.07000000000005002,14,10,54703.81999999999,54703.88999999999
30239,U26114,24,66202.79000000001,14,10,680500.0,746702.79
30240,U11471,24,-1088.9700000000012,20,4,104217.5,103128.53
30241,U8216,24,321.7800000000002,13,11,46248.520000000004,46570.3
30242,U11786,24,60772.35,14,10,21538.19,82310.54
30243,U34389,24,1259.679999999999,17,7,12041.2,13300.88
30244,U839197,24,-165.91999999999916,19,5,6173.1900000000005,6007.270000000001
30245,U12926,24,9086.960000000006,18,6,19525.49999999999,28612.459999999995
30246,U28004,24,7650.730000000001,14,10,9519.84,17170.57
30247,U15831,24,42853.720000000576,8,16,5502123.51,5544977.23
30248,U25277,24,643.4300000000005,21,3,2870.7,3514.13
30249,U16265,24,262.0999999999767,11,13,222927.0,223189.09999999998
30250,U21549,24,-60174.179999999935,10,14,1204813.02,1144638.84
30251,U29316,24,1746.8700000000003,11,13,4750.43,6497.300000000001
30252,U43563,24,-2903.819999999999,14,10,39078.05,36174.23
30253,U34588,24,-3346.5099999999998,18,6,6908.58,3562.07
30254,U37792,24,-1587.5300000000007,18,6,45962.15,44374.62
30255,U39242,24,-5870.000000000001,20,4,33545.619999999995,27675.619999999995
30256,U16622,24,-3529.66,22,2,6045.55,2515.8900000000003
30257,U1161489,24,-4372.72,17,7,5663.49,1290.7699999999995
30258,U16503,24,-387.8000000000005,19,5,6511.63,6123.83
30259,U41894,24,-11966.479999999989,17,7,72159.45999999999,60192.98
30260,U40504,24,5500.08,13,11,26960.0,32460.08
30261,U778012,24,2301.18,14,10,2498.82,4800.0
30262,U31045,24,-3318.34,19,5,6817.340000000001,3499.000000000001
30263,U690757,24,-38233.119999999995,17,7,41095.89,2862.770000000004
30264,U25592,24,-339139.86000000004,15,9,868987.3300000001,529847.47
30265,U19737,24,-175636.08000000007,6,18,1765891.2,1590255.1199999999
30266,U23488,24,-820.0999999999894,13,11,123802.0,122981.90000000001
30267,U14926,24,10430.83,17,7,4181.1,14611.93
30268,U22713,24,16147.630000000005,14,10,1282932.83,1299080.46
30269,U35088,24,13952.510000000002,13,11,43756.76,57709.270000000004
30270,U18321,24,8381.329999999998,15,9,11736.06,20117.39
30271,U43727,24,1834.14,14,10,5074.200000000001,6908.340000000001
30272,U25590,24,377403.47000000003,13,11,30640.299999999996,408043.77
30273,U38960,24,267.8699999999974,18,6,67870.56999999995,68138.43999999994
30274,U35053,24,18965.52,15,9,25523.61,44489.130000000005
30275,U10926,24,-3826.1100000000006,15,9,33752.11,29926.0
30276,U33991,24,6225.5199999999995,18,6,3640.56,9866.08
30277,U38138,24,7906.669999999998,11,13,226939.0,234845.66999999998
30278,U10247,24,-5605.610000000001,17,7,42523.10999999999,36917.49999999999
30279,U1379630,24,-9585.05,19,5,10332.02,746.9700000000012
30280,U22245,24,83929.02999999998,14,10,118647.17,202576.19999999998
30281,U21152,24,-2579.1400000000003,15,9,13553.0,10973.86
30282,U23394,24,11964341.74,5,19,14774150.67,26738492.41
30283,U30371,24,-2121.9900000000016,19,5,43116.7,40994.70999999999
30284,U32120,24,-1283.7099999999998,23,1,1284.12,0.41000000000008185
30285,U693950,24,0.0,14,10,7725.0,7725.0
30286,U10018,24,-104444.43999999999,18,6,558808.8999999999,454364.4599999999
30287,U10800,24,-33522.92,18,6,57955.69,24432.770000000004
30288,U31749,24,31502.39,9,15,40540.92,72043.31
30289,U15298,24,-27184.13000000001,13,11,175006.27000000002,147822.14
30290,U1366145,24,4869.700000000001,13,11,3480.1700000000005,8349.87
30291,U9104,24,60.87000000000012,22,2,6489.529999999999,6550.399999999999
30292,U37143,24,-1309.65,16,8,2485.68,1176.0299999999997
30293,U18305,24,137.82000000000244,19,5,103229.04999999999,103366.87
30294,U12509,24,2476.9099999999976,17,7,41276.98,43753.89
30295,U9995,24,-2352.71,19,5,14641.74,12289.029999999999
30296,U21078,24,-4132.13,17,7,17715.19,13583.059999999998
30297,U43290,24,-6757.620000000003,17,7,38938.5,32180.879999999997
30298,U18890,24,29569.619999999988,17,7,100587.6,130157.22
30299,U679234,24,-2748.9300000000003,16,8,10244.94,7496.01
30300,U35608,24,13647.819999999998,18,6,109638.40000000001,123286.22
30301,U14941,24,-488.2600000000002,16,8,19243.58,18755.32
30302,U41445,24,-3694.0099999999948,19,5,33296.54999999999,29602.539999999994
30303,U37630,24,-12379.910000000002,19,5,20230.0,7850.089999999998
30304,U33600,24,-9510.71,10,14,90345.18,80834.47
30305,U35483,24,7324.189999999995,15,9,71065.38,78389.57
30306,U25594,24,6713.029999999999,16,8,4803.6,11516.63
30307,U1135716,24,-6409.85,12,12,13389.94,6980.09
30308,U40288,24,7828.439999999999,21,3,2174.02,10002.46
30309,U36386,24,-368.2,20,4,508.25000000000006,140.05000000000007
30310,U22403,24,93829.43000000001,9,15,103198.93000000001,197028.36000000002
30311,U9056,24,10018.87,14,10,8487.56,18506.43
30312,U37506,24,-2503.1800000000003,19,5,3803.66,1300.4799999999996
30313,U1198142,24,-4.400000000000089,19,5,1988.2799999999997,1983.8799999999997
30314,U40844,24,-10631.83,14,10,29908.2,19276.370000000003
30315,U14576,24,-647.8300000000138,12,12,710208.58,709560.75
30316,U34814,24,-1070.3199999999997,15,9,18133.32,17063.0
30317,U29673,24,-2654.82,17,7,35478.649999999994,32823.829999999994
30318,U17004,24,-1165.8100000000013,16,8,24478.27,23312.46
30319,U606521,24,-2732.7700000000004,20,4,4250.920000000001,1518.1500000000005
30320,U38671,24,5283.650000000001,16,8,1356.1,6639.75
30321,U17804,24,-50676.03999999999,12,12,170484.32,119808.28000000001
30322,U35039,24,-20.750000000000764,10,14,203734.0,203713.25
30323,U1299573,24,-753.2099999999999,16,8,2284.2,1530.9899999999998
30324,U13447,24,882.2700000000003,18,6,30097.36,30979.63
30325,U32478,24,333.63999999999993,14,10,1680.31,2013.9499999999998
30326,U11013,24,-3997.8399999999965,10,14,140000.0,136002.16
30327,U12541,24,572.7299999999999,18,6,8227.289999999999,8800.019999999999
30328,U28992,24,52114.79,11,13,38130.0,90244.79000000001
30329,U28079,24,-237.25999999999976,17,7,8968.92,8731.66
30330,U29578,24,-68069.86,16,8,88225.97,20156.11
30331,U649543,24,-279.77000000000004,14,10,667.98,388.21
30332,U39027,23,3640.040000000037,18,5,400997.9,404637.94000000006
30333,U9966,23,-3375.3400000000115,11,12,821028.4400000001,817653.1000000001
30334,U33970,23,-4198.159999999999,20,3,8437.17,4239.010000000001
30335,U10628,23,-1585.7299999999996,18,5,5595.719999999999,4009.99
30336,U953061,23,0.0,12,11,1009.4599999999999,1009.4599999999999
30337,U19785,23,62181.01000000001,14,9,259321.44,321502.45
30338,U42932,23,29.43000000000029,21,2,4973.3,5002.7300000000005
30339,U19924,23,-129274.29000000001,17,6,170433.83000000002,41159.54000000001
30340,U40307,23,5003.82,9,14,80103.3,85107.12
30341,U28086,23,761.710000000001,15,8,31861.5,32623.21
30342,U16086,23,9289.540000000008,14,9,310441.11,319730.65
30343,U40537,23,-1640.0899999999913,16,7,106466.62,104826.53
30344,U1272690,23,1.3200000000006185,11,12,18860.7,18862.02
30345,U30902,23,91.59,19,4,198.44,290.03
30346,U19321,23,-3305.29,14,9,6104.02,2798.7300000000005
30347,U21523,23,1074.9400000000023,18,5,60259.060000000005,61334.00000000001
30348,U42299,23,130.27999999999884,11,12,748879.99,749010.27
30349,U38421,23,-26059.979999999996,16,7,100501.50999999998,74441.52999999998
30350,U18217,23,-4560.57,17,6,14247.96,9687.39
30351,U10197,23,54398.090000000004,16,7,127710.02,182108.11000000002
30352,U620350,23,-3.206324095117452e-13,14,9,9366.079999999998,9366.079999999998
30353,U37577,23,-159.20000000000033,16,7,11821.249999999998,11662.049999999997
30354,U40773,23,-10424.4,16,7,13331.34,2906.9400000000005
30355,U33671,23,156888.13,5,18,1170000.0,1326888.13
30356,U1137410,23,-2596.4900000000007,19,4,2598.0800000000004,1.5899999999996908
30357,U21945,23,16618.059999999994,11,12,306986.43,323604.49
30358,U28818,23,11893.920000000006,13,10,43848.32000000001,55742.24000000001
30359,U982323,23,-1116.0299999999997,17,6,5014.32,3898.29
30360,U39331,23,-563.48,16,7,10683.16,10119.68
30361,U38449,23,52.360000000000014,10,13,2405.63,2457.9900000000002
30362,U38112,23,-13.489999999999782,10,13,8719.67,8706.18
30363,U13279,23,206814.42999999996,15,8,506310.94000000006,713125.37
30364,U36962,23,-5113.430000000001,17,6,17350.0,12236.57
30365,U42286,23,1336.13,11,12,19809.71,21145.84
30366,U605231,23,9.510000000000218,15,8,15194.5,15204.01
30367,U30495,23,1962.5,11,12,35952.78,37915.28
30368,U661272,23,121.37999999999903,20,3,5610.070000000001,5731.45
30369,U38859,23,-3639.2000000000003,15,8,12669.939999999999,9030.739999999998
30370,U1246646,23,14133.26,15,8,9256.93,23390.190000000002
30371,U31744,23,168.66000000000005,20,3,1931.36,2100.02
30372,U17438,23,-178881.48,17,6,245141.52000000002,66260.04000000001
30373,U688794,23,-26712.519999999997,22,1,26712.539999999997,0.020000000000436557
30374,U14370,23,-1274.6399999999994,17,6,5478.14,4203.500000000001
30375,U43378,23,-1536.319999999996,12,11,56456.009999999995,54919.69
30376,U19613,23,-96.17999999999883,12,11,9722.019999999999,9625.84
30377,U1106438,23,0.39000000000002544,13,10,415.61,416.00000000000006
30378,U24702,23,1939.4800000000032,13,10,25082.03,27021.510000000002
30379,U43382,23,150.6400000000001,16,7,1478.9599999999996,1629.5999999999997
30380,U43622,23,-1198.4199999999971,15,8,34959.75,33761.33
30381,U18103,23,-28.489999999999952,18,5,552.52,524.03
30382,U33531,23,-83.07999999999902,12,11,22762.699999999997,22679.62
30383,U40682,23,-12772.140000000001,17,6,38775.990000000005,26003.850000000006
30384,U36196,23,-2264.210000000004,10,13,58293.450000000004,56029.24
30385,U30062,23,2608.8200000000033,11,12,82529.4,85138.22
30386,U36172,23,-29824.77000000002,14,9,338154.7,308329.93
30387,U34320,23,-4716.529999999999,12,11,148601.74,143885.21
30388,U43572,23,3.0600000000085856,12,11,37571.990000000005,37575.05000000002
30389,U34182,23,-1102.8700000000006,17,6,15955.079999999998,14852.209999999997
30390,U9947,23,4018.4000000000005,14,9,30216.539999999997,34234.939999999995
30391,U37624,23,170.16000000000076,13,10,18704.29,18874.45
30392,U39751,23,-690.9199999999861,12,11,802867.24,802176.32
30393,U33221,23,2575.770000000004,11,12,135268.0,137843.77000000002
30394,U30655,23,-3422.1600000000035,13,10,49888.1,46465.939999999995
30395,U19617,23,-2610.579999999987,6,17,332000.0,329389.42000000004
30396,U21937,23,-74.46999999999935,20,3,10310.2,10235.730000000001
30397,U23948,23,-8876.7,11,12,20806.170000000002,11929.470000000001
30398,U1121784,23,-3110.3199999999997,16,7,18868.660000000003,15758.340000000004
30399,U21491,23,10755.25,13,10,26838.14,37593.39
30400,U1138109,23,-14707.390000000005,20,3,39846.55999999999,25139.169999999984
30401,U38538,23,4211.63,10,13,20693.300000000003,24904.930000000004
30402,U29309,23,-11177.17,19,4,11802.82,625.6499999999996
30403,U30974,23,5267.540000000001,14,9,9882.11,15149.650000000001
30404,U35192,23,-494.68999999999994,19,4,1897.77,1403.08
30405,U19242,23,48.45000000000073,20,3,13751.599999999999,13800.05
30406,U34614,23,7431.730000000003,7,16,331189.22,338620.94999999995
30407,U41553,23,9147.109999999997,15,8,34254.35,43401.45999999999
30408,U39162,23,930.9099999999999,15,8,4669.740000000001,5600.650000000001
30409,U14282,23,4616.740000000001,6,17,8916.4,13533.14
30410,U10033,23,-57381.64,19,4,150191.64,92810.00000000001
30411,U17412,23,-72526.73,12,11,150168.84,77642.11
30412,U20959,23,24026.27,15,8,19646.55,43672.82
30413,U40965,23,-12481.44,15,8,39239.86000000001,26758.420000000006
30414,U1273222,23,-2107.5000000000005,16,7,12214.9,10107.4
30415,U35492,23,10717.169999999998,9,14,10516.2,21233.37
30416,U12794,23,-16295.93,20,3,26025.65,9729.720000000001
30417,U10759,23,29647.079999999994,17,6,57843.06000000001,87490.14000000001
30418,U23149,23,3130.16,18,5,19304.04,22434.2
30419,U36876,23,6617.190000000002,16,7,77317.23,83934.42
30420,U29333,23,10887.979999999996,15,8,64315.25,75203.23
30421,U20118,23,-9.470000000001164,14,9,339122.30999999994,339112.83999999997
30422,U32671,23,-232.4400000000001,15,8,8591.64,8359.199999999999
30423,U18218,23,-406.44999999999834,11,12,34000.03,33593.58
30424,U19650,23,-12153.95,12,11,82022.73999999999,69868.79
30425,U40719,23,-1628.0999999999985,17,6,38069.0,36440.9
30426,U24704,23,-4332.799999999999,15,8,27911.390000000003,23578.590000000004
30427,U20172,23,548.7499999999994,14,9,9936.84,10485.59
30428,U14512,23,-12605.699999999993,16,7,69447.09,56841.39
30429,U13702,23,12928.37999999999,15,8,206419.05000000002,219347.43
30430,U10133,23,16813.46,12,11,44044.36,60857.82
30431,U891831,23,-228.6500000000001,11,12,1737.83,1509.1799999999998
30432,U1383246,23,-11103.970000000005,18,5,37151.24,26047.269999999993
30433,U36994,23,-141871.65999999997,19,4,152441.40999999997,10569.75
30434,U20149,23,88530.96,14,9,60973.22,149504.18
30435,U34972,23,126.95999999999913,10,13,130396.6,130523.56
30436,U9705,23,1131.119999999999,14,9,37295.96000000001,38427.08
30437,U38141,23,5049.690000000018,14,9,205496.0,210545.69000000003
30438,U8056,23,25516.000000000004,9,14,32751.69,58267.69
30439,U12275,23,-58578.46,16,7,141515.36,82936.9
30440,U1201611,23,-3358.1900000000005,17,6,9862.54,6504.35
30441,U18487,23,38249.69,12,11,60508.0,98757.69
30442,U10716,23,28729.66,15,8,79671.09999999999,108400.76
30443,U953574,23,-7572.660000000001,14,9,33781.740000000005,26209.080000000005
30444,U31072,23,-9167.91,17,6,13237.099999999997,4069.189999999997
30445,U22185,23,-34379.80999999999,14,9,68783.45,34403.64000000001
30446,U38389,23,1480.3300000000017,13,10,172163.51,173643.84000000003
30447,U34710,23,-74.57999999999973,10,13,10374.939999999999,10300.359999999999
30448,U19450,23,-18248.05999999999,9,14,343215.0,324966.94
30449,U35444,23,-370.03,19,4,1731.28,1361.25
30450,U35523,23,-8251.32,15,8,20806.830000000005,12555.510000000006
30451,U31064,23,-407.76000000000204,16,7,50128.71,49720.95
30452,U665935,23,-1049.15,11,12,7731.55,6682.4
30453,U621676,23,-663.9599999999999,16,7,5555.389999999999,4891.429999999999
30454,U9576,23,-555.4800000000978,11,12,2083219.96,2082664.48
30455,U39076,23,-1830.3700000000001,16,7,28214.27,26383.9
30456,U38690,23,-58963.670000000006,19,4,93616.40000000001,34652.73
30457,U10286,23,254392.12999999995,13,10,32037.050000000003,286429.17999999993
30458,U33489,23,10467.02,14,9,59183.0,69650.02
30459,U22746,23,178.23000000000005,11,12,10932.05,11110.279999999999
30460,U29044,23,-8289.51,20,3,8402.07,112.55999999999949
30461,U33584,23,125943.31,10,13,123402.78,249346.09
30462,U34124,23,-1332.9500000000007,18,5,23817.85,22484.899999999998
30463,U31053,23,2615.49999999999,8,15,123897.87,126513.36999999998
30464,U36160,23,-3153.95,22,1,6995.900000000001,3841.9500000000007
30465,U31281,23,-10671.370000000006,10,13,200225.0,189553.63
30466,U31495,23,1119.199999999994,10,13,171656.56,172775.75999999998
30467,U31706,23,9502.780000000012,13,10,136326.97999999998,145829.75999999998
30468,U857285,23,-224.0,13,10,3725.44,3501.44
30469,U34324,23,0.5300000000006548,12,11,31100.0,31100.53
30470,U9549,23,144756.08,9,14,1147.51,145903.59
30471,U40388,23,0.0,13,10,68240.48,68240.48
30472,U11279,23,-119552.58,16,7,176646.0,57093.42
30473,U34849,23,-5554.920000000002,9,14,34281.810000000005,28726.890000000003
30474,U1142706,23,0.13000000000015005,12,11,12700.300000000001,12700.430000000002
30475,U32416,23,10030.540000000023,9,14,128338.0,138368.54000000004
30476,U11916,23,21342.539999999997,17,6,35933.490000000005,57276.03
30477,U9645,23,9537.879999999997,13,10,38484.0,48021.88
30478,U23062,23,21216.659999999996,15,8,20706.13,41922.78999999999
30479,U43092,23,25405.94,16,7,217966.33,243372.27
30480,U20316,23,-8576.89,14,9,20142.52,11565.630000000001
30481,U13344,23,-18436.059999999994,14,9,55076.399999999994,36640.34
30482,U9179,23,-7749.100000000002,17,6,35035.23,27286.13
30483,U12694,23,19397.789999999997,12,11,23702.3,43100.09
30484,U24760,23,24848.210000000003,15,8,13450.79,38299.0
30485,U28059,23,48112.85,18,5,51921.08,100033.93
30486,U1109001,23,3172.7799999999997,11,12,4451.509999999999,7624.289999999999
30487,U28806,23,2131.5200000000004,18,5,15246.04,17377.56
30488,U30612,23,29501.270000000004,10,13,11742.130000000001,41243.40000000001
30489,U748908,23,-1360.69,19,4,1760.75,400.05999999999995
30490,U36214,23,-16126.900000000003,15,8,524857.3600000001,508730.4600000001
30491,U24094,23,805.15,20,3,230.0,1035.15
30492,U36408,23,-12637.579999999998,20,3,17622.69,4985.110000000001
30493,U24262,23,77323.97,9,14,38677.95,116001.92
30494,U40086,23,4044.2199999999993,17,6,20358.14,24402.36
30495,U26132,23,19079.130000000012,13,10,321100.0,340179.13
30496,U13294,23,-436.70999999999947,13,10,3537.62,3100.9100000000003
30497,U20210,23,-6041.880000000002,19,4,16712.56,10670.68
30498,U27933,23,-20725.229999999996,13,10,56395.0,35669.770000000004
30499,U13526,23,-21540.210000000003,15,8,61540.25000000001,40000.04000000001
30500,U18637,23,1241.6099999999997,16,7,21444.469999999998,22686.079999999998
30501,U33172,23,-58186.090000000004,18,5,122032.0,63845.909999999996
30502,U22004,23,-76173.57,18,5,88723.81000000001,12550.240000000005
30503,U12831,23,7143.959999999998,19,4,10955.389999999998,18099.349999999995
30504,U11311,23,-29509.03,15,8,30713.010000000002,1203.9800000000032
30505,U36595,23,1846.9399999999996,13,10,34554.72,36401.66
30506,U29162,23,-9951.12,14,9,41550.45,31599.329999999994
30507,U12447,23,1273.2400000000023,12,11,252980.78000000003,254254.02000000002
30508,U35284,23,-84.839999999979,12,11,277959.12,277874.28
30509,U23443,23,12131.57,15,8,18730.25,30861.82
30510,U35139,23,-1197.0699999999988,16,7,31099.82,29902.75
30511,U36340,23,4355.640000000002,11,12,48168.97,52524.61
30512,U11867,23,-23511.860000000015,10,13,392913.0,369401.14
30513,U18777,23,-120651.73000000001,13,10,236361.35,115709.62
30514,U26087,23,-1983.7700000000004,14,9,33720.0,31736.23
30515,U1091308,23,-363.84999999999974,13,10,17669.34,17305.49
30516,U19335,23,-29695.350000000006,12,11,51954.0,22258.649999999994
30517,U36279,23,-5309.82,14,9,16637.45,11327.630000000001
30518,U1107437,23,0.0,14,9,179.39,179.39
30519,U30647,23,88527.70000000003,16,7,208290.01,296817.71
30520,U41998,23,-1201.21,15,8,10398.34,9197.130000000001
30521,U20382,23,27520.010000000002,13,10,81610.03,109130.04000000001
30522,U30991,23,-5187.5499999999865,17,6,50015.39000000001,44827.84000000002
30523,U23961,23,4584.91,12,11,58219.23999999999,62804.149999999994
30524,U37117,23,57249.73999999999,16,7,471660.0,528909.74
30525,U9157,23,40748.98999999999,13,10,95256.9,136005.88999999998
30526,U32324,23,631261.82,8,15,703900.01,1335161.83
30527,U36808,23,4021.6300000000083,10,13,72844.0,76865.63
30528,U617414,23,-1748.8200000000002,14,9,3462.0099999999998,1713.1899999999996
30529,U24369,23,2015.1299999999464,13,10,933127.88,935143.01
30530,U17135,23,362878.17000000004,8,15,1559000.0,1921878.17
30531,U13092,23,167.81000000000057,14,9,52305.520000000004,52473.33
30532,U33416,23,0.0,12,11,29606.25,29606.25
30533,U39208,23,-131.84999999999812,8,15,53430.79,53298.94
30534,U31069,23,-2046.22,19,4,3097.08,1050.86
30535,U22994,23,-78.65999999999622,9,14,207373.0,207294.34
30536,U32640,23,-37513.71,12,11,47318.91,9805.200000000004
30537,U35465,23,-176.48000000000684,16,7,74345.73000000001,74169.25
30538,U17036,23,-165194.81000000006,7,16,251004.0,85809.18999999994
30539,U26334,23,-14873.89,16,7,33284.899999999994,18411.009999999995
30540,U38048,23,5632.789999999996,14,9,109904.79999999999,115537.58999999998
30541,U22526,23,2109.510000000001,18,5,6743.799999999999,8853.310000000001
30542,U942420,23,-1528.7600000000002,11,12,12624.36,11095.6
30543,U42110,23,-54438.98,15,8,91088.4,36649.41999999999
30544,U30973,23,7857.58,12,11,26472.620000000003,34330.200000000004
30545,U35740,23,2738.0699999999993,9,14,5834.57,8572.64
30546,U22658,23,1.1600000000034925,11,12,273000.0,273001.16000000003
30547,U39965,23,-3587.08,15,8,15367.5,11780.42
30548,U1125279,23,1998.63,15,8,14085.6,16084.23
30549,U30926,23,-5402.02,15,8,9833.06,4431.039999999999
30550,U1172118,23,-1.699999999999875,15,8,4557.81,4556.110000000001
30551,U23033,23,-12262.78,17,6,12388.060000000001,125.28000000000065
30552,U37649,23,-12997.430000000004,11,12,580626.29,567628.86
30553,U34478,23,-1165.4400000000082,13,10,161931.1,160765.66
30554,U14697,23,26418.94,17,6,21581.190000000002,48000.130000000005
30555,U20892,23,-3627.509999999993,17,6,38627.23999999999,34999.729999999996
30556,U12403,23,41198.70999999996,12,11,1111406.0,1152604.71
30557,U27741,23,11836.18,17,6,14364.0,26200.18
30558,U42576,23,-14516.419999999998,16,7,27998.47,13482.050000000003
30559,U39500,23,-147157.36,15,8,637710.68,490553.32000000007
30560,U37809,23,-25674.210000000003,14,9,71236.2,45561.98999999999
30561,U18929,23,839.1300000000047,14,9,1072735.5,1073574.63
30562,U41665,23,-48213.29000000001,15,8,80724.32,32511.03
30563,U42222,23,-1843.7200000000003,17,6,2098.91,255.1899999999996
30564,U20577,23,-6787.750000000002,9,14,71503.0,64715.25
30565,U41082,23,33.77000000000007,14,9,1475.3100000000004,1509.0800000000004
30566,U603098,23,-67.91000000000004,12,11,13905.269999999999,13837.359999999999
30567,U37023,23,3810.6899999999982,12,11,44012.67,47823.35999999999
30568,U622354,23,-4.093947403305265e-14,13,10,3909.0,3909.0
30569,U41973,23,-46665.92,11,12,105454.8,58788.880000000005
30570,U8712,23,-4720.3,18,5,16751.32,12031.02
30571,U25431,23,7532.1500000000015,10,13,85064.85,92597.0
30572,U24710,23,101487.21999999999,12,11,131734.0,233221.21999999997
30573,U42134,23,7164.359999999997,13,10,70545.45,77709.81
30574,U13063,23,-36644.17,8,15,376736.0,340091.83
30575,U9740,23,-1485.3799999999999,21,2,2732.7599999999998,1247.3799999999999
30576,U31020,23,8869.21,10,13,4513.9,13383.109999999999
30577,U19066,23,-581203.05,8,15,1884998.6,1303795.55
30578,U14514,23,5094.61999999999,7,16,360882.66000000003,365977.28
30579,U30421,23,-2593.2799999999993,19,4,11905.300000000003,9312.020000000004
30580,U31558,23,8737.189999999999,9,14,4383.710000000001,13120.9
30581,U9643,23,2495.0700000000006,15,8,12375.689999999999,14870.759999999998
30582,U1212045,23,2340.6200000000003,12,11,7483.460000000001,9824.080000000002
30583,U1159559,23,7695.3099999999995,11,12,12806.82,20502.129999999997
30584,U1136232,23,-3577.8,19,4,5265.04,1687.2399999999998
30585,U25316,23,-1067.2700000000077,10,13,123484.33,122417.06
30586,U14905,23,69627.22,8,15,360944.14,430571.36
30587,U675964,23,795.2599999999993,16,7,5448.34,6243.599999999999
30588,U40489,23,14050.869999999999,19,4,6026.42,20077.29
30589,U43587,23,-2965.749999999999,20,3,13352.0,10386.25
30590,U34732,23,-2167.41,19,4,12607.0,10439.59
30591,U41106,23,403.9899999999999,21,2,1496.3600000000001,1900.35
30592,U31597,23,2032.4400000000003,18,5,5309.67,7342.110000000001
30593,U34946,23,2815.59,18,5,11664.33,14479.92
30594,U19611,23,13.1,18,5,556.8,569.9
30595,U8160,23,-862.9099999999471,14,9,850588.2100000001,849725.3000000002
30596,U39499,23,-98.94999999999997,17,6,706.7400000000001,607.7900000000002
30597,U1245371,23,-3095.08,22,1,3095.1699999999996,0.08999999999969077
30598,U28068,23,95542.44,5,18,120100.0,215642.44
30599,U10359,23,20198.47,12,11,32379.829999999998,52578.3
30600,U37514,23,18814.27,11,12,12840.34,31654.61
30601,U25218,23,-561.0100000000002,18,5,2319.09,1758.08
30602,U16112,23,20776.719999999976,15,8,222397.64,243174.36
30603,U15361,23,-34435.56,14,9,96986.26000000001,62550.70000000001
30604,U16797,23,-5272.640000000002,14,9,41810.26,36537.62
30605,U31993,23,-1038.7899999999995,10,13,26811.39,25772.6
30606,U38135,23,1397.9000000000008,16,7,11108.1,12506.000000000002
30607,U1155220,23,-52.849999999996506,15,8,110104.32999999999,110051.48
30608,U20188,23,-114.6899999999996,16,7,14471.14,14356.45
30609,U1194311,23,-10.599999999999454,18,5,6211.240000000001,6200.640000000001
30610,U10322,23,2077.9699999999993,15,8,16539.86,18617.83
30611,U43786,23,21757.059999999998,10,13,3362.21,25119.269999999997
30612,U1074061,23,5806.009999999999,14,9,11433.2,17239.21
30613,U34543,23,3825.76,15,8,4581.59,8407.35
30614,U17838,23,7228.550000000002,20,3,14471.48,21700.030000000002
30615,U13028,23,-179.72999999999996,16,7,13662.54,13482.810000000001
30616,U27411,23,190582.45,7,16,342757.0,533339.45
30617,U798846,23,1855.7300000000005,11,12,18926.44,20782.17
30618,U834262,23,16628.86,8,15,20701.660000000003,37330.520000000004
30619,U699147,23,-0.9600000000000364,15,8,1857.6599999999999,1856.6999999999998
30620,U17833,23,930.289999999999,12,11,20387.510000000002,21317.800000000003
30621,U38728,23,145157.11000000002,12,11,278829.48000000004,423986.5900000001
30622,U1139234,23,-110.57000000000058,17,6,11985.0,11874.43
30623,U10175,23,18219.72,16,7,26386.16,44605.880000000005
30624,U38918,23,66.60000000000036,12,11,21333.4,21400.0
30625,U33727,23,203.94000000000003,18,5,1076.1399999999999,1280.08
30626,U23630,23,-73976.65,11,12,170902.84000000003,96926.19000000003
30627,U656825,23,-2616.3900000000003,19,4,4966.51,2350.12
30628,U23547,23,-23280.870000000003,16,7,47850.56,24569.689999999995
30629,U35271,23,1176.4399999999994,14,9,10840.610000000002,12017.050000000001
30630,U42578,23,8787.189999999999,18,5,17220.0,26007.19
30631,U11575,23,-5565.0300000000025,19,4,42783.4,37218.369999999995
30632,U40278,23,-8023.940000000005,7,16,46331.549999999996,38307.60999999999
30633,U40274,23,-372.20000000000005,15,8,1842.69,1470.49
30634,U40860,23,764.9200000000001,15,8,2433.35,3198.27
30635,U24196,23,642.1300000000006,18,5,30033.02,30675.15
30636,U42340,23,18167.17,20,3,11638.650000000001,29805.82
30637,U30981,23,-24578.890000000003,20,3,31078.9,6500.009999999998
30638,U38823,23,99.17000000000053,16,7,11559.14,11658.31
30639,U15562,23,-311985.82,15,8,363145.45,51159.630000000005
30640,U25266,23,1916.7700000000002,16,7,2102.54,4019.3100000000004
30641,U25806,23,524.069999999994,14,9,168875.52999999997,169399.59999999998
30642,U26722,23,560692.3,10,13,757975.0,1318667.3
30643,U37738,23,8149.339999999999,15,8,6290.75,14440.09
30644,U1272603,23,488.50000000000006,13,10,11250.5,11739.0
30645,U27864,23,22690.260000000013,10,13,92589.11,115279.37000000001
30646,U27554,23,-1593.5,14,9,84986.10999999999,83392.60999999999
30647,U8207,23,-1625.7599999999993,18,5,14259.760000000006,12634.000000000007
30648,U12817,23,-10156.199999999999,16,7,117173.79999999999,107017.59999999999
30649,U24410,23,-297512.17,8,15,944235.61,646723.44
30650,U690405,23,247.8399999999997,15,8,12052.47,12300.31
30651,U1163160,23,-213.1600000000003,13,10,4079.44,3866.2799999999997
30652,U35399,23,11930.06,8,15,56100.4,68030.46
30653,U29593,23,-9522.06,12,11,121781.39,112259.33
30654,U37920,23,41589.27,18,5,84509.73,126099.0
30655,U12291,23,-4896.38,15,8,8511.019999999999,3614.6399999999985
30656,U24241,23,9492.27,17,6,6315.0,15807.27
30657,U687781,23,-3168.59,12,11,19790.0,16621.41
30658,U10694,23,1934.7000000000003,19,4,11844.77,13779.470000000001
30659,U18751,23,8338.32,12,11,93069.64,101407.95999999999
30660,U901527,23,1406.839999999999,15,8,14080.150000000001,15486.99
30661,U22609,23,-53.569999999999936,18,5,2689.01,2635.4400000000005
30662,U32035,23,-426.53999999999996,18,5,3494.0,3067.46
30663,U19197,22,-4589.63,18,4,9358.15,4768.5199999999995
30664,U28109,22,309789.02,7,15,75019.16,384808.18000000005
30665,U12785,22,54.4399999999996,14,8,14263.070000000002,14317.510000000002
30666,U11730,22,1470.2999999999993,13,9,32455.28,33925.58
30667,U32210,22,51979.9099999999,11,11,10254889.0,10306868.91
30668,U31981,22,-6417.240000000002,14,8,56752.29,50335.05
30669,U11317,22,21303.769999999997,8,14,32144.61,53448.38
30670,U20755,22,-5187.77,18,4,29050.0,23862.23
30671,U22399,22,-2767.5900000000283,15,7,315034.77999999997,312267.18999999994
30672,U1297174,22,-897.0700000000003,18,4,9410.43,8513.36
30673,U8286,22,-27928.839999999997,17,5,57993.700000000004,30064.860000000008
30674,U19662,22,-1964.3399999999774,9,13,489671.4,487707.06000000006
30675,U30338,22,-20077.350000000002,20,2,20100.0,22.649999999997817
30676,U22156,22,-467.6899999999999,20,2,7309.75,6842.06
30677,U11872,22,1799.9299999999985,15,7,42016.0,43815.93
30678,U41708,22,1809.420000000002,18,4,7985.35,9794.770000000002
30679,U28778,22,330.6300000000001,14,8,8706.34,9036.970000000001
30680,U19995,22,-820.9499999999998,12,10,17964.0,17143.05
30681,U23850,22,1895.1100000000001,12,10,14720.42,16615.53
30682,U40993,22,-62631.180000000015,15,7,124550.87,61919.68999999998
30683,U1051717,22,-2.842170943040401e-14,12,10,589.66,589.66
30684,U21860,22,-73553.11000000002,15,7,117167.52999999998,43614.41999999997
30685,U35488,22,116.22,17,5,1190.62,1306.84
30686,U15138,22,2111.4999999999927,10,12,68515.4,70626.9
30687,U663489,22,-378.76000000000005,18,4,2080.9,1702.14
30688,U20891,22,16137.710000000001,16,6,30355.0,46492.71
30689,U12581,22,-387885.77,15,7,5636667.0,5248781.23
30690,U8997,22,-34138.36,18,4,55472.53,21334.17
30691,U10667,22,3971.820000000001,10,12,9829.55,13801.37
30692,U38043,22,8397.539999999995,16,6,51209.62,59607.159999999996
30693,U666064,22,-6931.410000000001,19,3,11527.66,4596.249999999999
30694,U36569,22,-12420.1,17,5,22824.1,10403.999999999998
30695,U37868,22,15351.859999999997,15,7,53746.94000000001,69098.8
30696,U667723,22,-389.17999999999984,14,8,5255.669999999999,4866.49
30697,U14536,22,3171.01,10,12,6639.43,9810.44
30698,U37740,22,-14742.890000000003,10,12,41967.46,27224.569999999996
30699,U18173,22,-36153.41,15,7,94264.02,58110.61
30700,U36377,22,-357.3900000000001,9,13,11314.18,10956.79
30701,U9877,22,12117.06,13,9,50112.0,62229.06
30702,U674643,22,-2672.08,13,9,10638.35,7966.27
30703,U36540,22,-246946.27000000008,6,16,1161600.0,914653.73
30704,U42050,22,4210.68,11,11,68021.4,72232.07999999999
30705,U36072,22,-9670.09,17,5,18176.1,8506.009999999998
30706,U35681,22,-216.10999999999967,16,6,14863.16,14647.05
30707,U1355670,22,-1886.2700000000002,20,2,2386.2699999999995,499.9999999999993
30708,U17378,22,-13415.73,17,5,25826.65,12410.920000000002
30709,U31008,22,-46745.18000000001,14,8,81269.45999999998,34524.27999999997
30710,U27429,22,3759.860000000008,10,12,89633.81,93393.67000000001
30711,U42916,22,-21585.139999999996,13,9,203596.0,182010.86000000002
30712,U31667,22,-31649.54,11,11,94550.01,62900.469999999994
30713,U31027,22,2222.2400000000052,9,13,226242.0,228464.24
30714,U24067,22,-924.19,12,10,5892.84,4968.65
30715,U25178,22,-5918.16,18,4,9054.619999999999,3136.459999999999
30716,U25788,22,-13175.94,15,7,22023.06,8847.12
30717,U17935,22,-34849.03,15,7,66860.5,32011.47
30718,U43914,22,-4375.599999999999,14,8,15950.0,11574.400000000001
30719,U22955,22,1155.0200000000004,14,8,26278.33,27433.350000000002
30720,U25489,22,8987.990000000007,14,8,25435.909999999996,34423.9
30721,U867418,22,1.4800000000002456,12,10,4515.37,4516.85
30722,U13204,22,-192978.0,14,8,234087.14,41109.140000000014
30723,U1114633,22,245.0,11,11,5255.0,5500.0
30724,U1322879,22,8627.919999999998,12,10,35676.119999999995,44304.03999999999
30725,U43950,22,10099.29,11,11,59053.0,69152.29000000001
30726,U24029,22,-1710.039999999999,18,4,15199.960000000001,13489.920000000002
30727,U38857,22,-75.2600000000011,17,5,15208.52,15133.26
30728,U8266,22,15103.96,11,11,12445.0,27548.96
30729,U19542,22,1256.8000000000002,18,4,5017.4,6274.2
30730,U24278,22,43.11999999999989,12,10,9159.01,9202.130000000001
30731,U36514,22,-83.34999999999998,19,3,105.2,21.850000000000023
30732,U29153,22,-4765.980000000007,13,9,43179.44,38413.45999999999
30733,U41288,22,-3003.4900000000007,19,3,11204.82,8201.329999999998
30734,U15215,22,4719.24,9,13,41226.8,45946.04
30735,U38244,22,-176587.85,12,10,237430.27,60842.419999999984
30736,U33602,22,853.2800000000002,18,4,2337.08,3190.36
30737,U12840,22,53097.93000000001,16,6,10745.5,63843.43000000001
30738,U39200,22,-89246.25,17,5,103000.01000000001,13753.76000000001
30739,U1269351,22,0.5099999999999909,14,8,2417.5,2418.01
30740,U40982,22,-2569.7199999999993,15,7,17738.479999999996,15168.759999999997
30741,U22493,22,-807.5000000000003,11,11,25982.39,25174.89
30742,U9501,22,2588.8400000000074,13,9,100709.45999999999,103298.3
30743,U1054818,22,-2204.0499999999997,19,3,3958.2700000000004,1754.2200000000007
30744,U1338394,22,300.12,14,8,373.49,673.61
30745,U38254,22,9585.020000000019,9,13,164036.0,173621.02000000002
30746,U26673,22,-2.0200000000022555,11,11,64170.0,64167.979999999996
30747,U1090978,22,-6885.050000000001,20,2,6890.68,5.6299999999992
30748,U43756,22,-264.5200000000005,9,13,27250.19,26985.67
30749,U43601,22,-1937.4300000000007,12,10,7277.510000000001,5340.08
30750,U20646,22,-13177.81,13,9,25478.629999999997,12300.819999999998
30751,U1076441,22,-1063.22,17,5,1206.6399999999999,143.41999999999985
30752,U15117,22,-2989.0999999999976,9,13,12532.04,9542.940000000002
30753,U24313,22,111728.18,11,11,49527.0,161255.18
30754,U41518,22,6131.07,15,7,13431.84,19562.91
30755,U13748,22,34884.98999999999,13,9,61106.380000000005,95991.37
30756,U1271063,22,-1934.98,16,6,3186.3999999999996,1251.4199999999996
30757,U38830,22,94745.71,11,11,36574.00000000001,131319.71000000002
30758,U24348,22,1690.4700000000012,12,10,99810.0,101500.47
30759,U20597,22,-24925.50999999998,10,12,641442.0,616516.49
30760,U36618,22,-3225.6800000000003,9,13,15349.93,12124.25
30761,U21542,22,-1070.8999999999978,13,9,70670.98999999999,69600.09
30762,U29670,22,3953.5000000000005,13,9,5475.63,9429.130000000001
30763,U37628,22,-270.84000000000015,12,10,6168.0,5897.16
30764,U17980,22,43428.41999999999,12,10,55684.48,99112.9
30765,U30009,22,-1328.4499999999953,13,9,125013.98,123685.53
30766,U1159123,22,0.7600000000005093,11,11,21092.07,21092.83
30767,U1093939,22,-332.42,17,5,1959.1499999999999,1626.7299999999998
30768,U39065,22,-2190.2899999999972,2,20,200000.0,197809.71
30769,U32954,22,-299.27999999999884,9,13,56756.0,56456.72
30770,U25315,22,-16603.010000000002,19,3,18742.67,2139.659999999996
30771,U27550,22,66124.97000000002,10,12,17657.829999999998,83782.80000000002
30772,U43921,22,-20154.269999999997,14,8,38963.9,18809.630000000005
30773,U24045,22,-261.5899999999674,11,11,2077100.0,2076838.4100000001
30774,U1132164,22,-135.35999999999999,20,2,136.2,0.8400000000000034
30775,U19357,22,1170.58,12,10,5898.0,7068.58
30776,U36526,22,-9828.09,19,3,13828.82,4000.7299999999996
30777,U10540,22,14874.789999999983,10,12,241525.91,256400.69999999998
30778,U984155,22,-2857.0199999999995,20,2,7711.0199999999995,4854.0
30779,U30134,22,-27946.729999999996,11,11,220237.12,192290.39
30780,U8860,22,-118335.01999999999,16,6,639096.46,520761.43999999994
30781,U36367,22,-305.01000000000045,13,9,19084.8,18779.789999999997
30782,U42292,22,10101.319999999985,18,4,290058.0,300159.32
30783,U20157,22,45991.049999999996,11,11,34012.6,80003.65
30784,U17148,22,-3792.4799999999996,9,13,14647.849999999999,10855.369999999999
30785,U11493,22,-112.62000000000094,16,6,68027.44000000002,67914.82000000002
30786,U29571,22,787.9799999999996,13,9,2962.61,3750.5899999999997
30787,U28950,22,-148.57999999999998,16,6,11795.31,11646.73
30788,U37591,22,-1559.620000000001,16,6,13919.619999999999,12359.999999999998
30789,U25861,22,-14112.36,12,10,439692.37,425580.01
30790,U21696,22,-46092.409999999996,16,6,85686.34999999999,39593.939999999995
30791,U30521,22,22.569999999999347,9,13,29580.4,29602.97
30792,U1129799,22,-2993.19,15,7,4443.48,1450.2899999999995
30793,U10709,22,27882.520000000004,16,6,3648.790000000001,31531.310000000005
30794,U12777,22,214.74000000000004,13,9,1826.96,2041.7
30795,U1220706,22,-1176.0800000000004,15,7,9655.14,8479.06
30796,U25607,22,33912.90000000001,19,3,66094.69,100007.59000000001
30797,U14164,22,10435.96,17,5,67573.33,78009.29000000001
30798,U41528,22,-15748.52,16,6,45350.0,29601.48
30799,U25292,22,6494.26,14,8,7119.74,13614.0
30800,U35239,22,528.9699999999996,18,4,9301.599999999999,9830.569999999998
30801,U14935,22,-949.8499999999999,15,7,4063.95,3114.1
30802,U745804,22,-432.85,15,7,1595.61,1162.7599999999998
30803,U23743,22,503.8200000000187,14,8,117932.34999999999,118436.17000000001
30804,U24195,22,-184.9300000000001,16,6,4955.0599999999995,4770.129999999999
30805,U41081,22,304.3700000000026,9,13,76858.57999999999,77162.94999999998
30806,U32012,22,51546.049999999996,10,12,16676.050000000003,68222.1
30807,U12233,22,43.16000000000349,14,8,85487.29999999999,85530.45999999999
30808,U16483,22,-6717.75,11,11,39433.53,32715.78
30809,U36448,22,-93411.34,19,3,103143.92,9732.580000000002
30810,U28315,22,13876.44,13,9,9229.5,23105.940000000002
30811,U16057,22,-3088.3299999999967,10,12,36072.0,32983.670000000006
30812,U14764,22,-19696.61,5,17,274000.0,254303.39
30813,U893925,22,119.54999999999995,14,8,5578.8099999999995,5698.36
30814,U14131,22,14849.630000000001,14,8,34538.9,49388.53
30815,U37421,22,-19671.280000000002,17,5,38804.09,19132.809999999994
30816,U34286,22,190078.68,9,13,412461.0,602539.6799999999
30817,U35108,22,-3043.260000000002,12,10,43576.68,40533.42
30818,U18299,22,3767.83,19,3,3383.3599999999997,7151.19
30819,U34779,22,-17195.640000000003,14,8,40494.09,23298.449999999993
30820,U43583,22,2440.1899999999996,11,11,34528.020000000004,36968.21000000001
30821,U8689,22,-4738.8499999999985,16,6,12915.59,8176.740000000002
30822,U14793,22,1941.299999999999,11,11,117431.83,119373.13
30823,U35635,22,-3539.17,19,3,7344.32,3805.1499999999996
30824,U29906,22,-2237.6399999999994,13,9,12011.7,9774.060000000001
30825,U16547,22,7465.539999999926,11,11,1304590.4200000002,1312055.9600000002
30826,U33059,22,1475.8100000000013,13,9,27551.61,29027.420000000002
30827,U34179,22,-277996.69,17,5,292447.56,14450.869999999995
30828,U9602,22,-17559.25,15,7,120320.54000000001,102761.29000000001
30829,U38595,22,21769.660000000003,15,7,47202.0,68971.66
30830,U30012,22,3818.8199999999924,9,13,109960.73,113779.54999999999
30831,U12501,22,-1490.2699999999986,14,8,16459.1,14968.83
30832,U17210,22,-21851.7,16,6,30253.0,8401.3
30833,U31637,22,-3612.8900000000026,14,8,26797.07,23184.179999999997
30834,U32062,22,36.290000000001896,10,12,31550.66,31586.95
30835,U38376,22,5130.310000000001,6,16,66935.29,72065.59999999999
30836,U32637,22,-2944.3600000000188,13,9,701705.28,698760.92
30837,U42138,22,53.95000000000002,12,10,1183.13,1237.0800000000002
30838,U24015,22,-755.3500000000022,14,8,184000.0,183244.65
30839,U36580,22,55281.939999999995,6,16,2055491.0,2110772.94
30840,U12928,22,-306.3800000000001,19,3,3273.86,2967.48
30841,U31334,22,777.6700000000004,15,7,21361.120000000003,22138.790000000005
30842,U19281,22,-29969.780000000002,15,7,51978.08,22008.3
30843,U41647,22,8879.230000000003,16,6,80917.0,89796.23000000001
30844,U11596,22,-754.77,19,3,797.8299999999999,43.059999999999945
30845,U40716,22,646.6199999999999,15,7,4270.219999999999,4916.839999999999
30846,U19944,22,-1511.6700000000003,20,2,1964.2000000000003,452.53
30847,U31151,22,6192.6,12,10,9309.44,15502.04
30848,U21852,22,2297.759999999997,14,8,37236.299999999996,39534.05999999999
30849,U26524,22,8137.459999999997,14,8,39026.63999999999,47164.09999999999
30850,U40121,22,-772.0900000000256,12,10,525476.22,524704.1299999999
30851,U36504,22,-15.110000000000582,11,11,74022.5,74007.39
30852,U19265,22,-80952.08,21,1,81113.2,161.11999999999534
30853,U35015,22,3160.15,14,8,6026.29,9186.44
30854,U897154,22,-1817.8,12,10,1887.8,70.0
30855,U20137,22,-16599.05,17,5,37099.3,20500.250000000004
30856,U32172,22,-689.1200000000001,17,5,1231.47,542.3499999999999
30857,U41479,22,16509.62,15,7,24798.9,41308.520000000004
30858,U28930,22,-295.7700000000001,13,9,1656.49,1360.7199999999998
30859,U1202119,22,-1492.2399999999993,18,4,10932.519999999997,9440.279999999997
30860,U36334,22,126422.26000000001,8,14,66007.73999999999,192430.0
30861,U17229,22,-206175.81999999998,12,10,314172.14,107996.32000000004
30862,U763328,22,747.2599999999999,16,6,4932.59,5679.85
30863,U41498,22,737.2999999999884,17,5,214281.97999999998,215019.27999999997
30864,U18975,22,-39075.219999999994,11,11,91061.08000000002,51985.86000000002
30865,U16808,22,-221.18000000000004,16,6,8320.39,8099.209999999999
30866,U24829,22,-17137.90000000002,11,11,420950.0,403812.1
30867,U682432,22,3.6499999999999573,16,6,1099.36,1103.0099999999998
30868,U31142,22,-1160.92,16,6,78852.20999999999,77691.29
30869,U31007,22,111182.76000000001,7,15,237100.0,348282.76
30870,U30076,22,3638.3599999999997,10,12,11401.8,15040.16
30871,U37744,22,-11607.669999999998,14,8,139548.0,127940.33
30872,U30695,22,-1286.5000000000018,16,6,41963.0,40676.5
30873,U10867,22,190.85000000001492,15,7,484570.1,484760.95
30874,U35954,22,-37.05999999999949,13,9,9507.5,9470.44
30875,U24295,22,40925.48,8,14,43281.35999999999,84206.84
30876,U9295,22,-29564.28,13,9,112289.7,82725.42
30877,U35494,22,-398070.0,11,11,497196.01,99126.01000000001
30878,U28657,22,31620.8,4,18,32024.49,63645.29
30879,U36336,22,298.3300000000745,8,14,1278177.22,1278475.55
30880,U30746,22,-4201.029999999999,15,7,15162.94,10961.910000000002
30881,U8811,22,1539.5699999999983,16,6,100639.21,102178.78
30882,U20034,22,-8267.57,17,5,12523.14,4255.57
30883,U34127,22,3025.4199999994044,12,10,5119535.0,5122560.419999999
30884,U26590,22,24002.16,11,11,32546.07,56548.229999999996
30885,U39638,22,1842.4399999999994,15,7,15914.43,17756.87
30886,U43804,22,-1817.0199999999993,17,5,29194.130000000005,27377.110000000004
30887,U18060,22,17422.989999999998,17,5,54127.22,71550.20999999999
30888,U42692,22,2481.649999999999,18,4,13073.349999999999,15554.999999999998
30889,U1064789,22,-27.279999999999973,16,6,1112.79,1085.51
30890,U28727,22,112578.57999999999,10,12,4561.0,117139.57999999999
30891,U23741,22,-495.9499999999998,13,9,12536.320000000002,12040.370000000003
30892,U40900,22,-239924.76,13,9,1205969.68,966044.9199999999
30893,U964673,22,46.06999999999999,18,4,174.0,220.07
30894,U17786,22,1900.9000000000008,17,5,3259.45,5160.35
30895,U29915,22,45583.25000000002,11,11,76951.38,122534.63000000003
30896,U15432,22,135.85000000000048,18,4,3231.7799999999997,3367.63
30897,U39339,22,-10402.879999999992,10,12,863124.3300000001,852721.4500000001
30898,U33146,22,3557.3399999999965,8,14,188537.0,192094.34
30899,U9983,22,-36359.57000000001,15,7,140879.35,104519.78
30900,U12065,22,478.7100000000011,14,8,27359.35,27838.06
30901,U22773,22,2037.219999999997,12,10,53696.58,55733.799999999996
30902,U16145,22,-607419.51,17,5,641439.73,34020.21999999997
30903,U29615,22,9697.34,10,12,10713.5,20410.84
30904,U1163257,22,-6786.299999999999,16,6,13056.42,6270.120000000001
30905,U26472,22,-5037.709999999997,15,7,15847.219999999998,10809.51
30906,U13722,22,-3240.209999999999,14,8,36477.98,33237.770000000004
30907,U21350,22,-896.6499999999996,13,9,17843.46,16946.809999999998
30908,U41736,22,-2333.8099999999995,12,10,22325.51,19991.699999999997
30909,U41054,22,-1130.3899999999976,10,12,178902.29,177771.90000000002
30910,U21476,22,-8573.539999999999,18,4,35041.55,26468.010000000002
30911,U30138,22,-1779.43,19,3,1791.0,11.569999999999936
30912,U38616,22,-30739.05000000001,14,8,133479.0,102739.94999999998
30913,U36305,22,16661.249999999916,16,6,1221950.96,1238612.21
30914,U10123,22,4836.160000000002,18,4,492.30000000000007,5328.460000000002
30915,U20050,22,51720.0,15,7,84983.68,136703.68
30916,U18475,22,3.9799999999995634,15,7,23998.02,24002.0
30917,U32405,22,-4.139999999999418,16,6,98593.14,98589.0
30918,U15288,22,3129.8300000000013,9,13,120716.18,123846.01
30919,U31160,22,-16375.79,19,3,42330.520000000004,25954.730000000003
30920,U1096940,22,-305.9699999999999,11,11,4339.52,4033.5500000000006
30921,U21914,22,-10841.15,16,6,31405.86,20564.71
30922,U12722,22,-4829.230000000018,14,8,383000.0,378170.76999999996
30923,U752855,22,650.1699999999998,11,11,7452.84,8103.01
30924,U35623,22,-13814.479999999998,17,5,66304.65999999999,52490.17999999999
30925,U35777,22,-88.94000000000233,11,11,71840.64,71751.7
30926,U12713,22,13198.779999999999,15,7,5310.17,18508.949999999997
30927,U574381,22,-2397.24,12,10,6783.440000000001,4386.200000000002
30928,U32477,22,22515.420000000006,7,15,139821.54,162336.96000000002
30929,U34261,22,-3889.1399999999994,14,8,47732.05,43842.91
30930,U24365,22,-226.38999999999945,12,10,42759.91,42533.520000000004
30931,U32310,22,55534.849999999984,14,8,25883.690000000002,81418.53999999998
30932,U30645,22,-22180.199999999997,16,6,37894.66,15714.460000000006
30933,U31404,22,1251.93000000002,14,8,479433.0,480684.93
30934,U32036,22,1524.190000000001,17,5,15638.6,17162.79
30935,U24512,22,98502.57999999999,15,7,11936.39,110438.96999999999
30936,U41437,22,-12301.560000000005,18,4,47211.6,34910.03999999999
30937,U23513,22,1673.9200000000042,18,4,103327.67000000001,105001.59000000001
30938,U21859,22,14783.989999999996,19,3,79716.02,94500.01
30939,U29943,22,7322.93,11,11,5702.81,13025.740000000002
30940,U22850,22,-219.2,20,2,219.92000000000002,0.7200000000000273
30941,U34714,22,35.960000000000065,12,10,3268.7999999999997,3304.7599999999998
30942,U14429,22,-2590.790000000001,14,8,48176.0,45585.21
30943,U42941,22,863.6099999999964,14,8,41826.840000000004,42690.45
30944,U1370850,22,3028.7500000000027,16,6,18822.949999999997,21851.7
30945,U33571,22,379.99999999999966,16,6,10722.72,11102.72
30946,U722143,22,25.749999999999943,14,8,2726.04,2751.79
30947,U31002,22,-3225.899999999997,13,9,49054.27,45828.37
30948,U32151,22,-6884.049999999996,18,4,72415.39,65531.340000000004
30949,U32537,22,689481.57,4,18,8055.0,697536.57
30950,U1198971,22,-11123.06,13,9,15083.06,3960.0
30951,U22443,22,331240.53,9,13,89466.0,420706.53
30952,U26110,22,2323.8699999999953,11,11,128177.15000000001,130501.02
30953,U38825,22,-13600.36,19,3,25738.9,12138.54
30954,U27345,22,-16690.79,13,9,34232.5,17541.71
30955,U27661,22,-292973.96,9,13,4412947.3100000005,4119973.3500000006
30956,U9780,22,16545.48,13,9,59410.0,75955.48
30957,U29032,22,-3751.5199999999963,16,6,58273.899999999994,54522.38
30958,U32768,22,30064.44000000003,10,12,234545.87,264610.31000000006
30959,U8649,22,36823.27,13,9,48419.8,85243.07
30960,U40912,22,16390.66,9,13,64336.0,80726.66
30961,U39174,22,-2119.2400000000052,15,7,144974.0,142854.76
30962,U32141,22,14035.88,12,10,979.6,15015.48
30963,U36845,22,-1331.670000000001,19,3,10734.18,9402.509999999998
30964,U31273,22,5003.49,13,9,7768.959999999999,12772.449999999999
30965,U14593,22,0.0,13,9,10401.29,10401.29
30966,U985976,22,-2478.6200000000003,18,4,3328.65,850.0299999999997
30967,U18121,22,33434.840000000026,13,9,80495.7,113930.54000000002
30968,U25322,22,-7147.27,16,6,13674.77,6527.5
30969,U37876,22,6694.949999999995,15,7,80214.43,86909.37999999999
30970,U20353,22,3194.909999999996,16,6,89180.83,92375.73999999999
30971,U15043,22,-10259.8,17,5,10409.05,149.25
30972,U42930,22,845.9800000000002,13,9,10297.18,11143.16
30973,U23098,22,-4845.169999999996,16,6,29393.980000000003,24548.810000000005
30974,U28581,22,-11.890000000006694,15,7,80846.0,80834.10999999999
30975,U19987,22,-33284.61,14,8,158457.37000000002,125172.76000000002
30976,U1175480,22,-15620.45,17,5,25785.780000000006,10165.330000000005
30977,U1316265,22,-1802.58,12,10,4695.240000000001,2892.6600000000008
30978,U1017118,22,-1400.5800000000002,18,4,7069.33,5668.75
30979,U34927,22,-39578.15000000002,10,12,441746.0,402167.85
30980,U13918,22,-1704.6699999999998,15,7,6515.91,4811.24
30981,U12298,22,2809.8300000000063,7,15,135363.0,138172.83000000002
30982,U20044,22,-5976.76,15,7,11232.2,5255.4400000000005
30983,U27533,22,5752.1699999999955,8,14,108099.89,113852.06
30984,U35885,22,6285.91,18,4,786.6300000000001,7072.54
30985,U9733,22,-5878.700000000001,14,8,38443.78,32565.079999999998
30986,U32552,22,14782.579999999994,12,10,78074.7,92857.28
30987,U9680,22,-120946.82000000005,10,12,542592.0700000001,421645.25
30988,U1148995,22,-30.96,21,1,31.0,0.03999999999999915
30989,U17852,22,-42034.729999999996,5,17,106218.97,64184.240000000005
30990,U23156,22,3724.5500000000034,13,9,64035.58,67760.13
30991,U29807,22,-20469.429999999997,17,5,33397.36,12927.930000000004
30992,U32704,22,25.10999999999933,18,4,21165.660000000003,21190.770000000004
30993,U13280,22,-415.89000000001977,10,12,243704.96,243289.06999999998
30994,U16931,22,-14625.48,10,12,95623.98,80998.5
30995,U16911,22,28257.160000000003,13,9,120748.13,149005.29
30996,U39051,22,-274531.57999999996,8,14,440178.81,165647.23000000004
30997,U35784,22,2999.38,11,11,6077.67,9077.05
30998,U36864,22,35326.08,8,14,31573.330000000005,66899.41
30999,U22502,22,-2292.37,12,10,19709.52,17417.15
31000,U38320,22,2452.41,17,5,2921.58,5373.99
31001,U29073,22,8784.829999999998,16,6,147433.80999999997,156218.63999999996
31002,U39471,22,569539.0499999999,6,16,27096.46,596635.5099999999
31003,U24596,22,-2610.4599999999996,13,9,24714.989999999998,22104.53
31004,U43261,22,38689.729999999996,12,10,84674.57,123364.3
31005,U26095,22,-1055.4800000000005,16,6,9546.38,8490.899999999998
31006,U23492,22,-9732.54,18,4,18417.18,8684.64
31007,U24870,22,593.8600000000006,12,10,17023.510000000002,17617.370000000003
31008,U24898,22,-10444.13,16,6,16376.99,5932.860000000001
31009,U38944,22,1985.050000000003,11,11,164046.41999999998,166031.46999999997
31010,U991780,22,-10887.489999999998,21,1,43583.490000000005,32696.000000000007
31011,U38151,22,4869.090000000003,11,11,33862.399999999994,38731.49
31012,U12566,22,-5914.530000000001,16,6,70802.65,64888.119999999995
31013,U30985,22,-8.009999999999996,17,5,72.77000000000002,64.76000000000003
31014,U13020,22,75794.12999999977,10,12,3019431.5,3095225.63
31015,U1230500,22,-13720.789999999997,16,6,22107.149999999998,8386.36
31016,U9635,22,-37991.049999999996,18,4,84354.15999999999,46363.10999999999
31017,U763439,22,-13832.669999999998,19,3,15952.669999999998,2120.0
31018,U584771,22,-3594.219999999999,14,8,17743.18,14148.960000000001
31019,U24235,22,-1860.4699999999998,17,5,22195.350000000002,20334.88
31020,U32368,22,4669.200000000016,11,11,173185.49,177854.69
31021,U17663,22,9093.649999999998,15,7,19305.100000000002,28398.75
31022,U21984,22,5650.889999999999,8,14,28725.0,34375.89
31023,U38786,22,6962.35,14,8,2762.62,9724.970000000001
31024,U38370,22,-61416.189999999995,13,9,109424.56000000001,48008.37000000002
31025,U38274,22,-156.21000000000006,19,3,520.2800000000001,364.07000000000005
31026,U11278,22,-5603.149999999998,16,6,24301.809999999998,18698.66
31027,U34783,22,-226.79999999999998,16,6,6238.0,6011.2
31028,U29243,22,302.429999999993,8,14,137376.46,137678.88999999998
31029,U11268,22,-5509.0199999999895,12,10,273481.76,267972.74
31030,U13142,22,-136.63999999999942,7,15,265614.0,265477.36
31031,U1146061,22,-1580.3599999999997,17,5,4100.41,2520.05
31032,U21388,22,-698.4100000000026,17,5,21459.21,20760.799999999996
31033,U21321,22,-2333.7099999999996,19,3,2701.69,367.9800000000005
31034,U29282,22,37529.74,11,11,20481.0,58010.74
31035,U22138,22,6554.760000000004,11,11,69020.03,75574.79000000001
31036,U11551,22,10002.619999999999,13,9,7904.57,17907.19
31037,U44044,21,-13.679999999998586,15,6,19022.13,19008.45
31038,U29650,21,1726.0700000000004,14,7,17798.579999999998,19524.649999999998
31039,U22006,21,-3086.42,18,3,3712.7799999999997,626.3599999999997
31040,U18899,21,-99708.36999999998,13,8,221786.1,122077.73000000003
31041,U19604,21,8.580000000001746,11,10,70949.0,70957.58
31042,U41893,21,120837.89999999998,13,8,60771.47,181609.37
31043,U30405,21,2836.92,8,13,3050.92,5887.84
31044,U1215004,21,94.030000000001,12,9,19597.350000000002,19691.380000000005
31045,U39998,21,-1991.0300000000009,12,9,18571.28,16580.249999999996
31046,U29742,21,9916.1,18,3,2530.35,12446.45
31047,U34191,21,-193.93000000000038,12,9,121765.67,121571.73999999999
31048,U13152,21,-3914.59,12,9,26025.0,22110.41
31049,U10226,21,-198.0899999999965,10,11,106783.0,106584.91
31050,U26252,21,38372.27,12,9,23700.87,62073.14
31051,U41485,21,6783.920000000002,12,9,14140.949999999999,20924.870000000003
31052,U34056,21,-1.8189894035458565e-12,10,11,15172.79,15172.789999999999
31053,U32979,21,5069.04,13,8,14561.0,19630.04
31054,U35013,21,-59858.11,12,9,81775.0,21916.89
31055,U21706,21,-50814.20000000001,13,8,103451.06999999999,52636.86999999998
31056,U42759,21,6231.970000000005,14,7,97547.79000000001,103779.76000000001
31057,U21055,21,-3902.2299999999996,15,6,24925.1,21022.87
31058,U42284,21,2000.9699999999993,11,10,16544.65,18545.620000000003
31059,U1036637,21,99.92999999999998,13,8,6100.0,6199.93
31060,U38539,21,120.74000000000001,15,6,6231.04,6351.78
31061,U33908,21,-2377.799999999992,10,11,84016.98999999999,81639.19
31062,U10367,21,-11936.679999999993,7,14,208150.91,196214.23
31063,U23327,21,-7216.969999999994,9,12,228175.0,220958.03
31064,U28897,21,-195.75000000000114,13,8,101877.51,101681.76
31065,U20938,21,-7391.750000000001,11,10,72646.9,65255.149999999994
31066,U41583,21,-945.6400000000001,16,5,4602.76,3657.12
31067,U34940,21,54978.47,5,16,160961.83000000002,215940.30000000002
31068,U13546,21,10328.21,14,7,63385.98,73714.19
31069,U17721,21,19282.93,8,13,59953.82,79236.75
31070,U964332,21,-5739.4000000000015,14,7,9961.750000000002,4222.35
31071,U39778,21,365.48999999999944,11,10,41537.51,41903.0
31072,U17187,21,6710.610000000001,14,7,124412.97,131123.58000000002
31073,U32288,21,-1943.8300000000004,15,6,22325.120000000003,20381.29
31074,U41822,21,-112140.98999999999,7,14,3989575.02,3877434.0300000003
31075,U23796,21,2050.119999999996,5,16,33326.86,35376.979999999996
31076,U38548,21,-2944.3,13,8,141069.0,138124.7
31077,U30452,21,-51932.73,14,7,119677.94,67745.20999999999
31078,U1247964,21,-444.9300000000002,15,6,6325.5599999999995,5880.629999999999
31079,U11486,21,12019.619999999988,16,5,32474.780000000002,44494.399999999994
31080,U43871,21,11137.869999999999,12,9,20272.11,31409.98
31081,U30127,21,-9691.429999999998,13,8,67375.01,57683.579999999994
31082,U10157,21,27744.769999999997,15,6,60556.95,88301.72
31083,U23749,21,19139.690000000002,10,11,36460.78,55600.47
31084,U24584,21,319794.47000000003,8,13,25219.210000000003,345013.68000000005
31085,U1124241,21,11433.159999999998,11,10,2787.2699999999995,14220.429999999997
31086,U27463,21,16278.439999999999,12,9,22788.3,39066.74
31087,U20175,21,-512.8400000000026,14,7,20216.5,19703.659999999996
31088,U12224,21,-2.1174173525650986e-12,10,11,21355.96,21355.959999999995
31089,U26020,21,59819.98999999999,15,6,32277.15,92097.13999999998
31090,U23386,21,-23.970000000001164,11,10,63775.0,63751.03
31091,U1227978,21,280.5400000000001,11,10,4443.65,4724.19
31092,U38976,21,13948.099999999999,10,11,37958.9,51907.0
31093,U35792,21,27464.98,17,4,13695.54,41160.520000000004
31094,U32573,21,4459.61,10,11,4397.360000000001,8856.970000000001
31095,U1039062,21,0.0,12,9,2865.0,2865.0
31096,U42464,21,-95672.76999999999,11,10,314278.47000000003,218605.70000000004
31097,U987640,21,9.079999999999998,11,10,1242.04,1251.12
31098,U25756,21,-4579.710000000001,13,8,17429.670000000002,12849.960000000001
31099,U29731,21,-566.2499999999999,20,1,566.6999999999999,0.4500000000000455
31100,U29665,21,-52300.08,17,4,64805.469999999994,12505.389999999992
31101,U35184,21,63.16,16,5,2169.0,2232.16
31102,U18680,21,-172.80000000000015,16,5,1901.02,1728.2199999999998
31103,U11951,21,-7551.909999999998,14,7,29192.43,21640.520000000004
31104,U21374,21,-146946.27,13,8,754507.32,607561.0499999999
31105,U10865,21,40446.850000000006,12,9,31410.85,71857.70000000001
31106,U26134,21,-1553.8600000000001,16,5,7666.59,6112.73
31107,U10170,21,-12442.0,10,11,88441.13,75999.13
31108,U18866,21,3401.930000000003,15,6,24342.23,27744.160000000003
31109,U775658,21,171.21000000000004,10,11,1884.85,2056.06
31110,U39894,21,93.42999999999999,11,10,967.5000000000001,1060.93
31111,U35832,21,-143.63999999999987,11,10,7368.7,7225.0599999999995
31112,U1242958,21,-1737.36,14,7,2223.21,485.85000000000014
31113,U26432,21,583752.08,4,17,1715.5,585467.58
31114,U19025,21,-355348.27,14,7,357407.52,2059.25
31115,U23022,21,-569.0700000000002,18,3,1670.0500000000002,1100.98
31116,U43082,21,3917.16,12,9,18989.72,22906.88
31117,U10407,21,-41249.98,13,8,57686.13,16436.149999999994
31118,U35880,21,-2311.1099999999997,12,9,5919.9,3608.79
31119,U26971,21,1302.9299999999996,17,4,5584.12,6887.049999999999
31120,U35267,21,-45019.7,13,8,60656.65999999999,15636.959999999992
31121,U34678,21,234.55999999999997,13,8,780.8100000000001,1015.37
31122,U39950,21,4398.91,12,9,51279.14,55678.05
31123,U11178,21,-563.2200000000003,16,5,16808.52,16245.3
31124,U40967,21,10216.63,13,8,8424.429999999998,18641.059999999998
31125,U26761,21,-521626.52,16,5,555053.31,33426.79000000004
31126,U12046,21,18521.490000000005,9,12,100410.3,118931.79000000001
31127,U39370,21,12755.570000000005,6,15,186513.69,199269.26
31128,U30930,21,169154.99000000002,15,6,239951.52000000002,409106.51
31129,U11773,21,124.46999999999935,15,6,10808.35,10932.82
31130,U832066,21,-15043.179999999998,15,6,26663.250000000004,11620.070000000005
31131,U17478,21,-86031.92,10,11,651076.13,565044.21
31132,U22485,21,-204.94999999999982,14,7,28914.47,28709.52
31133,U40848,21,-78.77999999999906,15,6,15070.44,14991.660000000002
31134,U23473,21,-1940.7399999999998,14,7,22612.46,20671.72
31135,U40765,21,-634.9499999999982,15,6,23272.230000000003,22637.280000000006
31136,U34542,21,0.3400000000037835,11,10,42227.24,42227.58
31137,U20461,21,15121.130000000003,18,3,19117.840000000004,34238.97000000001
31138,U1041254,21,0.9199999999999965,15,6,473.68,474.6
31139,U13143,21,-1316.4600000000064,11,10,181320.04,180003.58000000002
31140,U33349,21,-3932.03,19,2,5935.490000000001,2003.4600000000005
31141,U1179772,21,-234.23000000000025,12,9,3118.34,2884.1099999999997
31142,U902154,21,-3301.3299999999995,17,4,7096.88,3795.5500000000006
31143,U42918,21,48378.66,15,6,13878.500000000002,62257.16
31144,U18651,21,-360.0,11,10,30360.0,30000.0
31145,U38319,21,-4414.640000000001,14,7,19670.0,15255.359999999999
31146,U1088212,21,-14619.320000000005,15,6,20843.4,6224.079999999996
31147,U18992,21,-11335.380000000005,10,11,225620.0,214284.62
31148,U636619,21,137.29,13,8,1734.6299999999999,1871.9199999999998
31149,U21331,21,314.99999999999636,10,11,86338.37,86653.37
31150,U623398,21,82.50000000000091,12,9,11808.72,11891.220000000001
31151,U25321,21,3988.33,14,7,3980.2200000000003,7968.55
31152,U22406,21,17320.369999999995,7,14,1240091.0,1257411.37
31153,U32389,21,-138.97999999999678,14,7,121140.42,121001.44
31154,U30578,21,-135556.81,18,3,136985.79,1428.9800000000105
31155,U42666,21,-7812.490000000003,6,15,89725.89,81913.4
31156,U11980,21,-12159.220000000001,14,7,87315.0,75155.78
31157,U1245251,21,-2.9999999999999942,12,9,762.0,759.0
31158,U751550,21,144.02999999999952,13,8,6416.01,6560.04
31159,U30445,21,880.2500000000382,8,13,1027319.46,1028199.71
31160,U43232,21,-9244.620000000024,10,11,1210359.0,1201114.38
31161,U38882,21,-30826.44000000006,9,12,1559200.0,1528373.56
31162,U39430,21,172162.81000000006,5,16,230746.74,402909.55000000005
31163,U39643,21,220.2300000000026,12,9,31235.36,31455.590000000004
31164,U20322,21,7193.839999999998,11,10,64823.979999999996,72017.81999999999
31165,U13042,21,-30221.92,14,7,40141.31,9919.39
31166,U9600,21,-2812.3500000000004,12,9,21915.879999999997,19103.53
31167,U27628,21,98.67000000000007,6,15,54000.0,54098.67
31168,U19998,21,-12971.13000000002,18,3,50767.85000000002,37796.72
31169,U36378,21,-332.8400000000006,13,8,11052.519999999999,10719.679999999998
31170,U1319029,21,-1650.1200000000001,13,8,11801.74,10151.619999999999
31171,U16766,21,-9786.999999999996,10,11,89365.7,79578.7
31172,U13548,21,1218.1999999999998,17,4,1198.5500000000002,2416.75
31173,U652564,21,314.8699999999998,13,8,7712.34,8027.21
31174,U18339,21,23236.18,11,10,103961.0,127197.18
31175,U593473,21,1.7100000000000932,11,10,1224.3799999999999,1226.09
31176,U32174,21,88846.04,13,8,60483.9,149329.94
31177,U9633,21,2992.26,18,3,23.150000000000006,3015.4100000000003
31178,U22451,21,12149.660000000207,10,11,1739001.1600000001,1751150.8200000003
31179,U658964,21,-2499.2100000000005,13,8,8233.42,5734.209999999999
31180,U40256,21,35187.560000000005,9,12,35733.88,70921.44
31181,U37991,21,31116.4,5,16,117486.97,148603.37
31182,U19984,21,11798.429999999998,13,8,16401.91,28200.339999999997
31183,U37715,21,119806.28,6,15,499900.0,619706.28
31184,U32434,21,-15471.2,18,3,32249.829999999998,16778.629999999997
31185,U16658,21,16388.210000000006,12,9,181790.3,198178.51
31186,U19271,21,3173.9199999999973,16,5,7440.230000000002,10614.15
31187,U27830,21,7826.8,15,6,17109.769999999997,24936.569999999996
31188,U18085,21,-1302.2900000000009,16,5,74815.5,73513.20999999999
31189,U11167,21,12.409999999999894,15,6,1870.7599999999998,1883.1699999999996
31190,U679659,21,1.8500000000000059,13,8,2644.9,2646.75
31191,U14219,21,-2212.3300000000004,19,2,5118.4400000000005,2906.11
31192,U10163,21,-35045.069999999985,14,7,102048.02999999998,67002.95999999999
31193,U21880,21,7396.140000000131,13,8,1079930.58,1087326.7200000002
31194,U29700,21,2226.8100000000068,10,11,50112.8,52339.61000000001
31195,U8803,21,1567.42,15,6,1873.7099999999998,3441.13
31196,U31899,21,-162.31000000005588,10,11,504500.0,504337.68999999994
31197,U25963,21,-331.3400000000003,18,3,3751.3399999999997,3419.9999999999995
31198,U29325,21,-397.27,15,6,13392.470000000001,12995.2
31199,U1216839,21,-3077.82,17,4,3290.16,212.3399999999997
31200,U21075,21,199974.98999999996,13,8,69289.91,269264.89999999997
31201,U26714,21,-10050.449999999999,14,7,17175.51,7125.0599999999995
31202,U25345,21,36160.08,13,8,33458.47,69618.55
31203,U12526,21,10449.0,17,4,88600.22,99049.22
31204,U8039,21,18972.410000000003,14,7,29110.530000000002,48082.94
31205,U23784,21,143.02999999999884,10,11,118096.69,118239.72
31206,U25548,21,-1025.3900000000003,17,4,9133.0,8107.61
31207,U38097,21,40814.81,10,11,40374.59,81189.4
31208,U33111,21,459.1999999999998,10,11,21220.0,21679.2
31209,U19015,21,-121648.92,15,6,121772.0,123.08000000000175
31210,U782829,21,-1537.8100000000004,13,8,10390.94,8853.130000000001
31211,U32039,21,-1527.0200000000004,11,10,15367.0,13839.98
31212,U25255,21,107221.73999999999,13,8,64450.0,171671.74
31213,U37739,21,280.0699999999997,14,7,27961.579999999998,28241.649999999998
31214,U25599,21,-3471.4099999999744,7,14,712700.0,709228.5900000001
31215,U35695,21,67355.48000000001,9,12,5115.0,72470.48000000001
31216,U9268,21,-41091.33,10,11,77277.54000000001,36186.21000000001
31217,U18405,21,26819.38,15,6,31669.24,58488.62
31218,U14584,21,159664.58,11,10,220688.86000000002,380353.44
31219,U34152,21,10993.519999999999,13,8,6126.5599999999995,17120.079999999998
31220,U641742,21,1200.0,12,9,17689.379999999997,18889.379999999997
31221,U37158,21,-12387.46,11,10,158308.76,145921.30000000002
31222,U29938,21,-348951.76,11,10,460000.0,111048.23999999999
31223,U25726,21,77105.07,12,9,53951.46,131056.53
31224,U25113,21,-27520.78,12,9,1240546.73,1213025.95
31225,U1023546,21,100.58000000000007,11,10,760.5999999999999,861.18
31226,U23826,21,-11486.89,11,10,43527.0,32040.11
31227,U11562,21,-1231.8300000000017,14,7,93985.28,92753.45
31228,U42208,21,1075.68,15,6,4224.75,5300.43
31229,U576784,21,-11484.949999999999,12,9,15174.089999999997,3689.1399999999976
31230,U40094,21,-6556.239999999991,10,11,476939.45,470383.21
31231,U38709,21,-214509.31000000003,14,7,365893.19999999995,151383.88999999993
31232,U1062032,21,-16.10000000000003,17,4,622.1099999999999,606.0099999999999
31233,U29899,21,4433.330000000002,16,5,399856.67,404290.0
31234,U38368,21,-3583.0000000000005,11,10,28270.260000000002,24687.260000000002
31235,U34959,21,8976.59000000001,8,13,70643.6,79620.19000000002
31236,U19112,21,-248.55,14,7,843.63,595.0799999999999
31237,U33494,21,7009.74,9,12,14431.0,21440.739999999998
31238,U35228,21,2062.8000000000006,19,2,10217.200000000003,12280.000000000004
31239,U41587,21,-10215.659999999998,12,9,25198.960000000003,14983.300000000005
31240,U624084,21,-2781.5699999999997,10,11,24084.36,21302.79
31241,U35601,21,-13315.790000000003,16,5,35045.96,21730.17
31242,U37419,21,70017.5,10,11,750010.0,820027.5
31243,U39073,21,2152.329999999958,9,12,716852.0,719004.33
31244,U850514,21,1336.8900000000012,13,8,32132.219999999998,33469.11
31245,U40761,21,-8966.980000000001,15,6,53421.01000000001,44454.030000000006
31246,U29630,21,11389.749999999998,6,15,646644.0,658033.75
31247,U30358,21,-567.64,15,6,1121.7,554.0600000000001
31248,U35685,21,-23282.789999999994,15,6,68086.2,44803.41
31249,U21010,21,-34766.090000000004,17,4,81574.11000000003,46808.020000000026
31250,U39552,21,-43961.75,17,4,51276.34,7314.5899999999965
31251,U22172,21,-1924.25,18,3,8513.7,6589.450000000001
31252,U10659,21,-2315.869999999999,16,5,61049.97,58734.100000000006
31253,U33120,21,-330.40000000000146,16,5,15302.34,14971.939999999999
31254,U42387,21,4371.74,13,8,17607.38,21979.120000000003
31255,U24433,21,298692.56999999995,9,12,430000.05000000005,728692.62
31256,U27154,21,-1646813.12,11,10,1779208.43,132395.30999999982
31257,U31573,21,-13925.11,16,5,15116.2,1191.0900000000001
31258,U23646,21,3745.01,10,11,26453.9,30198.910000000003
31259,U31656,21,-358211.98,12,9,1592500.0,1234288.02
31260,U14711,21,-34296.29000000001,13,8,55974.1,21677.80999999999
31261,U40022,21,-12837.89,11,10,115247.0,102409.11
31262,U617908,21,400.14,8,13,5726.09,6126.2300000000005
31263,U22346,21,-17105.25,13,8,89412.24000000002,72306.99000000002
31264,U13069,21,3400.9599999999964,11,10,23849.2,27250.159999999996
31265,U36592,21,553.9100000000002,13,8,8307.9,8861.81
31266,U20110,21,83017.08,11,10,40302.44,123319.52
31267,U22993,21,0.0,12,9,861188.27,861188.27
31268,U16885,21,691839.8899999999,9,12,429752.7,1121592.5899999999
31269,U1305409,21,-676.0799999999999,13,8,1304.26,628.1800000000001
31270,U26035,21,-199.6400000000004,15,6,4576.4400000000005,4376.8
31271,U40562,21,18881.03,15,6,2505.11,21386.14
31272,U11641,21,-8585.980000000001,16,5,36581.7,27995.719999999994
31273,U40847,21,63.79000000001514,10,11,99236.43,99300.22
31274,U35300,21,-35947.299999999974,10,11,313585.5,277638.2
31275,U42177,21,-295.91999999999973,14,7,33175.0,32879.08
31276,U1127526,21,-5334.260000000001,16,5,6013.060000000001,678.8000000000002
31277,U8344,21,356.80999999999966,14,7,10603.92,10960.73
31278,U28702,21,-5318.79,16,5,15378.61,10059.82
31279,U8114,21,-10325.68,12,9,41273.64,30947.96
31280,U24959,21,2932.5699999999997,11,10,2488.76,5421.33
31281,U25005,21,-5335.81,14,7,23096.640000000003,17760.83
31282,U42230,21,-125.90999999999985,12,9,58326.04,58200.130000000005
31283,U33988,21,-4477.170000000001,16,5,18679.71,14202.539999999997
31284,U42822,21,-2688.01,11,10,19767.9,17079.89
31285,U14882,21,-31815.959999999992,8,13,139634.66,107818.70000000001
31286,U8383,21,-6795.8,18,3,7244.3,448.5
31287,U32990,21,4507.15,15,6,1625.25,6132.4
31288,U35986,21,-1375.1399999999921,13,8,185582.5,184207.36000000002
31289,U23138,21,-20924.969999999994,12,9,471433.25,450508.28
31290,U37085,21,6447.89,16,5,6654.99,13102.880000000001
31291,U40458,21,-6910.190000000001,14,7,27455.98,20545.789999999997
31292,U39036,21,-4396.9400000000005,12,9,15448.0,11051.06
31293,U19909,21,53.23000000000002,16,5,6833.4400000000005,6886.67
31294,U32904,21,-39918.64,11,10,107497.58,67578.94
31295,U35092,21,6316.290000000002,8,13,156301.1,162617.39
31296,U36690,21,322.1899999999996,16,5,5931.02,6253.21
31297,U15145,21,40048.009999999995,11,10,234753.8,274801.81
31298,U17635,21,52081.54000000001,6,15,47407.63,99489.17000000001
31299,U31890,21,-76098.72,4,17,300100.0,224001.28
31300,U30292,21,-3997.7700000000004,15,6,18470.65,14472.880000000001
31301,U38304,21,752.7200000000005,18,3,7752.4,8505.12
31302,U12104,21,5334.589999999999,8,13,6478.01,11812.599999999999
31303,U1371649,21,-119024.19,16,5,149622.97999999998,30598.78999999998
31304,U19467,21,-7986.44,16,5,46811.65,38825.21
31305,U18234,21,105129.57,11,10,34112.8,139242.37
31306,U10364,21,-16820.15,10,11,68702.92,51882.77
31307,U1252435,21,-21568.09,16,5,27394.09,5826.0
31308,U589085,21,-14181.710000000001,16,5,21315.889999999996,7134.179999999995
31309,U25864,21,-18.299999999999955,17,4,3173.5,3155.2
31310,U9068,21,0.020000000000436557,11,10,49000.01,49000.03
31311,U23006,21,14040.480000000001,15,6,22347.54,36388.020000000004
31312,U14211,21,-1037.41,17,4,1777.32,739.9099999999999
31313,U43034,21,-13569.379999999997,16,5,28451.29,14881.910000000003
31314,U24724,21,24804.420000000002,10,11,17689.32,42493.740000000005
31315,U36051,21,2623.3300000000004,14,7,24452.870000000003,27076.200000000004
31316,U904572,21,-13529.130000000001,17,4,21329.130000000005,7800.000000000004
31317,U26168,21,-21613.499999999996,15,6,56754.75,35141.25
31318,U10831,21,11849.320000000002,12,9,20455.670000000002,32304.990000000005
31319,U34523,21,200302.75000000003,7,14,111019.32,311322.07000000007
31320,U37732,21,765.4899999999977,16,5,75640.41,76405.9
31321,U11341,21,131980.28000000003,14,7,77706.61,209686.89
31322,U32300,21,20924.48,7,14,34154.8,55079.28
31323,U37720,21,8839.88,9,12,46480.25,55320.13
31324,U1250936,21,756.35,15,6,1443.65,2200.0
31325,U28440,21,-58855.880000000005,9,12,395078.52999999997,336222.64999999997
31326,U28322,21,628.81,17,4,1858.6599999999999,2487.47
31327,U1073366,21,2182.08,10,11,3517.92,5700.0
31328,U612895,21,-14.15999999999994,15,6,1199.1200000000001,1184.9600000000003
31329,U35091,21,-10926.52,14,7,29998.95,19072.43
31330,U25902,21,-37961.78000000003,9,12,436400.0,398438.22
31331,U31322,21,81.93000000000053,11,10,5652.09,5734.02
31332,U713773,21,3478.2400000000007,12,9,10321.78,13800.02
31333,U41663,21,20297.650000000078,9,12,1351239.73,1371537.3800000001
31334,U1065821,21,717.6,12,9,1286.3000000000002,2003.9
31335,U27442,21,4322.44,12,9,4769.51,9091.95
31336,U22354,21,75975.95,10,11,108757.94000000002,184733.89
31337,U9462,21,-1081505.08,9,12,1955056.0,873550.9199999999
31338,U28906,21,1.1368683772161603e-13,13,8,1291.1000000000001,1291.1000000000004
31339,U37304,21,32157.929999999997,6,15,295350.8,327508.73
31340,U27822,21,6298.8,17,4,8501.37,14800.170000000002
31341,U964333,21,-979.4400000000005,15,6,44193.439999999995,43213.99999999999
31342,U24341,21,-31730.53,11,10,119935.85,88205.32
31343,U23344,21,-7188.679999999997,11,10,45713.0,38524.32000000001
31344,U964765,21,3922.5100000000007,13,8,15459.66,19382.170000000002
31345,U19661,21,-15984.159999999996,12,9,229696.68,213712.52
31346,U43024,21,-8180.7599999999975,11,10,56469.91,48289.15000000001
31347,U38523,21,-908.3400000000001,14,7,30778.0,29869.66
31348,U786742,21,-0.7999999999991587,18,3,4443.8099999999995,4443.01
31349,U17505,21,19804.629999999994,7,14,2625875.24,2645679.87
31350,U872220,21,-2235.2100000000005,9,12,3733.05,1497.8399999999997
31351,U1191078,21,1234.0599999999997,16,5,10640.410000000002,11874.470000000001
31352,U32403,21,566.129999999998,13,8,59204.01,59770.14
31353,U18395,21,-463.89999999999964,14,7,13862.1,13398.2
31354,U668779,21,488.04999999999995,14,7,4951.910000000001,5439.960000000001
31355,U21800,21,109.89000000000544,14,7,117674.38999999998,117784.27999999998
31356,U21535,21,925.2400000000016,17,4,9619.399999999998,10544.64
31357,U28677,21,12215.179999999997,8,13,87817.78,100032.95999999999
31358,U24827,21,-77261.17000000001,12,9,123097.86000000002,45836.69
31359,U17892,21,8587.85,13,8,11942.15,20530.0
31360,U1167731,21,-90.50000000000087,17,4,14715.21,14624.71
31361,U37670,21,-59.85999999999876,11,10,18450.0,18390.14
31362,U1075775,21,31.420000000000414,12,9,8897.140000000001,8928.560000000001
31363,U36054,21,-26342.850000000002,5,16,65100.0,38757.149999999994
31364,U10523,21,3595.549999999951,10,11,492179.6,495775.1499999999
31365,U15253,21,24219.990000000005,13,8,188557.6,212777.59000000003
31366,U30307,21,301.5300000000025,10,11,72403.20000000001,72704.73000000001
31367,U22732,21,120.43999999999869,13,8,52035.41,52155.850000000006
31368,U38448,21,-6667.2699999999995,14,7,25105.559999999998,18438.289999999997
31369,U42357,21,-12541.74,12,9,54986.0,42444.26
31370,U8163,21,97841.05999999998,14,7,14013.21,111854.26999999999
31371,U15036,21,38684.39,10,11,111046.0,149730.39
31372,U684430,21,648.2200000000005,14,7,5581.98,6230.2
31373,U20501,21,-0.32000000000061846,10,11,26903.81,26903.49
31374,U21451,21,-100.00000000000068,11,10,23274.989999999998,23174.989999999998
31375,U1146403,21,-1770.6000000000004,13,8,2596.69,826.0899999999997
31376,U13730,21,-306261.42000000004,15,6,413102.75,106841.32999999996
31377,U15449,21,-1742.8499999999935,12,9,161285.96,159543.11
31378,U669573,21,58.119999999999976,12,9,664.28,722.4
31379,U42199,21,-139.35999999999996,18,3,684.0,544.6400000000001
31380,U22452,21,4577.690000000029,5,16,153000.0,157577.69000000003
31381,U41669,21,-281697.45999999996,13,8,347423.28,65725.82000000007
31382,U20145,21,496.92999999999995,15,6,509.21999999999997,1006.1499999999999
31383,U21915,21,-4146.18,9,12,32182.0,28035.82
31384,U41324,21,5088.74,10,11,11050.0,16138.74
31385,U33958,21,2804.3900000000003,14,7,6693.66,9498.05
31386,U14004,21,5291.079999999999,14,7,10255.189999999999,15546.269999999997
31387,U20952,21,205.48000000000016,16,5,3845.92,4051.4
31388,U30988,21,-58456.59,9,12,110965.9,52509.31
31389,U21277,21,25130.01,7,14,25403.120000000003,50533.130000000005
31390,U31662,21,4438.36,15,6,10928.759999999998,15367.119999999999
31391,U20707,21,-203.84000000000037,14,7,33887.91,33684.07
31392,U10863,21,7122.390000000001,15,6,7332.95,14455.34
31393,U42252,21,-9220.310000000001,17,4,54496.0,45275.69
31394,U39403,21,-6110.18,19,2,6140.0,29.81999999999971
31395,U41851,21,-6505.430000000008,7,14,111335.22,104829.79
31396,U13495,21,11241.62000000001,18,3,25784.729999999992,37026.350000000006
31397,U39867,21,63250.810000000005,8,13,64599.5,127850.31
31398,U20618,21,7404.9000000000015,16,5,7610.59,15015.490000000002
31399,U30373,21,-3480.0899999999965,16,5,63500.46,60020.37
31400,U617449,21,-342.8400000000006,20,1,5342.84,5000.0
31401,U25219,21,-69.28999999999996,11,10,13798.89,13729.599999999999
31402,U1143881,21,978.2399999999999,16,5,2471.7600000000007,3450.0000000000005
31403,U28744,21,-255.51999999998952,7,14,451220.0,450964.48
31404,U44005,21,28502.49,10,11,9295.259999999998,37797.75
31405,U19541,21,-73.4599999999964,10,11,52127.82,52054.36
31406,U1204013,21,-2409.1499999999996,18,3,2652.3399999999997,243.19000000000005
31407,U23543,21,2231.1100000000006,14,7,13529.330000000002,15760.440000000002
31408,U16380,21,-2311.6400000000003,9,12,19702.52,17390.88
31409,U14616,21,-50832.24,11,10,346043.19999999995,295210.95999999996
31410,U27676,21,509.2799999999997,17,4,5661.5599999999995,6170.839999999999
31411,U19178,21,-201913.16999999993,13,8,815915.88,614002.7100000001
31412,U15884,21,-1061839.4,11,10,3458188.5,2396349.1
31413,U24090,21,-10134.94,7,14,21275.440000000002,11140.500000000002
31414,U32871,21,1369.1799999999994,13,8,24034.14,25403.32
31415,U33434,21,13330.529999999999,16,5,7391.0599999999995,20721.589999999997
31416,U33452,21,704.3400000000001,14,7,75700.0,76404.34
31417,U826434,21,11.650000000000109,11,10,2965.9900000000002,2977.6400000000003
31418,U40166,21,8853.920000000002,9,12,14073.640000000001,22927.560000000005
31419,U19404,21,-459.59999999999997,19,2,760.8799999999999,301.2799999999999
31420,U43875,21,-1469.67,13,8,8586.98,7117.3099999999995
31421,U28633,21,42445.740000000005,10,11,120305.0,162750.74
31422,U12010,21,8105.029999999998,14,7,234403.82,242508.85
31423,U34082,21,-414.07999999999987,14,7,9360.99,8946.91
31424,U36026,21,-10287.669999999998,16,5,34364.89,24077.22
31425,U24787,21,390.8800000000001,17,4,35.14999999999998,426.0300000000001
31426,U36028,20,853.4599999999998,15,5,1981.07,2834.5299999999997
31427,U1306961,20,-1112.95,10,10,7923.0,6810.05
31428,U22076,20,3540.5499999999993,15,5,9142.410000000002,12682.960000000001
31429,U37185,20,-20727.219999999998,17,3,26907.319999999996,6180.0999999999985
31430,U30990,20,-48226.18,14,6,118241.9,70015.72
31431,U38212,20,772836.4500000002,11,9,703571.0,1476407.4500000002
31432,U33412,20,121275.97,12,8,68906.02,190181.99
31433,U25512,20,26.17,10,10,39024.0,39050.17
31434,U38740,20,429618.54,18,2,270828.8,700447.34
31435,U21900,20,6386.839999999992,9,11,151803.88999999998,158190.72999999998
31436,U8709,20,97.25000000000145,9,11,40776.7,40873.95
31437,U39921,20,-7183.719999999972,8,12,1040953.0,1033769.28
31438,U18776,20,16710.32,13,7,88104.9,104815.22
31439,U8716,20,952.8200000000002,15,5,8747.7,9700.52
31440,U15080,20,-4320.0499999999965,11,9,60529.03999999999,56208.99
31441,U32812,20,-1207.3399999999988,15,5,42207.42,41000.08
31442,U23053,20,-89567.11,9,11,154239.0,64671.89
31443,U34860,20,-1239.6499999999996,13,7,13461.62,12221.970000000001
31444,U33506,20,-2766.6499999999983,13,7,33563.35,30796.7
31445,U31350,20,4243.779999999999,10,10,50795.25,55039.03
31446,U23192,20,-548.1299999999953,9,11,431289.15,430741.02
31447,U13373,20,965.3999999999971,16,4,32645.62,33611.02
31448,U37778,20,106.77,15,5,369.13000000000005,475.90000000000003
31449,U35509,20,19488.76000000001,16,4,432481.0,451969.76
31450,U37723,20,1464.9199999999937,10,10,62349.46,63814.37999999999
31451,U624649,20,-2543.9799999999996,16,4,16316.600000000002,13772.620000000003
31452,U993461,20,14587.309999999998,15,5,27370.6,41957.909999999996
31453,U33566,20,-13.510000000003515,17,3,105709.70000000001,105696.19
31454,U23155,20,-5723.699999999941,10,10,1053002.64,1047278.94
31455,U9844,20,6391.4,15,5,18289.62,24681.019999999997
31456,U25298,20,63133.19000000004,11,9,718623.36,781756.55
31457,U19369,20,99884.12000000002,4,16,506442.11,606326.23
31458,U15113,20,-8024.169999999998,11,9,145717.0,137692.83000000002
31459,U29797,20,132603.43,4,16,103000.0,235603.43
31460,U23694,20,-4433.77,14,6,7044.82,2611.0499999999993
31461,U18741,20,126377.98,13,7,23801.29,150179.27
31462,U31047,20,8955.280000000002,13,7,19906.63,28861.910000000003
31463,U29901,20,-4788.0300000000025,10,10,53122.46,48334.42999999999
31464,U34219,20,373.7499999999998,12,8,14565.64,14939.39
31465,U18944,20,-3726.7400000000002,18,2,3765.32,38.57999999999993
31466,U8850,20,-1924.750000000011,11,9,114059.50000000003,112134.75000000001
31467,U32669,20,10096.99,16,4,13280.199999999999,23377.19
31468,U37039,20,59274.990000000005,6,14,190000.0,249274.99
31469,U40520,20,-5912.860000000002,4,16,24100.0,18187.14
31470,U25022,20,34.00000000000003,15,5,533.76,567.76
31471,U21161,20,12638.699999999999,11,9,30131.48,42770.18
31472,U34924,20,-19867.019999999993,15,5,61783.27,41916.25
31473,U39767,20,11633.89,8,12,57098.600000000006,68732.49
31474,U11301,20,84763.01000000001,6,14,134100.0,218863.01
31475,U37587,20,-15887.06,14,6,100372.67,84485.61
31476,U26703,20,-162.89999999999986,14,6,7257.16,7094.26
31477,U35401,20,-50865.98,16,4,51876.32000000001,1010.3400000000038
31478,U14572,20,295.5899999999998,13,7,2960.96,3256.5499999999997
31479,U31481,20,-2962292.8900000006,8,12,7812013.0,4849720.109999999
31480,U926968,20,22.29000000000001,14,6,1314.26,1336.55
31481,U727228,20,0.4000000000005457,10,10,9946.400000000001,9946.800000000003
31482,U38015,20,32072.419999999995,10,10,22393.800000000003,54466.22
31483,U22070,20,-186.26000000000022,13,7,25233.0,25046.739999999998
31484,U29374,20,55.90000000000005,15,5,751.2299999999999,807.13
31485,U26823,20,4182.1,13,7,16289.61,20471.71
31486,U22230,20,996.3999999999996,11,9,52947.34,53943.74
31487,U42887,20,-2923.899999999987,11,9,250529.94999999998,247606.05
31488,U8513,20,999.0499999999995,13,7,31893.64,32892.69
31489,U17366,20,-1124.9799999999987,14,6,27038.73,25913.75
31490,U25718,20,-3338.4500000000003,17,3,11945.97,8607.519999999999
31491,U17887,20,26403.79,14,6,6294.43,32698.22
31492,U43453,20,9807.41,11,9,72425.74,82233.15000000001
31493,U1265936,20,-295.47000000000116,14,6,21932.5,21637.03
31494,U18063,20,-6480.74,10,10,12308.8,5828.0599999999995
31495,U34178,20,27.33999999999969,14,6,13501.0,13528.34
31496,U8119,20,-110.1299999999992,14,6,13866.39,13756.26
31497,U40085,20,28835.160000000018,12,8,322500.0,351335.16000000003
31498,U26618,20,-2326.9700000000003,10,10,6909.0,4582.03
31499,U15788,20,-266.30000000001485,9,11,217183.37,216917.06999999998
31500,U36092,20,12611.470000000021,9,11,245830.0,258441.47000000003
31501,U8818,20,2337.5300000000007,12,8,21132.46,23469.989999999998
31502,U835484,20,-4297.92,14,6,10336.97,6039.049999999999
31503,U28442,20,-72.38999999999986,11,9,69208.0,69135.61
31504,U638527,20,2999.48,15,5,3934.3800000000006,6933.860000000001
31505,U25824,20,-14294.37,11,9,84194.81000000001,69900.44000000002
31506,U25054,20,45821.7,9,11,93536.68000000001,139358.38
31507,U952935,20,5.690000000000055,10,10,5449.1,5454.790000000001
31508,U27423,20,-343.0699999999997,10,10,27861.0,27517.93
31509,U19794,20,-47556.99,12,8,50330.0,2773.010000000002
31510,U596330,20,-2.339999999999993,14,6,867.41,865.0699999999999
31511,U10539,20,4783.97,15,5,8247.02,13030.990000000002
31512,U24392,20,7516.449999999997,12,8,42962.78,50479.229999999996
31513,U16271,20,-447798.71,8,12,994448.88,546650.1699999999
31514,U18044,20,-62.039999999999964,9,11,11446.05,11384.009999999998
31515,U28471,20,-12936.719999999998,14,6,70891.1,57954.380000000005
31516,U23842,20,-527.6500000000015,12,8,19138.82,18611.17
31517,U43333,20,-4852.830000000002,12,8,17767.920000000002,12915.09
31518,U40627,20,10880.740000000002,9,11,10563.0,21443.74
31519,U19947,20,-1840.7399999999998,15,5,12387.74,10547.0
31520,U20496,20,13749.570000000003,13,7,31557.249999999996,45306.82
31521,U8892,20,-27030.890000000003,10,10,227125.37,200094.47999999998
31522,U15235,20,-6225.709999999997,9,11,18984.24,12758.530000000004
31523,U22106,20,-200919.31,10,10,848639.26,647719.95
31524,U43739,20,-898.9600000000003,12,8,9442.3,8543.339999999998
31525,U30827,20,-373.07,16,4,808.21,435.14000000000004
31526,U14999,20,30561.250000000007,13,7,29706.699999999997,60267.950000000004
31527,U29795,20,-42366.509999999995,15,5,45109.439999999995,2742.9300000000003
31528,U938251,20,-12.929999999999993,11,9,1234.65,1221.72
31529,U18426,20,-74008.29,14,6,115712.5,41704.21000000001
31530,U30656,20,-4027.2599999999998,13,7,14464.849999999999,10437.589999999998
31531,U29053,20,111.24000000000342,10,10,84822.2,84933.44
31532,U35081,20,677.9799999999998,14,6,14364.0,15041.98
31533,U42744,20,3465.8199999999997,14,6,3386.5,6852.32
31534,U42680,20,67.52000000000004,16,4,1679.8,1747.32
31535,U43629,20,-1023.83,19,1,1024.0,0.16999999999995907
31536,U676168,20,-4152.75,20,0,4152.75,0.0
31537,U14035,20,-8604.019999999999,11,9,61915.0,53310.98
31538,U17770,20,-5541.860000000001,11,9,23921.510000000002,18379.65
31539,U23438,20,57825.009999999995,10,10,189828.19,247653.2
31540,U34686,20,-5302.21,13,7,10439.64,5137.429999999999
31541,U22541,20,1014.3499999999999,13,7,4688.0599999999995,5702.41
31542,U19656,20,374.380000000001,10,10,41710.0,42084.380000000005
31543,U21471,20,1229.6699999999996,13,7,11438.41,12668.08
31544,U28567,20,1739.0299999999895,8,12,183232.51,184971.54
31545,U9122,20,1556.85,16,4,1243.16,2800.01
31546,U42016,20,-45001.0,10,10,76502.8,31501.800000000003
31547,U29785,20,-38.29,17,3,238.3,200.01000000000002
31548,U685629,20,-21181.73,13,7,26631.76,5450.029999999999
31549,U41618,20,-119644.29,11,9,184136.0,64491.71000000001
31550,U628964,20,-7367.9400000000005,15,5,12767.95,5400.01
31551,U22853,20,605.3900000000003,13,7,3164.73,3770.1200000000003
31552,U44051,20,-17014.929999999993,9,11,116533.0,99518.07
31553,U40641,20,16998.230000000003,16,4,21093.25,38091.48
31554,U1274370,20,2307.68,11,9,2030.0,4337.68
31555,U28791,20,53933.23999999999,9,11,140773.0,194706.24
31556,U27008,20,54987.71,13,7,13953.630000000001,68941.34
31557,U1217529,20,4714.950000000001,14,6,2826.88,7541.830000000001
31558,U28158,20,-5574.32,17,3,5646.0,71.68000000000029
31559,U1136659,20,-2465.16,20,0,2465.16,0.0
31560,U38554,20,1011.2499999999998,9,11,21272.0,22283.25
31561,U21792,20,-1900.8600000000001,18,2,2068.97,168.10999999999967
31562,U42519,20,65995.78,8,12,73038.0,139033.78
31563,U14868,20,316185.24000000005,7,13,147432.0,463617.24000000005
31564,U639677,20,4600.83,12,8,2859.0,7459.83
31565,U26083,20,-144288.41999999998,12,8,435333.6,291045.18
31566,U956921,20,-1768.6299999999999,11,9,2308.63,540.0000000000002
31567,U28227,20,302.6899999999964,16,4,102877.09999999999,103179.79
31568,U14071,20,970.0799999999928,16,4,65576.92000000001,66547.0
31569,U41960,20,-19690.47,16,4,63991.270000000004,44300.8
31570,U33756,20,-9935.68,15,5,15836.220000000001,5900.540000000001
31571,U24956,20,-16611.41,16,4,23621.260000000002,7009.850000000002
31572,U16479,20,1179.5200000000004,13,7,25737.07,26916.59
31573,U1206189,20,-914.5699999999999,13,7,1761.48,846.9100000000001
31574,U18674,20,1911.9599999999998,15,5,8152.99,10064.949999999999
31575,U15888,20,6572.580000000001,10,10,27030.0,33602.58
31576,U13366,20,-26928.370000000024,10,10,198892.1,171963.72999999998
31577,U1355286,20,247.99999999999994,9,11,612.3,860.3
31578,U43827,20,141.60999999999817,12,8,34584.96000000001,34726.57000000001
31579,U10445,20,-2820.42,16,4,42445.689999999995,39625.27
31580,U30642,20,3914.08,11,9,5372.02,9286.1
31581,U24127,20,1031.9600000000792,9,11,3393600.0,3394631.96
31582,U30430,20,4899.249999999884,10,10,744138.59,749037.8399999999
31583,U11698,20,-18838.2,13,7,133110.19,114271.99
31584,U577882,20,-161.07999999999998,9,11,1409.4600000000003,1248.3800000000003
31585,U8808,20,-21985.67,14,6,27095.6,5109.93
31586,U32287,20,-2386.6,13,7,5214.0,2827.4
31587,U23965,20,-24042.100000000006,12,8,178690.84000000003,154648.74000000002
31588,U41582,20,-201124.40999999997,10,10,578471.5599999999,377347.14999999997
31589,U21088,20,4418.27,16,4,7962.73,12381.0
31590,U24248,20,3761.5299999999997,16,4,2070.4700000000003,5832.0
31591,U31675,20,-134293.33,11,9,360520.38,226227.05000000002
31592,U1303789,20,-1358.9599999999998,15,5,5117.01,3758.05
31593,U38165,20,-129.56,10,10,1006.3,876.74
31594,U23820,20,-2789.3100000000113,12,8,126485.81,123696.49999999999
31595,U26463,20,-2037213.87,18,2,2074115.0699999998,36901.19999999972
31596,U39394,20,6057.6600000000035,12,8,155698.41999999998,161756.08
31597,U1151564,20,-571.5199999999998,18,2,2882.2299999999996,2310.71
31598,U27055,20,-452.6099999999997,12,8,19836.93,19384.32
31599,U31762,20,-50464.399999999994,11,9,290550.0,240085.6
31600,U31249,20,-416.21000000000095,17,3,4062.2100000000014,3646.0000000000005
31601,U31117,20,3156.319999999949,12,8,449738.04000000004,452894.36
31602,U22975,20,-34167.11,13,7,136615.38999999998,102448.27999999998
31603,U28955,20,-1013.2299999999957,5,15,33804.579999999994,32791.35
31604,U709038,20,-3957.69,15,5,5793.54,1835.85
31605,U24089,20,374.34999999999127,5,15,260000.0,260374.34999999998
31606,U43730,20,-8264.099999999999,15,5,22265.0,14000.900000000001
31607,U41178,20,-13010.66,14,6,58817.89000000001,45807.23000000001
31608,U25210,20,-2838.0299999999997,16,4,5763.389999999999,2925.3599999999997
31609,U35382,20,20473.799999999996,11,9,5036.34,25510.139999999996
31610,U40069,20,10463.64,11,9,8719.94,19183.58
31611,U37443,20,-316696.70999999996,11,9,327669.13999999996,10972.429999999993
31612,U15901,20,-696623.66,8,12,1408338.15,711714.4899999999
31613,U14729,20,-7587.770000000019,9,11,584991.15,577403.38
31614,U38517,20,-76596.56,6,14,203746.53,127149.97
31615,U11787,20,2538.5100000000016,17,3,2580.95,5119.460000000001
31616,U41216,20,8098.17,12,8,19033.16,27131.33
31617,U29968,20,-150194.65000000002,9,11,216735.0,66540.34999999998
31618,U36435,20,61.22000000000003,13,7,1492.0,1553.22
31619,U20292,20,985.5099999999948,10,10,83672.16,84657.67
31620,U17693,20,13099.030000000004,13,7,17387.75,30486.780000000006
31621,U27748,20,-18930.179999999997,11,9,78999.58,60069.40000000001
31622,U20017,20,1124.5199999999995,14,6,8139.54,9264.06
31623,U9259,20,355.20000000000005,14,6,736.0,1091.2
31624,U42820,20,-4763.929999999999,13,7,22913.8,18149.87
31625,U34901,20,1490.550000000001,12,8,17368.97,18859.520000000004
31626,U937152,20,-888.9899999999998,13,7,10603.889999999998,9714.899999999998
31627,U24681,20,-1.490000000000009,11,9,2391.0,2389.51
31628,U23103,20,-7220.610000000001,17,3,7353.41,132.79999999999927
31629,U40152,20,-12486.199999999995,12,8,77969.66,65483.46000000001
31630,U33312,20,-10145.510000000002,13,7,30566.28,20420.769999999997
31631,U1339096,20,1122.75,14,6,7977.68,9100.43
31632,U33424,20,4388.299999999999,13,7,18131.9,22520.2
31633,U34040,20,-20179.579999999998,15,5,28760.96,8581.380000000001
31634,U22005,20,-5644.8099999999995,16,4,9043.849999999999,3399.039999999999
31635,U25074,20,-2.8600000000001273,10,10,2502.94,2500.08
31636,U42650,20,-7737.389999999999,13,7,17493.03,9755.64
31637,U21281,20,741.1799999999998,13,7,4738.5599999999995,5479.74
31638,U34093,20,-9081.980000000001,17,3,16926.76,7844.779999999997
31639,U15031,20,2503.4500000000007,14,6,25174.9,27678.350000000002
31640,U23450,20,420.12000000011176,10,10,1308559.0,1308979.12
31641,U34344,20,198.12000000000035,13,7,49716.07000000001,49914.19000000001
31642,U25041,20,-328705.25999999995,8,12,556463.6,227758.34000000003
31643,U25523,20,-21.110000000000042,13,7,213.56000000000003,192.45
31644,U44050,20,-4292.089999999987,12,8,321539.49000000005,317247.4000000001
31645,U30318,20,771.8999999999942,9,11,115463.67,116235.56999999999
31646,U23456,20,-283.0200000000134,8,12,204651.5,204368.47999999998
31647,U41475,20,-8544.539999999999,16,4,23645.0,15100.460000000001
31648,U43714,20,4662.19,14,6,12808.0,17470.19
31649,U32771,20,-85.97000000000116,10,10,26355.86,26269.89
31650,U30540,20,30026.76999999999,13,7,307808.0,337834.77
31651,U38997,20,7730.6,10,10,26885.02,34615.62
31652,U13891,20,-26848.909999999996,18,2,26877.8,28.890000000003056
31653,U42093,20,26299.42,5,15,90486.8,116786.22
31654,U25591,20,322.74,11,9,1296.91,1619.65
31655,U743011,20,-23691.870000000003,19,1,29691.870000000003,6000.0
31656,U38802,20,-36633.04,15,5,49527.2,12894.159999999996
31657,U11432,20,15878.399999999998,11,9,49852.3,65730.7
31658,U12360,20,792075.65,14,6,14879.380000000001,806955.03
31659,U42183,20,320.5200000000041,11,9,166189.47,166509.99
31660,U29347,20,-19394.690000000002,12,8,263409.70999999996,244015.01999999996
31661,U13976,20,-289127.06,12,8,444522.57,155395.51
31662,U12951,20,6701.65,15,5,6705.66,13407.31
31663,U35155,20,-172.0000000000117,9,11,363477.27999999997,363305.27999999997
31664,U19898,20,42028.69,11,9,47358.37,89387.06
31665,U10978,20,1710.5900000000024,11,9,60808.21,62518.8
31666,U43801,20,0.0,10,10,17508.41,17508.41
31667,U25949,20,343.71000000000004,13,7,13908.300000000001,14252.010000000002
31668,U33243,20,1223.3600000000006,12,8,41476.28,42699.64
31669,U22644,20,12.820000000012802,9,11,421360.61,421373.43
31670,U32539,20,4269.630000000004,14,6,111252.61,115522.24
31671,U25531,20,-552.9499999999998,11,9,18276.0,17723.05
31672,U990653,20,3498.5,13,7,2807.54,6306.04
31673,U17957,20,18.81000000000313,11,9,64004.0,64022.810000000005
31674,U10429,20,-1899.029999999999,12,8,21148.18,19249.15
31675,U11402,20,1090.7200000000005,13,7,7413.4800000000005,8504.2
31676,U13727,20,8262.470000000008,12,8,172039.55,180302.02
31677,U1197892,20,-1032.17,14,6,4937.88,3905.71
31678,U17909,20,-1992.5399999999645,15,5,503898.05,501905.51
31679,U19320,20,-2700.05,13,7,8580.62,5880.570000000001
31680,U28282,20,800.6999999999997,14,6,2635.1600000000008,3435.8600000000006
31681,U33130,20,-9056.61,11,9,73067.56,64010.95
31682,U1133757,20,-1541.1499999999999,14,6,1906.2799999999997,365.1299999999999
31683,U36020,20,-160.76000000000002,13,7,44458.14000000001,44297.380000000005
31684,U13322,20,-26783.120000000006,9,11,206791.33000000002,180008.21000000002
31685,U41062,20,16405.96,10,10,25324.0,41729.96
31686,U631839,20,-1136.1200000000001,15,5,3147.42,2011.3
31687,U32103,20,-3058.3899999999994,14,6,16858.5,13800.11
31688,U36471,20,-35596.09,14,6,139144.37,103548.28
31689,U28146,20,818.2800000000001,15,5,10132.95,10951.230000000001
31690,U36525,20,544.1300000000001,9,11,8182.59,8726.720000000001
31691,U9380,20,-60324.850000000006,14,6,127779.1,67454.25
31692,U40569,20,659.0100000000009,13,7,31295.91,31954.920000000002
31693,U18383,20,972.9700000000007,4,16,14159.970000000001,15132.940000000002
31694,U33845,20,-467.009999999998,15,5,76780.36000000002,76313.35000000002
31695,U19263,20,298.4699999999999,11,9,3100.2200000000003,3398.69
31696,U37093,20,2184.32,16,4,5727.91,7912.23
31697,U32614,20,-104026.57999999999,15,5,132457.75,28431.170000000013
31698,U8227,20,9228.45,9,11,17708.23,26936.68
31699,U22269,20,-57817.11000000001,16,4,63991.44000000001,6174.330000000002
31700,U35476,20,-13803.61,10,10,40291.96,26488.35
31701,U14091,20,5092.609999999999,12,8,24941.660000000003,30034.270000000004
31702,U14631,20,-41169.13,12,8,63931.55999999999,22762.429999999993
31703,U21207,20,-15679.339999999997,10,10,77405.39,61726.05
31704,U27719,20,-9341.160000000003,8,12,353892.0,344550.83999999997
31705,U22381,20,495.4399999999989,9,11,29308.95,29804.39
31706,U25429,20,691.5999999999999,16,4,4786.0,5477.6
31707,U965024,20,-11.219999999999345,12,8,25821.0,25809.78
31708,U16229,20,-11804.060000000029,10,10,572372.0,560567.94
31709,U17727,20,-15260.109999999999,15,5,29361.010000000006,14100.900000000007
31710,U25733,20,4504.3499999999985,12,8,141121.0,145625.35
31711,U801744,20,6612.4,8,12,99.6,6712.0
31712,U10020,20,633.1999999999998,14,6,6108.0,6741.2
31713,U29436,20,-4907.0,16,4,5091.0,184.0
31714,U22359,20,-2.1827872842550278e-11,13,7,131125.82,131125.81999999998
31715,U28364,20,-21079.07,17,3,52088.7,31009.629999999997
31716,U24687,20,1208.63,9,11,2368.21,3576.84
31717,U37914,20,-294.6,11,9,1358.2399999999998,1063.6399999999999
31718,U31024,20,-577.51,15,5,5334.840000000001,4757.330000000001
31719,U1100060,20,-1869.7400000000002,20,0,1869.7400000000002,0.0
31720,U42409,20,-928.1800000000003,16,4,4708.200000000001,3780.0200000000004
31721,U39131,20,2698.9300000000003,12,8,22027.7,24726.63
31722,U14890,20,-3089.6600000000035,11,9,25811.93,22722.269999999997
31723,U9109,20,8.039999999997235,14,6,13862.74,13870.779999999997
31724,U27364,20,905.3099999999976,12,8,306033.32,306938.63
31725,U37302,20,-100422.91,6,14,161918.74,61495.82999999999
31726,U32739,20,21597.6,13,7,5746.84,27344.44
31727,U19084,20,-2080.2200000000003,17,3,5493.15,3412.9299999999994
31728,U25387,20,50630.23000000001,13,7,37651.0,88281.23000000001
31729,U19606,20,-4950.11,17,3,8250.16,3300.05
31730,U37731,20,6878.76,11,9,9437.74,16316.5
31731,U11846,20,-399.58000000000175,7,13,24248.71,23849.129999999997
31732,U34161,20,-137.8000000000011,12,8,19906.739999999998,19768.939999999995
31733,U37197,20,6236.050000000005,13,7,53072.240000000005,59308.29000000001
31734,U15205,20,-13849.640000000003,14,6,36017.299999999996,22167.659999999993
31735,U32751,20,100.88999999999987,10,10,7914.0,8014.889999999999
31736,U17809,20,358.7199999999998,14,6,2405.24,2763.9599999999996
31737,U641396,20,-2418.55,16,4,9157.48,6738.929999999999
31738,U37993,20,35724.4,10,10,10786.0,46510.4
31739,U599681,20,-2092.3499999999995,16,4,7762.589999999999,5670.24
31740,U43431,20,-3770.4700000000003,15,5,13161.740000000002,9391.27
31741,U22471,20,-2872.7700000000004,8,12,36989.2,34116.42999999999
31742,U21990,20,-913.1499999999996,17,3,3957.5,3044.3500000000004
31743,U23589,20,61701.78,12,8,76310.26999999999,138012.05
31744,U36677,20,-31.19000000000087,9,11,17669.79,17638.6
31745,U40451,20,-86.92999999999992,13,7,13297.35,13210.42
31746,U13341,20,692.8599999998405,9,11,2251911.37,2252604.23
31747,U30053,20,3243.0600000000013,11,9,29468.260000000002,32711.320000000003
31748,U37790,20,8102.580000000001,12,8,16932.0,25034.58
31749,U40528,20,48.0,9,11,99716.18,99764.18
31750,U847231,20,-661.2600000000003,13,7,16526.33,15865.070000000002
31751,U16449,20,-64535.389999999985,16,4,200390.33,135854.94
31752,U43898,20,1660.04,12,8,15643.859999999999,17303.899999999998
31753,U37743,20,21517.75,13,7,27808.86,49326.61
31754,U20477,20,10727.789999999997,10,10,338460.1,349187.88999999996
31755,U24682,20,-5476.7,12,8,204872.58000000002,199395.88
31756,U18077,20,365.17999999999995,17,3,1512.8,1877.98
31757,U23332,20,6350.000000000004,10,10,170890.73,177240.73
31758,U22934,20,-18759.449999999997,13,7,67803.31,49043.86
31759,U12238,20,-1111.02,11,9,7916.23,6805.209999999999
31760,U24091,20,-1328.3300000000017,15,5,486497.0,485168.67
31761,U42665,20,-7508.950000000001,9,11,12499.56,4990.609999999999
31762,U30174,20,1600.1000000000004,11,9,5894.5,7494.6
31763,U35103,20,-454.34999999999997,16,4,750.45,296.1000000000001
31764,U31609,20,-111840.34000000004,13,7,561548.06,449707.72000000003
31765,U12737,20,-137.1499999999999,19,1,4392.74,4255.59
31766,U35758,20,-1681.9399999999996,14,6,5717.12,4035.1800000000003
31767,U32495,20,-10489.68,11,9,27764.0,17274.32
31768,U25160,20,398.3000000000029,9,11,51547.719999999994,51946.02
31769,U26599,20,-26070.58,14,6,48862.31,22791.729999999996
31770,U19076,20,-3530.1699999999983,11,9,32793.78,29263.61
31771,U32438,20,2933.26,15,5,10303.79,13237.050000000001
31772,U25396,20,6977.829999999999,12,8,10190.3,17168.129999999997
31773,U39311,20,35441.93,10,10,10149.08,45591.01
31774,U18048,20,3431.4400000000005,13,7,11613.470000000001,15044.910000000002
31775,U13821,20,-7537.739999999991,7,13,1020254.7000000001,1012716.9600000001
31776,U23264,20,-23.919999999998254,10,10,24401.6,24377.68
31777,U12328,20,-28554.750000000004,13,7,124508.23000000001,95953.48000000001
31778,U29944,20,4746.630000000001,14,6,16008.49,20755.120000000003
31779,U36360,20,5390.59,11,9,6125.0,11515.59
31780,U18289,20,-31249.740000000005,11,9,102461.77,71212.03
31781,U19767,20,-2200.5899999999992,10,10,6621.98,4421.39
31782,U15349,20,-24852.2,15,5,31879.379999999997,7027.179999999997
31783,U26898,20,586.7700000000003,10,10,11485.849999999999,12072.619999999999
31784,U13449,20,259.81999999999994,13,7,13012.16,13271.98
31785,U41735,20,-70200.48,6,14,229745.08000000002,159544.60000000003
31786,U10699,20,804.4800000000005,12,8,15380.0,16184.48
31787,U8591,20,1108.01,12,8,5645.6,6753.610000000001
31788,U9456,20,19079.620000000017,9,11,1001400.1799999999,1020479.7999999999
31789,U34683,20,-12015.529999999999,10,10,30237.32,18221.79
31790,U32653,20,2614.2399999999907,12,8,219358.02000000002,221972.26
31791,U43099,20,-4220.510000000009,10,10,538802.32,534581.8099999999
31792,U670207,20,-2.6099999999997525,11,9,9887.329999999998,9884.719999999998
31793,U20908,20,-88432.61,12,8,189352.06,100919.45
31794,U40836,19,-5407.610000000001,15,4,11376.560000000001,5968.950000000001
31795,U21995,19,201.52000000000083,12,7,10693.449999999999,10894.97
31796,U1308402,19,-131.49,10,9,510.9,379.40999999999997
31797,U27607,19,0.9699999999997999,13,6,2951.73,2952.7
31798,U1282875,19,4128.0199999999995,13,6,3786.65,7914.67
31799,U18998,19,-1085.1599999999999,14,5,7053.82,5968.66
31800,U11546,19,185034.57000000004,8,11,222130.72,407165.29000000004
31801,U27624,19,-2660.6899999999987,12,7,34756.0,32095.31
31802,U42691,19,-656.8599999999999,17,2,2369.5,1712.64
31803,U36648,19,-3225.939999999974,7,12,710000.0,706774.06
31804,U35969,19,-45122.95,8,11,188985.25,143862.3
31805,U25170,19,992.0,14,5,46359.0,47351.0
31806,U39082,19,-1745.6500000000015,9,10,60570.35,58824.7
31807,U34727,19,-366.3,15,4,611.56,245.25999999999993
31808,U40235,19,-60569.82999999998,10,9,304044.95999999996,243475.12999999998
31809,U8838,19,1700.4900000000002,10,9,16000.0,17700.49
31810,U23112,19,2802.1699999999983,11,8,118672.89,121475.06
31811,U1381718,19,-31715.250000000004,17,2,31952.530000000002,237.27999999999884
31812,U26026,19,5861.590000000002,12,7,32729.559999999998,38591.15
31813,U20166,19,-10753.099999999999,14,5,62619.16,51866.060000000005
31814,U31710,19,-128.11000000000058,6,13,22782.0,22653.89
31815,U27380,19,-487.78000000000065,10,9,33045.0,32557.22
31816,U38231,19,-919.5100000000011,13,6,9117.76,8198.25
31817,U18676,19,-3365.22000000002,9,10,198719.75,195354.52999999997
31818,U8749,19,11789.130000000003,12,7,39610.99,51400.12
31819,U14879,19,-3909.0599999999995,10,9,18380.7,14471.640000000001
31820,U622667,19,0.09000000000000696,12,7,436.14,436.23
31821,U41248,19,-3556.3300000000017,10,9,64160.0,60603.67
31822,U21965,19,-1289.8400000000001,12,7,18629.85,17340.01
31823,U43433,19,-84136.31,15,4,95120.22,10983.910000000003
31824,U34214,19,15749.21,9,10,14280.0,30029.21
31825,U20994,19,-9225.13,13,6,23087.58,13862.450000000003
31826,U8594,19,15799.260000000006,12,7,99280.26,115079.52
31827,U1329548,19,0.8099999999994907,11,8,7499.27,7500.08
31828,U596466,19,1140.0600000000009,9,10,13958.64,15098.7
31829,U14885,19,-22982.769999999997,14,5,126480.0,103497.23000000001
31830,U25520,19,-1385.2500000000002,15,4,2370.14,984.8899999999996
31831,U23465,19,-8529.68,10,9,43395.579999999994,34865.899999999994
31832,U31642,19,15073.470000000003,12,7,367773.78,382847.25000000006
31833,U37882,19,174.84,14,5,57.53999999999999,232.38
31834,U985490,19,-852.9800000000002,12,7,3708.89,2855.91
31835,U23087,19,775040.13,8,11,144433.41,919473.54
31836,U25932,19,-437.2199999999989,13,6,50972.69,50535.47
31837,U38094,19,18282.910000000447,4,15,4542207.5,4560490.41
31838,U18368,19,827.7200000000012,9,10,65965.11,66792.83
31839,U39755,19,-486.1399999999994,12,7,111136.38,110650.24
31840,U32246,19,12962.769999999997,15,4,21570.3,34533.06999999999
31841,U26830,19,7109.260000000003,15,4,4520.12,11629.380000000003
31842,U33870,19,10260.939999999999,15,4,10360.96,20621.899999999998
31843,U42574,19,3142.729999999999,13,6,11734.36,14877.09
31844,U42667,19,-2771.8599999999997,11,8,5239.68,2467.8200000000006
31845,U20700,19,-200885.76,14,5,231961.61,31075.849999999977
31846,U20719,19,198.99999999999818,10,9,23695.71,23894.71
31847,U14057,19,24603.32,7,12,21100.0,45703.32
31848,U17986,19,66074.60999999999,10,9,17084.600000000002,83159.20999999999
31849,U1030295,19,1.019999999999996,10,9,107.17,108.19
31850,U9430,19,11851.650000000016,12,7,102347.08,114198.73000000001
31851,U35810,19,-1508.1299999999992,13,6,10509.470000000001,9001.340000000002
31852,U33392,19,908823.61,11,8,45812.64,954636.25
31853,U21448,19,1453.6100000000106,11,8,250005.5,251459.11000000002
31854,U14790,19,-2948.4400000000005,14,5,5274.51,2326.0699999999997
31855,U36361,19,-22706.7,11,8,107000.0,84293.3
31856,U19508,19,5404.689999999996,11,8,131088.04,136492.73
31857,U26112,19,1842.65,5,14,90956.0,92798.65
31858,U10689,19,-3335.8199999999943,11,8,80456.28,77120.46
31859,U42573,19,247.23999999999933,11,8,8249.3,8496.539999999999
31860,U760412,19,701.9999999999998,10,9,10981.41,11683.41
31861,U36620,19,10.699999999999818,13,6,2629.01,2639.71
31862,U44034,19,3634.5200000000004,13,6,5952.4,9586.92
31863,U19704,19,1436.3300000000022,13,6,60541.04000000001,61977.37000000001
31864,U1036976,19,-326.35,16,3,539.47,213.12
31865,U37719,19,-18314.18,15,4,21495.29,3181.1100000000006
31866,U11062,19,-16.48999999999819,10,9,49274.26000000001,49257.77000000001
31867,U8676,19,-3653.5400000000013,15,4,24656.760000000002,21003.22
31868,U22378,19,-40.30999999999999,15,4,252.5,212.19
31869,U35932,19,105843.80000000002,7,12,124035.0,229878.80000000002
31870,U10994,19,-456.20999999999185,11,8,185400.4,184944.19
31871,U15661,19,-14.789999999999992,14,5,377.8,363.01
31872,U648562,19,97288.09,11,8,9482.65,106770.73999999999
31873,U8625,19,-5499.59,15,4,25704.0,20204.41
31874,U1123860,19,4.560000000000005,11,8,1042.81,1047.37
31875,U21537,19,-3602.580000000001,11,8,14948.449999999999,11345.869999999999
31876,U11626,19,-28.16000000000122,4,15,86320.0,86291.84
31877,U1317634,19,271.93999999999994,11,8,1730.9499999999998,2002.8899999999999
31878,U9411,19,183467.58,8,11,202806.0,386273.57999999996
31879,U14881,19,-38657.14,14,5,41477.24,2820.0999999999985
31880,U30811,19,1548.4400000000003,12,7,22721.8,24270.239999999998
31881,U43168,19,-29183.869999999995,15,4,74244.6,45060.73000000001
31882,U774294,19,-303.84000000000015,12,7,27015.86,26712.02
31883,U18851,19,-399.05999999999995,17,2,1769.0600000000004,1370.0000000000005
31884,U9076,19,-16793.879999999997,13,6,35312.200000000004,18518.320000000007
31885,U13367,19,976.5900000000017,14,5,108602.38,109578.97
31886,U28237,19,9294.56,12,7,2722.31,12016.869999999999
31887,U27030,19,4092.8399999999974,9,10,28461.280000000002,32554.12
31888,U19695,19,-19854.5,7,12,227000.0,207145.5
31889,U41132,19,-1316.5299999999997,12,7,5019.54,3703.01
31890,U18659,19,-18049.549999999996,11,8,68713.12,50663.57
31891,U42135,19,-85961.41999999995,10,9,2037054.9,1951093.48
31892,U24750,19,2846.8700000000003,12,7,12193.53,15040.400000000001
31893,U32525,19,-3965.2600000000093,12,7,681064.29,677099.03
31894,U33858,19,19311.870000000003,10,9,22474.92,41786.79
31895,U19639,19,349.4400000000005,8,11,19347.0,19696.440000000002
31896,U21930,19,-154.8999999999982,9,10,132075.06999999998,131920.16999999998
31897,U17559,19,-5081.83,12,7,12106.04,7024.210000000001
31898,U29297,19,-14957.300000000001,15,4,31238.2,16280.9
31899,U13865,19,-768.8999999999996,14,5,42561.6,41792.7
31900,U785579,19,-0.8599999999999,14,5,2158.27,2157.41
31901,U1241327,19,-115.05999999999996,11,8,1089.22,974.1600000000001
31902,U16872,19,-780173.6300000001,8,11,1627476.0,847302.3699999999
31903,U11298,19,-10189.829999999998,11,8,34449.86,24260.030000000002
31904,U16037,19,273125.09,5,14,130309.0,403434.09
31905,U25522,19,-28893.729999999996,9,10,69463.0,40569.270000000004
31906,U16838,19,118847.01000000001,12,7,249480.6,368327.61
31907,U23833,19,-22765.040000000005,13,6,166210.24,143445.19999999998
31908,U30917,19,-1772.0200000000018,14,5,35371.09,33599.06999999999
31909,U1292472,19,-2026.4199999999996,14,5,3340.06,1313.6400000000003
31910,U15872,19,482.07000000000005,17,2,1518.99,2001.06
31911,U29230,19,9393.84,14,5,23594.68,32988.520000000004
31912,U16678,19,-24023.870000000006,9,10,152627.61,128603.73999999998
31913,U21500,19,2658.5400000000004,12,7,5410.080000000001,8068.620000000001
31914,U39486,19,472460.65,5,14,199000.0,671460.65
31915,U12355,19,-1035398.6400000001,12,7,1113518.8599999999,78120.21999999974
31916,U43894,19,579.5599999999997,13,6,6075.17,6654.73
31917,U21611,19,355.75999999998135,9,10,425042.47,425398.23
31918,U9641,19,-22660.7,17,2,30198.96,7538.259999999998
31919,U28030,19,-432.2899999999999,15,4,1459.61,1027.32
31920,U19988,19,-79.96000000000001,10,9,2977.22,2897.2599999999998
31921,U32757,19,1574.9800000000005,10,9,17155.34,18730.32
31922,U12249,19,2344.65,15,4,7257.339999999998,9601.989999999998
31923,U28039,19,-17553.000000000007,12,7,58961.600000000006,41408.6
31924,U1068817,19,444.19000000000096,12,7,16222.7,16666.890000000003
31925,U21804,19,4482.72,16,3,9012.01,13494.73
31926,U18555,19,-1496.99,17,2,1514.79,17.799999999999955
31927,U803049,19,-67.58000000000004,17,2,1767.5800000000002,1700.0
31928,U18698,19,20.089999999999975,10,9,1076.04,1096.1299999999999
31929,U24334,19,-1764.1100000000006,7,12,29271.5,27507.39
31930,U10337,19,31179.909999999993,7,12,617690.44,648870.35
31931,U40631,19,-2913.79,16,3,11746.0,8832.21
31932,U35133,19,-3836.060000000001,11,8,15054.769999999999,11218.709999999997
31933,U778430,19,-5279.05,15,4,6837.02,1557.9700000000003
31934,U1024586,19,202.70000000000002,14,5,661.34,864.0400000000001
31935,U32983,19,21523.89,11,8,14521.0,36044.89
31936,U12687,19,155.5,16,3,15627.08,15782.58
31937,U35829,19,5346.82,11,8,65230.0,70576.82
31938,U42990,19,-28999.38,14,5,119000.0,90000.62
31939,U1104223,19,6889.0,8,11,6906.4800000000005,13795.48
31940,U957801,19,18.800000000000068,8,11,2257.05,2275.8500000000004
31941,U625024,19,1052.8199999999997,9,10,4713.7,5766.5199999999995
31942,U585073,19,-749.3300000000002,9,10,8824.34,8075.01
31943,U25583,19,8122.580000000004,11,8,68416.49999999999,76539.07999999999
31944,U30639,19,90.84999999999998,15,4,1109.25,1200.1
31945,U16759,19,76111.73000000001,12,7,26705.350000000002,102817.08000000002
31946,U20500,19,-4900.45,16,3,8895.3,3994.8499999999995
31947,U42897,19,-6068.62,14,5,11760.2,5691.580000000001
31948,U38673,19,2677.1800000000003,9,10,12749.06,15426.24
31949,U882174,19,61.650000000000404,10,9,6533.5,6595.150000000001
31950,U28745,19,1003.369999999999,10,9,24000.0,25003.37
31951,U26173,19,-13303.43,14,5,14635.3,1331.869999999999
31952,U15380,19,-73646.06999999999,17,2,77010.48,3364.4100000000035
31953,U13438,19,-6106.0099999999975,11,8,43721.89,37615.880000000005
31954,U26185,19,-13645.16,15,4,15584.939999999999,1939.7799999999988
31955,U15382,19,-371971.09,6,13,483354.02,111382.93
31956,U11297,19,-16054.529999999999,14,5,37350.94,21296.410000000003
31957,U18502,19,4257.450000000001,15,4,6332.83,10590.28
31958,U28491,19,50634.28999999999,12,7,95941.17,146575.46
31959,U36109,19,-3123.6400000000003,12,7,18780.0,15656.36
31960,U11491,19,-15577.470000000001,14,5,70930.83,55353.36
31961,U35707,19,963.9599999999987,11,8,37379.0,38342.96
31962,U30893,19,6316.67,16,3,1904.6,8221.27
31963,U15686,19,6864.560000000056,9,10,1122000.0,1128864.56
31964,U19690,19,14168.64,11,8,40478.14,54646.78
31965,U578545,19,219.19999999999982,12,7,4315.3,4534.5
31966,U24480,19,-22070.52,9,10,141443.24,119372.71999999999
31967,U33422,19,3602.2700000000004,12,7,11456.4,15058.67
31968,U37553,19,-6375.23,14,5,37653.82,31278.59
31969,U34661,19,-9459.1,15,4,13249.3,3790.199999999999
31970,U38341,19,-17856.36,16,3,21941.38,4085.0200000000004
31971,U15551,19,1756.1799999999967,9,10,90178.08999999998,91934.26999999997
31972,U9931,19,-52322.47000000001,12,7,147396.37,95073.9
31973,U1385411,19,0.2400000000000091,14,5,1481.84,1482.08
31974,U28085,19,58.51000000000204,10,9,110150.0,110208.51000000001
31975,U17060,19,24199.899999999983,10,9,171687.19,195887.09
31976,U33404,19,-6220.0599999999995,12,7,27090.36,20870.300000000003
31977,U9805,19,-423.50000000000045,9,10,101270.4,100846.9
31978,U735929,19,14.39999999999992,10,9,1684.8000000000002,1699.2
31979,U35005,19,-3585.7300000000005,9,10,47666.0,44080.27
31980,U20834,19,1017.0699999999999,14,5,4182.679999999999,5199.749999999999
31981,U17024,19,12748.809999999998,13,6,29949.83,42698.64
31982,U41869,19,-1977.0099999998238,6,13,26382599.0,26380621.99
31983,U30791,19,1340.4999999999936,8,11,76455.0,77795.5
31984,U40749,19,15386.74,11,8,18363.059999999998,33749.799999999996
31985,U39449,19,5590.409999999998,15,4,16675.47,22265.879999999997
31986,U34565,19,-2208.9699999999966,10,9,66112.43,63903.46
31987,U32975,19,224.9400000000021,13,6,26760.489999999998,26985.43
31988,U44016,19,873.7599999999995,10,9,20419.5,21293.26
31989,U37244,19,3315.5,11,8,16627.700000000004,19943.200000000004
31990,U1097624,19,402.00000000000006,13,6,2300.07,2702.07
31991,U27753,19,-40452.22,8,11,132055.15,91602.93
31992,U41490,19,-9798.870000000003,15,4,44809.35,35010.479999999996
31993,U38654,19,-8207.92,16,3,8352.380000000001,144.46000000000095
31994,U27768,19,8070.710000000001,6,13,13698.59,21769.300000000003
31995,U1122142,19,0.1799999999998363,14,5,2739.8099999999995,2739.9899999999993
31996,U43838,19,22837.95,14,5,43882.98,66720.93000000001
31997,U25748,19,23237.409999999938,8,11,847506.96,870744.3699999999
31998,U1150983,19,7.490000000002283,13,6,21527.070000000003,21534.560000000005
31999,U38780,19,-14159.579999999996,14,5,31574.5,17414.920000000006
32000,U39660,19,1539.5400000000002,13,6,5666.400000000001,7205.9400000000005
32001,U1226506,19,650.9099999999988,14,5,22667.46,23318.37
32002,U22871,19,4493.949999999999,13,6,9255.099999999999,13749.049999999997
32003,U969605,19,-48.92999999999854,15,4,15907.019999999999,15858.09
32004,U1138259,19,-621.6599999999999,16,3,4158.66,3537.0
32005,U37081,19,54581.42,11,8,26380.0,80961.42
32006,U1348658,19,-5384.94,17,2,5532.96,148.02000000000044
32007,U8777,19,-261.78000000000065,13,6,26638.18,26376.4
32008,U28117,19,-1348.4599999999996,14,5,13664.000000000002,12315.540000000003
32009,U18480,19,14.199999999982538,10,9,225155.0,225169.19999999998
32010,U13225,19,781.5200000000077,11,8,111922.4,112703.92
32011,U35715,19,5573.079999999997,9,10,148840.0,154413.08
32012,U37777,19,-22254.230000000003,15,4,24603.520000000004,2349.290000000001
32013,U37990,19,2380.33,16,3,3219.67,5600.0
32014,U12912,19,-139273.40000000002,5,14,430000.0,290726.6
32015,U19797,19,1025.5800000000002,13,6,7080.0,8105.58
32016,U1214712,19,-661.52,13,6,840.1399999999999,178.6199999999999
32017,U41295,19,-615.0799999999999,13,6,3131.2,2516.12
32018,U18379,19,1369.5,9,10,24961.27,26330.77
32019,U14189,19,138192.5300000001,3,16,1384900.0,1523092.53
32020,U34641,19,3504.0200000000004,13,6,13870.03,17374.050000000003
32021,U34140,19,-115364.12,12,7,124056.01,8691.89
32022,U1091972,19,-2.700000000000017,10,9,379.49,376.78999999999996
32023,U11958,19,-3769.0600000000013,12,7,50440.0,46670.94
32024,U900339,19,-473.1699999999999,13,6,1627.42,1154.2500000000002
32025,U37521,19,-751.0699999999997,10,9,22955.95,22204.88
32026,U15933,19,-52681.76,15,4,62286.65,9604.89
32027,U8980,19,-1917.7000000000007,17,2,5477.55,3559.8499999999995
32028,U26630,19,-25479.190000000002,15,4,36525.34,11046.149999999994
32029,U18636,19,-22897.629999999997,10,9,161072.08000000002,138174.45
32030,U40916,19,-13397.729999999996,10,9,65103.0,51705.270000000004
32031,U21236,19,2632.420000000001,14,5,8502.83,11135.25
32032,U43594,19,-3502.9600000000028,9,10,71185.77,67682.81
32033,U32176,19,4845.599999999999,9,10,16141.619999999999,20987.219999999998
32034,U26428,19,124964.88000000002,3,16,500000.0,624964.88
32035,U36635,19,6532.779999999999,14,5,19229.0,25761.78
32036,U33345,19,-571.9899999999993,16,3,6377.779999999999,5805.789999999999
32037,U30772,19,-2497.21,15,4,13365.75,10868.54
32038,U34520,19,-7836.420000000002,13,6,62838.149999999994,55001.729999999996
32039,U670996,19,106.0,11,8,3985.01,4091.01
32040,U24954,19,140157.22,13,6,354872.12,495029.33999999997
32041,U9761,19,-10891.32000000001,13,6,114880.18,103988.85999999999
32042,U29268,19,-1148.2600000000002,15,4,11063.4,9915.14
32043,U22699,19,21024.22,8,11,40749.0,61773.22
32044,U43047,19,-47774.45,11,8,55396.75,7622.300000000003
32045,U42227,19,-306.39000000000044,13,6,7390.990000000001,7084.6
32046,U21675,19,-37348.29,18,1,37387.53,39.23999999999796
32047,U32034,19,-155801.35,11,8,163892.0,8090.649999999994
32048,U30017,19,-653.3000000000001,17,2,1653.3000000000002,1000.0000000000001
32049,U40927,19,-8224.92,14,5,36074.3,27849.380000000005
32050,U961927,19,-277.77999999999975,8,11,8920.95,8643.170000000002
32051,U37704,19,50085.0,9,10,35778.0,85863.0
32052,U716636,19,881.94,4,15,105.0,986.94
32053,U16421,19,3934.41,9,10,12958.04,16892.45
32054,U9070,19,459.6899999999987,10,9,60690.979999999996,61150.67
32055,U680127,19,611.5399999999997,16,3,4770.61,5382.15
32056,U23096,19,-593.8799999999992,15,4,11809.8,11215.92
32057,U38273,19,-3793.800000000001,13,6,22420.7,18626.9
32058,U40862,19,62354.36000000001,8,11,67932.57999999999,130286.94
32059,U1137078,19,767.0,9,10,4205.0,4972.0
32060,U661586,19,9493.28,12,7,2737.15,12230.43
32061,U21893,19,374022.1,10,9,1978.25,376000.35
32062,U16429,19,53.49000000000611,10,9,167479.0,167532.49000000002
32063,U15250,19,29317.77,5,14,17522.09,46839.86
32064,U43153,19,-6901.0,11,8,37542.0,30641.0
32065,U10417,19,-581.69,12,7,18461.76,17880.07
32066,U31462,19,-39695.920000000006,9,10,113252.45,73556.53
32067,U33103,19,1531.2999999999956,10,9,245917.37,247448.66999999998
32068,U22326,19,-839.99,15,4,21489.49,20649.5
32069,U29504,19,-9479.300000000008,12,7,172350.79,162871.49
32070,U35647,19,1229.78,10,9,5752.0199999999995,6981.799999999999
32071,U19594,19,-55.86999999999989,13,6,3627.47,3571.6
32072,U29278,19,7803.86,9,10,16593.98,24397.84
32073,U28156,19,-28882.05000000001,12,7,102282.25,73400.19999999998
32074,U36332,19,-1228.79,16,3,6551.21,5322.42
32075,U33341,19,-13427.349999999999,12,7,26653.19,13225.84
32076,U26547,19,327.4400000000005,11,8,29022.35,29349.79
32077,U42741,19,4526.150000000004,9,10,491440.62999999995,495966.77999999997
32078,U28060,19,-1210.8999999999996,14,5,8028.0,6817.1
32079,U35560,19,-18865.85,14,5,37960.9,19095.050000000003
32080,U15126,19,97472.22,4,15,2060.0,99532.22
32081,U23684,19,-14817.6,16,3,14935.08,117.47999999999956
32082,U1273319,19,-4266.93,11,8,19137.98,14871.05
32083,U43035,19,31840.4,15,4,826.0,32666.4
32084,U42681,19,8799.740000000002,8,11,53438.1,62237.84
32085,U1245886,19,-1325.13,13,6,3420.6699999999996,2095.5399999999995
32086,U20281,19,-12261.29,14,5,17365.09,5103.799999999999
32087,U34000,19,-546.3799999999972,11,8,50892.32,50345.94
32088,U41907,19,11708.579999999998,13,6,23089.29,34797.869999999995
32089,U28054,19,35487.68000000001,9,10,87342.15,122829.83
32090,U9218,19,-267.17,14,5,868.3499999999999,601.1799999999998
32091,U9971,19,343548.25,10,9,756207.65,1099755.9
32092,U1255923,19,282.8200000000006,10,9,27024.0,27306.82
32093,U42699,19,4722.890000000001,14,5,3554.3499999999995,8277.240000000002
32094,U40944,19,-80.88000000000011,14,5,13243.589999999998,13162.71
32095,U17881,19,6568.08,14,5,2076.26,8644.34
32096,U30348,19,1618.7600000000011,15,4,15728.779999999999,17347.54
32097,U23702,19,-47.38999999999396,10,9,96803.0,96755.61
32098,U33690,19,593.4000000000001,15,4,13033.380000000001,13626.78
32099,U30777,19,21213.18,13,6,40393.08,61606.26
32100,U22364,19,-29423.620000000003,11,8,140251.8,110828.18
32101,U29848,19,-8183.93,14,5,39464.01,31280.08
32102,U37473,19,2674.9599999999996,11,8,2949.05,5624.01
32103,U29205,19,7725.509999999997,10,9,258121.83,265847.33999999997
32104,U15908,19,76.38000000000102,6,13,66237.96,66314.34000000001
32105,U39184,19,55454.0999999999,8,11,1183000.0,1238454.0999999999
32106,U1116651,19,0.0,10,9,1105.6599999999999,1105.6599999999999
32107,U36636,19,45399.950000000004,13,6,16876.350000000002,62276.3
32108,U41906,19,-98105.53,12,7,136563.15,38457.619999999995
32109,U42652,19,-919068.03,16,3,937341.6100000001,18273.580000000075
32110,U13788,19,2216.7700000000004,14,5,16076.980000000003,18293.750000000004
32111,U36754,19,-116344.67,11,8,127527.56,11182.89
32112,U703216,19,-1454.6000000000001,13,6,4164.719999999999,2710.119999999999
32113,U16535,19,-4529.740000000002,12,7,18679.610000000004,14149.870000000003
32114,U12590,19,-3942.1800000000003,10,9,17266.68,13324.5
32115,U9791,19,-9948.409999999993,15,4,42338.51000000001,32390.100000000017
32116,U41413,19,27.889999999999997,4,15,12.0,39.89
32117,U14432,19,-20606.42,14,5,24358.85,3752.4300000000003
32118,U9690,19,2464.9400000000023,13,6,21873.81,24338.750000000004
32119,U41282,19,-394497.23,13,6,406363.53,11866.300000000047
32120,U41563,19,5499.750000000001,14,5,5197.799999999999,10697.55
32121,U39354,19,66497.57999999997,3,16,13048.12,79545.69999999997
32122,U9175,19,37211.87,9,10,5910.12,43121.990000000005
32123,U35591,19,-11251.450000000004,12,7,87241.8,75990.35
32124,U40507,19,9803.7,9,10,23115.0,32918.7
32125,U17499,19,-2191.320000000014,10,9,132818.32,130627.0
32126,U33184,19,2379.1900000000005,12,7,12265.01,14644.2
32127,U38764,19,142702.42000000004,6,13,384986.64999999997,527689.0700000001
32128,U22546,19,-0.4599999999991269,8,11,33045.59,33045.13
32129,U1359784,19,47.95000000000002,10,9,635.29,683.24
32130,U21515,19,-635.869999999999,12,7,23637.0,23001.13
32131,U39727,19,34842.009999999995,1,18,1398.0,36240.009999999995
32132,U11353,19,499.6699999999995,12,7,20379.869999999995,20879.539999999994
32133,U12371,19,182.66000000000057,13,6,4701.289999999998,4883.949999999999
32134,U10535,19,-468.07,19,0,468.07,0.0
32135,U1215262,19,-1481.98,16,3,1488.8900000000003,6.910000000000309
32136,U12769,19,-2843.8,11,8,10040.599999999999,7196.799999999998
32137,U8533,19,-17352.129999999997,18,1,17376.66,24.530000000002474
32138,U1140998,19,-0.7300000000005404,11,8,2810.88,2810.1499999999996
32139,U1270542,19,499.33,9,10,832.03,1331.36
32140,U21063,19,-33.279999999999745,14,5,15201.46,15168.18
32141,U39387,19,-171648.78,7,12,349000.0,177351.22
32142,U34381,19,1350.7299999999996,12,7,62344.8,63695.53
32143,U39964,19,62937.199999999975,7,12,623603.4,686540.6
32144,U40162,19,-73320.01000000001,8,11,105383.91,32063.899999999994
32145,U40870,19,-846.0699999999999,12,7,2386.83,1540.76
32146,U948452,19,-98.65000000000009,14,5,4796.74,4698.09
32147,U30609,19,-40335.900000000016,13,6,85809.51000000001,45473.60999999999
32148,U1050817,19,-1102.8,19,0,1102.8,0.0
32149,U990469,19,-0.040000000000190994,13,6,9563.039999999999,9562.999999999998
32150,U32232,19,6195.319999999997,10,9,41687.25,47882.57
32151,U19426,19,-787.0200000000011,15,4,13182.07,12395.05
32152,U21097,19,16284.679999999997,13,6,17734.030000000002,34018.71
32153,U12797,19,-1669.75,15,4,3219.8100000000004,1550.0600000000004
32154,U30756,19,139496.46,10,9,128715.3,268211.76
32155,U16278,19,13526.08,9,10,12132.0,25658.08
32156,U24783,18,-368.31000000000006,14,4,1241.6300000000003,873.3200000000003
32157,U1058824,18,-62.94999999999982,9,9,9519.96,9457.009999999998
32158,U22739,18,6348.240000000003,10,8,6816.610000000001,13164.850000000004
32159,U23072,18,-75609.08,9,9,434697.75,359088.67
32160,U24906,18,3470.1,12,6,58230.0,61700.1
32161,U17524,18,241.8000000000029,9,9,71071.15999999999,71312.95999999999
32162,U10772,18,-5401.759999999999,13,5,17837.47,12435.710000000003
32163,U30372,18,-1852.7799999999115,12,6,552854.45,551001.67
32164,U1210108,18,157.6400000000001,11,7,2260.55,2418.1900000000005
32165,U14478,18,-11057.369999999999,16,2,11280.0,222.63000000000102
32166,U36821,18,186903.15,7,11,27204.0,214107.15
32167,U34078,18,6369.0799999999945,12,6,34312.0,40681.079999999994
32168,U11248,18,130509.44,11,7,70092.0,200601.44
32169,U43585,18,-3727.4399999999996,14,4,9175.46,5448.0199999999995
32170,U30732,18,770.5900000000001,11,7,10809.2,11579.79
32171,U902026,18,-2603.1400000000003,11,7,3654.64,1051.4999999999995
32172,U41442,18,-115.79,9,9,129990.0,129874.21
32173,U13167,18,26546.440000000002,11,7,14006.0,40552.44
32174,U897002,18,0.6700000000000728,11,7,3759.0,3759.67
32175,U8622,18,4287.5,13,5,1263.9,5551.4
32176,U11109,18,3223.690000000002,13,5,11520.48,14744.170000000002
32177,U1097935,18,-0.9399999999999977,12,6,450.66,449.72
32178,U10812,18,-12607.82,14,4,62702.829999999994,50095.009999999995
32179,U680376,18,-7689.860000000001,14,4,18396.170000000002,10706.310000000001
32180,U25332,18,10789.680000000002,3,15,5990.99,16780.670000000002
32181,U36319,18,-43554.65999999999,9,9,217004.89,173450.23000000004
32182,U10425,18,-9074.209999999992,8,10,95606.39,86532.18000000001
32183,U27751,18,-4014.5899999999965,8,10,114160.88,110146.29000000001
32184,U9468,18,8076.239999999991,9,9,244096.24,252172.47999999998
32185,U802072,18,0.0,9,9,3651.0,3651.0
32186,U23239,18,804.3900000000001,12,6,5729.7300000000005,6534.120000000001
32187,U31796,18,-49623.20000000001,9,9,262358.04000000004,212734.84000000003
32188,U20081,18,879.9699999999996,14,4,7548.100000000001,8428.070000000002
32189,U41495,18,-1454.609999999986,8,10,166511.0,165056.39
32190,U20257,18,-9894.74,13,5,14418.42,4523.68
32191,U818738,18,-2016.9700000000003,15,3,2531.7200000000003,514.75
32192,U26427,18,301.1900000000023,12,6,100930.68,101231.87
32193,U21862,18,449.7099999999996,10,8,6331.94,6781.65
32194,U1065741,18,-713.5999999999999,14,4,1874.6,1161.0
32195,U34092,18,-1942.5900000000008,9,9,18154.59,16212.0
32196,U23143,18,-34401.579999999994,15,3,34473.18,71.60000000000582
32197,U18139,18,4047.9600000000005,9,9,5275.29,9323.25
32198,U30242,18,32450.539999999997,6,12,70236.45999999999,102686.99999999999
32199,U28329,18,-6259.85,11,7,33691.87,27432.020000000004
32200,U13237,18,-4977.840000000004,11,7,48615.07,43637.229999999996
32201,U23822,18,20993.81,3,15,858.75,21852.56
32202,U802293,18,303.32999999999885,9,9,10707.8,11011.129999999997
32203,U19962,18,211.52000000001135,9,9,487367.89999999997,487579.42
32204,U17801,18,1886.8500000000008,10,8,8551.85,10438.7
32205,U25807,18,4862.55,14,4,451.05999999999995,5313.610000000001
32206,U39135,18,194993.52,9,9,402.7,195396.22
32207,U828612,18,120.5,10,8,8630.0,8750.5
32208,U39213,18,-4897.690000000002,9,9,129700.0,124802.31
32209,U43574,18,97570.76,8,10,110794.26,208365.02
32210,U27615,18,-4113.8099999999995,13,5,6147.04,2033.2300000000005
32211,U19532,18,6.149999999999864,10,8,3054.16,3060.3099999999995
32212,U37172,18,5059.580000000021,5,13,410500.0,415559.58
32213,U30195,18,-75.5,12,6,7241.0599999999995,7165.5599999999995
32214,U23645,18,-11999.720000000001,14,4,83825.5,71825.78
32215,U35235,18,-15087.47999999997,5,13,500797.16000000003,485709.68000000005
32216,U36819,18,-115.61000000000011,10,8,23040.0,22924.39
32217,U39977,18,1611.5299999999977,10,8,37943.759999999995,39555.28999999999
32218,U19442,18,-23367.199999999997,9,9,94875.52,71508.32
32219,U29103,18,9650.179999999993,8,10,73859.12,83509.29999999999
32220,U29542,18,-1235.9599999999264,10,8,1725986.6500000001,1724750.6900000002
32221,U17591,18,-116.1499999999998,14,4,10321.31,10205.16
32222,U32119,18,29561.49,12,6,22611.83,52173.32000000001
32223,U11424,18,11246.239999999996,10,8,8655.5,19901.739999999998
32224,U1042174,18,-312.4,11,7,952.4200000000001,640.0200000000001
32225,U17526,18,-1005.3899999999999,15,3,9006.78,8001.390000000001
32226,U18684,18,-21475.920000000002,12,6,26579.280000000002,5103.360000000001
32227,U13491,18,-1909.5400000000034,13,5,104447.45999999999,102537.91999999998
32228,U21516,18,-27725.169999999955,6,12,824106.27,796381.1000000001
32229,U43365,18,-1116.8899999999999,12,6,13416.26,12299.37
32230,U39941,18,-36638.25999999991,7,11,1408976.46,1372338.2
32231,U13576,18,-310.32000000000005,14,4,717.96,407.64
32232,U29722,18,42505.770000000004,14,4,60329.56,102835.33
32233,U35018,18,-4951.219999999999,12,6,62471.26,57520.04
32234,U12352,18,50944.47,11,7,118065.69,169010.16
32235,U19865,18,-10634.239999999998,14,4,50655.869999999995,40021.63
32236,U24593,18,-39927.24000000001,11,7,207760.50999999998,167833.26999999996
32237,U1348271,18,657.09,9,9,5201.93,5859.02
32238,U19878,18,86314.09999999999,12,6,184383.96000000002,270698.06
32239,U36025,18,87.63000000000011,10,8,15521.02,15608.650000000001
32240,U15990,18,-6302.610000000001,11,7,111077.98,104775.37
32241,U32572,18,3775.57,12,6,6704.85,10480.42
32242,U33888,18,4950.24,11,7,19465.7,24415.940000000002
32243,U11449,18,-16840.59,9,9,76750.0,59909.41
32244,U30725,18,-3616.93,14,4,3861.63,244.70000000000027
32245,U1062017,18,-536.8999999999999,10,8,1169.9999999999998,633.0999999999999
32246,U40248,18,781.48,11,7,6089.0,6870.48
32247,U1094613,18,7124.63,16,2,2281.37,9406.0
32248,U9418,18,-6998.129999999999,7,11,342000.0,335001.87
32249,U28152,18,-11348.74,11,7,14453.9,3105.16
32250,U18403,18,11334.56,12,6,18000.470000000005,29335.030000000006
32251,U743536,18,1461.8999999999996,11,7,18005.54,19467.440000000002
32252,U43027,18,2093.93,10,8,9466.619999999999,11560.55
32253,U32985,18,-4756.810000000012,11,7,280740.19,275983.38
32254,U11881,18,106.53999999999999,13,5,9993.98,10100.52
32255,U1275044,18,3449.31,12,6,1554.33,5003.639999999999
32256,U10450,18,7333.860000000001,11,7,40115.509999999995,47449.369999999995
32257,U809611,18,0.0999999999999659,11,7,748.03,748.1299999999999
32258,U18819,18,31669.870000000006,11,7,76554.73999999999,108224.61
32259,U38544,18,-942.89,11,7,9552.93,8610.04
32260,U1137295,18,-23.2800000000002,11,7,11702.17,11678.89
32261,U37037,18,-6227.25,12,6,10656.43,4429.18
32262,U39212,18,3502.989999999998,5,13,95000.0,98502.98999999999
32263,U1191334,18,13.439999999999984,11,7,578.14,591.5799999999999
32264,U35775,18,50018.25,7,11,22634.0,72652.25
32265,U10664,18,1006.9600000000003,10,8,4175.29,5182.25
32266,U18657,18,15060.630000000001,6,12,11733.0,26793.63
32267,U21735,18,-744.17,13,5,2814.4100000000008,2070.2400000000007
32268,U20610,18,-293.7400000000001,11,7,10895.65,10601.91
32269,U30096,18,-7095.779999999999,13,5,37593.8,30498.020000000004
32270,U16746,18,-101444.24,11,7,151464.74,50020.499999999985
32271,U8885,18,17904.829999999998,10,8,14672.59,32577.42
32272,U43997,18,-499.5799999999981,15,3,20500.37,20000.79
32273,U15403,18,11658.05,9,9,25569.0,37227.05
32274,U41075,18,-14528.690000000002,13,5,59162.5,44633.81
32275,U30239,18,5691.089999999999,8,10,16141.1,21832.19
32276,U22619,18,70042.68000000001,10,8,70775.99,140818.67
32277,U20102,18,-97.58999999999986,12,6,10803.79,10706.2
32278,U43513,18,4325.459999999992,7,11,102031.0,106356.45999999999
32279,U40409,18,-39146.9,14,4,39246.64,99.73999999999796
32280,U31410,18,-160.4499999999989,11,7,18760.85,18600.4
32281,U26768,18,-6003.0,3,15,6140.0,137.0
32282,U40936,18,9692.400000000001,8,10,74774.79999999999,84467.19999999998
32283,U954760,18,4500.0,6,12,4500.0,9000.0
32284,U578363,18,-5812.790000000001,14,4,6812.84,1000.0499999999993
32285,U676443,18,-1975.9400000000005,15,3,2076.0000000000005,100.05999999999995
32286,U8064,18,57703.710000000014,9,9,112386.06,170089.77000000002
32287,U24387,18,8829.54,12,6,15770.48,24600.02
32288,U29161,18,-37310.45,7,11,81000.0,43689.55
32289,U25846,18,18.17999999999666,11,7,47081.8,47099.98
32290,U22187,18,-88.48000000000131,12,6,50190.37,50101.89
32291,U21131,18,97526.1,12,6,111800.0,209326.1
32292,U34831,18,22673.340000000004,12,6,24253.730000000003,46927.07000000001
32293,U41541,18,-132799.1,12,6,182511.52000000002,49712.42000000001
32294,U623504,18,-1763.8400000000001,11,7,19714.2,17950.36
32295,U11652,18,-824.8899999999985,11,7,73931.5,73106.61
32296,U14100,18,-1541.9000000000024,12,6,25410.0,23868.1
32297,U25220,18,-964.9,15,3,91322.75000000001,90357.85000000002
32298,U24006,18,125.30999999999973,11,7,4107.7,4233.009999999999
32299,U13919,18,10128.76,9,9,6392.98,16521.739999999998
32300,U31503,18,-4719.460000000001,9,9,177419.59999999998,172700.13999999998
32301,U1158631,18,-3331.05,14,4,20644.44,17313.39
32302,U37183,18,18871.909999999996,14,4,6217.14,25089.049999999996
32303,U35642,18,13257.23,11,7,33256.0,46513.229999999996
32304,U36923,18,-579.4900000000016,12,6,17760.0,17180.51
32305,U27150,18,-127957.78000000003,5,13,795183.9199999999,667226.1399999999
32306,U18059,18,-782.8300000000002,14,4,4563.41,3780.58
32307,U21110,18,14495.46,9,9,28913.8,43409.259999999995
32308,U41505,18,11528.37,11,7,5189.92,16718.29
32309,U22116,18,-11652.719999999996,11,7,111663.70000000001,100010.98000000001
32310,U19029,18,-1286.3800000000003,10,8,5164.07,3877.6899999999996
32311,U41435,18,0.0,15,3,330.0,330.0
32312,U36577,18,-2710.739999999998,10,8,63794.42,61083.68
32313,U1036659,18,-397.25,11,7,5561.9400000000005,5164.6900000000005
32314,U34664,18,1602.3299999999958,13,5,33594.87,35197.2
32315,U22770,18,14758.87,10,8,12813.609999999999,27572.48
32316,U24990,18,93.75,10,8,125003.0,125096.75
32317,U21177,18,3543.5699999999997,11,7,34625.0,38168.57
32318,U44035,18,-3451.8599999999997,12,6,8754.0,5302.14
32319,U13620,18,-110309.85999999999,8,10,1360851.78,1250541.92
32320,U37404,18,-14795.45,10,8,30506.920000000006,15711.470000000005
32321,U42852,18,-21.80000000000291,10,8,61598.310000000005,61576.51
32322,U22369,18,1779.9999999999995,12,6,10093.74,11873.74
32323,U17449,18,1011.9200000000001,12,6,36975.600000000006,37987.520000000004
32324,U18765,18,3284.3300000000027,9,9,57853.81,61138.14
32325,U1194443,18,15808.249999999998,9,9,7120.51,22928.76
32326,U24191,18,9118.870000000055,11,7,2320020.0,2329138.87
32327,U23808,18,8562.139999999998,11,7,20066.07,28628.21
32328,U32680,18,-55.70000000000073,12,6,31032.699999999997,30976.999999999996
32329,U34251,18,7464.749999999998,7,11,113585.66,121050.41
32330,U1157943,18,53690.71,12,6,8000.6,61691.31
32331,U13144,18,-2422.3899999999994,14,4,11826.2,9403.810000000001
32332,U32157,18,488.88000000000176,5,13,25071.64,25560.52
32333,U40594,18,29.319999999999943,11,7,3948.07,3977.3900000000003
32334,U43697,18,0.010000000001673495,11,7,19821.36,19821.370000000003
32335,U33066,18,3384.21,12,6,5300.0,8684.21
32336,U33842,18,-2129.09,9,9,28286.0,26156.91
32337,U38472,18,162.16000000000008,14,4,996.3699999999999,1158.53
32338,U1370547,18,-2.6599999999998545,10,8,6730.02,6727.360000000001
32339,U1091815,18,-632.96,11,7,4069.0,3436.04
32340,U19786,18,7963.7,12,6,5335.93,13299.630000000001
32341,U1237398,18,-2904.6099999999997,14,4,2907.62,3.0100000000002183
32342,U41279,18,6067.710000000002,11,7,13657.49,19725.2
32343,U42072,18,41486.82,8,10,3723.7599999999998,45210.58
32344,U34671,18,-4056.34,14,4,13400.2,9343.86
32345,U10724,18,-43380.96,8,10,257820.99,214440.03
32346,U34057,18,50368.52,13,5,11611.48,61980.0
32347,U9312,18,-26371.660000000003,14,4,36795.93000000001,10424.270000000004
32348,U642685,18,-954.9899999999998,11,7,14069.5,13114.51
32349,U863274,18,-0.8800000000001091,9,9,2677.37,2676.49
32350,U22712,18,-1504.0699999999997,13,5,28451.41,26947.34
32351,U34194,18,10654.76,9,9,6031.67,16686.43
32352,U14399,18,-12730.19,13,5,18209.08,5478.890000000001
32353,U33315,18,573.2399999999985,6,12,52497.899999999994,53071.13999999999
32354,U599774,18,-1155.76,18,0,1155.76,0.0
32355,U26574,18,-749.7099999999999,15,3,3049.75,2300.04
32356,U29422,18,-400380.67000000004,15,3,403609.83,3229.1599999999744
32357,U18158,18,4457.040000000008,6,12,580019.9,584476.9400000001
32358,U35981,18,5646.24,13,5,506.15000000000003,6152.389999999999
32359,U40791,18,5033.9,10,8,8216.0,13249.9
32360,U41896,18,-99.90999999999997,15,3,1264.1599999999999,1164.25
32361,U42353,18,-15721.310000000001,14,4,18417.75,2696.4399999999987
32362,U37949,18,-7325.780000000001,11,7,20938.01,13612.229999999998
32363,U27539,18,-139.76999999999998,15,3,558.02,418.25
32364,U41419,18,-930.3599999999999,15,3,1197.8700000000001,267.5100000000002
32365,U36507,18,203627.99,9,9,154483.76,358111.75
32366,U31853,18,6471.13,10,8,8947.6,15418.73
32367,U36302,18,-1189.3300000000002,12,6,3049.7100000000005,1860.3800000000003
32368,U28482,18,-313.1899999999999,15,3,5714.320000000001,5401.130000000001
32369,U15135,18,-14584.08,12,6,42766.85,28182.769999999997
32370,U25195,18,-29056.379999999997,11,7,88658.4,59602.02
32371,U26371,18,10919.88,12,6,6595.0,17514.879999999997
32372,U15053,18,1190.2800000000002,7,11,87982.07999999999,89172.35999999999
32373,U16915,18,109399.65000000059,8,10,8670281.0,8779680.65
32374,U9416,18,8020.09,11,7,16041.41,24061.5
32375,U39770,18,-3743.2799999999997,13,5,7983.91,4240.63
32376,U39748,18,32.75000000000003,16,2,287.25000000000006,320.0000000000001
32377,U16703,18,24541.190000000195,8,10,1317346.2999999998,1341887.49
32378,U1216694,18,-970.4199999999998,14,4,10547.419999999998,9576.999999999998
32379,U10436,18,-3004.3299999999977,14,4,58313.02,55308.69
32380,U37656,18,96451.70999999999,14,4,30342.05,126793.76
32381,U1311626,18,-3449.99,17,1,4949.99,1500.0
32382,U17649,18,-4707.92,9,9,20636.22,15928.300000000001
32383,U12640,18,161959.83,8,10,54357.4,216317.22999999998
32384,U17291,18,302.130000000001,12,6,19727.76,20029.89
32385,U24729,18,-29726.32,11,7,332511.56,302785.24
32386,U24251,18,19354.899999999998,14,4,2145.1000000000004,21500.0
32387,U36863,18,-12226.150000000003,13,5,20833.66,8607.509999999997
32388,U14214,18,-141778.32999999996,9,9,151702.24,9923.910000000033
32389,U39472,18,-34524.939999999944,10,8,1081594.0,1047069.06
32390,U1328055,18,-637.5000000000002,10,8,6223.38,5585.88
32391,U15505,18,1969.3500000000058,7,11,162559.91999999998,164529.27
32392,U24487,18,-8975.870000000003,10,8,114486.46,105510.59
32393,U1243366,18,-2554.8300000000004,14,4,5127.5,2572.6699999999996
32394,U36297,18,173495.44,11,7,13070.7,186566.14
32395,U17859,18,-307.8099999999994,13,5,20686.14,20378.33
32396,U28029,18,3867.5499999999997,11,7,1340.57,5208.12
32397,U26718,18,-8790.26,15,3,14127.4,5337.139999999999
32398,U31987,18,-1731.769999999999,14,4,26916.140000000007,25184.370000000006
32399,U1205284,18,124.70000000000024,9,9,9949.650000000001,10074.350000000002
32400,U19616,18,-4904.959999999999,9,9,176006.0,171101.04
32401,U1149967,18,-1796.6999999999998,16,2,1803.6399999999999,6.940000000000055
32402,U19499,18,8176.44,7,11,13293.869999999999,21470.309999999998
32403,U35568,18,-175240.96,13,5,263257.78,88016.82000000004
32404,U32164,18,51083.8,5,13,140793.0,191876.8
32405,U14565,18,8763.870000000003,12,6,1317846.0,1326609.87
32406,U24093,18,-1717.2799999999952,13,5,71500.0,69782.72
32407,U31056,18,79.43999999999801,9,9,52657.96,52737.399999999994
32408,U16794,18,216523.15000000002,10,8,174997.0,391520.15
32409,U1239795,18,-696.5000000000001,12,6,2129.51,1433.0100000000002
32410,U36948,18,-265.07000000000005,10,8,2711.84,2446.77
32411,U689394,18,-2522.2,10,8,9246.099999999999,6723.899999999999
32412,U23639,18,-3947.6399999999976,8,10,47476.72000000001,43529.08000000001
32413,U36996,18,-50577.88,10,8,60397.0,9819.120000000003
32414,U42571,18,7076.650000000002,8,10,171654.61,178731.25999999998
32415,U32884,18,-1355.8500000000004,11,7,16717.0,15361.15
32416,U39719,18,-68451.38,11,7,574936.62,506485.24
32417,U41961,18,-6664.870000000001,15,3,9998.910000000002,3334.040000000001
32418,U16776,18,930.0699999999861,10,8,74425.85000000002,75355.92000000001
32419,U1044130,18,-1663.49,16,2,1713.7,50.210000000000036
32420,U16640,18,69963.20999999999,8,10,91413.93,161377.13999999998
32421,U22325,18,-223.26000000000204,8,10,164260.0,164036.74
32422,U25103,18,195101.80000000002,13,5,16591.86,211693.66000000003
32423,U39554,18,5078.34,10,8,4438.08,9516.42
32424,U904886,18,-6172.65,13,5,6693.29,520.6400000000003
32425,U42956,18,25558.530000000002,8,10,27713.56,53272.090000000004
32426,U11400,18,-8777.060000000003,14,4,58013.03,49235.969999999994
32427,U29415,18,2111.41,8,10,11214.0,13325.41
32428,U34585,18,-72676.54000000001,10,8,147632.73,74956.19
32429,U1073753,18,0.01999999999998181,9,9,670.02,670.04
32430,U15239,18,9836.130000000001,12,6,947.27,10783.400000000001
32431,U1104366,18,517.0,10,8,1987.08,2504.08
32432,U37198,18,-143897.24,6,12,310301.0,166403.76
32433,U33444,18,918.8500000000006,12,6,14843.18,15762.03
32434,U10447,18,-10650.050000000003,10,8,50345.899999999994,39695.84999999999
32435,U17861,18,-770.8100000000001,11,7,14677.9,13907.09
32436,U23691,18,6576.6,10,8,12773.0,19349.6
32437,U43613,18,1196.7900000000016,15,3,54696.17999999999,55892.969999999994
32438,U23274,18,-330.09000000000015,13,5,3836.6499999999996,3506.5599999999995
32439,U41207,18,-2581.93,12,6,11388.7,8806.77
32440,U39752,18,672.67,11,7,29934.0,30606.67
32441,U8785,18,-31625.07,13,5,32918.59,1293.5199999999968
32442,U23824,18,-23199.809999999998,13,5,34111.0,10911.190000000002
32443,U13959,18,-34.02000000000087,15,3,18734.04,18700.02
32444,U12069,18,6569.140000000047,4,14,2605000.0,2611569.14
32445,U41084,18,236.35000000000494,7,11,275270.4,275506.75
32446,U9226,18,-1889.3800000000629,9,9,680024.05,678134.6699999999
32447,U39875,18,2133.5699999999842,8,10,112195.94,114329.50999999998
32448,U16922,18,51224.490000000005,7,11,146024.86,197249.34999999998
32449,U14212,18,-23392.309999999998,11,7,123682.57,100290.26000000001
32450,U28194,18,-2447.360000000001,9,9,14329.48,11882.119999999999
32451,U42200,18,327.1899999999998,13,5,4988.73,5315.919999999999
32452,U29449,18,-113272.76000000001,11,7,389069.01,275796.25
32453,U16628,18,297.52,13,5,9702.57,10000.09
32454,U20442,18,-117073.26000000001,7,11,1180000.0,1062926.74
32455,U958143,18,4681.18,10,8,1982.18,6663.360000000001
32456,U38917,18,-103231.79,9,9,228638.0,125406.21
32457,U37010,18,11424.11,10,8,13805.68,25229.79
32458,U656274,18,-343.58,13,5,447.4,103.82
32459,U12263,18,318.1500000000045,11,7,116304.56999999999,116622.72
32460,U745365,18,627.6000000000004,12,6,19632.46,20260.059999999998
32461,U898705,18,2399.8,8,10,12197.67,14597.470000000001
32462,U21787,18,-18618.950000000004,12,6,37239.01,18620.059999999998
32463,U26438,18,1944.2399999999766,7,11,208885.3,210829.53999999998
32464,U36967,18,2384.83,9,9,4963.17,7348.0
32465,U939461,18,53.870000000000005,14,4,369.03,422.9
32466,U19937,18,132.51999999999998,14,4,2467.5800000000017,2600.1000000000017
32467,U1195737,18,314.5,7,11,423.5,738.0
32468,U28217,18,37.60999999999825,10,8,119464.33,119501.94
32469,U10111,18,5853.580000000002,10,8,43664.3,49517.880000000005
32470,U618174,18,951.5,10,8,9507.57,10459.07
32471,U34544,18,-4220.250000000012,8,10,224500.0,220279.75
32472,U903009,18,-6555.379999999999,12,6,16027.97,9472.59
32473,U39407,18,-94025.79000000001,10,8,149538.8,55513.00999999998
32474,U43861,18,1823.8800000000047,11,7,75339.65,77163.53
32475,U15418,18,-328368.62999999995,14,4,328446.04,77.4100000000326
32476,U43212,18,-1163.2399999999998,9,9,94286.14000000001,93122.90000000001
32477,U15667,18,4208.819999999998,10,8,18475.08,22683.9
32478,U36379,18,-1951.5200000000004,11,7,40387.61,38436.09
32479,U14119,18,-10913.04999999999,9,9,420480.0,409566.95
32480,U28249,18,91795.9,12,6,245133.15,336929.05
32481,U22229,18,195.6499999999994,8,10,83132.0,83327.65
32482,U25494,18,61495.50000000001,10,8,35574.369999999995,97069.87
32483,U629671,18,-13.750000000000227,11,7,5361.27,5347.52
32484,U21342,18,293959.54000000004,10,8,396541.58,690501.1200000001
32485,U1159179,18,-290.3600000000006,13,5,4380.3600000000015,4090.000000000001
32486,U39293,18,16745.660000000003,11,7,26242.0,42987.66
32487,U1312090,18,496.2100000000003,12,6,2932.8099999999995,3429.02
32488,U747285,18,-4681.439999999999,12,6,4736.959999999999,55.52000000000044
32489,U18865,18,8965.199999999999,10,8,14118.0,23083.199999999997
32490,U968932,18,-3666.1200000000003,17,1,3666.1800000000003,0.05999999999994543
32491,U20945,18,26850.7,11,7,1342.58,28193.28
32492,U42818,18,-23242.680000000004,13,5,67079.1,43836.42
32493,U1133319,18,3.019999999999982,12,6,656.99,660.01
32494,U23937,18,1943.1000000000934,10,8,2212977.02,2214920.12
32495,U38407,18,7586.18,9,9,12827.66,20413.84
32496,U18214,18,4856.149999999989,7,11,139221.34,144077.49
32497,U26265,18,-53.630000000000564,8,10,11435.039999999999,11381.409999999998
32498,U8491,18,21409.59,12,6,3990.16,25399.75
32499,U42567,18,-51933.95,15,3,88116.6,36182.65000000001
32500,U34880,18,148864.02000000002,7,11,66102.82,214966.84000000003
32501,U10073,18,81962.48000000007,6,12,1945171.0,2027133.48
32502,U34608,18,-1004.1100000000029,14,4,37793.20999999999,36789.09999999999
32503,U35972,18,-969.8600000000006,15,3,5999.860000000001,5030.0
32504,U8159,18,0.18000000000045474,10,8,25459.889999999996,25460.069999999996
32505,U41781,18,54.099999999999966,14,4,1355.9,1410.0
32506,U20425,18,11158.750000000051,8,10,1010126.72,1021285.47
32507,U20568,18,-1070.3100000000006,10,8,18419.359999999993,17349.049999999992
32508,U684357,18,823.9000000000001,11,7,5346.86,6170.76
32509,U15592,18,10436.000000000005,13,5,1558.68,11994.680000000006
32510,U20898,18,0.029999999999981812,9,9,5785.0,5785.03
32511,U19840,18,8.569999999992433,8,10,386933.21,386941.78
32512,U39620,18,-33923.59999999928,7,11,6188734.0,6154810.4
32513,U36056,18,5289.720000000002,8,10,19214.579999999998,24504.3
32514,U26883,18,9943.68,10,8,13070.699999999999,23014.379999999997
32515,U40074,18,-11014.57,12,6,31270.5,20255.93
32516,U14804,18,-5792.390000000002,11,7,75500.26,69707.87
32517,U1379861,18,-10509.61,14,4,12403.61,1894.0
32518,U966610,18,-393.72,9,9,1522.77,1129.05
32519,U23025,18,3306.6100000000006,8,10,67840.0,71146.61
32520,U12986,18,11758.83,8,10,24592.23,36351.06
32521,U18030,18,21907.02,9,9,46100.0,68007.02
32522,U27574,18,2638.350000000001,12,6,23688.199999999997,26326.55
32523,U8496,18,-22514.949999999997,7,11,132776.07,110261.12000000001
32524,U22179,18,1562.3500000000015,10,8,25091.36,26653.710000000003
32525,U14554,18,2956.0899999999992,9,9,14580.910000000002,17537.0
32526,U28234,18,-3008.17,6,12,14208.25,11200.08
32527,U18736,18,2.2999999999992724,11,7,25277.190000000002,25279.49
32528,U35960,18,2.9200000000002433,10,8,10558.66,10561.58
32529,U1272979,18,878.1999999999998,9,9,4849.4,5727.599999999999
32530,U26442,18,1176.6699999999946,13,5,83626.1,84802.77
32531,U21532,18,-34295.32,12,6,63302.82000000001,29007.500000000007
32532,U1098942,18,-531.47,13,5,2855.63,2324.16
32533,U38981,18,2417.149999999994,6,12,382000.0,384417.15
32534,U39343,18,-2555.01,14,4,2560.0,4.989999999999782
32535,U24321,18,-51738.42,11,7,118553.7,66815.28
32536,U10519,18,-102.44000000000187,9,9,36813.469999999994,36711.02999999999
32537,U15137,18,-35765.130000000005,11,7,42275.0,6509.869999999995
32538,U18730,18,2636.7,16,2,10263.3,12900.0
32539,U17158,18,14.760000000000437,9,9,27228.95,27243.710000000003
32540,U23864,18,-5133.279999999999,13,5,190064.26,184930.98
32541,U26600,18,-68165.03000000001,9,9,200889.25,132724.21999999997
32542,U37500,18,1627.12,5,13,179987.0,181614.12
32543,U42676,18,-20425.37,15,3,21598.66,1173.2900000000009
32544,U36549,18,11267.4,9,9,17151.0,28418.4
32545,U25729,18,3347.319999999997,11,7,48003.64,51350.96
32546,U42716,18,129.59,15,3,834.45,964.0400000000001
32547,U16171,18,-11126.180000000002,10,8,88433.33000000003,77307.15000000002
32548,U32980,18,1715.1,9,9,1081.54,2796.64
32549,U19605,18,928.4899999999934,13,5,77565.89,78494.37999999999
32550,U18409,18,-746.3299999999997,15,3,4530.910000000001,3784.580000000001
32551,U43141,18,16372.849999999999,8,10,632441.66,648814.51
32552,U35497,18,-505.4800000000014,10,8,26632.93,26127.449999999997
32553,U1029783,18,2201.17,16,2,2586.16,4787.33
32554,U20809,18,-99544.44000000002,12,6,300773.0,201228.56
32555,U23569,18,2802.730000000001,11,7,14725.71,17528.44
32556,U41853,18,-2864.59,5,13,31991.92,29127.329999999998
32557,U36534,18,2434.59,10,8,8062.9,10497.49
32558,U39314,18,26819.24,10,8,8878.52,35697.76
32559,U29304,18,-382.1100000000006,13,5,119842.0,119459.89
32560,U31068,18,38.659999999999854,11,7,20394.260000000002,20432.920000000002
32561,U33609,18,-4726.709999999999,14,4,6135.52,1408.8100000000013
32562,U26345,18,-683.94,13,5,1194.3600000000001,510.4200000000001
32563,U14077,18,-1053.8800000000017,16,2,51063.28999999999,50009.40999999999
32564,U31767,18,-4749.690000000004,13,5,57835.079999999994,53085.38999999999
32565,U1326159,18,84.73000000000005,11,7,2205.14,2289.87
32566,U40455,18,8475.710000000001,11,7,6638.52,15114.230000000001
32567,U956973,18,-1064.0700000000002,14,4,1290.7900000000002,226.72000000000003
32568,U34303,18,-44819.74000000002,6,12,305000.0,260180.25999999998
32569,U41944,18,151.39999999999964,13,5,8152.39,8303.79
32570,U40383,17,4.969999999999914,13,4,2432.7,2437.6699999999996
32571,U28411,17,6139.379999999999,11,6,26267.620000000003,32407.0
32572,U1276050,17,-3.9499999999996818,8,9,9694.35,9690.400000000001
32573,U26055,17,520.4100000000003,8,9,14715.789999999999,15236.199999999999
32574,U1273836,17,-7219.76,14,3,8492.78,1273.0200000000004
32575,U27114,17,6958.21,12,5,3675.27,10633.48
32576,U716720,17,-7134.35,12,5,7167.030000000001,32.68000000000029
32577,U10082,17,1364.36,12,5,1811.8,3176.16
32578,U9710,17,1894.0399999999954,9,8,70657.59,72551.62999999999
32579,U42936,17,-10391.820000000002,13,4,16208.95,5817.129999999999
32580,U32328,17,67384.81,9,8,9668.89,77053.7
32581,U28180,17,-73.4099999999973,6,11,47906.240000000005,47832.83000000001
32582,U9502,17,-51651.94,8,9,103987.17000000001,52335.23000000001
32583,U1246302,17,-501.1499999999998,11,6,1624.06,1122.91
32584,U34573,17,814.71,12,5,2851.1099999999997,3665.8199999999997
32585,U39160,17,-169143.2000000001,8,9,825944.41,656801.21
32586,U32952,17,1921.8000000000004,11,6,10771.95,12693.750000000002
32587,U1218450,17,-1174.3999999999999,15,2,1846.4699999999998,672.0699999999999
32588,U1340739,17,-4590.64,11,6,13169.13,8578.489999999998
32589,U27572,17,5015.999999999999,11,6,17018.980000000003,22034.980000000003
32590,U42472,17,-28624.199999999997,9,8,313953.94,285329.74
32591,U11171,17,100038.06,2,15,200.0,100238.06
32592,U37779,17,76916.69999999995,8,9,1014097.55,1091014.25
32593,U1255281,17,-12460.469999999998,16,1,12461.469999999998,1.0
32594,U34662,17,-391.0400000000009,13,4,80513.0,80121.95999999999
32595,U21031,17,11155.329999999994,11,6,51467.83,62623.159999999996
32596,U17252,17,408.1800000000003,10,7,15259.33,15667.51
32597,U35573,17,-1801.6799999999998,9,8,20097.1,18295.42
32598,U41512,17,-52643.88,8,9,145300.0,92656.12
32599,U25577,17,-4420.579999999998,14,3,14620.599999999997,10200.019999999999
32600,U23952,17,-461.7300000000012,10,7,71218.49,70756.76000000001
32601,U22487,17,50606.69,14,3,2834.6400000000003,53441.33
32602,U37356,17,398.129999999999,11,6,17178.72,17576.85
32603,U12112,17,-10.010000000001694,8,9,20627.719999999998,20617.709999999995
32604,U998466,17,-119.57999999999998,10,7,552.98,433.40000000000003
32605,U21903,17,-4426.26,9,8,14920.99,10494.73
32606,U25104,17,-1161.57,12,5,2711.79,1550.22
32607,U33882,17,31192.629999999997,12,5,3354.38,34547.009999999995
32608,U13509,17,-7835.68,10,7,32237.68,24402.0
32609,U25623,17,12764.829999999998,11,6,30411.74,43176.57
32610,U16730,17,-8153.07,13,4,10158.99,2005.92
32611,U963930,17,-3103.8299999999995,15,2,3103.85,0.020000000000436557
32612,U36174,17,257700.63000000003,7,10,25594.719999999998,283295.35000000003
32613,U36763,17,-1049.0200000000007,15,2,5280.73,4231.709999999999
32614,U8405,17,54414.0,13,4,92056.97,146470.97
32615,U11423,17,-13029.31,13,4,13606.0,576.6900000000005
32616,U31920,17,-98582.90000000001,7,10,202466.37,103883.46999999999
32617,U9855,17,248.06999999999982,14,3,2585.67,2833.74
32618,U15456,17,-70289.55999999998,9,8,317044.68000000005,246755.12000000005
32619,U761989,17,-16619.0,9,8,25240.010000000002,8621.010000000002
32620,U1083086,17,-1258.24,14,3,2458.34,1200.1000000000001
32621,U43269,17,-45682.67,10,7,68723.8,23041.130000000005
32622,U22507,17,-127091.67000000003,7,10,345585.0,218493.32999999996
32623,U8394,17,-1.9799999999995634,10,7,36418.66,36416.68000000001
32624,U8728,17,-10592.84,12,5,27528.37,16935.53
32625,U19701,17,-6233.71,12,5,12534.0,6300.29
32626,U27838,17,-590.5300000000001,8,9,4557.69,3967.1599999999994
32627,U25400,17,-8635.62,9,8,14305.9,5670.279999999999
32628,U11763,17,-9119.130000000001,9,8,12584.3,3465.1699999999983
32629,U28622,17,-2288.850000000006,9,8,105786.36,103497.51
32630,U35759,17,5236.500000000002,9,8,28114.56,33351.060000000005
32631,U27953,17,24858.559999999994,11,6,119206.68,144065.24
32632,U1113504,17,-345.4000000000001,12,5,944.0600000000001,598.66
32633,U37933,17,-3675.8600000000006,11,6,24938.0,21262.14
32634,U27005,17,-60132.57,12,5,86176.58000000002,26044.010000000017
32635,U40381,17,1898.8700000000001,7,10,1543.8600000000001,3442.7300000000005
32636,U43999,17,-339.52999999999975,10,7,14668.039999999999,14328.509999999998
32637,U28395,17,57499.36,0,17,0.0,57499.36
32638,U41148,17,7068.26,10,7,36188.92,43257.18
32639,U41789,17,5927.340000000001,11,6,9589.04,15516.380000000001
32640,U38038,17,28685.909999999996,10,7,7156.829999999999,35842.74
32641,U43576,17,-25021.52,11,6,40287.0,15265.48
32642,U10373,17,3651.1800000000003,9,8,7239.280000000001,10890.460000000001
32643,U33354,17,0.010000000000436557,8,9,29397.070000000003,29397.080000000005
32644,U760549,17,-28245.429999999997,13,4,33245.44,5000.010000000006
32645,U10046,17,1612.4700000000303,9,8,512979.47,514591.94
32646,U28033,17,35695.079999999994,6,11,7502.6,43197.67999999999
32647,U10263,17,93073.62999999999,10,7,18974.440000000002,112048.06999999999
32648,U36104,17,946.6500000000001,13,4,1311.83,2258.48
32649,U18167,17,-352892.37,9,8,400617.4,47725.03000000003
32650,U968030,17,-26896.94,14,3,30170.71,3273.7700000000004
32651,U40310,17,7604.859999999997,10,7,308422.16000000003,316027.02
32652,U43442,17,18622.170000000002,9,8,13926.84,32549.010000000002
32653,U16428,17,-1614.34,12,5,6763.469999999999,5149.129999999999
32654,U14305,17,-46544.5,9,8,97146.70999999999,50602.20999999999
32655,U36315,17,25957.780000000002,10,7,32475.27,58433.05
32656,U39881,17,879.3799999999992,13,4,12068.34,12947.72
32657,U919875,17,177.82999999999936,10,7,8379.39,8557.22
32658,U22599,17,425318.26,1,16,10000.0,435318.26
32659,U8217,17,6911.700000000001,12,5,36845.009999999995,43756.70999999999
32660,U16933,17,13492.809999999996,10,7,53499.0,66991.81
32661,U1268958,17,3514.0599999999995,7,10,2665.5499999999997,6179.609999999999
32662,U28390,17,4619.0,9,8,38883.229999999996,43502.229999999996
32663,U42894,17,-11548.98,14,3,14837.579999999998,3288.5999999999985
32664,U1263453,17,-588.8,10,7,5943.019999999999,5354.219999999998
32665,U36237,17,-3594.7199999999993,9,8,15574.0,11979.28
32666,U14476,17,-250.99,12,5,1406.63,1155.64
32667,U20351,17,-4.639999999999418,10,7,61104.649999999994,61100.009999999995
32668,U37564,17,2036.9099999999999,8,9,4090.0,6126.91
32669,U29861,17,-55411.30000000002,10,7,157011.13999999998,101599.83999999997
32670,U19343,17,1903.9799999999996,9,8,33207.8,35111.78
32671,U28082,17,582.0799999999945,9,8,103800.0,104382.07999999999
32672,U31391,17,3575.8099999999995,14,3,1697.47,5273.28
32673,U28966,17,-1224.7900000000009,8,9,23067.0,21842.21
32674,U31965,17,-33293.73,16,1,33326.07,32.33999999999651
32675,U14728,17,24269.33999999999,10,7,59961.15,84230.48999999999
32676,U35388,17,42.09000000000083,11,6,27545.02,27587.11
32677,U18157,17,19767.47,9,8,718.0,20485.47
32678,U18333,17,-1213.6999999999985,8,9,35230.6,34016.9
32679,U10098,17,14750.86,10,7,18139.0,32889.86
32680,U21966,17,3981.5600000000004,11,6,1362.69,5344.25
32681,U30834,17,22013.19999999992,7,10,1021046.74,1043059.94
32682,U22319,17,151.06000000000063,13,4,10988.949999999999,11140.01
32683,U1215578,17,-297.80999999999995,13,4,2037.89,1740.0800000000002
32684,U36794,17,22743.059999999998,9,8,23090.58,45833.64
32685,U12629,17,-17542.85,11,6,42194.17,24651.32
32686,U705029,17,-6030.9,12,5,8581.029999999999,2550.129999999999
32687,U9286,17,245.7299999999998,12,5,19085.43,19331.16
32688,U17991,17,-995.5400000000001,14,3,1886.6299999999999,891.0899999999998
32689,U15149,17,26094.800000000017,5,12,1030768.3400000001,1056863.1400000001
32690,U628377,17,62.36999999999978,8,9,5019.5,5081.87
32691,U40575,17,-150.3399999999965,10,7,29397.839999999997,29247.5
32692,U9939,17,10604.87,4,13,86508.37,97113.23999999999
32693,U35998,17,-7591.550000000001,11,6,47815.91,40224.36
32694,U29584,17,4836.4,13,4,3759.58,8595.98
32695,U25119,17,36407.60999999999,12,5,19990.6,56398.20999999999
32696,U18873,17,2010.1499999999942,8,9,122102.0,124112.15
32697,U43270,17,0.0,9,8,27811.03,27811.03
32698,U39484,17,9950.62,10,7,31000.0,40950.62
32699,U29942,17,36845.939999999995,9,8,23629.88,60475.81999999999
32700,U17849,17,1884.1800000000003,12,5,38452.78,40336.96
32701,U33568,17,-6465.31,12,5,7574.66,1109.3499999999995
32702,U37377,17,13.839999999999264,10,7,12242.32,12256.16
32703,U24886,17,8429.049999999996,10,7,72607.89,81036.94
32704,U34917,17,27.020000000000095,12,5,3549.17,3576.19
32705,U36856,17,-137.56000000000006,9,8,2872.1000000000004,2734.5400000000004
32706,U11262,17,1846.409999999999,12,5,35002.8,36849.21
32707,U21291,17,-18833.830000000005,11,6,96490.88,77657.05
32708,U32462,17,-50.38,13,4,210.24999999999997,159.86999999999998
32709,U42623,17,-31138.58,12,5,59806.0,28667.42
32710,U26233,17,-9921.290000000008,8,9,295092.0,285170.70999999996
32711,U31253,17,-25343.58,13,4,44390.0,19046.42
32712,U33385,17,-13034.32,14,3,13154.33,120.01000000000022
32713,U15926,17,-4937.719999999999,11,6,14440.759999999998,9503.039999999999
32714,U35185,17,7686.369999999999,13,4,4565.200000000001,12251.57
32715,U25921,17,-93533.99999999999,5,12,730107.8200000001,636573.8200000001
32716,U25314,17,-2213.38,15,2,3013.3900000000003,800.0100000000002
32717,U37318,17,-18719.77,12,5,27600.8,8881.029999999999
32718,U24741,17,-921.4499999999999,12,5,5883.369999999999,4961.919999999999
32719,U10336,17,2023.0500000000013,8,9,20886.4,22909.450000000004
32720,U1359143,17,80.59999999999984,12,5,1741.5900000000004,1822.1900000000003
32721,U16804,17,-7094.780000000003,9,8,73480.56,66385.78
32722,U11045,17,-2705.379999999999,13,4,16807.75,14102.37
32723,U24814,17,-649.5199999999991,9,8,17109.239999999998,16459.719999999998
32724,U18026,17,2916.2,11,6,12967.38,15883.579999999998
32725,U832677,17,592.3500000000004,9,8,27907.66,28500.010000000002
32726,U14415,17,1149.5399999999972,9,8,38878.369999999995,40027.90999999999
32727,U644661,17,-4073.5099999999998,15,2,4498.51,425.00000000000045
32728,U25351,17,8780.34,12,5,11289.38,20069.72
32729,U10746,17,374.2499999999999,13,4,4896.8,5271.05
32730,U29633,17,-92444.27,12,5,108900.0,16455.729999999996
32731,U10804,17,4483.170000000002,11,6,42393.55,46876.72
32732,U14689,17,22142.11,4,13,180000.0,202142.11
32733,U23752,17,-2208.959999999999,5,12,71750.0,69541.04000000001
32734,U23650,17,202953.32000000004,9,8,13570.82,216524.14000000004
32735,U27224,17,1390.1200000000035,10,7,37334.66,38724.780000000006
32736,U955085,17,-111.37000000000035,12,5,9268.81,9157.439999999999
32737,U14430,17,25304.46,11,6,22410.0,47714.46
32738,U8278,17,-586.8999999999996,9,8,7732.23,7145.33
32739,U19668,17,0.1999999999998181,9,8,25389.25,25389.45
32740,U24971,17,1237.620000000002,10,7,50940.75,52178.37
32741,U8468,17,-7241.880000000001,5,12,111655.78,104413.9
32742,U23028,17,81642.24,10,7,77307.26000000001,158949.5
32743,U37910,17,-277214.99999999953,7,10,5000660.0,4723445.0
32744,U38029,17,-123600.66999999994,7,10,554904.36,431303.69000000006
32745,U18968,17,-3062.2100000000005,14,3,10065.6,7003.389999999999
32746,U37887,17,-2811.2800000000007,7,10,10040.66,7229.379999999999
32747,U1115585,17,-3631.1100000000006,15,2,7609.68,3978.5699999999997
32748,U36583,17,36.83999999999992,8,9,1762.38,1799.22
32749,U27391,17,-143.25000000000145,8,9,39557.65,39414.4
32750,U27028,17,-21189.809999999998,10,7,76477.87,55288.06
32751,U16747,17,-139.13000000000102,12,5,14141.61,14002.48
32752,U35222,17,8610.46,12,5,22241.739999999998,30852.199999999997
32753,U40184,17,-7110.780000000001,10,7,24232.010000000002,17121.230000000003
32754,U15934,17,2210.0400000000004,11,6,9806.0,12016.04
32755,U38229,17,-1806.42,13,4,8541.740000000002,6735.3200000000015
32756,U27570,17,4722.049999999988,7,10,129317.81,134039.86
32757,U27118,17,-3186.510000000002,7,10,77487.68000000001,74301.17000000001
32758,U715655,17,-2472.609999999998,10,7,29986.609999999997,27514.0
32759,U31115,17,42973.41000000015,9,8,11067999.0,11110972.41
32760,U28924,17,387.3,15,2,625.4999999999999,1012.8
32761,U37485,17,-230275.36000000004,15,2,230395.75000000003,120.38999999998487
32762,U37412,17,-8320.6,10,7,16763.96,8443.359999999999
32763,U1239243,17,-250.15999999999997,9,8,1206.1799999999998,956.0199999999999
32764,U33168,17,-19670.96,6,11,37428.96,17758.0
32765,U14612,17,-874.3500000000004,12,5,7908.5,7034.15
32766,U35376,17,3.029999999991269,9,8,520912.9,520915.93
32767,U28476,17,76.86000000000104,12,5,12814.8,12891.66
32768,U20907,17,31058.48999999999,10,7,90208.34,121266.82999999999
32769,U16481,17,-75066.65000000001,7,10,124197.61,49130.95999999999
32770,U25778,17,-24899.15,12,5,196500.0,171600.85
32771,U8796,17,1983.3700000000001,11,6,8252.14,10235.51
32772,U30544,17,2700.6499999999987,12,5,19041.350000000002,21742.0
32773,U871228,17,-0.8299999999996999,10,7,3398.2200000000003,3397.3900000000003
32774,U23489,17,-1748.5800000000072,7,10,177156.61000000002,175408.03
32775,U1318528,17,-1.2000000000000028,10,7,321.21,320.01
32776,U31482,17,761.8999999999996,11,6,13554.100000000002,14316.000000000002
32777,U8431,17,-5762.129999999997,10,7,110768.04000000001,105005.91
32778,U13431,17,-3183.3999999999987,9,8,113413.83,110230.43000000001
32779,U23455,17,5222.2999999999965,7,10,56734.630000000005,61956.93
32780,U25317,17,12774.79,10,7,37645.700000000004,50420.490000000005
32781,U34072,17,805.6700000000001,10,7,27148.0,27953.67
32782,U1201999,17,0.010000000001127773,8,9,12694.9,12694.91
32783,U34443,17,-1531.4499999999744,8,9,172884.47,171353.02000000002
32784,U13883,17,-1200.21,10,7,13722.130000000001,12521.920000000002
32785,U42447,17,-6951.090000000001,10,7,36547.72,29596.63
32786,U20539,17,8965.17,10,7,13685.56,22650.73
32787,U30254,17,-110599.89999999998,9,8,665000.0,554400.1
32788,U22640,17,-271.2200000000071,12,5,101158.41,100887.19
32789,U15142,17,-20800.750000000004,10,7,116819.90999999997,96019.15999999997
32790,U38126,17,2351.5199999999995,12,5,16341.83,18693.35
32791,U9632,17,11988.219999999998,11,6,80995.13,92983.35
32792,U11967,17,13352.209999999997,9,8,5758.54,19110.749999999996
32793,U27721,17,-2995.470000000001,10,7,15980.66,12985.189999999999
32794,U1090329,17,205.0599999999995,11,6,5273.9400000000005,5479.0
32795,U21570,17,290868.14999999997,11,6,115505.0,406373.14999999997
32796,U18995,17,32740.030000000013,10,7,41063.159999999996,73803.19
32797,U28668,17,5357.530000000001,15,2,1042.47,6400.000000000001
32798,U33596,17,1771.98,10,7,9673.310000000001,11445.29
32799,U15453,17,-7214.940000000002,11,6,78656.90000000001,71441.96
32800,U38349,17,364.63999999999623,12,5,52578.85,52943.49
32801,U34154,17,-478.9200000000001,13,4,2958.0,2479.08
32802,U41499,17,-260.2600000000002,12,5,10858.27,10598.01
32803,U36318,17,534160.42,5,12,812514.3,1346674.7200000002
32804,U27165,17,-348.0899999999983,12,5,23563.79,23215.700000000004
32805,U28703,17,-2055.36,13,4,20146.45,18091.09
32806,U17798,17,-78.49999999999909,7,10,28896.25,28817.75
32807,U40292,17,-95290.26000000001,15,2,96230.88000000002,940.6200000000099
32808,U34131,17,-47410.43000000001,10,7,51241.9,3831.469999999994
32809,U27516,17,-821.4699999999721,11,6,459406.0,458584.53
32810,U20886,17,3005.6699999999983,9,8,119044.48,122050.15
32811,U21454,17,9322.55,9,8,13844.139999999998,23166.689999999995
32812,U18750,17,-5946.0500000000175,9,8,238594.31999999998,232648.26999999996
32813,U36265,17,203.66000000000008,7,10,14400.0,14603.66
32814,U35467,17,-2207.320000000016,9,8,402478.01,400270.69
32815,U21038,17,75.07000000000016,16,1,3566.0,3641.07
32816,U15647,17,-13947.650000000001,11,6,20687.41,6739.759999999998
32817,U13911,17,-2854.7299999999996,12,5,9699.060000000001,6844.330000000002
32818,U39929,17,81506.46,8,9,647.8399999999999,82154.3
32819,U38180,17,426.34000000000003,9,8,797.78,1224.12
32820,U26418,17,43612.23999999999,8,9,109987.0,153599.24
32821,U27763,17,6144.83,10,7,65397.67999999999,71542.51
32822,U34955,17,26957.579999999998,12,5,71298.9,98256.48
32823,U39551,17,46489.179999999964,10,7,555523.0,602012.1799999999
32824,U12975,17,48041.10999999999,5,12,57896.58,105937.69
32825,U43060,17,-26485.280000000097,6,11,739800.0,713314.7199999999
32826,U1122065,17,1113.789999999999,8,9,15659.369999999999,16773.159999999996
32827,U40867,17,-49933.05,12,5,194958.25,145025.2
32828,U34098,17,-248.4300000000003,11,6,49738.92,49490.49
32829,U15786,17,-13129.79,15,2,33930.0,20800.21
32830,U35040,17,17674.550000000003,12,5,8446.929999999998,26121.480000000003
32831,U40358,17,-48847.0,13,4,55806.9,6959.9000000000015
32832,U16590,17,-12864.300000000001,11,6,33336.13,20471.829999999994
32833,U28241,17,5197.500000000001,9,8,989.78,6187.280000000001
32834,U15438,17,-1940.8899999999849,6,11,106058.0,104117.11000000002
32835,U839995,17,-8588.46,12,5,9511.49,923.0300000000007
32836,U20757,17,162463.9,6,11,50884.299999999996,213348.19999999998
32837,U19597,17,27435.35,9,8,35779.97,63215.32
32838,U27555,17,7859.5,8,9,187267.15,195126.65
32839,U731636,17,-3492.7900000000004,16,1,3492.8500000000004,0.05999999999994543
32840,U12942,17,-269388.68,12,5,819928.55,550539.8700000001
32841,U18510,17,-426977.61,7,10,587263.3,160285.69000000006
32842,U26841,17,410054.27999999997,7,10,62750.0,472804.27999999997
32843,U41937,17,88347.09999999996,10,7,583331.4299999999,671678.5299999999
32844,U34121,17,-1671.85,15,2,3019.07,1347.2200000000003
32845,U1116655,17,2.26929586233382e-13,11,6,2884.75,2884.75
32846,U19302,17,-132624.84999999998,8,9,203637.4,71012.55000000002
32847,U842034,17,-3768.3800000000006,12,5,6765.69,2997.309999999999
32848,U29894,17,-19969.350000000002,9,8,32179.500000000004,12210.150000000001
32849,U42209,17,-212503.55000000002,12,5,228804.97,16301.419999999984
32850,U10924,17,3707.779999999999,9,8,24434.89,28142.67
32851,U901934,17,-2.4399999999999906,15,2,102.55,100.11000000000001
32852,U34104,17,-768.8000000000029,7,10,88609.18,87840.37999999999
32853,U1163559,17,-3936.5399999999995,9,8,9358.52,5421.980000000001
32854,U9532,17,-3886.3099999999977,13,4,54975.09,51088.78
32855,U40322,17,44.80999999999995,14,3,1000.0,1044.81
32856,U24917,17,-4059.2899999999995,8,9,23535.02,19475.73
32857,U30908,17,-23704.53,12,5,35107.0,11402.470000000001
32858,U14393,17,22039.4,9,8,18004.129999999997,40043.53
32859,U19575,17,8073.980000000003,8,9,12829.2,20903.180000000004
32860,U1086377,17,84.5900000000006,11,6,37357.21,37441.8
32861,U42394,17,-298.73999999999995,11,6,10153.04,9854.300000000001
32862,U36183,17,8794.07,12,5,10040.359999999999,18834.43
32863,U22802,17,-41668.92999999999,11,6,177692.0,136023.07
32864,U23771,17,-107.40000000000204,11,6,41528.0,41420.6
32865,U35772,17,-9996.84,9,8,51074.0,41077.16
32866,U37800,17,7739.84,11,6,4954.7,12694.54
32867,U14007,17,7573.919999999998,8,9,74439.25,82013.17
32868,U11856,17,5662.13999999999,6,11,520001.01,525663.15
32869,U29495,17,-829.2299999999959,9,8,54000.0,53170.770000000004
32870,U900514,17,181.53999999999996,9,8,1442.78,1624.32
32871,U31964,17,-399.6399999999994,10,7,22036.44,21636.8
32872,U32446,17,27618.02,10,7,31783.3,59401.32
32873,U947639,17,0.12999999999999545,10,7,709.7299999999999,709.8599999999999
32874,U25514,17,405.2800000000023,9,8,186083.30000000002,186488.58000000002
32875,U920520,17,2706.9,9,8,1673.1399999999999,4380.04
32876,U29400,17,-34.970000000000255,9,8,18120.879999999997,18085.909999999996
32877,U21457,17,-6393.43,11,6,112916.86,106523.43
32878,U22615,17,888.5200000000018,4,13,42000.0,42888.520000000004
32879,U37634,17,336962.02999999997,5,12,2140.0,339102.02999999997
32880,U24390,17,14268.380000000005,10,7,32748.65,47017.030000000006
32881,U34157,17,2077.9199999999837,3,14,210398.6,212476.52
32882,U43845,17,1462.9299999999998,15,2,5642.07,7105.0
32883,U36327,17,3093.84,8,9,31578.370000000003,34672.21000000001
32884,U42416,17,-299824.79,8,9,327750.98,27926.190000000002
32885,U23347,17,2957.4800000000014,8,9,19852.649999999998,22810.129999999997
32886,U36221,17,8743.68,12,5,2287.1800000000003,11030.86
32887,U1204879,17,-462.81999999999994,13,4,473.35999999999996,10.54000000000002
32888,U33295,17,-152.02000000000055,14,3,5176.920000000001,5024.900000000001
32889,U20997,17,-7336.290000000001,8,9,57561.72999999999,50225.43999999999
32890,U620143,17,-7972.54,11,6,8090.58,118.03999999999996
32891,U23280,17,-16331.759999999998,9,8,29131.920000000002,12800.160000000003
32892,U43184,17,-52845.9,8,9,81696.75,28850.85
32893,U33170,17,44940.950000000004,10,7,11190.95,56131.90000000001
32894,U35499,17,-31344.809999999994,13,4,55592.13999999999,24247.329999999998
32895,U31285,17,15257.81,5,12,26315.0,41572.81
32896,U1270154,17,2.8499999999998904,8,9,1452.01,1454.86
32897,U41181,17,-19583.54,10,7,60291.34000000001,40707.80000000001
32898,U1097154,17,799.9999999999999,10,7,3433.0000000000005,4233.0
32899,U43248,17,-2147.29,13,4,4311.61,2164.3199999999997
32900,U19229,17,-23992.69,10,7,38368.58,14375.890000000003
32901,U35641,17,92089.09,9,8,65268.56,157357.65
32902,U36037,17,10170.970000000008,8,9,821992.99,832163.96
32903,U13897,17,240388.50999999998,5,12,503937.0,744325.51
32904,U22510,17,6338.24,11,6,12783.89,19122.129999999997
32905,U9663,17,1114.5100000000002,7,10,1326.8200000000002,2441.3300000000004
32906,U12567,17,-146.5999999999858,7,10,489880.0,489733.4
32907,U8018,17,183919.44,10,7,56198.45,240117.89
32908,U21679,17,44.99000000000001,8,9,45356.0,45400.99
32909,U1057387,17,-22.299999999999997,14,3,222.32,200.01999999999998
32910,U582110,17,-1639.4399999999996,9,8,6921.62,5282.18
32911,U36757,17,-1895.399999999999,10,7,8524.96,6629.56
32912,U43230,17,193.1,12,5,1437.34,1630.4399999999998
32913,U20101,17,-3854.71,13,4,5189.85,1335.1400000000003
32914,U22794,17,198.0000000000029,9,8,143824.56999999998,144022.56999999998
32915,U34627,17,-33.3,9,8,584.6999999999999,551.4
32916,U981398,17,-5.660000000000011,11,6,1878.5,1872.84
32917,U38246,17,19902.61,8,9,20000.940000000002,39903.55
32918,U19563,17,0.850000000001728,12,5,33208.08,33208.93
32919,U11456,17,-6113.99,12,5,26035.059999999998,19921.07
32920,U43359,17,12232.480000000003,10,7,35087.44,47319.920000000006
32921,U36857,17,-766.2800000000002,7,10,521501.35000000003,520735.07
32922,U43430,17,36143.86,7,10,11045.4,47189.26
32923,U670636,17,-5.71,10,7,8.069999999999999,2.3599999999999985
32924,U19529,17,13006.43,11,6,80693.96,93700.39000000001
32925,U10232,17,20929.159999999996,6,11,19417.16,40346.31999999999
32926,U694163,17,-0.7000000000000455,15,2,700.7,700.0
32927,U12730,17,2105.6,10,7,29500.0,31605.6
32928,U21189,17,-13295.47,12,5,24547.57,11252.1
32929,U658330,17,0.48,9,8,1173.3799999999999,1173.86
32930,U39264,17,-1628.4500000000003,10,7,12454.779999999999,10826.329999999998
32931,U36138,17,16900.44,7,10,54050.68,70951.12
32932,U954159,17,3519.4499999999994,10,7,5198.0,8717.449999999999
32933,U42525,17,-5441.659999999999,8,9,64928.95,59487.29
32934,U31286,17,622.9299999999857,8,9,398164.42,398787.35
32935,U17880,17,-1493.5900000000001,11,6,8913.8,7420.209999999999
32936,U23082,17,-2339.38,16,1,2365.0,25.61999999999989
32937,U22208,17,413422.64999999997,10,7,178472.53,591895.1799999999
32938,U24752,17,36124.85,8,9,6600.1900000000005,42725.04
32939,U32598,17,2339.969999999994,8,9,225334.4,227674.37
32940,U34199,17,14735.969999999992,12,5,178006.0,192741.97
32941,U12158,17,8949.77,10,7,23005.96,31955.73
32942,U16897,17,221.78999999999974,8,9,5038.78,5260.57
32943,U38078,17,-1798.3099999999995,13,4,18250.989999999998,16452.68
32944,U12205,17,-391.7799999999999,11,6,2308.0699999999997,1916.2899999999997
32945,U24872,17,-14899.080000000002,11,6,67213.85,52314.770000000004
32946,U42088,17,10.029999999999745,8,9,7534.41,7544.44
32947,U25409,17,-16053.29,13,4,18883.48,2830.1899999999987
32948,U43217,17,53668.740000000005,10,7,163239.93999999997,216908.68
32949,U9029,17,10.950000000011642,7,10,447236.74,447247.69
32950,U11924,17,99965.48999999999,10,7,58135.439999999995,158100.93
32951,U25488,17,-499.7999999999993,8,9,16110.0,15610.2
32952,U34762,17,7276.380000000001,10,7,19566.54,26842.920000000002
32953,U28450,17,-16509.08,7,10,37697.66,21188.58
32954,U35142,17,23305.8,10,7,10520.679999999998,33826.479999999996
32955,U752637,17,12334.550000000005,15,2,8908.8,21243.350000000006
32956,U12368,17,2744.15,14,3,756.0,3500.15
32957,U14276,17,71.0900000000163,11,6,135685.26,135756.35000000003
32958,U35110,17,23868.240000000005,10,7,32033.14,55901.380000000005
32959,U17720,17,-290.9200000000002,11,6,1793.71,1502.79
32960,U659492,17,-1166.5199999999998,17,0,1166.5199999999998,0.0
32961,U32366,17,-19.170000000000044,14,3,2137.2,2118.0299999999997
32962,U23601,17,1222.980000000001,10,7,40075.090000000004,41298.07000000001
32963,U22924,17,135.93000000000004,12,5,522.65,658.58
32964,U28809,17,-4347.949999999999,4,13,100234.3,95886.35
32965,U1099315,17,103.43,12,5,1096.58,1200.01
32966,U36353,17,46906.74,9,8,176.0,47082.74
32967,U27177,17,121.04999999999995,11,6,689.18,810.2299999999999
32968,U30008,17,3208.6699999999973,9,8,26953.87,30162.539999999997
32969,U23813,17,455.9800000000006,12,5,21915.86,22371.84
32970,U753217,16,83.70000000000005,10,6,1128.2,1211.9
32971,U30155,16,402.2099999999973,6,10,36018.96,36421.17
32972,U8451,16,34001.08,11,5,17258.06,51259.14
32973,U36126,16,0.9900000000000091,8,8,30983.42,30984.41
32974,U1104917,16,-265.0999999999998,9,7,4759.57,4494.47
32975,U28002,16,3029.4399999999996,12,4,6024.1,9053.54
32976,U1137199,16,-13980.6,13,3,30980.600000000006,17000.000000000007
32977,U33687,16,-136.29000000000002,12,4,2141.96,2005.67
32978,U691076,16,6.389999999999986,11,5,1155.6100000000001,1162.0
32979,U18211,16,160.67000000002562,9,7,353696.1,353856.77
32980,U16372,16,-1788.9399999999998,9,7,16548.87,14759.929999999998
32981,U34561,16,19152.24,10,6,13890.0,33042.240000000005
32982,U18654,16,13.770000000001147,9,7,16334.18,16347.95
32983,U9785,16,-1557.87,7,9,13522.76,11964.89
32984,U904774,16,20.469999999999978,8,8,438.32,458.78999999999996
32985,U41821,16,-63.46000000000003,10,6,2708.3199999999997,2644.8599999999997
32986,U21690,16,-23856.759999999995,11,5,108858.79,85002.03
32987,U33572,16,3973.7999999999997,10,6,8296.3,12270.099999999999
32988,U19142,16,741.5500000000001,8,8,198.6,940.1500000000001
32989,U25378,16,-267223.82000000007,9,7,404000.0,136776.17999999993
32990,U13699,16,-12158.089999999967,12,4,447691.82,435533.73000000004
32991,U8791,16,-738.8400000000003,11,5,10866.31,10127.47
32992,U1267574,16,-1246.4499999999998,14,2,1271.5499999999997,25.09999999999991
32993,U33278,16,567.950000000004,11,5,92437.34,93005.29
32994,U37436,16,-17636.7,10,6,59786.29,42149.59
32995,U9287,16,-160.79000000000087,11,5,21961.0,21800.21
32996,U26068,16,-536.0200000000004,10,6,8904.210000000001,8368.19
32997,U15244,16,-29132.38,12,4,30898.190000000006,1765.810000000005
32998,U37707,16,-1618.9800000000018,9,7,83843.1,82224.12000000001
32999,U36634,16,-7796.700000000003,10,6,28901.06,21104.36
33000,U20186,16,49914.41,8,8,54718.67,104633.08
33001,U41024,16,333.6799999999998,10,6,4589.49,4923.169999999999
33002,U28962,16,-80507.88,9,7,151963.97,71456.09
33003,U40329,16,-86.47000000000116,11,5,72790.88,72704.41
33004,U24817,16,-1864.5799999999992,11,5,13763.220000000001,11898.640000000001
33005,U23707,16,-11676.460000000003,9,7,92124.34,80447.87999999999
33006,U19669,16,923.1299999999993,9,7,10790.9,11714.029999999999
33007,U20255,16,1535.5700000000002,11,5,2416.81,3952.38
33008,U34655,16,1432.95,10,6,5216.080000000001,6649.030000000001
33009,U29750,16,961.99,15,1,1039.01,2001.0
33010,U17398,16,10.519999999985448,7,9,207499.34000000003,207509.86000000002
33011,U962614,16,132.28,12,4,3587.72,3720.0
33012,U793153,16,-1190.4799999999998,16,0,1190.4799999999998,0.0
33013,U18663,16,-1424.0300000000193,10,6,100926.55000000002,99502.52
33014,U13511,16,3303.6799999999994,11,5,16879.82,20183.5
33015,U34091,16,-13138.189999999944,7,9,1254071.1099999999,1240932.92
33016,U35245,16,-6913.47,8,8,180315.0,173401.53
33017,U1153615,16,-33888.82,16,0,33888.82,0.0
33018,U1291188,16,-1013.5099999999989,10,6,11749.66,10736.150000000001
33019,U19674,16,-2322.9700000000003,10,6,19720.0,17397.03
33020,U13497,16,8688.859999999999,10,6,12270.77,20959.629999999997
33021,U16972,16,229.9200000000019,11,5,30042.85,30272.77
33022,U25013,16,-4891.9,12,4,8267.72,3375.8199999999997
33023,U38590,16,-2410.7100000000005,12,4,13025.0,10614.289999999999
33024,U24427,16,-1403.13,11,5,13019.99,11616.86
33025,U32088,16,4366.4000000000015,12,4,11199.919999999998,15566.32
33026,U31866,16,1662.8300000000004,6,10,16012.85,17675.68
33027,U8870,16,33371.78,11,5,72136.79000000001,105508.57
33028,U21740,16,349.59000000000003,14,2,194.86,544.45
33029,U28580,16,-840564.96,15,1,841039.0,474.04000000003725
33030,U34377,16,7514.62,9,7,11337.02,18851.64
33031,U35349,16,53009.22999999998,4,12,714870.69,767879.9199999999
33032,U37168,16,241.55999999999912,10,6,28336.13,28577.69
33033,U18864,16,4334.97,10,6,4910.95,9245.92
33034,U32676,16,12621.820000000002,8,8,34274.229999999996,46896.049999999996
33035,U21773,16,8863.5,10,6,3280.94,12144.44
33036,U10068,16,-16128.549999999996,6,10,78840.17,62711.62
33037,U26148,16,59963.37999999999,6,10,12119.88,72083.26
33038,U42279,16,-9098.62,11,5,29899.010000000002,20800.39
33039,U43863,16,-2375.3000000000006,12,4,55153.670000000006,52778.37
33040,U10761,16,-5848.39,12,4,6855.23,1006.8399999999992
33041,U43112,16,-88339.88999999997,10,6,652195.74,563855.85
33042,U41454,16,32167.930000000004,9,7,8738.66,40906.590000000004
33043,U43994,16,218.71999999999989,12,4,817.7,1036.4199999999998
33044,U1135268,16,101.25,7,9,8699.27,8800.52
33045,U11897,16,340.1399999999999,10,6,2590.0,2930.14
33046,U1169095,16,0.9699999999993452,11,5,8500.26,8501.23
33047,U13940,16,8960.779999999999,3,13,5489.14,14449.919999999998
33048,U22607,16,92424.84,9,7,197191.65,289616.49
33049,U33650,16,-41338.72,9,7,47144.25,5805.529999999999
33050,U29003,16,-11119.66,7,9,66000.0,54880.34
33051,U36431,16,-7051.749999999998,8,8,24353.95,17302.200000000004
33052,U15558,16,8116.719999999998,11,5,14287.960000000001,22404.68
33053,U903275,16,-3114.7400000000002,14,2,3115.2000000000003,0.4600000000000364
33054,U41559,16,17341.9,9,7,46738.0,64079.9
33055,U35507,16,-13557.83,13,3,15314.0,1756.17
33056,U18958,16,-37795.020000000004,9,7,67421.0,29625.979999999996
33057,U23713,16,-200523.18,7,9,931383.0,730859.8200000001
33058,U37811,16,-284.87,13,3,358.7799999999999,73.90999999999991
33059,U10048,16,-2155.719999999996,8,8,24645.07,22489.350000000002
33060,U31838,16,336.520000000002,10,6,53907.16,54243.68000000001
33061,U22340,16,-21949.35,5,11,40988.2,19038.85
33062,U991991,16,-12275.93,10,6,12310.93,35.0
33063,U22446,16,-11829.010000000006,8,8,47073.57,35244.56
33064,U43227,16,-7027.95,12,4,9400.509999999997,2372.5599999999968
33065,U21012,16,75101.47,7,9,30985.0,106086.47
33066,U989224,16,1081.5099999999998,9,7,7105.500000000001,8187.01
33067,U42076,16,1087.99,11,5,2881.42,3969.41
33068,U36542,16,-845.17,10,6,10893.0,10047.83
33069,U1327106,16,10572.01,9,7,40755.08,51327.090000000004
33070,U1161344,16,-131.97000000000003,9,7,3240.23,3108.26
33071,U14736,16,74631.40000000001,8,8,6088.250000000001,80719.65000000001
33072,U28319,16,-454.6599999999753,6,10,436168.50999999995,435713.85
33073,U29779,16,-21504.290000000005,11,5,104157.20000000001,82652.91
33074,U724818,16,-15673.820000000002,12,4,15733.820000000002,60.0
33075,U36518,16,29661.059999999998,7,9,185174.75999999998,214835.81999999998
33076,U20748,16,400.1400000000003,11,5,9319.55,9719.689999999999
33077,U39593,16,-2564.78,13,3,5085.0,2520.22
33078,U17227,16,145821.66000000015,3,13,5000000.0,5145821.66
33079,U28569,16,225.8399999999965,5,11,59538.2,59764.03999999999
33080,U38608,16,225.4899999999907,7,9,314400.0,314625.49
33081,U42624,16,-22089.98,12,4,26258.02,4168.040000000001
33082,U34138,16,-1456.53,11,5,3967.5999999999995,2511.0699999999997
33083,U34202,16,-1726.7899999999997,9,7,12060.249999999998,10333.46
33084,U38186,16,-295.84000000000003,13,3,992.53,696.6899999999999
33085,U1074894,16,-293.2199999999999,11,5,1184.46,891.2400000000001
33086,U43033,16,-3.950000000000273,9,7,8241.789999999999,8237.839999999998
33087,U22842,16,-63.13000000000102,9,7,34068.3,34005.17
33088,U766592,16,399.619999999999,8,8,12023.98,12423.599999999999
33089,U19607,16,-1412854.6500000001,10,6,2956811.2199999997,1543956.5699999996
33090,U26978,16,-3706.880000000001,12,4,17466.09,13759.21
33091,U40742,16,562.0699999999999,8,8,1181.24,1743.31
33092,U24945,16,9664.760000000046,5,11,701954.22,711618.98
33093,U30364,16,12612.180000000006,7,9,115003.95999999999,127616.14
33094,U684689,16,3756.5800000000004,3,13,6988.0,10744.58
33095,U37601,16,6288.989999999998,9,7,49410.0,55698.99
33096,U23220,16,-5114.8099999999995,11,5,17594.5,12479.69
33097,U43322,16,1578.5100000000002,9,7,6394.08,7972.59
33098,U20410,16,-5697.27,10,6,25801.84,20104.57
33099,U18227,16,23640.91,7,9,168570.55,192211.46
33100,U24298,16,0.8699999999953434,7,9,980000.0,980000.87
33101,U21077,16,496.0799999999981,10,6,21609.850000000002,22105.93
33102,U37161,16,12.409999999999968,6,10,11656.0,11668.41
33103,U16213,16,-5591.680000000002,8,8,65135.27999999999,59543.59999999999
33104,U30293,16,-7261.929999999999,11,5,10018.06,2756.13
33105,U802448,16,-30679.31,12,4,35501.74999999999,4822.439999999991
33106,U40958,16,-14999.529999999999,10,6,63506.0,48506.47
33107,U36839,16,-930.04,7,9,5905.6,4975.56
33108,U24214,16,861.7700000000023,9,7,29500.46,30362.230000000003
33109,U18656,16,362.5100000000093,10,6,616238.45,616600.96
33110,U25506,16,138309.78,8,8,233693.88,372003.66000000003
33111,U27990,16,-16874.24,7,9,75772.82,58898.58
33112,U23578,16,-180.2099999999973,4,12,53323.92,53143.71
33113,U1200687,16,6590.200000000001,8,8,9911.39,16501.59
33114,U37079,16,15654.41,9,7,245.5,15899.91
33115,U33869,16,-14795.81,10,6,21791.29,6995.480000000001
33116,U8035,16,-495801.68999999994,6,10,713076.0,217274.31000000006
33117,U34832,16,218074.76999999996,3,13,250000.0,468074.76999999996
33118,U589062,16,-1479.56,12,4,5913.83,4434.27
33119,U25876,16,607.3099999999995,10,6,22452.2,23059.510000000002
33120,U29952,16,92195.22999999998,9,7,130142.83,222338.06
33121,U38080,16,-935.42,10,6,2616.2599999999998,1680.8399999999997
33122,U13295,16,-9499.159999999996,11,5,153910.52,144411.36
33123,U9866,16,1227.0700000000002,8,8,2531.59,3758.6600000000003
33124,U43481,16,603.499999999999,8,8,28733.34,29336.84
33125,U19180,16,3758.699999999999,11,5,11919.7,15678.4
33126,U34739,16,51970.950000000004,7,9,2926.9,54897.850000000006
33127,U33378,16,-11317.480000000001,10,6,29015.199999999997,17697.719999999994
33128,U22360,16,-2892.2800000000007,11,5,5286.170000000001,2393.8900000000003
33129,U977863,16,2567.74,11,5,7416.7300000000005,9984.470000000001
33130,U36519,16,3454.6,9,7,3285.12,6739.719999999999
33131,U1137517,16,4844.7300000000005,11,5,3107.27,7952.0
33132,U37297,16,-1341.98,10,6,1667.95,325.97
33133,U25536,16,-941.6800000000003,11,5,18750.0,17808.32
33134,U27565,16,-3338.709999999999,10,6,10965.039999999999,7626.33
33135,U13805,16,-4240.32,10,6,8383.830000000002,4143.510000000002
33136,U40284,16,33512.14,10,6,69178.1,102690.24
33137,U27318,16,640.0700000000002,10,6,1770.0,2410.07
33138,U33179,16,13190.2,13,3,1588.8500000000001,14779.050000000001
33139,U39357,16,42893.93,6,10,46568.0,89461.93
33140,U9679,16,47660.64,12,4,5090.58,52751.22
33141,U18994,16,1965.4800000000005,10,6,19435.059999999998,21400.539999999997
33142,U8638,16,-3802.989999999999,13,3,8833.02,5030.030000000002
33143,U38399,16,-245.71000000000012,12,4,2515.9,2270.19
33144,U39807,16,32012.790000000037,6,10,275024.0,307036.79000000004
33145,U24737,16,-417.44,15,1,433.90999999999997,16.46999999999997
33146,U26716,16,-58479.16,12,4,65368.9,6889.739999999998
33147,U13098,16,261.1199999999993,8,8,7984.44,8245.56
33148,U36775,16,3487.840000000002,5,11,64864.81,68352.65
33149,U37979,16,-441.5600000000004,9,7,27920.28,27478.719999999998
33150,U20900,16,-952.4699999999998,11,5,10294.73,9342.26
33151,U1240686,16,422.0,14,2,4349.0,4771.0
33152,U18468,16,-45967.23,9,7,447580.04,401612.81
33153,U25719,16,-4553.48,10,6,30327.699999999997,25774.219999999998
33154,U39120,16,2242.9500000000003,12,4,5070.0,7312.950000000001
33155,U42022,16,-89.99000000000001,11,5,647.99,558.0
33156,U677886,16,-9835.61,13,3,10894.0,1058.3899999999994
33157,U39118,16,13452.71000000008,9,7,467517.04,480969.75000000006
33158,U41897,16,17270.71,5,11,11353.029999999999,28623.739999999998
33159,U37280,16,11090.999999999998,13,3,10009.000000000002,21100.0
33160,U1088264,16,-1.5798473640415978e-13,10,6,3610.7900000000004,3610.7900000000004
33161,U1060815,16,535.27,9,7,2607.0,3142.27
33162,U27273,16,42979.71000000001,4,12,5500.0,48479.71000000001
33163,U11189,16,12684.1,10,6,1944.9,14629.0
33164,U38592,16,2082245.8400000003,4,12,1056840.78,3139086.62
33165,U26861,16,1.1799999999998363,10,6,7852.59,7853.77
33166,U23263,16,-19784.609999999997,12,4,21615.359999999997,1830.75
33167,U13175,16,154.0699999999997,8,8,13846.36,14000.43
33168,U25686,16,1643.29,7,9,8720.380000000001,10363.670000000002
33169,U20569,16,95.21000000000004,10,6,17414.17,17509.379999999997
33170,U36978,16,8675.33,5,11,20912.45,29587.78
33171,U35976,16,-1541.4300000000003,11,5,9744.369999999999,8202.939999999999
33172,U35487,16,1279.7300000000023,12,4,21721.39,23001.120000000003
33173,U34300,16,-24964.119999999995,11,5,110999.0,86034.88
33174,U41458,16,-99774.83,13,3,106108.17,6333.3399999999965
33175,U25163,16,-231877.14,11,5,239489.21,7612.069999999978
33176,U17452,16,641.4299999999998,13,3,3359.46,4000.89
33177,U34374,16,-23804.620000000003,10,6,50361.340000000004,26556.72
33178,U1339331,16,-6082.59,13,3,6682.01,599.4200000000001
33179,U34937,16,568.8399999999983,5,11,32200.0,32768.84
33180,U34822,16,16538.339999999997,6,10,235571.22,252109.56
33181,U41975,16,1013.22,13,3,3586.78,4600.0
33182,U29757,16,137.9,10,6,196.94999999999996,334.84999999999997
33183,U25207,16,-215.76000000000118,7,9,66624.31,66408.55
33184,U25780,16,-14224.81,12,4,22340.3,8115.49
33185,U8788,16,4061.5,6,10,43156.0,47217.5
33186,U1181818,16,-685.7799999999994,12,4,8185.78,7500.0
33187,U32160,16,-99.3799999999992,13,3,12407.7,12308.320000000002
33188,U42899,16,-34863.79,12,4,49706.0,14842.21
33189,U39078,16,-16774.989999999998,9,7,19748.0,2973.010000000002
33190,U38573,16,-15716.490000000009,5,11,125689.0,109972.51
33191,U28354,16,14540.460000000003,12,4,11346.0,25886.460000000003
33192,U734894,16,-450.57000000000005,10,6,1331.4599999999998,880.8899999999998
33193,U643406,16,-15328.069999999998,13,3,20984.96,5656.890000000001
33194,U11774,16,441.65,10,6,703.65,1145.3
33195,U26648,16,-2157.4400000000014,12,4,31392.019999999997,29234.579999999994
33196,U21328,16,-5456.440000000001,9,7,77126.67,71670.23
33197,U21654,16,448.61,8,8,752.0,1200.6100000000001
33198,U18313,16,75873.63,9,7,187007.24000000002,262880.87
33199,U42249,16,-333.43,13,3,9848.7,9515.27
33200,U40837,16,7494.100000000002,9,7,27379.300000000003,34873.40000000001
33201,U619711,16,814.08,9,7,1232.08,2046.1599999999999
33202,U902429,16,42.15000000000009,13,3,5632.9,5675.049999999999
33203,U29315,16,22191.190000000002,6,10,3628.59,25819.780000000002
33204,U31288,16,1.6299999999999049,9,7,2345.3799999999997,2347.0099999999998
33205,U679686,16,963.4499999999998,13,3,7036.57,8000.0199999999995
33206,U40588,16,-16758.78,11,5,21770.53,5011.75
33207,U40522,16,8607.09,9,7,9853.61,18460.7
33208,U30555,16,4144.21,8,8,21135.260000000002,25279.47
33209,U28185,16,14056.429999999995,9,7,35796.340000000004,49852.77
33210,U37311,16,7585.74,9,7,28600.0,36185.74
33211,U15070,16,550.7899999999998,13,3,2568.61,3119.4
33212,U42719,16,98.24000000000888,8,8,79024.2,79122.44
33213,U13436,16,28378.15,2,14,41002.0,69380.15
33214,U13705,16,-3965.6799999999985,10,6,74100.28,70134.6
33215,U43569,16,3195.0000000000005,10,6,13174.25,16369.25
33216,U12724,16,-3481.3,12,4,11984.78,8503.48
33217,U43018,16,315995.12999999995,6,10,163920.0,479915.12999999995
33218,U19219,16,535.3299999999999,13,3,587.14,1122.4699999999998
33219,U43648,16,45.02,13,3,312.92,357.94
33220,U15301,16,98207.85,7,9,1875.0300000000002,100082.88
33221,U14524,16,88133.87,5,11,50576.76,138710.63
33222,U32535,16,-3654.7400000000002,12,4,3982.2000000000003,327.46000000000004
33223,U18987,16,-579.9699999999982,8,8,38681.02,38101.049999999996
33224,U39238,16,-5201.299999999992,11,5,72870.73,67669.43000000001
33225,U29638,16,0.860000000000035,13,3,1432.1599999999999,1433.02
33226,U25723,16,1327.1899999999996,14,2,3507.9600000000005,4835.15
33227,U1105943,16,-643.3199999999999,12,4,668.81,25.49000000000001
33228,U31575,16,-485.93000000000006,11,5,1119.86,633.9299999999998
33229,U33681,16,4427.9800000000005,5,11,13163.35,17591.33
33230,U31225,16,9957.279999999999,8,8,284592.0,294549.28
33231,U38712,16,-141672.17,15,1,142052.1,379.929999999993
33232,U30105,16,-113142.15000000002,9,7,176026.5,62884.34999999998
33233,U38783,16,-5500.43,10,6,14386.0,8885.57
33234,U43637,16,-51.879999999999995,11,5,294.0,242.12
33235,U19040,16,17392.339999999997,7,9,4331.15,21723.489999999998
33236,U19372,16,-1444.699999999997,7,9,23546.0,22101.300000000003
33237,U30460,16,-4069.8399999999997,10,6,26870.0,22800.16
33238,U43692,16,3978.380000000001,8,8,33399.64,37378.020000000004
33239,U36643,16,1015.0999999999999,11,5,19605.0,20620.1
33240,U39047,16,-81806.69,9,7,84504.48,2697.7899999999936
33241,U973459,16,-2269.8999999999996,15,1,2277.8999999999996,8.0
33242,U36513,16,8193.85,7,9,63818.740000000005,72012.59000000001
33243,U1113080,16,-1868.8200000000004,14,2,3095.03,1226.2099999999998
33244,U39769,16,55466.33,8,8,49684.26,105150.59
33245,U24776,16,-2730.9100000000003,12,4,5244.360000000001,2513.4500000000003
33246,U39000,16,2177262.64,7,9,12466.0,2189728.64
33247,U11190,16,-14147.199999999999,9,7,22392.949999999997,8245.749999999998
33248,U24294,16,14611.369999999999,7,9,20661.850000000002,35273.22
33249,U16914,16,647.7599999997765,9,7,4004769.6399999997,4005417.3999999994
33250,U35360,16,-167.11999999996385,8,8,554500.0,554332.88
33251,U618289,16,-5.600000000000051,10,6,2197.6200000000003,2192.0200000000004
33252,U18942,16,3162.489999999998,9,7,35119.68,38282.17
33253,U1179251,16,-41472.0,9,7,44372.01,2900.010000000002
33254,U31945,16,2087.6200000000003,7,9,5774.360000000001,7861.980000000001
33255,U13072,16,-7918.900000000001,9,7,15502.0,7583.099999999999
33256,U12449,16,199236.29000000004,9,7,210566.52,409802.81000000006
33257,U20955,16,488.5400000000098,10,6,264311.73,264800.27
33258,U9123,16,-95672.00999999998,6,10,158672.95,63000.94000000003
33259,U29099,16,-477.4800000000006,9,7,10210.41,9732.929999999998
33260,U43599,16,-3791.7799999999997,9,7,17816.350000000002,14024.570000000003
33261,U36708,16,-172.48999999999978,8,8,10513.89,10341.4
33262,U32114,16,255.91999999999825,11,5,55381.96,55637.88
33263,U24951,16,-8953.719999999998,10,6,43686.78,34733.06
33264,U12511,16,147349.82,6,10,162060.6,309410.42000000004
33265,U15251,16,-229.94000000000233,8,8,161373.3,161143.36
33266,U24756,16,428.65000000000043,10,6,6852.44,7281.09
33267,U19945,16,115835.54,5,11,100063.5,215899.03999999998
33268,U33699,16,85670.66,11,5,19753.54,105424.20000000001
33269,U33085,16,254.09000000000015,10,6,5849.6,6103.6900000000005
33270,U19745,16,4530.39,12,4,40577.219999999994,45107.60999999999
33271,U31895,16,79606.57999999999,9,7,15682.84,95289.41999999998
33272,U688653,16,56.170000000000435,10,6,12017.61,12073.78
33273,U8722,16,4826.129999999997,9,7,37153.74999999999,41979.87999999999
33274,U19110,16,24295.69,7,9,8804.599999999999,33100.28999999999
33275,U40306,16,351.5299999999999,6,10,109783.16,110134.69
33276,U10668,16,-15299.38,11,5,98774.0,83474.62
33277,U41580,16,3080.240000000001,9,7,25931.69,29011.93
33278,U36370,16,-29.479999999999933,10,6,3328.7,3299.22
33279,U21827,16,9264.45,10,6,4175.98,13440.43
33280,U19262,16,1579.070000000001,9,7,14320.78,15899.850000000002
33281,U38281,16,10058.8,11,5,3950.4,14009.199999999999
33282,U28877,16,-32887.600000000006,5,11,98292.0,65404.399999999994
33283,U16222,16,-2078.29,11,5,13878.65,11800.36
33284,U41886,16,159132.33000000002,8,8,22619.62,181751.95
33285,U30146,16,-7203.880000000001,12,4,14028.880000000001,6825.0
33286,U37351,16,2727.5499999999993,8,8,13610.7,16338.25
33287,U17081,16,-12085.78,8,8,21211.280000000002,9125.500000000002
33288,U43369,16,7829.869999999986,3,13,310000.0,317829.87
33289,U1151632,16,37.930000000000035,13,3,548.5699999999999,586.5
33290,U18603,16,-400.1200000000015,10,6,28100.329999999998,27700.209999999995
33291,U31206,16,-2707.48,12,4,4312.34,1604.8600000000001
33292,U38834,16,-44740.0,11,5,78906.0,34166.0
33293,U1075556,16,-10.459999999999127,10,6,10660.14,10649.68
33294,U21307,16,3185.670000000019,6,10,450000.0,453185.67000000004
33295,U731119,16,-291.10000000000036,10,6,16852.11,16561.010000000002
33296,U20334,16,-1197.8700000000003,9,7,6022.67,4824.799999999999
33297,U34877,16,2154.71,9,7,5662.629999999999,7817.339999999999
33298,U15952,16,-1819.0699999999993,10,6,7144.829999999999,5325.76
33299,U43087,16,45.11000000016065,11,5,2725111.9499999997,2725157.06
33300,U1328906,16,1926.6300000000006,14,2,1287.4699999999996,3214.1000000000004
33301,U32910,16,458.01000000000005,11,5,675.8799999999999,1133.8899999999999
33302,U14185,16,-21089.37,11,5,46351.3,25261.930000000004
33303,U629821,16,3.0599999999998864,8,8,1269.14,1272.2
33304,U39276,16,28024.430000000004,6,10,84682.98,112707.41
33305,U28968,16,-4145.330000000002,9,7,30000.0,25854.67
33306,U14657,16,16.03999999999997,11,5,818.3599999999999,834.3999999999999
33307,U1330579,16,-292.28999999999996,13,3,2408.3,2116.01
33308,U23118,16,-542.9799999999998,14,2,3790.64,3247.66
33309,U43986,16,510.0,7,9,767010.0,767520.0
33310,U9394,16,-22043.98,10,6,28707.579999999998,6663.5999999999985
33311,U25280,16,-1046.0899999999992,9,7,14178.51,13132.420000000002
33312,U32644,16,-28869.289999999997,11,5,65231.2,36361.91
33313,U24739,16,14259.7,12,4,1109.8,15369.5
33314,U1041148,16,-3591.72,11,5,13690.269999999999,10098.55
33315,U18224,16,-1812.2000000000146,11,5,109873.42,108061.21999999999
33316,U32005,16,-186.37999999999738,13,3,60189.5,60003.12
33317,U1273915,16,31.169999999998254,10,6,32029.940000000002,32061.11
33318,U10096,16,35953.83,8,8,107036.90000000001,142990.73
33319,U40551,16,6131.0199999999995,7,9,28179.24,34310.26
33320,U11177,16,4.020000000000209,8,8,2318.3599999999997,2322.38
33321,U903478,16,661.3699999999999,10,6,4639.19,5300.5599999999995
33322,U37520,16,-4692.0,9,7,24397.699999999997,19705.699999999997
33323,U34639,16,24777.52,9,7,23419.48,48197.0
33324,U34020,16,4211.6600000000035,9,7,41893.43,46105.090000000004
33325,U27370,16,1088.6899999999996,6,10,8975.82,10064.509999999998
33326,U34314,16,12730.409999999996,10,6,39570.770000000004,52301.18
33327,U642812,16,-3209.57,9,7,4212.57,1002.9999999999995
33328,U21796,16,-27510.219999999998,12,4,41310.1,13799.880000000001
33329,U13869,16,-1445.8000000000065,6,10,85633.28,84187.48
33330,U628262,16,11189.02,8,8,2817.14,14006.16
33331,U29940,16,-89.11999999999969,12,4,5352.389999999999,5263.2699999999995
33332,U27283,16,37.359999999996944,6,10,176102.0,176139.36
33333,U37328,16,-308.58000000000175,9,7,104735.0,104426.42
33334,U21573,16,-149.61999999999898,9,7,26899.61,26749.99
33335,U9772,16,887.9300000000001,5,11,1895.9,2783.83
33336,U43167,16,10795.18,5,11,11978.73,22773.91
33337,U33592,16,101.31999999999994,13,3,3298.9,3400.2200000000003
33338,U43982,16,-7849.5,13,3,15849.769999999999,8000.269999999999
33339,U24719,16,-3769.7599999999998,9,7,5017.82,1248.06
33340,U21575,16,-43532.73,6,10,95206.0,51673.27
33341,U33798,16,-1308.9599999999998,11,5,4056.2999999999997,2747.34
33342,U32759,16,4932.049999999999,7,9,56942.84,61874.89
33343,U38202,16,22.570000000000075,6,10,24611.9,24634.47
33344,U40023,16,-53.17999999999847,10,6,16653.239999999998,16600.059999999998
33345,U41704,16,-399.5400000000017,9,7,205422.83000000002,205023.29
33346,U1029553,16,-206.25,11,5,607.3499999999999,401.0999999999999
33347,U25459,16,5168.889999999996,6,10,87812.0,92980.89
33348,U1095072,16,876.3100000000004,13,3,2074.95,2951.26
33349,U17289,16,-82646.08,9,7,110077.28,27431.199999999997
33350,U22428,16,-2180.84,13,3,5504.44,3323.5999999999995
33351,U11651,16,-926.1200000000026,9,7,67258.93,66332.81
33352,U21580,16,4854.880000000005,8,8,104034.0,108888.88
33353,U15527,16,-199179.15999999997,8,8,215826.53,16647.370000000024
33354,U37006,16,43320.270000000004,6,10,12011.8,55332.07000000001
33355,U13547,16,-372.1400000000003,7,9,8484.8,8112.659999999999
33356,U22488,16,3327.32,12,4,7174.2,10501.52
33357,U34564,16,-27.309999999995938,9,7,73090.48,73063.17
33358,U39440,16,-1890.06,10,6,5641.0,3750.94
33359,U19857,16,-760.2299999999998,10,6,4763.32,4003.09
33360,U43947,16,710.6899999999999,11,5,1263.47,1974.1599999999999
33361,U32293,16,-34.479999999995925,9,7,89870.5,89836.02
33362,U30016,16,3361.2000000000007,12,4,8138.799999999999,11500.0
33363,U18934,16,65586.75000000001,10,6,162441.41999999998,228028.16999999998
33364,U42811,16,-19878.510000000002,14,2,23839.32,3960.8099999999977
33365,U26308,16,-1210.4400000000023,7,9,29099.95,27889.51
33366,U38105,16,1676.1500000000005,13,3,3974.24,5650.39
33367,U9938,16,-16020.95,11,5,28488.36,12467.41
33368,U926209,16,-284.52,13,3,287.28000000000003,2.7600000000000477
33369,U1161096,16,-2898.75,12,4,3858.66,959.9099999999999
33370,U33656,16,25256.91,12,4,4938.1900000000005,30195.1
33371,U32481,16,-20054.64,8,8,69841.1,49786.46000000001
33372,U18407,16,-3331.620000000001,11,5,7458.620000000001,4127.0
33373,U10037,16,-22263.250000000004,6,10,126228.58,103965.33
33374,U1102719,16,3456.93,5,11,1025.71,4482.639999999999
33375,U11461,16,325.8199999999979,8,8,56646.48,56972.3
33376,U20929,16,-506.65000000000146,10,6,30932.29,30425.64
33377,U10976,16,-22396.329999999998,8,8,87533.62,65137.28999999999
33378,U39186,16,402.3299999999999,11,5,4570.0,4972.33
33379,U26700,16,-4131.549999999999,12,4,25131.71,21000.16
33380,U1249538,16,-3410.7200000000003,9,7,4208.74,798.0199999999995
33381,U25779,16,13298.439999999999,11,5,1120337.94,1133636.38
33382,U24505,16,-26015.959999999995,11,5,37812.4,11796.440000000006
33383,U8620,16,9975.45,9,7,20257.66,30233.11
33384,U22171,16,591.0799999999971,8,8,49904.63,50495.70999999999
33385,U20606,16,-338.5499999999993,11,5,13639.56,13301.01
33386,U800809,16,-19.060000000000173,10,6,5421.2,5402.139999999999
33387,U40262,16,39.669999999999845,10,6,1669.76,1709.4299999999998
33388,U27898,16,5147.33,9,7,838.97,5986.3
33389,U9818,16,957.5299999999997,9,7,6245.4,7202.929999999999
33390,U23354,16,8170.6900000000005,5,11,28564.660000000003,36735.350000000006
33391,U31883,16,-5507.04,13,3,6991.500000000001,1484.460000000001
33392,U36622,16,-169456.79000000004,7,9,172765.1,3308.3099999999686
33393,U11650,16,-2262.770000000001,8,8,18002.0,15739.23
33394,U23418,16,-102750.68,8,8,233812.75,131062.07
33395,U25990,16,3791.53,11,5,28650.4,32441.93
33396,U39272,16,-224.5199999999968,8,8,54115.32000000001,53890.80000000001
33397,U591462,16,1316.059999999999,11,5,14192.58,15508.64
33398,U33316,16,-32.229999999974275,8,8,166694.64,166662.41000000003
33399,U29407,16,0.0,9,7,11678.4,11678.4
33400,U40029,15,2814.1900000000005,8,7,15782.18,18596.370000000003
33401,U16499,15,98650.11000000002,6,9,3524.8700000000003,102174.98000000001
33402,U27926,15,8100.6500000000015,10,5,9294.0,17394.65
33403,U776731,15,-1851.5,13,2,5389.0,3537.5
33404,U42331,15,-535.48,10,5,2395.84,1860.3600000000001
33405,U20519,15,-320.49,12,3,4189.410000000001,3868.920000000001
33406,U21418,15,-16091.939999999995,9,6,60330.71,44238.770000000004
33407,U34993,15,97.9899999999999,7,8,2040.52,2138.5099999999998
33408,U19692,15,606.830000000007,5,10,141488.99,142095.82
33409,U8483,15,2221.62,8,7,3104.5099999999998,5326.129999999999
33410,U19494,15,597.9100000000001,10,5,2689.07,3286.9800000000005
33411,U32418,15,-264.21000000000004,9,6,5064.79,4800.58
33412,U29858,15,15455.3,8,7,11803.2,27258.5
33413,U12261,15,-2049.5899999999965,10,5,101413.0,99363.41
33414,U31541,15,-1630.77,10,5,4007.66,2376.89
33415,U40100,15,2349.5800000000017,4,11,506300.0,508649.58
33416,U24363,15,19999.999999999996,6,9,239980.0,259980.0
33417,U27586,15,426.74999999999955,10,5,7752.629999999999,8179.379999999999
33418,U28946,15,204.18000000000114,10,5,17786.440000000002,17990.620000000003
33419,U10244,15,-2370.2199999999957,6,9,104360.39,101990.17
33420,U8608,15,2933.91,10,5,13657.98,16591.89
33421,U11849,15,11270.08,5,10,9018.9,20288.98
33422,U20392,15,-12311.439999999999,10,5,22769.49,10458.050000000003
33423,U31972,15,23353.840000000022,4,11,406781.23,430135.07
33424,U35164,15,-38033.74999999999,8,7,151350.0,113316.25
33425,U37907,15,-1372.0700000000002,9,6,5898.88,4526.8099999999995
33426,U1129264,15,-196.67,11,4,1496.6499999999999,1299.9799999999998
33427,U10067,15,272.8699999999999,6,9,5830.0,6102.87
33428,U29997,15,601.44,9,6,3781.06,4382.5
33429,U29245,15,28704.960000000006,9,6,31300.41,60005.37000000001
33430,U17913,15,-44659.280000000006,12,3,48319.50000000001,3660.220000000001
33431,U34326,15,-29569.89,9,6,55016.94,25447.050000000003
33432,U12549,15,15950.099999999968,7,8,1012924.0,1028874.1
33433,U668579,15,710.9999999999995,9,6,9952.41,10663.41
33434,U12698,15,-24964.29,13,2,47164.24999999999,22199.959999999992
33435,U33925,15,20985.719999999998,6,9,13107.220000000001,34092.94
33436,U1024151,15,2855.92,12,3,734.0799999999999,3590.0
33437,U24556,15,-1689.9799999999996,8,7,28110.420000000002,26420.440000000002
33438,U758733,15,5302.0,2,13,1.6500000000000001,5303.65
33439,U38361,15,5004.7300000000005,7,8,11384.09,16388.82
33440,U11820,15,-136.4699999999998,8,7,10648.99,10512.52
33441,U19010,15,-12643.23999999999,8,7,1602772.0,1590128.76
33442,U12960,15,197.02999999999997,8,7,2935.0,3132.0299999999997
33443,U11468,15,1156.36,11,4,283.76,1440.12
33444,U22336,15,18520.59000000001,5,10,429144.5,447665.09
33445,U23244,15,3697.12,11,4,7448.93,11146.05
33446,U13313,15,3321.400000000001,7,8,9875.06,13196.460000000001
33447,U36672,15,9699.86,8,7,212902.0,222601.86
33448,U24207,15,-14.680000000002906,9,6,111166.01,111151.32999999999
33449,U755606,15,-2119.4900000000007,8,7,15775.0,13655.509999999998
33450,U986359,15,-7734.15,10,5,7999.17,265.02000000000044
33451,U668286,15,8752.36,5,10,11626.34,20378.7
33452,U1132390,15,41.48999999999988,9,6,3509.6699999999996,3551.1599999999994
33453,U40893,15,-29921.960000000006,4,11,113940.82,84018.86
33454,U1364569,15,1554.9500000000003,8,7,4428.18,5983.130000000001
33455,U26229,15,1923.5,10,5,3620.8700000000003,5544.370000000001
33456,U1335175,15,-3146.5200000000004,14,1,3751.9100000000003,605.3899999999999
33457,U43439,15,-3223.1700000000014,10,5,57064.880000000005,53841.71000000001
33458,U21749,15,16007.550000000001,6,9,32700.0,48707.55
33459,U844965,15,-4703.97,11,4,7230.0,2526.0299999999997
33460,U950872,15,-20.12000000000012,10,5,3901.8999999999996,3881.7799999999997
33461,U38427,15,-495.28999999999996,8,7,10860.55,10365.259999999998
33462,U1242305,15,2.0599999999999454,10,5,4138.0,4140.0599999999995
33463,U42404,15,-9546.45,12,3,14554.0,5007.549999999999
33464,U953261,15,400.0,10,5,5600.0,6000.0
33465,U35756,15,-12253.13,8,7,39944.36,27691.230000000003
33466,U32735,15,19862.08,12,3,28270.92,48133.0
33467,U17651,15,301.1600000000035,7,8,94199.0,94500.16
33468,U27315,15,29.140000000000327,11,4,13260.3,13289.439999999999
33469,U29435,15,-547287.1100000001,7,8,920033.02,372745.9099999999
33470,U37202,15,-1094.0800000000008,11,4,12176.52,11082.439999999999
33471,U35498,15,-235589.18,5,10,485000.0,249410.82
33472,U21987,15,194.12000000000262,7,8,38508.0,38702.12
33473,U18672,15,7976.41,2,13,9143.94,17120.35
33474,U970599,15,-5236.24,13,2,5437.239999999999,200.9999999999991
33475,U41143,15,245.7800000000001,11,4,4668.849999999999,4914.629999999999
33476,U1270329,15,15796.619999999999,5,10,15296.619999999999,31093.239999999998
33477,U1022419,15,-42.77000000000132,10,5,8075.02,8032.249999999999
33478,U8104,15,286.4500000000007,6,9,58700.0,58986.45
33479,U23929,15,-4501.900000000001,6,9,527649.97,523148.06999999995
33480,U22531,15,-25441.0,10,5,29518.7,4077.7000000000007
33481,U13895,15,-512.1099999999998,6,9,879.2,367.09000000000026
33482,U1311766,15,-1160.37,11,4,1872.1699999999998,711.8
33483,U612609,15,-3317.9100000000008,10,5,11019.41,7701.499999999999
33484,U19698,15,-4509.61,4,11,23674.73,19165.12
33485,U29796,15,1481.2500000000002,8,7,4874.75,6356.0
33486,U11776,15,22563.07,11,4,8354.0,30917.07
33487,U18543,15,-9440.18,11,4,17731.38,8291.2
33488,U8828,15,-29045.01,9,6,44089.58,15044.570000000003
33489,U21896,15,-376.02000000000044,5,10,25720.0,25343.98
33490,U1253646,15,-18442.25,13,2,18457.76,15.5099999999984
33491,U19190,15,599.6899999999937,9,6,50570.12,51169.81
33492,U751244,15,3320.0,8,7,190.0,3510.0
33493,U1076075,15,330.1300000000002,9,6,1871.3099999999997,2201.44
33494,U31643,15,2175.89,10,5,14829.83,17005.72
33495,U34667,15,-29.0,14,1,50.0,21.0
33496,U31019,15,-16523.52,7,8,20315.960000000003,3792.4400000000023
33497,U40214,15,3735.689999999944,7,8,5057199.22,5060934.91
33498,U39304,15,-42.340000000000074,11,4,13085.0,13042.66
33499,U760211,15,-1.1368683772161603e-13,8,7,2008.0100000000002,2008.0100000000002
33500,U8567,15,241312.12,3,12,160000.0,401312.12
33501,U24123,15,-1145.5100000000002,10,5,4737.25,3591.74
33502,U20836,15,-2411.17,11,4,11349.289999999999,8938.119999999999
33503,U42949,15,-6.439999999999998,11,4,103.82,97.38
33504,U1205386,15,5966.620000000001,12,3,4267.380000000001,10234.000000000002
33505,U37164,15,1403.7699999999998,11,4,4927.83,6331.599999999999
33506,U18756,15,-2.7899999999999636,5,10,2556.0,2553.21
33507,U40729,15,222.4500000000003,5,10,160636.59,160859.04
33508,U714673,15,2461.87,8,7,8576.330000000002,11038.2
33509,U40018,15,23572.39,2,13,19136.69,42709.08
33510,U23655,15,63593.8200000003,6,9,5401637.0,5465230.82
33511,U17883,15,1089.2700000000002,9,6,4123.82,5213.09
33512,U38095,15,2732.3,8,7,9701.599999999999,12433.899999999998
33513,U35961,15,-12379.599999999999,10,5,41178.17,28798.57
33514,U16736,15,124.83999999999862,10,5,47452.53000000001,47577.37000000001
33515,U31581,15,-25328.409999999996,5,10,168334.09999999998,143005.68999999997
33516,U29799,15,-1035.52,10,5,2387.28,1351.7600000000002
33517,U27922,15,600.16,6,9,64330.0,64930.16
33518,U35439,15,-4820.920000000002,10,5,74118.09,69297.17
33519,U16819,15,-203.21999999999886,8,7,25067.879999999997,24864.66
33520,U600372,15,652.7800000000001,6,9,2905.12,3557.9
33521,U29907,15,-1246.6199999999953,6,9,335800.0,334553.38
33522,U29972,15,1204.4600000000003,10,5,6176.219999999999,7380.679999999999
33523,U19834,15,-50593.08,6,9,153973.3,103380.21999999999
33524,U1098214,15,-1.7600000000000193,8,7,6333.65,6331.889999999999
33525,U11851,15,12717.35,7,8,16525.0,29242.35
33526,U36204,15,42653.37,6,9,3687.62,46340.990000000005
33527,U40354,15,-789.02,11,4,5270.93,4481.91
33528,U27923,15,-21728.620000000003,6,9,36304.20999999999,14575.58999999999
33529,U10498,15,20261.579999999998,6,9,25171.260000000002,45432.84
33530,U751133,15,329.7799999999995,9,6,4400.01,4729.79
33531,U678596,15,-26.43000000002212,11,4,157186.43,157159.99999999997
33532,U22720,15,-27817.92,9,6,38514.24,10696.32
33533,U32600,15,-3830.2199999999993,12,3,16004.55,12174.33
33534,U25128,15,-4078.689999999997,10,5,20645.0,16566.310000000005
33535,U27452,15,-30.610000000000582,10,5,13977.08,13946.47
33536,U9830,15,5127.6,7,8,61669.0,66796.6
33537,U27052,15,1767.8800000000301,5,10,502315.61,504083.49
33538,U33442,15,6275.15,2,13,5023.54,11298.689999999999
33539,U19337,15,-25134.2,7,8,27634.28,2500.079999999998
33540,U43638,15,7944.589999999999,3,12,2480.01,10424.599999999999
33541,U10968,15,0.0,7,8,205853.44,205853.44
33542,U23795,15,4511.16,9,6,6873.16,11384.32
33543,U1243314,15,-320.0,10,5,5350.57,5030.57
33544,U18494,15,1954.2099999999991,8,7,14350.0,16304.21
33545,U35477,15,4119.799999999999,4,11,32268.0,36387.8
33546,U37502,15,10486.289999999999,12,3,4394.6,14880.89
33547,U38987,15,-3230.209999999999,4,11,47000.0,43769.79
33548,U35189,15,1600.33,6,9,6300.32,7900.65
33549,U34110,15,4998.08,9,6,140.0,5138.08
33550,U41913,15,1139.1099999999994,9,6,31153.28,32292.39
33551,U42298,15,602.4499999999998,8,7,5400.0,6002.45
33552,U9239,15,-13898.44,10,5,15716.18,1817.7399999999998
33553,U41727,15,-23035.48,10,5,32534.66,9499.18
33554,U1127754,15,-1887.68,9,6,3689.75,1802.07
33555,U28822,15,-220.3000000000011,7,8,26717.899999999998,26497.6
33556,U25323,15,9557.110000000004,9,6,90268.5,99825.61
33557,U1218178,15,-61.659999999999854,10,5,6990.0,6928.34
33558,U37422,15,58800.57000000001,11,4,75782.0,134582.57
33559,U717241,15,-609.59,15,0,609.59,0.0
33560,U13389,15,-4967.35,10,5,21030.02,16062.67
33561,U41396,15,-22717.239999999998,14,1,22718.199999999997,0.9599999999991269
33562,U741476,15,468.36000000000007,12,3,1813.8100000000002,2282.17
33563,U15498,15,-899.45,13,2,5606.97,4707.52
33564,U1264364,15,177.0,10,5,997.15,1174.15
33565,U1053337,15,-12.29000000000001,10,5,828.2500000000002,815.9600000000003
33566,U11027,15,15133.709999999957,8,7,1021859.58,1036993.2899999999
33567,U30256,15,-280.089999999851,11,4,4001352.98,4001072.89
33568,U12893,15,2818.9700000000003,8,7,561.88,3380.8500000000004
33569,U36001,15,29947.15,8,7,37225.4,67172.55
33570,U24564,15,0.0,10,5,472.91999999999996,472.91999999999996
33571,U42661,15,81525.57,6,9,1052097.06,1133622.6300000001
33572,U18622,15,-1751.49,13,2,1762.84,11.349999999999909
33573,U32811,15,29099.999999999996,6,9,38590.34,67690.34
33574,U38033,15,-19991.71,7,8,70089.9,50098.189999999995
33575,U16453,15,-9691.449999999999,9,6,30070.109999999997,20378.659999999996
33576,U10063,15,-4509.79,9,6,9395.93,4886.14
33577,U34316,15,5006.5700000000015,11,4,9163.43,14170.000000000002
33578,U35274,15,-6111.969999999999,10,5,23380.0,17268.03
33579,U27305,15,21485.020000000004,9,6,108188.7,129673.72
33580,U24271,15,-20259.9,12,3,30920.41,10660.509999999998
33581,U605432,15,1325.9599999999994,11,4,6865.799999999999,8191.759999999998
33582,U24005,15,55.54,12,3,224.5,280.04
33583,U27784,15,319.05999999999995,10,5,10691.18,11010.24
33584,U37179,15,-50852.0,9,6,54514.22,3662.220000000001
33585,U29144,15,959.41,12,3,610.62,1570.03
33586,U40763,15,2063.7700000000004,10,5,43788.42,45852.19
33587,U22251,15,-84636.62,9,6,298500.0,213863.38
33588,U947057,15,-21598.28,13,2,21600.14,1.860000000000582
33589,U12457,15,-97.26000000000059,9,6,105498.54999999999,105401.29
33590,U29587,15,493.98999999999995,10,5,3475.41,3969.3999999999996
33591,U41950,15,1970.2699999999986,9,6,13775.16,15745.429999999998
33592,U21192,15,9088.619999999999,5,10,10106.0,19194.62
33593,U11308,15,-813.9599999999986,7,8,94296.65000000001,93482.69000000002
33594,U36122,15,-5929.15,9,6,21496.0,15566.85
33595,U27416,15,-20643.480000000003,11,4,32057.180000000004,11413.7
33596,U1157113,15,-25146.3,13,2,25185.649999999998,39.349999999998545
33597,U23273,15,13743.26,9,6,5470.53,19213.79
33598,U34938,15,11796.97,9,6,5587.98,17384.949999999997
33599,U8936,15,-14584.900000000001,8,7,51462.06,36877.159999999996
33600,U14600,15,-113.71000000000008,11,4,3215.5600000000004,3101.8500000000004
33601,U25881,15,8907.16,4,11,1100.01,10007.17
33602,U699462,15,1355.5299999999984,12,3,11344.470000000001,12700.0
33603,U17561,15,-16795.36,10,5,255250.9,238455.53999999998
33604,U35353,15,-11813.9,12,3,24817.25,13003.35
33605,U34693,15,-4477.0,11,4,11987.240000000002,7510.240000000002
33606,U1085125,15,-66.67000000000019,10,5,2323.04,2256.37
33607,U14556,15,50.150000000000546,7,8,61851.14,61901.29
33608,U19983,15,10184.9,8,7,31368.820000000007,41553.72000000001
33609,U26113,15,245.09999999999977,12,3,8656.130000000001,8901.230000000001
33610,U13283,15,19297.579999999998,6,9,15900.0,35197.58
33611,U959970,15,-799.8699999999998,11,4,6209.88,5410.01
33612,U28147,15,-356.33000000000175,9,6,35390.0,35033.67
33613,U39256,15,2064.540000000001,8,7,163827.0,165891.54
33614,U1103156,15,580.2900000000003,10,5,7499.530000000001,8079.820000000001
33615,U35126,15,164.45000000000073,9,6,39685.62,39850.07000000001
33616,U21335,15,30284.589999999997,7,8,12893.82,43178.409999999996
33617,U34394,15,4129.789999999997,11,4,23336.84,27466.629999999997
33618,U21944,15,223.33999999999997,9,6,1547.54,1770.8799999999999
33619,U19969,15,-34483.25000000002,11,4,241827.01,207343.75999999998
33620,U1243297,15,150.57999999999993,11,4,15276.61,15427.19
33621,U33889,15,-1646.8600000000001,12,3,3236.94,1590.08
33622,U39300,15,11579.080000000002,9,6,24627.790000000005,36206.87000000001
33623,U13961,15,-7605.76,9,6,18919.890000000003,11314.130000000003
33624,U1108452,15,-210.1,10,5,496.11,286.01
33625,U1268078,15,477.13000000000005,6,9,1010.1899999999999,1487.32
33626,U22454,15,33972.33,8,7,20000.01,53972.34
33627,U35674,15,217.28000000000247,8,7,17965.02,18182.300000000003
33628,U36300,15,-183.75000000000037,9,6,24613.1,24429.35
33629,U993750,15,-7673.450000000001,11,4,7708.650000000001,35.19999999999982
33630,U29832,15,145.00999999999988,11,4,3826.12,3971.1299999999997
33631,U34757,15,0.9499999999883357,8,7,323346.47,323347.42
33632,U40782,15,-3395.1599999999994,8,7,7121.02,3725.860000000001
33633,U40978,15,-8596.44,12,3,11951.58,3355.1399999999994
33634,U13302,15,3429.9500000000003,7,8,719.1599999999999,4149.110000000001
33635,U1381466,15,-2561.1199999999994,12,3,9827.49,7266.370000000001
33636,U32032,15,31115.309999999998,6,9,70970.01000000001,102085.32
33637,U41602,15,-11799.470000000001,13,2,12056.470000000001,257.0
33638,U8270,15,-5137.25,8,7,13346.23,8208.98
33639,U31042,15,-231.15999999999985,9,6,20486.74,20255.58
33640,U32879,15,-8883.64,10,5,15500.66,6617.02
33641,U30030,15,3894.8900000000003,12,3,7655.0,11549.89
33642,U1161295,15,-8301.91,12,3,11567.92,3266.01
33643,U27573,15,-278.0,11,4,2651.2,2373.2
33644,U725822,15,-1442.24,12,3,1464.16,21.920000000000073
33645,U1044150,15,-2755.0499999999997,12,3,8274.23,5519.18
33646,U30299,15,900627.72,7,8,3148.6,903776.32
33647,U34499,15,-104.92000000000002,10,5,268.38,163.45999999999998
33648,U962771,15,412.68999999999994,6,9,4051.34,4464.03
33649,U31403,15,1713.0699999999997,9,6,3140.0,4853.07
33650,U1188215,15,-0.01999999999998181,10,5,6780.12,6780.1
33651,U19117,15,-4357.75,10,5,9105.0,4747.25
33652,U20151,15,717.2100000000008,5,10,150707.67,151424.88
33653,U25784,15,-498.49000000000024,8,7,6457.92,5959.43
33654,U670295,15,1895.74,6,9,1618.99,3514.73
33655,U42477,15,-29237.24,9,6,63969.15,34731.91
33656,U32518,15,-4.85,8,7,40290.0,40285.15
33657,U35714,15,-4079.3199999999956,7,8,300050.52,295971.2
33658,U40203,15,-138.06999999999996,12,3,1145.9699999999998,1007.8999999999999
33659,U27777,15,-483.21999999999935,11,4,11147.66,10664.44
33660,U43224,15,4123.6,10,5,13693.98,17817.58
33661,U33082,15,985.3599999999999,13,2,1015.6,2000.96
33662,U34402,15,-0.0500000000001819,8,7,7582.0,7581.95
33663,U23666,15,-610.9600000000003,13,2,16632.49,16021.53
33664,U12142,15,1985.9200000000005,10,5,9514.86,11500.78
33665,U34521,15,15470.630000000001,10,5,48007.8,63478.43000000001
33666,U14306,15,77882.25999999998,8,7,124563.65,202445.90999999997
33667,U11166,15,16795.4,6,9,42800.34,59595.74
33668,U22153,15,11119.52,10,5,3432.49,14552.01
33669,U36308,15,-16644.66,14,1,16695.7,51.04000000000087
33670,U22021,15,3080.699999999999,10,5,20528.09,23608.79
33671,U19761,15,80.85000000000002,11,4,919.7800000000001,1000.6300000000001
33672,U25839,15,1.9099999999998545,8,7,2526.11,2528.02
33673,U38147,15,6723.629999999999,11,4,20750.0,27473.629999999997
33674,U20662,15,-263.5600000000013,11,4,53197.990000000005,52934.43000000001
33675,U31485,15,70.79999999999988,7,8,15415.73,15486.529999999999
33676,U40846,15,886.3400000000001,10,5,1591.67,2478.01
33677,U1199884,15,-3954.69,12,3,3980.88,26.190000000000055
33678,U39146,15,31832.83,10,5,52928.990000000005,84761.82
33679,U10026,15,-23464.239999999998,12,3,26602.52,3138.2800000000025
33680,U33771,15,-78921.18,2,13,330000.0,251078.82
33681,U23761,15,26661.860000000008,8,7,300482.23000000004,327144.09
33682,U34171,15,14986.309999999998,9,6,10923.32,25909.629999999997
33683,U805930,15,-4908.42,8,7,29210.0,24301.58
33684,U12062,15,-2059.65,10,5,4135.55,2075.9
33685,U30693,15,-568.5799999999999,9,6,25751.149999999998,25182.57
33686,U8022,15,-300.9400000000005,10,5,8492.95,8192.01
33687,U15224,15,4201.779999999999,6,9,223660.0,227861.78
33688,U19534,15,125.19999999999345,7,8,99755.79999999999,99880.99999999999
33689,U42313,15,-876.9899999999998,7,8,15558.68,14681.69
33690,U39446,15,-3688.2500000000036,8,7,51883.45,48195.2
33691,U23470,15,3839.92,12,3,3843.08,7683.0
33692,U10188,15,394.3299999998999,6,9,1333516.0,1333910.3299999998
33693,U30380,15,-47203.79,10,5,59593.17,12389.379999999997
33694,U1176456,15,-2.9600000000000364,8,7,2855.97,2853.0099999999998
33695,U22768,15,-20358.98,10,5,50757.45,30398.469999999998
33696,U36090,15,-1823.8,9,6,10782.920000000002,8959.120000000003
33697,U25432,15,-24725.77,11,4,28780.0,4054.2299999999996
33698,U12018,15,-94.06999999999971,10,5,122500.0,122405.93
33699,U35672,15,43337.8,9,6,38380.0,81717.8
33700,U43192,15,1064.2999999999997,9,6,4733.799999999999,5798.0999999999985
33701,U22610,15,13.990000000000164,10,5,3352.32,3366.3100000000004
33702,U39533,15,4.7299999999959255,10,5,44800.0,44804.729999999996
33703,U20698,15,-713.3199999999999,11,4,6551.53,5838.21
33704,U11531,15,-759.3099999999977,11,4,32760.6,32001.29
33705,U21686,15,-4801.34,8,7,19000.0,14198.66
33706,U39388,15,36442.94,4,11,269796.0,306238.94
33707,U33126,15,-117.53999999999996,9,6,2867.63,2750.09
33708,U9546,15,-169032.40999999997,7,8,400420.18,231387.77000000002
33709,U18014,15,6434.609999999999,11,4,13790.259999999998,20224.869999999995
33710,U20923,15,58971.43,2,13,166.34,59137.77
33711,U30885,15,4861.700000000001,10,5,1907.2000000000003,6768.9000000000015
33712,U37801,15,6990.39,10,5,6571.6,13561.990000000002
33713,U41385,15,-853.2399999999998,10,5,12834.0,11980.76
33714,U21689,15,57.879999999999995,7,8,3703.47,3761.35
33715,U9720,15,4086.629999999999,12,3,12274.92,16361.55
33716,U19222,15,-1599.5900000000001,10,5,5700.0,4100.41
33717,U10242,15,-2814.3599999999988,11,4,18121.7,15307.340000000002
33718,U40715,15,1424.9799999999996,8,7,31106.0,32530.98
33719,U8805,15,-4107.68,9,6,16608.420000000002,12500.740000000002
33720,U28169,15,-6569.659999999997,10,5,21501.940000000002,14932.280000000006
33721,U26683,15,28023.72,11,4,20276.52,48300.240000000005
33722,U18035,15,175.5999999999999,11,4,1379.9,1555.5
33723,U24081,15,272.6499999999942,8,7,114020.92,114293.56999999999
33724,U41111,15,-122.96000000000004,7,8,9493.0,9370.04
33725,U36983,15,-7448.51,7,8,11634.0,4185.49
33726,U42126,15,-880.09,8,7,1699.0,818.91
33727,U13958,15,-15329.180000000002,10,5,58017.520000000004,42688.340000000004
33728,U36281,15,-57773.1,10,5,96650.0,38876.9
33729,U1052137,15,-148.91,10,5,1028.38,879.4700000000001
33730,U12836,15,484.1299999999992,9,6,19791.940000000002,20276.07
33731,U35933,15,24067.319999999996,6,9,46228.62,70295.94
33732,U35129,15,-8621.699999999999,9,6,16391.379999999997,7769.6799999999985
33733,U34743,15,-23190.94,8,7,29769.66,6578.720000000001
33734,U31569,15,374.02,7,8,7305.700000000001,7679.720000000001
33735,U11991,15,12411.25,5,10,25212.0,37623.25
33736,U42805,15,140566.40999999992,4,11,1236803.5,1377369.91
33737,U30093,15,-5466.1,11,4,13808.68,8342.58
33738,U26356,15,169.01000000000016,10,5,21481.170000000002,21650.18
33739,U12164,15,-15246.239999999998,9,6,65800.0,50553.76
33740,U16310,15,189202.12,6,9,61885.4,251087.52
33741,U19935,15,4194.6900000000005,9,6,5663.39,9858.080000000002
33742,U27542,15,6234.219999999972,7,8,396600.0,402834.22
33743,U33067,15,-94364.15,11,4,112288.54999999999,17924.399999999994
33744,U37749,15,-30099.91,9,6,61100.0,31000.09
33745,U42952,15,3227.38,8,7,5592.0,8819.380000000001
33746,U39988,15,-4823.449999999999,10,5,59826.74,55003.29
33747,U38513,15,-48162.47000000001,5,10,145000.0,96837.53
33748,U34876,15,1735.13,9,6,1965.8,3700.9300000000003
33749,U36018,15,-8139.259999999996,5,10,133516.0,125376.74
33750,U22198,15,6156.249999999996,8,7,175676.0,181832.25
33751,U42978,15,-699.8699999999999,10,5,4576.529999999999,3876.659999999999
33752,U24942,15,306.2700000000003,11,4,9743.36,10049.630000000001
33753,U36673,15,-52699.96000000001,7,8,69804.28,17104.319999999992
33754,U34424,15,41070.85,5,10,38772.0,79842.85
33755,U38073,15,1738951.13,5,10,1000050.0,2739001.13
33756,U28669,15,8330.939999999997,6,9,58937.24,67268.18
33757,U828632,15,3.200000000000017,8,7,914.4,917.6
33758,U43015,15,54609.73,6,9,130435.32,185045.05000000002
33759,U1250689,15,-243.77,8,7,644.77,401.0
33760,U26247,15,-11977.83,11,4,55652.44000000001,43674.61000000001
33761,U21054,15,1462.5900000000292,5,10,730376.0,731838.5900000001
33762,U23845,15,-6299.1,11,4,12911.219999999998,6612.119999999997
33763,U26354,15,70.19999999999999,6,9,224.8,295.0
33764,U14646,15,6087.61,5,10,1423.6100000000001,7511.219999999999
33765,U1321745,15,28.640000000000004,6,9,32.39,61.03
33766,U43589,15,2099.62,10,5,5902.0,8001.62
33767,U29541,15,-3591.64,12,3,3629.1,37.460000000000036
33768,U698094,15,-9879.14,11,4,13729.15,3850.01
33769,U27981,15,-480.1,10,5,1631.92,1151.8200000000002
33770,U33872,15,-504.8499999999996,10,5,8346.189999999999,7841.339999999999
33771,U1298475,15,-166.31000000000017,10,5,2393.36,2227.05
33772,U8309,15,-84905.57,7,8,200334.71,115429.13999999998
33773,U18915,15,1530.5400000000009,11,4,16669.5,18200.04
33774,U42797,15,1573.0200000000013,12,3,15358.0,16931.02
33775,U32665,15,201.51999999999185,6,9,213500.0,213701.52
33776,U30304,15,24991.269999999997,12,3,23459.0,48450.27
33777,U8865,15,-4098.130000000001,10,5,29434.0,25335.87
33778,U35482,15,-32571.089999999997,11,4,40668.8,8097.710000000006
33779,U18628,15,1048.8600000000001,9,6,849.8000000000001,1898.6600000000003
33780,U21296,15,652.2800000000097,6,9,117956.7,118608.98000000001
33781,U21141,15,-115.50000000000003,9,6,1023.58,908.08
33782,U19814,15,-10072.220000000005,7,8,115700.0,105627.78
33783,U32590,15,15579.55,9,6,11881.46,27461.01
33784,U35935,15,142930.44,6,9,9861.0,152791.44
33785,U34217,15,-3625.0,8,7,29284.949999999997,25659.949999999997
33786,U16326,15,-5195.700000000001,12,3,11265.26,6069.5599999999995
33787,U18449,15,103.29999999999997,4,11,9510.08,9613.38
33788,U967923,15,-1027.65,8,7,4629.9,3602.2499999999995
33789,U8342,15,8670.369999999999,10,5,12996.919999999996,21667.289999999994
33790,U11165,15,-7999.99,7,8,50000.0,42000.01
33791,U33343,15,34989.18,8,7,54013.0,89002.18
33792,U12657,15,53887.48,5,10,20034.2,73921.68000000001
33793,U16110,15,-4205.320000000001,5,10,24788.11,20582.79
33794,U18788,15,-8193.14,12,3,68351.98999999999,60158.84999999999
33795,U1059892,15,305.31,7,8,1428.17,1733.48
33796,U8302,15,-4074.5,11,4,45519.520000000004,41445.020000000004
33797,U30388,15,363.300000000002,8,7,51997.53,52360.83
33798,U21924,15,11133.130000000005,6,9,295768.02,306901.15
33799,U18187,15,506.6100000000024,10,5,12842.44,13349.050000000003
33800,U25989,15,-2610.1899999999905,4,11,347628.83,345018.64
33801,U8166,15,155389.48,7,8,66446.52,221836.0
33802,U39434,15,2529.67,12,3,12783.76,15313.43
33803,U34018,14,19219.88,7,7,30082.0,49301.880000000005
33804,U14757,14,22.40000000000009,8,6,6816.34,6838.74
33805,U19509,14,1983.86,4,10,5621.55,7605.41
33806,U42383,14,151183.88999999998,5,9,1266.31,152450.19999999998
33807,U37124,14,225.21000000000004,12,2,775.0,1000.21
33808,U1157651,14,-3049.99,9,5,4230.37,1180.38
33809,U43775,14,-566.4800000000002,11,3,3353.9800000000005,2787.5
33810,U33837,14,-19322.670000000013,7,7,220176.0,200853.33
33811,U1188873,14,-24242.61,14,0,24242.61,0.0
33812,U1122247,14,267.02999999999975,7,7,11886.03,12153.060000000001
33813,U42945,14,-1371.2999999999997,10,4,4872.9400000000005,3501.640000000001
33814,U36499,14,1658.8600000000024,7,7,30865.28,32524.14
33815,U40658,14,0.8900000000012369,7,7,25053.0,25053.89
33816,U12845,14,-99993.69,6,8,185294.0,85300.31
33817,U750210,14,1500.0,9,5,2997.02,4497.02
33818,U25062,14,2417.67,7,7,4583.59,7001.26
33819,U36587,14,-188558.92,9,5,1518703.0,1330144.08
33820,U33540,14,-3866.3600000000006,10,4,17742.98,13876.619999999999
33821,U32694,14,-0.18000000000029104,9,5,5347.56,5347.38
33822,U25250,14,-10188.11,10,4,12209.22,2021.1099999999988
33823,U30486,14,-1286.35,13,1,1396.35,110.0
33824,U20331,14,-5961.110000000001,9,5,17863.940000000002,11902.830000000002
33825,U33346,14,-1426.9399999999998,9,5,8561.7,7134.760000000001
33826,U40298,14,1.920000000000016,5,9,431.7,433.62
33827,U41370,14,-1500.6799999999996,8,6,14200.83,12700.15
33828,U28228,14,-103377.25,9,5,123000.0,19622.75
33829,U20525,14,38544.270000000004,9,5,14335.529999999999,52879.8
33830,U34999,14,-25935.28,8,6,41794.3,15859.020000000004
33831,U1023446,14,-326.07000000000005,7,7,334.35,8.279999999999973
33832,U33178,14,3563.3500000000004,8,6,2410.5,5973.85
33833,U28571,14,2143.359999999998,7,7,201880.0,204023.36
33834,U32984,14,0.029999999999972715,7,7,3900.0,3900.0299999999997
33835,U41349,14,92.91000000000052,10,4,19105.2,19198.11
33836,U20593,14,-720.5999999999999,9,5,10331.710000000001,9611.11
33837,U19530,14,25751.41,7,7,6179.0,31930.41
33838,U29507,14,-17168.92,9,5,25631.8,8462.880000000001
33839,U35760,14,-21527.800000000003,6,8,46232.63,24704.829999999994
33840,U14408,14,790.1999999999998,9,5,22181.73,22971.93
33841,U742345,14,134.74999999999997,10,4,1296.5400000000002,1431.2900000000002
33842,U27715,14,-1726.599999999998,8,6,21341.34,19614.74
33843,U24197,14,-10029.910000000002,9,5,12679.590000000002,2649.6800000000003
33844,U1071453,14,-921.1299999999999,8,6,3965.13,3044.0
33845,U17674,14,-2382.800000000001,8,6,9578.92,7196.119999999999
33846,U14661,14,-20.210000000000036,10,4,1035.09,1014.8799999999999
33847,U22781,14,685.16,5,9,1543.8799999999999,2229.04
33848,U35151,14,-77257.70000000001,9,5,144619.01,67361.31
33849,U32891,14,-431.83000000000004,10,4,552.77,120.93999999999994
33850,U30365,14,-145186.65,8,6,433430.0,288243.35
33851,U14607,14,-6580.9800000000005,10,4,7134.95,553.9699999999993
33852,U595660,14,13325.21,6,8,9685.18,23010.39
33853,U9452,14,-390460.95999999996,6,8,462899.7,72438.74000000005
33854,U31201,14,281.88000000000284,7,7,56033.52,56315.4
33855,U25613,14,4591.849999999999,6,8,33817.9,38409.75
33856,U18113,14,-3121.42,10,4,10501.6,7380.18
33857,U17874,14,-2671.52,11,3,5490.39,2818.8700000000003
33858,U30071,14,12830.500000000073,7,7,1810716.0,1823546.5
33859,U28994,14,-30402.03,11,3,31805.03,1403.0
33860,U25428,14,7824.18,12,2,8375.82,16200.0
33861,U29706,14,1711.78,10,4,6089.630000000001,7801.410000000001
33862,U38004,14,48.13000000000011,10,4,10354.65,10402.779999999999
33863,U17268,14,-23757.39,9,5,32976.0,9218.61
33864,U15216,14,138.01999999999998,6,8,2683.09,2821.11
33865,U9682,14,4366.529999999997,9,5,27062.22,31428.75
33866,U22435,14,120.55000000000011,9,5,9424.369999999999,9544.919999999998
33867,U43348,14,6920.08,5,9,6917.9,13837.98
33868,U9894,14,646.1999999999982,3,11,101000.0,101646.2
33869,U34185,14,682.2999999999993,9,5,43978.7,44661.0
33870,U38169,14,-74.68000000000029,8,6,27330.36,27255.68
33871,U41917,14,-4088.7799999999997,11,3,16375.119999999997,12286.339999999997
33872,U31316,14,-5656.24,12,2,5660.75,4.510000000000218
33873,U38810,14,-1922.19,11,3,2475.2799999999997,553.0899999999997
33874,U34973,14,-1.2599999999997618,7,7,4546.599999999999,4545.34
33875,U30041,14,1685.3800000000003,11,3,1452.86,3138.2400000000002
33876,U42888,14,880.3199999999999,12,2,1059.68,1940.0
33877,U31785,14,-2089.98,8,6,4072.0,1982.02
33878,U27478,14,715.9299999999998,10,4,2597.6699999999996,3313.5999999999995
33879,U25508,14,-1000.0,9,5,4748.5599999999995,3748.5599999999995
33880,U19942,14,-24398.09,8,6,83172.18,58774.09
33881,U8566,14,-92432.33,10,4,94478.95999999999,2046.62999999999
33882,U1238138,14,-817.1399999999999,9,5,2287.5099999999998,1470.37
33883,U902685,14,-1676.2799999999995,7,7,11256.380000000001,9580.100000000002
33884,U39153,14,-14697.720000000001,9,5,22759.09,8061.369999999999
33885,U738402,14,7.230000000000014,7,7,2091.6899999999996,2098.9199999999996
33886,U21445,14,-538602.9900000001,7,7,757091.3400000001,218488.34999999998
33887,U11315,14,-33193.700000000004,10,4,46874.9,13681.199999999997
33888,U678034,14,-2360.0,11,3,3730.01,1370.0100000000002
33889,U31587,14,6568.800000000001,9,5,4158.28,10727.080000000002
33890,U38119,14,-5156.62,4,10,19000.0,13843.380000000001
33891,U10731,14,-5605.24,8,6,7486.9,1881.6599999999999
33892,U1325434,14,2881.4300000000003,7,7,1656.61,4538.04
33893,U689759,14,-9249.82,14,0,9249.82,0.0
33894,U24092,14,-41494.04,11,3,173921.04,132427.0
33895,U10885,14,33787.4,4,10,38684.0,72471.4
33896,U36818,14,-9.720000000000255,8,6,23853.0,23843.28
33897,U32802,14,2740.81,8,6,60572.0,63312.81
33898,U981913,14,57924.59,9,5,62075.41,120000.0
33899,U42915,14,-3396.1400000000003,10,4,4956.8,1560.6599999999999
33900,U25072,14,-6598.769999999999,8,6,30019.800000000003,23421.030000000006
33901,U27968,14,1479.51,2,12,160.0,1639.51
33902,U17055,14,1815.4499999999944,6,8,150943.93000000002,152759.38
33903,U42955,14,532.1899999999998,10,4,2314.5000000000005,2846.6900000000005
33904,U19892,14,141.97999999999956,10,4,8808.029999999999,8950.009999999998
33905,U1086098,14,635.25,6,8,842.71,1477.96
33906,U40835,14,-99114.34999999999,4,10,118375.0,19260.65000000001
33907,U37699,14,8398.34,6,8,27628.0,36026.34
33908,U19358,14,710.9799999999959,7,7,44532.090000000004,45243.07
33909,U28647,14,12490.340000000004,1,13,100000.0,112490.34
33910,U39913,14,524.44,8,6,8740.880000000001,9265.320000000002
33911,U23436,14,-226.60000000000008,8,6,4653.279999999999,4426.6799999999985
33912,U28062,14,544703.2700000001,3,11,106150.0,650853.2700000001
33913,U1140389,14,-709.3900000000001,9,5,1060.42,351.03
33914,U32923,14,-31760.11,5,9,42883.06,11122.949999999997
33915,U1173493,14,1493.000000000001,8,6,13322.310000000001,14815.310000000001
33916,U38365,14,-863.5,10,4,2059.68,1196.1799999999998
33917,U26256,14,-1999.4400000000003,8,6,8980.0,6980.5599999999995
33918,U767557,14,-537.1099999999999,11,3,1046.1399999999999,509.03
33919,U19876,14,-57.71,11,3,82.0,24.29
33920,U10649,14,3862.7099999999996,10,4,12000.0,15862.71
33921,U12393,14,-5228.68,8,6,104273.5,99044.82
33922,U34435,14,3606.4099999999994,8,6,10684.039999999999,14290.449999999999
33923,U40849,14,21.649999999999636,5,9,40631.4,40653.05
33924,U34048,14,-2037.1900000000005,7,7,12100.23,10063.039999999999
33925,U21525,14,-146.1300000000001,8,6,14535.36,14389.23
33926,U29783,14,8510.95,8,6,3137.6800000000003,11648.630000000001
33927,U20097,14,-1004.5300000000002,5,9,10160.0,9155.47
33928,U15014,14,-3778.319999999999,9,5,24812.31,21033.99
33929,U8082,14,788.0200000000003,8,6,31632.92,32420.94
33930,U35366,14,-548.6999999999998,9,5,14905.9,14357.2
33931,U32662,14,705.3600000000005,7,7,42479.92,43185.28
33932,U11908,14,-103604.37,11,3,112785.0,9180.630000000005
33933,U12219,14,5728.53,5,9,16487.0,22215.53
33934,U15519,14,-971.7599999999999,10,4,7896.08,6924.32
33935,U1250255,14,-0.15999999999985448,12,2,1544.06,1543.9
33936,U28443,14,39.13999999999994,8,6,1327.65,1366.79
33937,U9313,14,-2225.96,9,5,15464.74,13238.779999999999
33938,U19579,14,29887.640000000003,8,6,66.5,29954.140000000003
33939,U10896,14,-2128.020000000002,5,9,64941.79,62813.77
33940,U19226,14,-4.800000000000338,8,6,8295.929999999998,8291.129999999997
33941,U1316881,14,-266.74000000000007,9,5,3710.76,3444.02
33942,U1091692,14,548.5099999999996,10,4,3612.42,4160.929999999999
33943,U14414,14,19697.44,7,7,353.0,20050.44
33944,U38433,14,-39385.07000000001,8,6,164453.39,125068.32
33945,U34168,14,987.51,7,7,114.75999999999999,1102.27
33946,U11218,14,0.8899999999994179,6,8,104593.43999999999,104594.32999999999
33947,U13726,14,8904.77,6,8,21444.15,30348.920000000002
33948,U8502,14,40190.939999999995,5,9,36920.63,77111.56999999999
33949,U925813,14,-663.73,11,3,663.81,0.07999999999992724
33950,U34771,14,-8028.660000000009,6,8,119200.0,111171.34
33951,U12031,14,7535.000000000004,5,9,61381.58,68916.58
33952,U42354,14,-8819.889999999998,6,8,72862.72,64042.83
33953,U33689,14,-185628.27000000002,9,5,216164.6,30536.329999999987
33954,U29850,14,0.4900000000000273,5,9,893.9399999999999,894.43
33955,U35622,14,-6628.07,10,4,14530.0,7901.93
33956,U31848,14,-568.71,8,6,18037.22,17468.510000000002
33957,U37299,14,-362.63000000000005,8,6,4927.0,4564.37
33958,U36917,14,-17051.370000000003,8,6,64821.380000000005,47770.01
33959,U19684,14,-90.17000000000007,11,3,839.38,749.2099999999999
33960,U22819,14,-555.9500000000007,6,8,18993.67,18437.719999999998
33961,U25177,14,-3450.6800000000003,10,4,13316.0,9865.32
33962,U38451,14,-115.08999999999969,7,7,7990.880000000001,7875.790000000001
33963,U37540,14,-1116.9700000000012,6,8,50208.08,49091.11
33964,U35912,14,-49965.75,11,3,64376.77,14411.019999999997
33965,U933193,14,-382.68999999999994,9,5,7406.68,7023.990000000001
33966,U36721,14,3202.949999999997,7,7,100320.0,103522.95
33967,U20876,14,17546.86,9,5,66103.14,83650.0
33968,U25200,14,16.010000000001163,7,7,31548.54,31564.550000000003
33969,U34450,14,15843.179999999998,8,6,14488.900000000001,30332.08
33970,U16407,14,167.80000000000018,9,5,5732.91,5900.71
33971,U751299,14,0.0,10,4,39360.0,39360.0
33972,U11048,14,2517.000000000009,6,8,126098.51999999999,128615.52
33973,U24692,14,2197.3299999999995,10,4,1322.81,3520.1399999999994
33974,U35359,14,8157.66,9,5,11506.0,19663.66
33975,U1320826,14,16.159999999999854,8,6,3608.94,3625.1
33976,U899225,14,-7420.33,9,5,9213.130000000001,1792.800000000001
33977,U23728,14,-1664.16,9,5,3354.0,1689.84
33978,U37215,14,-249.19999999999936,8,6,7711.959999999999,7462.76
33979,U1113621,14,-3.089999999999991,8,6,7080.91,7077.82
33980,U1178181,14,116.83000000000015,5,9,1899.5500000000002,2016.3800000000003
33981,U10893,14,97337.04000000001,2,12,55.0,97392.04000000001
33982,U42593,14,-86.53999999999998,10,4,759.75,673.21
33983,U16578,14,3144.8100000000004,9,5,17217.3,20362.11
33984,U39991,14,3875.7700000000004,10,4,24131.989999999998,28007.76
33985,U17262,14,11766.0,6,8,9344.3,21110.3
33986,U1072652,14,-3.4699999999999935,8,6,71.98,68.51
33987,U10960,14,1024.9700000000023,7,7,93562.86,94587.83
33988,U36984,14,-1577.8900000000006,7,7,6211.4400000000005,4633.55
33989,U1329630,14,23.230000000000018,7,7,1540.0,1563.23
33990,U17905,14,-1386.63,10,4,2787.01,1400.38
33991,U844371,14,0.65,7,7,3729.4,3730.05
33992,U650301,14,6.25,6,8,5296.83,5303.08
33993,U14491,14,-9.979999999999563,7,7,166010.02,166000.03999999998
33994,U38269,14,-85.09000000000015,6,8,31494.0,31408.91
33995,U576117,14,-19255.46,8,6,28632.71,9377.25
33996,U14507,14,-7579.550000000003,7,7,102680.0,95100.45
33997,U12250,14,-2352.4100000000003,11,3,5927.150000000001,3574.7400000000002
33998,U25440,14,753.22,7,7,5820.219999999999,6573.44
33999,U38719,14,-18471.16,9,5,26219.739999999998,7748.579999999998
34000,U1215448,14,-10.200000000000006,6,8,130.0,119.8
34001,U35535,14,0.0,7,7,31698.0,31698.0
34002,U1269606,14,2313.29,4,10,168.22000000000003,2481.51
34003,U43006,14,108532.96000000008,7,7,700000.0,808532.9600000001
34004,U11662,14,6782.85,9,5,906011.0700000001,912793.92
34005,U24656,14,-15.6200000000008,5,9,27560.86,27545.239999999998
34006,U1219893,14,167.2400000000001,9,5,1252.3899999999999,1419.6299999999999
34007,U16206,14,90508.31,8,6,142175.44,232683.75
34008,U20632,14,-2406.84,5,9,63409.66,61002.82000000001
34009,U23277,14,17214.04,11,3,33884.16,51098.200000000004
34010,U988435,14,-1048.4,11,3,1251.07,202.66999999999985
34011,U42128,14,-268.77,11,3,343.7,74.93
34012,U16620,14,2165.3899999999994,8,6,110639.38,112804.77
34013,U37658,14,-2184.8,10,4,4797.67,2612.87
34014,U37507,14,8807.2,4,10,39805.0,48612.2
34015,U30494,14,990.81,8,6,819.93,1810.7399999999998
34016,U9178,14,4926.4000000000115,8,6,245811.14,250737.54000000004
34017,U12634,14,95553.91,10,4,6165.839999999999,101719.75
34018,U36284,14,-435750.7000000002,6,8,1512225.0,1076474.2999999998
34019,U30392,14,-406.85000000000053,9,5,24645.32,24238.469999999998
34020,U623550,14,-4894.2699999999995,8,6,5197.98,303.71000000000004
34021,U33402,14,70343.11,5,9,104548.70999999999,174891.82
34022,U23900,14,3.3100000000013097,7,7,51907.21000000001,51910.520000000004
34023,U23125,14,2249.7999999999993,5,9,948525.89,950775.6900000001
34024,U12804,14,-358.27999999999935,5,9,14649.53,14291.250000000002
34025,U25645,14,4564.02,7,7,11820.0,16384.02
34026,U12993,14,-96901.21,8,6,102573.06,5671.849999999991
34027,U43164,14,-14.850000000000023,9,5,528.0,513.15
34028,U41504,14,1822.21,10,4,10828.0,12650.21
34029,U18855,14,-1347.69,10,4,4651.54,3303.85
34030,U13568,14,3403.250000000002,7,7,36010.0,39413.25
34031,U38837,14,-33.30999999999949,6,8,10875.55,10842.24
34032,U14837,14,-2921.9300000000003,11,3,7322.0,4400.07
34033,U21617,14,-5954.78,9,5,18426.34,12471.560000000001
34034,U38763,14,660.5500000000002,12,2,345.28,1005.8300000000002
34035,U28193,14,106465.7,7,7,12189.4,118655.09999999999
34036,U16335,14,44818.87,3,11,7075.0,51893.87
34037,U40435,14,18217.1,10,4,2171.5699999999997,20388.67
34038,U24240,14,-647.49,9,5,4790.8,4143.31
34039,U30516,14,-3631.51,9,5,5293.75,1662.2399999999998
34040,U12966,14,-2511.8100000000004,6,8,5115.98,2604.169999999999
34041,U16344,14,0.17000000000007276,6,8,19000.0,19000.17
34042,U9431,14,-2907.7799999999997,4,10,46100.0,43192.22
34043,U676415,14,-308.79999999999995,9,5,961.93,653.13
34044,U32354,14,5551.010000000001,7,7,29822.03,35373.04
34045,U19622,14,27491.920000000002,5,9,51490.18000000001,78982.1
34046,U22327,14,-34.310000000000144,7,7,14901.54,14867.230000000001
34047,U25930,14,-1228.13,13,1,1228.75,0.6199999999998909
34048,U34640,14,1994.5299999999988,9,5,32008.0,34002.53
34049,U20937,14,21597.17,4,10,6910.0,28507.17
34050,U24300,14,8192.750000000002,5,9,19106.91,27299.660000000003
34051,U27543,14,-1243.6100000000006,6,8,45278.759999999995,44035.149999999994
34052,U14586,14,-147349.14,11,3,202909.03,55559.889999999985
34053,U1226765,14,-0.960000000000008,12,2,206.91,205.95
34054,U8099,14,-2274.270000000004,9,5,50412.08,48137.81
34055,U10821,14,186786.99000000002,5,9,18403.600000000002,205190.59000000003
34056,U42780,14,63.0,9,5,50305.0,50368.0
34057,U28550,14,-7443.369999999999,7,7,45080.46,37637.09
34058,U27072,14,98428.47,5,9,89810.0,188238.47
34059,U26775,14,192.77999999999997,10,4,978.6600000000001,1171.44
34060,U1306213,14,2.1699999999998862,11,3,3442.08,3444.25
34061,U1087021,14,-11.949999999999855,10,4,5271.860000000001,5259.910000000001
34062,U19345,14,5207.460000000001,10,4,8165.8,13373.260000000002
34063,U43518,14,-9800.61,10,4,22297.15,12496.54
34064,U17660,14,12150.8,9,5,95768.87999999999,107919.68
34065,U19333,14,47250.51,4,10,44363.29,91613.8
34066,U18248,14,-886.1200000000001,10,4,193330.8,192444.68
34067,U43345,14,-497416.10000000003,10,4,560695.07,63278.969999999914
34068,U8140,14,-903.6800000000001,8,6,6072.91,5169.23
34069,U25390,14,1036.260000000002,7,7,27733.8,28770.06
34070,U1234209,14,1495.56,8,6,2287.49,3783.0499999999997
34071,U41678,14,-7.809999999997672,11,3,93928.0,93920.19
34072,U30621,14,75.10000000000582,6,8,112700.0,112775.1
34073,U35019,14,10603.36,8,6,14117.48,24720.84
34074,U37475,14,499.56999999999886,7,7,12260.550000000001,12760.12
34075,U958090,14,9.910000000000093,8,6,2263.0,2272.9100000000003
34076,U26835,14,-201607.7,10,4,203461.25,1853.5499999999884
34077,U586264,14,337.119999999999,6,8,18556.0,18893.12
34078,U36410,14,-6315.940000000224,10,4,3989382.4000000004,3983066.46
34079,U978584,14,101.07999999999996,9,5,997.82,1098.9
34080,U33677,14,-13086.619999999999,9,5,28047.8,14961.18
34081,U10248,14,11105.280000000002,12,2,24901.949999999997,36007.229999999996
34082,U39391,14,-31798.25,6,8,32410.76,612.5099999999984
34083,U23397,14,1.8099999999976717,6,8,101931.0,101932.81
34084,U1068105,14,-31.96,9,5,244.05,212.09
34085,U10862,14,-94521.75000000001,3,11,117000.0,22478.249999999985
34086,U1105615,14,-2735.04,10,4,4735.22,2000.1800000000003
34087,U17202,14,60295.79,10,4,124714.0,185009.79
34088,U18936,14,-1118.3699999999992,9,5,11463.070000000002,10344.700000000003
34089,U21925,14,-13481.40000000003,8,6,2079686.8800000001,2066205.48
34090,U674071,14,11956.09,10,4,11502.22,23458.309999999998
34091,U37495,14,-83.43000000000006,7,7,1646.98,1563.55
34092,U32968,14,-9799.95,6,8,38245.0,28445.05
34093,U13074,14,-305.7500000000512,6,8,1620159.5499999998,1619853.7999999998
34094,U1300070,14,-17776.2,9,5,19584.52,1808.3199999999997
34095,U31574,14,-1638.6,11,3,6040.0,4401.4
34096,U32437,14,372.9399999999993,10,4,8805.52,9178.46
34097,U10707,14,-1177.06,11,3,1685.63,508.57000000000016
34098,U42927,14,-8754.219999999987,9,5,98800.0,90045.78000000001
34099,U23275,14,19774.660000000003,5,9,11500.0,31274.660000000003
34100,U1150818,14,-640.32,12,2,1135.3300000000002,495.0100000000001
34101,U18852,14,2224.5799999999995,10,4,7740.719999999999,9965.3
34102,U13806,14,26371.44,5,9,8150.01,34521.45
34103,U19504,14,3918.3600000000006,11,3,3181.7200000000003,7100.080000000001
34104,U1271972,14,404.01,6,8,4888.01,5292.02
34105,U30422,14,1944.12,10,4,66856.0,68800.12
34106,U15433,14,-144.26999999999998,10,4,616.13,471.86
34107,U18824,14,696.06,10,4,8394.73,9090.789999999999
34108,U21824,14,-3.359999999998763,9,5,40203.95999999999,40200.59999999999
34109,U17082,14,34030.11,6,8,4063.0,38093.11
34110,U8966,14,-72110.04999999997,7,7,107299.99,35189.94000000003
34111,U901942,14,-933.41,10,4,1333.4200000000003,400.01000000000033
34112,U9734,14,15206.109999999997,8,6,40276.8,55482.91
34113,U11709,14,-181.34000000000003,11,3,4102.34,3921.0
34114,U38716,14,749.2799999999997,7,7,3172.79,3922.0699999999997
34115,U22828,14,-2107.73,11,3,2149.19,41.460000000000036
34116,U23213,14,5799.769999999999,6,8,5944.7,11744.469999999998
34117,U19726,14,-1512.74,9,5,6892.6,5379.860000000001
34118,U28793,14,3900.0699999999997,2,12,3931.56,7831.629999999999
34119,U10181,14,100124.51000000001,9,5,100000.0,200124.51
34120,U16983,14,-6819.319999999999,8,6,38522.21,31702.89
34121,U19002,14,14816.830000000002,3,11,365.41999999999996,15182.250000000002
34122,U43606,14,6107.650000000001,9,5,16656.31,22763.960000000003
34123,U19232,14,1968.8599999999997,8,6,16005.42,17974.28
34124,U12939,14,-778.7600000000002,5,9,3463.0,2684.24
34125,U21475,14,-596426.88,7,7,611697.0,15270.119999999995
34126,U17498,14,7500.069999999999,6,8,43116.45,50616.52
34127,U21446,14,1761.3199999999997,11,3,11239.98,13001.3
34128,U16130,14,26074.78,3,11,44200.0,70274.78
34129,U32384,14,-1660.8100000000022,9,5,93261.60000000002,91600.79000000002
34130,U14279,14,-19868.05,7,7,23596.079999999998,3728.029999999999
34131,U38305,14,0.07000000000001422,7,7,1977.5400000000002,1977.6100000000001
34132,U19874,14,-18391.749999999996,8,6,72831.08,54439.33
34133,U16729,14,101073.10000000003,10,4,32945.71,134018.81000000003
34134,U11282,14,430.3200000000005,8,6,10674.140000000001,11104.460000000001
34135,U1336745,14,-85.34999999999945,9,5,14698.720000000001,14613.370000000003
34136,U18110,14,-9275.71,7,7,31858.0,22582.29
34137,U20358,14,36355.59,10,4,3714.4300000000003,40070.02
34138,U39813,14,0.0,8,6,11242.35,11242.35
34139,U43228,14,7423.759999999999,9,5,12842.909999999998,20266.67
34140,U38932,14,-74112.35000000002,3,11,460300.0,386187.64999999997
34141,U10285,14,-2701.01,9,5,6718.700000000001,4017.6900000000005
34142,U18148,14,2451.3099999999995,10,4,14543.119999999999,16994.43
34143,U21118,14,-322.1599999999992,5,9,12412.939999999999,12090.779999999999
34144,U17149,14,38434.28999999999,7,7,45434.07,83868.35999999999
34145,U36321,14,56952.600000000006,6,8,104610.4,161563.0
34146,U793480,14,23.93999999999998,7,7,775.3299999999999,799.2699999999999
34147,U36267,14,984.48,8,6,14429.869999999999,15414.349999999999
34148,U19689,14,-554.54,10,4,1041.42,486.8800000000001
34149,U36106,14,-21881.000000000004,7,7,46385.0,24503.999999999996
34150,U41845,14,-19305.14,7,7,142450.95,123145.81000000001
34151,U26430,14,-6520.33,3,11,50000.0,43479.67
34152,U19106,14,12884.150000000001,9,5,24121.510000000002,37005.66
34153,U10183,14,-365.97000000000025,11,3,14594.0,14228.029999999999
34154,U30971,14,-2879.6900000000005,7,7,17093.690000000002,14214.000000000002
34155,U25236,14,14694.660000000009,10,4,97099.26,111793.92
34156,U37544,14,18877.66,8,6,126125.0,145002.66
34157,U667653,14,153.73999999999955,8,6,7522.62,7676.36
34158,U19824,14,-3030.3,10,4,6790.639999999999,3760.3399999999992
34159,U22596,14,-4262.799999999996,4,10,214266.40999999997,210003.61
34160,U1303502,14,-2.660000000000082,10,4,6413.74,6411.08
34161,U833168,14,425.8600000000001,10,4,2411.02,2836.88
34162,U29117,14,68037.85,6,8,4369.58,72407.43000000001
34163,U34827,14,3273.6399999999994,6,8,18554.219999999998,21827.859999999997
34164,U30861,14,505.6999999999998,9,5,2554.31,3060.0099999999998
34165,U23030,14,14804.490000000002,6,8,25736.04,40540.53
34166,U34276,14,-2886.089999999999,8,6,24509.0,21622.91
34167,U19089,14,3424.37,10,4,4605.02,8029.39
34168,U13764,14,9783.01,8,6,303.92,10086.93
34169,U17802,14,-637.7299999999999,10,4,1890.7600000000002,1253.0300000000002
34170,U1048169,14,221.67999999999995,7,7,8059.1,8280.78
34171,U10122,14,-2798.9999999999977,9,5,38836.6,36037.6
34172,U27102,14,25758.44,5,9,8795.63,34554.07
34173,U24044,14,-46407.07000000001,9,5,183865.0,137457.93
34174,U37650,14,-2796.9500000000007,11,3,14364.880000000001,11567.93
34175,U29880,14,-0.3800000000046566,8,6,310932.76,310932.38
34176,U41109,14,-224.51999999999998,11,3,444.81,220.29000000000002
34177,U40195,14,-19265.44,6,8,122966.76000000001,103701.32
34178,U37349,14,12020.07,4,10,11774.7,23794.77
34179,U29199,14,7825.22,6,8,36047.79,43873.01
34180,U35661,14,-0.6100000000005821,9,5,18512.07,18511.46
34181,U1254613,14,0.0,7,7,980.0,980.0
34182,U10900,14,2102.2999999999884,7,7,251179.52,253281.81999999998
34183,U37316,14,2054.16,10,4,8445.56,10499.72
34184,U17805,14,13531.470000000001,8,6,14095.029999999999,27626.5
34185,U19545,14,439.0699999999997,5,9,4580.0,5019.07
34186,U32196,14,54.220000000000006,10,4,60057.8,60112.020000000004
34187,U22661,14,-70456.89,11,3,128666.29000000001,58209.40000000001
34188,U39961,14,-2702.58,6,8,3018.81,316.23
34189,U37932,14,4810.850000000001,5,9,56306.0,61116.85
34190,U9470,14,67183.84,6,8,47261.0,114444.84
34191,U22648,14,-3195.5299999999997,5,9,13000.0,9804.470000000001
34192,U43866,14,186.0,8,6,2516.0600000000004,2702.0600000000004
34193,U43699,14,2475.0,7,7,18354.0,20829.0
34194,U28588,14,-1272.7199999999998,11,3,1728.48,455.7600000000002
34195,U36389,14,0.0,7,7,29915.15,29915.15
34196,U33942,14,-18054.900000000005,12,2,20739.730000000003,2684.829999999998
34197,U16093,14,-75134.82999999999,7,7,81578.28,6443.450000000012
34198,U39255,14,-1491.15,11,3,6492.23,5001.08
34199,U21555,14,-7102.8099999999995,12,2,7329.389999999999,226.57999999999993
34200,U14129,14,-21522.14,10,4,28742.93,7220.790000000001
34201,U10155,14,-69374.64,10,4,88900.65,19526.009999999995
34202,U20715,14,246.32999999999993,9,5,3428.8999999999996,3675.2299999999996
34203,U42807,14,1724.71,5,9,66700.0,68424.71
34204,U40828,14,188934.14999999997,5,9,187177.0,376111.14999999997
34205,U649379,14,-245.78,9,5,352.8,107.02000000000001
34206,U25073,14,-50509.91,11,3,70571.15000000001,20061.240000000005
34207,U11055,14,-973.9200000000001,6,8,106600.0,105626.08
34208,U25569,14,2569.0,9,5,72655.48,75224.48
34209,U23982,14,-23670.989999999994,8,6,72255.01000000001,48584.02000000002
34210,U1289507,14,-554.3499999999999,9,5,2901.83,2347.48
34211,U32275,14,-20498.83,11,3,44456.95,23958.119999999995
34212,U22548,14,29.55999999999949,7,7,25467.03,25496.589999999997
34213,U41480,14,38.41000000000001,9,5,83719.42,83757.83
34214,U32885,14,-5460.330000000001,10,4,17576.84,12116.509999999998
34215,U16250,14,616.1900000000002,10,4,18799.99,19416.18
34216,U29081,14,0.0,10,4,4199.54,4199.54
34217,U12462,14,17740.760000000006,9,5,22008.43,39749.19
34218,U24351,14,26038.200000000004,6,8,35464.240000000005,61502.44000000001
34219,U12599,14,-140.18000000000063,6,8,42150.17,42009.99
34220,U11307,14,11346.389999999989,4,10,228333.34,239679.72999999998
34221,U33024,14,327537.56,4,10,25125.760000000002,352663.32
34222,U38675,14,-29779.56,9,5,39008.74,9229.179999999997
34223,U17997,14,-52392.29999999999,10,4,212496.66999999998,160104.37
34224,U36304,14,48203.03,10,4,37702.95999999999,85905.98999999999
34225,U17731,14,12270.599999999999,8,6,95182.82,107453.42000000001
34226,U40320,14,9727.710000000003,8,6,301224.8,310952.51
34227,U16745,14,98073.46999999999,9,5,2217.48,100290.94999999998
34228,U35423,14,-1970.5800000000002,8,6,15395.38,13424.8
34229,U23714,14,-39453.159999999996,11,3,41704.92,2251.760000000002
34230,U30355,14,-77.27999999999884,6,8,123675.26,123597.98
34231,U840767,14,-3312.7499999999995,12,2,3713.2599999999998,400.5100000000002
34232,U10303,14,2591.1,7,7,4602.3099999999995,7193.41
34233,U1116718,14,-18.830000000000176,7,7,2759.56,2740.7299999999996
34234,U1158647,14,410.0,8,6,2023.0,2433.0
34235,U30408,14,1020.4700000000003,6,8,11695.0,12715.470000000001
34236,U10344,14,261.2299999999982,8,6,11433.01,11694.239999999998
34237,U710628,14,-12108.06,12,2,13908.06,1800.0
34238,U20867,14,-1073.529999999997,4,10,92899.0,91825.47
34239,U30453,14,-1657.42,7,7,8217.42,6560.0
34240,U37619,14,-3691.4300000000003,7,7,19893.58,16202.150000000001
34241,U1240786,14,-2478.46,9,5,12352.31,9873.849999999999
34242,U23797,14,-14872.1,8,6,24004.9,9132.800000000001
34243,U599915,14,-1.3642420526593924e-12,8,6,91800.37,91800.37
34244,U40399,14,83.2000000000001,8,6,6167.0,6250.2
34245,U10604,14,9753.489999999998,8,6,13293.45,23046.94
34246,U26127,14,3164.899999999999,6,8,62028.22000000001,65193.12000000001
34247,U26712,14,11889.26000000001,6,8,641336.0,653225.26
34248,U33624,13,-43746.29,6,7,144802.0,101055.70999999999
34249,U32969,13,250.96000000000004,8,5,15759.300000000001,16010.260000000002
34250,U971956,13,-1586.47,10,3,2686.48,1100.01
34251,U11465,13,354.5200000000001,9,4,4299.839999999999,4654.36
34252,U621015,13,2.3499999999999273,7,6,1703.03,1705.3799999999999
34253,U41313,13,-672.4499999999998,9,4,8046.0,7373.55
34254,U31146,13,-4842.030000000001,7,6,9043.76,4201.73
34255,U35306,13,-7311.599999999994,8,5,110779.1,103467.50000000001
34256,U27454,13,2792.08,8,5,69.02000000000001,2861.1
34257,U28593,13,-359.2599999999998,10,3,2491.34,2132.0800000000004
34258,U26735,13,-25173.4,5,8,120922.0,95748.6
34259,U905646,13,2.0000000000009095,7,6,14015.05,14017.05
34260,U40859,13,438744.49000000005,7,6,66220.0,504964.49000000005
34261,U25043,13,307.7999999999997,10,3,3325.3399999999997,3633.1399999999994
34262,U39023,13,-34824.659999999996,6,7,118000.0,83175.34
34263,U32915,13,-4.3600000000000225,7,6,6214.3,6209.9400000000005
34264,U33630,13,10.13000000000001,9,4,134.61,144.74
34265,U8460,13,-53610.76,10,3,60240.99,6630.229999999996
34266,U43918,13,244.11999999999927,8,5,8687.99,8932.109999999999
34267,U30130,13,207741.93000000002,3,10,1635.0,209376.93000000002
34268,U22486,13,3297.0000000000005,9,4,6306.0,9603.0
34269,U39765,13,-11276.489999999998,5,8,61333.68,50057.19
34270,U43701,13,-277.70000000000005,10,3,7321.0,7043.3
34271,U37676,13,-3323.6499999999996,8,5,20003.129999999997,16679.479999999996
34272,U20905,13,12777.959999999995,6,7,32429.04,45207.0
34273,U12805,13,-52605.23999999999,9,4,119889.34,67284.1
34274,U36009,13,-13050.75,9,4,17538.68,4487.93
34275,U31515,13,164.87999999999997,10,3,185.6,350.47999999999996
34276,U23049,13,24357.82,4,9,18755.68,43113.5
34277,U1250456,13,-8443.009999999998,12,1,8458.009999999998,15.0
34278,U922826,13,2240.06,3,10,155.5,2395.56
34279,U950009,13,-5634.109999999999,8,5,12558.109999999999,6924.0
34280,U42830,13,-25061.239999999998,8,5,62600.36,37539.12
34281,U21079,13,2909.9,7,6,4092.0,7001.9
34282,U20306,13,-31081.550000000003,6,7,90000.0,58918.45
34283,U701222,13,-648.8999999999996,9,4,3449.12,2800.2200000000003
34284,U18816,13,-42073.51,11,2,42129.200000000004,55.69000000000233
34285,U36686,13,-2893.3100000000004,7,6,15333.0,12439.689999999999
34286,U1005627,13,-1435.32,10,3,1438.02,2.7000000000000455
34287,U43802,13,17249.989999999998,6,7,4782.450000000001,22032.44
34288,U19296,13,-28814.7,7,6,34767.23,5952.5300000000025
34289,U37001,13,56.60000000000005,9,4,968.3000000000001,1024.9
34290,U985158,13,0.1699999999999997,9,4,74.73,74.9
34291,U34598,13,1022.5299999999879,5,8,90000.0,91022.52999999998
34292,U15474,13,-5979.68,10,3,6669.529999999999,689.8499999999985
34293,U42670,13,-2988.5199999999895,2,11,92000.0,89011.48000000001
34294,U24551,13,-13781.979999999978,8,5,362411.88,348629.9
34295,U696006,13,700.23,6,7,12992.34,13692.57
34296,U15230,13,-8834.24,10,3,10660.54,1826.300000000001
34297,U588949,13,-5052.379999999999,12,1,5052.3899999999985,0.009999999999308784
34298,U18098,13,-2567.900000000001,7,6,18796.1,16228.199999999997
34299,U21793,13,-2792.86,10,3,6494.0,3701.14
34300,U15119,13,-319.75,4,9,7637.6900000000005,7317.9400000000005
34301,U36574,13,-260.8199999999997,5,8,71330.0,71069.18
34302,U41412,13,-2020.2099999999998,10,3,2171.1000000000004,150.89000000000055
34303,U43203,13,522.4000000000015,6,7,28424.19,28946.59
34304,U26369,13,426.85000000000036,8,5,9144.21,9571.06
34305,U10071,13,-44224.99999999999,7,6,213000.0,168775.0
34306,U43970,13,-3733.81,12,1,3733.96,0.15000000000009095
34307,U27855,13,235.31999999999996,8,5,759.51,994.8299999999999
34308,U30290,13,3090.1700000000005,10,3,4352.5,7442.67
34309,U971419,13,-1.0900000000000318,6,7,2603.75,2602.66
34310,U24910,13,8074.140000000098,5,8,1342000.0,1350074.1400000001
34311,U40968,13,-7471.169999999998,8,5,19861.9,12390.730000000003
34312,U9726,13,-2353.96,10,3,11404.0,9050.04
34313,U32740,13,835.0,8,5,688.9100000000001,1523.91
34314,U1165669,13,4140.99,10,3,12364.0,16504.989999999998
34315,U39967,13,-2244.579999999998,7,6,37290.49,35045.91
34316,U32471,13,18675.559999999998,5,8,10139.3,28814.859999999997
34317,U14950,13,37.69999999999915,5,8,15307.0,15344.699999999999
34318,U10281,13,-12375.839999999997,10,3,72403.32,60027.48000000001
34319,U30110,13,-1210.8,8,5,1584.13,373.33000000000015
34320,U42541,13,10960.78,8,5,3618.61,14579.390000000001
34321,U24448,13,582.2700000000004,10,3,11440.779999999999,12023.05
34322,U38893,13,17629.750000000015,5,8,222323.0,239952.75
34323,U9341,13,0.0,7,6,40200.0,40200.0
34324,U9193,13,-4255.36,9,4,5180.15,924.79
34325,U43325,13,-1645.99,8,5,91146.0,89500.01
34326,U40188,13,-1111.6800000000003,10,3,8890.36,7778.68
34327,U32414,13,-44878.13,9,4,50710.26,5832.130000000005
34328,U40366,13,11507.770000000004,6,7,40294.92,51802.69
34329,U10279,13,-316.77000000000004,7,6,2470.3399999999997,2153.5699999999997
34330,U615741,13,14999.999999999998,8,5,9022.0,24022.0
34331,U31331,13,1694.8800000000278,4,9,690584.83,692279.71
34332,U18272,13,1405.7600000000025,9,4,149168.56,150574.32
34333,U35326,13,-148.26000000000022,10,3,3648.76,3500.5
34334,U641773,13,1.0399999999999454,7,6,3713.0,3714.04
34335,U43807,13,-1741.6700000000023,10,3,14473.180000000002,12731.51
34336,U12909,13,-704.9699999999998,10,3,3705.96,3000.9900000000002
34337,U21394,13,-30055.86,6,7,255431.2,225375.34000000003
34338,U36861,13,-15302.279999999997,6,7,45629.18,30326.9
34339,U8693,13,-1234.1799999999994,8,5,12635.73,11401.55
34340,U21883,13,-635.3300000000006,8,5,52137.909999999996,51502.579999999994
34341,U1175324,13,0.6699999999999591,10,3,2211.2,2211.87
34342,U21156,13,151002.67000000004,4,9,706000.01,857002.68
34343,U1232656,13,226.49999999999997,12,1,973.5,1200.0
34344,U42613,13,94.5300000000002,7,6,16890.440000000002,16984.97
34345,U21424,13,2122.1499999999996,7,6,8050.6,10172.75
34346,U35171,13,6745.84,7,6,818.55,7564.39
34347,U18687,13,73.50000000000098,7,6,6730.14,6803.640000000001
34348,U12366,13,-2599.4599999999996,6,7,11085.0,8485.54
34349,U22228,13,-149.74000000001251,6,7,78477.15,78327.40999999997
34350,U41242,13,25021.090000000004,5,8,21859.590000000004,46880.68000000001
34351,U1243741,13,237.18000000000006,10,3,3542.82,3780.0
34352,U22240,13,1066.960000000021,5,8,359827.5,360894.46
34353,U37701,13,-108.61999999999989,7,6,36259.0,36150.38
34354,U41877,13,-3139.359999999999,10,3,3725.68,586.3200000000006
34355,U1297897,13,-1050.22,9,4,1350.2600000000002,300.0400000000002
34356,U34383,13,-492.32000000000244,7,6,18398.97,17906.649999999998
34357,U1313554,13,-134.63,8,5,780.0,645.37
34358,U20639,13,-38499.74,7,6,52700.0,14200.260000000002
34359,U43396,13,-228.29000000000002,9,4,407.9,179.60999999999996
34360,U928140,13,329.61999999999966,6,7,4120.41,4450.03
34361,U35660,13,2238.1899999999987,6,7,62600.0,64838.19
34362,U579817,13,-6588.58,6,7,7668.58,1080.0
34363,U33524,13,862.6500000000001,7,6,7291.46,8154.110000000001
34364,U35052,13,-2548.8399999999965,7,6,319355.0,316806.16000000003
34365,U23011,13,17965.410000000003,5,8,47814.54,65779.95000000001
34366,U33878,13,3150.1099999999997,8,5,5085.68,8235.79
34367,U23175,13,503.13,11,2,1170.2,1673.33
34368,U35809,13,1399.2199999999993,6,7,15811.0,17210.22
34369,U20427,13,-31.979999999995925,6,7,41083.82,41051.840000000004
34370,U907162,13,-43502.62000000001,10,3,43632.62000000001,130.0
34371,U24122,13,428.54999999999995,6,7,6242.0,6670.55
34372,U22075,13,2082.3999999999996,8,5,2565.3199999999997,4647.719999999999
34373,U611412,13,-9801.07,12,1,9801.08,0.010000000000218279
34374,U24693,13,-2212.6400000000003,10,3,9413.52,7200.88
34375,U16953,13,-9854.210000000003,6,7,19018.0,9163.789999999997
34376,U1161603,13,-0.3100000000004002,7,6,11388.22,11387.91
34377,U43076,13,-30849.77,8,5,57674.05,26824.280000000002
34378,U20115,13,-769.3099999999984,8,5,26295.2,25525.890000000003
34379,U9086,13,23350.7,5,8,19936.309999999998,43287.009999999995
34380,U20008,13,36318.33999999997,4,9,320000.0,356318.33999999997
34381,U18671,13,6059.810000000001,9,4,25100.0,31159.81
34382,U10118,13,4063.0,7,6,20679.0,24742.0
34383,U25256,13,-3290.24,7,6,5414.24,2124.0
34384,U25357,13,95.66999999999916,7,6,18222.65,18318.32
34385,U20241,13,-1.5200000000040745,7,6,88977.0,88975.48
34386,U37203,13,-1006.1700000000001,9,4,3149.26,2143.09
34387,U30736,13,-10761.65,10,3,11365.0,603.3500000000004
34388,U23398,13,9545.11,9,4,50508.0,60053.11
34389,U10629,13,139794.1,4,9,28555.82,168349.92
34390,U26072,13,1207.6700000000003,7,6,17029.02,18236.690000000002
34391,U13130,13,6507.01,7,6,10289.0,16796.010000000002
34392,U1328563,13,-581.89,10,3,660.93,79.03999999999996
34393,U35526,13,-106056.86999999997,7,6,425042.06,318985.19000000006
34394,U36335,13,-50.040000000000006,7,6,83.18,33.14
34395,U35270,13,-637.21,9,4,2204.7,1567.4899999999998
34396,U34929,13,-145090.69999999998,6,7,174918.65999999997,29827.959999999992
34397,U26388,13,15677.93,9,4,15880.23,31558.16
34398,U18150,13,563.31,7,6,139362.36000000002,139925.67
34399,U29622,13,151.15999999999997,9,4,1172.69,1323.85
34400,U22958,13,-4300.249999999998,7,6,5960.009999999999,1659.7600000000011
34401,U9573,13,-4035.29,9,4,8094.09,4058.8
34402,U11682,13,4019.88,8,5,2379.77,6399.65
34403,U22114,13,-58.64999999999916,6,7,23711.9,23653.250000000004
34404,U691464,13,2950.2200000000003,6,7,24050.0,27000.22
34405,U15128,13,-1739.230000000001,5,8,13778.47,12039.239999999998
34406,U29222,13,112.94000000000233,5,8,88160.4,88273.34
34407,U34731,13,5761.5999999999985,8,5,46000.0,51761.6
34408,U37381,13,-377.0600000000013,5,8,13003.38,12626.319999999998
34409,U940921,13,-0.12999999999999545,5,8,199.95,199.82
34410,U24966,13,-12531.02,7,6,33149.0,20617.98
34411,U24258,13,56606.56,7,6,209156.54,265763.1
34412,U29120,13,1274.6499999999999,6,7,4469.89,5744.54
34413,U1094866,13,11592.46,8,5,15651.539999999999,27244.0
34414,U39058,13,4994.750000000012,3,10,200513.9,205508.65
34415,U25149,13,-3508.960000000001,9,4,8089.72,4580.759999999999
34416,U38937,13,-70.38,10,3,235.96,165.58
34417,U21458,13,11266.5,5,8,22721.81,33988.31
34418,U37256,13,-6392.110000000001,6,7,15635.94,9243.83
34419,U30427,13,11.360000000000014,6,7,4377.47,4388.83
34420,U12173,13,-5817.029999999999,8,5,50821.15,45004.12
34421,U33737,13,-7586.0,9,4,16875.18,9289.18
34422,U39810,13,-18952.47,5,8,138702.44,119749.97
34423,U20271,13,-1277.0900000000001,9,4,2562.79,1285.6999999999998
34424,U33718,13,6750.51,7,6,22566.52,29317.03
34425,U32566,13,-240077.31000000006,5,8,739988.1599999999,499910.84999999986
34426,U41436,13,-3024.5200000000004,9,4,81684.81,78660.29
34427,U31252,13,-3685.4400000000005,6,7,15429.93,11744.49
34428,U32089,13,-12849.989999999994,4,9,53230.26,40380.270000000004
34429,U23628,13,-23775.940000000002,11,2,53139.420000000006,29363.480000000003
34430,U35094,13,-25178.1,7,6,61217.770000000004,36039.670000000006
34431,U44043,13,23414.039999999997,5,8,13486.7,36900.74
34432,U36330,13,-12409.07,7,6,67590.5,55181.43
34433,U43240,13,1094.08,7,6,1816.0700000000002,2910.15
34434,U24663,13,3495.3399999999965,8,5,206454.0,209949.34
34435,U34173,13,-1066.390000000007,8,5,80980.0,79913.60999999999
34436,U15953,13,-31692.569999999996,10,3,31850.569999999992,157.99999999999636
34437,U12444,13,7646.5,8,5,26153.11,33799.61
34438,U29505,13,8064.199999999999,6,7,6903.52,14967.72
34439,U22368,13,-5644.330000000002,6,7,22071.570000000003,16427.24
34440,U1140154,13,-186.57999999999998,10,3,377.58,191.0
34441,U43137,13,2590.8000000000175,7,6,340011.57,342602.37
34442,U17643,13,-473.66999999999825,7,6,59037.979999999996,58564.31
34443,U22929,13,-28251.92,6,7,112242.1,83990.18000000001
34444,U9586,13,-90978.76999999996,6,7,1118876.44,1027897.6699999999
34445,U1093179,13,-39707.65,12,1,39707.69,0.040000000000873115
34446,U33071,13,3228.69,9,4,8293.31,11522.0
34447,U1340828,13,-3432.65,11,2,3447.65,15.0
34448,U31386,13,2697.459999999999,7,6,11210.0,13907.46
34449,U42551,13,298.03999999999996,6,7,7686.0,7984.04
34450,U9700,13,3028.94,8,5,4774.29,7803.23
34451,U22543,13,179.71999999999983,8,5,6920.32,7100.04
34452,U42986,13,-34052.69,5,8,102197.45,68144.76
34453,U34429,13,-10.749999999997963,11,2,61471.02,61460.27
34454,U13736,13,10693.580000000004,8,5,29666.0,40359.58
34455,U35072,13,-63.9999999999998,8,5,8570.61,8506.61
34456,U24568,13,-210987.37,11,2,211432.06,444.6900000000023
34457,U33255,13,25412.030000000002,9,4,31690.019999999997,57102.05
34458,U686646,13,-868.9399999999999,9,4,4189.9400000000005,3321.0000000000005
34459,U37386,13,95330.97,6,7,56820.0,152150.97
34460,U18706,13,-781.1399999999999,7,6,5286.5,4505.360000000001
34461,U42439,13,-1.9899999999999818,10,3,4002.53,4000.5400000000004
34462,U1252037,13,0.9399999999998272,12,1,1519.0600000000002,1520.0
34463,U10888,13,9482.370000000003,6,7,35065.39,44547.76
34464,U10017,13,-85681.56,8,5,479762.0,394080.44
34465,U32129,13,-1343.3400000000001,8,5,5057.22,3713.88
34466,U17968,13,-21329.619999999995,6,7,136383.41,115053.79000000001
34467,U1372541,13,-6.0300000000002,9,4,12812.29,12806.26
34468,U939687,13,451.93,9,4,800.0699999999999,1252.0
34469,U950285,13,378.1399999999999,9,4,4928.96,5307.1
34470,U18941,13,525.929999999993,8,5,81100.63,81626.56
34471,U33370,13,2118.92,7,6,9594.36,11713.28
34472,U41171,13,1656.7799999999997,6,7,6853.2,8509.98
34473,U1316130,13,-0.7099999999991269,8,5,12290.0,12289.29
34474,U12473,13,16405.18,8,5,33603.0,50008.18
34475,U620847,13,-1211.5700000000002,9,4,1713.6200000000001,502.04999999999995
34476,U1003741,13,0.9600000000000364,7,6,5717.96,5718.92
34477,U18980,13,48643.61,6,7,58060.0,106703.61
34478,U12389,13,-437.5799999999999,6,7,2720.41,2282.83
34479,U1316643,13,-534.3799999999998,11,2,2704.1399999999994,2169.7599999999998
34480,U30073,13,0.27000000000043656,5,8,20737.69,20737.96
34481,U1244915,13,2.630000000000109,7,6,8120.0,8122.63
34482,U38742,13,65026.29,5,8,22947.04,87973.33
34483,U1132933,13,8297.62,6,7,9459.92,17757.54
34484,U43085,13,-5075.88,8,5,13326.970000000001,8251.09
34485,U17962,13,-16444.81,5,8,42476.77,26031.959999999995
34486,U41802,13,32249.649999999998,6,7,2776.0,35025.649999999994
34487,U33585,13,59270.82,4,9,5999.0,65269.82
34488,U20127,13,-156786.61000000002,8,5,437146.5,280359.89
34489,U43673,13,-187.7999999999993,7,6,127645.40000000001,127457.6
34490,U34522,13,703541.3799999999,5,8,502818.0,1206359.38
34491,U25060,13,14783.49,10,3,4297.5,19080.989999999998
34492,U32949,13,-31.93999999999869,8,5,32432.019999999997,32400.079999999998
34493,U955684,13,-790.31,9,4,2390.32,1600.0100000000002
34494,U42572,13,-688.9599999999973,9,4,21224.87,20535.910000000003
34495,U31529,13,14063.119999999999,5,8,179739.71,193802.83
34496,U13013,13,-36565.21,9,4,40358.58,3793.3700000000026
34497,U12262,13,402.40999999999985,7,6,10260.03,10662.44
34498,U33162,13,-49016.06,4,9,70414.01,21397.949999999997
34499,U20621,13,3037.6200000000003,10,3,3062.45,6100.07
34500,U25667,13,-2254.29,8,5,3605.01,1350.7200000000003
34501,U30912,13,8024.070000000002,10,3,12977.3,21001.370000000003
34502,U35387,13,-101.01000000004024,3,10,441799.0,441697.98999999993
34503,U17453,13,2205.319999999998,10,3,15370.519999999999,17575.839999999997
34504,U22279,13,-10464.830000000002,8,5,42965.62,32500.79
34505,U34267,13,-21658.940000000006,10,3,91667.4,70008.45999999999
34506,U38061,13,630.4800000000005,9,4,6080.0,6710.4800000000005
34507,U12516,13,4222.99,10,3,777.6600000000001,5000.65
34508,U21299,13,1515.039999999999,10,3,20531.04,22046.08
34509,U20375,13,118.17000000000007,7,6,22812.879999999997,22931.049999999996
34510,U18270,13,0.9600000000000364,6,7,21000.0,21000.96
34511,U1283381,13,0.05000000000291038,7,6,55069.2,55069.25
34512,U31839,13,-10704.66,8,5,11388.0,683.3400000000001
34513,U1150044,13,-8915.619999999999,10,3,9215.619999999999,300.0
34514,U26903,13,142.1199999999997,6,7,3912.7000000000003,4054.82
34515,U26559,13,-53535.32,5,8,85237.35,31702.030000000006
34516,U1203563,13,-2889.62,11,2,2901.0,11.38000000000011
34517,U847106,13,313.62000000000035,10,3,3953.8799999999997,4267.5
34518,U35381,13,560208.92,4,9,110500.0,670708.92
34519,U1169117,13,-367.01,10,3,1367.04,1000.03
34520,U26491,13,-332004.25999999995,5,8,652901.0,320896.74000000005
34521,U25720,13,4118.36,9,4,6381.04,10499.4
34522,U34601,13,-5742.589999999998,9,4,12589.1,6846.510000000002
34523,U25507,13,1595.6400000000003,5,8,2502.94,4098.58
34524,U22827,13,2823.8999999999996,11,2,8576.1,11400.0
34525,U19261,13,13121.66,4,9,3678.54,16800.2
34526,U20121,13,14697.18,8,5,14979.0,29676.18
34527,U707158,13,6.079999999999998,8,5,84.52,90.6
34528,U30189,13,1774.4199999999998,10,3,3101.38,4875.8
34529,U26415,13,-23.730000000000764,8,5,13480.5,13456.769999999999
34530,U603074,13,-166.91,11,2,167.13,0.21999999999999886
34531,U31218,13,-2482.19,10,3,3592.08,1109.8899999999999
34532,U28028,13,9.419999999999852,9,4,10165.24,10174.66
34533,U27534,13,-307.77999999999884,6,7,234648.4,234340.62
34534,U1098596,13,952.5100000000004,7,6,4560.820000000001,5513.330000000001
34535,U20711,13,-249.88000000000102,8,5,117329.94,117080.06
34536,U43991,13,-3031.5200000000004,7,6,16138.54,13107.02
34537,U31351,13,-168.39000000000124,8,5,40167.01,39998.62
34538,U31577,13,9825.829999999998,5,8,10405.51,20231.339999999997
34539,U25131,13,7.900000000000002,10,3,196.2,204.1
34540,U18107,13,-4186.729999999981,5,8,137862.7,133675.97000000003
34541,U31343,13,-7813.610000000005,7,6,40287.9,32474.289999999997
34542,U15506,13,-219.89,10,3,1037.31,817.42
34543,U12789,13,-6126.17,8,5,7042.93,916.7600000000002
34544,U33693,13,-2.7199999999999704,9,4,217.54,214.82000000000002
34545,U13641,13,811.81,8,5,2731.79,3543.6
34546,U1133210,13,2458.98,8,5,585.8199999999999,3044.8
34547,U37836,13,24850.39,7,6,96032.71,120883.1
34548,U20418,13,135.66000000000022,7,6,29200.0,29335.66
34549,U29976,13,-1742.0800000000002,11,2,2042.5800000000002,300.5
34550,U41155,13,3373.000000000002,9,4,7100.889999999999,10473.890000000001
34551,U35598,13,-1839.71,9,4,6350.0,4510.29
34552,U26476,13,3.400000000000105,9,4,2727.58,2730.98
34553,U1026298,13,4161.219999999999,9,4,7153.39,11314.61
34554,U1138022,13,-8791.63,12,1,8791.66,0.030000000000654836
34555,U1331540,13,870.2500000000001,7,6,1729.8400000000001,2600.09
34556,U39925,13,-6256.839999999999,9,4,12000.0,5743.160000000001
34557,U34843,13,-4132.12,9,4,12106.8,7974.679999999999
34558,U18182,13,1013.1499999999996,6,7,14686.0,15699.15
34559,U42981,13,8020.16,8,5,17584.0,25604.16
34560,U43372,13,3433.59,4,9,4600.0,8033.59
34561,U39990,13,18139.08,5,8,136062.0,154201.08000000002
34562,U41463,13,15810.29,5,8,49000.0,64810.29
34563,U20918,13,9.059999999999986,8,5,427.04,436.1
34564,U800666,13,-32078.07,9,4,35752.07,3674.0
34565,U10273,13,183.65,10,3,406.01,589.66
34566,U31213,13,647.2899999999992,8,5,10984.33,11631.619999999999
34567,U1319339,13,-2179.8199999999997,7,6,4543.33,2363.51
34568,U845138,13,-1094.4099999999999,12,1,4072.81,2978.4
34569,U24983,13,879.0899999999999,7,6,1263.9099999999999,2143.0
34570,U22766,13,-88759.39999999997,5,8,611564.06,522804.6600000001
34571,U24840,13,-11114.600000000002,6,7,73541.39,62426.78999999999
34572,U33256,13,-394.8700000000026,9,4,24423.95,24029.079999999998
34573,U42338,13,61252.340000000004,6,7,7666.74,68919.08
34574,U935899,13,-3719.970000000001,8,5,12455.0,8735.029999999999
34575,U35703,13,61495.71,6,7,204.86,61700.57
34576,U40332,13,-140.7700000000009,6,7,16269.029999999999,16128.259999999998
34577,U25425,13,2025.9299999999996,9,4,7918.64,9944.57
34578,U29659,13,13332.610000000004,5,8,233646.34,246978.95
34579,U33307,13,5434.55,9,4,1123.0700000000002,6557.620000000001
34580,U18056,13,-567.99,10,3,873.3399999999999,305.3499999999999
34581,U34580,13,5.729999999999563,8,5,26797.78,26803.51
34582,U18720,13,4846.3,9,4,1280.0,6126.3
34583,U23368,13,-89261.04000000001,8,5,202061.75,112800.70999999999
34584,U12066,13,168.45000000000437,9,4,59226.0,59394.450000000004
34585,U36180,13,38117.35,8,5,49822.0,87939.35
34586,U31659,13,108.73000000000138,8,5,16568.3,16677.03
34587,U35728,13,30099.670000000002,6,7,15927.0,46026.67
34588,U1298091,13,-278.22,11,2,436.24,158.01999999999998
34589,U13248,13,6906.879999999999,6,7,14210.44,21117.32
34590,U39194,13,-917.0399999999992,6,7,23027.04,22110.0
34591,U35838,13,1017.9999999999998,6,7,1966.68,2984.68
34592,U25454,13,120.53999999999942,9,4,5719.530000000001,5840.07
34593,U24722,13,6026.039999999999,4,9,33100.0,39126.04
34594,U14443,13,111115.34,4,9,111892.0,223007.34
34595,U17315,13,-160569.69999999998,8,5,320853.8,160284.1
34596,U23459,13,-135.2900000000006,7,6,7274.4400000000005,7139.15
34597,U28231,13,1482.38,4,9,1630.0,3112.38
34598,U17707,13,6936.0,5,8,90473.98,97409.98
34599,U1189186,13,202.0,6,7,1052.0,1254.0
34600,U39541,13,200853.15,6,7,7668.830000000001,208521.97999999998
34601,U1366794,13,250.0,8,5,500.0,750.0
34602,U34742,13,-552.9599999999995,8,5,12795.8,12242.84
34603,U32074,13,-5552.38,6,7,28704.2,23151.82
34604,U25136,13,6949.559999999998,10,3,90788.2,97737.76
34605,U39263,13,15285.179999999997,5,8,53794.0,69079.18
34606,U9504,13,11120.929999999998,4,9,1336.0,12456.929999999998
34607,U944193,13,0.30000000000007104,7,6,2488.3,2488.6000000000004
34608,U1267658,13,-3288.5899999999992,10,3,5305.379999999999,2016.79
34609,U42096,13,-7322.15,10,3,37873.37,30551.22
34610,U39005,13,46913.0,9,4,18226.9,65139.9
34611,U922561,13,-1509.26,8,5,2608.11,1098.8500000000001
34612,U30250,13,29052.9,7,6,6620.47,35673.37
34613,U8902,13,4198.789999999994,8,5,74303.55,78502.34
34614,U42552,13,-10064.130000000003,8,5,10826.759999999998,762.6299999999956
34615,U38614,13,-124.49999999999935,7,6,10927.08,10802.58
34616,U16695,13,-7895.69,9,4,11748.919999999998,3853.2299999999987
34617,U24418,13,-8912.110000000044,6,7,1010000.0,1001087.8899999999
34618,U30595,13,-6800.320000000001,10,3,8613.0,1812.6799999999994
34619,U12093,13,-733.0799999999999,5,8,32039.0,31305.92
34620,U19210,13,-828.4399999999997,11,2,3428.44,2600.0000000000005
34621,U19590,13,-1946.6800000000007,9,4,7103.700000000001,5157.02
34622,U674185,13,13.819999999999935,9,4,4365.17,4378.99
34623,U39483,13,17548.089999999997,5,8,21081.43,38629.52
34624,U1246869,13,0.0,6,7,181.53,181.53
34625,U10221,13,-4050.7700000000004,10,3,7064.0,3013.2299999999996
34626,U22206,13,-5709.910000000001,9,4,10954.02,5244.11
34627,U36352,13,-152334.19,8,5,217428.0,65093.81
34628,U23736,13,7934.76,2,11,8060.0,15994.76
34629,U26635,13,-199.55999999999986,7,6,1522.53,1322.97
34630,U33626,13,-12110.46,9,4,34823.009999999995,22712.549999999996
34631,U43170,13,3864.49,6,7,7400.49,11264.98
34632,U12958,13,12853.23,7,6,16947.79,29801.02
34633,U932665,13,-419.5899999999999,9,4,542.05,122.46000000000004
34634,U22107,13,-9997.660000000003,7,6,330000.0,320002.33999999997
34635,U30162,13,-602.48,8,5,1492.9799999999998,890.4999999999998
34636,U27974,13,6737.899999999998,7,6,2466.2200000000003,9204.119999999999
34637,U33795,13,974.5499999999993,6,7,21790.58,22765.13
34638,U39166,13,-4455.3,8,5,13563.0,9107.7
34639,U12628,13,2041.2000000000007,5,8,241228.8,243270.0
34640,U32155,13,400.3799999999969,11,2,49603.32,50003.7
34641,U35478,13,17047.83,3,10,13362.74,30410.57
34642,U744012,13,1124.2,7,6,4901.39,6025.59
34643,U14857,13,19380.7,5,8,4700.0,24080.7
34644,U29240,13,40162.51,4,9,11242.42,51404.93
34645,U24694,13,84.36999999999989,8,5,1546.85,1631.2199999999998
34646,U22901,13,-79175.79000000001,9,4,107773.1,28597.309999999998
34647,U32254,13,342.3800000000007,10,3,7085.7,7428.080000000001
34648,U651283,13,-242.04000000000005,11,2,287.78000000000003,45.73999999999998
34649,U24135,13,1862.4900000000052,7,6,131226.0,133088.49
34650,U25630,13,129.20000000000073,6,7,57008.05,57137.25
34651,U8339,13,-2797.1299999999997,10,3,5007.45,2210.32
34652,U22992,13,51011.08,6,7,64579.16,115590.24
34653,U37354,13,7917.389999999999,8,5,783.2299999999999,8700.619999999999
34654,U38817,13,-52438.850000000006,6,7,63930.01,11491.159999999996
34655,U16373,13,-2128.4700000000003,6,7,41687.3,39558.83
34656,U31852,13,11037.220000000001,3,10,209527.36000000002,220564.58000000002
34657,U37734,13,12151.630000000001,8,5,33812.170000000006,45963.8
34658,U1046528,13,-2546.0,8,5,7245.999999999999,4699.999999999999
34659,U8331,13,497.04999999999563,9,4,52689.74,53186.78999999999
34660,U38666,13,-65.83000000000038,8,5,4994.78,4928.949999999999
34661,U987541,13,2899.8099999999995,8,5,8765.73,11665.539999999999
34662,U1045031,13,35.349999999999966,8,5,800.11,835.46
34663,U22656,13,-14.91,7,6,34397.71,34382.799999999996
34664,U18955,13,7704.030000000001,7,6,10340.1,18044.13
34665,U15843,13,47875.51,5,8,35501.12,83376.63
34666,U27239,13,8456.470000000001,8,5,24024.5,32480.97
34667,U896504,13,-708.7999999999998,8,5,1480.47,771.6700000000002
34668,U14869,13,-61519.14000000001,6,7,90279.9,28760.759999999987
34669,U16506,13,774.6200000000025,7,6,117758.44,118533.06
34670,U28141,13,11225.050000000001,7,6,57200.0,68425.05
34671,U26316,13,-4740.77,9,4,21557.48,16816.71
34672,U9716,13,4440.0,9,4,31090.0,35530.0
34673,U16507,13,56.149999999999864,5,8,2425.88,2482.0299999999997
34674,U18332,13,-4456.99,6,7,9192.0,4735.01
34675,U18390,13,3096.9800000000105,8,5,251170.6,254267.58000000002
34676,U673264,13,-42.56999999999996,10,3,1000.77,958.2
34677,U1205673,13,-38185.149999999994,10,3,43267.149999999994,5082.0
34678,U33871,13,-1451.8199999999997,9,4,4431.610000000001,2979.790000000001
34679,U33963,13,761.6600000000001,9,4,2504.84,3266.5
34680,U43081,13,8.72546479513403e-12,6,7,155779.46,155779.46
34681,U1314103,13,-298.4,9,4,1130.9299999999998,832.5299999999999
34682,U34636,13,1433.48,10,3,5543.0,6976.48
34683,U41771,13,-59.2800000000002,9,4,12487.640000000001,12428.36
34684,U836251,13,-498.19,9,4,1904.08,1405.8899999999999
34685,U27139,13,-948.1800000000003,8,5,12394.0,11445.82
34686,U24922,13,-3293.75,9,4,7759.0,4465.25
34687,U28031,13,-5979.139999999999,9,4,186000.0,180020.86
34688,U34002,13,7502.48,6,7,10818.400000000001,18320.88
34689,U14392,13,15179.630000000003,9,4,19136.1,34315.73
34690,U41667,13,-43617.590000000004,7,6,71725.0,28107.409999999996
34691,U33659,13,2078.74,9,4,593.56,2672.2999999999997
34692,U37691,13,1709.63,7,6,9029.01,10738.64
34693,U21333,12,-108.13999999999999,7,5,725.4,617.26
34694,U37048,12,4003.27,5,7,841.16,4844.43
34695,U741670,12,500.0,6,6,6431.05,6931.05
34696,U25761,12,49971.17,7,5,2607.86,52579.03
34697,U30588,12,-49.8100000000004,6,6,9633.26,9583.45
34698,U19842,12,2923.36,4,8,3000.0,5923.360000000001
34699,U31616,12,-5999.97,6,6,17705.0,11705.029999999999
34700,U36517,12,488.97999999999956,5,7,9145.05,9634.029999999999
34701,U778513,12,-1258.0,7,5,5822.0,4564.0
34702,U9258,12,16702.0,5,7,23400.93,40102.93
34703,U17536,12,-25758.19,7,5,29824.42,4066.2299999999996
34704,U38382,12,-4276.609999999999,7,5,9824.55,5547.9400000000005
34705,U40969,12,-4637.679999999956,6,6,1058632.98,1053995.3
34706,U17999,12,-316.28999999999996,6,6,1787.6799999999998,1471.3899999999999
34707,U40755,12,-60887.31,9,3,103915.15000000001,43027.84000000001
34708,U32396,12,-1483.4300000000005,8,4,5243.680000000001,3760.250000000001
34709,U33188,12,6512.13,6,6,21225.29,27737.420000000002
34710,U41756,12,-7115.099999999999,4,8,18727.65,11612.550000000003
34711,U1106921,12,-2.089999999999918,7,5,4727.11,4725.0199999999995
34712,U24552,12,81387.48,7,5,1533.22,82920.7
34713,U37250,12,-52.07000000000001,10,2,192.13,140.06
34714,U659764,12,5265.240000000001,4,8,401.5,5666.740000000001
34715,U21974,12,310.18999999999994,7,5,109.76000000000002,419.94999999999993
34716,U27559,12,-937.1500000000005,8,4,8823.6,7886.45
34717,U19707,12,-477.7499999999982,5,7,29125.59,28647.840000000004
34718,U38173,12,4748.33,6,6,287.2,5035.53
34719,U34080,12,-9407.859999999999,7,5,22893.670000000002,13485.810000000003
34720,U8900,12,3675.2100000000014,4,8,14846.82,18522.030000000002
34721,U28737,12,-5522.6,9,3,7037.79,1515.1899999999996
34722,U9282,12,171.1700000000019,5,7,56430.0,56601.17
34723,U22700,12,5433.63,7,5,5455.44,10889.07
34724,U11540,12,-10666.080000000002,8,4,26970.22,16304.14
34725,U1268587,12,1.799999999999983,6,6,588.86,590.66
34726,U41749,12,303577.37,7,5,3245.0,306822.37
34727,U12032,12,346.51,7,5,606.0,952.51
34728,U25053,12,61.710000000000264,6,6,60684.49,60746.2
34729,U637170,12,13602.04,5,7,1025.96,14628.0
34730,U20581,12,-137.75999999999928,9,3,2622.9199999999996,2485.1600000000003
34731,U820044,12,-87.1,8,4,369.7,282.6
34732,U35140,12,3787.809999999993,6,6,239893.59,243681.4
34733,U30084,12,-3050.1100000000233,4,8,400173.26,397123.14999999997
34734,U40751,12,-529.6599999999999,6,6,21077.0,20547.34
34735,U28288,12,-218.38999999999942,9,3,20016.72,19798.33
34736,U13300,12,20147.49,7,5,853.45,21000.940000000002
34737,U37300,12,-232554.02,5,7,256500.37,23946.350000000006
34738,U43413,12,-100490.74,4,8,132170.0,31679.259999999995
34739,U22101,12,0.0,6,6,30252.03,30252.03
34740,U31458,12,58049.13,6,6,1797.96,59847.09
34741,U22494,12,13178.01,4,8,1654.7,14832.710000000001
34742,U14849,12,-28668.03999999999,4,8,533962.81,505294.7700000001
34743,U19317,12,-155426.39,8,4,505865.0,350438.61
34744,U43814,12,17606.62,7,5,6689.02,24295.64
34745,U979889,12,0.0,7,5,7713.0,7713.0
34746,U39936,12,12.420000000000073,7,5,8150.0,8162.42
34747,U1032315,12,603.85,8,4,1100.0,1703.85
34748,U38814,12,0.029999999998835847,7,5,80577.63,80577.66
34749,U22433,12,-507.4499999999999,8,4,2690.1400000000003,2182.6900000000005
34750,U1087372,12,19.870000000000005,8,4,2801.0,2820.87
34751,U16281,12,24573.440000000002,6,6,73329.73999999999,97903.18
34752,U31469,12,57673.70999999999,5,7,46400.0,104073.70999999999
34753,U1052325,12,-2616.3199999999997,8,4,5643.32,3027.0
34754,U21137,12,-8498.62,4,8,10705.660000000002,2207.040000000001
34755,U18607,12,200.0,6,6,54600.5,54800.5
34756,U20095,12,-2746.33,9,3,6381.219999999999,3634.8899999999994
34757,U22991,12,4914.88,9,3,1351.8,6266.68
34758,U29096,12,-38891.97999999998,5,7,258579.31,219687.33000000002
34759,U12160,12,2215.78,9,3,360.21999999999997,2576.0
34760,U760787,12,-229.99999999999977,8,4,4442.38,4212.38
34761,U22874,12,44942.57,7,5,26421.0,71363.57
34762,U43839,12,-3568.61,7,5,7174.0,3605.39
34763,U20028,12,4995.900000000001,5,7,26021.91,31017.81
34764,U39444,12,-16104.529999999995,6,6,85000.0,68895.47
34765,U24661,12,56445.399999999994,7,5,955.44,57400.84
34766,U36023,12,150596.21,5,7,17000.0,167596.21
34767,U31819,12,-465.7900000000006,6,6,7967.0,7501.209999999999
34768,U13607,12,520100.98,5,7,503102.52,1023203.5
34769,U40547,12,1450.75,5,7,11350.93,12801.68
34770,U26933,12,-27762.789999999994,7,5,58753.84,30991.050000000003
34771,U38964,12,431.50999999999914,5,7,47600.0,48031.51
34772,U18563,12,49749.51,6,6,4057.1,53806.61
34773,U18062,12,400.68999999999653,4,8,51415.83,51816.52
34774,U42444,12,-12704.51,9,3,15479.6,2775.09
34775,U13889,12,18155.17,5,7,19590.16,37745.33
34776,U1195318,12,-7472.4400000000005,9,3,7874.4400000000005,402.0
34777,U36477,12,-3625.639999999999,9,3,6320.71,2695.070000000001
34778,U15469,12,-437.64999999999964,7,5,16041.65,15604.0
34779,U14163,12,9383.099999999999,6,6,316.33000000000004,9699.429999999998
34780,U976712,12,-5338.55,11,1,5339.31,0.7600000000002183
34781,U14743,12,-3388.0099999999948,4,8,88817.38,85429.37000000001
34782,U17818,12,-24298.29,9,3,24637.08,338.7900000000009
34783,U23866,12,-40968.26,9,3,52824.53,11856.269999999997
34784,U40462,12,-20824.709999999995,8,4,20887.419999999995,62.70999999999913
34785,U30748,12,30991.210000000003,7,5,41837.5,72828.71
34786,U26553,12,4001.8100000000013,5,7,22692.1,26693.91
34787,U38444,12,-2905.67,8,4,21778.7,18873.03
34788,U21253,12,-2035.0100000000011,7,5,22524.97,20489.96
34789,U1027521,12,-1957.62,9,3,5057.62,3100.0
34790,U1053747,12,-60.40000000000006,9,3,1166.18,1105.78
34791,U24759,12,8582.04,7,5,1048.08,9630.12
34792,U42155,12,4943.080000000002,6,6,103042.0,107985.08
34793,U34459,12,-10226.070000000003,7,5,18500.0,8273.929999999997
34794,U31908,12,117.12,8,4,2883.7599999999998,3000.8799999999997
34795,U19549,12,-555.0499999999998,8,4,1091.8799999999999,536.83
34796,U1272954,12,-19529.899999999998,8,4,20079.899999999998,550.0
34797,U24972,12,-632.99,9,3,1277.0,644.01
34798,U14779,12,414.3199999999979,5,7,26354.62,26768.939999999995
34799,U36107,12,-949.77,7,5,1599.0,649.23
34800,U35719,12,-3162.5,10,2,7392.0,4229.5
34801,U8977,12,1726.8199999999997,8,4,2806.69,4533.51
34802,U16744,12,480.59,6,6,44520.0,45000.59
34803,U31664,12,-15348.41,8,4,37680.0,22331.59
34804,U13890,12,2489.61,8,4,884.0,3373.61
34805,U29412,12,-18.79000000000815,5,7,126355.0,126336.20999999999
34806,U11808,12,-1079.5,7,5,12006.54,10927.04
34807,U34567,12,92285.69,6,6,5491.629999999999,97777.32
34808,U20585,12,4618.87,7,5,715.1,5333.97
34809,U9980,12,939.880000000001,6,6,11665.4,12605.28
34810,U35272,12,2888.2000000000003,8,4,1118.6,4006.8
34811,U41017,12,-70982.73,6,6,259000.0,188017.27000000002
34812,U30720,12,-15475.48,6,6,41678.38,26202.899999999998
34813,U27119,12,1.3799999999982901,7,5,18227.16,18228.539999999997
34814,U22468,12,79.5,7,5,568.0,647.5
34815,U1355384,12,-26.590000000000227,6,6,3478.36,3451.77
34816,U29690,12,-57.910000000000025,7,5,708.64,650.73
34817,U977923,12,-2500.94,9,3,3714.29,1213.35
34818,U12519,12,4394.220000000001,8,4,65683.0,70077.22
34819,U24795,12,16824.44,9,3,30619.0,47443.44
34820,U960882,12,-3939.58,9,3,7856.26,3916.6800000000003
34821,U37135,12,-273.58000000000004,9,3,615.0,341.41999999999996
34822,U29442,12,-97.95999999999961,7,5,10210.02,10112.060000000001
34823,U27682,12,-9.390000000000875,6,6,80058.4,80049.01
34824,U24548,12,707.24,6,6,1908.0,2615.24
34825,U1230274,12,-307.46000000000004,7,5,1299.17,991.71
34826,U38217,12,12428.630000000005,6,6,320506.0,332934.63
34827,U39653,12,-3088.1699999999987,8,4,14776.7,11688.530000000002
34828,U22139,12,-31631.729999999996,5,7,114482.34,82850.61
34829,U30876,12,15565.200000000003,3,9,2000.01,17565.210000000003
34830,U28714,12,24831.84,5,7,12170.0,37001.84
34831,U1154935,12,-77.41000000000011,8,4,2486.53,2409.12
34832,U35345,12,-17045.859999999997,7,5,25046.22,8000.360000000004
34833,U38606,12,-89466.79,7,5,356008.0,266541.21
34834,U30470,12,2712.67,5,7,13877.96,16590.629999999997
34835,U22284,12,5493.72,4,8,3768.34,9262.060000000001
34836,U11211,12,3514.6899999999996,7,5,2729.7300000000005,6244.42
34837,U33096,12,5815.200000000001,4,8,4779.0,10594.2
34838,U29401,12,76.11999999999989,8,4,2937.6099999999997,3013.7299999999996
34839,U36358,12,-20810.879999999997,8,4,21614.63,803.7500000000036
34840,U29402,12,-11986.2,9,3,41990.0,30003.8
34841,U31641,12,56.47999999999956,7,5,10253.8,10310.279999999999
34842,U42445,12,0.02999999999974534,6,6,3680.0,3680.0299999999997
34843,U30688,12,-645.8799999999974,6,6,23987.089999999997,23341.21
34844,U39355,12,3025.12,6,6,5596.0,8621.119999999999
34845,U652582,12,-219.32999999999998,6,6,858.01,638.6800000000001
34846,U715387,12,51.16000000000031,6,6,5858.0,5909.16
34847,U23451,12,12320.11,4,8,12325.0,24645.11
34848,U12083,12,-7408.740000000001,8,4,9269.199999999999,1860.4599999999982
34849,U41633,12,-112175.2,7,5,128000.0,15824.800000000003
34850,U1084811,12,285.7299999999999,7,5,1594.21,1879.94
34851,U39137,12,213751.83000000002,0,12,0.0,213751.83000000002
34852,U44068,12,4397.01,8,4,10504.0,14901.01
34853,U31450,12,2559.5100000000198,4,8,208754.52,211314.03
34854,U31164,12,109735.91,5,7,151000.03000000003,260735.94000000003
34855,U17567,12,-8081.479999999999,9,3,21261.41,13179.93
34856,U19513,12,9960.01,6,6,1560.0,11520.01
34857,U8363,12,-8433.060000000001,9,3,16837.300000000003,8404.240000000002
34858,U43663,12,10000.9,5,7,22000.0,32000.9
34859,U1086612,12,-1665.8499999999997,5,7,2171.4599999999996,505.6099999999999
34860,U902065,12,6.55,8,4,6633.91,6640.46
34861,U26033,12,-423.85,10,2,729.0,305.15
34862,U40044,12,-1132.32,9,3,3237.94,2105.62
34863,U12156,12,5649.890000000007,3,9,205900.0,211549.89
34864,U29015,12,8369.720000000001,6,6,55308.35,63678.07
34865,U31430,12,-20788.31,9,3,57212.0,36423.69
34866,U41686,12,-70681.29999999999,8,4,75144.0,4462.700000000012
34867,U32262,12,15498.900000000001,6,6,20573.570000000003,36072.47
34868,U11322,12,111.37000000000012,7,5,2899.44,3010.8100000000004
34869,U28996,12,22248.53,6,6,20508.239999999998,42756.77
34870,U34941,12,61502.12999999999,3,9,63611.35999999999,125113.48999999999
34871,U33803,12,5245.0,7,5,8875.08,14120.08
34872,U36570,12,-26119.549999999996,7,5,29680.149999999998,3560.600000000002
34873,U15838,12,8950.9,5,7,27310.14,36261.04
34874,U39308,12,10000.309999999998,5,7,54000.3,64000.61
34875,U12098,12,-3009.5500000000034,8,4,29643.820000000003,26634.27
34876,U1129652,12,152.60000000000002,8,4,1735.5,1888.1
34877,U21848,12,148.5600000000004,6,6,5472.669999999999,5621.23
34878,U40809,12,-45456.810000000005,7,5,52140.04000000001,6683.230000000003
34879,U21639,12,1127.43,9,3,1096.96,2224.3900000000003
34880,U1010839,12,221.86,7,5,1928.15,2150.01
34881,U1163752,12,-38940.0,9,3,47133.369999999995,8193.369999999995
34882,U27436,12,-152752.41,4,8,470000.0,317247.58999999997
34883,U665107,12,-1440.3399999999983,9,3,11191.97,9751.630000000001
34884,U10461,12,4233.48,3,9,580.53,4814.009999999999
34885,U18754,12,-97815.68,5,7,517500.0,419684.32
34886,U22074,12,-1.9700000000011642,6,6,79269.54000000001,79267.57
34887,U42738,12,-27.589999999981956,4,8,632139.0,632111.41
34888,U31830,12,842.8799999999994,8,4,10734.800000000001,11577.68
34889,U16323,12,1716.0,6,6,13114.0,14830.0
34890,U40473,12,5457.820000000002,6,6,50499.0,55956.82
34891,U26160,12,108.47000000000116,8,4,150971.6,151080.07
34892,U962580,12,0.2599999999999909,6,6,965.8199999999999,966.0799999999999
34893,U995435,12,381.98,8,4,630.0,1011.98
34894,U30575,12,4489.040000000001,3,9,4746.71,9235.75
34895,U34796,12,5356.790000000001,7,5,26308.0,31664.79
34896,U24026,12,-56989.66,11,1,57044.44,54.779999999998836
34897,U27772,12,549.49,6,6,580.64,1130.13
34898,U582211,12,114.29000000000087,7,5,65412.49,65526.78
34899,U22950,12,41598.61,2,10,23374.84,64973.45
34900,U39930,12,30124.53,5,7,274924.0,305048.53
34901,U29108,12,213278.6,5,7,75297.0,288575.6
34902,U25672,12,-31826.589999999997,4,8,103079.4,71252.81
34903,U18744,12,992449.9299999999,8,4,16872.47,1009322.3999999999
34904,U17858,12,20.960000000000036,8,4,8379.060000000001,8400.02
34905,U34892,12,62992.53,5,7,12794.4,75786.93
34906,U18141,12,96.88999999999942,6,6,18035.0,18131.89
34907,U37537,12,-36362.36,8,4,38136.05,1773.6900000000023
34908,U38566,12,9999.330000000004,9,3,74063.0,84062.33
34909,U27107,12,-190526.89999999994,4,8,546000.0,355473.1000000001
34910,U31082,12,591.2700000000041,6,6,59099.43,59690.700000000004
34911,U30684,12,-1191.3699999999953,7,5,235552.01,234360.64
34912,U762287,12,0.010000000000218279,5,7,4762.0,4762.01
34913,U33152,12,40.06,7,5,117.0,157.06
34914,U20164,12,-3229.75,7,5,7973.26,4743.51
34915,U34597,12,12640.279999999999,4,8,6300.0,18940.28
34916,U29844,12,-2225.1099999999997,9,3,2869.9,644.7900000000004
34917,U23658,12,-2496.84,8,4,6997.889999999999,4501.049999999999
34918,U1257428,12,-7511.9,11,1,7611.9,100.0
34919,U40581,12,-511.80000000000007,7,5,1405.0,893.1999999999999
34920,U36483,12,9.064970996064403e-14,6,6,2064.44,2064.44
34921,U18500,12,-2039.5299999999988,4,8,64171.08,62131.55
34922,U967814,12,-880.6300000000001,12,0,880.6300000000001,0.0
34923,U16699,12,70225.53,8,4,513.2099999999999,70738.74
34924,U27886,12,7034.110000000001,5,7,6710.370000000001,13744.480000000001
34925,U26782,12,-2755.85,8,4,17002.0,14246.15
34926,U14698,12,50004.88,9,3,10996.5,61001.38
34927,U39481,12,-53349.14,3,9,212260.0,158910.86
34928,U1253940,12,-21116.620000000003,7,5,24896.690000000002,3780.0699999999997
34929,U42213,12,-28841.36,9,3,36087.0,7245.639999999999
34930,U26509,12,-3077.6899999999996,8,4,5086.8,2009.1100000000006
34931,U28224,12,1925.1799999999998,9,3,5163.98,7089.16
34932,U32470,12,-43653.99,7,5,79431.0,35777.01
34933,U969658,12,-22.5,7,5,1081.5,1059.0
34934,U24777,12,3861.32,6,6,4335.889999999999,8197.21
34935,U19810,12,369.79999999998836,6,6,440009.0,440378.8
34936,U28123,12,-46041.94999999999,4,8,700247.2000000001,654205.2500000001
34937,U27950,12,-3087.21,5,7,5268.950000000001,2181.7400000000007
34938,U43702,12,28058.979999999996,9,3,10595.19,38654.17
34939,U24914,12,172.80999999999767,6,6,102061.68,102234.48999999999
34940,U1086550,12,142.95,6,6,477.05000000000007,620.0
34941,U33500,12,5155.070000000004,4,8,75258.48,80413.55
34942,U11515,12,-10573.920000000002,10,2,13093.779999999999,2519.859999999997
34943,U702277,12,191.0,3,9,13769.0,13960.0
34944,U43911,12,4433.700000000001,9,3,7100.0,11533.7
34945,U28573,12,-3312.9500000000007,8,4,14137.57,10824.619999999999
34946,U29958,12,59.179999999999836,6,6,39747.759999999995,39806.939999999995
34947,U1287826,12,-514.3699999999999,10,2,1231.2200000000003,716.8500000000004
34948,U32487,12,6203.199999999997,8,4,25992.860000000004,32196.06
34949,U24893,12,-1683.86,7,5,6102.0,4418.14
34950,U24072,12,1950.6799999999998,8,4,5816.25,7766.93
34951,U35676,12,-2200.5900000000024,8,4,63538.51,61337.92
34952,U20885,12,3142.1000000000004,6,6,8043.700000000001,11185.800000000001
34953,U16285,12,-531.4899999999991,6,6,13211.94,12680.45
34954,U37190,12,1446.2700000000004,6,6,23142.0,24588.27
34955,U44054,12,6103.33,7,5,12060.0,18163.33
34956,U37712,12,-5441.35,8,4,8351.01,2909.66
34957,U29158,12,-329641.65,7,5,340348.0,10706.349999999977
34958,U678981,12,-565.05,10,2,2665.0699999999997,2100.0199999999995
34959,U15199,12,13690.839999999997,10,2,117184.47,130875.31
34960,U34888,12,-646.6200000000008,8,4,10810.61,10163.99
34961,U35597,12,-269.08000000000004,7,5,572.82,303.74
34962,U741391,12,-2492.4700000000003,9,3,2617.65,125.17999999999984
34963,U35854,12,37911.70000000002,3,9,100279.4,138191.1
34964,U707540,12,-7655.509999999999,9,3,7774.199999999999,118.6899999999996
34965,U42581,12,-1382.3900000000003,6,6,21982.800000000003,20600.410000000003
34966,U23146,12,5628.55,0,12,0.0,5628.55
34967,U31613,12,529.1999999999971,4,8,114900.0,115429.2
34968,U42480,12,-13742.079999999996,6,6,27263.2,13521.120000000004
34969,U27261,12,38.950000000000074,7,5,5061.0,5099.95
34970,U10296,12,-9077.260000000002,8,4,22791.56,13714.3
34971,U28164,12,-2472.8799999999997,4,8,2600.0,127.12000000000035
34972,U28172,12,-3086.0099999999984,5,7,54573.57,51487.56
34973,U41116,12,25735.809999999998,7,5,26356.04,52091.85
34974,U22839,12,8842.29,5,7,10206.0,19048.29
34975,U8174,12,973.4999999999994,7,5,8225.73,9199.23
34976,U37918,12,0.9500000000116415,7,5,170463.29,170464.24000000002
34977,U28661,12,-78887.74999999999,9,3,83468.12999999999,4580.380000000005
34978,U1085375,12,-4774.58,8,4,9565.71,4791.129999999999
34979,U19589,12,1370.29,10,2,344.8,1715.09
34980,U34654,12,-4156.52,9,3,13438.77,9282.25
34981,U1240156,12,-371.79,12,0,371.79,0.0
34982,U32106,12,2398.84,6,6,20701.16,23100.0
34983,U32280,12,-3084.3999999999987,8,4,19130.22,16045.820000000003
34984,U16698,12,9256.160000000002,4,8,6676.65,15932.810000000001
34985,U36197,12,33359.94,6,6,119007.6,152367.54
34986,U44033,12,1173.8400000000004,6,6,18162.48,19336.32
34987,U21113,12,-56174.43,5,7,108260.0,52085.57
34988,U1187235,12,108.75999999999999,8,4,646.5,755.26
34989,U11898,12,-4952.509999999999,6,6,5897.439999999999,944.9299999999994
34990,U939613,12,973.02,6,6,11527.0,12500.02
34991,U39237,12,-1574.5399999999968,6,6,121200.0,119625.46
34992,U13573,12,-3174.080000000001,9,3,5736.830000000001,2562.75
34993,U21100,12,632.6899999999998,7,5,9255.06,9887.75
34994,U33623,12,333.07000000000016,7,5,6952.16,7285.23
34995,U36469,12,-16.30999999999767,7,5,15630.0,15613.690000000002
34996,U11576,12,-4949.07,7,5,45576.92,40627.85
34997,U37677,12,-331356.25,9,3,450000.0,118643.75
34998,U14860,12,-5065.889999999999,8,4,5116.57,50.68000000000029
34999,U10056,12,10409.61,6,6,28485.09,38894.7
35000,U20234,12,-7.980000000000473,5,7,12917.23,12909.25
35001,U23698,12,175.54000000000005,8,4,600.55,776.09
35002,U34734,12,-2540.6000000000004,9,3,16038.0,13497.4
35003,U938586,12,-877.5,9,3,1677.91,800.4100000000001
35004,U32922,12,435.55999999999995,7,5,4952.88,5388.4400000000005
35005,U26670,12,-168.89999999999873,6,6,32075.04,31906.140000000003
35006,U32540,12,2919.0100000000007,9,3,5506.0,8425.01
35007,U22965,12,0.020000000004074536,4,8,109790.0,109790.02
35008,U43095,12,303.46000000000004,7,5,2786.46,3089.92
35009,U38733,12,-37737.86,8,4,49174.8,11436.940000000002
35010,U30954,12,-0.1999999999999318,6,6,3251.3999999999996,3251.2
35011,U583181,12,51.120000000000005,6,6,321.0,372.12
35012,U36080,12,3611.46,2,10,1891.09,5502.55
35013,U35170,12,-6641.889999999999,8,4,13800.0,7158.110000000001
35014,U765291,12,4538.52,8,4,15650.529999999999,20189.05
35015,U38509,12,-39712.31,7,5,66099.84,26387.53
35016,U1257967,12,2003.4,5,7,1711.0,3714.4
35017,U28739,12,-19254.620000000003,5,7,59256.33,40001.71
35018,U35236,12,925.4100000000001,8,4,4074.6499999999996,5000.0599999999995
35019,U18763,12,-44235.3,6,6,67001.11,22765.809999999998
35020,U14898,12,-1664.89,8,4,2937.96,1273.07
35021,U21983,12,-2535.75,9,3,5263.360000000001,2727.6100000000006
35022,U18456,12,67116.83,4,8,7684.0,74800.83
35023,U36395,12,-772.2900000000002,8,4,1993.3700000000001,1221.08
35024,U634449,12,-612.3400000000001,7,5,1747.49,1135.1499999999999
35025,U25582,12,36665.61,4,8,314.0,36979.61
35026,U15278,12,-1988.199999999999,9,3,32785.17999999999,30796.979999999996
35027,U38806,12,2044.5900000000001,10,2,15758.300000000001,17802.89
35028,U1259930,12,-583.67,9,3,645.98,62.31000000000006
35029,U32664,12,8.419999999999959,7,5,3583.82,3592.2400000000002
35030,U42972,12,524.9399999999987,5,7,54620.0,55144.94
35031,U35054,12,-36790.81999999999,7,5,39310.0,2519.1800000000076
35032,U9613,12,-8.75,5,7,2308.98,2300.23
35033,U18887,12,-26030.600000000002,6,6,54899.14,28868.539999999997
35034,U930445,12,-734.39,10,2,834.4,100.00999999999999
35035,U33812,12,2054.170000000002,8,4,20142.68,22196.850000000002
35036,U16422,12,228647.66000000003,8,4,26528.18,255175.84000000003
35037,U31936,12,-2040.7000000000005,9,3,13532.67,11491.97
35038,U21197,12,6.160000000000003,7,5,1183.6399999999999,1189.8
35039,U41439,12,7283.07,8,4,23802.8,31085.87
35040,U36000,12,101.80000000000001,11,1,198.2,300.0
35041,U8746,12,-5932.36,6,6,12850.880000000001,6918.520000000001
35042,U24282,12,-372.25000000000006,6,6,2428.54,2056.29
35043,U41346,12,145.52999999999702,6,6,69559.62,69705.15
35044,U18800,12,-1598.88,8,4,3779.1299999999997,2180.2499999999995
35045,U13278,12,90740.54,2,10,150972.07,241712.61
35046,U1313156,12,-6.3700000000000045,9,3,206.39,200.01999999999998
35047,U1217161,12,29.0,6,6,2067.0,2096.0
35048,U8969,12,-73.86000000000043,7,5,10335.96,10262.099999999999
35049,U15782,12,283736.01,2,10,100000.0,383736.01
35050,U15573,12,10605.599999999999,3,9,57000.0,67605.6
35051,U29709,12,-13100.490000000002,3,9,78000.0,64899.509999999995
35052,U33685,12,11.20000000000029,6,6,7232.0,7243.200000000001
35053,U1303305,12,-1.8900000000001,7,5,2697.0,2695.1099999999997
35054,U30249,12,-391.01,9,3,667.75,276.74
35055,U29827,12,429.21000000000004,5,7,12471.44,12900.650000000001
35056,U34067,12,-38018.430000000044,2,10,618879.0,580860.57
35057,U29898,12,17826.45,4,8,17806.0,35632.45
35058,U21327,12,-10235.35,7,5,17659.64,7424.289999999999
35059,U40116,12,531.71,7,5,80211.0,80742.71
35060,U35776,12,43496.66,4,8,7967.82,51464.48
35061,U1131581,12,-3200.0,7,5,9882.32,6682.32
35062,U1151761,12,-419.40999999999997,7,5,1398.04,978.63
35063,U42236,12,2.8300000000017462,6,6,103095.20000000001,103098.03000000001
35064,U945865,12,0.0,6,6,17200.0,17200.0
35065,U21319,12,-14388.29,4,8,34825.0,20436.71
35066,U11933,12,-574.8100000000004,9,3,5644.03,5069.219999999999
35067,U1132682,12,0.0,3,9,4305.84,4305.84
35068,U33276,12,40908.59,4,8,7480.67,48389.259999999995
35069,U28561,12,-2386.03,9,3,3876.67,1490.6399999999999
35070,U31133,12,-7.1599999999998545,8,4,1617.7599999999998,1610.6
35071,U35577,12,1103.0,11,1,20747.0,21850.0
35072,U31542,12,-2493.48,8,4,2786.6,293.1199999999999
35073,U21114,12,-13194.529999999999,9,3,14285.82,1091.2900000000009
35074,U41592,12,-2591.1,10,2,2600.0,8.900000000000091
35075,U43915,12,78250.12,4,8,148016.81,226266.93
35076,U28516,12,-95.35,10,2,108.0,12.650000000000006
35077,U1186936,12,325.0,4,8,67061.0,67386.0
35078,U42191,12,223.15999999999985,5,7,14485.0,14708.16
35079,U20869,12,-3175.5399999999972,8,4,65850.0,62674.46000000001
35080,U9494,12,180.0400000000001,5,7,4192.0,4372.04
35081,U38618,12,570.4099999999997,5,7,13014.85,13585.26
35082,U42816,12,2947.6500000000015,7,5,43753.0,46700.65
35083,U20934,12,-25671.3,7,5,44100.0,18428.7
35084,U42654,12,75.86000000000058,3,9,101624.48000000001,101700.34000000001
35085,U25712,12,-15370.300000000017,5,7,289210.17,273839.87
35086,U40904,12,13103.739999999996,5,7,15870.15,28973.889999999996
35087,U22046,12,-925.64,9,3,1105.9199999999998,180.27999999999986
35088,U12597,12,-107.52000000000051,8,4,5410.09,5302.57
35089,U1262121,12,1.23,6,6,4528.23,4529.459999999999
35090,U1009218,12,2967.0200000000004,7,5,6038.0,9005.02
35091,U25867,12,29814.05,3,9,29814.0,59628.05
35092,U35402,12,2775.8700000000003,4,8,8924.78,11700.650000000001
35093,U20072,12,-19655.42,7,5,137690.58000000002,118035.16000000002
35094,U40315,12,19051.07,5,7,15200.0,34251.07
35095,U33288,12,-7138.699999999993,5,7,160006.0,152867.30000000002
35096,U31994,12,-33797.05,9,3,39726.11,5929.059999999998
35097,U21165,12,-2292.1,8,4,15426.639999999998,13134.539999999997
35098,U32882,12,-86.90000000000073,8,4,8268.900000000001,8182.000000000001
35099,U19131,12,36464.11,1,11,1.0,36465.11
35100,U14851,12,9291.369999999999,7,5,46208.66,55500.03
35101,U583142,12,-4526.390000000001,10,2,4626.58,100.18999999999869
35102,U32017,12,-8453.77,7,5,21976.550000000003,13522.780000000002
35103,U42306,12,-147.3099999999995,8,4,14176.67,14029.36
35104,U23073,12,10001.43,4,8,23177.25,33178.68
35105,U36364,12,-474.7300000000005,9,3,3302.54,2827.8099999999995
35106,U1194339,12,10.0,5,7,670.0,680.0
35107,U28112,12,-82.55999999999992,8,4,2926.06,2843.5
35108,U10698,12,108.479999999999,7,5,20340.83,20449.31
35109,U1271884,12,8631.68,6,6,36900.009999999995,45531.689999999995
35110,U1200174,12,78.0,5,7,47.0,125.0
35111,U40764,12,58669.24,3,9,43796.4,102465.64
35112,U29787,12,-3000.7599999999998,8,4,27000.0,23999.24
35113,U40909,12,-40248.869999999995,5,7,53248.96,13000.090000000004
35114,U41340,12,-27441.11,7,5,135272.0,107830.89
35115,U33463,12,-25769.230000000003,8,4,61047.90000000001,35278.670000000006
35116,U40267,12,-45287.45999999998,7,5,137896.1,92608.64000000003
35117,U9790,12,45086.01,6,6,48355.01,93441.02
35118,U24087,12,-12121.54,7,5,35270.2,23148.659999999996
35119,U42469,12,-693.8199999999997,9,3,24160.0,23466.18
35120,U1034950,12,93.34000000000003,9,3,895.8299999999999,989.17
35121,U19447,12,-5461.4400000000005,6,6,12089.25,6627.8099999999995
35122,U979823,12,48751.81999999999,5,7,52967.0,101718.81999999999
35123,U43042,12,3734.78,6,6,2561.28,6296.06
35124,U25484,12,0.08000000000033225,6,6,2249.52,2249.6000000000004
35125,U24557,12,0.8299999999981083,5,7,97464.25,97465.08
35126,U20759,12,-147.7800000000003,7,5,8796.62,8648.84
35127,U12816,12,-11480.99,9,3,11741.0,260.0100000000002
35128,U40538,12,974.6100000000001,6,6,3499.79,4474.4
35129,U18764,12,-463.6300000000001,7,5,6864.0,6400.37
35130,U24611,12,26213.61,7,5,10419.15,36632.76
35131,U33369,12,-330.15000000000003,9,3,1177.3,847.1499999999999
35132,U30438,12,-146.09999999999985,4,8,2920.02,2773.92
35133,U1241536,12,13292.48,4,8,15733.28,29025.760000000002
35134,U28891,12,465.01,8,4,649.6,1114.6100000000001
35135,U40815,12,399.17999999999995,9,3,1602.5,2001.6799999999998
35136,U41426,12,2748.21,8,4,3295.79,6044.0
35137,U35963,12,-69255.59,7,5,112027.03,42771.44
35138,U18623,12,35.600000000000364,5,7,9390.48,9426.08
35139,U42630,12,1655.0499999999997,5,7,10296.98,11952.029999999999
35140,U17671,12,-6000.0,8,4,13298.0,7298.0
35141,U9516,12,-113856.53,6,6,165934.55,52078.01999999999
35142,U43338,12,-11971.850000000006,6,6,104360.95,92389.09999999999
35143,U25725,12,36.87000000000003,5,7,620.75,657.62
35144,U40314,12,-3847.1100000000006,9,3,21382.21,17535.1
35145,U8946,12,-44366.729999999996,9,3,64450.0,20083.270000000004
35146,U43204,12,-9080.119999999999,8,4,18087.0,9006.880000000001
35147,U38420,12,-286.95,7,5,784.4399999999999,497.48999999999995
35148,U17718,12,25914.319999999996,6,6,19998.0,45912.31999999999
35149,U16532,12,-10114.28,10,2,17088.59,6974.3099999999995
35150,U21106,12,793.9599999999969,4,8,50041.48,50835.44
35151,U19502,11,5342.669999999998,7,4,6157.38,11500.05
35152,U35942,11,-27003.759999999984,4,7,226800.0,199796.24000000002
35153,U973408,11,-4576.61,8,3,6172.61,1596.0
35154,U21688,11,0.0,6,5,17425.920000000002,17425.920000000002
35155,U37309,11,-33.28999999999999,7,4,421.77,388.48
35156,U18316,11,22036.299999999996,8,3,81332.08,103368.38
35157,U24326,11,-804.1000000000001,9,2,3732.76,2928.66
35158,U27989,11,-8444.66,8,3,28506.0,20061.34
35159,U40643,11,-4839.74,9,2,12006.0,7166.26
35160,U30916,11,-79054.26000000001,7,4,94586.98000000001,15532.720000000001
35161,U1335017,11,-2530.71,10,1,2532.15,1.4400000000000546
35162,U30875,11,-4787.849999999999,9,2,4989.3,201.45000000000073
35163,U24992,11,-96.66000000000001,7,4,165.69,69.02999999999999
35164,U30891,11,-2808.09,7,4,12130.0,9321.91
35165,U9495,11,-49988.9,6,5,140000.0,90011.1
35166,U9661,11,-14598.48,6,5,47414.45,32815.97
35167,U43554,11,-3191.61,10,1,3196.1400000000003,4.5300000000002
35168,U26359,11,2963.0,4,7,371.93,3334.93
35169,U39334,11,-1.8499999999999943,8,3,102.0,100.15
35170,U24322,11,25947.640000000003,1,10,300000.0,325947.64
35171,U32472,11,374.33000000000175,7,4,63546.74,63921.07
35172,U29335,11,1.02,6,5,55979.0,55980.02
35173,U22425,11,9652.32,2,9,9540.0,19192.32
35174,U10204,11,220.7199999999965,4,7,100006.0,100226.72
35175,U9108,11,-14504.809999999998,6,5,124520.2,110015.39
35176,U40834,11,-1355.7,9,2,2363.19,1007.49
35177,U42468,11,482.7800000000001,5,6,6617.87,7100.65
35178,U41683,11,549662.86,6,5,504001.12,1053663.98
35179,U31759,11,-382.6600000000001,8,3,40992.34,40609.67999999999
35180,U30744,11,3261.3199999999997,2,9,3442.76,6704.08
35181,U38787,11,-499797.37999999995,6,5,505534.44,5737.060000000056
35182,U42402,11,1191.3100000000031,8,3,34578.17,35769.48
35183,U621458,11,-4039.42,9,2,8613.42,4574.0
35184,U30855,11,371.99,8,3,687.8,1059.79
35185,U22977,11,767.1100000000006,5,6,50109.6,50876.71
35186,U1108255,11,-5601.9400000000005,9,2,8651.94,3050.0
35187,U10466,11,-78.21000000000004,7,4,10826.58,10748.369999999999
35188,U17514,11,436.1900000000001,7,4,3365.0,3801.19
35189,U37427,11,-238.92000000000002,6,5,669.75,430.83
35190,U25360,11,-10813.11,5,6,17234.6,6421.489999999998
35191,U43473,11,-3724.5900000000006,7,4,24640.63,20916.04
35192,U33401,11,-7487.360000000001,6,5,27069.0,19581.64
35193,U31688,11,-40.28000000000054,6,5,13853.27,13812.99
35194,U1179928,11,800.1800000000003,6,5,20579.42,21379.6
35195,U1074197,11,633.02,4,7,1726.02,2359.04
35196,U43682,11,1.5700000000001637,5,6,6519.469999999999,6521.039999999999
35197,U19446,11,-41576.03,7,4,68458.8,26882.770000000004
35198,U40506,11,2282.69,7,4,5019.4,7302.09
35199,U19214,11,998.0800000000006,8,3,6542.400000000001,7540.480000000001
35200,U34681,11,6102.21,3,8,8500.0,14602.21
35201,U11739,11,926.08,4,7,4335.12,5261.2
35202,U673307,11,-3116.97,9,2,3887.09,770.1200000000003
35203,U20510,11,7278.890000000014,4,7,163754.0,171032.89
35204,U648213,11,21.80000000000001,9,2,518.0,539.8
35205,U1320192,11,-2.9599999999999795,6,5,1654.4,1651.44
35206,U9136,11,-3934.31,6,5,10342.25,6407.9400000000005
35207,U30815,11,-16104.75,9,2,16200.0,95.25
35208,U24304,11,0.4999999999998863,5,6,2388.9,2389.4
35209,U1353864,11,5.650000000000091,6,5,1343.2799999999997,1348.9299999999998
35210,U35146,11,48.47999999999999,6,5,11729.2,11777.68
35211,U36899,11,-125.5100000000003,5,6,50369.9,50244.39
35212,U33725,11,36995.82,4,7,5255.5,42251.32
35213,U42359,11,-2098.880000000001,4,7,15474.36,13375.48
35214,U16403,11,-17170.869999999995,6,5,47987.0,30816.130000000005
35215,U43581,11,-23744.559999999998,8,3,37283.3,13538.740000000005
35216,U19373,11,8898.34,1,10,500.0,9398.34
35217,U36341,11,5619.9800000000005,5,6,838.2,6458.18
35218,U32821,11,-7867.510000000003,8,3,58345.700000000004,50478.19
35219,U9903,11,698.5399999999993,6,5,13804.46,14502.999999999998
35220,U12116,11,-33490.84000000001,6,5,566000.0,532509.16
35221,U1138138,11,767.51,8,3,2046.49,2814.0
35222,U28327,11,-15058.87,5,6,28221.0,13162.13
35223,U28635,11,25508.93,2,9,7400.0,32908.93
35224,U40962,11,7389.739999999999,6,5,15503.55,22893.289999999997
35225,U22809,11,267.6299999999974,7,4,179739.96000000002,180007.59000000003
35226,U26526,11,-297.6200000000001,9,2,2297.98,2000.36
35227,U23548,11,20958.35,7,4,6539.0,27497.35
35228,U931742,11,-1409.8799999999999,8,3,5184.610000000001,3774.7300000000005
35229,U1062326,11,423.74000000000007,5,6,585.6800000000001,1009.4200000000001
35230,U28767,11,18696.38,0,11,0.0,18696.38
35231,U24301,11,2000.29,4,7,3533.0,5533.29
35232,U39034,11,1189.75,6,5,3445.98,4635.73
35233,U39901,11,-130133.79,6,5,130787.0,653.2100000000064
35234,U1268165,11,-5178.68,8,3,7004.66,1825.9799999999996
35235,U1252784,11,-3530.8199999999997,9,2,4157.82,627.0
35236,U16504,11,-108449.14,6,5,128551.0,20101.86
35237,U36909,11,70177.49,5,6,5882.68,76060.17000000001
35238,U30608,11,27.170000000000073,6,5,4873.0,4900.17
35239,U27920,11,998.44,5,6,2734.0,3732.44
35240,U13197,11,-4131.899999999999,5,6,14053.55,9921.650000000001
35241,U1101712,11,1405.79,9,2,954.3000000000001,2360.09
35242,U26818,11,-7736.72,7,4,13374.18,5637.46
35243,U31447,11,14.289999999999985,8,3,660.6400000000001,674.9300000000001
35244,U1125614,11,-261.2999999999999,6,5,1674.26,1412.96
35245,U1183904,11,-18932.280000000002,8,3,19932.33,1000.0499999999993
35246,U42075,11,4062.0,8,3,818.0,4880.0
35247,U42580,11,4350.200000000002,7,4,14240.9,18591.100000000002
35248,U38953,11,189978.97000000003,4,7,155056.0,345034.97000000003
35249,U1312311,11,1241.4099999999999,5,6,2739.9,3981.31
35250,U30386,11,-16103.000000000002,8,3,42185.66,26082.660000000003
35251,U32816,11,-16666.259999999995,8,3,42151.049999999996,25484.79
35252,U939541,11,-1099.98,7,4,1859.02,759.04
35253,U8855,11,-369.43,8,3,371.9,2.4699999999999704
35254,U41604,11,2676.71,2,9,331.01,3007.7200000000003
35255,U41147,11,304.99,3,8,181.29,486.28
35256,U42458,11,3385.12,4,7,9883.34,13268.46
35257,U615358,11,-282.81000000000006,8,3,1272.84,990.0299999999999
35258,U952363,11,-3562.52,9,2,3563.3300000000004,0.8100000000004002
35259,U40587,11,29507.469999999998,7,4,28992.800000000003,58500.270000000004
35260,U27323,11,-1457.61,8,3,1932.1,474.49
35261,U36664,11,4818.970000000001,5,6,14041.300000000001,18860.270000000004
35262,U38046,11,8213.82,2,9,36400.0,44613.82
35263,U955484,11,6.739999999999782,5,6,7363.01,7369.75
35264,U28672,11,-19729.629999999997,6,5,71785.08,52055.450000000004
35265,U39532,11,1437.0199999999998,4,7,1684.77,3121.79
35266,U986000,11,199.51,8,3,224.5,424.01
35267,U21094,11,13712.89,4,7,10925.0,24637.89
35268,U28084,11,-19.889999999999855,8,3,41001.0,40981.11
35269,U29163,11,-3682.69,6,5,9455.720000000001,5773.030000000001
35270,U1219733,11,-820.0,7,4,1750.0,930.0
35271,U736725,11,-774.0300000000002,9,2,1579.95,805.9199999999998
35272,U35945,11,11539.070000000007,3,8,411529.66,423068.73
35273,U30648,11,-267.9,9,2,1478.9,1211.0
35274,U19169,11,-519.1300000000001,6,5,2719.5,2200.37
35275,U28705,11,-3337.9800000000005,5,6,11051.0,7713.0199999999995
35276,U38726,11,847.7099999999627,4,7,600563.67,601411.38
35277,U34136,11,-12771.789999999994,4,7,218000.0,205228.21000000002
35278,U22000,11,-9947.599999999999,8,3,20206.0,10258.400000000001
35279,U43118,11,4550.530000000001,7,4,11456.42,16006.95
35280,U18702,11,-2625.2999999999993,6,5,18874.84,16249.54
35281,U18844,11,-33095.14,8,3,43110.17999999999,10015.039999999994
35282,U22711,11,4139.26,6,5,44561.44,48700.700000000004
35283,U12459,11,9552.830000000002,7,4,122448.5,132001.33000000002
35284,U38982,11,2475.1000000000004,3,8,16586.0,19061.1
35285,U22462,11,-570.9,9,2,575.79,4.889999999999986
35286,U18638,11,8200.45,8,3,6685.36,14885.810000000001
35287,U36255,11,4104.01,7,4,7304.82,11408.83
35288,U16349,11,685.0900000000001,6,5,842.49,1527.5800000000002
35289,U10483,11,-13414.920000000006,7,4,153510.77000000002,140095.85
35290,U39074,11,-37332.469999999994,3,8,86880.0,49547.530000000006
35291,U39855,11,93439.0,4,7,90700.0,184139.0
35292,U15503,11,-5260.55,9,2,6641.0,1380.4499999999998
35293,U791756,11,-794.15,9,2,802.16,8.009999999999991
35294,U26619,11,-21.360000000000582,7,4,16415.0,16393.64
35295,U37012,11,65494.219999999994,4,7,6666.07,72160.29
35296,U1236684,11,-109.46000000000004,8,3,1879.8400000000001,1770.38
35297,U22831,11,264.97,8,3,31.039999999999996,296.01000000000005
35298,U1045899,11,-19.620000000000033,7,4,245.94000000000003,226.32
35299,U38798,11,-77385.30000000002,2,9,272971.0,195585.69999999998
35300,U13627,11,14774.42,6,5,6832.4,21606.82
35301,U18747,11,8292.4,5,6,5442.860000000001,13735.26
35302,U1137881,11,100.00000000000045,7,4,11045.34,11145.34
35303,U1195812,11,-203.08000000000004,9,2,803.0799999999999,599.9999999999999
35304,U34839,11,2075.690000000001,6,5,18000.0,20075.690000000002
35305,U9223,11,-25785.499999999996,7,4,36760.09,10974.59
35306,U12410,11,-694.6699999999992,7,4,16038.46,15343.79
35307,U30026,11,4001.6000000000004,4,7,8300.0,12301.6
35308,U655801,11,3.619999999999891,5,6,8500.0,8503.619999999999
35309,U29776,11,3501.2400000000002,9,2,4737.760000000001,8239.000000000002
35310,U36068,11,13278.209999999992,7,4,83238.05,96516.26
35311,U8979,11,-393316.0100000001,2,9,1217580.0,824263.9899999999
35312,U43434,11,-202686.16,6,5,452783.66000000003,250097.50000000003
35313,U18007,11,-781.68,8,3,1776.69,995.0100000000001
35314,U10733,11,-3834.8199999999997,9,2,18845.58,15010.760000000002
35315,U20321,11,-16032.84,6,5,49132.9,33100.06
35316,U41658,11,2465.209999999999,6,5,34738.94,37204.15
35317,U899513,11,3140.3399999999997,7,4,584.66,3724.9999999999995
35318,U41875,11,13362.23,9,2,10952.0,24314.23
35319,U17696,11,-3035.4800000000105,7,4,205018.9,201983.41999999998
35320,U35214,11,14896.6,5,6,10174.8,25071.4
35321,U27371,11,-1368.4499999999998,8,3,9569.0,8200.55
35322,U1239325,11,-371.71999999999997,6,5,1268.73,897.01
35323,U13902,11,308.83000000000175,6,5,102584.75,102893.58
35324,U1232903,11,22222.0,0,11,0.0,22222.0
35325,U22473,11,-208.43,8,3,728.6,520.1700000000001
35326,U41687,11,-57450.38,5,6,92577.0,35126.62
35327,U18499,11,2165.48,6,5,3401.5200000000004,5567.0
35328,U12671,11,-17.019999999999712,6,5,33824.34,33807.32
35329,U40438,11,3045.44,7,4,3548.67,6594.110000000001
35330,U964406,11,-7201.4,10,1,7203.4,2.0
35331,U21881,11,274.6200000000001,8,3,2454.5,2729.12
35332,U1099672,11,-1176.26,9,2,1686.26,510.0
35333,U19267,11,-427.36000000000035,8,3,4524.28,4096.919999999999
35334,U890444,11,-24595.989999999998,6,5,25576.27,980.2800000000025
35335,U33481,11,12805.91,4,7,26256.88,39062.79
35336,U979671,11,2496.63,7,4,2840.37,5337.0
35337,U29790,11,-22062.509999999984,4,7,291000.0,268937.49
35338,U25668,11,-1842.3000000000013,4,7,22369.059999999998,20526.759999999995
35339,U18147,11,17284.47,4,7,61000.0,78284.47
35340,U17800,11,-42003.55,7,4,462610.54000000004,420606.99000000005
35341,U752379,11,-1029.27,6,5,4388.0,3358.73
35342,U1118890,11,-1721.4700000000003,11,0,1721.4700000000003,0.0
35343,U21794,11,-703.4,8,3,1025.3,321.9
35344,U43627,11,301804.43,6,5,157012.0,458816.43
35345,U16463,11,-169082.02000000002,6,5,410105.44,241023.41999999998
35346,U1145169,11,3807.300000000001,6,5,24762.749999999996,28570.049999999996
35347,U34164,11,-1590.5700000000004,8,3,3194.6200000000003,1604.05
35348,U43519,11,-3284.12,7,4,5437.2,2153.08
35349,U38596,11,35217.799999999996,7,4,2522.38,37740.17999999999
35350,U37631,11,0.9699999999993452,7,4,5239.2,5240.169999999999
35351,U26497,11,-7909.14,6,5,10200.4,2291.2599999999993
35352,U1265017,11,-687.1800000000001,9,2,760.19,73.00999999999999
35353,U21048,11,165.13999999999942,5,6,12535.060000000001,12700.2
35354,U22979,11,-49883.23999999999,5,6,221026.4,171143.16
35355,U17810,11,-159212.65,6,5,194006.0,34793.350000000006
35356,U26795,11,30505.21,3,8,4571.11,35076.32
35357,U19461,11,-66767.72,9,2,125167.72,58400.0
35358,U20601,11,-300.72999999999956,5,6,24590.68,24289.95
35359,U32683,11,-38.650000000000034,6,5,912.6700000000001,874.02
35360,U1099861,11,637.0,2,9,142.45,779.45
35361,U17769,11,7924.639999999999,6,5,14199.46,22124.1
35362,U38288,11,-18107.969999999998,4,7,100196.12,82088.15
35363,U26318,11,3001.1600000000003,4,7,24001.0,27002.16
35364,U30192,11,79673.51,5,6,50581.68,130255.19
35365,U39996,11,9.49000000000003,9,2,197.35999999999999,206.85000000000002
35366,U28948,11,-25035.150000000005,5,6,89151.23,64116.07999999999
35367,U18914,11,-3845.3999999999996,8,3,12249.11,8403.710000000001
35368,U36607,11,145017.06,6,5,165177.0,310194.06
35369,U24815,11,17.030000000000655,6,5,49166.520000000004,49183.55
35370,U28049,11,-515.21,8,3,6216.5,5701.29
35371,U31761,11,23530.03,2,9,1950.0,25480.03
35372,U27815,11,-48611.53999999999,9,2,48674.369999999995,62.830000000001746
35373,U18262,11,-6739.160000000001,7,4,6889.5,150.33999999999924
35374,U703784,11,35.01,5,6,2225.01,2260.0200000000004
35375,U10044,11,-1370.5399999999936,6,5,53163.0,51792.46000000001
35376,U729003,11,-242.03,7,4,463.15000000000003,221.12000000000003
35377,U607973,11,0.0,5,6,501.0,501.0
35378,U15622,11,-1321.75,7,4,2713.71,1391.96
35379,U1179908,11,1019.8000000000002,9,2,5780.2,6800.0
35380,U25640,11,12259.8,4,7,13152.0,25411.8
35381,U26713,11,-1706.7099999999991,6,5,79679.44,77972.73000000001
35382,U25924,11,11473.95,8,3,3734.6499999999996,15208.6
35383,U13110,11,262751.98000000004,2,9,591.94,263343.92000000004
35384,U32543,11,-66.71000000000204,5,6,60158.29,60091.58
35385,U1126671,11,0.8300000000000409,5,6,1540.01,1540.8400000000001
35386,U27638,11,964.1499999999942,5,6,210475.68,211439.83
35387,U8695,11,1634.0,7,4,14467.05,16101.05
35388,U1290675,11,-18.589999999999918,7,4,638.5699999999999,619.98
35389,U26568,11,199.60999999999996,5,6,9253.94,9453.550000000001
35390,U952843,11,-146.4,9,2,156.44,10.039999999999992
35391,U1055980,11,224.82999999999993,6,5,4405.27,4630.1
35392,U10537,11,1893.0100000000002,7,4,4298.01,6191.02
35393,U615577,11,-0.060000000000172804,7,4,3351.44,3351.38
35394,U40005,11,34659.87,8,3,8513.27,43173.14
35395,U17847,11,-117.99999999999709,5,6,201776.0,201658.0
35396,U29689,11,404.4599999999991,7,4,18123.25,18527.71
35397,U18043,11,-603.2499999999991,7,4,20741.61999999999,20138.36999999999
35398,U1225687,11,2327.8,4,7,12733.2,15061.0
35399,U1085309,11,189.06000000000006,7,4,810.94,1000.0000000000001
35400,U19654,11,-606.9599999999991,7,4,30040.0,29433.04
35401,U42380,11,-4620.07,7,4,12452.0,7831.93
35402,U18466,11,-7307.719999999999,9,2,14001.2,6693.480000000001
35403,U22294,11,-5160.39,9,2,5471.18,310.78999999999996
35404,U10319,11,-2621.5899999999997,1,10,10000.0,7378.41
35405,U31564,11,47986.469999999994,4,7,159781.72,207768.19
35406,U33993,11,-5295.590000000023,6,5,505448.0,500152.41
35407,U18836,11,25951.890000000014,2,9,250000.0,275951.89
35408,U38582,11,13132.879999999997,6,5,20235.0,33367.88
35409,U43616,11,-7322.649999999997,8,3,37207.48,29884.830000000005
35410,U36596,11,-1888807.51,4,7,1890000.0,1192.4899999999907
35411,U42828,11,-12127.579999999998,8,3,31806.0,19678.420000000002
35412,U23095,11,-9557.159999999998,8,3,9987.059999999998,429.89999999999964
35413,U842055,11,309.02000000000044,7,4,20498.81,20807.83
35414,U39279,11,1838.53,7,4,2275.5,4114.03
35415,U28556,11,2.12000000000171,4,7,32453.67,32455.79
35416,U24428,11,146.10000000000218,7,4,38480.0,38626.100000000006
35417,U35735,11,-8780.68,6,5,18225.92,9445.239999999998
35418,U36660,11,1369.6300000000017,6,5,30838.0,32207.63
35419,U31094,11,454.02,7,4,30529.8,30983.82
35420,U17535,11,-6044.290000000008,8,3,106054.0,100009.70999999999
35421,U10517,11,-107609.29,8,3,191554.41999999998,83945.12999999999
35422,U30599,11,1727.7900000000002,7,4,4533.7,6261.49
35423,U21560,11,3435.4100000000003,7,4,4044.6,7480.01
35424,U24004,11,-398.36,8,3,1591.26,1192.9
35425,U1206936,11,-50232.19,9,2,66821.19,16589.0
35426,U24831,11,-1951.08,2,9,25373.0,23421.92
35427,U40483,11,33.53,5,6,110.00999999999999,143.54
35428,U37346,11,-338.7500000000009,7,4,7606.139999999999,7267.3899999999985
35429,U1067711,11,-71.51999999999987,8,3,1464.52,1393.0
35430,U36057,11,14639.18,4,7,14819.5,29458.68
35431,U9879,11,3.399999999999986,6,5,277.62,281.02
35432,U25922,11,8331.139999999998,6,5,8339.34,16670.479999999996
35433,U27897,11,49.38000000000011,8,3,1951.0,2000.38
35434,U25188,11,-76.31,10,1,4176.31,4100.0
35435,U1142660,11,-0.12000000000000086,6,5,23.209999999999997,23.089999999999996
35436,U15017,11,817.2799999999964,2,9,34703.8,35521.08
35437,U28965,11,12562.369999999999,5,6,95010.0,107572.37
35438,U893144,11,201.0,7,4,310.0,511.0
35439,U1324326,11,60.629999999999995,7,4,1050.73,1111.3600000000001
35440,U23777,11,27.819999999999947,6,5,2680.29,2708.11
35441,U17655,11,-7044.24,8,3,12006.0,4961.76
35442,U41611,11,14752.56,4,7,10666.0,25418.559999999998
35443,U37757,11,-6836.3,6,5,10031.0,3194.7
35444,U8521,11,3259.1800000000003,6,5,10620.0,13879.18
35445,U25213,11,-288331.19,4,7,1110000.0,821668.81
35446,U1235206,11,-786.73,8,3,12810.71,12023.98
35447,U29945,11,0.0,4,7,18682.64,18682.64
35448,U10144,11,-1055.1900000000023,7,4,51057.33,50002.14
35449,U13387,11,17640.03,4,7,668.58,18308.61
35450,U698469,11,-124.77000000000001,8,3,768.71,643.94
35451,U35605,11,4617.630000000001,6,5,7242.1,11859.730000000001
35452,U41912,11,19598.850000000002,5,6,80301.17,99900.02
35453,U35736,11,6918.77,3,8,11741.0,18659.77
35454,U26207,11,-8.63,9,2,13.060000000000002,4.4300000000000015
35455,U43716,11,10194.99,6,5,15209.18,25404.17
35456,U43213,11,204.63999999999965,6,5,10209.08,10413.72
35457,U37490,11,51.95000000000002,6,5,234.63000000000002,286.58000000000004
35458,U32511,11,-55.94000000000051,6,5,16091.279999999999,16035.339999999998
35459,U580658,11,854.02,4,7,5807.0,6661.02
35460,U38083,11,-13.720000000001164,5,6,230014.0,230000.28
35461,U22982,11,599215.22,2,9,203434.5,802649.72
35462,U34117,11,11627.15,3,8,6412.84,18039.989999999998
35463,U41492,11,-1319.3,10,1,1618.3,299.0
35464,U19116,11,-9933.959999999963,5,6,500000.0,490066.04000000004
35465,U33389,11,-16230.900000000001,7,4,34500.0,18269.1
35466,U28427,11,1197.0099999999998,4,7,5705.76,6902.77
35467,U38211,11,1.179999999999418,4,7,67000.0,67001.18
35468,U21539,11,1849.31,6,5,2819.8,4669.110000000001
35469,U893664,11,332.25,7,4,3309.26,3641.51
35470,U21043,11,4946.34,6,5,9805.52,14751.86
35471,U25040,11,5.089999999999691,4,7,10745.84,10750.93
35472,U18570,11,292197.51999999996,7,4,11006.2,303203.72
35473,U752582,11,-18678.079999999998,9,2,18769.809999999998,91.72999999999956
35474,U8123,11,176.11999999999966,6,5,3752.2200000000003,3928.34
35475,U24772,11,-69197.54000000001,8,3,73328.43,4130.889999999985
35476,U898876,11,-520.99,7,4,880.91,359.91999999999996
35477,U12546,11,-692.5400000000009,6,5,8746.8,8054.259999999998
35478,U36441,11,-1245.54,9,2,1292.1,46.559999999999945
35479,U27896,11,106266.88,3,8,330.0,106596.88
35480,U17463,11,549.27,6,5,3051.0,3600.27
35481,U40239,11,4567.2300000000005,7,4,7461.74,12028.970000000001
35482,U41241,11,9.094947017729282e-13,5,6,40774.159999999996,40774.159999999996
35483,U11181,11,-505.75,7,4,626.7900000000001,121.04000000000008
35484,U40759,11,-20146.68,6,5,50270.94,30124.260000000002
35485,U15591,11,-747.1200000000008,7,4,14753.54,14006.42
35486,U43328,11,25630.240000000005,3,8,49755.0,75385.24
35487,U40722,11,-492.1000000000001,9,2,579.03,86.9299999999999
35488,U32574,11,-6385.4299999999985,6,5,31933.0,25547.57
35489,U13437,11,-6098.86,6,5,85705.0,79606.14
35490,U38861,11,-44.70000000000073,5,6,46792.0,46747.3
35491,U675183,11,0.5099999999997635,6,5,1779.85,1780.3599999999997
35492,U37745,11,-1.97,8,3,2032.1399999999999,2030.1699999999998
35493,U9306,11,44312.25000000001,5,6,29533.27,73845.52
35494,U19101,11,2268.0399999999995,7,4,6941.450000000001,9209.49
35495,U18781,11,-29639.99,9,2,69800.0,40160.009999999995
35496,U39289,11,7.759999999999309,8,3,11900.0,11907.759999999998
35497,U41848,11,10465.560000000001,5,6,5091.28,15556.84
35498,U9612,11,4713.639999999963,3,8,800000.0,804713.64
35499,U12074,11,11320.589999999998,4,7,20946.66,32267.25
35500,U37292,11,9463.329999999998,6,5,8514.59,17977.92
35501,U35194,11,-15340.299999999997,5,6,29500.0,14159.700000000003
35502,U34097,11,-9992.210000000001,6,5,18503.4,8511.19
35503,U1133297,11,-70.58999999999993,8,3,856.6500000000001,786.0600000000002
35504,U22925,11,28045.659999999993,5,6,133155.26,161200.92
35505,U11922,11,-19001.04,9,2,88009.17,69008.13
35506,U28713,11,-12167.94,7,4,30999.0,18831.059999999998
35507,U28021,11,-180.10000000000025,7,4,8052.0,7871.9
35508,U28532,11,-757.9700000000303,9,2,300791.4,300033.43
35509,U13662,11,415.97999999999956,4,7,18574.0,18989.98
35510,U963719,11,0.29999999999996874,5,6,1098.0,1098.3
35511,U33017,11,14341.119999999999,7,4,9115.67,23456.79
35512,U35993,11,19370.359999999997,6,5,1054.7799999999997,20425.139999999996
35513,U36333,11,-670.8499999999999,4,7,7669.62,6998.77
35514,U41949,11,-54812.520000000004,2,9,115000.0,60187.479999999996
35515,U1110944,11,5632.370000000001,3,8,5453.05,11085.420000000002
35516,U926549,11,-36.949999999999996,8,3,38.029999999999994,1.0799999999999983
35517,U854100,11,6487.65,4,7,7494.389999999999,13982.039999999999
35518,U16831,11,3246.99,5,6,6898.219999999999,10145.21
35519,U10234,11,2154.13,5,6,4918.0,7072.13
35520,U25394,11,-385.25000000000364,8,3,58895.619999999995,58510.369999999995
35521,U26301,11,-36.21000000000568,7,4,240637.29,240601.08000000002
35522,U12637,11,-2524.9699999999993,5,6,29455.0,26930.03
35523,U1102768,11,-276.28,7,4,3269.3199999999997,2993.04
35524,U21434,11,-1955.17,5,6,18011.2,16056.03
35525,U30538,11,4826.38,6,5,5709.8,10536.18
35526,U21710,11,0.13999999999941792,5,6,90000.0,90000.14
35527,U31304,11,219989.26,7,4,81032.9,301022.16000000003
35528,U24715,11,-6222.99,8,3,8987.0,2764.01
35529,U40148,11,57.7200000000001,5,6,6759.0199999999995,6816.74
35530,U28286,11,3852.77,5,6,18364.89,22217.66
35531,U8771,11,-117695.61,10,1,118695.61,1000.0
35532,U33786,11,11564.799999999997,5,6,3104.35,14669.149999999998
35533,U8254,11,-2872.9900000000002,8,3,31873.34,29000.35
35534,U21414,11,933.9800000000025,6,5,28862.04,29796.020000000004
35535,U24114,11,-49684.76999999999,4,7,200141.0,150456.23
35536,U21956,11,3252.26,5,6,2528.3900000000003,5780.650000000001
35537,U42185,11,3049.7299999999996,2,9,7000.0,10049.73
35538,U38570,11,1578.5600000000002,4,7,7577.0599999999995,9155.619999999999
35539,U29895,11,0.06999999999969987,5,6,25741.249999999996,25741.319999999996
35540,U34387,11,77.70999999999988,9,2,1301.4800000000002,1379.19
35541,U34462,11,1.5799999999999272,7,4,3361.0,3362.58
35542,U1248636,11,6808.5700000000015,4,7,8520.55,15329.12
35543,U11139,11,-29694.28,5,6,61289.0,31594.72
35544,U759049,11,-9385.119999999999,10,1,9385.48,0.3600000000005821
35545,U17813,11,-579.78,5,6,11490.949999999999,10911.169999999998
35546,U27585,11,0.0,9,2,27617.28,27617.28
35547,U43895,11,47530.03,5,6,105500.0,153030.03
35548,U42437,11,71.35999999999967,6,5,11457.22,11528.579999999998
35549,U42232,11,-2930.559999999999,7,4,15843.69,12913.130000000001
35550,U41015,11,-910481.24,8,3,958471.0,47989.76000000001
35551,U9867,11,-29.55000000000291,5,6,55668.4,55638.85
35552,U28577,11,25016.47,6,5,55730.75,80747.22
35553,U35531,11,-13020.949999999999,7,4,17305.0,4284.050000000001
35554,U12105,11,16954.19,8,3,19943.899999999998,36898.09
35555,U43125,11,6247.5,5,6,3174.34,9421.84
35556,U12055,11,-5955.67,6,5,16476.0,10520.33
35557,U577170,11,-1996.88,8,3,11193.880000000001,9197.0
35558,U608144,11,-1642.8600000000006,8,3,20244.86,18602.0
35559,U28137,11,-37038.19,5,6,39237.090000000004,2198.9000000000015
35560,U36128,11,378.95000000000005,6,5,427.4,806.35
35561,U41246,11,812292.5299999999,1,10,310000.0,1122292.5299999998
35562,U12470,11,1944.550000000004,3,8,104000.0,105944.55
35563,U34554,11,-10167.120000000003,6,5,28569.0,18401.879999999997
35564,U32109,11,-615.9400000000002,7,4,3291.94,2676.0
35565,U1275431,11,260.42,5,6,424.63,685.05
35566,U36886,11,-164.57999999999993,9,2,7327.5,7162.92
35567,U30397,11,-27.5,8,3,2420.5,2393.0
35568,U38034,11,-687.9400000000005,6,5,5356.0,4668.0599999999995
35569,U10946,11,99.0,6,5,198.0,297.0
35570,U23407,11,-1328.7899999999995,6,5,4131.32,2802.53
35571,U29384,11,72010.06,4,7,16887.239999999998,88897.29999999999
35572,U42365,11,0.05,8,3,504.36,504.41
35573,U23318,11,3002.33,10,1,2021.61,5023.94
35574,U30228,11,500831.67,5,6,143179.44,644011.11
35575,U29488,11,-30516.1,10,1,30530.26,14.159999999999854
35576,U26637,11,7638.26,7,4,9677.6,17315.86
35577,U41840,11,-18972.880000000005,6,5,106013.5,87040.62
35578,U18087,11,-258.71000000000004,8,3,515.23,256.52
35579,U970487,11,0.0,7,4,409.79999999999995,409.79999999999995
35580,U1096981,11,4.360000000000582,7,4,11059.35,11063.710000000001
35581,U35217,11,57.600000000000364,7,4,5392.5,5450.1
35582,U593077,11,-2085.8199999999993,10,1,2085.859999999999,0.03999999999996362
35583,U12701,11,-1624.73,5,6,13908.079999999998,12283.349999999999
35584,U11117,11,1140.77,8,3,1454.38,2595.15
35585,U38161,11,-1259.8899999999994,7,4,50201.5,48941.61
35586,U15089,11,-823.6100000000006,7,4,36830.5,36006.89
35587,U705233,11,-0.07999999999998408,6,5,709.9300000000001,709.8500000000001
35588,U8975,11,2485.3,9,2,1325.1,3810.4
35589,U12844,11,144.10000000000016,5,6,2981.97,3126.07
35590,U42238,11,16527.260000000002,6,5,27800.0,44327.26
35591,U43461,11,9795.590000000002,7,4,1931.3400000000001,11726.930000000002
35592,U10654,11,-803.5899999999999,5,6,4804.48,4000.8899999999994
35593,U12779,11,2881.2299999999996,5,6,8436.220000000001,11317.45
35594,U10152,11,-2.9399999999999933,7,4,729.42,726.48
35595,U28707,11,-324.7899999999998,8,3,4060.0,3735.21
35596,U29720,11,-6316.190000000002,8,3,18856.239999999998,12540.049999999996
35597,U32190,11,-100.5,8,3,5900.0,5799.5
35598,U40021,11,112.20000000000007,3,8,1474.6599999999999,1586.86
35599,U18931,10,16462.790000000008,5,5,98380.0,114842.79000000001
35600,U14763,10,63893.229999999996,2,8,600.0,64493.229999999996
35601,U1120004,10,-21972.93,10,0,21972.93,0.0
35602,U1077600,10,0.0,5,5,420.0,420.0
35603,U12236,10,-9047.0,6,4,9536.38,489.3799999999992
35604,U21623,10,5999.43,4,6,821.24,6820.67
35605,U18798,10,-7095.720000000002,4,6,28268.17,21172.449999999997
35606,U8714,10,-3251.95,6,4,4487.5599999999995,1235.6099999999997
35607,U13114,10,275.6700000000001,6,4,11411.61,11687.28
35608,U20801,10,-10441.69,5,5,12138.36,1696.67
35609,U9595,10,-14957.529999999999,7,3,15799.71,842.1800000000003
35610,U11631,10,58.79999999998836,5,5,650000.0,650058.8
35611,U24053,10,29800.25,2,8,58605.0,88405.25
35612,U36846,10,-1.5276668818842154e-12,5,5,31390.620000000003,31390.620000000003
35613,U796262,10,1675.1800000000003,4,6,7724.82,9400.0
35614,U13689,10,32762.380000000005,1,9,0.07,32762.450000000004
35615,U1061733,10,40.83000000000011,6,4,1150.0,1190.8300000000002
35616,U1076945,10,-11.160000000000002,6,4,242.33999999999997,231.17999999999998
35617,U920198,10,-1445.31,8,2,1446.3199999999997,1.0099999999997635
35618,U32388,10,-611.3299999999996,7,3,3912.34,3301.0100000000007
35619,U19290,10,6914.2,3,7,3200.0,10114.2
35620,U36350,10,-135.9400000000005,7,3,9885.0,9749.06
35621,U1079018,10,3477.3100000000004,7,3,3937.7,7415.01
35622,U43390,10,1482.92,5,5,7264.0,8746.92
35623,U41872,10,-279.0999999999995,6,4,3603.7699999999995,3324.67
35624,U37060,10,-1486.63,7,3,2534.13,1047.5
35625,U17795,10,-944.0,5,5,2533.3999999999996,1589.3999999999996
35626,U33921,10,3738.0600000000013,4,6,15722.28,19460.340000000004
35627,U1261218,10,-2004.74,8,2,2304.7799999999997,300.03999999999974
35628,U32362,10,1823.5,8,2,9.929999999999998,1833.43
35629,U37709,10,-6254.970000000001,6,4,19606.0,13351.029999999999
35630,U22669,10,56.51999999999998,5,5,1113.57,1170.09
35631,U36274,10,5584.790000000003,4,6,41323.700000000004,46908.490000000005
35632,U20822,10,-16665.76,4,6,35000.0,18334.24
35633,U35664,10,1049.0499999999884,4,6,159883.0,160932.05
35634,U35738,10,302.3299999999999,4,6,4864.0,5166.33
35635,U1251750,10,-5624.950000000001,7,3,5950.400000000001,325.4499999999998
35636,U753655,10,-979.99,6,4,999.99,20.0
35637,U23676,10,-16793.09,4,6,21695.07,4901.98
35638,U11484,10,3835.4500000000003,3,7,464.7,4300.150000000001
35639,U30344,10,-522254.56999999995,7,3,523861.72,1607.1500000000233
35640,U15206,10,-6211.98,5,5,10990.0,4778.02
35641,U24735,10,11.170000000000073,7,3,1489.32,1500.49
35642,U39419,10,209303.02999999994,2,8,570000.0,779303.0299999999
35643,U27983,10,4796.4400000000005,5,5,18000.0,22796.440000000002
35644,U38316,10,69.27999999999997,6,4,1753.5,1822.78
35645,U33437,10,719.6800000000003,3,7,110000.0,110719.68
35646,U20458,10,2328.66,4,6,30825.93,33154.59
35647,U13520,10,241.98999999999995,5,5,160.02999999999997,402.0199999999999
35648,U42582,10,-5204.110000000001,7,3,8204.98,3000.869999999999
35649,U43868,10,44130.95999999999,0,10,0.0,44130.95999999999
35650,U19731,10,-1.0,6,4,89.0,88.0
35651,U22383,10,111652.56,4,6,180000.0,291652.56
35652,U42695,10,-4.779999999998836,5,5,110806.5,110801.72
35653,U989979,10,-8893.82,9,1,8894.57,0.75
35654,U11589,10,-5097.229999999981,5,5,693041.98,687944.75
35655,U24515,10,2944.7999999999993,4,6,56189.82,59134.619999999995
35656,U727725,10,-48.57,7,3,51.49,2.9200000000000017
35657,U36937,10,733.0200000000011,5,5,15418.1,16151.12
35658,U13686,10,-11967.990000000002,6,4,21004.78,9036.789999999997
35659,U42336,10,82.0,8,2,2599.0,2681.0
35660,U17085,10,-264.46000000001396,6,4,607640.5199999999,607376.0599999999
35661,U9801,10,-6733.84,4,6,4628734.66,4622000.82
35662,U29828,10,1.4551915228366852e-11,7,3,298780.18,298780.18
35663,U876914,10,-2060.68,8,2,2890.6800000000003,830.0000000000005
35664,U24435,10,-10083.829999999998,7,3,11785.919999999998,1702.0900000000001
35665,U39424,10,101130.33,3,7,538.4,101668.73
35666,U21256,10,10607.0,3,7,16700.0,27307.0
35667,U26583,10,8633.83,8,2,5663.339999999999,14297.169999999998
35668,U36383,10,1569.6,5,5,2505.2400000000002,4074.84
35669,U1205395,10,0.13999999999987267,5,5,2923.87,2924.0099999999998
35670,U903804,10,10187.43,2,8,305.38000000000005,10492.81
35671,U23921,10,771.28,5,5,4407.59,5178.87
35672,U17332,10,1594.0100000000002,4,6,70601.9,72195.90999999999
35673,U39113,10,-2778.070000000007,2,8,92839.0,90060.93
35674,U10576,10,-4177.549999999999,4,6,16049.85,11872.300000000001
35675,U20957,10,49515.76,5,5,8816.880000000001,58332.64
35676,U10069,10,77134.54,5,5,11125.0,88259.54
35677,U36405,10,97288.21999999999,1,9,30000.0,127288.21999999999
35678,U36719,10,487.9800000000008,3,7,50329.4,50817.380000000005
35679,U37116,10,-7116.18,5,5,14047.8,6931.619999999999
35680,U11996,10,12023.810000000001,6,4,13010.0,25033.81
35681,U20635,10,8394.87,4,6,8339.32,16734.190000000002
35682,U37842,10,-75.91000000000004,1,9,1000.0,924.0899999999999
35683,U713044,10,-793.39,7,3,942.4399999999999,149.04999999999995
35684,U10064,10,4601.589999999999,5,5,10290.0,14891.59
35685,U1245832,10,-2.9200000000000728,6,4,2222.92,2220.0
35686,U21744,10,-3925.46,7,3,8685.5,4760.04
35687,U25358,10,-1333.82,4,6,8869.72,7535.9
35688,U10799,10,50050.01999999999,5,5,78375.0,128425.01999999999
35689,U30465,10,-29115.439999999973,3,7,280000.0,250884.56000000003
35690,U9424,10,37613.770000000004,2,8,5373.91,42987.68000000001
35691,U39979,10,-1719.92,7,3,2231.0,511.0799999999999
35692,U1034755,10,-3330.2200000000003,10,0,3330.2200000000003,0.0
35693,U36129,10,0.21000000000003638,4,6,8645.0,8645.21
35694,U11510,10,12934.0,6,4,5066.65,18000.65
35695,U23914,10,26703.3,5,5,9435.2,36138.5
35696,U42796,10,4.790000000037253,4,6,420176.4,420181.19000000006
35697,U14934,10,9180.719999999998,3,7,9057.61,18238.329999999998
35698,U37692,10,6940.0,6,4,779.21,7719.21
35699,U37511,10,5530.61,6,4,73.02,5603.63
35700,U43337,10,-700.7200000000012,4,6,23601.2,22900.48
35701,U863029,10,-10.219999999999345,7,3,9187.24,9177.02
35702,U851570,10,2677.82,6,4,222.17999999999998,2900.0
35703,U1053539,10,0.6399999999999793,7,3,188.0,188.64
35704,U39320,10,0.8999999999999915,6,4,220.24,221.14
35705,U21508,10,-1118.6499999999983,5,5,61133.619999999995,60014.969999999994
35706,U916793,10,0.6500000000000341,4,6,616.15,616.8
35707,U36156,10,565.1899999999996,5,5,4435.21,5000.4
35708,U23908,10,-1076311.0,5,5,1129092.0,52781.0
35709,U28346,10,6490.930000000008,3,7,140000.0,146490.93
35710,U43120,10,25.96000000000017,3,7,1409.76,1435.7200000000003
35711,U43568,10,157.6800000000003,5,5,26866.36,27024.04
35712,U843693,10,-2804.66,8,2,3806.66,1002.0
35713,U18075,10,-1889.420000000042,6,4,311993.9,310104.48
35714,U42862,10,-3201.680000000022,3,7,163210.92,160009.24
35715,U10356,10,1260.2,3,7,1319.1499999999999,2579.35
35716,U31627,10,5380.389999999998,7,3,31514.0,36894.39
35717,U20216,10,-5644.780000000006,4,6,100006.0,94361.22
35718,U16645,10,-277.32,7,3,925.0,647.6800000000001
35719,U1316263,10,422.5,0,10,0.0,422.5
35720,U10959,10,886.4900000000052,7,3,61116.17,62002.66
35721,U37327,10,118179.06,2,8,130000.0,248179.06
35722,U14973,10,-97972.41,1,9,100000.0,2027.5899999999965
35723,U22830,10,-74.78999999999999,7,3,126.9,52.110000000000014
35724,U20589,10,-4.263256414560601e-14,8,2,1244.8999999999999,1244.8999999999999
35725,U17918,10,-625.5999999999999,6,4,1554.6,929.0
35726,U1153722,10,-2.8500000000000014,6,4,33.86,31.009999999999998
35727,U42053,10,95443.18,2,8,22000.0,117443.18
35728,U40872,10,-5996.08,6,4,10500.01,4503.93
35729,U27796,10,-4631.07,7,3,17704.42,13073.349999999999
35730,U37902,10,25157.26000000001,3,7,202000.0,227157.26
35731,U763636,10,0.039999999999931646,8,2,629.96,630.0
35732,U750265,10,-452.43000000000006,6,4,2545.01,2092.58
35733,U23419,10,1.0,4,6,99000.0,99001.0
35734,U27485,10,1.7300000000032014,5,5,72000.0,72001.73000000001
35735,U19128,10,-27443.68,7,3,60337.979999999996,32894.299999999996
35736,U43525,10,-500.82000000000266,5,5,47748.0,47247.18
35737,U22500,10,-148060.83,7,3,174250.0,26189.170000000013
35738,U27597,10,-176.06,8,2,202.44,26.379999999999995
35739,U33868,10,125.76,6,4,435.11,560.87
35740,U13562,10,-150901.78000000003,2,8,300359.98,149458.19999999995
35741,U42864,10,-34.88999999999942,5,5,16000.0,15965.11
35742,U19319,10,-729443.21,8,2,730006.0,562.7900000000373
35743,U38956,10,24801.5,3,7,28458.49,53259.990000000005
35744,U35379,10,-26212.389999999992,7,3,77148.91,50936.52000000001
35745,U38963,10,29976.97,3,7,31282.55,61259.520000000004
35746,U29140,10,510.72,6,4,5200.0,5710.72
35747,U13659,10,-2399.8800000000006,5,5,17507.22,15107.34
35748,U19770,10,-1980.36,5,5,9570.4,7590.04
35749,U27352,10,-447.97000000000025,5,5,2659.56,2211.5899999999997
35750,U23829,10,353976.64,1,9,1438.98,355415.62
35751,U36003,10,8946.82,3,7,62400.0,71346.82
35752,U18724,10,-59.209999999999994,6,4,113.16,53.95
35753,U16004,10,-462620.73,8,2,519873.23,57252.5
35754,U22154,10,20013.540000000008,6,4,180000.0,200013.54
35755,U1092908,10,-631.62,7,3,935.7,304.08000000000004
35756,U27130,10,-6451.43,5,5,10771.0,4319.57
35757,U40701,10,147.39,7,3,1110.4099999999999,1257.7999999999997
35758,U705567,10,-724.13,8,2,726.15,2.019999999999982
35759,U616081,10,10009.04,4,6,7546.04,17555.08
35760,U18666,10,4380.200000000001,5,5,4388.58,8768.78
35761,U20217,10,-229.41000000000003,7,3,546.33,316.92
35762,U36536,10,-44503.12,3,7,70824.0,26320.879999999997
35763,U32393,10,6505.790000000001,4,6,6454.72,12960.510000000002
35764,U1082220,10,-64.64000000000001,6,4,2634.93,2570.29
35765,U32970,10,58.86999999999995,7,3,310.0,368.86999999999995
35766,U1049149,10,-249.3800000000001,7,3,4799.38,4550.0
35767,U16562,10,-78376.54999999994,2,8,781600.0,703223.4500000001
35768,U40449,10,0.16000000000008188,6,4,591.9999999999999,592.16
35769,U1167650,10,-779.8000000000001,7,3,2779.7999999999997,1999.9999999999995
35770,U752968,10,248.57999999999998,7,3,1068.43,1317.01
35771,U37978,10,-2441.91,7,3,2784.4900000000002,342.5800000000004
35772,U41260,10,1081.03,5,5,290.92,1371.95
35773,U23392,10,734.9100000000035,5,5,52958.32,53693.23
35774,U25952,10,900011.4400000001,3,7,7950.8099999999995,907962.2500000001
35775,U609293,10,797.9299999999998,5,5,5682.09,6480.02
35776,U27831,10,1167.4,5,5,4985.0,6152.4
35777,U1149843,10,-2.4000000000000163,7,3,164.78000000000003,162.38000000000002
35778,U10692,10,-98.92000000000007,6,4,4723.0,4624.08
35779,U41706,10,-21236.249999999996,4,6,40201.170000000006,18964.92000000001
35780,U33509,10,-1665.7399999999998,5,5,8398.0,6732.26
35781,U25606,10,-48.60999999999876,5,5,21129.059999999998,21080.449999999997
35782,U38423,10,5677.25,6,4,11945.0,17622.25
35783,U9105,10,-12260.380000000003,6,4,39001.36,26740.979999999996
35784,U43573,10,47.52999999999994,7,3,939.7600000000001,987.2900000000001
35785,U37944,10,33029.35,2,8,4000.0,37029.35
35786,U39329,10,-56787.93,2,8,120000.0,63212.07
35787,U33397,10,-2032.0,5,5,29832.0,27800.0
35788,U21237,10,2232.7300000000014,7,3,14521.919999999998,16754.65
35789,U29213,10,7710.63,5,5,1390.0,9100.630000000001
35790,U31013,10,-557.89,5,5,773.66,215.76999999999998
35791,U866780,10,-1085.92,6,4,6825.92,5740.0
35792,U27458,10,29.450000000000045,5,5,4438.610000000001,4468.06
35793,U978483,10,-10376.46,8,2,13176.48,2800.0200000000004
35794,U20038,10,7762.48,4,6,5378.22,13140.7
35795,U24335,10,176.16,7,3,647.05,823.2099999999999
35796,U1192779,10,6392.839999999998,8,2,8611.159999999998,15003.999999999996
35797,U8633,10,-14383.339999999997,5,5,69985.38,55602.04000000001
35798,U23408,10,25002.409999999996,3,7,18333.28,43335.689999999995
35799,U25388,10,5.340000000000031,8,2,794.66,800.0
35800,U11385,10,-42348.62,6,4,52448.26,10099.64
35801,U14447,10,-2637.1800000000003,2,8,40000.0,37362.82
35802,U37819,10,-11067.43,5,5,41001.0,29933.57
35803,U30078,10,-31072.090000000004,4,6,109669.43999999999,78597.34999999998
35804,U21369,10,-76.53999999999999,8,2,79.78,3.240000000000009
35805,U28623,10,-1048.25,6,4,1658.3,610.05
35806,U31531,10,33504.03,2,8,2500.0,36004.03
35807,U9448,10,-14035.029999999999,5,5,31574.0,17538.97
35808,U965821,10,3703.04,5,5,6130.37,9833.41
35809,U1023097,10,0.24000000000023647,5,5,1297.84,1298.0800000000002
35810,U42826,10,-856.8500000000001,6,4,2573.21,1716.36
35811,U38458,10,114.4,5,5,153.6,268.0
35812,U910964,10,-3446.0,7,3,3566.01,120.01000000000022
35813,U17474,10,-11341.01,6,4,16019.22,4678.209999999999
35814,U24716,10,353.94000000000005,7,3,2890.4300000000003,3244.3700000000003
35815,U34001,10,3312.5599999999995,5,5,16200.0,19512.559999999998
35816,U21463,10,4.610000000000582,4,6,24229.0,24233.61
35817,U43738,10,-5198.34,6,4,25798.55,20600.21
35818,U9642,10,-16.339999999999975,6,4,1565.28,1548.94
35819,U26163,10,-346.34999999999997,7,3,1138.2,791.8500000000001
35820,U23253,10,-5136.109999999999,4,6,38610.2,33474.09
35821,U16026,10,1358.68,1,9,100.0,1458.68
35822,U10598,10,-2987.62,8,2,4191.0,1203.38
35823,U16673,10,-16343.789999999994,5,5,50259.44,33915.65000000001
35824,U37566,10,171.52999999999975,6,4,5370.6,5542.13
35825,U15853,10,-10934.34,5,5,18465.17,7530.829999999998
35826,U26323,10,-5338.5,6,4,15938.84,10600.34
35827,U36699,10,0.0,5,5,11600.0,11600.0
35828,U36578,10,1161.9500000000005,6,4,289.20000000000005,1451.1500000000005
35829,U33836,10,-782.5799999999999,7,3,9297.51,8514.93
35830,U1195044,10,644.1599999999999,7,3,3655.84,4300.0
35831,U25813,10,-3082.7000000000003,9,1,16202.7,13120.0
35832,U33557,10,-1091.88,6,4,8300.0,7208.12
35833,U20999,10,7500.1,3,7,24526.1,32026.199999999997
35834,U34616,10,-10858.18,6,4,23064.94,12206.759999999998
35835,U741092,10,1.0000000000001819,5,5,4061.09,4062.09
35836,U1141463,10,135.84999999999982,5,5,3512.71,3648.56
35837,U16405,10,942.2299999999999,7,3,557.98,1500.21
35838,U29447,10,934.2199999999999,5,5,535.9200000000001,1470.1399999999999
35839,U23934,10,-1466.1999999999998,7,3,3701.2,2235.0
35840,U21351,10,323.47,6,4,1454.61,1778.08
35841,U41990,10,-5148.43,6,4,10589.0,5440.57
35842,U20995,10,4340.33,4,6,729.27,5069.6
35843,U28342,10,1.679999999993015,5,5,433980.0,433981.68
35844,U39974,10,-275.03,6,4,971.0,695.97
35845,U26944,10,9105.68,3,7,600.0,9705.68
35846,U19306,10,34337.63,3,7,1845.17,36182.799999999996
35847,U639861,10,-411.0,5,5,2931.0,2520.0
35848,U10813,10,-77811.13,8,2,78447.0,635.8699999999953
35849,U41418,10,8716.310000000001,5,5,1356.0,10072.310000000001
35850,U24333,10,23895.409999999974,5,5,1000006.24,1023901.6499999999
35851,U42904,10,-769.69,7,3,2885.93,2116.24
35852,U31062,10,-10.310000000000091,5,5,2930.4,2920.09
35853,U20120,10,-2630.7700000000004,7,3,3130.8,500.02999999999975
35854,U26183,10,-2204.26,8,2,5739.65,3535.3899999999994
35855,U1064600,10,-181.42,8,2,424.41999999999996,242.99999999999997
35856,U13654,10,-1757056.52,6,4,1759000.0,1943.4799999999814
35857,U1062247,10,0.9300000000000035,6,4,28.930000000000003,29.860000000000007
35858,U10482,10,4077.3,6,4,11854.48,15931.779999999999
35859,U10128,10,231089.27000000002,7,3,70907.02999999998,301996.3
35860,U10854,10,-9.579999999999927,7,3,2219.8,2210.2200000000003
35861,U40518,10,-2519.5099999999993,4,6,7535.120000000001,5015.6100000000015
35862,U818987,10,3053.5499999999997,6,4,596.73,3650.2799999999997
35863,U16624,10,-294.65,4,6,55300.0,55005.35
35864,U41743,10,-169.0,5,5,7179.38,7010.38
35865,U16773,10,-2077.3900000000003,6,4,4134.6,2057.21
35866,U22551,10,-0.9900000000016007,7,3,24001.0,24000.01
35867,U41224,10,-493.89999999999964,5,5,12834.59,12340.69
35868,U40793,10,-2990.6600000000003,5,5,11611.73,8621.07
35869,U33639,10,-666.6000000000001,5,5,8447.84,7781.24
35870,U33455,10,15071.02,4,6,1044.0,16115.02
35871,U15563,10,-2776.6500000000015,8,2,26816.65,24040.0
35872,U19557,10,0.09000000000014552,4,6,5500.0,5500.09
35873,U19472,10,-3225.09,8,2,6450.18,3225.09
35874,U20782,10,-7886.379999999997,7,3,18698.0,10811.620000000003
35875,U16430,10,2488.3699999999994,3,7,312.6,2800.9699999999993
35876,U741986,10,-6947.49,8,2,7047.5,100.01000000000022
35877,U1217534,10,-295.1100000000001,7,3,2195.11,1900.0
35878,U36985,10,6597.320000000001,4,6,7485.19,14082.51
35879,U35208,10,160.3,7,3,144.07,304.37
35880,U9968,10,28511.190000000002,4,6,1506.0,30017.190000000002
35881,U37184,10,7709.279999999999,4,6,26644.0,34353.28
35882,U38664,10,10004.93,3,7,8446.77,18451.7
35883,U28424,10,11862.640000000007,5,5,51761.05,63623.69000000001
35884,U35778,10,7599.929999999999,3,7,7585.34,15185.27
35885,U1068339,10,-100.88000000000005,9,1,740.88,640.0
35886,U24379,10,1141.6500000000003,5,5,10093.2,11234.85
35887,U40475,10,-255.52999999999957,7,3,4945.98,4690.45
35888,U11470,10,3137.0099999999993,6,4,28312.96,31449.969999999998
35889,U18526,10,231.95000000000005,7,3,595.1600000000001,827.1100000000001
35890,U36215,10,122485.55999999997,2,8,150100.0,272585.55999999994
35891,U607815,10,-4090.33,6,4,4340.78,250.44999999999982
35892,U1032671,10,-920.0399999999997,8,2,3920.0399999999995,3000.0
35893,U18556,10,209366.25,2,8,27237.6,236603.85
35894,U740754,10,-549.8800000000001,9,1,550.6800000000001,0.7999999999999545
35895,U8820,10,814.96,5,5,1540.0,2354.96
35896,U10333,10,-1099.02,9,1,1109.32,10.299999999999955
35897,U1120769,10,7004.719999999999,4,6,4395.6,11400.32
35898,U42004,10,888.3499999999999,5,5,4540.85,5429.200000000001
35899,U38533,10,-6377.730000000005,3,7,85280.0,78902.26999999999
35900,U39985,10,3175.9200000000023,2,8,20075.87,23251.79
35901,U37921,10,49397.55,5,5,42750.3,92147.85
35902,U27281,10,70014.6,4,6,88000.0,158014.6
35903,U17895,10,2218.1499999999996,5,5,1858.6,4076.7499999999995
35904,U35658,10,3864.69,6,4,3759.87,7624.5599999999995
35905,U20961,10,2774.0,4,6,26.0,2800.0
35906,U9525,10,9015.6,5,5,7006.0,16021.6
35907,U19095,10,-2654.03,6,4,3793.8,1139.77
35908,U16556,10,1974.6900000000023,6,4,512119.0,514093.69
35909,U9467,10,1185.619999999999,6,4,38000.0,39185.619999999995
35910,U30219,10,-2489.31,6,4,11993.17,9503.86
35911,U13602,10,29878.029999999995,4,6,91000.0,120878.03
35912,U30384,10,-2932.51,7,3,3117.16,184.64999999999964
35913,U39303,10,34113.83,3,7,4167.37,38281.200000000004
35914,U30528,10,-0.36000000000012733,6,4,7750.42,7750.0599999999995
35915,U41916,10,-295.1000000000058,4,6,240600.0,240304.9
35916,U18532,10,891.1599999999999,5,5,4836.0,5727.16
35917,U878187,10,-1954.440000000001,5,5,13377.87,11423.43
35918,U26802,10,6669.08,5,5,8694.1,15363.18
35919,U38199,10,6620.42,3,7,6023.360000000001,12643.78
35920,U1290400,10,9.729999999999999,4,6,10.229999999999999,19.959999999999997
35921,U1336765,10,-0.3799999999996544,5,5,7609.5,7609.120000000001
35922,U30135,10,-1184.28,5,5,2278.0,1093.72
35923,U37774,10,15973.94,4,6,402.0,16375.94
35924,U867379,10,590.93,8,2,1176.22,1767.15
35925,U1218710,10,-2458.34,7,3,3058.38,600.04
35926,U33929,10,18571.619999999995,4,6,109060.0,127631.62
35927,U41019,10,-301.56999999999937,6,4,4754.46,4452.89
35928,U31354,10,555.1700000000001,4,6,3911.15,4466.32
35929,U40688,10,-737.0799999999931,6,4,154023.91,153286.83000000002
35930,U32429,10,11239.25,6,4,11659.0,22898.25
35931,U34795,10,-6447.5,4,6,21776.55,15329.05
35932,U27871,10,-7989.129999999999,4,6,10600.01,2610.880000000001
35933,U39530,10,1119.4599999999991,5,5,17615.75,18735.21
35934,U40823,10,17.67000000000189,5,5,45982.71000000001,46000.380000000005
35935,U41180,10,-380.94000000000005,6,4,1083.9,702.96
35936,U30717,10,-1209.4799999999996,6,4,26494.54,25285.06
35937,U24537,10,-4761.510000000009,7,3,405194.51,400433.0
35938,U31732,10,-610.5900000000038,6,4,27012.440000000002,26401.85
35939,U29055,10,-249965.2,5,5,280214.0,30248.79999999999
35940,U33525,10,90538.45,3,7,180000.0,270538.45
35941,U19808,10,601.1899999999999,3,7,6728.6,7329.79
35942,U33760,10,4987.080000000093,4,6,3038100.0,3043087.08
35943,U42688,10,3595.1499999999996,3,7,4949.0,8544.15
35944,U24944,10,-30601.71,6,4,30899.0,297.2900000000009
35945,U36906,10,-24718.22,2,8,55000.0,30281.78
35946,U42747,10,-15065.080000000002,5,5,59973.03,44907.95
35947,U37433,10,38520.020000000004,3,7,12080.0,50600.020000000004
35948,U36291,10,47.61999999999534,4,6,373899.99,373947.61
35949,U1327922,10,-103.97999999999956,6,4,6324.0,6220.02
35950,U11352,10,82783.15999999999,2,8,99.96,82883.12
35951,U14498,10,46872.25,3,7,4000.0,50872.25
35952,U18562,10,9900.36,5,5,10800.0,20700.36
35953,U31497,10,360.0,8,2,8640.0,9000.0
35954,U41283,10,-1030.0599999999995,6,4,13084.199999999999,12054.14
35955,U990023,10,-15181.59,9,1,19316.31,4134.720000000001
35956,U37763,10,-2130.85,7,3,2223.35,92.5
35957,U35201,10,1866.0599999999995,6,4,10659.0,12525.06
35958,U33281,10,907.1500000000001,5,5,1092.87,2000.02
35959,U18683,10,0.7299999999995634,4,6,17800.0,17800.73
35960,U25045,10,5635.14,5,5,16672.0,22307.14
35961,U28433,10,-5308.040000000001,7,3,17840.0,12531.96
35962,U12917,10,40411.98000000001,3,7,3976.7000000000003,44388.68000000001
35963,U25172,10,244.45000000000073,4,6,56502.0,56746.45
35964,U11004,10,-4330.409999999999,6,4,4588.629999999999,258.22000000000025
35965,U34086,10,2582.31,4,6,1166.0,3748.31
35966,U41287,10,-275.63,7,3,1066.0,790.37
35967,U8882,10,-840.3100000000001,6,4,4608.68,3768.3700000000003
35968,U29020,10,-2608.220000000001,5,5,41581.66,38973.44
35969,U28035,10,754.9800000000432,5,5,764558.0,765312.9800000001
35970,U9019,10,3699.0599999999995,6,4,8141.39,11840.45
35971,U1322363,10,138.71,5,5,5105.0,5243.71
35972,U9243,10,174.52999999999997,6,4,829.87,1004.4
35973,U1198041,10,-0.4200000000000159,6,4,1429.3600000000001,1428.94
35974,U9882,10,-39.99000000000001,5,5,446.0,406.01
35975,U39722,10,-26777.350000000002,5,5,43172.380000000005,16395.030000000002
35976,U17789,10,163.36000000000058,6,4,5727.75,5891.110000000001
35977,U34874,10,-47.49000000000174,6,4,45048.01,45000.52
35978,U24290,10,-224.54000000000002,4,6,330.0,105.45999999999998
35979,U40683,10,23945.12,3,7,23945.0,47890.119999999995
35980,U25516,10,100.0,8,2,26000.0,26100.0
35981,U15912,10,-3482.4500000000007,5,5,8516.61,5034.16
35982,U35862,10,-98.44999999999982,7,3,5574.75,5476.3
35983,U39066,10,-117.52999999999996,4,6,456.78,339.25
35984,U670618,10,-6.590000000000064,6,4,3782.41,3775.8199999999997
35985,U9447,10,-89830.3,6,4,89996.0,165.6999999999971
35986,U37597,10,1503.3000000000002,7,3,8500.0,10003.3
35987,U1245589,10,0.5900000000004547,6,4,4841.1900000000005,4841.780000000001
35988,U19976,10,0.6100000000001273,5,5,6354.5,6355.110000000001
35989,U1060438,10,1098.3100000000002,5,5,622.1700000000001,1720.4800000000002
35990,U37941,10,-473.88,7,3,1133.39,659.5100000000001
35991,U38612,10,4668.639999999999,4,6,28150.4,32819.04
35992,U40408,10,-6304.889999999999,8,2,13328.0,7023.110000000001
35993,U41455,10,14055.389999999998,3,7,3456.5299999999997,17511.92
35994,U35437,10,-2559.84,9,1,2560.94,1.099999999999909
35995,U38313,10,-23688.57,6,4,34479.6,10791.029999999999
35996,U747010,10,-439.2999999999993,6,4,6259.299999999999,5820.0
35997,U24542,10,157.75,3,7,50055.0,50212.75
35998,U1101143,10,-4.059999999999974,6,4,415.46999999999997,411.40999999999997
35999,U1353359,10,3.0,5,5,231.08,234.08
36000,U10472,10,0.0,9,1,8.08,8.08
36001,U31145,10,-2336.49,8,2,2429.63,93.14000000000033
36002,U26012,10,5460.49,6,4,540.5699999999999,6001.0599999999995
36003,U40736,10,20843.61,4,6,1670.95,22514.56
36004,U31389,10,-0.8100000000013097,5,5,22422.0,22421.19
36005,U1345245,10,0.9900000000000002,5,5,12.99,13.98
36006,U1092136,10,0.4199999999999591,6,4,1091.0,1091.42
36007,U34398,10,-94.29,6,4,20217.3,20123.01
36008,U39378,10,-18832.74,5,5,68125.0,49292.259999999995
36009,U11514,10,-3697.9900000000066,4,6,104560.0,100862.01
36010,U38708,10,167740.52,4,6,1143493.59,1311234.11
36011,U30308,10,-677.8000000000011,3,7,19502.75,18824.949999999997
36012,U15100,10,76.99,4,6,51.21,128.2
36013,U18919,10,-24.390000000000146,5,5,3048.92,3024.5299999999997
36014,U32253,10,-9128.519999999997,6,4,17767.17,8638.650000000001
36015,U18970,10,30.20999999999981,6,4,6141.799999999999,6172.009999999999
36016,U29833,10,-1.2800000000024738,4,6,58166.0,58164.72
36017,U1090014,10,-289.83,7,3,392.51,102.68
36018,U17827,10,339.25000000000017,5,5,1768.3200000000002,2107.57
36019,U29693,10,20048.43,6,4,178.19,20226.62
36020,U39197,10,8900.21,5,5,31670.31,40570.520000000004
36021,U36253,10,17.18999999999869,3,7,28500.0,28517.19
36022,U34317,10,2365.0899999999997,8,2,52.839999999999996,2417.93
36023,U17439,10,-815.44,3,7,3267.8199999999997,2452.3799999999997
36024,U37127,10,7783.52,5,5,9000.0,16783.52
36025,U10853,10,1635.08,8,2,1189.64,2824.7200000000003
36026,U18102,10,-25568.29,5,5,101770.0,76201.70999999999
36027,U42734,10,5135.700000000001,5,5,11792.810000000003,16928.510000000002
36028,U1352426,10,26480.09,3,7,1285.09,27765.18
36029,U1238959,10,-1025.8,6,4,1075.82,50.01999999999998
36030,U35604,10,-19356.18,7,3,36848.28,17492.1
36031,U40345,10,-19997.22,5,5,25748.56,5751.34
36032,U19799,10,-627.5300000000279,4,6,301502.16000000003,300874.63
36033,U24838,10,-770.7599999999999,5,5,1733.4,962.6400000000002
36034,U25214,10,-651.5900000000005,4,6,16957.82,16306.23
36035,U42136,10,-2.1000000000000227,5,5,801.32,799.22
36036,U11975,10,-208.8099999999995,6,4,15400.0,15191.19
36037,U12507,10,8384.869999999999,4,6,240.97,8625.839999999998
36038,U18835,10,-645.2,6,4,1556.65,911.45
36039,U40808,10,176.81999999999994,5,5,433.86,610.68
36040,U22357,10,-64.51000000000005,5,5,506.14,441.62999999999994
36041,U970170,10,-1078.09,6,4,2418.6899999999996,1340.5999999999997
36042,U22481,10,835.3199999999999,6,4,134.05,969.3699999999999
36043,U40910,10,69.11999999999999,5,5,108.35999999999999,177.47999999999996
36044,U40269,10,-23.0,6,4,4623.0,4600.0
36045,U33839,10,-24.8,8,2,25.0,0.1999999999999993
36046,U1093852,10,-297.97,5,5,443.01,145.03999999999996
36047,U25821,10,-9.870000000000017,5,5,4110.13,4100.26
36048,U1162780,10,-1526.34,9,1,3626.3399999999997,2100.0
36049,U31279,10,-15351.25,5,5,56500.12,41148.87
36050,U14650,10,-538.48,7,3,978.7,440.22
36051,U27014,10,27147.32,2,8,14371.5,41518.82
36052,U587532,10,1145.67,5,5,8751.1,9896.77
36053,U34551,10,37367.27,4,6,22691.809999999998,60059.079999999994
36054,U1073596,10,4.319999999999982,5,5,5255.51,5259.83
36055,U31556,10,-1122.2000000000007,6,4,16354.6,15232.4
36056,U15875,10,-358.43999999998135,6,4,600385.0,600026.56
36057,U27244,9,6944.239999999998,5,4,13538.0,20482.239999999998
36058,U20753,9,-629.0300000000008,6,3,8429.1,7800.07
36059,U1190806,9,-16.0,6,3,279.0,263.0
36060,U35064,9,1601.8600000000001,4,5,1272.0,2873.86
36061,U33909,9,636.0300000000025,4,5,71294.0,71930.03
36062,U22899,9,36388.0,5,4,12012.0,48400.0
36063,U43611,9,20932.26,4,5,7522.0,28454.26
36064,U9463,9,-792.8000000000002,5,4,6813.0,6020.2
36065,U43977,9,121.05999999999767,3,6,53500.0,53621.06
36066,U38978,9,-1297.6200000000001,5,4,2448.0,1150.3799999999999
36067,U31592,9,13638.470000000001,5,4,16266.47,29904.940000000002
36068,U750940,9,-6391.8,6,3,8891.84,2500.04
36069,U706077,9,344.27,4,5,105.74000000000001,450.01
36070,U22016,9,2541.78,4,5,6761.2,9302.98
36071,U1235007,9,-5449.97,8,1,5450.0,0.02999999999974534
36072,U41125,9,7063.01,3,6,10288.8,17351.809999999998
36073,U11320,9,1092.31,4,5,12.0,1104.31
36074,U34132,9,802.23,5,4,1989.0,2791.23
36075,U43036,9,-32.67000000000007,7,2,12036.8,12004.13
36076,U1298609,9,-617.5799999999999,7,2,681.67,64.09000000000003
36077,U13101,9,0.0,7,2,421.51,421.51
36078,U811261,9,707.97,7,2,2694.04,3402.01
36079,U1321069,9,-13.990000000000009,6,3,514.0,500.01
36080,U34623,9,-29386.2,4,5,35000.86,5614.66
36081,U21323,9,-553759.14,5,4,687841.88,134082.74
36082,U31437,9,-25.710000000000036,6,3,4728.0,4702.29
36083,U18805,9,10494.42,4,5,10589.34,21083.760000000002
36084,U1071494,9,-1412.1,7,2,1412.2199999999998,0.11999999999989086
36085,U29800,9,499723.47,3,6,18792.58,518516.05
36086,U33840,9,11061.54,4,5,3598.83,14660.37
36087,U37835,9,-8820.78,5,4,20799.0,11978.22
36088,U1106580,9,7.8,5,4,2480.0,2487.8
36089,U37339,9,1824.8999999999974,4,5,52176.0,54000.899999999994
36090,U41971,9,33.23000000000002,6,3,2277.7,2310.93
36091,U36588,9,-90.37999999999784,5,4,23081.0,22990.620000000003
36092,U24857,9,57035.729999999996,2,7,58333.34,115369.06999999999
36093,U40142,9,-2043.5,5,4,6494.44,4450.94
36094,U13493,9,36.549999999999955,7,2,963.6700000000001,1000.22
36095,U35457,9,8895.46,5,4,4109.93,13005.39
36096,U19653,9,-37.769999999999996,5,4,3559.8199999999997,3522.0499999999997
36097,U951348,9,1.1499999999996362,6,3,5750.0,5751.15
36098,U895994,9,124.75999999999999,6,3,670.94,795.7
36099,U13277,9,-308.8600000000006,4,5,54321.310000000005,54012.450000000004
36100,U13904,9,-1903.5,6,3,22582.0,20678.5
36101,U27792,9,-615.8899999999996,4,5,15080.0,14464.11
36102,U40136,9,-0.9600000000011641,5,4,71858.58,71857.62
36103,U31382,9,4819.290000000001,4,5,6497.58,11316.87
36104,U12706,9,-13647.259999999998,3,6,27146.9,13499.640000000003
36105,U1239788,9,1.039999999999993,4,5,149.5,150.54
36106,U14395,9,-9328.67,7,2,9613.3,284.6299999999992
36107,U11800,9,62757.240000000005,3,6,457.7,63214.94
36108,U979352,9,-7955.490000000001,5,4,14833.53,6878.04
36109,U1301113,9,0.2799999999995453,5,4,3639.2799999999997,3639.5599999999995
36110,U1174177,9,-0.1999999999999318,5,4,4003.7899999999995,4003.5899999999997
36111,U12264,9,-538685.9500000001,3,6,1599838.0,1061152.0499999998
36112,U31128,9,1.0499999999992724,4,5,70000.0,70001.05
36113,U1361828,9,-1.1100000000000012,6,3,24.369999999999997,23.259999999999998
36114,U26084,9,58406.649999999994,3,6,70405.0,128811.65
36115,U35348,9,3846.3500000000004,3,6,14400.0,18246.35
36116,U31970,9,1.3500000000021828,4,5,22440.36,22441.710000000003
36117,U33541,9,2959.01,4,5,4875.0,7834.01
36118,U16550,9,-624.7200000000005,4,5,19783.579999999998,19158.859999999997
36119,U24413,9,-26381.39,7,2,26500.0,118.61000000000058
36120,U979360,9,-2021.6799999999998,6,3,2123.37,101.69000000000005
36121,U43424,9,-7453.790000000001,4,5,25869.53,18415.739999999998
36122,U31121,9,-10985.07,7,2,14267.38,3282.3099999999995
36123,U967302,9,1161.8400000000001,3,6,1162.35,2324.19
36124,U28867,9,3039.41,5,4,20900.0,23939.41
36125,U38044,9,4629.409999999985,4,5,186299.0,190928.40999999997
36126,U31909,9,-17240.05,4,5,18154.12,914.0699999999997
36127,U43447,9,-831.7800000000007,4,5,20665.940000000002,19834.160000000003
36128,U34075,9,-1756.4900000000002,7,2,1789.6300000000003,33.1400000000001
36129,U30487,9,-5476.639999999999,7,2,5700.0,223.36000000000058
36130,U43800,9,29200.379999999997,0,9,0.0,29200.379999999997
36131,U22413,9,-6.280000000000873,5,4,4406.450000000001,4400.17
36132,U42294,9,-183.48,7,2,193.52,10.04000000000002
36133,U32513,9,11.409999999999991,6,3,127.69999999999999,139.10999999999999
36134,U841444,9,-141.17999999999984,5,4,4396.63,4255.450000000001
36135,U31105,9,6770.560000000001,5,4,4643.7,11414.260000000002
36136,U574573,9,-10911.2,6,3,35928.0,25016.8
36137,U36176,9,1713.539999999999,2,7,10100.0,11813.539999999999
36138,U19400,9,-145.6399999999907,6,3,1000145.65,1000000.01
36139,U9095,9,-9785.34,8,1,9949.94,164.60000000000036
36140,U26744,9,1.4599999999993816,3,6,12745.84,12747.3
36141,U35161,9,2544.0900000000006,2,7,3700.0,6244.09
36142,U18807,9,-631.3199999999997,2,7,22000.0,21368.68
36143,U11815,9,-11008.95,6,3,22010.0,11001.05
36144,U37764,9,-573.9200000000001,4,5,28712.34,28138.42
36145,U43499,9,398.2100000000007,4,5,18202.98,18601.19
36146,U8826,9,142.9600000000002,6,3,1083.92,1226.8800000000003
36147,U24614,9,17882.41,2,7,827.1,18709.51
36148,U1339029,9,13353.94,5,4,337.97,13691.91
36149,U29537,9,113.19000000000088,4,5,9204.78,9317.970000000001
36150,U43615,9,122.78000000000043,5,4,8922.22,9045.0
36151,U8974,9,6874.610000000001,5,4,8300.0,15174.61
36152,U1302827,9,0.0999999999999659,6,3,776.8000000000001,776.9000000000001
36153,U796048,9,-544.79,7,2,1025.92,481.1300000000001
36154,U1289819,9,182.16999999999996,5,4,817.87,1000.04
36155,U23811,9,-55.960000000000036,4,5,6316.04,6260.08
36156,U581242,9,6836.75,2,7,5700.0,12536.75
36157,U1118335,9,-210.1,5,4,2519.15,2309.05
36158,U620331,9,-3995.9500000000003,6,3,7016.099999999999,3020.149999999999
36159,U34187,9,253.07,7,2,52.0,305.07
36160,U23723,9,1857.69,5,4,7679.55,9537.24
36161,U21963,9,-59990.56999999999,5,4,62103.17999999999,2112.6100000000006
36162,U820355,9,2.2700000000000244,4,5,368.12,370.39000000000004
36163,U742416,9,41.32000000000005,6,3,762.7,804.0200000000001
36164,U1308369,9,507.0,5,4,1318.78,1825.78
36165,U1254841,9,-28.92000000000003,5,4,858.3000000000001,829.38
36166,U25527,9,-907.33,5,4,3910.0,3002.67
36167,U28392,9,-796.06,5,4,2300.0,1503.94
36168,U33567,9,172528.25,5,4,1076.74,173604.99
36169,U32967,9,523.9999999999989,5,4,22000.0,22524.0
36170,U33967,9,-44390.60999999999,5,4,67531.59000000001,23140.980000000018
36171,U34427,9,-122195.84,5,4,134798.0,12602.160000000003
36172,U27863,9,943.0300000000002,5,4,1089.7,2032.7300000000002
36173,U1152722,9,492.20000000000005,5,4,1507.81,2000.01
36174,U33472,9,59989.83,4,5,60391.74,120381.57
36175,U9393,9,1466.3000000001666,4,5,3002127.0,3003593.3000000003
36176,U25441,9,1600.1,5,4,800.0,2400.1
36177,U34850,9,-11240.48,5,4,22008.0,10767.52
36178,U1252111,9,6348.820000000001,4,5,1491.18,7840.000000000001
36179,U724311,9,777.01,3,6,1011.71,1788.72
36180,U21300,9,-237.59,6,3,438.37,200.78
36181,U1083250,9,-29.76,6,3,49.870000000000005,20.110000000000003
36182,U770504,9,-3181.88,5,4,3581.9999999999995,400.11999999999944
36183,U33019,9,65.93999999999869,3,6,31500.0,31565.94
36184,U609141,9,1029.0,1,8,4435.0,5464.0
36185,U968384,9,-5450.26,5,4,5485.330000000001,35.07000000000062
36186,U1133564,9,-1.4432899320127035e-15,5,4,77.6,77.6
36187,U24277,9,-2683.2300000000005,5,4,10500.0,7816.7699999999995
36188,U24676,9,55757.979999999996,3,6,7353.74,63111.719999999994
36189,U587614,9,-9.237055564881302e-14,6,3,921.3700000000001,921.37
36190,U970433,9,5997.75,6,3,2752.26,8750.01
36191,U41787,9,-1623.8100000000002,6,3,4335.76,2711.95
36192,U21365,9,2299.4400000000023,6,3,60366.0,62665.44
36193,U20454,9,159.56999999999994,7,2,594.69,754.26
36194,U40357,9,941.9,5,4,748.1000000000001,1690.0
36195,U37986,9,-1462.9200000000005,6,3,14965.550000000001,13502.630000000001
36196,U634682,9,-358.52,6,3,369.35999999999996,10.839999999999975
36197,U10195,9,-2431.72,6,3,2468.17,36.45000000000027
36198,U25306,9,6.619999999999891,6,3,7167.32,7173.94
36199,U41988,9,-12292.25,8,1,12477.439999999999,185.1899999999987
36200,U26588,9,985.6699999999998,3,6,6952.32,7937.99
36201,U31925,9,3401.0599999999995,4,5,14600.0,18001.059999999998
36202,U27745,9,-2004.2600000000004,5,4,31605.440000000002,29601.18
36203,U23001,9,-110.83000000000001,7,2,111.10000000000001,0.269999999999996
36204,U35561,9,-410.96000000000004,6,3,604.0,193.03999999999996
36205,U14925,9,1248.5900000000038,6,3,22421.0,23669.590000000004
36206,U38515,9,-2371.99,4,5,8936.0,6564.01
36207,U34663,9,1580.2399999999998,2,7,1489.0,3069.24
36208,U40973,9,4500.93,3,6,4887.5,9388.43
36209,U42116,9,-1368.2600000000002,5,4,11969.0,10600.74
36210,U1208547,9,940.0,3,6,5850.0,6790.0
36211,U28410,9,9408.93,3,6,53100.0,62508.93
36212,U13188,9,-9533.37,1,8,40000.0,30466.629999999997
36213,U34037,9,8.02,4,5,56.68,64.7
36214,U22094,9,75.35,5,4,129.9,205.25
36215,U30251,9,-17958.95,6,3,21958.99,4000.040000000001
36216,U24145,9,73573.88,4,5,139.9,73713.78
36217,U576219,9,27.0,4,5,66.0,93.0
36218,U927954,9,-111.56000000000009,5,4,6066.84,5955.28
36219,U38800,9,238.97000000000003,6,3,1261.88,1500.8500000000001
36220,U24367,9,100.15999999999985,4,5,52100.0,52200.16
36221,U22725,9,9219.16,2,7,15700.85,24920.010000000002
36222,U23250,9,6534.18,4,5,3832.2900000000004,10366.470000000001
36223,U15281,9,-5611.949999999999,4,5,29900.0,24288.050000000003
36224,U29598,9,12.0,5,4,148188.0,148200.0
36225,U12165,9,-135.90000000000055,5,4,31080.06,30944.16
36226,U25457,9,555.7299999999999,4,5,1486.44,2042.17
36227,U12145,9,4420.16,5,4,15619.0,20039.16
36228,U18290,9,0.029999999999972715,4,5,2811.0,2811.0299999999997
36229,U19660,9,48874.56,3,6,1156.23,50030.79
36230,U35059,9,-2192.7799999999997,7,2,9279.88,7087.099999999999
36231,U1299033,9,-543.99,7,2,1044.0,500.01
36232,U1180478,9,-59623.6,9,0,59623.6,0.0
36233,U21808,9,-1573.82,8,1,1574.6399999999999,0.8199999999999363
36234,U29664,9,-599.6000000000004,5,4,17299.6,16700.0
36235,U24259,9,26211.92,3,6,16585.6,42797.52
36236,U42011,9,-118.2,5,4,100119.4,100001.2
36237,U31436,9,-57.700000000000045,6,3,3137.74,3080.04
36238,U19592,9,12001.42,1,8,50.0,12051.42
36239,U12127,9,68737.78,4,5,613.0,69350.78
36240,U10647,9,-2631.24,7,2,3438.0,806.7600000000002
36241,U38163,9,0.009999999999990905,5,4,62400.0,62400.01
36242,U24727,9,-29.900000000000006,4,5,619.86,589.96
36243,U15085,9,1.5500000000465661,2,7,3000000.0,3000001.55
36244,U18893,9,-34206.52000000001,4,5,236612.0,202405.47999999998
36245,U20947,9,-1196.7699999999998,8,1,1203.86,7.0900000000001455
36246,U32267,9,-2.4700000000000273,3,6,663.34,660.87
36247,U14413,9,-14504.619999999999,6,3,22317.640000000003,7813.020000000004
36248,U30799,9,-16435.57,3,6,110000.0,93564.43
36249,U18801,9,7984.200000000003,5,4,920.9,8905.100000000002
36250,U33555,9,-157.54999999999993,6,3,495.93999999999994,338.39
36251,U1129953,9,-9.079999999999993,6,3,489.09,480.01
36252,U19871,9,-800.42,6,3,812.0,11.580000000000041
36253,U1134631,9,2041.22,5,4,4200.2,6241.42
36254,U42417,9,-376.93999999999994,6,3,1241.01,864.07
36255,U27935,9,-10024.48,5,4,21362.3,11337.82
36256,U19901,9,274.1699999999999,5,4,7606.6,7880.77
36257,U24055,9,1191.85,5,4,1133.88,2325.73
36258,U38263,9,0.33000000000174623,4,5,51674.0,51674.33
36259,U18679,9,-567.8600000000006,2,7,12000.0,11432.14
36260,U15006,9,12230.39,5,4,5144.04,17374.43
36261,U21084,9,27.200000000000102,4,5,5838.719999999999,5865.919999999999
36262,U34126,9,-3069.8,6,3,7014.9,3945.0999999999995
36263,U19603,9,-126.66999999999982,5,4,3737.0,3610.3300000000004
36264,U29614,9,-1043.0,7,2,9224.0,8181.0
36265,U36747,9,0.049999999999272404,4,5,14200.0,14200.05
36266,U32370,9,5266.89,5,4,187.82,5454.71
36267,U593954,9,-2619.7399999999993,8,1,2620.1199999999994,0.38000000000010914
36268,U42384,9,1119.12,5,4,1400.98,2520.1
36269,U21085,9,-19515.399999999998,6,3,50129.22,30613.820000000003
36270,U27883,9,-2293.92,4,5,21300.0,19006.08
36271,U24819,9,-880.8699999999998,5,4,4381.4,3500.5299999999997
36272,U10167,9,101491.84,3,6,8514.28,110006.12
36273,U22836,9,190.44000000000005,7,2,1309.9,1500.3400000000001
36274,U35068,9,673.8900000000002,4,5,14024.21,14698.099999999999
36275,U952852,9,-106.0,5,4,3475.0,3369.0
36276,U36084,9,565.2600000000002,6,3,8467.14,9032.4
36277,U28958,9,-770.0200000000004,5,4,58863.0,58092.979999999996
36278,U22252,9,-11457.830000000002,6,3,12457.920000000002,1000.0900000000001
36279,U35486,9,2575.7800000000007,5,4,24467.81,27043.590000000004
36280,U29223,9,28562.33,5,4,86566.2,115128.53
36281,U22785,9,40387.4,3,6,23300.0,63687.4
36282,U32018,9,11309.269999999999,5,4,1538.6,12847.869999999999
36283,U650458,9,12.329999999999126,4,5,8062.129999999999,8074.459999999998
36284,U19735,9,-51504.03999999999,5,4,173538.90999999997,122034.86999999998
36285,U43545,9,8570.03,2,7,6400.0,14970.03
36286,U13693,9,-99.0,6,3,30552.96,30453.96
36287,U31559,9,45.23000000000002,6,3,6505.030000000001,6550.26
36288,U28947,9,-200.47000000000003,5,4,404.86,204.39
36289,U43113,9,-551.7599999999999,6,3,3791.89,3240.13
36290,U1307147,9,120.57999999999981,4,5,3107.58,3228.16
36291,U26771,9,2320.6200000000003,6,3,4582.6,6903.220000000001
36292,U598553,9,-1199.44,8,1,2322.6,1123.1599999999999
36293,U43412,9,-130201.24,6,3,141067.95,10866.710000000006
36294,U1234496,9,71.99999999999989,4,5,3500.12,3572.12
36295,U42977,9,1473.7299999999996,4,5,24029.800000000003,25503.530000000002
36296,U17015,9,1237.8400000000233,3,6,510000.0,511237.84
36297,U42401,9,143.27999999999975,4,5,5846.16,5989.44
36298,U16900,9,299542.79,5,4,58924.799999999996,358467.58999999997
36299,U26381,9,-64.64,5,4,323.03,258.39
36300,U1273358,9,-880.5500000000002,6,3,2906.17,2025.62
36301,U41149,9,-2088.8499999999995,4,5,2923.99,835.1400000000003
36302,U33910,9,461.6,6,3,508.29999999999995,969.9
36303,U41776,9,410956.58,3,6,155000.0,565956.5800000001
36304,U36124,9,-2029.4299999999998,4,5,5620.68,3591.2500000000005
36305,U14771,9,-1311.5,7,2,1313.8500000000001,2.3500000000001364
36306,U21805,9,-0.8999999999999773,6,3,827.8,826.9
36307,U26455,9,88.29000000000087,7,2,62738.0,62826.29
36308,U732261,9,-2625.489999999998,5,4,86270.0,83644.51000000001
36309,U14386,9,-2491.65,5,4,10481.189999999999,7989.539999999999
36310,U33933,9,89.58000000000084,4,5,15014.2,15103.780000000002
36311,U15274,9,46831.55000000009,4,5,2002300.0,2049131.55
36312,U1360713,9,3.4299999999998363,5,4,2191.5499999999997,2194.9799999999996
36313,U27882,9,1269.7700000000002,4,5,19790.0,21059.77
36314,U1084013,9,218.66999999999985,4,5,2855.19,3073.8599999999997
36315,U19021,9,37055.759999999995,3,6,71.42,37127.17999999999
36316,U21607,9,18110.28,3,6,34120.0,52230.28
36317,U42467,9,20255.51999999999,5,4,112100.0,132355.52
36318,U36049,9,2580.26,6,3,6527.0,9107.26
36319,U36930,9,-48.84000000000003,4,5,1754.83,1705.9899999999998
36320,U31077,9,-2682.6,6,3,3005.64,323.03999999999996
36321,U30934,9,-66.75999999999975,5,4,1446.68,1379.9200000000003
36322,U28879,9,-53622.63,5,4,110885.0,57262.37
36323,U17098,9,2775.95,2,7,3445.19,6221.139999999999
36324,U20896,9,-3220.97,6,3,5221.0,2000.0300000000002
36325,U33979,9,-1044.77,6,3,2874.0,1829.23
36326,U1030794,9,-929.83,7,2,2929.8600000000006,2000.0300000000007
36327,U41425,9,0.0,2,7,600.61,600.61
36328,U1171220,9,-43937.490000000005,8,1,44437.490000000005,500.0
36329,U25084,9,0.0,7,2,149.15,149.15
36330,U18130,9,-13969.46,6,3,29878.4,15908.940000000002
36331,U18762,9,37276.9,2,7,444.38,37721.28
36332,U13015,9,-7123.98,6,3,27123.989999999998,20000.01
36333,U29381,9,1363.0199999999995,3,6,1388.85,2751.8699999999994
36334,U30856,9,-718.5900000000001,5,4,25620.0,24901.41
36335,U10308,9,-2986.0,6,3,9576.0,6590.0
36336,U734230,9,-1947.7500000000002,8,1,1948.5400000000002,0.7899999999999636
36337,U33338,9,-23.789999999999964,3,6,107500.0,107476.21
36338,U40839,9,45.5100000000004,5,4,16684.3,16729.81
36339,U36120,9,9742.63,6,3,381.01,10123.64
36340,U20414,9,-5.980000000000018,5,4,4506.0,4500.02
36341,U21464,9,10993.86,5,4,15125.16,26119.02
36342,U1362066,9,-2467.7,7,2,2517.7,50.0
36343,U33466,9,-383.6600000000001,3,6,3735.0,3351.34
36344,U16147,9,-63.03,7,2,163.1,100.07
36345,U1229755,9,-0.12999999999996703,6,3,363.27,363.14
36346,U30309,9,-24019.730000000003,2,7,90000.0,65980.26999999999
36347,U23076,9,-2259.11,6,3,2528.0,268.8899999999999
36348,U28527,9,-2110.8100000000013,6,3,20921.11,18810.3
36349,U36972,9,-449.2400000000001,6,3,11353.24,10904.0
36350,U25192,9,6012.59,5,4,20006.0,26018.59
36351,U30362,9,-45.32000000000019,4,5,2286.77,2241.45
36352,U8762,9,9041.48,5,4,4936.02,13977.5
36353,U33797,9,26274.57,4,5,4756.0,31030.57
36354,U21886,9,30841.400000000012,2,7,50210.3,81051.70000000001
36355,U33086,9,6360.209999999999,3,6,20739.0,27099.21
36356,U29047,9,1690.3799999999997,3,6,2324.35,4014.7299999999996
36357,U43245,9,-188.01999999999975,5,4,40347.0,40158.98
36358,U27419,9,38465.59,4,5,267.6,38733.189999999995
36359,U26093,9,-336.7199999999998,6,3,8130.0,7793.280000000001
36360,U1247724,9,115.0,5,4,8596.0,8711.0
36361,U1267048,9,-68.99,5,4,167.31,98.32000000000001
36362,U1238017,9,2.0,4,5,3408.0,3410.0
36363,U1110239,9,603.26,6,3,1338.09,1941.35
36364,U1048537,9,-92.66000000000003,4,5,375.56000000000006,282.90000000000003
36365,U1370551,9,10.789999999999964,5,4,4145.34,4156.13
36366,U31720,9,60.57000000000022,2,7,2200.0,2260.57
36367,U35043,9,2092.6499999999996,5,4,13807.35,15900.0
36368,U10449,9,-561.7599999999999,5,4,1120.4,558.6400000000002
36369,U35754,9,1226.4999999999998,4,5,5940.01,7166.51
36370,U37942,9,2762.0,5,4,13018.0,15780.0
36371,U39386,9,-30858.03,3,6,51200.0,20341.97
36372,U897912,9,2.149999999999709,5,4,4668.49,4670.639999999999
36373,U10270,9,-4059.81,6,3,7584.0,3524.19
36374,U34077,9,-1998.6200000000008,5,4,13974.0,11975.38
36375,U11200,9,7349.95,4,5,7384.34,14734.29
36376,U40703,9,3777.100000000006,2,7,200000.0,203777.1
36377,U13932,9,-1777.38,6,3,3140.61,1363.23
36378,U28262,9,2.2100000000007185,4,5,24003.3,24005.51
36379,U32110,9,-4.547473508864641e-13,5,4,12412.98,12412.98
36380,U23020,9,1029.5400000000002,4,5,2087.39,3116.9300000000003
36381,U38749,9,210101.77,5,4,410000.0,620101.77
36382,U21646,9,42303.94000000001,5,4,30797.17,73101.11000000002
36383,U42000,9,-1.6100000000000136,5,4,972.99,971.38
36384,U34677,9,20.290000000000063,4,5,2282.48,2302.77
36385,U19860,9,8002.959999999999,3,6,11385.32,19388.28
36386,U15944,9,137.8099999999998,3,6,10362.53,10500.34
36387,U28549,9,6388.91,4,5,8975.42,15364.33
36388,U34292,9,-331212.04,4,5,911500.0,580287.96
36389,U20641,9,-49418.9,7,2,98669.0,49250.1
36390,U27355,9,-31012.020000000004,4,5,80460.0,49447.979999999996
36391,U14006,9,3268.42,5,4,831.7,4100.12
36392,U972593,9,10673.75,5,4,46.269999999999996,10720.02
36393,U12624,9,-1801.72,6,3,4715.13,2913.41
36394,U41891,9,-553.6800000000007,4,5,22845.2,22291.52
36395,U18152,9,77692.61,5,4,12805.0,90497.61
36396,U1098314,9,154.02999999999997,6,3,1292.27,1446.3
36397,U12721,9,4162.46,5,4,10116.0,14278.46
36398,U12202,9,1712.42,6,3,9088.0,10800.42
36399,U34833,9,-19860.300000000003,6,3,30000.0,10139.699999999997
36400,U1073158,9,1264.99,4,5,509.68999999999994,1774.6799999999998
36401,U35036,9,5482.6,4,5,3870.0,9352.6
36402,U34617,9,40.24000000000182,4,5,18350.809999999998,18391.05
36403,U18828,9,158548.90999999997,1,8,90000.0,248548.90999999997
36404,U28113,9,9758.400000000001,4,5,3702.7,13461.100000000002
36405,U19356,9,-1764.8500000000004,5,4,13174.05,11409.199999999999
36406,U1091257,9,-481.31999999999994,8,1,693.3199999999999,212.0
36407,U21876,9,-3070.4900000000016,3,6,29980.45,26909.96
36408,U27902,9,3663.45,1,8,761.0,4424.45
36409,U1050188,9,-686.7,7,2,1037.72,351.02
36410,U22532,9,120.10000000000036,4,5,7412.9,7533.0
36411,U28971,9,6727.0599999999995,4,5,230.9,6957.959999999999
36412,U13187,9,-5037.739999999994,4,5,53912.0,48874.26000000001
36413,U31523,9,1047.4400000000026,3,6,50325.07,51372.51
36414,U12841,9,-644.65,6,3,1554.43,909.7800000000001
36415,U20776,9,3001.2799999999997,2,7,3120.28,6121.5599999999995
36416,U23913,9,-320.37,6,3,546.9,226.52999999999997
36417,U22564,9,6200.5,3,6,6085.83,12286.33
36418,U1261667,9,-2785.52,8,1,2795.52,10.0
36419,U15512,9,22795.78,2,7,22248.04,45043.82
36420,U1235159,9,30.0,4,5,850.0,880.0
36421,U15286,9,8937.73,2,7,14000.0,22937.73
36422,U21583,9,-9002.740000000002,6,3,12582.0,3579.2599999999984
36423,U24183,9,-20023.49,7,2,20323.5,300.0099999999984
36424,U21968,9,3608.35,4,5,616.98,4225.33
36425,U1351900,9,294.47,3,6,925.8,1220.27
36426,U32728,9,1647.750000000001,6,3,14755.72,16403.47
36427,U10420,9,7492.5599999999995,2,7,4664.0,12156.56
36428,U38657,9,-24194.929999999702,6,3,6068000.0,6043805.07
36429,U32839,9,26766.88,3,6,26141.0,52907.880000000005
36430,U1040467,9,-98.60000000000002,5,4,285.7,187.09999999999997
36431,U9302,9,38040.86,2,7,54955.520000000004,92996.38
36432,U31825,9,-1757.76,6,3,18377.23,16619.47
36433,U23998,9,5001.110000000001,3,6,5471.0,10472.11
36434,U20968,9,9200.28,4,5,14037.73,23238.010000000002
36435,U24280,9,89858.15999999999,2,7,5160.32,95018.47999999998
36436,U10919,9,-12799.97,5,4,55176.0,42376.03
36437,U584906,9,1990.4599999999991,5,4,13989.54,15980.0
36438,U39052,9,2692.9200000000005,6,3,2429.06,5121.9800000000005
36439,U29885,9,6451.630000000001,6,3,151.14000000000001,6602.770000000001
36440,U38957,9,-0.08000000000174623,6,3,10525.82,10525.739999999998
36441,U19135,9,-7804.02,7,2,21436.02,13632.0
36442,U32175,9,659.2000000000007,6,3,17625.82,18285.02
36443,U20812,9,485.75,5,4,9426.599999999999,9912.349999999999
36444,U983595,9,-1396.3200000000006,6,3,8528.29,7131.97
36445,U15777,9,1.699999999997658,4,5,439777.44,439779.14
36446,U27731,9,52785.94,6,3,353.49,53139.43
36447,U24624,9,108.63000000000005,4,5,783.14,891.77
36448,U12437,9,-367330.0,3,6,1114638.0,747308.0
36449,U15903,9,360136.26,1,8,270.0,360406.26
36450,U14654,9,-496384.55999999994,4,5,992321.89,495937.3300000001
36451,U10458,9,-3109.1,6,3,3545.48,436.3800000000001
36452,U21013,9,-7999.659999999998,5,4,41975.2,33975.54
36453,U23464,9,38941.39,5,4,10537.4,49478.79
36454,U22275,9,13622.060000000001,6,3,2200.2,15822.260000000002
36455,U18612,9,-198377.38,6,3,202475.0,4097.619999999995
36456,U36881,9,2000.41,4,5,4200.0,6200.41
36457,U38005,9,-3051.1699999999996,4,5,3077.34,26.170000000000528
36458,U26338,9,-3298.99,4,5,9200.0,5901.01
36459,U24474,9,16896.289999999994,4,5,16891.8,33788.09
36460,U40228,9,6024.91,5,4,172.7,6197.61
36461,U854218,9,-1.0800000000000018,5,4,61.099999999999994,60.019999999999996
36462,U33535,9,-1288.1,7,2,1702.5,414.4000000000001
36463,U35062,9,-253.62,4,5,372.76,119.13999999999999
36464,U32615,9,837.8900000000002,6,3,996.37,1834.2600000000002
36465,U21371,9,-1.0,6,3,1.27,0.27
36466,U41388,9,0.4099999999998545,4,5,15734.0,15734.41
36467,U710776,9,1001.97,6,3,28.98,1030.95
36468,U20208,9,1.7600000000002183,4,5,16612.0,16613.760000000002
36469,U43515,9,-24.459999999999127,3,6,25930.0,25905.54
36470,U32480,9,4172.31,6,3,5694.06,9866.37
36471,U36970,9,5920.41,4,5,6423.23,12343.64
36472,U37476,9,-1673.33,5,4,1892.24,218.91000000000008
36473,U40607,9,0.040000000000873115,5,4,37693.0,37693.04
36474,U32134,9,503.19000000000005,4,5,1484.0,1987.19
36475,U10780,9,-3546.5499999999993,6,3,14146.6,10600.050000000001
36476,U704036,9,-53.70000000000001,6,3,462.21999999999997,408.52
36477,U39926,9,-218.83000000000004,5,4,42435.399999999994,42216.56999999999
36478,U17906,9,-19337.4,6,3,70355.0,51017.6
36479,U26073,9,-2203.34,5,4,6940.0,4736.66
36480,U19349,9,193.5600000000013,3,6,70000.0,70193.56
36481,U24496,9,13.980000000000004,5,4,215.2,229.18
36482,U35167,9,91087.02,4,5,9083.34,100170.36
36483,U34060,9,505580.35000000003,3,6,174.0,505754.35000000003
36484,U37431,9,9485.509999999998,0,9,0.0,9485.509999999998
36485,U30265,9,-363.14000000000055,5,4,3954.5600000000004,3591.42
36486,U666110,9,310.0,5,4,3875.0,4185.0
36487,U1238602,9,-2277.1000000000004,8,1,2310.1000000000004,33.0
36488,U874031,9,-7.820000000000391,5,4,5373.0,5365.179999999999
36489,U1056734,9,6.939999999999998,5,4,159.81,166.75
36490,U10479,9,-4475.860000000001,6,3,16178.74,11702.88
36491,U28074,9,-22749.62,4,5,32881.0,10131.380000000001
36492,U39978,9,-7464.65,3,6,9300.0,1835.3500000000004
36493,U664241,9,5896.339999999999,6,3,1753.66,7649.999999999999
36494,U16061,9,44.35999999999999,5,4,2312.87,2357.23
36495,U19151,9,-2004.92,5,4,32006.0,30001.08
36496,U1357249,9,-193.42000000000002,8,1,193.52,0.09999999999999432
36497,U28846,9,-3.8200000000000376,6,3,472.74000000000007,468.92
36498,U24128,9,-1996.29,4,5,4000.0,2003.71
36499,U25849,9,-584.1699999999995,2,7,10000.0,9415.83
36500,U1112445,9,-2.2737367544323206e-13,6,3,2410.01,2410.01
36501,U38734,9,-532.0800000000002,5,4,1031.0,498.91999999999985
36502,U43206,9,51.970000000000255,4,5,10605.9,10657.869999999999
36503,U1062636,9,-0.36999999999998634,5,4,284.82000000000005,284.45000000000005
36504,U1292665,9,43.519999999999996,5,4,156.52,200.04000000000002
36505,U37141,9,-633.9999999999989,5,4,30506.0,29872.0
36506,U36245,9,29967.949999999997,3,6,6535.86,36503.81
36507,U26067,9,7269.070000000001,3,6,7269.58,14538.650000000001
36508,U33724,9,-2641.51,5,4,14506.0,11864.49
36509,U21953,9,-56.45,6,3,381.45,325.0
36510,U28258,9,13154.200000000004,5,4,9000.02,22154.220000000005
36511,U12788,9,-17.279999999999973,3,6,2351.1,2333.8199999999997
36512,U1081062,9,-2577.3500000000004,9,0,2577.3500000000004,0.0
36513,U10206,9,0.05999999999994543,6,3,669.0,669.06
36514,U1355267,9,322.0099999999996,4,5,4574.22,4896.23
36515,U13880,9,2769.159999999996,3,6,67876.0,70645.16
36516,U28967,9,3276.51,4,5,2910.98,6187.49
36517,U29716,9,457.9599999999991,4,5,14000.0,14457.96
36518,U26377,9,7061.889999999999,3,6,401.67,7463.5599999999995
36519,U19505,9,-17379.0,8,1,22379.0,5000.0
36520,U16198,9,2639.7799999999997,4,5,7375.0,10014.779999999999
36521,U14165,9,499122.63,2,7,1000.0,500122.63
36522,U22757,9,-181.09,8,1,182.8,1.710000000000008
36523,U19016,8,-422.80999999999995,5,3,823.2,400.3900000000001
36524,U20774,8,59.95000000000004,3,5,2051.76,2111.71
36525,U25189,8,-266.41999999999996,5,3,386.84,120.42000000000002
36526,U33027,8,-335.49,7,1,342.27,6.779999999999973
36527,U669926,8,30.53,5,3,36.0,66.53
36528,U39882,8,-851.4000000000001,6,2,1963.6399999999999,1112.2399999999998
36529,U21416,8,6.059999999999945,4,4,1992.9,1998.96
36530,U37000,8,-565.54,4,4,2149.82,1584.2800000000002
36531,U834319,8,5537.72,2,6,5338.58,10876.3
36532,U13741,8,-1031533.0200000001,3,5,1055385.3,23852.27999999991
36533,U35882,8,425.8399999999997,6,2,3310.38,3736.22
36534,U35872,8,4711.32,5,3,602.06,5313.379999999999
36535,U36209,8,2009.1499999999999,4,4,92.8,2101.95
36536,U21723,8,4772.790000000019,2,6,231700.0,236472.79
36537,U20925,8,6055.91,4,4,2355.6,8411.51
36538,U1095493,8,-574.7199999999999,8,0,574.7199999999999,0.0
36539,U35097,8,-145.63999999999908,4,4,11919.0,11773.36
36540,U31217,8,-1655.55,3,5,2310.0,654.45
36541,U988968,8,217.20999999999998,2,6,8.129999999999999,225.33999999999997
36542,U14641,8,-606.4900000000001,4,4,1212.2,605.7099999999999
36543,U672637,8,544.0,3,5,2206.0,2750.0
36544,U25595,8,2008.27,2,6,697.0,2705.27
36545,U1198930,8,361.69,4,4,126.0,487.69
36546,U30118,8,18002.870000000003,3,5,22471.66,40474.53
36547,U25403,8,9.569999999999935,5,3,1766.46,1776.03
36548,U29834,8,47775.86,0,8,0.0,47775.86
36549,U9764,8,0.01999999999998181,4,4,4400.0,4400.02
36550,U25386,8,9.094947017729282e-13,2,6,12883.29,12883.29
36551,U984597,8,-30.36,5,3,80.38,50.019999999999996
36552,U24270,8,41.220000000001164,4,4,109555.2,109596.42
36553,U1317694,8,77.0,4,4,1176.98,1253.98
36554,U22008,8,127278.84,0,8,0.0,127278.84
36555,U1221519,8,-454.83000000000004,6,2,554.84,100.00999999999999
36556,U1200660,8,-6818.42,8,0,6818.42,0.0
36557,U21517,8,51037.83,4,4,13731.42,64769.25
36558,U35291,8,571.6100000000001,4,4,6528.759999999999,7100.369999999999
36559,U39406,8,-804.21,6,2,1890.1,1085.8899999999999
36560,U27999,8,13407.3,0,8,0.0,13407.3
36561,U18689,8,-2110.0699999999997,6,2,2191.49,81.42000000000007
36562,U37943,8,3193.3200000000006,4,4,15711.38,18904.7
36563,U8210,8,594.0500000000002,3,5,4706.0,5300.05
36564,U34867,8,-27856.04,4,4,33200.0,5343.959999999999
36565,U28056,8,64.30000000000001,5,3,818.65,882.95
36566,U948233,8,-56.36000000000013,6,2,1956.7700000000002,1900.41
36567,U41616,8,-3307.0,6,2,13371.0,10064.0
36568,U15066,8,-17139.11,5,3,30026.0,12886.89
36569,U43565,8,437.0,5,3,4698.0,5135.0
36570,U9387,8,335.87999999999965,6,2,5206.12,5542.0
36571,U14092,8,-29846.92,5,3,30859.8,1012.880000000001
36572,U27742,8,-923.74,7,1,924.0,0.2599999999999909
36573,U21751,8,211.22000000000003,6,2,238.24,449.46000000000004
36574,U43851,8,776.74,4,4,3327.7999999999997,4104.54
36575,U21648,8,-17157.93,5,3,34318.29,17160.36
36576,U10269,8,4269.460000000001,1,7,5000.0,9269.460000000001
36577,U23471,8,8641.830000000002,3,5,46509.22,55151.05
36578,U9538,8,2242.7699999999895,2,6,151205.82,153448.59
36579,U38576,8,-265151.61,5,3,371107.31,105955.70000000001
36580,U849140,8,-508.14,8,0,508.14,0.0
36581,U704788,8,4.980000000000024,4,4,205.89999999999998,210.88
36582,U16552,8,-32.58,4,4,77.34,44.760000000000005
36583,U13196,8,179.06000000000003,3,5,333.47,512.5300000000001
36584,U29430,8,-8053.889999999999,4,4,33058.270000000004,25004.380000000005
36585,U35850,8,13.009999999999991,5,3,926.0,939.01
36586,U29255,8,322.05999999999995,3,5,1995.59,2317.6499999999996
36587,U29166,8,-179576.06,2,6,300005.0,120428.94
36588,U38487,8,-1946.17,4,4,3097.9,1151.73
36589,U1150177,8,-3361.7300000000005,8,0,3361.7300000000005,0.0
36590,U963344,8,0.47000000000025466,4,4,10508.96,10509.43
36591,U41741,8,-9437.68,5,3,11037.7,1600.0200000000004
36592,U43022,8,4563.9,4,4,5196.0,9759.9
36593,U35652,8,257.78999999999996,2,6,132.6,390.39
36594,U30903,8,28290.0,6,2,69510.0,97800.0
36595,U926437,8,3.100000000000003,5,3,80.00999999999999,83.11
36596,U8445,8,15134.98,1,7,13500.0,28634.98
36597,U24773,8,-1.5900000000000047,7,1,94.59,93.0
36598,U25620,8,13840.619999999999,3,5,2979.9700000000003,16820.59
36599,U673206,8,1200.0,3,5,592.75,1792.75
36600,U26810,8,-19538.22,4,4,35178.0,15639.779999999999
36601,U1289779,8,-389.64,8,0,389.64,0.0
36602,U13425,8,33753.61,5,3,56893.0,90646.61
36603,U15283,8,-28949.850000000002,4,4,130006.0,101056.15
36604,U18125,8,-102351.08,4,4,102600.0,248.91999999999825
36605,U24986,8,0.25,4,4,1535.78,1536.03
36606,U23932,8,-801.010000000002,5,3,56530.6,55729.59
36607,U30472,8,11870.0,5,3,22130.0,34000.0
36608,U35501,8,-1468.3599999999942,3,5,143286.46,141818.1
36609,U23315,8,5869.800000000003,2,6,160000.0,165869.8
36610,U1042309,8,-362.40999999999997,6,2,549.7099999999999,187.29999999999995
36611,U15429,8,3623.74,3,5,8423.0,12046.74
36612,U41221,8,2477.1799999999985,2,6,42760.0,45237.18
36613,U28912,8,-44.67000000000007,6,2,15450.130000000001,15405.460000000001
36614,U25903,8,167.34,5,3,278.32,445.65999999999997
36615,U9365,8,-5681.2,5,3,8711.0,3029.8
36616,U960547,8,-223.68999999999997,7,1,2164.69,1941.0
36617,U25735,8,5764.2699999999995,4,4,1472.0,7236.2699999999995
36618,U40694,8,-289.17,5,3,953.02,663.8499999999999
36619,U12513,8,-98.95999999999913,3,5,54000.0,53901.04
36620,U27885,8,2841.8,4,4,4331.8,7173.6
36621,U8786,8,922.1199999999999,3,5,7958.26,8880.380000000001
36622,U40513,8,-398.53999999999996,4,4,800.0,401.46000000000004
36623,U31176,8,-234.46000000000095,2,6,30000.0,29765.54
36624,U1350270,8,-2197.28,7,1,2197.2900000000004,0.010000000000218279
36625,U40735,8,-646.27,7,1,647.3,1.0299999999999727
36626,U1249199,8,-3129.56,8,0,3129.56,0.0
36627,U12829,8,-1067.44,5,3,1152.13,84.69000000000005
36628,U40563,8,1398.6399999999994,5,3,10501.0,11899.64
36629,U31312,8,-7253.96,6,2,8154.01,900.0500000000002
36630,U43422,8,-9400.079999999944,5,3,709876.89,700476.81
36631,U44014,8,-595.3499999999985,3,5,60000.0,59404.65
36632,U23798,8,302.3,4,4,280.5,582.8
36633,U21550,8,32222.87,2,6,28980.0,61202.869999999995
36634,U15781,8,5.640000000005529,3,5,80010.00000000001,80015.64000000001
36635,U19811,8,-46745.42000000001,6,2,146800.0,100054.57999999999
36636,U21279,8,358.6399999999998,3,5,5312.92,5671.5599999999995
36637,U23810,8,-100.10000000000001,6,2,238.1,138.0
36638,U9562,8,3587.5099999999975,3,5,151900.0,155487.51
36639,U42113,8,791.4099999999999,2,6,5903.52,6694.93
36640,U34476,8,-29748.420000000002,3,5,30035.0,286.5799999999981
36641,U43161,8,1300.47,3,5,16700.0,18000.47
36642,U35448,8,-24.77000000000291,4,4,60036.0,60011.229999999996
36643,U33598,8,20060.879999999997,2,6,20091.58,40152.46
36644,U29192,8,726.36,4,4,493.03999999999996,1219.4
36645,U21072,8,30050.0,4,4,83150.0,113200.0
36646,U1305256,8,-0.27000000000003754,4,4,1056.49,1056.22
36647,U671443,8,-1050.8600000000001,8,0,1050.8600000000001,0.0
36648,U19107,8,7465.510000000001,1,7,0.01,7465.520000000001
36649,U12863,8,142.03999999999996,3,5,490.0,632.04
36650,U31983,8,1995.7799999999997,6,2,6005.0,8000.78
36651,U20052,8,57031.33,3,5,161382.37,218413.7
36652,U33663,8,24326.260000000002,3,5,13532.0,37858.26
36653,U692902,8,-1.9499999999999886,4,4,532.0,530.05
36654,U40690,8,-1842.4699999999991,4,4,9885.630000000001,8043.160000000002
36655,U1156253,8,97.67,5,3,125.47,223.14
36656,U1374348,8,-0.09999999999990905,3,5,2476.59,2476.4900000000002
36657,U971392,8,0.0,4,4,2437.14,2437.14
36658,U43684,8,94272.8,6,2,7737.0,102009.8
36659,U43954,8,-1.4800000000000182,4,4,1517.43,1515.95
36660,U35743,8,3000.09,2,6,3100.0,6100.09
36661,U1254314,8,-856.8199999999999,6,2,877.04,20.220000000000027
36662,U982295,8,19073.829999999998,2,6,19050.0,38123.83
36663,U816841,8,-539.0,8,0,539.0,0.0
36664,U10043,8,-42253.880000000005,4,4,48248.0,5994.119999999995
36665,U14403,8,80065.32,2,6,40000.0,120065.32
36666,U1215051,8,-2408.8199999999997,8,0,2408.8199999999997,0.0
36667,U40605,8,-898.45,6,2,1189.58,291.1299999999999
36668,U1292618,8,46.050000000000004,5,3,60.129999999999995,106.18
36669,U28509,8,4037.87,3,5,263.25,4301.12
36670,U10237,8,-841.29,6,2,1653.0900000000001,811.8000000000002
36671,U633131,8,0.5,4,4,401.5,402.0
36672,U27590,8,-41476.59999999999,3,5,56928.86,15452.26000000001
36673,U12791,8,0.08000000000174623,3,5,250000.0,250000.08000000002
36674,U31158,8,9672.07,6,2,332.0,10004.07
36675,U24821,8,-78466.57,5,3,79967.9,1501.3299999999872
36676,U19139,8,-31541.889999999992,5,3,42999.0,11457.110000000008
36677,U35566,8,-206.26999999999862,4,4,21020.0,20813.730000000003
36678,U42869,8,102.96000000000001,3,5,50141.2,50244.159999999996
36679,U15083,8,74.25000000000013,4,4,2867.2599999999998,2941.5099999999998
36680,U43407,8,3322.16,3,5,10100.0,13422.16
36681,U30347,8,0.13999999999941792,3,5,49500.0,49500.14
36682,U37903,8,54.580000000000254,5,3,9956.89,10011.47
36683,U1161026,8,-2541.27,7,1,2542.0299999999997,0.7599999999997635
36684,U903927,8,-934.09,5,3,1334.0900000000001,400.0000000000001
36685,U35114,8,-6436.169999999999,4,4,16445.309999999998,10009.14
36686,U35547,8,-1228.77,7,1,3464.98,2236.21
36687,U9480,8,1932.0,3,5,4056.1200000000003,5988.120000000001
36688,U1084849,8,-179.88,8,0,179.88,0.0
36689,U41579,8,-5422.38,5,3,5427.0,4.619999999999891
36690,U40161,8,-2640.8199999999997,2,6,10630.0,7989.18
36691,U24771,8,1270.050000000003,3,5,80040.86,81310.91
36692,U32419,8,-13150.230000000003,5,3,60625.65,47475.42
36693,U700781,8,-289.49,4,4,389.51,100.01999999999998
36694,U10421,8,2727.2799999999697,5,3,370714.82,373442.1
36695,U32041,8,956.6699999999983,2,6,28200.0,29156.67
36696,U30464,8,-10342.26,5,3,17465.28,7123.019999999999
36697,U31876,8,8264.0,5,3,18244.46,26508.46
36698,U37641,8,6399.999999999999,4,4,914.98,7314.98
36699,U21789,8,-2749.3800000000015,5,3,22253.4,19504.02
36700,U39123,8,-159.98,5,3,170.0,10.02000000000001
36701,U38082,8,-107.76,6,2,208.0,100.24
36702,U18925,8,88270.4,1,7,939.6,89210.0
36703,U43226,8,1976.7400000000002,5,3,3224.45,5201.1900000000005
36704,U28961,8,6001.5599999999995,2,6,3960.82,9962.38
36705,U23721,8,3692.9199999999983,2,6,35120.0,38812.92
36706,U31190,8,0.13999999999941792,3,5,16500.0,16500.14
36707,U903785,8,172.0,4,4,1828.0,2000.0
36708,U12961,8,-9417.29,5,3,9439.94,22.649999999999636
36709,U1091024,8,-3517.52,8,0,3517.52,0.0
36710,U23141,8,279.32000000000016,5,3,1382.82,1662.14
36711,U17757,8,5555.59,5,3,930.0,6485.59
36712,U1085749,8,2460.4,5,3,2039.6,4500.0
36713,U798291,8,-551.36,7,1,551.37,0.009999999999990905
36714,U29580,8,-4788.469999999999,3,5,15500.0,10711.53
36715,U955444,8,1.0,4,4,440.09,441.09
36716,U35835,8,45.23999999999069,4,4,204220.0,204265.24
36717,U19553,8,2076.7,6,2,867.28,2943.9799999999996
36718,U17053,8,-298.23,3,5,1023.7,725.47
36719,U25101,8,2942.54,5,3,3010.0,5952.54
36720,U15057,8,2001.81,3,5,4400.0,6401.8099999999995
36721,U1220213,8,3196.1499999999996,6,2,1407.28,4603.429999999999
36722,U10463,8,6313.79,3,5,2482.0,8795.79
36723,U37606,8,2985.38,4,4,8015.13,11000.51
36724,U34486,8,376.1899999999996,4,4,8870.1,9246.29
36725,U20630,8,-3086.230000000001,4,4,19390.0,16303.769999999999
36726,U30181,8,444.71000000000004,4,4,233.4,678.11
36727,U9511,8,100.24999999999991,4,4,4375.03,4475.28
36728,U19567,8,-878.3599999999988,3,5,17184.379999999997,16306.019999999999
36729,U34061,8,-514.3800000000006,4,4,9900.0,9385.619999999999
36730,U40417,8,-88.20999999999738,5,3,50026.0,49937.79
36731,U38181,8,1.0100000000000284,4,4,957.09,958.1
36732,U28215,8,-25.509999999999764,5,3,6616.0,6590.49
36733,U33784,8,907.63,6,2,592.85,1500.48
36734,U33743,8,33.43,3,5,15020.0,15053.43
36735,U964839,8,208.42999999999998,3,5,1072.0,1280.43
36736,U42493,8,33.02,5,3,3602.0,3635.02
36737,U614720,8,-7111.7,6,2,7351.700000000001,240.0000000000009
36738,U22760,8,-181.01999999999998,4,4,2181.05,2000.0300000000002
36739,U21725,8,1495.4000000000015,4,4,23406.0,24901.4
36740,U29006,8,200.54000000000235,3,5,97100.0,97300.54000000001
36741,U1087923,8,83.78999999999995,7,1,568.89,652.68
36742,U41083,8,-2752.1100000000006,4,4,13110.0,10357.89
36743,U37459,8,19590.12,3,5,4670.45,24260.57
36744,U43522,8,898.57,3,5,1794.3400000000001,2692.9100000000003
36745,U22090,8,-6211.329999999999,4,4,11412.46,5201.13
36746,U35996,8,-158.04999999999885,3,5,10456.78,10298.730000000001
36747,U21813,8,17056.66,4,4,10607.96,27664.62
36748,U666457,8,59.89000000000004,5,3,150.13,210.02000000000004
36749,U35964,8,-29962.059999999998,2,6,250000.0,220037.94
36750,U19531,8,-48.0,6,2,198.0,150.0
36751,U25561,8,1736.73,5,3,3479.13,5215.860000000001
36752,U8376,8,2660.7000000000003,3,5,1420.0,4080.7000000000003
36753,U18481,8,-231.87,4,4,400.0,168.13
36754,U35436,8,-125.18,3,5,503.0,377.82
36755,U42989,8,8478.14,2,6,2407.48,10885.619999999999
36756,U15742,8,-196.02999999999997,4,4,394.6,198.57000000000005
36757,U1237819,8,-1.0199999999999818,6,2,664.02,663.0
36758,U23278,8,-126485.93999999999,4,4,143000.0,16514.060000000012
36759,U17084,8,-15528.039999999999,3,5,21267.8,5739.76
36760,U10518,8,414.0000000000026,2,6,90000.0,90414.0
36761,U10819,8,-295.66999999999996,4,4,615.4000000000001,319.73000000000013
36762,U32505,8,-71.97999999999979,3,5,3303.68,3231.7
36763,U21770,8,907.2600000000002,3,5,11000.0,11907.26
36764,U1215841,8,999.72,4,4,1414.2799999999997,2414.0
36765,U40613,8,-21468.57,4,4,24473.440000000002,3004.8700000000026
36766,U18646,8,-52708.37,6,2,62686.83,9978.46
36767,U39791,8,-43.98999999999978,4,4,11900.0,11856.01
36768,U985734,8,-5.684341886080802e-14,6,2,2205.0,2205.0
36769,U40335,8,-888.2400000000005,5,3,5439.22,4550.98
36770,U35410,8,1190.5100000000002,4,4,9000.0,10190.51
36771,U39587,8,-68.99000000000001,5,3,92.9,23.909999999999997
36772,U18703,8,927.8500000000004,5,3,10220.0,11147.85
36773,U35845,8,-32155.309999999998,5,3,38614.6,6459.290000000001
36774,U37278,8,-185.93000000000006,6,2,686.8,500.8699999999999
36775,U10670,8,-288.95000000000005,5,3,3289.5,3000.55
36776,U41049,8,1677.14,0,8,0.0,1677.14
36777,U33329,8,-485.98,6,2,696.1,210.12
36778,U18841,8,-30115.639999999996,3,5,82170.21,52054.57000000001
36779,U36312,8,0.9499999999993634,3,5,6073.0,6073.949999999999
36780,U11854,8,2754.83,3,5,5485.91,8240.74
36781,U39963,8,9946.62,4,4,395.0,10341.62
36782,U18108,8,-1430.95,6,2,2231.76,800.8100000000002
36783,U18721,8,-100677.67,6,2,101000.0,322.33000000000175
36784,U737573,8,1299.42,4,4,700.5799999999999,2000.0
36785,U27732,8,-16492.44,5,3,17321.79,829.3500000000022
36786,U12494,8,-1959.3500000000004,3,5,9265.96,7306.609999999999
36787,U28795,8,227717.95999999996,1,7,65.0,227782.95999999996
36788,U32682,8,3086.96,4,4,6400.82,9487.779999999999
36789,U13988,8,-19459.75,5,3,1969548.04,1950088.29
36790,U26549,8,2227.91,5,3,11.84,2239.75
36791,U30126,8,-2727.38,8,0,2727.38,0.0
36792,U37706,8,4205.43,6,2,1800.0,6005.43
36793,U25364,8,-84.55000000000005,4,4,975.61,891.06
36794,U29877,8,10765.07,5,3,20035.0,30800.07
36795,U17256,8,-469.88,5,3,985.74,515.86
36796,U1369160,8,65.10000000000001,4,4,19.84,84.94000000000001
36797,U1032475,8,-858.02,6,2,950.04,92.01999999999998
36798,U9952,8,-61077.22,5,3,78980.0,17902.78
36799,U38218,8,1940.28,4,4,5009.8,6950.08
36800,U42946,8,10350.66,3,5,1283.92,11634.58
36801,U16409,8,-5.689999999999998,4,4,205.7,200.01
36802,U985119,8,271.18000000000006,7,1,228.82000000000002,500.0000000000001
36803,U35959,8,930.000000000001,2,6,7812.96,8742.960000000001
36804,U42604,8,-143.87000000000012,3,5,4044.25,3900.38
36805,U33348,8,-669.54,5,3,3464.0,2794.46
36806,U36945,8,8352.0,4,4,6650.0,15002.0
36807,U42872,8,-54374.48,6,2,54802.0,427.5199999999968
36808,U969629,8,-10299.999999999998,3,5,60000.259999999995,49700.259999999995
36809,U12837,8,-1160620.45,6,2,1160800.0,179.55000000004657
36810,U13474,8,-152.79000000000002,4,4,315.07000000000005,162.28000000000003
36811,U936031,8,49720.42,6,2,1547.56,51267.979999999996
36812,U17758,8,-11603.89,6,2,11613.01,9.1200000000008
36813,U1108827,8,1355.35,5,3,529.65,1885.0
36814,U34397,8,-625.8199999999997,5,3,8201.33,7575.51
36815,U17819,8,3265.62,4,4,2109.24,5374.86
36816,U38123,8,469.1200000000002,5,3,3515.75,3984.8700000000003
36817,U15102,8,680.9300000000001,5,3,1120.8,1801.73
36818,U22749,8,18865.0,3,5,18866.6,37731.6
36819,U31080,8,0.05999999999994543,4,4,7190.0,7190.0599999999995
36820,U9471,8,169.89,3,5,1091.1100000000001,1261.0
36821,U39790,8,-6855.070000000005,4,4,148195.01,141339.94
36822,U37789,8,-7001.99,6,2,7169.0,167.01000000000022
36823,U20317,8,-41.430000000000035,4,4,5648.97,5607.54
36824,U25850,8,103.18000000000146,5,3,17087.6,17190.78
36825,U914367,8,0.9900000000000002,4,4,2.99,3.9800000000000004
36826,U24443,8,267.03,1,7,730.0,997.03
36827,U18184,8,16273.41,5,3,23963.37,40236.78
36828,U24007,8,-92.41,5,3,218.0,125.59
36829,U33121,8,1629.53,4,4,3320.0,4949.53
36830,U40182,8,4044.58,2,6,1540.8999999999999,5585.48
36831,U18093,8,-10338.270000000006,5,3,210549.2,200210.93
36832,U26907,8,-102532.04999999999,5,3,102661.18,129.13000000000466
36833,U38584,8,-16005.730000000001,4,4,22645.67,6639.939999999997
36834,U14011,8,-1081.21,5,3,1487.7,406.49
36835,U1205731,8,44.450000000000045,4,4,3506.0,3550.45
36836,U25812,8,-533.4200000000001,3,5,8068.74,7535.32
36837,U27299,8,7166.389999999999,4,4,57035.0,64201.39
36838,U25329,8,-1868.1,8,0,1868.1,0.0
36839,U10302,8,191.94999999999854,4,4,10160.21,10352.159999999998
36840,U34981,8,194.05000000000018,4,4,4831.0,5025.05
36841,U40527,8,0.0,4,4,9551.01,9551.01
36842,U35174,8,-121.38,5,3,2167.49,2046.1099999999997
36843,U35000,8,-14403.51,5,3,15206.7,803.1900000000005
36844,U1096339,8,228.3499999999999,7,1,1891.65,2120.0
36845,U41984,8,3.8400000000001455,1,7,13372.0,13375.84
36846,U1220254,8,1.000000000000041,5,3,1029.17,1030.17
36847,U822895,8,1.79999999999999,4,4,101.99999999999999,103.79999999999998
36848,U34470,8,-20.72999999999978,3,5,7260.0,7239.27
36849,U1345421,8,-9.999999999999995,6,2,160.05,150.05
36850,U19407,8,29622.260000000002,1,7,25751.0,55373.26
36851,U40405,8,6806.94,3,5,2229.3,9036.24
36852,U21405,8,-626.0400000000792,3,5,567955.18,567329.14
36853,U13165,8,-1544.2499999999998,5,3,4633.23,3088.9799999999996
36854,U28382,8,54062.60999999999,2,6,40000.0,94062.60999999999
36855,U37667,8,-3500.0999999999985,5,3,21506.0,18005.9
36856,U36075,8,-0.6399999999994179,5,3,16724.0,16723.36
36857,U21116,8,97820.01,1,7,1338.3,99158.31
36858,U32999,8,-100.17000000000003,5,3,251.57,151.39999999999998
36859,U905265,8,8030.0,6,2,6110.0,14140.0
36860,U30065,8,-25598.79,5,3,31600.0,6001.209999999999
36861,U23225,8,-616.7399999999998,5,3,3258.7599999999998,2642.02
36862,U9208,8,-1616.04,5,3,7662.0,6045.96
36863,U1341228,8,740.0,2,6,10.0,750.0
36864,U1052162,8,104.43000000000002,4,4,449.56,553.99
36865,U947540,8,423.0400000000001,3,5,630.04,1053.08
36866,U27994,8,2089.8399999999892,3,5,215000.0,217089.84
36867,U17919,8,2.700000000000836,3,5,9212.42,9215.12
36868,U18550,8,2959.2299999999996,5,3,6200.0,9159.23
36869,U8380,8,170.0,4,4,3600.0,3770.0
36870,U40190,8,247654.4,2,6,1100.0,248754.4
36871,U26889,8,101923.17,5,3,204.0,102127.17
36872,U17624,8,5.779999999999973,3,5,3100.0,3105.7799999999997
36873,U39209,8,713.48,4,4,251.96,965.44
36874,U37464,8,64775.689999999995,2,6,8577.79,73353.48
36875,U36662,8,-814.4700000000012,3,5,8255.0,7440.529999999999
36876,U1083576,8,-177.40000000000003,4,4,312.40000000000003,135.0
36877,U666588,8,-53.19,7,1,53.2,0.010000000000005116
36878,U21353,8,-30005.58,5,3,80006.0,50000.42
36879,U19640,8,49982.49999999999,3,5,1962.66,51945.159999999996
36880,U1234636,8,-146.57999999999998,6,2,153.54,6.960000000000008
36881,U25347,8,-1257.56,2,6,1333.2,75.6400000000001
36882,U29905,8,-13042.71,6,2,23042.81,10000.100000000002
36883,U20728,8,1494.99,2,6,56.0,1550.99
36884,U21829,8,17.279999999999994,4,4,118.0,135.28
36885,U24708,8,50058.6,4,4,59995.0,110053.6
36886,U25724,8,39.62000000000016,2,6,4967.04,5006.66
36887,U39064,8,83027.87000000001,0,8,0.0,83027.87000000001
36888,U41021,8,74.20000000000027,4,4,11503.0,11577.2
36889,U10779,8,12610.92,3,5,5325.34,17936.260000000002
36890,U755700,8,-1957.3899999999999,4,4,2089.4900000000002,132.10000000000036
36891,U33333,8,30005.719999999994,3,5,60500.0,90505.72
36892,U1110311,8,0.0,5,3,2237.0,2237.0
36893,U1204526,8,6491.43,2,6,6450.0,12941.43
36894,U29411,8,17029.559999999998,2,6,4600.0,21629.559999999998
36895,U10058,8,1.5899999999965075,5,3,380000.0,380001.58999999997
36896,U42399,8,10045.700000000186,4,4,2909324.92,2919370.62
36897,U634696,8,1.7199999999999847,4,4,257.79,259.51
36898,U19150,8,6503.679999999999,2,6,6615.56,13119.24
36899,U38354,8,-546.36,5,3,697.92,151.55999999999995
36900,U23960,8,-25770.97,1,7,100000.0,74229.03
36901,U19103,8,-6218.0,6,2,7538.0,1320.0
36902,U25187,8,-1284.0,6,2,2957.0,1673.0
36903,U15470,8,29.10999999998512,4,4,306943.76,306972.87
36904,U918190,8,-370.72,8,0,370.72,0.0
36905,U1168676,8,-12.11,6,2,112.15,100.04
36906,U13470,8,-1287.8199999999997,6,2,48021.85,46734.03
36907,U42036,8,-55.57,5,3,113.6,58.029999999999994
36908,U18997,8,-2.469999999999345,4,4,10602.71,10600.24
36909,U1344821,8,0.9400000000005093,4,4,10353.0,10353.94
36910,U39273,8,-41528.119999999995,5,3,58584.0,17055.880000000005
36911,U22483,8,-156.17000000000007,5,3,17705.0,17548.83
36912,U17640,8,940.4000000000001,4,4,8193.18,9133.58
36913,U8414,8,26.279999999998253,4,4,30100.0,30126.28
36914,U1128422,8,-8050.07,8,0,8050.07,0.0
36915,U1198853,8,595.6599999999997,6,2,3411.74,4007.3999999999996
36916,U20825,8,-69742.54999999999,3,5,600188.0,530445.45
36917,U1148378,8,113.95999999999992,6,2,698.34,812.3
36918,U34156,8,-1483.67,6,2,1998.6499999999999,514.9799999999998
36919,U23380,8,-244.64000000000001,5,3,1245.23,1000.59
36920,U18251,8,-6230.219999999999,5,3,14748.89,8518.67
36921,U26939,8,12968.17,0,8,0.0,12968.17
36922,U934520,8,89.51999999999998,5,3,900.0,989.52
36923,U19732,8,-54.250000000000725,4,4,20100.95,20046.7
36924,U34846,8,-8744.949999999999,3,5,18390.0,9645.050000000001
36925,U20140,8,4198.7300000000005,5,3,6184.8099999999995,10383.54
36926,U28058,8,2998.9300000000003,2,6,8000.0,10998.93
36927,U16460,8,-130.01999999999998,4,4,164.8,34.78000000000003
36928,U1108983,8,-2.9400000000000546,5,3,2541.94,2539.0
36929,U25224,8,-18.980000000000008,7,1,19.040000000000006,0.05999999999999872
36930,U35746,8,27931.38,1,7,9617.21,37548.59
36931,U1219486,8,-1032.8599999999997,5,3,2883.5299999999997,1850.67
36932,U16070,8,29934.079999999998,4,4,174.36,30108.44
36933,U17190,8,-50274.75,3,5,51340.19,1065.4400000000023
36934,U1022017,8,-105.71,8,0,105.71,0.0
36935,U21507,8,2815.5,5,3,10226.55,13042.05
36936,U41076,8,16120.98,4,4,10660.6,26781.58
36937,U42175,8,464.90000000000003,4,4,676.44,1141.3400000000001
36938,U30776,8,-68948.04000000001,6,2,79936.70000000001,10988.660000000003
36939,U29258,8,33174.14,5,3,23230.32,56404.46
36940,U14786,8,3887.0699999999993,5,3,6983.35,10870.42
36941,U20197,8,3371.48,4,4,1532.4299999999998,4903.91
36942,U13759,8,132999.34000000003,2,6,718.0,133717.34000000003
36943,U39485,8,129592.06999999996,3,5,228040.0,357632.06999999995
36944,U23248,8,1273.86,5,3,894.3,2168.16
36945,U32964,8,6230.48,2,6,10675.0,16905.48
36946,U26295,8,-9899.75,4,4,29960.0,20060.25
36947,U33510,8,2667.879999999986,5,3,932597.15,935265.03
36948,U10845,8,-11850.0,4,4,27850.0,16000.0
36949,U32298,8,-151.02000000000135,4,4,13955.260000000002,13804.240000000002
36950,U1072870,8,970.0,6,2,140.0,1110.0
36951,U37755,8,-5.559999999997672,4,4,52396.0,52390.44
36952,U36973,8,-293.57000000000005,4,4,1470.0,1176.4299999999998
36953,U1102563,8,-639.4200000000001,8,0,639.4200000000001,0.0
36954,U29876,8,-558.72,5,3,1212.74,654.02
36955,U20275,8,8549.710000000003,2,6,70865.6,79415.31000000001
36956,U42500,8,-591.1000000000004,6,2,48594.0,48002.9
36957,U1279266,8,0.0,4,4,612.0,612.0
36958,U28406,8,3787.59,3,5,8137.9,11925.49
36959,U21239,8,-6526.71,6,2,11077.4,4550.69
36960,U32982,8,0.06000000000130967,4,4,13885.3,13885.36
36961,U43054,8,-13788.68,5,3,19800.0,6011.32
36962,U1339908,8,122.53999999999996,6,2,4327.46,4450.0
36963,U742739,8,-312.2600000000001,6,2,1199.93,887.67
36964,U29743,8,-78.94000000000233,5,3,28656.0,28577.059999999998
36965,U1134390,8,-400.88000000000005,5,3,1413.48,1012.5999999999999
36966,U1025913,8,-119.22999999999998,5,3,473.0,353.77000000000004
36967,U13206,8,-21.080000000000013,5,3,309.2,288.12
36968,U24021,8,10477.919999999998,4,4,59482.729999999996,69960.65
36969,U1366870,8,3773.19,6,2,1044.04,4817.23
36970,U23665,8,-35004.259999999995,5,3,35007.28,3.0200000000040745
36971,U797414,8,-311.31,6,2,2011.3600000000001,1700.0500000000002
36972,U39071,8,31000.0,0,8,0.0,31000.0
36973,U1251934,8,-1.0000000000000715,5,3,1033.33,1032.33
36974,U1021635,8,-10.0,5,3,49.419999999999995,39.419999999999995
36975,U23198,8,-3352.7200000000003,5,3,7408.0,4055.2799999999997
36976,U21748,8,-18910.8,4,4,26000.0,7089.200000000001
36977,U1221109,8,200.0,4,4,905.5,1105.5
36978,U19224,8,1973.51,3,5,87.0,2060.51
36979,U1154447,8,-1547.35,7,1,1549.35,2.0
36980,U1179190,8,-4121.9,8,0,4121.9,0.0
36981,U32285,8,7197.490000000001,3,5,7823.01,15020.5
36982,U39111,8,-92947.12000000001,4,4,93616.5,669.3799999999901
36983,U34633,8,0.5799999999999272,3,5,7975.0,7975.58
36984,U40327,8,1975.88,5,3,1144.0,3119.88
36985,U41768,8,-50095.330000000075,5,3,1050552.0,1000456.6699999999
36986,U11378,8,5.059999999999945,5,3,1149.96,1155.02
36987,U11552,8,-1299.1600000000003,2,6,8623.26,7324.1
36988,U23631,8,42946.43,4,4,23675.2,66621.63
36989,U18440,8,4456.19,3,5,104.67,4560.86
36990,U11001,8,-390.91000000000054,4,4,11459.22,11068.31
36991,U26866,8,-33.710000000000036,5,3,2398.0,2364.29
36992,U31087,8,30468.89,3,5,95.03,30563.92
36993,U1312607,8,-292.37000000000035,7,1,1292.3700000000003,1000.0
36994,U25504,8,-14800.000000000004,4,4,50100.229999999996,35300.229999999996
36995,U619144,8,1050.0,1,7,200.0,1250.0
36996,U33603,8,-16361.990000000002,5,3,22381.53,6019.539999999997
36997,U34965,8,1163.2099999999919,5,3,191440.0,192603.21
36998,U34819,8,-3.500000000000001,6,2,13.51,10.009999999999998
36999,U40216,8,2401.8099999999995,4,4,7600.0,10001.81
37000,U10442,8,2736.13,3,5,1206.0,3942.13
37001,U35035,8,44.81,5,3,355.2,400.01
37002,U39185,8,33822.75,1,7,3000.0,36822.75
37003,U32500,8,-4594.77,5,3,16982.0,12387.23
37004,U9984,8,4727.31,4,4,2350.7,7078.01
37005,U19946,7,-8142.36,3,4,8297.03,154.67000000000098
37006,U24098,7,-415.0100000000002,3,4,15965.66,15550.65
37007,U30607,7,921.2700000000041,3,4,100065.3,100986.57
37008,U682977,7,-8.700000000000017,4,3,442.71000000000004,434.01
37009,U759379,7,9.103828801926284e-15,4,3,2308.0,2308.0
37010,U41240,7,-2945.69,5,2,3067.5,121.80999999999995
37011,U33321,7,-1086.72,4,3,1200.0,113.27999999999997
37012,U32506,7,2045.23,4,3,1736.82,3782.05
37013,U38215,7,2433.9800000000005,2,5,7229.0,9662.98
37014,U23384,7,-12039.8,5,2,12058.5,18.700000000000728
37015,U33790,7,-14280.480000000001,1,6,20000.0,5719.519999999999
37016,U26642,7,97.94000000000005,3,4,1432.2,1530.14
37017,U27189,7,19394.09,0,7,0.0,19394.09
37018,U41131,7,-1933.1000000000004,4,3,14335.15,12402.05
37019,U34231,7,-75660.95,3,4,90250.0,14589.050000000003
37020,U43832,7,474.80000000000007,4,3,1248.97,1723.77
37021,U37191,7,-4913.539999999994,2,5,610000.0,605086.46
37022,U11008,7,50.72999999999997,4,3,886.16,936.89
37023,U33880,7,8998.55,5,2,11008.81,20007.36
37024,U8281,7,-626.64,5,2,1016.03,389.39
37025,U22910,7,3608.79,2,5,380.84000000000003,3989.63
37026,U12911,7,-73.58000000000001,5,2,132.6,59.01999999999998
37027,U33863,7,-33683.96000000001,3,4,66000.0,32316.039999999994
37028,U768631,7,-10.96,6,1,11.0,0.03999999999999915
37029,U24133,7,15811.94,3,4,416.0,16227.94
37030,U24935,7,406.62,4,3,467.0,873.62
37031,U16816,7,-23983.69,4,3,38000.0,14016.310000000001
37032,U35323,7,6297.41,2,5,6297.5,12594.91
37033,U9366,7,12250.419999999984,2,5,500000.01,512250.43
37034,U760397,7,0.0,5,2,598.0,598.0
37035,U36522,7,34943.42,4,3,100156.0,135099.41999999998
37036,U22290,7,30.300000000000875,2,5,30472.22,30502.52
37037,U39786,7,-16171.929999999997,2,5,26137.0,9965.070000000003
37038,U13451,7,3054.76,1,6,1700.0,4754.76
37039,U31614,7,-1189.9899999999961,4,3,37100.08,35910.090000000004
37040,U17617,7,0.09,4,3,8708.34,8708.43
37041,U1317556,7,-379.97,5,2,379.99,0.01999999999998181
37042,U14962,7,12000.069999999998,2,5,45000.0,57000.07
37043,U1320580,7,2400.0,2,5,2000.0,4400.0
37044,U1251364,7,-27613.350000000002,6,1,27713.350000000002,100.0
37045,U17992,7,8.31000000000001,4,3,179.04,187.35
37046,U42311,7,927.56,4,3,145.6,1073.1599999999999
37047,U36591,7,-2731.8700000000003,2,5,7500.0,4768.129999999999
37048,U8136,7,150.06,3,4,94.36,244.42000000000002
37049,U33301,7,358.2,4,3,665.3499999999999,1023.55
37050,U21866,7,2912.05,4,3,3088.0,6000.05
37051,U21383,7,-32.289999999999964,3,4,4432.5,4400.21
37052,U23945,7,-3960.0000000000005,5,2,4085.1400000000003,125.13999999999987
37053,U1170381,7,-22826.269999999997,6,1,22826.289999999997,0.020000000000436557
37054,U38102,7,30276.5,4,3,31075.53,61352.03
37055,U18649,7,19972.54,3,4,363.76,20336.3
37056,U905908,7,78.74000000000001,3,4,853.74,932.48
37057,U951438,7,-1410.13,5,2,1435.06,24.929999999999836
37058,U1312776,7,-865.8000000000002,4,3,3066.01,2200.21
37059,U18586,7,239.37999999999997,3,4,1262.0,1501.3799999999999
37060,U1303750,7,-515.51,5,2,1070.52,555.01
37061,U1246883,7,3200.0,0,7,0.0,3200.0
37062,U18709,7,-30286.050000000003,5,2,40300.0,10013.949999999997
37063,U1033238,7,-393.56,6,1,843.56,449.99999999999994
37064,U22808,7,10008.44,2,5,50256.81,60265.25
37065,U1309178,7,-178.94,4,3,278.96,100.01999999999998
37066,U700104,7,-1069.54,5,2,1069.58,0.03999999999996362
37067,U43014,7,2175.9300000000067,2,5,160500.0,162675.93
37068,U21868,7,-1761.2,2,5,2009.0,247.79999999999995
37069,U21263,7,-113.37999999999992,5,2,1814.3,1700.92
37070,U34650,7,0.27000000000043656,3,4,7850.0,7850.27
37071,U1117187,7,1412.0,4,3,54.56,1466.56
37072,U35813,7,331.32,3,4,399.0,730.3199999999999
37073,U18488,7,-218.95000000000002,4,3,1619.8,1400.85
37074,U1301757,7,8.199999999999989,3,4,755.19,763.3900000000001
37075,U35100,7,8738.05,4,3,84.0,8822.05
37076,U13626,7,-266889.2,3,4,268000.0,1110.7999999999884
37077,U13886,7,149.32999999999993,3,4,11882.68,12032.01
37078,U43052,7,2420.34,2,5,2441.66,4862.0
37079,U38996,7,51726.44,4,3,32940.0,84666.44
37080,U972591,7,-3.6400000000001,4,3,1847.19,1843.55
37081,U8879,7,-282.76,6,1,284.0,1.240000000000009
37082,U26329,7,33377.76,2,5,31813.0,65190.76
37083,U22189,7,11191.0,2,5,5583.33,16774.33
37084,U15027,7,0.37000000000261934,2,5,91000.0,91000.37
37085,U35833,7,0.1200000000003638,2,5,12500.0,12500.12
37086,U12478,7,20046.240000000005,4,3,10010.29,30056.530000000006
37087,U14978,7,-352.58,5,2,423.0,70.42000000000002
37088,U18310,7,619.96,0,7,0.0,619.96
37089,U982085,7,-0.34999999999990905,6,1,600.35,600.0000000000001
37090,U669699,7,45.780000000000044,3,4,1579.52,1625.3
37091,U39189,7,223.9599999999999,3,4,12200.01,12423.97
37092,U36394,7,-80516.48,4,3,81376.53,860.0500000000029
37093,U39495,7,242.56000000000085,2,5,50050.5,50293.06
37094,U21303,7,-4999.68,3,4,14800.0,9800.32
37095,U17269,7,-315.53999999999996,6,1,325.53999999999996,10.0
37096,U20214,7,-9266.029999999999,6,1,9275.0,8.970000000001164
37097,U22706,7,7500.189999999999,2,5,7500.0,15000.189999999999
37098,U16584,7,22950.379999999997,4,3,35065.13,58015.509999999995
37099,U24612,7,-26548.889999999956,3,4,421194.02,394645.13000000006
37100,U811428,7,-53933.36,7,0,53933.36,0.0
37101,U1323898,7,290.0,4,3,1720.0,2010.0
37102,U27039,7,-20492.02,4,3,21064.0,571.9799999999996
37103,U30150,7,4419.02,2,5,4424.54,8843.560000000001
37104,U43468,7,4202.01,2,5,4166.68,8368.69
37105,U32613,7,-57.51000000000204,3,4,17107.92,17050.409999999996
37106,U747132,7,-1611.7800000000002,5,2,3149.78,1538.0
37107,U43541,7,999.38,3,4,584.5,1583.88
37108,U26123,7,-215381.79,5,2,215522.0,140.20999999999185
37109,U25928,7,-127.81999999999994,4,3,1970.37,1842.55
37110,U25804,7,15867.949999999999,2,5,15946.0,31813.949999999997
37111,U25713,7,1.7399999999979627,3,4,70000.0,70001.73999999999
37112,U26351,7,0.010000000000218279,4,3,15637.78,15637.79
37113,U36022,7,-1.829999999999127,3,4,60559.0,60557.17
37114,U26867,7,2016.300000000003,2,5,200000.0,202016.3
37115,U35340,7,-4496.630000000005,3,4,340396.0,335899.37
37116,U15702,7,-858.6200000000001,3,4,17000.0,16141.38
37117,U33137,7,3198.39,4,3,3101.8,6300.1900000000005
37118,U11864,7,12088.94,2,5,7911.66,20000.6
37119,U19019,7,-2995.8600000000006,2,5,50011.69,47015.83
37120,U26317,7,10381.67,5,2,289623.0,300004.67
37121,U15850,7,13899.35,3,4,2368.0,16267.35
37122,U15946,7,-7369.55,3,4,7377.64,8.090000000000146
37123,U35644,7,-1320.12,4,3,2043.1799999999998,723.06
37124,U37736,7,6400.049999999999,2,5,6361.12,12761.169999999998
37125,U16163,7,-628.6000000000004,4,3,5251.43,4622.83
37126,U9158,7,79.67999999999999,3,4,103.74000000000001,183.42000000000002
37127,U23106,7,85.41000000000076,4,3,4264.68,4350.090000000001
37128,U33773,7,-668.0799999999999,3,4,12410.0,11741.92
37129,U19093,7,-1776.5000000000002,5,2,9390.19,7613.6900000000005
37130,U31470,7,-587.72,5,2,737.73,150.01
37131,U18660,7,509.5,4,3,590.6,1100.1
37132,U29764,7,1431.1599999999999,3,4,11740.0,13171.16
37133,U12404,7,4156.53,4,3,4170.76,8327.29
37134,U11850,7,-43819.659999999996,3,4,45820.0,2000.3400000000038
37135,U29922,7,2.6300000000000026,3,4,124.71000000000001,127.34
37136,U22419,7,11963.880000000001,2,5,66.5,12030.380000000001
37137,U37531,7,-14280.189999999999,3,4,47600.0,33319.81
37138,U19431,7,535.4,4,3,254.5,789.9
37139,U1076515,7,-4158.679999999999,6,1,4158.7,0.020000000000436557
37140,U1308981,7,-287.0,5,2,417.0,130.0
37141,U33764,7,3.552713678800501e-15,5,2,60.0,60.0
37142,U982444,7,1390.0,2,5,90.0,1480.0
37143,U35539,7,3615.459999999992,2,5,300000.0,303615.45999999996
37144,U24377,7,3667.65,2,5,3662.5,7330.15
37145,U27020,7,-2343.22,5,2,2580.0,236.7800000000002
37146,U25801,7,-231512.19999999998,5,2,231957.11999999997,444.9199999999837
37147,U19114,7,19.32000000000018,3,4,4581.0,4600.320000000001
37148,U42993,7,15905.150000000001,4,3,4150.0,20055.15
37149,U27619,7,495.5100000000002,2,5,51600.0,52095.51
37150,U23310,7,-1.2799999999997453,3,4,8656.119999999999,8654.84
37151,U21173,7,-2695.93,3,4,2851.0,155.07000000000016
37152,U34106,7,-679.6800000000001,4,3,2568.0,1888.32
37153,U23863,7,2715.5899999999965,1,6,130000.0,132715.59
37154,U17441,7,-84405.86,4,3,92231.56,7825.699999999997
37155,U752620,7,276.38,4,3,190.0,466.38
37156,U39448,7,-743.94,4,3,1144.65,400.71000000000004
37157,U15679,7,0.8899999999994179,4,3,19308.5,19309.39
37158,U26169,7,-53150.92000000001,2,5,148000.0,94849.07999999999
37159,U35905,7,2856.3099999999995,5,2,13148.0,16004.31
37160,U821260,7,-0.5,3,4,11056.0,11055.5
37161,U625205,7,-13548.59,5,2,13928.629999999997,380.03999999999724
37162,U33395,7,-80.66999999999825,4,3,31504.0,31423.33
37163,U27316,7,-692.41,6,1,1096.9099999999999,404.4999999999999
37164,U13563,7,21470.0,3,4,19575.0,41045.0
37165,U9096,7,-0.9800000000000182,5,2,1679.99,1679.01
37166,U1238042,7,-1956.17,5,2,1956.27,0.09999999999990905
37167,U28908,7,9001.439999999999,2,5,9666.66,18668.1
37168,U35871,7,-58052.630000000005,4,3,58105.97,53.33999999999651
37169,U958804,7,-119.9,4,3,638.8,518.9
37170,U24450,7,0.030000000000654836,3,4,19880.0,19880.03
37171,U28562,7,-31999.97,5,2,32070.7,70.72999999999956
37172,U1147434,7,-559.03,5,2,3959.0299999999997,3400.0
37173,U30568,7,265.53,4,3,240.46,505.99
37174,U42870,7,40.409999999999854,3,4,3385.97,3426.3799999999997
37175,U18568,7,2043.64,2,5,11046.43,13090.07
37176,U22683,7,-84.58,4,3,384.63,300.05
37177,U41434,7,-2010.49,5,2,2057.0299999999997,46.539999999999736
37178,U34793,7,-60218.7,5,2,60320.0,101.30000000000291
37179,U27581,7,169.53999999999883,3,4,50020.0,50189.54
37180,U1234349,7,-2072.1000000000004,6,1,4422.1,2350.0
37181,U22722,7,18492.33,2,5,18492.33,36984.66
37182,U25571,7,0.0,4,3,2861.2,2861.2
37183,U23442,7,16444.010000000002,2,5,16666.66,33110.67
37184,U34643,7,15921.27,2,5,15900.0,31821.27
37185,U43389,7,-4700.31,4,3,13051.0,8350.689999999999
37186,U1025440,7,-1021.02,6,1,1021.11,0.09000000000003183
37187,U32111,7,6253.45,2,5,6240.56,12494.01
37188,U32845,7,10400.04,1,6,1500.0,11900.04
37189,U8952,7,-2752.3999999999996,3,4,8257.83,5505.43
37190,U8456,7,943.3099999999977,3,4,512740.8,513684.11
37191,U31518,7,0.819999999999709,3,4,34496.0,34496.82
37192,U20868,7,-68.64,4,3,284.12,215.48000000000002
37193,U24320,7,6003.5599999999995,3,4,43000.0,49003.56
37194,U23683,7,-135.74,3,4,737.0,601.26
37195,U28848,7,-379.49,6,1,381.08,1.589999999999975
37196,U10347,7,0.930000000000291,3,4,12200.0,12200.93
37197,U35958,7,-20090.399999999998,3,4,20328.62,238.22000000000116
37198,U10413,7,-26344.56000000001,3,4,89670.3,63325.73999999999
37199,U18005,7,-36109.79,1,6,50000.0,13890.21
37200,U26604,7,-5.919999999998254,4,3,56006.0,56000.08
37201,U33580,7,-1094.4900000000016,3,4,25095.370000000003,24000.88
37202,U1088879,7,-746.74,3,4,3207.0,2460.26
37203,U924666,7,-6.75,4,3,9500.0,9493.25
37204,U24205,7,-295.82,4,3,382.5,86.68
37205,U1319415,7,-1599.0,4,3,1849.05,250.04999999999995
37206,U988916,7,-995.98,5,2,8995.98,8000.0
37207,U41909,7,265.51,2,5,78.5,344.01
37208,U668092,7,433.0,0,7,0.0,433.0
37209,U587225,7,-4574.94,4,3,4594.96,20.020000000000437
37210,U30028,7,8552.04,2,5,8583.34,17135.38
37211,U26905,7,-11998.05,4,3,82000.0,70001.95
37212,U37685,7,-319.97999999999973,3,4,15350.0,15030.02
37213,U21412,7,6500.74,2,5,6466.68,12967.42
37214,U29924,7,3200.02,4,3,902.9799999999999,4103.0
37215,U27888,7,0.17000000000007276,3,4,5000.0,5000.17
37216,U39758,7,177.98999999999978,2,5,8900.0,9077.99
37217,U1215377,7,-528.55,5,2,528.63,0.08000000000004093
37218,U31960,7,-3485.4700000000003,6,1,3499.0,13.529999999999745
37219,U1243380,7,208.19,3,4,816.4,1024.59
37220,U1265208,7,1199.62,4,3,690.38,1890.0
37221,U23855,7,8200.119999999999,2,5,8166.66,16366.779999999999
37222,U34967,7,-359.39,4,3,720.0,360.61
37223,U984562,7,3557.0699999999997,4,3,8960.0,12517.07
37224,U26784,7,0.05999999999994543,3,4,6800.0,6800.0599999999995
37225,U34365,7,325.25,3,4,58475.0,58800.25
37226,U35764,7,1182.5,4,3,1771.0,2953.5
37227,U16665,7,-1119.9,4,3,1447.54,327.6399999999999
37228,U1318714,7,-12991.349999999999,6,1,13099.029999999999,107.68000000000029
37229,U37864,7,975.98,4,3,2006.0,2981.98
37230,U1091993,7,5.684341886080802e-14,4,3,610.4,610.4000000000001
37231,U42142,7,37.97999999999956,4,3,20516.02,20554.0
37232,U20879,7,15401.01,2,5,15381.94,30782.95
37233,U16242,7,-1492.91,4,3,3269.4,1776.49
37234,U23794,7,-57093.9,5,2,64187.07,7093.169999999998
37235,U32776,7,70951.03000000001,4,3,29077.019999999997,100028.05000000002
37236,U1158281,7,-7773.22,6,1,7778.34,5.119999999999891
37237,U32877,7,20946.7,2,5,20458.41,41405.11
37238,U32678,7,3200.16,2,5,3152.5,6352.66
37239,U12049,7,410.9399999999996,5,2,12264.58,12675.52
37240,U36868,7,-157683.98000000004,1,6,360000.0,202316.01999999996
37241,U19583,7,-79.26000000000022,3,4,22832.0,22752.739999999998
37242,U34142,7,-3.0599999999999454,4,3,4813.1,4810.040000000001
37243,U26058,7,-1641.4200000000005,3,4,30507.690000000002,28866.27
37244,U9263,7,568.96,3,4,1284.5,1853.46
37245,U961972,7,-350.0,7,0,350.0,0.0
37246,U40411,7,-8974.98,3,4,9008.34,33.36000000000058
37247,U40801,7,-9924.98,5,2,10425.0,500.02000000000044
37248,U704081,7,0.3100000000000023,3,4,48.32,48.63
37249,U26184,7,-1011.29,4,3,2822.0,1810.71
37250,U24255,7,13627.150000000001,2,5,13600.0,27227.15
37251,U39504,7,-2727.3,4,3,6728.95,4001.6499999999996
37252,U27595,7,293.14999999999964,3,4,8400.0,8693.15
37253,U24793,7,-6300.6,5,2,9321.6,3021.0
37254,U888848,7,-49.92,4,3,51.18,1.259999999999998
37255,U641901,7,188.54000000000002,4,3,361.46,550.0
37256,U18347,7,1053.3999999999994,5,2,5529.85,6583.25
37257,U703461,7,-2932.87,4,3,17933.0,15000.130000000001
37258,U863128,7,-296.96000000000004,4,3,7104.68,6807.72
37259,U32264,7,-25.5,4,3,26.0,0.5
37260,U24605,7,-234.77999999999994,4,3,1361.85,1127.07
37261,U1258722,7,-3520.0,5,2,3521.0,1.0
37262,U38455,7,-6212.2699999999995,3,4,6600.0,387.7300000000005
37263,U21534,7,-15.250000000000218,3,4,6313.08,6297.83
37264,U980233,7,60.269999999999996,3,4,30.0,90.27
37265,U22222,7,194.12,4,3,1606.0,1800.12
37266,U26285,7,13770.34,2,5,30278.0,44048.34
37267,U594446,7,-22.70999999999958,4,3,6422.78,6400.07
37268,U39129,7,1370.2999999999956,2,5,90000.0,91370.29999999999
37269,U29789,7,-76225.93000000001,4,3,76505.69,279.75999999999476
37270,U1242619,7,3000.86,3,4,3327.81,6328.67
37271,U37107,7,9990.699999999999,3,4,19.44,10010.14
37272,U26644,7,17242.890000000003,4,3,19078.8,36321.69
37273,U13394,7,-1412.050000000001,2,5,17510.0,16097.949999999999
37274,U37793,7,1677.7299999999996,3,4,16795.64,18473.37
37275,U37451,7,14380.91,1,6,1000.0,15380.91
37276,U31132,7,-96.49000000000001,5,2,109.41,12.919999999999987
37277,U26273,7,673.6899999999999,4,3,826.46,1500.15
37278,U25080,7,-21.109999999999673,2,5,6550.0,6528.89
37279,U1353103,7,-5737.2,5,2,5737.26,0.06000000000040018
37280,U31841,7,7.609999999998763,3,4,14500.0,14507.609999999999
37281,U15127,7,2.399999999999943,4,3,615.51,617.91
37282,U1170516,7,-85.88000000000044,4,3,4213.0,4127.12
37283,U25764,7,-37231.47,4,3,47272.48,10041.010000000002
37284,U34269,7,20545.699999999997,3,4,30006.0,50551.7
37285,U21610,7,7500.2,2,5,7500.0,15000.2
37286,U9139,7,8223.55,2,5,10000.0,18223.55
37287,U24620,7,91.0199999999995,1,6,2500.0,2591.0199999999995
37288,U37596,7,-1172.04,5,2,1451.56,279.52
37289,U19030,7,464.4,4,3,2535.98,3000.38
37290,U21230,7,-319.7100000000001,4,3,786.5699999999999,466.85999999999984
37291,U21782,7,67.56000000000927,4,3,241932.5,242000.06
37292,U34103,7,15.50000000000091,1,6,31990.0,32005.5
37293,U37002,7,-44.57000000000001,4,3,379.8,335.23
37294,U22220,7,-135.44,4,3,333.0,197.56
37295,U21863,7,-11644.41,4,3,29000.0,17355.59
37296,U25333,7,-649.5899999999999,4,3,2652.0,2002.41
37297,U22277,7,-302.92,5,2,779.97,477.05
37298,U31743,7,-12677.51,4,3,42975.0,30297.489999999998
37299,U42801,7,-1414.8599999999997,4,3,10484.8,9069.939999999999
37300,U19020,7,36.330000000001746,5,2,69862.04,69898.37
37301,U1136432,7,3.2729374765949615e-13,5,2,3999.9999999999995,4000.0
37302,U791151,7,25.209999999999923,3,4,1600.01,1625.2199999999998
37303,U37655,7,-331.0399999999989,2,5,15634.099999999999,15303.06
37304,U26462,7,4200.08,2,5,4156.76,8356.84
37305,U38373,7,-4257.769999999999,4,3,11200.0,6942.230000000001
37306,U13946,7,-29988.690000000002,1,6,220000.0,190011.31
37307,U1150384,7,5000.02,2,5,5000.0,10000.02
37308,U42173,7,-969.0699999999999,4,3,4484.62,3515.55
37309,U1311852,7,-8.56,5,2,12.56,4.0
37310,U33440,7,-23.9,5,2,32.0,8.100000000000001
37311,U32186,7,49999.97999999998,4,3,348000.02,398000.0
37312,U16561,7,-365.0600000000023,3,4,37352.20999999999,36987.14999999999
37313,U29661,7,2336.87,4,3,13100.0,15436.869999999999
37314,U877453,7,-0.6700000000000107,4,3,925.68,925.01
37315,U25328,7,53437.45,2,5,999.8,54437.25
37316,U32135,7,2.650000000000091,2,5,63599.0,63601.65
37317,U23218,7,1691.1,1,6,522.0,2213.1
37318,U18213,7,10970.460000000001,2,5,10231.6,21202.06
37319,U23288,7,-269.58,6,1,270.0,0.4200000000000159
37320,U20737,7,-7.029999999999418,4,3,42007.14,42000.11
37321,U35441,7,-9269.59,3,4,57290.58,48020.990000000005
37322,U15572,7,13794.97,2,5,6.0,13800.97
37323,U25706,7,157.40999999999963,4,3,11765.91,11923.32
37324,U13007,7,-203.58999999999992,3,4,20006.0,19802.41
37325,U19527,7,40117.93,4,3,10300.0,50417.93
37326,U575055,7,-2321.2299999999996,6,1,2321.2799999999997,0.0500000000001819
37327,U21918,7,246.64,4,3,2153.57,2400.21
37328,U10019,7,76.49999999999982,2,5,5377.5,5454.0
37329,U22288,7,1476.5000000000002,4,3,540.59,2017.0900000000001
37330,U32554,7,-806.9900000000005,4,3,11719.78,10912.79
37331,U1169440,7,1500.13,4,3,3300.23,4800.360000000001
37332,U1292254,7,-30.329999999999984,6,1,150.32999999999998,120.0
37333,U34357,7,-156.5800000000001,5,2,1856.7,1700.12
37334,U35299,7,-514.91,5,2,636.96,122.05000000000007
37335,U30002,7,-1998.63,3,4,8484.58,6485.95
37336,U26627,7,-88.92,4,3,5289.0,5200.08
37337,U30522,7,-91.32999999999993,3,4,7799.5599999999995,7708.23
37338,U627406,7,19.38000000000011,3,4,6792.0,6811.38
37339,U34875,7,-1196.99,3,4,2748.0,1551.01
37340,U24362,7,0.0,5,2,17268.11,17268.11
37341,U26312,7,-32111.21,5,2,32170.0,58.79000000000087
37342,U26230,7,-709653.7400000001,4,3,909698.0,200044.2599999999
37343,U37996,7,-3428.28,3,4,6736.9,3308.6199999999994
37344,U14570,7,-24.039999999999907,3,4,2400.96,2376.92
37345,U27409,7,1738.7,3,4,8300.0,10038.7
37346,U43128,7,2315.6300000000006,3,4,14587.0,16902.63
37347,U14585,7,74.33999999999999,4,3,94.18,168.51999999999998
37348,U10089,7,0.3000000000001819,5,2,5377.7,5378.0
37349,U965025,7,-2440.0,4,3,13440.0,11000.0
37350,U39013,7,1857.79,3,4,6942.98,8800.77
37351,U1054148,7,-264.39,5,2,264.53,0.13999999999998636
37352,U40536,7,-3972.19,6,1,3972.8,0.6100000000001273
37353,U23272,7,-1357.3400000000001,5,2,6359.18,5001.84
37354,U30147,7,334.4000000000001,3,4,928.0,1262.4
37355,U17736,7,-184.89999999999998,4,3,560.0,375.1
37356,U28429,7,39913.69,3,4,3639.0,43552.69
37357,U31396,7,-4.460000000000036,3,4,1404.6200000000001,1400.16
37358,U41874,7,13182.0,2,5,5538.49,18720.489999999998
37359,U31298,7,-138.54,5,2,338.65,200.10999999999999
37360,U38954,7,15312.02,2,5,64300.0,79612.02
37361,U742456,7,1580.01,2,5,1580.0,3160.01
37362,U19620,7,0.21000000000003638,2,5,9968.47,9968.68
37363,U689425,7,-16.659999999999783,4,3,4896.67,4880.01
37364,U11852,7,-283594.64,5,2,323104.64,39510.0
37365,U1330718,7,-1002.16,5,2,3057.24,2055.08
37366,U29526,7,-4245.610000000001,3,4,49000.0,44754.39
37367,U1117315,7,361.0,4,3,20.0,381.0
37368,U39178,7,11163.77,2,5,11166.74,22330.510000000002
37369,U26646,7,153.76999999999953,2,5,6216.76,6370.53
37370,U28665,7,-74499.48999999999,4,3,121570.16,47070.67000000001
37371,U15046,7,672.6600000000017,2,5,8300.0,8972.660000000002
37372,U19875,7,-18002.67,4,3,36004.17,18001.5
37373,U21651,7,317.52,4,3,661.37,978.89
37374,U26922,7,-892.2499999999997,2,5,35700.0,34807.75
37375,U42442,7,1034.76,3,4,3502.0,4536.76
37376,U22632,7,-14958.48,4,3,15345.599999999999,387.119999999999
37377,U1233344,7,37.0,4,3,767.16,804.16
37378,U19181,7,-3533.67,4,3,6034.639999999999,2500.9699999999993
37379,U1233860,7,98.02,3,4,4.47,102.49
37380,U18223,7,-25.600000000000364,3,4,11200.0,11174.4
37381,U964684,7,-2408.29,6,1,2408.31,0.01999999999998181
37382,U11878,7,-1761.23,4,3,2034.73,273.5
37383,U33806,7,-5982.03,4,3,13229.0,7246.97
37384,U12257,7,0.2300000000000182,3,4,6153.83,6154.0599999999995
37385,U42301,7,51967.68,2,5,10091.0,62058.68
37386,U32158,7,24687.53,4,3,8636.0,33323.53
37387,U35115,7,7306.4400000000005,4,3,2506.0,9812.44
37388,U37958,7,2638.319999999993,1,6,120000.0,122638.31999999999
37389,U29034,7,23000.0,2,5,15000.0,38000.0
37390,U41209,7,6.97,4,3,1.0,7.97
37391,U39984,7,88.48999999999981,2,5,4106.0,4194.49
37392,U15784,7,-1182.9700000000012,4,3,11190.0,10007.029999999999
37393,U30726,7,-56.71000000000001,4,3,312.1,255.39000000000001
37394,U39931,7,-15.899999999999636,4,3,14015.9,14000.0
37395,U9760,7,5.360000000000582,3,4,10950.0,10955.36
37396,U33251,7,-218.75,5,2,631.5,412.75
37397,U38490,7,14794.03,0,7,0.0,14794.03
37398,U39654,7,9097.339999999998,3,4,270.0,9367.339999999998
37399,U31822,7,7680.21,4,3,1014.99,8695.2
37400,U23787,7,-238.91999999999996,4,3,745.8,506.88
37401,U26877,7,384314.95,2,5,103360.0,487674.95
37402,U42260,7,-169240.93000000002,3,4,200200.0,30959.069999999978
37403,U27096,7,1.499999999999418,2,5,25000.0,25001.5
37404,U29317,7,-554.3300000000002,3,4,1885.0,1330.6699999999998
37405,U9067,7,1101.4,2,5,139.10999999999999,1240.51
37406,U10743,7,-72436.92,5,2,90386.95,17950.03
37407,U22907,7,-10476.21,5,2,11157.5,681.2900000000009
37408,U8652,7,-613.1,6,1,614.29,1.1899999999999409
37409,U24459,7,5801.35,2,5,5833.34,11634.69
37410,U41444,7,2837.81,5,2,769.36,3607.17
37411,U27486,7,-1544.95,5,2,2399.96,855.01
37412,U43571,7,73453.59,3,4,931.5999999999999,74385.19
37413,U24286,7,7400.93,2,5,7333.34,14734.27
37414,U1146526,7,-1978.53,5,2,1979.07,0.5399999999999636
37415,U656235,7,-837.6600000000001,6,1,844.7500000000001,7.090000000000032
37416,U33449,7,329.69,3,4,397.9,727.5899999999999
37417,U9736,7,314.15999999999997,4,3,326.19000000000005,640.35
37418,U35586,7,8340.15,2,5,8333.34,16673.489999999998
37419,U43671,7,28.34999999999991,3,4,2072.0,2100.35
37420,U1210277,7,10.8900000000001,5,2,2112.12,2123.01
37421,U1105150,7,1495.6399999999999,2,5,2984.4,4480.04
37422,U27420,7,0.3299999999999841,4,3,983.26,983.5899999999999
37423,U23815,7,-15679.01,4,3,24605.94,8926.929999999998
37424,U33703,7,0.020000000000436557,3,4,10600.0,10600.02
37425,U29808,7,-116.61,5,2,165.0,48.39
37426,U17484,7,-140.70000000000002,1,6,150.0,9.299999999999983
37427,U1112331,7,120.0,4,3,1622.0,1742.0
37428,U37554,7,7111.58,3,4,19.0,7130.58
37429,U39817,7,-10244.8,4,3,10298.4,53.600000000000364
37430,U40371,7,93.29000000000043,2,5,302860.98,302954.26999999996
37431,U40400,7,17.75,3,4,19482.38,19500.13
37432,U32304,7,-6284.83,4,3,7469.63,1184.8000000000002
37433,U674500,7,162.97000000000003,4,3,0.04,163.01000000000002
37434,U8725,7,-18902.07999999999,2,5,250000.0,231097.92
37435,U812413,7,-3825.69,6,1,3826.3,0.6100000000001273
37436,U19831,7,80.11,4,3,220.0,300.11
37437,U42389,7,3497.31,2,5,3793.34,7290.65
37438,U1141908,7,-2516.4100000000003,5,2,3868.1400000000003,1351.73
37439,U33819,7,3554.5600000000004,4,3,2636.2799999999997,6190.84
37440,U43080,7,-1338.8800000000037,3,4,55300.0,53961.119999999995
37441,U24937,7,248.64999999999964,4,3,19354.510000000002,19603.160000000003
37442,U43521,7,6400.9400000000005,2,5,6240.56,12641.5
37443,U1257523,7,115.25999999999992,5,2,635.23,750.4899999999999
37444,U20973,7,1.2100000000001727,2,5,20379.56,20380.77
37445,U25211,7,-3294.63,4,3,6596.0,3301.37
37446,U29076,7,-14958.73,3,4,35000.0,20041.27
37447,U43955,7,-164.27999999999997,6,1,164.52999999999997,0.25
37448,U11688,7,-6822.81,2,5,18000.0,11177.189999999999
37449,U24252,7,-304.87000000000046,6,1,3749.0700000000006,3444.2000000000003
37450,U27483,7,-261.3,6,1,561.3,299.99999999999994
37451,U679221,7,-17409.3,6,1,18409.3,1000.0
37452,U40529,7,1697.0000000000005,3,4,4307.24,6004.24
37453,U26727,7,38333.979999999996,2,5,38333.34,76667.31999999999
37454,U26069,7,-71.99,5,2,140.2,68.21
37455,U39773,7,21669.120000000003,2,5,1502.0,23171.120000000003
37456,U15932,7,1308.4499999999998,3,4,5186.0,6494.45
37457,U21814,7,226.11,4,3,354.41,580.52
37458,U795547,7,-4654.029999999999,6,1,4667.799999999999,13.770000000000437
37459,U30057,7,0.0,4,3,4300.0,4300.0
37460,U43758,7,37.67000000000007,3,4,2962.34,3000.01
37461,U32961,7,0.580000000000382,4,3,7999.74,8000.32
37462,U637001,7,80.00999999999999,3,4,320.07,400.08
37463,U26762,7,16768.420000000013,5,2,203960.0,220728.42
37464,U42499,7,3805.58,4,3,2824.7000000000003,6630.280000000001
37465,U23740,7,0.22,3,4,1480.0,1480.22
37466,U697529,7,2.9400000000000013,3,4,21.89,24.830000000000002
37467,U23975,7,-764.0699999999999,6,1,764.0799999999999,0.009999999999990905
37468,U31942,7,6600.98,2,5,6500.0,13100.98
37469,U9209,7,-3363.76,4,3,4874.88,1511.12
37470,U12683,7,-19744.15,2,5,54000.0,34255.85
37471,U40626,7,2631.32,3,4,57.8,2689.1200000000003
37472,U9417,7,13680.41,2,5,13681.26,27361.67
37473,U38567,7,-16649.09,6,1,16666.0,16.909999999999854
37474,U22097,7,18976.9,5,2,36266.0,55242.9
37475,U35082,7,983.99,4,3,1817.0,2800.99
37476,U32960,7,558.27,3,4,542.3,1100.57
37477,U9442,7,72.97000000000025,4,3,3924.79,3997.76
37478,U18090,7,1.079999999999984,3,4,141.0,142.07999999999998
37479,U23201,7,38799.350000000006,1,6,191.0,38990.350000000006
37480,U30889,7,-101.65999999999997,3,4,1602.0,1500.3400000000001
37481,U33335,7,-9999.310000000001,3,4,24160.0,14160.689999999999
37482,U18761,7,4400.07,2,5,4390.54,8790.61
37483,U21289,7,-16917.030000000002,5,2,17099.09,182.05999999999767
37484,U24068,7,-14539.01,5,2,14551.0,11.989999999999782
37485,U12650,7,-38988.50999999997,4,3,375241.75,336253.24000000005
37486,U22467,7,-1699.67,3,4,2132.28,432.6100000000001
37487,U1022169,7,-663.61,4,3,963.74,300.13
37488,U35230,7,5.52,0,7,0.0,5.52
37489,U22440,7,-682.55,5,2,780.31,97.75999999999999
37490,U33283,7,-1795.0599999999986,2,5,18100.0,16304.940000000002
37491,U28190,7,0.55,3,4,2900.0,2900.55
37492,U23463,7,24314.649999999998,2,5,24120.3,48434.95
37493,U22072,7,-4322.62,6,1,4326.0,3.380000000000109
37494,U35128,7,-1070.03,5,2,1144.6799999999998,74.64999999999986
37495,U11636,7,11662.080000000005,1,6,100000.0,111662.08
37496,U34148,7,-9887.93,5,2,55006.0,45118.07
37497,U35839,7,-11695.4,4,3,18700.0,7004.6
37498,U27857,6,-2043.17,4,2,2163.2,120.02999999999975
37499,U31039,6,3494.790000000001,3,3,6384.209999999999,9879.0
37500,U1160408,6,-1.7899999999999991,4,2,21.86,20.07
37501,U43736,6,3455.4799999999996,3,3,5124.0,8579.48
37502,U18981,6,-12281.450000000004,3,3,123000.0,110718.54999999999
37503,U21224,6,39918.14,2,4,5320.85,45238.99
37504,U21178,6,621.27,2,4,600000.0,600621.27
37505,U38059,6,1500.0,2,4,1500.0,3000.0
37506,U24228,6,50.010000000000005,2,4,54.92,104.93
37507,U800557,6,33.53999999999978,2,4,8341.55,8375.089999999998
37508,U977148,6,-7208.280000000001,5,1,7928.280000000001,720.0
37509,U21825,6,-350.6800000000003,3,3,11352.08,11001.4
37510,U14870,6,6.1400000000001,3,3,6797.0,6803.14
37511,U20734,6,3150.17,1,5,5500.0,8650.17
37512,U24119,6,-23583.239999999998,4,2,23749.9,166.6600000000035
37513,U40369,6,-4987.130000000001,4,2,6326.130000000001,1339.0
37514,U9510,6,2670.5899999999997,2,4,137.3,2807.89
37515,U18116,6,46186.08,2,4,2012.38,48198.46
37516,U1015054,6,0.0,3,3,14833.0,14833.0
37517,U1272120,6,4994.02,2,4,6.0,5000.02
37518,U8226,6,-200190.83,3,3,203280.01,3089.180000000022
37519,U26028,6,214.23000000000002,4,2,785.96,1000.19
37520,U662266,6,0.0,4,2,753.0,753.0
37521,U33550,6,1196.21,2,4,7000.0,8196.21
37522,U34990,6,-29.599999999999994,3,3,132.0,102.4
37523,U11901,6,-0.1799999999970896,2,4,37605.43,37605.25
37524,U39409,6,-4820.8,4,2,4850.0,29.199999999999818
37525,U14811,6,0.06000000000043656,2,4,8400.0,8400.060000000001
37526,U27931,6,-1956.98,5,1,1958.94,1.9600000000000364
37527,U39876,6,-175184.86000000002,1,5,1200000.0,1024815.14
37528,U640834,6,-4390.400000000001,6,0,4390.400000000001,0.0
37529,U29178,6,-0.6100000000005821,3,3,20000.62,20000.01
37530,U35424,6,49509.01,2,4,500.0,50009.01
37531,U970862,6,198.0,4,2,1110.0,1308.0
37532,U33117,6,-3424.33,3,3,13442.970000000001,10018.640000000001
37533,U24897,6,499.03,0,6,0.0,499.03
37534,U26018,6,-1108.4099999999996,3,3,30671.66,29563.25
37535,U1093334,6,-331.26,5,1,631.26,300.0
37536,U635758,6,160.0,4,2,820.0,980.0
37537,U20625,6,954.95,3,3,2023.06,2978.01
37538,U41842,6,611.6800000000001,1,5,100.0,711.6800000000001
37539,U39645,6,-9790.76,3,3,20212.03,10421.269999999999
37540,U21785,6,-1001.4099999999999,3,3,22009.25,21007.84
37541,U21581,6,3451.08,3,3,6149.0,9600.08
37542,U24813,6,-2016.31,4,2,2138.94,122.63000000000011
37543,U32994,6,107905.26,1,5,20000.0,127905.26
37544,U34264,6,487.11,2,4,305.0,792.11
37545,U34548,6,-229.71999999999997,2,4,4600.0,4370.28
37546,U19805,6,8944.9,1,5,1228.1,10173.0
37547,U36142,6,13841.549999999988,2,4,145000.0,158841.55
37548,U37825,6,-9500.0,4,2,22700.0,13200.0
37549,U22281,6,-992.899999999993,2,4,201000.0,200007.1
37550,U42457,6,-40806.22,4,2,40828.0,21.779999999998836
37551,U9994,6,-683.79,4,2,1368.0,684.21
37552,U17128,6,-57.709999999999894,3,3,3658.2,3600.49
37553,U37638,6,1043.46,2,4,216.58,1260.04
37554,U33098,6,-3283.15,3,3,9885.619999999999,6602.469999999999
37555,U10457,6,4160.040000000002,2,4,4166.589999999999,8326.630000000001
37556,U657342,6,2145.7,1,5,643.55,2789.25
37557,U679775,6,1252.26,2,4,1296.55,2548.81
37558,U12012,6,-1563.2,3,3,1573.56,10.3599999999999
37559,U12759,6,-499.66,3,3,1050.0,550.3399999999999
37560,U43919,6,16003.439999999999,1,5,8070.1,24073.54
37561,U30063,6,-1399.81,3,3,7358.0,5958.1900000000005
37562,U14154,6,-115.12,4,2,122.99000000000001,7.8700000000000045
37563,U21223,6,-1684.3700000000001,4,2,2531.17,846.8
37564,U1255685,6,1.56,4,2,3.4,4.96
37565,U37378,6,13012.72,0,6,0.0,13012.72
37566,U1363754,6,350.0,2,4,5000.04,5350.04
37567,U37396,6,-819.0700000000004,4,2,2518.1400000000003,1699.07
37568,U1156148,6,-1213.62,5,1,1213.6299999999999,0.009999999999990905
37569,U35352,6,24.659999999999854,3,3,20006.0,20030.66
37570,U28371,6,7402.829999999999,1,5,20000.0,27402.829999999998
37571,U9014,6,13239.109999999999,0,6,0.0,13239.109999999999
37572,U17687,6,-18398.100000000002,4,2,22392.15,3994.0499999999993
37573,U777358,6,394.01,2,4,375.0,769.01
37574,U22465,6,8631.89,1,5,7500.0,16131.89
37575,U1327384,6,-3933.1400000000003,5,1,3933.67,0.5299999999997453
37576,U1091306,6,-149.99,3,3,153.23999999999998,3.2499999999999716
37577,U21801,6,-29.610000000000582,2,4,13000.0,12970.39
37578,U625642,6,3.01,1,5,0.01,3.0199999999999996
37579,U20692,6,-595.3700000000008,3,3,6000.0,5404.629999999999
37580,U14450,6,-18.77,3,3,30.0,11.23
37581,U42808,6,-37.269999999999996,3,3,42.54,5.270000000000003
37582,U37826,6,1729.8000000000002,2,4,988.0,2717.8
37583,U888350,6,180.07999999999998,3,3,240.0,420.08
37584,U29987,6,499.1600000000035,3,3,35000.0,35499.16
37585,U38192,6,-383.85999999999996,4,2,500.3,116.44000000000005
37586,U42965,6,5006.24,2,4,8416.66,13422.9
37587,U11799,6,12572.45,4,2,8866.66,21439.11
37588,U931928,6,-794.82,6,0,794.82,0.0
37589,U1091317,6,-105.79999999999995,4,2,1605.8,1500.0
37590,U40179,6,-1837.91,4,2,1903.0,65.08999999999992
37591,U11716,6,-78.43000000000004,3,3,439.65999999999997,361.2299999999999
37592,U35391,6,12379.29,1,5,1596.25,13975.54
37593,U40488,6,-146.68,4,2,190.76,44.079999999999984
37594,U18319,6,-2840.69,5,1,2842.94,2.25
37595,U936548,6,-190.76,5,1,690.76,500.0
37596,U1344192,6,-1119.49,5,1,1124.48,4.990000000000009
37597,U1207805,6,-695.39,4,2,786.66,91.26999999999998
37598,U1242191,6,-1219.4400000000003,5,1,1222.5500000000002,3.1099999999999
37599,U31170,6,2015.8100000000002,0,6,0.0,2015.8100000000002
37600,U19552,6,-9.0,6,0,9.0,0.0
37601,U43355,6,-89108.07,2,4,90020.0,911.929999999993
37602,U43658,6,-59156.23,2,4,70700.0,11543.769999999997
37603,U41427,6,-15008.099999999999,3,3,30048.8,15040.7
37604,U24533,6,200.32999999999998,3,3,97.6,297.92999999999995
37605,U14794,6,-243.38999999999578,3,3,21350.1,21106.710000000003
37606,U1369235,6,3732.3199999999997,4,2,4150.68,7883.0
37607,U16224,6,0.0,4,2,6305.56,6305.56
37608,U19213,6,13126.99,2,4,6895.889999999999,20022.879999999997
37609,U745992,6,-856.7200000000001,5,1,856.7600000000002,0.04000000000007731
37610,U705639,6,-49.33,3,3,453.69000000000005,404.36000000000007
37611,U35058,6,-38.98999999999978,3,3,5645.0,5606.01
37612,U34027,6,-96.93999999999993,3,3,1235.8,1138.8600000000001
37613,U1066622,6,-140.0,4,2,288.74,148.74
37614,U35181,6,-3893.89,4,2,11894.0,8000.110000000001
37615,U37425,6,5156.66,2,4,5156.66,10313.32
37616,U1220831,6,-24.029999999999944,4,2,2024.06,2000.03
37617,U22155,6,-63223.44,4,2,113231.69,50008.25
37618,U14618,6,-231.6400000000001,2,4,2032.2,1800.56
37619,U14762,6,4145.0599999999995,2,4,263.74,4408.799999999999
37620,U23351,6,5003.61,2,4,3737.5,8741.11
37621,U37173,6,3931.3,1,5,75.7,4007.0
37622,U22849,6,-292.869999999999,2,4,28372.0,28079.13
37623,U29287,6,-28.289999999988357,3,3,500030.0,500001.71
37624,U31900,6,48333.9,3,3,8843.1,57177.0
37625,U23927,6,-384.71000000000004,4,2,389.0,4.289999999999964
37626,U23433,6,487.23,2,4,35.0,522.23
37627,U40957,6,-2629.360000000015,3,3,181830.72,179201.36
37628,U27022,6,-318.54999999999995,4,2,620.0,301.45000000000005
37629,U671156,6,290.2,4,2,309.8,600.0
37630,U8307,6,100.27999999999997,1,5,2000.0,2100.2799999999997
37631,U1284826,6,0.0,3,3,3.0,3.0
37632,U26294,6,-473.5,2,4,2632.0,2158.5
37633,U33732,6,28.959999999999923,3,3,4171.139999999999,4200.099999999999
37634,U10049,6,571.07,3,3,616.0,1187.0700000000002
37635,U13637,6,8544.970000000001,1,5,3562.0,12106.970000000001
37636,U1384912,6,-1769.7099999999998,5,1,1770.7099999999998,1.0
37637,U28155,6,0.0,3,3,994.7100000000002,994.7100000000002
37638,U39362,6,36767.92,0,6,0.0,36767.92
37639,U35124,6,12808.54,2,4,6.0,12814.54
37640,U27285,6,-2.4299999999998363,3,3,4200.0,4197.57
37641,U25866,6,10.030000000000001,4,2,40.0,50.03
37642,U971376,6,-127.0,4,2,9755.0,9628.0
37643,U33814,6,-489.99,3,3,1140.4099999999999,650.4199999999998
37644,U30058,6,-939.2599999999999,3,3,2931.2999999999997,1992.04
37645,U43792,6,-112.74000000000001,3,3,526.0,413.26
37646,U1177083,6,-2030.09,4,2,2050.1000000000004,20.010000000000446
37647,U23047,6,221337.16,2,4,2490.1,223827.26
37648,U32897,6,-196.67000000000002,3,3,580.0,383.33
37649,U16617,6,51.01000000000022,3,3,17866.96,17917.97
37650,U20305,6,-14539.19,3,3,38542.25,24003.059999999998
37651,U27802,6,-82.99,4,2,304.0,221.01
37652,U42895,6,-0.7000000000007276,4,2,15378.6,15377.9
37653,U22469,6,38104.72,3,3,23895.42,62000.14
37654,U25783,6,298.11,2,4,402.0,700.11
37655,U24447,6,954.57,4,2,47.21,1001.7800000000001
37656,U29080,6,24.679999999993015,3,3,303291.0,303315.68
37657,U32702,6,2136.11,2,4,4270.78,6406.889999999999
37658,U1249339,6,199.99999999999997,2,4,103.54,303.53999999999996
37659,U641445,6,-1737.39,6,0,1737.39,0.0
37660,U29515,6,-10013.699999999999,4,2,10113.8,100.10000000000036
37661,U32417,6,14616.5,3,3,7183.51,21800.010000000002
37662,U22698,6,-119766.40000000002,2,4,220000.0,100233.59999999998
37663,U10481,6,100.01000000000002,2,4,100.0,200.01000000000002
37664,U831263,6,-693.6700000000001,4,2,693.86,0.18999999999994088
37665,U25078,6,16557.65,2,4,129.0,16686.65
37666,U25279,6,4.059999999997672,3,3,38600.0,38604.06
37667,U24261,6,-723316.04,1,5,3500000.0,2776683.96
37668,U9713,6,0.05999999999949068,4,2,9080.0,9080.06
37669,U785514,6,0.12000000000000455,3,3,498.02,498.14
37670,U1148148,6,-5181.21,5,1,5681.21,500.0
37671,U24550,6,-111.75,5,1,112.0,0.25
37672,U44052,6,7.909999999999997,4,2,87.0,94.91
37673,U43566,6,-40.0,4,2,3070.0,3030.0
37674,U30237,6,67.67000000000007,3,3,7866.82,7934.49
37675,U1246877,6,3660.72,4,2,2139.2799999999997,5800.0
37676,U21874,6,1412015.7400000002,1,5,1409892.0,2821907.74
37677,U986082,6,120.32,2,4,200.0,320.32
37678,U39312,6,-540.3800000000001,2,4,10248.0,9707.619999999999
37679,U9336,6,2631.430000000002,4,2,23378.399999999998,26009.83
37680,U18071,6,-30668.93,2,4,53000.0,22331.07
37681,U23953,6,861.5,2,4,1526.26,2387.76
37682,U10905,6,-497.31999999999994,2,4,10101.0,9603.68
37683,U41060,6,-30.41999999999999,3,3,505.32000000000005,474.90000000000003
37684,U40646,6,-2424.9300000000003,4,2,20425.0,18000.07
37685,U33254,6,-179.23000000000002,3,3,800.0,620.77
37686,U40372,6,48.49000000000001,2,4,2574.48,2622.9700000000003
37687,U38442,6,7684.77,1,5,100.0,7784.77
37688,U41671,6,63081.060000000005,0,6,0.0,63081.060000000005
37689,U894633,6,-354.87999999999994,5,1,555.02,200.14000000000004
37690,U1277870,6,1.3199999999999932,4,2,65.81,67.13
37691,U34886,6,0.0500000000001819,3,3,6755.0,6755.05
37692,U755398,6,250.25000000000003,1,5,4.0,254.25000000000003
37693,U24405,6,-539.59,5,1,539.8,0.2099999999999227
37694,U10101,6,-1203.0,3,3,6942.0,5739.0
37695,U931904,6,-2291.1,6,0,2291.1,0.0
37696,U27657,6,-565.37,4,2,565.9200000000001,0.5500000000000682
37697,U19259,6,-6.9399999999996,3,3,7039.5,7032.56
37698,U29999,6,5058.639999999999,2,4,7699.4400000000005,12758.08
37699,U1306188,6,-169.06,5,1,1169.06,1000.0
37700,U35458,6,-15795.729999999998,3,3,20049.35,4253.620000000001
37701,U39148,6,842.0200000000004,2,4,6000.0,6842.02
37702,U38793,6,24520.6,1,5,664.0,25184.6
37703,U16505,6,69964.56,2,4,261.0,70225.56
37704,U11369,6,2507.4299999998884,1,5,3800000.0,3802507.4299999997
37705,U37323,6,44445.92000000001,1,5,750000.0,794445.92
37706,U8470,6,-911.85,2,4,950.0,38.14999999999998
37707,U36807,6,7615.43,2,4,26.0,7641.43
37708,U43885,6,50.01000000000931,2,4,70000.0,70050.01000000001
37709,U20932,6,1770.6000000000004,3,3,3137.0,4907.6
37710,U43250,6,3983.49,4,2,1020.0,5003.49
37711,U26142,6,1475.71,2,4,41.52,1517.23
37712,U30626,6,4362.96,3,3,721.0,5083.96
37713,U43340,6,9426.98,2,4,7000.0,16426.98
37714,U29596,6,7712.35,3,3,1000.0,8712.35
37715,U944769,6,-0.7300000000004729,3,3,7612.0,7611.2699999999995
37716,U43343,6,-20100.0,4,2,21010.0,910.0
37717,U21819,6,9433.160000000002,2,4,3511.1,12944.260000000002
37718,U31178,6,-11.190000000000001,3,3,37.49,26.3
37719,U42701,6,959.5,4,2,41.5,1001.0
37720,U43307,6,0.0,3,3,5400.0,5400.0
37721,U36611,6,4663.660000000001,2,4,16142.0,20805.66
37722,U36493,6,-3320.01,3,3,3340.02,20.009999999999764
37723,U16209,6,-249.3799999999901,2,4,172750.0,172500.62
37724,U1259300,6,100.02,2,4,20.0,120.02
37725,U1056732,6,2924.47,4,2,76.53999999999999,3001.0099999999998
37726,U849282,6,-1.219999999999999,5,1,10.780000000000001,9.560000000000002
37727,U14796,6,15089.050000000001,2,4,10.92,15099.970000000001
37728,U670100,6,-1420.0,4,2,1720.0,300.0
37729,U42809,6,-334.15999999999985,2,4,10150.0,9815.84
37730,U1120940,6,75.01,2,4,6.0,81.01
37731,U13479,6,0.49000000000116417,2,4,37510.0,37510.49
37732,U33611,6,-298.23999999999796,5,1,29618.239999999998,29320.0
37733,U1192731,6,-3933.34,5,1,3933.3500000000004,0.010000000000218279
37734,U26567,6,-3705.58,3,3,4178.9,473.3199999999997
37735,U1342920,6,136.43999999999997,3,3,382.87,519.31
37736,U39191,6,124200.85,0,6,0.0,124200.85
37737,U37260,6,373730.13,4,2,340000.0,713730.13
37738,U1139981,6,-35.79,4,2,61.81,26.020000000000003
37739,U23502,6,7502.57,2,4,14821.96,22324.53
37740,U12906,6,-706814.0,4,2,707189.96,375.95999999996275
37741,U41068,6,96.69999999999999,2,4,117.6,214.29999999999998
37742,U19351,6,11460.04,2,4,2720.65,14180.69
37743,U21172,6,-2581.84,4,2,2885.1000000000004,303.2600000000002
37744,U42332,6,1307.96,3,3,14040.0,15347.96
37745,U34420,6,-887.450000000003,2,4,120216.49,119329.04000000001
37746,U1228791,6,-538.48,5,1,539.34,0.8600000000000136
37747,U43101,6,-5067.99,5,1,5068.0,0.010000000000218279
37748,U970787,6,-10.0,4,2,2010.0,2000.0
37749,U17224,6,8497.650000000001,4,2,1503.89,10001.54
37750,U38949,6,-1901.02,2,4,52000.0,50098.98
37751,U19305,6,27873.09,1,5,21870.0,49743.09
37752,U9667,6,12020.5,0,6,0.0,12020.5
37753,U9187,6,4216.74,3,3,3588.0,7804.74
37754,U641905,6,200.0,3,3,1.0,201.0
37755,U12859,6,-28996.59,3,3,39800.0,10803.41
37756,U37917,6,3548.09,2,4,69.0,3617.09
37757,U12849,6,-37983.24,4,2,38000.0,16.760000000002037
37758,U40721,6,-32.590000000000146,3,3,2265.8,2233.21
37759,U32597,6,48868.009999999995,2,4,196.0,49064.009999999995
37760,U1204356,6,11.079999999999927,3,3,1461.2,1472.28
37761,U933657,6,-2093.96,4,2,2544.1,450.1399999999999
37762,U809796,6,-0.8800000000000523,3,3,1701.0,1700.12
37763,U21778,6,552.0999999999999,4,2,2502.35,3054.45
37764,U1165050,6,-538.1599999999999,5,1,1038.1599999999999,500.0
37765,U42349,6,3249.5299999999997,2,4,4016.0,7265.53
37766,U36453,6,464.1000000000002,2,4,3536.89,4000.9900000000002
37767,U11483,6,-3029.87,3,3,6197.39,3167.5200000000004
37768,U19560,6,633.3000000000001,2,4,635.2,1268.5
37769,U29190,6,305773.54,1,5,300.0,306073.54
37770,U662233,6,-2526.61,4,2,2555.92,29.309999999999945
37771,U30230,6,-548.8799999999998,4,2,5708.88,5160.0
37772,U20591,6,13939.53,0,6,0.0,13939.53
37773,U43478,6,-99556.92,5,1,100316.92,760.0
37774,U34417,6,-2120.32,4,2,2542.0,421.67999999999984
37775,U27865,6,1360.57,1,5,1000.0,2360.5699999999997
37776,U813357,6,-9.759999999999991,4,2,2665.0,2655.24
37777,U28397,6,0.0,4,2,1282.1,1282.1
37778,U1369754,6,-1030.91,5,1,1030.94,0.029999999999972715
37779,U23805,6,5968.860000000001,2,4,9718.38,15687.24
37780,U11753,6,-2670.2399999998743,2,4,1480000.0,1477329.7600000002
37781,U40933,6,-415.21,4,2,1278.38,863.1700000000001
37782,U35226,6,3.5799999999999272,2,4,12159.0,12162.58
37783,U37987,6,245.2299999999998,1,5,2199.0,2444.2299999999996
37784,U14543,6,15789.940000000002,2,4,50000.0,65789.94
37785,U1253743,6,1.3100000000004002,3,3,8470.59,8471.900000000001
37786,U900351,6,1030.03,1,5,650.0,1680.03
37787,U34174,6,763.7199999999998,2,4,6496.8,7260.52
37788,U43063,6,2635.51,2,4,874.11,3509.6200000000003
37789,U17868,6,13627.48,2,4,36425.7,50053.17999999999
37790,U958128,6,-57.58000000000009,4,2,734.18,676.5999999999999
37791,U10688,6,-1185.8900000000015,2,4,51350.0,50164.11
37792,U24446,6,-44.05,5,1,45.0,0.9500000000000028
37793,U38311,6,-16024.64,2,4,22061.91,6037.27
37794,U11817,6,500.85,2,4,562.5,1063.35
37795,U32738,6,35792.259999999995,1,5,41238.72,77030.98
37796,U1275083,6,-912.1399999999999,4,2,3057.92,2145.78
37797,U8787,6,-5.930000000000007,4,2,256.0,250.07
37798,U23715,6,10182.279999999999,2,4,10340.28,20522.559999999998
37799,U989038,6,0.5300000000000409,3,3,3364.9300000000003,3365.4600000000005
37800,U18297,6,-52590.95,2,4,53000.0,409.0500000000029
37801,U959228,6,-15.440000000000001,5,1,16.44,1.0
37802,U23560,6,-439.97,5,1,443.65,3.67999999999995
37803,U27675,6,-0.48,2,4,1530.0,1529.52
37804,U31198,6,-159875.64,1,5,160000.0,124.35999999998603
37805,U25987,6,1864.04,2,4,183.58,2047.62
37806,U34695,6,458.5199999999968,2,4,70000.0,70458.51999999999
37807,U654048,6,6175.52,4,2,24.5,6200.02
37808,U24901,6,-154.05,3,3,1154.12,1000.0699999999999
37809,U36309,6,158000.0,0,6,0.0,158000.0
37810,U34230,6,-9997.87,4,2,15648.0,5650.129999999999
37811,U9838,6,11.010000000000218,3,3,5877.0,5888.01
37812,U18431,6,716.8499999999999,3,3,3284.96,4001.81
37813,U1382373,6,116.67999999999995,5,1,693.3199999999999,809.9999999999999
37814,U42642,6,586.89,2,4,3869.92,4456.81
37815,U43874,6,-131.8700000000008,3,3,11620.0,11488.13
37816,U39268,6,709.13,2,4,37772.990000000005,38482.12
37817,U24648,6,-0.060000000000000005,6,0,0.060000000000000005,0.0
37818,U966683,6,-32.32,4,2,33.34,1.0200000000000031
37819,U22837,6,1285.5499999999993,4,2,10468.0,11753.55
37820,U28226,6,1643.4800000000002,3,3,4658.42,6301.900000000001
37821,U42857,6,-438.57,4,2,516.37,77.80000000000001
37822,U1249761,6,-0.1699999999998545,3,3,1788.59,1788.42
37823,U8044,6,-15.92,5,1,18.0,2.08
37824,U19930,6,0.009999999999990905,3,3,1530.0,1530.01
37825,U11819,6,215.02000000000044,3,3,4760.0,4975.02
37826,U36564,6,13.420000000001455,2,4,17373.62,17387.04
37827,U37442,6,91070.41,3,3,29000.0,120070.41
37828,U577163,6,-37703.46,3,3,38253.49,550.0299999999988
37829,U14835,6,-683.6200000000001,4,2,1369.1399999999999,685.5199999999998
37830,U34100,6,5600.779999999999,2,4,4767.77,10368.55
37831,U27375,6,-56.84,4,2,300060.0,300003.16
37832,U39589,6,-193937.94999999998,1,5,1700000.0,1506062.05
37833,U22806,6,20.650000000000006,2,4,231.0,251.65
37834,U18525,6,-1873.8099999999977,4,2,251888.0,250014.19
37835,U11784,6,-89.57,5,1,89.6,0.030000000000001137
37836,U41110,6,-2640.24,3,3,8849.86,6209.620000000001
37837,U9023,6,-8352.740000000002,2,4,18824.64,10471.899999999998
37838,U1184274,6,-28.020000000000437,4,2,5954.96,5926.94
37839,U38525,6,0.010000000000218279,2,4,5569.95,5569.96
37840,U33722,6,-155.96,4,2,3094.0,2938.04
37841,U42844,6,84352.11,1,5,3634.0,87986.11
37842,U36275,6,-106623.24,3,3,108625.0,2001.7599999999948
37843,U35620,6,-982.6199999999999,3,3,4781.0,3798.38
37844,U760833,6,3085.01,3,3,15.0,3100.01
37845,U23432,6,0.0,3,3,92600.0,92600.0
37846,U954223,6,1070.0,2,4,1070.0,2140.0
37847,U33678,6,3240.3099999999995,3,3,5000.0,8240.31
37848,U32092,6,5001.03,3,3,75000.0,80001.03
37849,U22223,6,33197.36,3,3,16810.0,50007.36
37850,U33522,6,24087.01,4,2,25913.0,50000.009999999995
37851,U24536,6,-2758.3700000000244,2,4,300000.0,297241.63
37852,U39429,6,29900.94,2,4,2.0,29902.94
37853,U28268,6,1578.33,3,3,9228.56,10806.89
37854,U10201,6,-7342.79,2,4,9999.0,2656.21
37855,U25048,6,-6.79,4,2,20.0,13.21
37856,U35717,6,7853.279999999999,2,4,8696.0,16549.28
37857,U12241,6,-5.3100000000000005,3,3,6.01,0.6999999999999993
37858,U8465,6,27270.15,2,4,9.0,27279.15
37859,U616614,6,859.8199999999999,2,4,300.0,1159.82
37860,U32641,6,0.29,3,3,372.1,372.39000000000004
37861,U30796,6,-4.529999999999973,5,1,2004.53,2000.0
37862,U1022656,6,4.001798892261377e-13,3,3,7454.06,7454.06
37863,U761267,6,1253.629999999992,1,5,70000.0,71253.62999999999
37864,U25977,6,-530.52,5,1,534.5,3.980000000000018
37865,U41793,6,-1007.8200000000002,4,2,2022.96,1015.1399999999999
37866,U20520,6,-290.26,5,1,1078.26,788.0
37867,U1230758,6,-0.00999999999999801,4,2,60.01,60.0
37868,U16333,6,-479.15999999999997,5,1,479.55999999999995,0.39999999999997726
37869,U33292,6,2342.23,3,3,4504.389999999999,6846.619999999999
37870,U39423,6,-2.27,3,3,7.0,4.73
37871,U38951,6,1273.6299999999999,2,4,1942.4,3216.0299999999997
37872,U29725,6,38564.75,2,4,2627.7,41192.45
37873,U26751,6,-91.41,3,3,160.0,68.59
37874,U40935,6,40064.700000000004,1,5,19.16,40083.86000000001
37875,U36313,6,10202.95,1,5,0.01,10202.960000000001
37876,U1154629,6,7049.0,4,2,2950.0,9999.0
37877,U34177,6,141368.38999999998,1,5,1000.0,142368.38999999998
37878,U27812,6,5.910000000000073,3,3,5090.110000000001,5096.02
37879,U39398,6,-9598.550000000001,2,4,10200.0,601.4499999999989
37880,U1095374,6,-880.68,4,2,880.9399999999999,0.2599999999999909
37881,U35030,6,1648.77,3,3,3000.0,4648.77
37882,U31896,6,-30071.1,4,2,30410.0,338.90000000000146
37883,U33947,6,-7982.05,3,3,12020.0,4037.95
37884,U22397,6,-556.0,4,2,40976.0,40420.0
37885,U1362959,6,-3369.5,5,1,3369.56,0.05999999999994543
37886,U42006,6,-10069.96,4,2,11081.98,1012.0200000000004
37887,U1114358,6,0.0,3,3,941.1300000000001,941.1300000000001
37888,U28974,6,-177.16999999999982,1,5,10000.0,9822.83
37889,U33713,6,7989.62,3,3,14.6,8004.22
37890,U17705,6,-64.18999999999998,2,4,168.28,104.09000000000002
37891,U1041736,6,-2900.0,3,3,3300.0,400.0
37892,U22376,6,57.01000000000022,3,3,3770.0,3827.01
37893,U29646,6,159.78,3,3,1898.4,2058.1800000000003
37894,U751476,6,0.12000000000004547,3,3,851.96,852.08
37895,U24697,6,4294.61,3,3,4317.51,8612.119999999999
37896,U25083,6,-105.82,5,1,105.94,0.12000000000000455
37897,U16166,6,-60.0,6,0,60.0,0.0
37898,U38620,6,-117.69999999999982,3,3,3229.0,3111.3
37899,U41552,6,-119.9,3,3,310.0,190.1
37900,U11602,6,32874.93,4,2,9134.0,42008.93
37901,U23729,6,201.59000000000015,3,3,16705.06,16906.65
37902,U19727,6,8001.049999999999,2,4,14701.3,22702.35
37903,U22060,6,-420.28,5,1,424.0,3.7200000000000273
37904,U30454,6,560.86,1,5,650.0,1210.8600000000001
37905,U25500,6,-24957.41,3,3,43888.880000000005,18931.470000000005
37906,U14137,6,3624.34,2,4,8904.5,12528.84
37907,U1312863,6,100.0,3,3,650.0,750.0
37908,U26632,6,0.3100000000013097,3,3,30020.0,30020.31
37909,U1201353,6,-423.0,5,1,423.48,0.4800000000000182
37910,U635265,6,1.7800000000000296,5,1,638.22,640.0
37911,U35631,6,-23639.7,6,0,23639.7,0.0
37912,U34064,6,5284.490000000001,1,5,10000.0,15284.490000000002
37913,U18142,6,23641.91,2,4,18436.0,42077.91
37914,U21019,6,-24974.280000000002,5,1,25044.7,70.41999999999825
37915,U38312,6,-49985.27,4,2,50013.0,27.7300000000032
37916,U21400,6,-39.17,4,2,40.0,0.8299999999999983
37917,U20933,6,4628.049999999999,3,3,10450.0,15078.05
37918,U927009,6,400.1199999999999,3,3,2906.0,3306.12
37919,U19195,6,10013.570000000002,2,4,1010.0,11023.570000000002
37920,U35648,6,8736.34,3,3,15000.01,23736.35
37921,U33360,6,-4186.0,4,2,5358.0,1172.0
37922,U37052,6,-40141.46,1,5,100000.0,59858.54
37923,U660387,6,-1213.54,6,0,1213.54,0.0
37924,U1247628,6,265.02,3,3,196.98,462.0
37925,U12636,6,-1143.56,4,2,4567.860000000001,3424.3000000000006
37926,U40855,6,724.16,2,4,3514.14,4238.3
37927,U26303,6,-449635.89,3,3,941406.67,491770.78
37928,U30225,6,-183.25,6,0,183.25,0.0
37929,U31089,6,-326.55,3,3,2237.3,1910.7500000000002
37930,U28776,6,-0.07000000000061846,4,2,6441.860000000001,6441.79
37931,U676999,6,640.0,4,2,1140.0,1780.0
37932,U38994,6,-77.90999999999985,3,3,5343.0,5265.09
37933,U32228,6,6000.49,2,4,83800.0,89800.49
37934,U1079056,6,0.9700000000000273,4,2,2000.03,2001.0
37935,U1304828,6,2200.01,2,4,300.0,2500.01
37936,U33106,6,-13230.6,5,1,13241.0,10.399999999999636
37937,U1268973,6,0.01999999999679858,3,3,50000.02,50000.03999999999
37938,U1180791,6,-53.96,5,1,53.98,0.01999999999999602
37939,U31381,6,-200.71000000000004,4,2,1154.99,954.28
37940,U988442,6,4.0,1,5,100.0,104.0
37941,U40377,6,-419.70000000000005,4,2,640.0,220.29999999999995
37942,U614922,6,100.94999999999999,3,3,1.0,101.94999999999999
37943,U32124,6,-5056.14,5,1,5060.17,4.029999999999745
37944,U27144,6,304.91999999999996,2,4,41.0,345.91999999999996
37945,U1298401,6,70.30999999999992,4,2,619.97,690.28
37946,U35252,6,24551.199999999997,1,5,6000.0,30551.199999999997
37947,U33224,6,-56.78,3,3,140.01,83.22999999999999
37948,U16821,6,-122.24999999999999,2,4,245.32,123.07000000000001
37949,U35057,6,-445.78000000000065,3,3,8646.0,8200.22
37950,U734569,6,571.0,2,4,2928.0,3499.0
37951,U716051,6,-52.00999999999999,4,2,112.03,60.02000000000001
37952,U1122728,6,-15486.720000000001,4,2,18486.72,3000.0
37953,U25860,6,-7181.13,3,3,26398.54,19217.41
37954,U29678,6,-98.82000000000002,3,3,498.90999999999997,400.0899999999999
37955,U40606,6,43724.43,0,6,0.0,43724.43
37956,U1109809,6,-2.220446049250313e-16,3,3,310.7,310.7
37957,U26738,6,-29.670000000000528,3,3,5174.0,5144.33
37958,U31383,6,0.5,3,3,475.1,475.6
37959,U22218,6,-199.77,4,2,206.0,6.22999999999999
37960,U23918,6,-65.00999999999999,3,3,1225.8,1160.79
37961,U835065,6,0.0,4,2,12380.44,12380.44
37962,U30336,6,-14838.74,1,5,15000.0,161.26000000000022
37963,U31937,6,232562.63000000024,1,5,3000000.0,3232562.6300000004
37964,U40767,6,1451.55,3,3,224.0,1675.55
37965,U19247,6,-44.92,3,3,50.06,5.140000000000001
37966,U43763,6,-267.5599999999977,4,2,63588.0,63320.44
37967,U1079566,6,-10.0,4,2,15.24,5.24
37968,U1183564,6,500.0,3,3,150.0,650.0
37969,U41680,6,-175.9,2,4,320.0,144.1
37970,U42910,6,7.420000000000073,4,2,11146.91,11154.33
37971,U16029,6,0.7400000000000233,3,3,570.49,571.23
37972,U37181,6,-919.0300000000002,2,4,4271.0,3351.97
37973,U11258,6,12832.04,1,5,412.0,13244.04
37974,U32561,6,-3045.5699999999997,2,4,16000.0,12954.43
37975,U16386,6,-3111.96,5,1,3155.0,43.039999999999964
37976,U18620,6,-3752.8700000000003,2,4,7517.64,3764.77
37977,U24203,6,6242.539999999999,2,4,12560.96,18803.5
37978,U8809,6,-4510.77,3,3,13000.0,8489.23
37979,U43367,6,0.9499999999970896,3,3,50029.48,50030.43
37980,U42712,6,760.0,4,2,38340.0,39100.0
37981,U34009,5,2117.0,3,2,106.0,2223.0
37982,U15004,5,13.769999999996799,2,3,51033.95,51047.719999999994
37983,U18780,5,42.169999999999995,2,3,18.0,60.169999999999995
37984,U10563,5,-8389.07,4,1,8390.32,1.25
37985,U29781,5,5537.69,2,3,298.31,5836.0
37986,U17971,5,-26906.49,3,2,27010.0,103.5099999999984
37987,U13006,5,20547.690000000002,0,5,0.0,20547.690000000002
37988,U24096,5,13931.48,2,3,1382.44,15313.92
37989,U21536,5,6600.0,1,4,25.75,6625.75
37990,U22058,5,5547.92,0,5,0.0,5547.92
37991,U673981,5,-1629.59,4,1,1629.6,0.009999999999990905
37992,U30279,5,4.0900000000001455,2,3,13006.64,13010.73
37993,U28609,5,-219.27,4,1,220.0,0.7299999999999898
37994,U30778,5,3.349999999999995,2,3,1697.62,1700.9699999999998
37995,U40415,5,-62.89000000000124,2,3,19140.0,19077.11
37996,U13949,5,457.6,2,3,358.0,815.6
37997,U37931,5,-287.48,3,2,687.67,400.18999999999994
37998,U31496,5,-12.209999999999999,2,3,13.719999999999999,1.5099999999999998
37999,U38888,5,-823.37,3,2,874.0,50.629999999999995
38000,U716896,5,-6767.039999999999,4,1,6767.0599999999995,0.020000000000436557
38001,U12343,5,0.23999999999796273,2,3,29385.0,29385.239999999998
38002,U17459,5,-12.840000000000218,3,2,2996.84,2984.0
38003,U20861,5,-25.84,4,1,26.0,0.16000000000000014
38004,U23802,5,6123.74,2,3,17688.809999999998,23812.549999999996
38005,U27089,5,649.6699999999983,1,4,30000.0,30649.67
38006,U23939,5,-76473.37,2,3,76581.46,108.09000000001106
38007,U24964,5,-308.77,2,3,814.4,505.63
38008,U35786,5,-294.88999999999993,2,3,3291.61,2996.7200000000003
38009,U634530,5,-7866.3099999999995,4,1,7866.66,0.3500000000003638
38010,U615955,5,0.0,3,2,2.0,2.0
38011,U975252,5,6323.46,0,5,0.0,6323.46
38012,U19497,5,-6363.18,4,1,6383.0,19.81999999999971
38013,U702883,5,0.02,2,3,160.02,160.04000000000002
38014,U40595,5,-915.51,2,3,1946.0,1030.49
38015,U1122886,5,4820.01,0,5,0.0,4820.01
38016,U43924,5,4.240000000001601,2,3,11036.38,11040.62
38017,U38611,5,737.0,3,2,6760.0,7497.0
38018,U25497,5,-3847.15,3,2,3981.0,133.8499999999999
38019,U21359,5,-559.46,1,4,600.0,40.539999999999964
38020,U20944,5,826.5,3,2,643.5,1470.0
38021,U37026,5,1146.98,0,5,0.0,1146.98
38022,U1238406,5,-704.97,4,1,704.98,0.009999999999990905
38023,U29286,5,-7689.120000000001,2,3,11696.0,4006.879999999999
38024,U43154,5,-758.48,2,3,2811.27,2052.79
38025,U14265,5,0.8100000000002296,2,3,10204.2,10205.01
38026,U24305,5,-58.77999999999997,2,3,1159.0,1100.22
38027,U19299,5,2001.43,3,2,3000.0,5001.43
38028,U21411,5,2.7299999999995634,2,3,8998.3,9001.029999999999
38029,U575799,5,4480.62,2,3,304.0,4784.62
38030,U37063,5,-1833.3600000000001,4,1,1833.4,0.03999999999996362
38031,U712543,5,2790.0,2,3,10.0,2800.0
38032,U12892,5,-29120.04,1,4,30000.0,879.9599999999991
38033,U26616,5,-134945.05,3,2,140220.0,5274.950000000012
38034,U9908,5,-179.98000000000002,2,3,5576.0,5396.02
38035,U1033701,5,5.08,0,5,0.0,5.08
38036,U12689,5,-2110.54,2,3,2512.77,402.23
38037,U30403,5,-24.520000000000003,3,2,56.0,31.479999999999997
38038,U755461,5,-11.76,4,1,11.78,0.019999999999999574
38039,U23329,5,3925.8300000000017,1,4,60000.0,63925.83
38040,U31672,5,601.1099999999988,2,3,24000.0,24601.11
38041,U19328,5,-16.950000000000045,2,3,1100.0,1083.05
38042,U11202,5,-11605.66,4,1,11606.0,0.3400000000001455
38043,U750081,5,-3825.4,5,0,3825.4,0.0
38044,U33383,5,9891.59,1,4,2000.0,11891.59
38045,U610976,5,590.78,3,2,3331.2200000000003,3922.0
38046,U30001,5,0.47000000000116415,2,3,400000.0,400000.47
38047,U941070,5,-2126.23,4,1,2526.23,400.0
38048,U697530,5,0.010000000000003126,2,3,20.01,20.020000000000003
38049,U38466,5,-3996.38,3,2,8000.0,4003.62
38050,U35542,5,-1678.0700000000002,3,2,3439.25,1761.1799999999998
38051,U1172313,5,-59.01,3,2,61.0,1.990000000000002
38052,U1300170,5,267.0,2,3,326.01,593.01
38053,U29078,5,10335.59,0,5,0.0,10335.59
38054,U36494,5,-17467.01,3,2,21508.0,4040.9900000000016
38055,U674674,5,176.0999999999999,3,2,900.0,1076.1
38056,U1168941,5,1985.01,2,3,2015.0,4000.01
38057,U13273,5,129.94999999999996,2,3,171.0,300.94999999999993
38058,U21649,5,960.29,2,3,449.79999999999995,1410.09
38059,U28552,5,4.0900000000001455,2,3,10104.79,10108.880000000001
38060,U42526,5,2403.34,3,2,7600.0,10003.34
38061,U36707,5,-9.094947017729282e-13,2,3,12670.14,12670.14
38062,U12085,5,1.679999999993015,2,3,100000.0,100001.68
38063,U9040,5,0.01999999999998181,2,3,300.35,300.37
38064,U15275,5,-2965.91,3,2,2995.05,29.140000000000327
38065,U1379241,5,50.0,3,2,6750.0,6800.0
38066,U31647,5,-0.06999999999992725,2,3,8445.0,8444.93
38067,U18811,5,3876.7099999999996,1,4,55000.0,58876.71
38068,U27519,5,541.6700000000001,2,3,8963.28,9504.95
38069,U38224,5,3841.34,2,3,2889.0,6730.34
38070,U40851,5,-1154.78,3,2,1600.0,445.22
38071,U39266,5,8049.9800000000005,2,3,6.0,8055.9800000000005
38072,U44029,5,16754.760000000002,0,5,0.0,16754.760000000002
38073,U41797,5,734.5,3,2,1020.0,1754.5
38074,U34861,5,-7578.549999999999,3,2,13000.0,5421.450000000001
38075,U20614,5,84.5999999999996,2,3,7233.56,7318.16
38076,U37221,5,75.6899999999996,2,3,11268.04,11343.73
38077,U40625,5,0.13999999999998636,2,3,139.6,139.73999999999998
38078,U19249,5,371.91,3,2,676.0,1047.91
38079,U25228,5,7930.57,2,3,2080.62,10011.189999999999
38080,U33696,5,11819.050000000001,0,5,0.0,11819.050000000001
38081,U20291,5,9.86999999999989,2,3,5000.0,5009.87
38082,U29540,5,-3060.0299999999997,4,1,3088.0,27.970000000000255
38083,U18688,5,499.9499999999971,2,3,68001.07,68501.02
38084,U10777,5,0.04000000000000625,2,3,100.01,100.05000000000001
38085,U38920,5,-9.91,2,3,20.0,10.09
38086,U29395,5,-15.949999999999818,2,3,15100.0,15084.05
38087,U41539,5,0.12999999999738066,2,3,31272.0,31272.129999999997
38088,U38819,5,27.50999999999999,2,3,1238.0,1265.51
38089,U22680,5,-16.4,4,1,51.3,34.9
38090,U33482,5,-2975.09,1,4,12000.0,9024.91
38091,U23306,5,-3599.1,3,2,4603.71,1004.6100000000001
38092,U18286,5,-8.989999999999782,2,3,15428.01,15419.02
38093,U38027,5,13066.24,2,3,2.0,13068.24
38094,U24236,5,1.259999999999991,2,3,598.8,600.06
38095,U30892,5,-299.8,2,3,485.15999999999997,185.35999999999996
38096,U40732,5,21165.09,2,3,158.0,21323.09
38097,U12499,5,-19966.51,2,3,20015.0,48.4900000000016
38098,U23296,5,25690.47,3,2,4500.0,30190.47
38099,U42407,5,3553.71,1,4,742.0,4295.71
38100,U32672,5,-719.0,2,3,818.0,99.0
38101,U34238,5,-712.97,4,1,714.4100000000001,1.4400000000000546
38102,U35135,5,2.3099999999976717,2,3,201000.0,201002.31
38103,U34212,5,-1354.06,3,2,2357.44,1003.3800000000001
38104,U33073,5,1.0199999999999996,2,3,20.0,21.02
38105,U22087,5,-26568.99,3,2,66409.0,39840.009999999995
38106,U1022320,5,339.73,3,2,260.29999999999995,600.03
38107,U19904,5,13368.59,2,3,310.14,13678.73
38108,U578708,5,-0.9099999999999966,4,1,200.91,200.0
38109,U1282240,5,0.4000000000005457,2,3,6430.0,6430.400000000001
38110,U34528,5,5525.299999999999,2,3,206.56,5731.86
38111,U25092,5,197.47999999999956,2,3,20393.16,20590.64
38112,U1108575,5,-28.87,4,1,28.89,0.019999999999999574
38113,U21081,5,-48485.56999999999,2,3,63000.0,14514.430000000008
38114,U11426,5,-117.21999999999986,2,3,11951.85,11834.630000000001
38115,U38000,5,40.05,3,2,754.97,795.02
38116,U35373,5,443.57,1,4,9.89,453.46
38117,U1167760,5,799.89,1,4,0.11,800.0
38118,U37321,5,-4815.259999999998,3,2,34823.39,30008.13
38119,U34820,5,0.0,3,2,3813.97,3813.97
38120,U14162,5,-3398.1000000000004,2,3,5000.0,1601.8999999999996
38121,U20901,5,-87.9,2,3,200.0,112.1
38122,U29009,5,-400.0,3,2,120800.0,120400.0
38123,U663225,5,-322.0,3,2,547.0,225.0
38124,U17330,5,-11980.73,2,3,12000.0,19.270000000000437
38125,U35165,5,-134.5999999999999,2,3,6700.0,6565.4
38126,U10023,5,-52.33,2,3,136.51999999999998,84.18999999999998
38127,U1177258,5,1350.15,0,5,0.0,1350.15
38128,U21139,5,572.1,1,4,128.0,700.1
38129,U22880,5,442.5600000000001,1,4,13000.0,13442.56
38130,U18990,5,64.23000000000002,2,3,6879.1,6943.33
38131,U31986,5,99290.72,1,4,0.02,99290.74
38132,U975696,5,217.49,4,1,1402.51,1620.0
38133,U957444,5,550.0,3,2,2310.0,2860.0
38134,U31454,5,2000.0,2,3,4000.0,6000.0
38135,U28919,5,496.11999999999534,2,3,133000.0,133496.12
38136,U27171,5,0.01,2,3,166.34,166.35
38137,U8404,5,-1888.5999999999985,3,2,31888.6,30000.0
38138,U24520,5,-920.5899999999997,2,3,5421.82,4501.23
38139,U22262,5,192773.21000000002,2,3,8500.0,201273.21000000002
38140,U42751,5,100.07,2,3,200.0,300.07
38141,U26752,5,10834.66,2,3,381.0,11215.66
38142,U33834,5,5780.08,1,4,5000.0,10780.08
38143,U28090,5,0.42000000000007276,2,3,15177.0,15177.42
38144,U43450,5,-2741.7200000000003,4,1,2750.8,9.079999999999927
38145,U31267,5,-14.94,3,2,15.01,0.07000000000000028
38146,U18731,5,3819.57,2,3,300.0,4119.57
38147,U26766,5,-1770.3799999999999,1,4,4000.0,2229.62
38148,U27911,5,0.8200000000001637,2,3,4000.0,4000.82
38149,U22024,5,9000.240000000005,2,3,131000.0,140000.24
38150,U36533,5,11095.349999999999,3,2,307.54,11402.89
38151,U679136,5,0.20000000000000284,3,2,59.8,60.0
38152,U1074077,5,-9.990000000000002,3,2,60.0,50.01
38153,U32319,5,-2.9800000000000004,2,3,1463.0,1460.02
38154,U34118,5,-1344.21,2,3,2690.0,1345.79
38155,U35636,5,-106.99,3,2,115.0,8.010000000000005
38156,U1217231,5,-4741.53,4,1,5248.7,507.1700000000001
38157,U41358,5,17200.25,1,4,9900.0,27100.25
38158,U12373,5,4597.3,2,3,6.0,4603.3
38159,U1052178,5,0.03,2,3,0.25,0.28
38160,U926075,5,0.10000000000000284,2,3,81.1,81.2
38161,U26115,5,1332.54,0,5,0.0,1332.54
38162,U20816,5,-4.580000000001746,3,2,20010.0,20005.42
38163,U1146553,5,690.45,2,3,909.56,1600.01
38164,U37440,5,11725.91,2,3,6.0,11731.91
38165,U36512,5,758.1800000000018,2,3,100000.01,100758.19
38166,U27884,5,1326.71,2,3,1500.0,2826.71
38167,U1124976,5,-7227.48,4,1,7227.5,0.020000000000436557
38168,U1130802,5,740.0,3,2,1060.0,1800.0
38169,U12244,5,300.15999999999997,2,3,399.85,700.01
38170,U22525,5,560.91,2,3,187.5,748.41
38171,U42645,5,-255.26,3,2,514.0,258.74
38172,U41701,5,102.95999999999185,1,4,120000.0,120102.95999999999
38173,U21332,5,-38.42,2,3,104.0,65.58
38174,U1252613,5,374.74,4,1,1278.26,1653.0
38175,U1368939,5,100.0,2,3,4.48,104.48
38176,U26660,5,-356151.56,4,1,356360.0,208.44000000000233
38177,U38505,5,73.48000000000002,2,3,203.25,276.73
38178,U1171113,5,-716.6899999999999,3,2,1244.4299999999998,527.7399999999999
38179,U764516,5,0.47,2,3,1.18,1.65
38180,U26387,5,2514.7299999999996,2,3,30000.0,32514.73
38181,U18357,5,-1.3877787807814457e-17,4,1,1.0,1.0
38182,U592796,5,1980.0,1,4,0.02,1980.02
38183,U26488,5,5228.12,2,3,6000.0,11228.119999999999
38184,U22627,5,-837.88,4,1,883.99,46.110000000000014
38185,U23610,5,7602.57,1,4,7711.13,15313.7
38186,U622403,5,-7.6200000000000045,3,2,998.09,990.47
38187,U24736,5,5023.87,2,3,2267.83,7291.7
38188,U18694,5,0.0,4,1,10.1,10.1
38189,U38216,5,2423.8399999999997,1,4,513.0,2936.8399999999997
38190,U27880,5,0.4600000000000364,2,3,2000.0,2000.46
38191,U1191927,5,-3.6100000000000003,3,2,3.63,0.019999999999999574
38192,U30294,5,0.010000000002037268,1,4,80000.0,80000.01000000001
38193,U27304,5,0.14,2,3,4000.0,4000.14
38194,U1290577,5,184.03000000000006,2,3,649.4,833.4300000000001
38195,U33720,5,0.11000000000058208,2,3,82000.0,82000.11
38196,U40492,5,-14.730000000000246,2,3,2364.78,2350.05
38197,U1102710,5,263.29999999999995,3,2,1041.98,1305.28
38198,U33234,5,483.52,2,3,199.01,682.53
38199,U43597,5,-107.17000000000007,2,3,10136.0,10028.83
38200,U18115,5,-1003.7,4,1,1756.7,753.0
38201,U16657,5,7983.430000000005,1,4,400000.0,407983.43
38202,U20607,5,-210.0,3,2,2609.0,2399.0
38203,U27658,5,418.9699999999998,2,3,2481.82,2900.79
38204,U1108795,5,-935.76,5,0,935.76,0.0
38205,U14921,5,684.6099999999999,3,2,6318.09,7002.7
38206,U25711,5,-2182.5699999999997,2,3,6624.86,4442.29
38207,U21023,5,-401.0,5,0,401.0,0.0
38208,U18254,5,1658.0,2,3,182.63,1840.63
38209,U763830,5,-550.0,2,3,750.02,200.01999999999998
38210,U1035864,5,4.0,2,3,37.0,41.0
38211,U41846,5,-304.28,2,3,1804.6,1500.32
38212,U18609,5,-49995.35,3,2,60014.11,10018.760000000002
38213,U41235,5,-1476.2399999999998,2,3,6478.29,5002.05
38214,U29423,5,-138.41,3,2,168.35999999999999,29.94999999999999
38215,U36624,5,10487.43,0,5,0.0,10487.43
38216,U23809,5,-5.3300000000000125,3,2,176.4,171.07
38217,U33176,5,-17999.399999999998,1,4,33655.0,15655.600000000002
38218,U641962,5,0.0,4,1,90.0,90.0
38219,U20543,5,3899.0299999999997,2,3,49.28,3948.31
38220,U25466,5,-0.91,3,2,1.02,0.10999999999999999
38221,U34134,5,2874.4700000000003,0,5,0.0,2874.4700000000003
38222,U13001,5,-48411.020000000004,3,2,77351.89,28940.869999999995
38223,U10945,5,0.3400000000001455,2,3,7647.82,7648.16
38224,U18716,5,1879.3400000000001,3,2,300.0,2179.34
38225,U37424,5,232.11999999999998,2,3,98.60000000000001,330.71999999999997
38226,U666324,5,81.0,3,2,1002.0,1083.0
38227,U16347,5,357.0400000000001,2,3,1266.81,1623.85
38228,U24633,5,-3864.0,4,1,4537.88,673.8800000000001
38229,U34878,5,7.579999999999927,1,4,20000.0,20007.58
38230,U31579,5,-12974.43,4,1,13024.859999999999,50.42999999999847
38231,U36403,5,4848.980000000001,1,4,2957.47,7806.450000000001
38232,U21132,5,-27.94999999999891,3,2,17886.28,17858.33
38233,U848052,5,16150.0,1,4,3300.0,19450.0
38234,U39677,5,50171.02,2,3,900.0,51071.02
38235,U1228793,5,501.87,1,4,500.0,1001.87
38236,U39202,5,35699.14,2,3,5976.0,41675.14
38237,U37174,5,94.03,2,3,2010.0,2104.03
38238,U20430,5,4.130000000000003,1,4,26.0,30.130000000000003
38239,U24455,5,-223.63,4,1,226.51999999999998,2.8899999999999864
38240,U21041,5,-164.99,2,3,10400.0,10235.01
38241,U38535,5,-10750.04,4,1,10759.0,8.959999999999127
38242,U830166,5,-5.799999999999997,3,2,60.8,55.0
38243,U14840,5,-407.14,2,3,836.95,429.81000000000006
38244,U755317,5,-2.449999999999818,3,2,4042.0,4039.55
38245,U623112,5,599.45,3,2,212.41,811.86
38246,U17644,5,-1068.6000000000004,2,3,4070.3,3001.7
38247,U1244201,5,0.0,2,3,51043.229999999996,51043.229999999996
38248,U35793,5,2085.19,2,3,47.699999999999996,2132.89
38249,U29169,5,-4540.99,3,2,5324.54,783.5500000000002
38250,U16949,5,407777.87,2,3,220.5,407998.37
38251,U39814,5,5001.51,2,3,10633.74,15635.25
38252,U28259,5,106.60999999999999,0,5,0.0,106.60999999999999
38253,U29281,5,19982.91,1,4,1800.0,21782.91
38254,U24461,5,2849.0899999999997,2,3,1.01,2850.1
38255,U1347002,5,-58.88,4,1,59.06,0.17999999999999972
38256,U19739,5,1840.51,3,2,160.0,2000.51
38257,U41303,5,-41.31000000000006,2,3,931.51,890.1999999999999
38258,U40273,5,5944.33,2,3,1000.0,6944.33
38259,U34586,5,8692.82,0,5,0.0,8692.82
38260,U19017,5,266.1500000000001,2,3,3734.62,4000.77
38261,U1011947,5,120.00999999999999,2,3,120.01,240.01999999999998
38262,U1245633,5,1300.03,1,4,420.0,1720.03
38263,U37211,5,0.0,2,3,1600.0,1600.0
38264,U38856,5,-4697.72,2,3,5300.0,602.2799999999997
38265,U41002,5,-294.22,2,3,600.0,305.78
38266,U12286,5,3820.629999999999,2,3,10056.0,13876.63
38267,U35633,5,-49.96,5,0,49.96,0.0
38268,U991717,5,-18429.21,4,1,18929.21,500.0
38269,U703239,5,-4761.110000000001,4,1,4785.12,24.00999999999931
38270,U36915,5,1.8800000000001091,2,3,11000.0,11001.880000000001
38271,U34379,5,0.5399999999999636,2,3,3146.12,3146.66
38272,U953049,5,119.69999999999993,3,2,628.1099999999999,747.8099999999998
38273,U10755,5,-2449.77,3,2,4900.0,2450.23
38274,U24368,5,-1027.52,3,2,2074.0,1046.48
38275,U39789,5,45016.51,2,3,6346.0,51362.51
38276,U34952,5,116.36999999999898,2,3,9388.28,9504.65
38277,U42321,5,30.360000000000582,2,3,6169.98,6200.34
38278,U1235636,5,-721.62,5,0,721.62,0.0
38279,U1249362,5,0.029999999999972715,2,3,958.63,958.66
38280,U685279,5,-57.98,2,3,90.0,32.02
38281,U42745,5,3.06,1,4,388.0,391.06
38282,U20077,5,0.9900000000000091,3,2,255.03,256.02
38283,U1055621,5,-1262.6399999999999,4,1,1262.6599999999999,0.01999999999998181
38284,U22287,5,-26597.99,2,3,53750.0,27152.01
38285,U35365,5,-2253.6600000000035,3,2,108149.0,105895.34
38286,U1083135,5,0.0,4,1,10.0,10.0
38287,U31940,5,480.02,2,3,2920.0,3400.02
38288,U23896,5,9.299999999999272,2,3,39216.0,39225.3
38289,U11129,5,1597.08,2,3,1903.0,3500.08
38290,U30975,5,0.05,2,3,20000.0,20000.05
38291,U31337,5,8.600000000000051,1,4,5340.0,5348.6
38292,U23050,5,-140.31,2,3,435.0,294.69
38293,U43972,5,-5104.11,3,2,5623.4,519.29
38294,U711713,5,-4952.62,4,1,4953.0,0.38000000000010914
38295,U891004,5,-1315.24,5,0,1315.24,0.0
38296,U8861,5,12691.75,0,5,0.0,12691.75
38297,U18038,5,-0.5,2,3,5793.6900000000005,5793.1900000000005
38298,U18640,5,281.3000000000029,2,3,73000.0,73281.3
38299,U20620,5,10.609999999999673,2,3,7192.1,7202.71
38300,U20887,5,-25862.5,4,1,25863.5,1.0
38301,U1066783,5,-4.57,3,2,24.57,20.0
38302,U34372,5,106.15000000000003,2,3,170.2,276.35
38303,U15384,5,90046.04999999999,3,2,150000.0,240046.05
38304,U42111,5,42.91,2,3,10.0,52.91
38305,U20951,5,4076.9,1,4,575.97,4652.87
38306,U30428,5,9.979999999999563,3,2,5000.02,5010.0
38307,U27220,5,0.0,3,2,177.73000000000002,177.73000000000002
38308,U41903,5,-1776.26,3,2,1812.0,35.74000000000001
38309,U39596,5,13609.55,1,4,800.0,14409.55
38310,U13372,5,-38029.11,2,3,48072.86,10043.75
38311,U28355,5,3763.320000000007,1,4,200000.0,203763.32
38312,U22968,5,334.1100000000001,2,3,2666.0,3000.11
38313,U1092393,5,438.22999999999996,4,1,342.8,781.03
38314,U38154,5,130.76999999999998,2,3,1279.5,1410.27
38315,U24303,5,83.1,2,3,63.9,147.0
38316,U1336175,5,699.76,2,3,455.45,1155.21
38317,U779379,5,-2213.37,4,1,2213.38,0.010000000000218279
38318,U602923,5,0.0,4,1,501.74,501.74
38319,U28704,5,-5993.7699999999995,1,4,10000.0,4006.2300000000005
38320,U10257,5,-421.73,1,4,1000.0,578.27
38321,U19702,5,-52.82999999999993,2,3,9658.0,9605.17
38322,U38461,5,-418.1700000000001,3,2,3714.36,3296.19
38323,U42611,5,5.740000000000009,2,3,3994.6,4000.34
38324,U25058,5,-1795.0,5,0,1795.0,0.0
38325,U18870,5,-48.529999999999994,3,2,88.86,40.330000000000005
38326,U37216,5,-7654.06,2,3,8921.0,1266.9399999999996
38327,U18498,5,-2.16,3,2,2.2,0.040000000000000036
38328,U24775,5,0.010000000000218279,2,3,10000.0,10000.01
38329,U37111,5,-789.8000000000002,2,3,9198.0,8408.2
38330,U13987,5,0.060000000000172804,2,3,3850.0,3850.0600000000004
38331,U29597,5,-9607.089999999997,2,3,55720.0,46112.91
38332,U27895,5,2939.03,0,5,0.0,2939.03
38333,U21913,5,40.470000000000255,2,3,9000.0,9040.470000000001
38334,U31483,5,505339.28,3,2,128600.0,633939.28
38335,U1353905,5,4.01,2,3,5.01,9.02
38336,U637916,5,-1741.66,4,1,1741.68,0.01999999999998181
38337,U35955,5,14446.960000000001,1,4,10.0,14456.960000000001
38338,U14915,5,-600.1699999999983,2,3,101700.0,101099.83
38339,U24168,5,-49970.82,1,4,50000.0,29.18000000000029
38340,U8402,5,-37.600000000000364,2,3,10100.0,10062.4
38341,U37277,5,-1356.45,3,2,1357.5,1.0499999999999545
38342,U26870,5,0.0,2,3,4744.02,4744.02
38343,U25382,5,-19999.88,4,1,20000.0,0.11999999999898137
38344,U23997,5,1608.0700000000015,3,2,10409.97,12018.04
38345,U19301,5,-1898.71,2,3,2449.06,550.3499999999999
38346,U11599,5,0.18999999999999992,2,3,6.0,6.1899999999999995
38347,U31442,5,486.0,3,2,19014.0,19500.0
38348,U1357414,5,740.0,3,2,760.0,1500.0
38349,U31233,5,1143.81,0,5,0.0,1143.81
38350,U25229,5,7.640000000001237,2,3,26080.0,26087.64
38351,U29394,5,8000.770000000019,1,4,900000.0,908000.77
38352,U37541,5,3143.33,2,3,1860.0,5003.33
38353,U18883,5,1173.09,3,2,152.91,1326.0
38354,U40540,5,-9875.97,3,2,21844.0,11968.03
38355,U939773,5,40.0,2,3,2950.0,2990.0
38356,U41289,5,-49304.46,2,3,62000.0,12695.54
38357,U35893,5,654727.33,1,4,180000.0,834727.33
38358,U36393,5,522.8799999999974,1,4,50000.0,50522.88
38359,U1121707,5,-52.25,4,1,52.3,0.04999999999999716
38360,U29444,5,2395.98,2,3,1034.5,3430.48
38361,U15778,5,-112.52999999999999,4,1,112.57,0.04000000000000625
38362,U1165611,5,-13.719999999999999,4,1,13.76,0.040000000000000924
38363,U1117921,5,0.010000000000001563,2,3,60.0,60.010000000000005
38364,U31110,5,0.010000000000218279,2,3,5150.0,5150.01
38365,U1246566,5,-14050.0,2,3,14160.0,110.0
38366,U21878,5,-2830.4600000000064,2,3,105000.0,102169.54
38367,U8413,5,6.0,2,3,20000.0,20006.0
38368,U34806,5,0.16999999999999993,2,3,20.8,20.97
38369,U31303,5,7626.75,4,1,2212.5,9839.25
38370,U15306,5,-2364.8000000000006,2,3,18600.0,16235.199999999999
38371,U38283,5,-169.83999999999992,2,3,2370.0,2200.16
38372,U26927,5,3059.67,1,4,7000.0,10059.67
38373,U36234,5,41.11000000000058,2,3,30165.28,30206.39
38374,U20941,5,0.03999999999999915,2,3,50.0,50.04
38375,U35150,5,-495.19,4,1,540.92,45.72999999999996
38376,U823884,5,-59.879999999999995,3,2,59.97,0.09000000000000341
38377,U15983,5,0.16000000000000003,2,3,0.02,0.18000000000000002
38378,U1092956,5,-9.949999999999818,3,2,2810.0,2800.05
38379,U13271,5,-129890.93,3,2,130000.0,109.07000000000698
38380,U1089628,5,-1114.1799999999998,5,0,1114.1799999999998,0.0
38381,U34268,5,-836.58,5,0,836.58,0.0
38382,U21826,5,-2924.52,4,1,2929.56,5.039999999999964
38383,U13887,5,770.83,3,2,1230.0,2000.83
38384,U664428,5,50.82000000000062,1,4,5999.2,6050.02
38385,U24039,5,0.0,2,3,99.52,99.52
38386,U33244,5,-914.9300000000001,4,1,915.6700000000001,0.7400000000000091
38387,U43592,5,1785.5,1,4,52.0,1837.5
38388,U31079,5,14632.710000000001,2,3,11260.74,25893.45
38389,U22062,5,6793.27,3,2,6100.0,12893.27
38390,U29465,5,4.547473508864641e-13,2,3,27569.36,27569.36
38391,U10437,5,-123.31,4,1,123.38,0.06999999999999318
38392,U991610,5,2.275957200481571e-15,3,2,102.99000000000001,102.99000000000001
38393,U30098,5,4.579999999999984,2,3,655.0,659.5799999999999
38394,U1039371,5,-935.0,3,2,1035.0,100.0
38395,U989956,5,-187.62,4,1,187.8,0.18000000000000682
38396,U17839,5,-5641.66,4,1,5642.0,0.3400000000001455
38397,U37636,5,-13519.81,2,3,13664.36,144.5500000000011
38398,U22109,5,0.32999999999992724,2,3,12000.0,12000.33
38399,U29357,5,6281.8,1,4,8960.0,15241.8
38400,U33606,5,17.009999999999764,2,3,3183.32,3200.33
38401,U23240,5,-949.8899999999999,2,3,2776.08,1826.19
38402,U24344,5,11086.42,1,4,39.0,11125.42
38403,U924787,5,-3.1999999999999913,3,2,103.89999999999999,100.7
38404,U12626,5,1194.0700000000002,2,3,6.0,1200.0700000000002
38405,U23312,5,466.1,4,1,509.9,976.0
38406,U22937,5,-70000.28,3,2,71888.78,1888.5
38407,U9784,5,-2915.0800000000004,2,3,5725.18,2810.1
38408,U43967,5,-163.53,3,2,164.4,0.8700000000000045
38409,U30932,5,0.01,2,3,2000.01,2000.02
38410,U19143,5,-424.3,3,2,425.87,1.5699999999999932
38411,U1167930,5,-238.09000000000003,4,1,1738.0900000000001,1500.0
38412,U25826,5,4.01,2,3,120.0,124.01
38413,U32213,5,-3897.92,4,1,3900.0,2.0799999999999272
38414,U706119,5,-7699.950000000001,4,1,17699.95,10000.0
38415,U21783,5,-57.79,3,2,45157.8,45100.01
38416,U31902,5,12652.0,1,4,6800.0,19452.0
38417,U38811,5,27530.88,0,5,0.0,27530.88
38418,U1344956,5,305.33000000000015,3,2,1530.0,1835.3300000000002
38419,U1118844,5,-1674.5500000000002,4,1,1674.5600000000002,0.009999999999990905
38420,U43474,5,10.669999999999998,1,4,17.05,27.72
38421,U33519,5,-261.40999999999997,3,2,581.0,319.59000000000003
38422,U38503,5,-1002.67,2,3,15788.0,14785.33
38423,U1227527,5,5676.24,1,4,300.0,5976.24
38424,U988278,5,100.0,2,3,200.0,300.0
38425,U1241718,5,0.1,2,3,30.1,30.200000000000003
38426,U19105,5,7862.21,1,4,426.2,8288.41
38427,U26645,5,12.2099999999998,3,2,2890.5500000000006,2902.76
38428,U1037633,5,203.86,3,2,416.14,620.0
38429,U33471,5,25036.190000000002,2,3,800.0,25836.190000000002
38430,U26710,5,-8527.89,5,0,8527.89,0.0
38431,U25671,5,-0.25,2,3,18816.25,18816.0
38432,U602745,5,-3245.28,4,1,3275.28,30.0
38433,U1302948,5,0.07000000000016371,2,3,2201.0,2201.07
38434,U18072,5,3600.33,1,4,3550.0,7150.33
38435,U26091,5,-95.05,3,2,226.9,131.85000000000002
38436,U31618,4,-289.79,3,1,290.0,0.20999999999997954
38437,U25534,4,-3564.73,1,3,3600.0,35.26999999999998
38438,U875824,4,0.0,2,2,1670.0,1670.0
38439,U28013,4,1298.97,0,4,0.0,1298.97
38440,U11829,4,-32389.48,3,1,32467.27,77.79000000000087
38441,U714980,4,436.71999999999997,0,4,0.0,436.71999999999997
38442,U928292,4,-209.0,3,1,2514.0,2305.0
38443,U10208,4,0.0,2,2,3000.0,3000.0
38444,U10171,4,-11060.66,2,2,11143.0,82.34000000000015
38445,U10222,4,-0.73,2,2,0.82,0.08999999999999997
38446,U28723,4,51.07,0,4,0.0,51.07
38447,U993828,4,1019.89,1,3,0.64,1020.53
38448,U19420,4,2380.0,2,2,2020.0,4400.0
38449,U22233,4,38.77000000000001,2,2,372.0,410.77
38450,U42847,4,21800.46,0,4,0.0,21800.46
38451,U18595,4,-1.980000000000004,2,2,102.0,100.02
38452,U20130,4,-7887.91,1,3,8000.0,112.09000000000015
38453,U23587,4,2899.1,1,3,18.9,2918.0
38454,U22645,4,0.0,2,2,580000.0,580000.0
38455,U710055,4,-3.62,3,1,43.62,40.0
38456,U12453,4,0.5,2,2,9800.01,9800.51
38457,U21934,4,12912.08,2,2,1112.24,14024.32
38458,U41424,4,46.07000000000146,1,3,60000.0,60046.07
38459,U30705,4,1625.13,2,2,77.0,1702.13
38460,U20076,4,19901.489999999998,1,3,9400.0,29301.489999999998
38461,U15310,4,88.76,1,3,10.0,98.76
38462,U39219,4,-1031.5700000000002,3,1,1035.0,3.4299999999998363
38463,U43534,4,593.98,0,4,0.0,593.98
38464,U1067066,4,-6.59,3,1,6.6,0.009999999999999787
38465,U39296,4,0.12000000000000001,1,3,0.01,0.13
38466,U40172,4,20006.12,1,3,9138.7,29144.82
38467,U10380,4,486.4400000000005,2,2,4521.4,5007.84
38468,U18616,4,-207.13999999999987,2,2,1249.0,1041.8600000000001
38469,U23970,4,-4.940000000000001,2,2,29.96,25.02
38470,U33736,4,-4409.51,1,3,5000.0,590.4899999999998
38471,U35870,4,-5800.0,2,2,15800.0,10000.0
38472,U43275,4,21.05,2,2,2.0,23.05
38473,U38495,4,762.0,2,2,100.0,862.0
38474,U23000,4,28701.25,1,3,8300.0,37001.25
38475,U12985,4,-235.52999999999997,2,2,1236.0,1000.47
38476,U611597,4,0.0,2,2,100.02,100.02
38477,U27697,4,2732.54,1,3,1000.0,3732.54
38478,U22719,4,8434.52,2,2,12000.0,20434.52
38479,U30539,4,-92.38,3,1,93.7,1.3200000000000074
38480,U39327,4,6244.38,1,3,5000.0,11244.380000000001
38481,U10739,4,-79.89000000000003,2,2,795.96,716.07
38482,U610525,4,40.0,0,4,0.0,40.0
38483,U12285,4,855.94,1,3,2977.06,3833.0
38484,U12416,4,-1547.4,2,2,1548.35,0.9499999999998181
38485,U19276,4,-32.76,3,1,32.78,0.020000000000003126
38486,U44006,4,-323.71,3,1,326.39,2.680000000000007
38487,U34948,4,496.8600000000006,1,3,24300.0,24796.86
38488,U1366555,4,80.03999999999999,0,4,0.0,80.03999999999999
38489,U798970,4,-8671.31,3,1,17341.21,8669.9
38490,U1081448,4,-0.31,3,1,0.32,0.010000000000000009
38491,U12621,4,-4999.29,2,2,5500.0,500.71000000000004
38492,U17133,4,-11963.509999999998,2,2,11993.24,29.730000000001382
38493,U18228,4,782.1300000000006,1,3,5000.0,5782.130000000001
38494,U22447,4,272.39,1,3,0.01,272.4
38495,U709136,4,0.0,2,2,0.02,0.02
38496,U701536,4,-215.84,4,0,215.84,0.0
38497,U17001,4,-20524.440000000002,2,2,20529.7,5.259999999998399
38498,U1377598,4,-151.0,3,1,5601.0,5450.0
38499,U34189,4,175.54,1,3,40.0,215.54
38500,U23169,4,390.0,2,2,61470.0,61860.0
38501,U40367,4,286.5400000000009,2,2,13213.8,13500.34
38502,U577732,4,699.57,2,2,2.21,701.7800000000001
38503,U24974,4,-422.96000000000004,3,1,423.5,0.5399999999999636
38504,U1322123,4,68.7,3,1,31.3,100.0
38505,U26704,4,-7552.389999999999,2,2,17666.0,10113.61
38506,U776724,4,1333.0500000000002,0,4,0.0,1333.0500000000002
38507,U8930,4,0.5,2,2,11.0,11.5
38508,U1117477,4,-375.9,4,0,375.9,0.0
38509,U42683,4,13499.23,0,4,0.0,13499.23
38510,U22032,4,0.30000000000001137,2,2,990.3,990.5999999999999
38511,U10225,4,2003.38,1,3,4981.52,6984.900000000001
38512,U596946,4,-29.67,2,2,40.0,10.329999999999998
38513,U18231,4,7532.11,0,4,0.0,7532.11
38514,U1007327,4,-0.6,3,1,0.9,0.30000000000000004
38515,U29851,4,394.01,1,3,186.0,580.01
38516,U802822,4,2752.0,0,4,0.0,2752.0
38517,U28000,4,-4696.33,2,2,6704.98,2008.6499999999996
38518,U9850,4,-150.7,3,1,157.12,6.420000000000016
38519,U734989,4,130.07,0,4,0.0,130.07
38520,U23148,4,2534.19,1,3,99.54,2633.73
38521,U21417,4,7747.189999999999,0,4,0.0,7747.189999999999
38522,U25679,4,1060.3,1,3,1054.93,2115.23
38523,U1136866,4,7272.0,2,2,885.0,8157.0
38524,U35984,4,-23.97,3,1,24.0,0.030000000000001137
38525,U29102,4,-1304.84,1,3,2000.0,695.1600000000001
38526,U36872,4,4816.16,1,3,200.0,5016.16
38527,U38070,4,-209.68,3,1,209.9,0.21999999999999886
38528,U21923,4,0.8599999999999921,1,3,150.0,150.85999999999999
38529,U1219472,4,-10.019999999999854,2,2,2110.03,2100.01
38530,U1157075,4,-115.32,4,0,115.32,0.0
38531,U23964,4,-7670.889999999999,1,3,9000.0,1329.1100000000006
38532,U43773,4,171.89999999999998,2,2,336.1,508.0
38533,U41177,4,-9998.99,2,2,19998.989999999998,9999.999999999998
38534,U42999,4,0.0,2,2,4600.0,4600.0
38535,U21769,4,0.25,2,2,30000.0,30000.25
38536,U1267793,4,-2568.0,4,0,2568.0,0.0
38537,U39754,4,-28.41,3,1,28.5,0.08999999999999986
38538,U20511,4,-10840.0,3,1,23081.0,12241.0
38539,U1092123,4,-196.66,4,0,196.66,0.0
38540,U798468,4,-3084.71,4,0,3084.71,0.0
38541,U864606,4,0.19,2,2,0.2,0.39
38542,U23825,4,260.06,1,3,244.0,504.06
38543,U42277,4,38.679999999999836,1,3,3252.0,3290.68
38544,U33774,4,-134.51,3,1,233.1,98.59
38545,U29432,4,-6898.1,3,1,7000.0,101.89999999999964
38546,U34079,4,5707.71,0,4,0.0,5707.71
38547,U11718,4,-9215.06,1,3,10000.0,784.9400000000005
38548,U38663,4,1653.4899999999998,1,3,7255.57,8909.06
38549,U21657,4,-11009.09,3,1,11024.0,14.909999999999854
38550,U10747,4,-375.4,2,2,436.8,61.400000000000034
38551,U29385,4,0.1799999999998363,2,2,1879.0,1879.1799999999998
38552,U40772,4,-29956.870000000003,1,3,30000.0,43.12999999999738
38553,U31063,4,-0.6399999999999999,2,2,2.0,1.36
38554,U38867,4,0.45999999999995456,1,3,800.0,800.4599999999999
38555,U14874,4,-19.63,2,2,21.0,1.370000000000001
38556,U1194264,4,-957.8199999999999,4,0,957.8199999999999,0.0
38557,U29024,4,-4432.1,2,2,24432.1,20000.0
38558,U20657,4,-1499.99,3,1,1500.0,0.009999999999990905
38559,U28211,4,2825.65,1,3,2689.4,5515.05
38560,U38222,4,100239.87,0,4,0.0,100239.87
38561,U654282,4,500.04,1,3,0.04,500.08000000000004
38562,U18078,4,1876.02,1,3,620.97,2496.99
38563,U31349,4,4405.039999999979,1,3,400000.0,404405.04
38564,U645020,4,6501.0,1,3,1.0,6502.0
38565,U1201646,4,60.0,1,3,2493.33,2553.33
38566,U29197,4,-18446.1,1,3,35000.0,16553.9
38567,U11127,4,-408.76,2,2,489.6,80.84000000000003
38568,U39853,4,233.89999999999998,3,1,304.6,538.5
38569,U27662,4,-99351.1,1,3,100000.0,648.8999999999942
38570,U23130,4,-330.4,3,1,574.0,243.60000000000002
38571,U21951,4,5.8999999999999995,1,3,4.0,9.899999999999999
38572,U31809,4,4413.95,1,3,6600.0,11013.95
38573,U1211610,4,-10.5,3,1,10.69,0.1899999999999995
38574,U43088,4,1.13,2,2,0.02,1.15
38575,U32218,4,-72.67999999999998,2,2,111.97999999999999,39.30000000000001
38576,U20848,4,1017971.16,0,4,0.0,1017971.16
38577,U38927,4,-727.1500000000001,2,2,729.6,2.449999999999932
38578,U946706,4,134.0,2,2,1606.0,1740.0
38579,U19161,4,-0.1299999999999999,2,2,7.4,7.2700000000000005
38580,U1271384,4,1000.01,1,3,0.01,1000.02
38581,U934633,4,0.0,2,2,5344.0,5344.0
38582,U39299,4,-17013.250000000004,2,2,25655.36,8642.109999999997
38583,U1237925,4,-9.999999999999998,3,1,10.03,0.030000000000001137
38584,U40339,4,1226.01,3,1,223.99,1450.0
38585,U37851,4,79.98,0,4,0.0,79.98
38586,U9497,4,-3.319999999999709,2,2,5373.32,5370.0
38587,U704152,4,2.4399999999999977,2,2,80.0,82.44
38588,U1053496,4,-57.47000000000003,2,2,1507.5,1450.03
38589,U31315,4,1.2100000000000546,1,3,3000.0,3001.21
38590,U40863,4,-4075.4299999999994,1,3,10000.0,5924.570000000001
38591,U1264567,4,-18.41,3,1,18.55,0.14000000000000057
38592,U16288,4,596.2,0,4,0.0,596.2
38593,U20199,4,2597.53,1,3,2717.01,5314.540000000001
38594,U34371,4,1100.0,2,2,9200.0,10300.0
38595,U10618,4,971.010000000002,1,3,50000.0,50971.01
38596,U1079476,4,-9833.34,4,0,9833.34,0.0
38597,U590305,4,11009.0,0,4,0.0,11009.0
38598,U33055,4,364.3699999999999,1,3,4300.0,4664.37
38599,U23678,4,758.6099999999999,1,3,4100.0,4858.61
38600,U20279,4,-499625.0,3,1,500000.0,375.0
38601,U26487,4,-18406.780000000002,1,3,30000.0,11593.219999999998
38602,U8989,4,3450.21,0,4,0.0,3450.21
38603,U30747,4,27.699999999999985,1,3,249.86,277.56
38604,U1161707,4,-2776.33,2,2,2833.33,57.0
38605,U1263096,4,-1234.08,3,1,1234.1,0.01999999999998181
38606,U896370,4,0.12000000000000001,2,2,0.34,0.46
38607,U41264,4,667.6999999999999,0,4,0.0,667.6999999999999
38608,U675824,4,360.2600000000002,2,2,1860.42,2220.6800000000003
38609,U1036270,4,0.0,2,2,20.0,20.0
38610,U582719,4,0.8000000000000025,2,2,31.8,32.6
38611,U24762,4,-4.547473508864641e-13,2,2,7305.74,7305.74
38612,U36995,4,490.59,0,4,0.0,490.59
38613,U40285,4,-3045.21,2,2,3180.92,135.71000000000004
38614,U603411,4,475.0,2,2,25.0,500.0
38615,U1219312,4,-473.96000000000004,4,0,473.96000000000004,0.0
38616,U610738,4,-7783.579999999999,4,0,7783.579999999999,0.0
38617,U25287,4,1000.73,1,3,2192.0,3192.73
38618,U42345,4,-72.57,3,1,121.57,49.0
38619,U10848,4,902.83,2,2,100.0,1002.83
38620,U40681,4,12.140000000000002,1,3,60.0,72.14
38621,U40906,4,-884.74,3,1,888.6,3.8600000000000136
38622,U39418,4,14.339999999999998,0,4,0.0,14.339999999999998
38623,U28001,4,-11999.94,2,2,12072.2,72.26000000000022
38624,U26065,4,5996.3,1,3,5.0,6001.3
38625,U36609,4,-597.94,2,2,600.0,2.0599999999999454
38626,U22884,4,2777.19,1,3,2777.74,5554.93
38627,U1050755,4,0.02,1,3,0.02,0.04
38628,U39254,4,5098.6,1,3,5097.0,10195.6
38629,U28715,4,1391.95,1,3,9.8,1401.75
38630,U9481,4,30852.33,1,3,5000.0,35852.33
38631,U37959,4,108.7300000000032,1,3,39800.0,39908.73
38632,U33955,4,640.16,1,3,10.0,650.16
38633,U36143,4,212.01000000000022,1,3,13289.0,13501.01
38634,U1196814,4,0.0,2,2,10000.0,10000.0
38635,U28320,4,2562.8899999999994,1,3,50000.0,52562.89
38636,U22829,4,0.0500000000001819,2,2,1633.9,1633.9500000000003
38637,U1343686,4,401.00000000000017,2,2,3101.8,3502.8
38638,U29814,4,8541.89,0,4,0.0,8541.89
38639,U970600,4,-764.4,4,0,764.4,0.0
38640,U30615,4,-43.96000000000001,2,2,88.0,44.03999999999999
38641,U20846,4,-0.4900000000000091,2,2,724.98,724.49
38642,U33093,4,1254.2600000000002,1,3,1200.0,2454.26
38643,U722743,4,13.670000000000002,3,1,86.33,100.0
38644,U38253,4,-49988.68,2,2,50800.0,811.3199999999997
38645,U1369736,4,-108.5,4,0,108.5,0.0
38646,U9935,4,-2946.4100000000003,2,2,2953.86,7.449999999999818
38647,U1251594,4,-9184.95,4,0,9184.95,0.0
38648,U14385,4,-6.5,2,2,19.2,12.7
38649,U868411,4,-774.0400000000001,4,0,774.0400000000001,0.0
38650,U13537,4,50406.06,0,4,0.0,50406.06
38651,U43252,4,0.0,2,2,15800.0,15800.0
38652,U35008,4,-972.95,3,1,1008.95,36.0
38653,U1314990,4,0.0,2,2,673.83,673.83
38654,U27312,4,-1007.74,2,2,1429.63,421.8900000000001
38655,U577660,4,-1386.65,2,2,1450.24,63.58999999999992
38656,U583350,4,0.0,2,2,311.87,311.87
38657,U20438,4,-55.300000000000004,2,2,60.0,4.699999999999996
38658,U1317318,4,-185.08,4,0,185.08,0.0
38659,U15131,4,-49957.850000000006,1,3,50000.0,42.14999999999418
38660,U756833,4,1184.64,1,3,100.1,1284.74
38661,U35702,4,669.61,2,2,2.0,671.61
38662,U35051,4,4.110000000002037,1,3,50000.0,50004.11
38663,U24194,4,-9.920000000000002,2,2,74.7,64.78
38664,U31520,4,6000.040000000001,1,3,2000.0,8000.040000000001
38665,U12425,4,-1089.31,2,2,1129.7,40.3900000000001
38666,U22689,4,-1.869999999999997,2,2,185.8,183.93
38667,U35493,4,17389.61,0,4,0.0,17389.61
38668,U1264168,4,-539.6,4,0,539.6,0.0
38669,U31465,4,-3358.18,2,2,6741.24,3383.06
38670,U36369,4,6871.870000000001,1,3,100.0,6971.870000000001
38671,U14767,4,-3078.4700000000003,3,1,4478.47,1400.0
38672,U989937,4,4077.04,2,2,1923.0800000000002,6000.12
38673,U9929,4,1.9800000000000182,2,2,518.05,520.03
38674,U27913,4,2362.45,0,4,0.0,2362.45
38675,U12099,4,6006.51,1,3,4275.04,10281.55
38676,U1174299,4,-1952.18,4,0,1952.18,0.0
38677,U31243,4,-39.75,3,1,39.8,0.04999999999999716
38678,U18027,4,30071.85,1,3,20000.0,50071.85
38679,U10097,4,175.01000000000204,2,2,20125.0,20300.010000000002
38680,U1316231,4,-399.16,3,1,399.21000000000004,0.05000000000001137
38681,U42492,4,-29.3,3,1,30.0,0.6999999999999993
38682,U28148,4,589.0699999999999,1,3,35.28,624.3499999999999
38683,U37408,4,-6286.11,2,2,6298.5,12.390000000000327
38684,U36941,4,-99.59,2,2,200.0,100.41
38685,U1315010,4,-1094.26,4,0,1094.26,0.0
38686,U1084297,4,-528.8,4,0,528.8,0.0
38687,U657260,4,2.0,1,3,2.0,4.0
38688,U1289875,4,0.0,2,2,3410.0,3410.0
38689,U23617,4,1.0,2,2,11.0,12.0
38690,U1302662,4,0.0,2,2,15000.0,15000.0
38691,U36498,4,4982.209999999999,1,3,5000.0,9982.21
38692,U43728,4,-6616.640000000001,2,2,11819.1,5202.459999999999
38693,U41545,4,13.269999999999982,1,3,260.0,273.27
38694,U33590,4,-461.99,3,1,472.0,10.009999999999991
38695,U20041,4,60104.86,0,4,0.0,60104.86
38696,U30360,4,-5778.08,2,2,5789.04,10.960000000000036
38697,U26996,4,-16365.039999999999,4,0,16365.039999999999,0.0
38698,U831753,4,-1009.93,2,2,3640.0,2630.07
38699,U32996,4,27.2699999999968,1,3,51000.0,51027.27
38700,U1167135,4,2421.77,2,2,0.32,2422.09
38701,U28880,4,-1.95,2,2,2.0,0.050000000000000044
38702,U11870,4,-105.64,3,1,107.0,1.3599999999999994
38703,U11869,4,363797.52,1,3,49688.0,413485.52
38704,U27761,4,405.0400000000001,2,2,268.79,673.8300000000002
38705,U583392,4,-5234.570000000001,3,1,6530.38,1295.8099999999995
38706,U978772,4,3.8199999999999985,1,3,8.0,11.819999999999999
38707,U693923,4,-0.19999999999998863,2,2,180.1,179.9
38708,U22442,4,-9.92,2,2,20.0,10.08
38709,U34982,4,-256.71,2,2,357.0,100.29000000000002
38710,U18095,4,-207.14000000000001,2,2,2100.0,1892.86
38711,U43005,4,340001.39,1,3,10000.0,350001.39
38712,U26805,4,-1378.65,3,1,1387.99,9.339999999999918
38713,U28913,4,-6.536993168992922e-13,1,3,10038.11,10038.11
38714,U1355698,4,-2.949999999999993,3,1,219.13,216.18
38715,U27859,4,-17981.24,1,3,20000.0,2018.7599999999984
38716,U1260831,4,300.01,1,3,0.01,300.02
38717,U12691,4,-299.49,2,2,600.0,300.51
38718,U822103,4,-5.260000000000019,3,1,205.26000000000002,200.0
38719,U1376475,4,-3741.34,4,0,3741.34,0.0
38720,U29440,4,333.03,2,2,22.0,355.03
38721,U21823,4,0.0,2,2,600000.0,600000.0
38722,U711752,4,0.28,2,2,34.28,34.56
38723,U1302574,4,-547.78,4,0,547.78,0.0
38724,U23167,4,1033.17,2,2,7.0,1040.17
38725,U1143816,4,3900.0299999999997,1,3,5700.0,9600.029999999999
38726,U40775,4,1217.6300000000047,2,2,201000.0,202217.63
38727,U33230,4,-295.0,4,0,295.0,0.0
38728,U41959,4,0.17000000000007276,1,3,9000.0,9000.17
38729,U695765,4,0.99,2,2,1.0,1.99
38730,U31184,4,4252.859999999968,1,3,730000.0,734252.86
38731,U904748,4,-5700.0,2,2,5900.0,200.0
38732,U11473,4,-56.07,2,2,199.6,143.53
38733,U39675,4,1202.45,1,3,1.46,1203.91
38734,U16625,4,-654.6,2,2,979.96,325.36
38735,U36459,4,-2700.12,1,3,3000.0,299.8800000000001
38736,U1381922,4,1349.48,2,2,1350.52,2700.0
38737,U43507,4,2.900000000000091,2,2,2240.0,2242.9
38738,U840274,4,9.0951551845464e-15,2,2,140.01,140.01
38739,U812520,4,191.58,2,2,10.0,201.58
38740,U16182,4,0.010000000002037268,2,2,33000.0,33000.01
38741,U31670,4,-5.470000000000001,2,2,6.0,0.5299999999999994
38742,U28128,4,131.92000000000002,2,2,669.96,801.8800000000001
38743,U930648,4,-251.82000000000002,4,0,251.82000000000002,0.0
38744,U9241,4,-347.76000000000005,4,0,347.76000000000005,0.0
38745,U39874,4,-6859.580000000001,1,3,6900.0,40.41999999999916
38746,U36404,4,-4994.64,3,1,5002.85,8.210000000000036
38747,U8933,4,10000.03,1,3,10000.0,20000.03
38748,U11195,4,30.16,1,3,30.0,60.16
38749,U1260793,4,1.49,2,2,201.0,202.49
38750,U21217,4,5.110000000000582,2,2,18331.0,18336.11
38751,U21225,4,6668.19,1,3,7980.0,14648.189999999999
38752,U25336,4,30026.260000000002,0,4,0.0,30026.260000000002
38753,U38967,4,-44.05,2,2,89.6,45.55
38754,U1272426,4,-1106.06,4,0,1106.06,0.0
38755,U42982,4,-80351.8,1,3,87161.0,6809.199999999997
38756,U29373,4,-305.99,3,1,306.0,0.009999999999990905
38757,U28093,4,-4127.090000000001,1,3,11632.79,7505.7
38758,U30061,4,6502.360000000001,0,4,0.0,6502.360000000001
38759,U42942,4,117.83,2,2,6.0,123.83
38760,U37391,4,0.0,1,3,35800.0,35800.0
38761,U15391,4,-594.96,3,1,599.0,4.039999999999964
38762,U1085030,4,-208.0,4,0,208.0,0.0
38763,U40421,4,-42.07,2,2,85.8,43.73
38764,U43847,4,9602.46,1,3,9635.0,19237.46
38765,U19350,4,-9999.97,2,2,10000.0,0.030000000000654836
38766,U1255367,4,285.0,0,4,0.0,285.0
38767,U20407,4,2500.16,1,3,2522.49,5022.65
38768,U32657,4,1.0,2,2,23996.0,23997.0
38769,U738104,4,-126.0,3,1,526.0,400.0
38770,U23765,4,809.0,2,2,1.05,810.05
38771,U20420,4,52.93,1,3,50.0,102.93
38772,U43420,4,-29939.38,2,2,30010.0,70.61999999999898
38773,U1067553,4,-7.99,3,1,8.0,0.009999999999999787
38774,U26181,4,2.9,3,1,2.1,5.0
38775,U19940,4,-2696.1000000000004,1,3,7500.0,4803.9
38776,U29292,4,4075.67,0,4,0.0,4075.67
38777,U23348,4,-21983.59,3,1,22000.0,16.409999999999854
38778,U25598,4,100.14,1,3,100.0,200.14
38779,U23416,4,-1702.0,4,0,1702.0,0.0
38780,U1027629,4,-2643.32,4,0,2643.32,0.0
38781,U1242186,4,673.0,1,3,100.0,773.0
38782,U19581,4,-432.12,2,2,1348.0,915.88
38783,U22372,4,1.0100000000002183,1,3,6000.0,6001.01
38784,U8291,4,-82972.54,2,2,150003.0,67030.46
38785,U37361,4,36.18000000000016,1,3,4000.0,4036.1800000000003
38786,U33901,4,-363.53999999999996,2,2,1473.79,1110.25
38787,U35974,4,10021.17,1,3,5000.0,15021.17
38788,U25754,4,5382.869999999999,1,3,5118.0,10500.869999999999
38789,U21674,4,-38.42,2,2,80.0,41.58
38790,U1208900,4,-7.900000000000091,3,1,1307.9,1300.0
38791,U11327,4,-20779.41,2,2,41499.6,20720.19
38792,U42865,4,20.630000000004657,1,3,200000.0,200020.63
38793,U34510,4,-10.84,2,2,11.0,0.16000000000000014
38794,U9571,4,419.39,1,3,356.63,776.02
38795,U17568,4,-99.16,1,3,99.7,0.5400000000000063
38796,U36495,4,3232.5099999999984,1,3,30000.0,33232.509999999995
38797,U14810,4,14509.95,1,3,10500.0,25009.95
38798,U23414,4,3272.0600000000095,1,3,300000.0,303272.06
38799,U31268,4,-76.0,4,0,76.0,0.0
38800,U974581,4,-4837.889999999999,2,2,4848.07,10.180000000000291
38801,U28007,4,13001.850000000002,1,3,12354.09,25355.940000000002
38802,U11655,4,-350.13,2,2,424.39,74.25999999999999
38803,U22053,4,9964.92,1,3,6688.2,16653.12
38804,U19915,4,0.5,2,2,57.5,58.0
38805,U36813,4,1501.78,1,3,1490.0,2991.7799999999997
38806,U733015,4,1964.06,1,3,630.18,2594.24
38807,U814569,4,161.05,0,4,0.0,161.05
38808,U11992,4,0.06000000000000028,2,2,10.01,10.07
38809,U32651,4,-7.289999999999992,2,2,177.29999999999998,170.01
38810,U1151399,4,598.73,3,1,4001.27,4600.0
38811,U38268,4,267.8899999999999,1,3,1071.0,1338.8899999999999
38812,U10527,4,-199.99,2,2,388.0,188.01
38813,U35433,4,-79850.7,2,2,180000.0,100149.3
38814,U40570,4,-189.0699999999997,1,3,52690.0,52500.93
38815,U763346,4,12680.91,0,4,0.0,12680.91
38816,U18154,4,-96.8,2,2,99.03,2.230000000000004
38817,U43300,4,-196.78999999999996,1,3,1309.0,1112.21
38818,U36010,4,0.36999999999989086,1,3,5200.0,5200.37
38819,U961279,4,-18.98,3,1,19.0,0.019999999999999574
38820,U961005,4,-1233.72,4,0,1233.72,0.0
38821,U32435,4,-745.0,2,2,11050.0,10305.0
38822,U12572,4,-189.74999999999994,2,2,513.04,323.29
38823,U19359,4,22.409999999999997,1,3,61.41,83.82
38824,U38238,4,1148.21,0,4,0.0,1148.21
38825,U28533,4,-3197.34,1,3,10000.0,6802.66
38826,U655432,4,-695.9200000000001,4,0,695.9200000000001,0.0
38827,U23695,4,19781.87,1,3,20670.0,40451.869999999995
38828,U18338,4,-296.41,2,2,314.82,18.409999999999968
38829,U18149,4,7.389999999999986,1,3,233.19,240.57999999999998
38830,U15222,4,51.40999999999913,1,3,20000.0,20051.41
38831,U22306,4,4392.01,1,3,58.0,4450.01
38832,U39180,4,-19.18,2,2,20.0,0.8200000000000003
38833,U19252,4,-219.66,2,2,440.0,220.34
38834,U35667,4,40000.0,2,2,60000.0,100000.0
38835,U15852,4,-35.39999999999999,1,3,38.9,3.500000000000007
38836,U41570,4,-1854.88,1,3,2000.0,145.1199999999999
38837,U684528,4,5049.299999999999,2,2,10.0,5059.299999999999
38838,U1036818,4,-0.35,2,2,0.39,0.040000000000000036
38839,U10748,4,2121.0,1,3,12308.0,14429.0
38840,U28053,4,-198.07999999999993,1,3,3000.0,2801.92
38841,U1181666,4,130.0,3,1,810.0,940.0
38842,U17545,4,2.19,0,4,0.0,2.19
38843,U42324,4,-0.95,2,2,2.0,1.05
38844,U19009,4,-2021.63,2,2,2025.0,3.369999999999891
38845,U843999,4,642.3,1,3,449.0,1091.3
38846,U24603,4,6001.61,1,3,848.59,6850.2
38847,U33539,4,4887.720000000001,1,3,5500.0,10387.720000000001
38848,U657470,4,500.01,1,3,500.0,1000.01
38849,U18808,4,-99998.79000000001,2,2,100000.0,1.209999999991851
38850,U1344732,4,-4371.48,4,0,4371.48,0.0
38851,U20902,4,-2.6499999999999915,2,2,192.7,190.05
38852,U40036,4,14.940000000000001,0,4,0.0,14.940000000000001
38853,U8146,4,707.8000000000029,1,3,110000.0,110707.8
38854,U26697,4,-48.38999999999942,2,2,20050.0,20001.61
38855,U26019,4,6038.85,1,3,1000.0,7038.85
38856,U40428,4,-3058.68,3,1,3058.73,0.0500000000001819
38857,U593029,4,-0.6999999999999886,3,1,139.0,138.3
38858,U40930,4,50164.11,1,3,1.0,50165.11
38859,U31456,4,-13313.72,3,1,13327.0,13.280000000000655
38860,U969868,4,-3243.9000000000005,4,0,3243.9000000000005,0.0
38861,U18956,4,-329.58000000000004,2,2,401.89,72.30999999999995
38862,U11983,4,994.28,1,3,10.0,1004.28
38863,U1179051,4,4.01,2,2,6.0,10.01
38864,U30329,3,4913.4,2,1,86.6,5000.0
38865,U43679,3,0.009999999999990905,1,2,300.0,300.01
38866,U707321,3,0.11,1,2,253.6,253.71
38867,U31060,3,-1300.0,2,1,2800.0,1500.0
38868,U38813,3,8018.74,0,3,0.0,8018.74
38869,U32754,3,-2.07,2,1,6.0,3.93
38870,U21752,3,-3334.97,2,1,3335.0,0.03000000000020009
38871,U36586,3,994.5,1,2,1350.0,2344.5
38872,U18794,3,5650.0,0,3,0.0,5650.0
38873,U38831,3,3.1399999999999997,1,2,2.0,5.14
38874,U33486,3,1350.92,1,2,650.0,2000.92
38875,U12649,3,-9.039999999999054,1,2,10301.0,10291.960000000001
38876,U25419,3,2.460000000000001,1,2,56.0,58.46
38877,U31125,3,-3.54,2,1,6.0,2.46
38878,U952666,3,8008.0,0,3,0.0,8008.0
38879,U10868,3,-22.93,2,1,23.0,0.07000000000000028
38880,U32258,3,-19.75,2,1,20.0,0.25
38881,U22303,3,-12228.92,1,2,12229.0,0.07999999999992724
38882,U1065422,3,200.02,0,3,0.0,200.02
38883,U655038,3,0.01,1,2,0.01,0.02
38884,U1352275,3,0.0,2,1,2955.54,2955.54
38885,U1312171,3,-9.85,2,1,10.0,0.15000000000000036
38886,U705741,3,0.03,1,2,0.03,0.06
38887,U677879,3,0.04,1,2,4217.73,4217.7699999999995
38888,U43238,3,5186.64,0,3,0.0,5186.64
38889,U40422,3,-1095.95,2,1,1096.0,0.049999999999954525
38890,U21798,3,-2059.91,1,2,11957.0,9897.09
38891,U26038,3,601.19,0,3,0.0,601.19
38892,U27862,3,2073.3,0,3,0.0,2073.3
38893,U24513,3,0.8000000000000003,1,2,1.68,2.4800000000000004
38894,U9221,3,-9938.0,2,1,10060.0,122.0
38895,U38247,3,11.93,1,2,16010.5,16022.43
38896,U39699,3,5812.08,0,3,0.0,5812.08
38897,U23885,3,20024.15,0,3,0.0,20024.15
38898,U780190,3,650.26,2,1,937.72,1587.98
38899,U700807,3,257.0,2,1,244.0,501.0
38900,U8097,3,90.0199999999968,1,2,29900.0,29990.019999999997
38901,U1071179,3,916.8,0,3,0.0,916.8
38902,U41537,3,14.199999999999818,1,2,2506.0,2520.2
38903,U934050,3,200.0,1,2,200.0,400.0
38904,U9649,3,-99.89,1,2,100.0,0.10999999999999943
38905,U1050891,3,60.0,0,3,0.0,60.0
38906,U42806,3,5951.76,1,2,50.0,6001.76
38907,U21201,3,0.009999999999990905,1,2,161.0,161.01
38908,U21198,3,53.63999999999999,0,3,0.0,53.63999999999999
38909,U984662,3,10.0,1,2,0.01,10.01
38910,U1102197,3,53.480000000000004,0,3,0.0,53.480000000000004
38911,U24247,3,-19.05,2,1,20.0,0.9499999999999993
38912,U18025,3,-266.39,1,2,820.0,553.61
38913,U16410,3,17603.42,0,3,0.0,17603.42
38914,U30727,3,0.05000000000001137,1,2,400.0,400.05
38915,U17340,3,-12483.210000000001,2,1,12609.76,126.54999999999927
38916,U35694,3,50.0,1,2,50.0,100.0
38917,U36874,3,3.07,1,2,384.72,387.79
38918,U31606,3,0.0,2,1,55.0,55.0
38919,U9323,3,-6670.55,2,1,6691.54,20.98999999999978
38920,U1104611,3,764.62,0,3,0.0,764.62
38921,U39957,3,-5.98,2,1,6.0,0.019999999999999574
38922,U1238387,3,269.79999999999995,2,1,200.2,469.99999999999994
38923,U1027692,3,0.01,1,2,0.49,0.5
38924,U1080929,3,-0.2,2,1,20.2,20.0
38925,U31668,3,0.0,2,1,317.0,317.0
38926,U32787,3,4.180000000000291,1,2,4329.31,4333.490000000001
38927,U12337,3,6536.629999999999,0,3,0.0,6536.629999999999
38928,U33905,3,336.02,1,2,299.0,635.02
38929,U22866,3,0.31,1,2,29783.0,29783.31
38930,U41087,3,3152.88,1,2,4302.0,7454.88
38931,U28893,3,-10795.37,2,1,10800.04,4.670000000000073
38932,U24378,3,0.38999999999998636,1,2,139.22,139.60999999999999
38933,U23962,3,121.45,1,2,30.0,151.45
38934,U25960,3,-119.31000000000131,1,2,25419.5,25300.19
38935,U1074369,3,-6.69,2,1,6.7,0.009999999999999787
38936,U13809,3,-162.48,2,1,163.5,1.0200000000000102
38937,U28805,3,2352.08,0,3,0.0,2352.08
38938,U943215,3,90.06,1,2,300.0,390.06
38939,U30769,3,300.0,1,2,758.0,1058.0
38940,U43711,3,-1.99,2,1,2.0,0.010000000000000009
38941,U21478,3,-141.14,2,1,196.0,54.860000000000014
38942,U24206,3,-2000.0,2,1,2680.48,680.48
38943,U814225,3,0.37,1,2,0.37,0.74
38944,U1125207,3,-6.94,2,1,6.95,0.009999999999999787
38945,U21818,3,0.08,1,2,43.0,43.08
38946,U1203929,3,-315.15000000000003,2,1,315.16,0.009999999999990905
38947,U37388,3,-30551.260000000002,2,1,30557.29,6.029999999998836
38948,U12302,3,1.9299999999999997,1,2,10.0,11.93
38949,U18799,3,2973.9100000000003,1,2,69.0,3042.9100000000003
38950,U1315479,3,-19.99000000000001,1,2,600.0,580.01
38951,U787310,3,0.02,1,2,0.02,0.04
38952,U20767,3,-39965.46,1,2,50000.0,10034.54
38953,U31216,3,32.22999999999996,1,2,367.98,400.21
38954,U25288,3,-49.93,2,1,50.0,0.07000000000000028
38955,U36243,3,11665.93,0,3,0.0,11665.93
38956,U24645,3,-206.75,2,1,206.8,0.05000000000001137
38957,U40015,3,-5.95,2,1,6.0,0.04999999999999982
38958,U41401,3,-1288.3599999999997,1,2,7289.66,6001.3
38959,U30477,3,-1.98,2,1,2.0,0.020000000000000018
38960,U34088,3,10008.27,0,3,0.0,10008.27
38961,U8193,3,2186.7,1,2,16572.0,18758.7
38962,U31565,3,53826.119999999995,0,3,0.0,53826.119999999995
38963,U31284,3,70.03,0,3,0.0,70.03
38964,U41881,3,1839.67,0,3,0.0,1839.67
38965,U21684,3,0.85,1,2,10.0,10.85
38966,U19123,3,0.3600000000005821,1,2,10000.0,10000.36
38967,U35848,3,-873.5,1,2,1275.0,401.5
38968,U38999,3,151.8,0,3,0.0,151.8
38969,U922267,3,138.0,2,1,220.0,358.0
38970,U31636,3,82.31,0,3,0.0,82.31
38971,U9347,3,-1.3200000000000003,2,1,10.01,8.69
38972,U42860,3,-19.83,2,1,20.0,0.1700000000000017
38973,U19421,3,-1567.1,2,1,1570.0,2.900000000000091
38974,U24718,3,54085.02,0,3,0.0,54085.02
38975,U993277,3,200.0,1,2,200.0,400.0
38976,U742955,3,95.66,1,2,5.0,100.66
38977,U1212886,3,0.4,1,2,0.4,0.8
38978,U13291,3,3.16,1,2,15.0,18.16
38979,U894034,3,0.019999999999999574,1,2,4.0,4.02
38980,U16675,3,25600.0,0,3,0.0,25600.0
38981,U753146,3,18.569999999999993,1,2,55.0,73.57
38982,U15422,3,84153.18000000001,1,2,4.68,84157.86
38983,U1264626,3,-3870.0,2,1,8870.0,5000.0
38984,U8118,3,-1965.93,2,1,2010.0,44.069999999999936
38985,U1238674,3,-14902.0,3,0,14902.0,0.0
38986,U27956,3,39.379999999999995,1,2,30.8,70.17999999999999
38987,U738774,3,-1839.99,1,2,2040.0,200.01
38988,U23903,3,0.34,0,3,0.0,0.34
38989,U1254159,3,500.0,1,2,1352.0,1852.0
38990,U34463,3,-30.43,2,1,80.42999999999999,49.99999999999999
38991,U24422,3,25.18,0,3,0.0,25.18
38992,U35802,3,0.06999999999999318,1,2,300.0,300.07
38993,U13550,3,3990.36,1,2,97.7,4088.06
38994,U1227100,3,-120.0,2,1,120.2,0.20000000000000284
38995,U22995,3,111.9,0,3,0.0,111.9
38996,U981544,3,-526.73,2,1,526.79,0.05999999999994543
38997,U12864,3,5.760000000000001,2,1,0.02,5.78
38998,U966040,3,-0.84,2,1,0.96,0.12
38999,U637761,3,90.0,2,1,910.0,1000.0
39000,U37418,3,66.04999999999995,1,2,1834.07,1900.12
39001,U15388,3,74.82,0,3,0.0,74.82
39002,U9721,3,-6673.67,1,2,6689.15,15.479999999999563
39003,U39002,3,7.290000000000006,1,2,102.0,109.29
39004,U665859,3,0.17,1,2,0.17,0.34
39005,U39872,3,1785.48,0,3,0.0,1785.48
39006,U23656,3,-18015.61,2,1,18048.66,33.04999999999927
39007,U1162208,3,-0.51,3,0,0.51,0.0
39008,U18206,3,-279.77,1,2,3400.0,3120.23
39009,U954030,3,313.36,2,1,326.64,640.0
39010,U30839,3,9.389999999999873,1,2,2464.0,2473.39
39011,U22103,3,0.009999999999990905,1,2,999.0,999.01
39012,U40797,3,-56456.02,2,1,56480.0,23.9800000000032
39013,U877588,3,0.87,2,1,2.13,3.0
39014,U21329,3,35.91,0,3,0.0,35.91
39015,U39024,3,362.03999999999996,0,3,0.0,362.03999999999996
39016,U1198698,3,1.0,1,2,1.0,2.0
39017,U31017,3,3.2,1,2,1000.0,1003.2
39018,U15890,3,29.25,2,1,6.0,35.25
39019,U30798,3,85.35000000000001,0,3,0.0,85.35000000000001
39020,U28953,3,149.01,1,2,1.0,150.01
39021,U35691,3,0.010000000000218279,1,2,2100.0,2100.01
39022,U37664,3,0.22000000000002728,1,2,279.67,279.89000000000004
39023,U41774,3,155.1,1,2,145.0,300.1
39024,U1363168,3,0.060000000000002274,1,2,250.0,250.06
39025,U37807,3,26.03,1,2,44000.0,44026.03
39026,U9793,3,-5.890000000000001,2,1,6.0,0.10999999999999943
39027,U40311,3,-41.52,2,1,45.67,4.149999999999999
39028,U17213,3,2045.15,1,2,10.0,2055.15
39029,U10675,3,1260.54,0,3,0.0,1260.54
39030,U1077406,3,0.10999999999999971,2,1,22.89,23.0
39031,U8428,3,1.52,1,2,10000.0,10001.52
39032,U24080,3,128.0,0,3,0.0,128.0
39033,U22948,3,641.0,1,2,504.0,1145.0
39034,U1368701,3,0.03,0,3,0.0,0.03
39035,U1287400,3,0.06,1,2,0.06,0.12
39036,U661005,3,0.009999999999999787,1,2,2.49,2.5
39037,U36178,3,5.919999999998254,1,2,100000.0,100005.92
39038,U35419,3,-4095.2,1,2,5000.0,904.8000000000002
39039,U947797,3,-9010.0,2,1,9010.09,0.09000000000014552
39040,U42769,3,0.05,1,2,9.9,9.950000000000001
39041,U1229957,3,0.14,1,2,0.14,0.28
39042,U13345,3,8.13,1,2,2.0,10.13
39043,U1259688,3,-120.0,2,1,120.89,0.8900000000000006
39044,U1024330,3,0.02,1,2,0.02,0.04
39045,U1103396,3,1267.0,0,3,0.0,1267.0
39046,U26914,3,10001.23,0,3,0.0,10001.23
39047,U658674,3,0.31,1,2,10.96,11.270000000000001
39048,U20409,3,-199532.07,1,2,200000.0,467.929999999993
39049,U17003,3,-29.93,1,2,30.0,0.07000000000000028
39050,U1270872,3,2800.0,0,3,0.0,2800.0
39051,U20327,3,1.050000000000182,1,2,5000.0,5001.05
39052,U43158,3,-5.53,2,1,6.0,0.46999999999999975
39053,U1130748,3,-5.93,2,1,6.0,0.07000000000000028
39054,U37833,3,-12.740000000000009,1,2,826.95,814.21
39055,U31995,3,0.04,1,2,95.76,95.80000000000001
39056,U25566,3,0.010000000000001563,1,2,18.2,18.21
39057,U20467,3,612.88,1,2,387.52,1000.4
39058,U25631,3,-61.06,2,1,62.36,1.2999999999999972
39059,U24558,3,-199704.33,1,2,200000.0,295.6700000000128
39060,U32161,3,-37800.0,2,1,49189.0,11389.0
39061,U29837,3,0.34999999999999964,1,2,15.46,15.81
39062,U698257,3,0.02,1,2,0.02,0.04
39063,U19223,3,-1.97,2,1,2.0,0.030000000000000027
39064,U17275,3,1824.01,1,2,80.0,1904.01
39065,U10313,3,11297.11,0,3,0.0,11297.11
39066,U948184,3,190.0,2,1,10.0,200.0
39067,U28423,3,-815.41,2,1,816.41,1.0
39068,U10817,3,-120.97000000000001,2,1,121.05000000000001,0.0799999999999983
39069,U31375,3,-30705.1,2,1,30825.0,119.90000000000146
39070,U31926,3,2.0200000000004366,1,2,5666.61,5668.63
39071,U860768,3,-2320.2,2,1,2938.83,618.6300000000001
39072,U37019,3,-956.71,1,2,1210.26,253.54999999999995
39073,U733616,3,255.0,1,2,305.0,560.0
39074,U19331,3,-139.04,1,2,149.0,9.960000000000008
39075,U953276,3,600.44,1,2,270.0,870.44
39076,U27386,3,-1.97,2,1,2.0,0.030000000000000027
39077,U40135,3,7311.4400000000005,0,3,0.0,7311.4400000000005
39078,U34166,3,55.879999999999995,0,3,0.0,55.879999999999995
39079,U38808,3,0.4,1,2,180.0,180.4
39080,U27433,3,30.09,1,2,0.01,30.1
39081,U38360,3,798.07,0,3,0.0,798.07
39082,U18156,3,20.65,0,3,0.0,20.65
39083,U664562,3,0.07,1,2,0.07,0.14
39084,U10989,3,8411.43,0,3,0.0,8411.43
39085,U35762,3,-7682.82,1,2,7700.0,17.18000000000029
39086,U24573,3,0.0,2,1,1252.0,1252.0
39087,U671517,3,100.0,1,2,100.0,200.0
39088,U13421,3,-34.94,2,1,36.0,1.0600000000000023
39089,U29955,3,0.45999999999997954,1,2,259.8,260.26
39090,U26057,3,-1913.64,2,1,1915.0,1.3599999999999
39091,U35951,3,0.2800000000002001,1,2,3897.89,3898.17
39092,U26258,3,112177.54000000001,0,3,0.0,112177.54000000001
39093,U42957,3,-39.56,1,2,1248.0,1208.44
39094,U18437,3,500.38,0,3,0.0,500.38
39095,U13052,3,177.07999999999998,0,3,0.0,177.07999999999998
39096,U1372109,3,-2.5,3,0,2.5,0.0
39097,U25193,3,-2.36,1,2,11003.0,11000.64
39098,U18634,3,-203.95,2,1,203.97,0.020000000000010232
39099,U1019645,3,0.01,1,2,0.01,0.02
39100,U40753,3,-10.0,2,1,110.0,100.0
39101,U18334,3,-7911.11,2,1,8000.0,88.89000000000033
39102,U650635,3,330.0,1,2,0.01,330.01
39103,U712872,3,325.0,1,2,1305.0,1630.0
39104,U40157,3,-20.78,2,1,115.83,95.05
39105,U950587,3,-518.26,2,1,518.32,0.06000000000005912
39106,U33076,3,-84.94999999999999,2,1,104.22999999999999,19.28
39107,U21879,3,-58.26,2,1,60.0,1.740000000000002
39108,U894138,3,140.0,2,1,2860.0,3000.0
39109,U35334,3,-598871.78,2,1,601284.0,2412.219999999972
39110,U29982,3,41.43000000000029,1,2,3058.66,3100.09
39111,U31665,3,0.17,1,2,232.3,232.47
39112,U663756,3,109.0,1,2,1170.0,1279.0
39113,U33495,3,243736.19,0,3,0.0,243736.19
39114,U1046684,3,-9.0,2,1,10.0,1.0
39115,U14346,3,-43.770000000000294,1,2,11320.0,11276.23
39116,U18070,3,4.990000000000009,1,2,225.78,230.77
39117,U896477,3,0.01,1,2,0.01,0.02
39118,U16802,3,-5.96,2,1,6.0,0.040000000000000036
39119,U25443,3,0.009999999999990905,1,2,199.0,199.01
39120,U42308,3,3.389999999999418,1,2,10000.0,10003.39
39121,U22626,3,1008.64,0,3,0.0,1008.64
39122,U30710,3,-3953.88,2,1,4000.0,46.11999999999989
39123,U1317737,3,0.06000000000000005,1,2,2.16,2.22
39124,U19239,3,1000.26,1,2,6000.0,7000.26
39125,U42270,3,-10009.95,2,1,10010.0,0.049999999999272404
39126,U945492,3,666.3800000000001,1,2,1239.0,1905.38
39127,U41885,3,-150330.66,2,1,150431.0,100.33999999999651
39128,U35618,3,6183.280000000001,0,3,0.0,6183.280000000001
39129,U12530,3,-41970.48,2,1,42000.0,29.5199999999968
39130,U35537,3,150.2,1,2,29.0,179.2
39131,U29461,3,-3849.829999999999,1,2,10000.0,6150.170000000001
39132,U9183,3,0.07999999999992724,1,2,2000.0,2000.08
39133,U24616,3,0.35000000000000003,0,3,0.0,0.35000000000000003
39134,U35867,3,-5.99,2,1,6.0,0.009999999999999787
39135,U41144,3,-16658.43,3,0,16658.43,0.0
39136,U35522,3,-59.870000000000005,1,2,59.89,0.01999999999999602
39137,U738236,3,-3735.75,3,0,3735.75,0.0
39138,U1266115,3,-466.49,2,1,466.5,0.009999999999990905
39139,U19308,3,7628.8099999999995,0,3,0.0,7628.8099999999995
39140,U24532,3,-2258.82,1,2,2300.0,41.179999999999836
39141,U17793,3,0.08,1,2,200.0,200.08
39142,U18082,3,2.42,2,1,6.0,8.42
39143,U15397,3,0.18999999999959982,1,2,7176.0,7176.19
39144,U31907,3,-9.87,2,1,10.01,0.14000000000000057
39145,U10002,3,-121.59,2,1,121.6,0.009999999999990905
39146,U23926,3,-6.180000000000064,1,2,2006.19,2000.01
39147,U37067,3,-107.59,2,1,108.4,0.8100000000000023
39148,U1302393,3,1042.41,1,2,0.59,1043.0
39149,U28530,3,0.06000000000040018,1,2,7744.0,7744.06
39150,U1108587,3,-1201.0,2,1,1202.39,1.3900000000001
39151,U35884,3,1.8699999999953434,1,2,200000.0,200001.87
39152,U32832,3,55.71,1,2,44.3,100.00999999999999
39153,U643866,3,0.1,1,2,0.1,0.2
39154,U13657,3,-477.56,1,2,480.0,2.4399999999999977
39155,U42100,3,28000.15,0,3,0.0,28000.15
39156,U1043469,3,38.0,0,3,0.0,38.0
39157,U31894,3,37.39999999999998,1,2,319.6,357.0
39158,U12695,3,0.6599999999998545,1,2,2471.35,2472.0099999999998
39159,U29927,3,1495.5100000000002,1,2,8505.46,10000.97
39160,U12700,3,-4074.74,2,1,4081.24,6.5
39161,U30928,3,594.1299999999991,1,2,49000.0,49594.13
39162,U31307,3,-360.0,2,1,458.0,98.0
39163,U37737,3,-4903.66,1,2,5000.0,96.34000000000015
39164,U17806,3,0.83,1,2,100.0,100.83
39165,U960917,3,4000.0,0,3,0.0,4000.0
39166,U12679,3,-34.10999999999967,2,1,3434.1099999999997,3400.0
39167,U24863,3,1261.8600000000001,0,3,0.0,1261.8600000000001
39168,U23214,3,-524.91,2,1,525.0,0.09000000000003183
39169,U37088,3,6052.52,0,3,0.0,6052.52
39170,U23246,3,547.78,0,3,0.0,547.78
39171,U23629,3,695.0,1,2,1000.0,1695.0
39172,U14021,3,-212.43,2,1,213.0,0.5699999999999932
39173,U28829,3,1978.0,1,2,374.0,2352.0
39174,U699321,3,-55.0,2,1,4155.0,4100.0
39175,U941685,3,-5.99,2,1,6.0,0.009999999999999787
39176,U703097,3,0.1,1,2,0.1,0.2
39177,U43724,3,-58.379999999999995,2,1,60.0,1.6200000000000045
39178,U583899,3,1520.0,0,3,0.0,1520.0
39179,U13223,3,-1396.23,2,1,1500.0,103.76999999999998
39180,U43542,3,-1795.58,2,1,1798.9,3.3200000000001637
39181,U896044,3,400.0,1,2,400.0,800.0
39182,U29353,3,-469.64,3,0,469.64,0.0
39183,U9184,3,-307.86,2,1,308.05,0.18999999999999773
39184,U23860,3,-0.010000000000001563,2,1,29.560000000000002,29.55
39185,U24383,3,1216.0,1,2,45.0,1261.0
39186,U25717,3,0.029999999999972715,1,2,1020.0,1020.03
39187,U687057,3,-5.970000000000001,2,1,6.0,0.02999999999999936
39188,U11521,3,0.0,2,1,10.0,10.0
39189,U16356,3,5.0,1,2,13280.0,13285.0
39190,U8800,3,0.11999999999989086,1,2,4388.87,4388.99
39191,U970232,3,99.01,1,2,1.0,100.01
39192,U33616,3,27.649999999999977,1,2,373.5,401.15
39193,U18685,3,3387.54,0,3,0.0,3387.54
39194,U1338864,3,2350.0,1,2,2350.0,4700.0
39195,U25875,3,-9987.640000000001,1,2,10000.0,12.359999999998763
39196,U9186,3,-5.99,2,1,6.0,0.009999999999999787
39197,U42648,3,0.010000000000005116,1,2,100.0,100.01
39198,U14838,3,0.06,1,2,2777.0,2777.06
39199,U10651,3,45.42000000000007,1,2,1354.61,1400.03
39200,U12901,3,5035.82,1,2,5000.0,10035.82
39201,U37786,3,-5.5,2,1,6.0,0.5
39202,U1027591,3,35.0,2,1,345.0,380.0
39203,U38936,3,172.51999999999998,0,3,0.0,172.51999999999998
39204,U721257,3,0.8800000000001091,1,2,3696.0,3696.88
39205,U35317,3,-99944.7,1,2,100000.0,55.30000000000291
39206,U21941,3,-6.96,2,1,7.0,0.040000000000000036
39207,U31919,3,-367.73999999999995,2,1,368.9,1.160000000000025
39208,U28796,3,-243.62,2,1,244.0,0.37999999999999545
39209,U18151,3,0.22,1,2,484.89,485.11
39210,U686435,3,600.0,0,3,0.0,600.0
39211,U625197,3,31.0,0,3,0.0,31.0
39212,U41930,3,59.92000000000007,1,2,11000.0,11059.92
39213,U21687,3,-19.63,1,2,20.0,0.370000000000001
39214,U945491,3,-1727.7900000000002,1,2,1798.96,71.16999999999985
39215,U1181453,3,0.0,2,1,20.0,20.0
39216,U19334,3,4.28,0,3,0.0,4.28
39217,U42560,3,4.100000000000023,1,2,531.0,535.1
39218,U34038,3,0.22,1,2,0.01,0.23
39219,U1179990,3,311.02,0,3,0.0,311.02
39220,U14574,3,1.6400000000000006,1,2,59.81,61.45
39221,U1256731,3,398.95,1,2,87.44,486.39
39222,U9225,3,177.64000000000001,0,3,0.0,177.64000000000001
39223,U15690,3,40018.43,1,2,15.0,40033.43
39224,U1319964,3,0.01,1,2,0.71,0.72
39225,U28418,3,-13989.130000000001,2,1,14000.01,10.8799999999992
39226,U1307642,3,46.53000000000003,2,1,366.53,413.06
39227,U32955,3,-7.105427357601002e-15,2,1,213.82,213.82
39228,U1244359,3,-29.84,2,1,49.84,20.000000000000004
39229,U806394,3,1.58,1,2,1.58,3.16
39230,U19090,3,-19.92,2,1,20.0,0.0799999999999983
39231,U26469,3,0.76,1,2,30000.0,30000.76
39232,U35183,3,-19978.56,1,2,20000.0,21.43999999999869
39233,U1070710,3,0.01,1,2,0.01,0.02
39234,U43609,3,-125.5,3,0,125.5,0.0
39235,U22276,3,-26.79,1,2,300.0,273.21
39236,U633678,3,0.01,1,2,0.01,0.02
39237,U43360,3,0.2,1,2,308.0,308.2
39238,U26325,3,-174.87000000000003,1,2,179.8,4.929999999999978
39239,U34350,3,4632.32,0,3,0.0,4632.32
39240,U42158,3,-1.99,2,1,2.0,0.010000000000000009
39241,U893924,2,0.0,1,1,0.99,0.99
39242,U24453,2,-106.89,1,1,107.0,0.10999999999999943
39243,U703297,2,900.18,0,2,0.0,900.18
39244,U1155504,2,0.0,1,1,200.0,200.0
39245,U30665,2,3005.7,0,2,0.0,3005.7
39246,U24621,2,-22167.54,2,0,22167.54,0.0
39247,U608991,2,0.40000000000009095,1,1,1983.0,1983.4
39248,U20067,2,-7395.23,1,1,7397.94,2.7100000000000364
39249,U20047,2,122.16999999999999,0,2,0.0,122.16999999999999
39250,U20714,2,0.99,1,1,0.01,1.0
39251,U13591,2,-1998.88,1,1,2000.0,1.1199999999998909
39252,U10300,2,0.0,1,1,2843.0,2843.0
39253,U8372,2,0.0,1,1,4000.0,4000.0
39254,U751322,2,0.0,1,1,0.62,0.62
39255,U1092655,2,58.50999999999999,1,1,290.0,348.51
39256,U891032,2,70.0,1,1,10.0,80.0
39257,U21784,2,111.34,0,2,0.0,111.34
39258,U20274,2,0.0,1,1,223.0,223.0
39259,U1276939,2,0.0,1,1,10.0,10.0
39260,U39746,2,0.0,1,1,3000.0,3000.0
39261,U32931,2,60.08,0,2,0.0,60.08
39262,U32841,2,0.88,0,2,0.0,0.88
39263,U24801,2,7896.57,0,2,0.0,7896.57
39264,U685487,2,-4269.13,2,0,4269.13,0.0
39265,U793060,2,1200.0,0,2,0.0,1200.0
39266,U594063,2,0.0,1,1,0.01,0.01
39267,U1337764,2,0.0,1,1,10.0,10.0
39268,U19559,2,66.17,0,2,0.0,66.17
39269,U10401,2,-19.97,1,1,20.0,0.030000000000001137
39270,U1295917,2,0.0,1,1,0.01,0.01
39271,U1058520,2,-0.46,2,0,0.46,0.0
39272,U34969,2,166.73,0,2,0.0,166.73
39273,U37434,2,0.8500000000000001,0,2,0.0,0.8500000000000001
39274,U23818,2,50.0,1,1,50.0,100.0
39275,U1250009,2,30.0,0,2,0.0,30.0
39276,U19405,2,0.0,1,1,10000.0,10000.0
39277,U672702,2,-532.78,2,0,532.78,0.0
39278,U11895,2,0.0,1,1,75.9,75.9
39279,U22253,2,-49998.95,1,1,49999.0,0.05000000000291038
39280,U22927,2,-2998.03,1,1,3000.0,1.9699999999998
39281,U1334064,2,3500.01,0,2,0.0,3500.01
39282,U12838,2,-49218.0,2,0,49218.0,0.0
39283,U12818,2,-6.0,2,0,6.0,0.0
39284,U11241,2,-9.97,1,1,10.0,0.02999999999999936
39285,U32408,2,-146.94,1,1,147.24,0.30000000000001137
39286,U37505,2,6905.34,0,2,0.0,6905.34
39287,U33181,2,352.15,0,2,0.0,352.15
39288,U34628,2,36.3,0,2,0.0,36.3
39289,U1268293,2,0.0,1,1,0.45,0.45
39290,U24043,2,-205.94,2,0,205.94,0.0
39291,U1032235,2,0.0,1,1,0.89,0.89
39292,U29839,2,0.0,1,1,20000.0,20000.0
39293,U19175,2,0.09,0,2,0.0,0.09
39294,U43278,2,-1974.69,1,1,2000.0,25.309999999999945
39295,U1359615,2,524.19,0,2,0.0,524.19
39296,U1081627,2,3100.0,0,2,0.0,3100.0
39297,U21834,2,0.0,1,1,47.8,47.8
39298,U1373417,2,-10.0,2,0,10.0,0.0
39299,U1262946,2,1251.0,0,2,0.0,1251.0
39300,U754014,2,0.0,1,1,0.01,0.01
39301,U20390,2,-723.54,1,1,800.0,76.46000000000004
39302,U681941,2,28.48,0,2,0.0,28.48
39303,U31941,2,-2499.99,1,1,2500.0,0.010000000000218279
39304,U1354772,2,800.0,0,2,0.0,800.0
39305,U1272749,2,0.0,1,1,196.1,196.1
39306,U30667,2,-482.12,1,1,521.0,38.879999999999995
39307,U951129,2,-358.82,2,0,358.82,0.0
39308,U15217,2,69.0,0,2,0.0,69.0
39309,U1335954,2,643.0,1,1,1757.0,2400.0
39310,U29326,2,17.73,0,2,0.0,17.73
39311,U11592,2,-13.7,1,1,15.0,1.3000000000000007
39312,U35726,2,-317.94,1,1,317.98,0.040000000000020464
39313,U1374264,2,600.01,0,2,0.0,600.01
39314,U30092,2,-525.99,1,1,526.0,0.009999999999990905
39315,U1343434,2,-0.16,1,1,0.2,0.04000000000000001
39316,U43798,2,-919.99,1,1,920.0,0.009999999999990905
39317,U25693,2,0.0,1,1,15621.0,15621.0
39318,U23634,2,0.8,0,2,0.0,0.8
39319,U639896,2,0.0,1,1,0.09,0.09
39320,U27998,2,7926.5,1,1,73.5,8000.0
39321,U32130,2,2988.31,0,2,0.0,2988.31
39322,U35127,2,501.19,0,2,0.0,501.19
39323,U39757,2,0.19,0,2,0.0,0.19
39324,U642065,2,6.029999999999999,0,2,0.0,6.029999999999999
39325,U15237,2,33402.11,0,2,0.0,33402.11
39326,U20813,2,0.06,0,2,0.0,0.06
39327,U35065,2,0.25,0,2,0.0,0.25
39328,U11883,2,5842.44,0,2,0.0,5842.44
39329,U25800,2,299.68,0,2,0.0,299.68
39330,U1137344,2,0.0,1,1,0.2,0.2
39331,U8888,2,-2148.34,1,1,2150.0,1.6599999999998545
39332,U1320447,2,0.0,1,1,1.46,1.46
39333,U40006,2,-7984.56,1,1,8000.0,15.4399999999996
39334,U1238229,2,0.0,1,1,50.0,50.0
39335,U29873,2,300.01,0,2,0.0,300.01
39336,U36127,2,0.0,1,1,4900.0,4900.0
39337,U691778,2,0.0,1,1,0.05,0.05
39338,U21822,2,5000.96,0,2,0.0,5000.96
39339,U18949,2,-8999.24,1,1,9000.0,0.7600000000002183
39340,U23944,2,0.0,1,1,1850.0,1850.0
39341,U959744,2,0.0,1,1,0.05,0.05
39342,U28302,2,5.16,0,2,0.0,5.16
39343,U927157,2,1.0,1,1,2.0,3.0
39344,U35428,2,600.67,0,2,0.0,600.67
39345,U30635,2,4.55,0,2,0.0,4.55
39346,U35982,2,1.0,1,1,1299.0,1300.0
39347,U940778,2,2100.0,0,2,0.0,2100.0
39348,U1104945,2,0.0,1,1,5.0,5.0
39349,U19013,2,-559.56,1,1,560.0,0.44000000000005457
39350,U24668,2,-2543.1299999999997,1,1,2544.93,1.800000000000182
39351,U1338090,2,-2.0,2,0,2.0,0.0
39352,U25482,2,-53.60000000000002,1,1,520.0,466.4
39353,U23121,2,-59.98,1,1,60.0,0.020000000000003126
39354,U1285537,2,0.0,1,1,20.0,20.0
39355,U22513,2,308.69,0,2,0.0,308.69
39356,U32209,2,1.95,0,2,0.0,1.95
39357,U669407,2,11.06,0,2,0.0,11.06
39358,U28718,2,-196.97,1,1,197.0,0.030000000000001137
39359,U34206,2,0.6999999999999886,1,1,394.3,395.0
39360,U1346473,2,0.0,1,1,0.28,0.28
39361,U44003,2,-16.0,2,0,16.0,0.0
39362,U979987,2,0.0,1,1,300.0,300.0
39363,U891172,2,235.91999999999996,1,1,408.0,643.92
39364,U1286950,2,0.0,1,1,926.0,926.0
39365,U25499,2,0.0,1,1,200.0,200.0
39366,U32626,2,-0.99,1,1,1.0,0.010000000000000009
39367,U21869,2,-119.93,1,1,120.0,0.06999999999999318
39368,U18789,2,-99911.53,1,1,100000.0,88.47000000000116
39369,U19188,2,0.0,1,1,29381.0,29381.0
39370,U40043,2,-4.87,1,1,5.0,0.1299999999999999
39371,U32193,2,13514.99,0,2,0.0,13514.99
39372,U1186471,2,-12.24,2,0,12.24,0.0
39373,U649363,2,-199.57000000000002,1,1,199.58,0.009999999999990905
39374,U18876,2,0.99,1,1,0.01,1.0
39375,U11219,2,0.45,0,2,0.0,0.45
39376,U14797,2,-2497.93,1,1,2500.0,2.0700000000001637
39377,U29366,2,0.04,0,2,0.0,0.04
39378,U577295,2,-11.99,1,1,12.0,0.009999999999999787
39379,U28466,2,-4995.89,1,1,5000.0,4.109999999999673
39380,U20484,2,10.04,0,2,0.0,10.04
39381,U739371,2,20.0,0,2,0.0,20.0
39382,U8322,2,-7799.75,1,1,7800.0,0.25
39383,U1154228,2,-1453.3,2,0,1453.3,0.0
39384,U43432,2,-478.64,1,1,500.0,21.360000000000014
39385,U904285,2,164.54999999999998,0,2,0.0,164.54999999999998
39386,U707352,2,0.0,1,1,0.1,0.1
39387,U1304437,2,0.0,1,1,0.71,0.71
39388,U22038,2,0.0,1,1,180.0,180.0
39389,U34327,2,-29.97,1,1,30.0,0.030000000000001137
39390,U1071512,2,800.0,0,2,0.0,800.0
39391,U1093381,2,32.0,1,1,968.0,1000.0
39392,U25102,2,-33229.46000000001,1,1,33229.48,0.01999999999679858
39393,U714714,2,0.04,0,2,0.0,0.04
39394,U1028373,2,116.19999999999999,1,1,275.0,391.2
39395,U9774,2,116.43,0,2,0.0,116.43
39396,U1165952,2,85.0,0,2,0.0,85.0
39397,U31085,2,4.92,0,2,0.0,4.92
39398,U1065774,2,-15.5,2,0,15.5,0.0
39399,U42514,2,0.0,1,1,2800.0,2800.0
39400,U36756,2,-4998.04,1,1,5000.0,1.9600000000000364
39401,U1241242,2,110.0,1,1,620.0,730.0
39402,U799123,2,1.85,0,2,0.0,1.85
39403,U41970,2,-136.78,1,1,140.5,3.719999999999999
39404,U25039,2,29.080000000000002,0,2,0.0,29.080000000000002
39405,U685343,2,0.0,1,1,0.01,0.01
39406,U17733,2,4.99,1,1,0.01,5.0
39407,U18416,2,30.340000000000003,1,1,100.0,130.34
39408,U40649,2,70213.24,0,2,0.0,70213.24
39409,U39952,2,0.13,0,2,0.0,0.13
39410,U25995,2,0.0,1,1,25.0,25.0
39411,U633109,2,3150.0,0,2,0.0,3150.0
39412,U642195,2,0.0,1,1,500.0,500.0
39413,U685250,2,0.0,1,1,80.0,80.0
39414,U1238205,2,-120.00999999999999,2,0,120.00999999999999,0.0
39415,U27744,2,-9998.43,1,1,10000.0,1.569999999999709
39416,U42591,2,-21.54,1,1,21.8,0.26000000000000156
39417,U1184240,2,-10.0,2,0,10.0,0.0
39418,U31222,2,20.0,1,1,4980.0,5000.0
39419,U1140316,2,-6.27,2,0,6.27,0.0
39420,U32782,2,200.17,0,2,0.0,200.17
39421,U900783,2,250.0,0,2,0.0,250.0
39422,U905289,2,0.0,1,1,0.04,0.04
39423,U9526,2,-599.99,1,1,600.0,0.009999999999990905
39424,U18658,2,-5850.049999999999,1,1,5857.44,7.390000000000327
39425,U739349,2,-2.25,1,1,276.18,273.93
39426,U29487,2,-93.61,1,1,93.67,0.060000000000002274
39427,U32905,2,119.55,1,1,18.8,138.35
39428,U12331,2,-99.96,1,1,100.0,0.04000000000000625
39429,U22039,2,0.26,0,2,0.0,0.26
39430,U1274385,2,100.0,0,2,0.0,100.0
39431,U1179898,2,2067.61,0,2,0.0,2067.61
39432,U37403,2,50211.52,0,2,0.0,50211.52
39433,U17143,2,-7149.0,1,1,10149.0,3000.0
39434,U12875,2,-2100.0,2,0,2100.0,0.0
39435,U958059,2,-5900.0,2,0,5900.0,0.0
39436,U642303,2,0.0,1,1,10.69,10.69
39437,U737738,2,-10.0,2,0,10.0,0.0
39438,U29226,2,4870.0,0,2,0.0,4870.0
39439,U1242333,2,-0.24,1,1,0.25,0.010000000000000009
39440,U25708,2,0.12000000000000001,1,1,0.01,0.13
39441,U32819,2,-4.99,1,1,5.0,0.009999999999999787
39442,U39384,2,0.44,0,2,0.0,0.44
39443,U22180,2,564.0,1,1,2797.0,3361.0
39444,U22365,2,8.370000000000005,1,1,91.63,100.0
39445,U9625,2,0.38,0,2,0.0,0.38
39446,U738395,2,-91.87,2,0,91.87,0.0
39447,U41923,2,183.20999999999998,0,2,0.0,183.20999999999998
39448,U35038,2,-49.52,1,1,50.0,0.4799999999999969
39449,U675595,2,0.0,1,1,0.01,0.01
39450,U32463,2,-4.1899999999999995,2,0,4.1899999999999995,0.0
39451,U967389,2,0.0,1,1,0.62,0.62
39452,U992368,2,-0.3400000000001455,1,1,6876.0,6875.66
39453,U23725,2,5000.0,1,1,15000.0,20000.0
39454,U29857,2,-1999.98,1,1,2000.0,0.01999999999998181
39455,U26255,2,0.58,0,2,0.0,0.58
39456,U983521,2,0.0,1,1,0.01,0.01
39457,U24847,2,-2998.63,1,1,3000.01,1.3800000000001091
39458,U29369,2,150.0,0,2,0.0,150.0
39459,U37113,2,0.53,0,2,0.0,0.53
39460,U20599,2,0.1,0,2,0.0,0.1
39461,U25330,2,-14999.96,1,1,15000.0,0.040000000000873115
39462,U22512,2,-1554.5,2,0,1554.5,0.0
39463,U934509,2,-14.93,1,1,15.0,0.07000000000000028
39464,U20797,2,600.0,1,1,200000.0,200600.0
39465,U22651,2,0.14,0,2,0.0,0.14
39466,U35342,2,41.43,0,2,0.0,41.43
39467,U656598,2,-18.63,1,1,18.65,0.019999999999999574
39468,U24215,2,-4.99,1,1,5.0,0.009999999999999787
39469,U24488,2,-21.979999999999997,1,1,21.99,0.010000000000001563
39470,U1111786,2,0.0,1,1,0.01,0.01
39471,U1209798,2,0.0,1,1,1170.0,1170.0
39472,U1366731,2,0.09999999999999964,1,1,9.9,10.0
39473,U34484,2,0.29,0,2,0.0,0.29
39474,U9331,2,0.61,0,2,0.0,0.61
39475,U681806,2,107.32,0,2,0.0,107.32
39476,U43900,2,-0.07,1,1,0.1,0.03
39477,U42621,2,2377.0499999999997,0,2,0.0,2377.0499999999997
39478,U1090514,2,-3000.0,2,0,3000.0,0.0
39479,U20738,2,-0.44999999999998863,1,1,317.45,317.0
39480,U41443,2,10405.259999999998,0,2,0.0,10405.259999999998
39481,U17958,2,0.0,1,1,0.01,0.01
39482,U43464,2,5090.42,0,2,0.0,5090.42
39483,U38040,2,0.0,1,1,5461.25,5461.25
39484,U1107231,2,99.97,1,1,0.03,100.0
39485,U40829,2,-797.78,1,1,800.0,2.2200000000000273
39486,U32798,2,-2.32000000000005,1,1,1013.0,1010.68
39487,U40263,2,0.06000000000000005,1,1,1.0,1.06
39488,U34414,2,0.0,1,1,20350.0,20350.0
39489,U22280,2,-4.98,1,1,5.0,0.019999999999999574
39490,U1053501,2,0.0,1,1,0.62,0.62
39491,U10021,2,12.299999999999997,1,1,20.0,32.3
39492,U28751,2,-15.0,2,0,15.0,0.0
39493,U10632,2,0.52,1,1,0.01,0.53
39494,U42398,2,-195.32,1,1,200.0,4.680000000000007
39495,U31066,2,-6590.31,1,1,6600.0,9.6899999999996
39496,U1318135,2,128.0,1,1,392.0,520.0
39497,U42466,2,-1999.06,1,1,2000.0,0.9400000000000546
39498,U33885,2,0.0,1,1,8300.0,8300.0
39499,U36550,2,-12599.43,1,1,12600.0,0.569999999999709
39500,U701975,2,0.0,1,1,16.76,16.76
39501,U41935,2,11515.57,0,2,0.0,11515.57
39502,U29934,2,50.01,0,2,0.0,50.01
39503,U24665,2,-19.98,1,1,20.0,0.019999999999999574
39504,U1273177,2,200.0,0,2,0.0,200.0
39505,U1250757,2,80.0,0,2,0.0,80.0
39506,U1100859,2,0.0,1,1,6.0,6.0
39507,U35169,2,0.29,1,1,0.01,0.3
39508,U38531,2,15.02,1,1,15.98,31.0
39509,U26757,2,-25.880000000000003,1,1,27.6,1.7199999999999989
39510,U39911,2,28.58,0,2,0.0,28.58
39511,U24791,2,944.79,0,2,0.0,944.79
39512,U34968,2,5.4799999999999995,0,2,0.0,5.4799999999999995
39513,U11902,2,0.86,0,2,0.0,0.86
39514,U37494,2,-2928.21,1,1,3000.0,71.78999999999996
39515,U42295,2,1644.0800000000002,0,2,0.0,1644.0800000000002
39516,U894758,2,2060.0,0,2,0.0,2060.0
39517,U19393,2,1596.4,0,2,0.0,1596.4
39518,U24873,2,23378.62,0,2,0.0,23378.62
39519,U29890,2,-219.1,1,1,221.0,1.9000000000000057
39520,U638006,2,-14124.46,2,0,14124.46,0.0
39521,U12496,2,4007.2,0,2,0.0,4007.2
39522,U1163224,2,600.0,0,2,0.0,600.0
39523,U43487,2,0.16,0,2,0.0,0.16
39524,U22258,2,-199.53,1,1,199.6,0.06999999999999318
39525,U19310,2,-1.95,1,1,2.0,0.050000000000000044
39526,U35806,2,7.96,0,2,0.0,7.96
39527,U28864,2,-2992.31,1,1,3000.0,7.690000000000055
39528,U42540,2,4817.79,0,2,0.0,4817.79
39529,U900874,2,0.0,1,1,8.91,8.91
39530,U25956,2,0.52,1,1,0.01,0.53
39531,U44060,2,0.0,1,1,10000.0,10000.0
39532,U30735,2,0.18,0,2,0.0,0.18
39533,U1323449,2,152.0,1,1,1149.0,1301.0
39534,U18613,2,1.6099999999999999,0,2,0.0,1.6099999999999999
39535,U41211,2,7097.01,0,2,0.0,7097.01
39536,U17129,2,0.1,0,2,0.0,0.1
39537,U34150,2,2.62,0,2,0.0,2.62
39538,U25852,2,434.03,0,2,0.0,434.03
39539,U34349,2,0.0,1,1,156.0,156.0
39540,U34556,2,-997.99,1,1,998.0,0.009999999999990905
39541,U43163,2,5011.86,0,2,0.0,5011.86
39542,U1378045,2,430.0,0,2,0.0,430.0
39543,U953685,2,-31.8,2,0,31.8,0.0
39544,U32796,2,6795.63,0,2,0.0,6795.63
39545,U21290,2,-21391.03,1,1,21400.0,8.970000000001164
39546,U758569,2,30.01,0,2,0.0,30.01
39547,U22091,2,4.99,0,2,0.0,4.99
39548,U673315,2,1100.01,0,2,0.0,1100.01
39549,U18191,2,9994.78,0,2,0.0,9994.78
39550,U10691,2,1623.69,0,2,0.0,1623.69
39551,U27758,2,11.22,0,2,0.0,11.22
39552,U38658,2,8.53,0,2,0.0,8.53
39553,U35075,2,0.16,0,2,0.0,0.16
39554,U26373,2,-28.87,1,1,28.96,0.08999999999999986
39555,U1256425,2,-9.57,1,1,10.0,0.4299999999999997
39556,U638328,2,0.0,1,1,0.41,0.41
39557,U29740,2,0.1599999999999966,1,1,91.84,92.0
39558,U930196,2,0.0,1,1,1.43,1.43
39559,U30419,2,-178.73,1,1,179.0,0.27000000000001023
39560,U756174,2,220.0,0,2,0.0,220.0
39561,U13907,2,-21.650000000000002,1,1,21.69,0.03999999999999915
39562,U17785,2,1.1400000000000001,0,2,0.0,1.1400000000000001
39563,U40131,2,0.0,1,1,1410.7,1410.7
39564,U37457,2,0.09,0,2,0.0,0.09
39565,U894204,2,700.0,1,1,599.0,1299.0
39566,U972223,2,50.01,0,2,0.0,50.01
39567,U771717,2,2600.0,0,2,0.0,2600.0
39568,U42374,2,-6.0600000000000005,1,1,10.0,3.9399999999999995
39569,U38164,2,3006.16,0,2,0.0,3006.16
39570,U22807,2,2000.04,0,2,0.0,2000.04
39571,U39399,2,200.19,0,2,0.0,200.19
39572,U42446,2,-78.80000000000001,1,1,250.0,171.2
39573,U730778,2,-260.0,1,1,1420.0,1160.0
39574,U26449,2,0.22,0,2,0.0,0.22
39575,U18160,2,1002.9,0,2,0.0,1002.9
39576,U26232,2,1459.02,0,2,0.0,1459.02
39577,U25899,2,-499.22999999999996,1,1,499.95,0.7200000000000273
39578,U26691,2,-919.59,1,1,925.0,5.409999999999968
39579,U948052,2,0.0,1,1,0.47,0.47
39580,U23168,2,0.79,0,2,0.0,0.79
39581,U1099885,2,0.0,1,1,236.5,236.5
39582,U18444,2,0.73,0,2,0.0,0.73
39583,U8873,2,-298.59,1,1,300.0,1.410000000000025
39584,U36288,2,33.92,0,2,0.0,33.92
39585,U19789,2,2.23,0,2,0.0,2.23
39586,U18495,2,720.96,0,2,0.0,720.96
39587,U42278,2,787.49,0,2,0.0,787.49
39588,U41954,2,-4999.5,1,1,5000.0,0.5
39589,U39221,2,4005.66,0,2,0.0,4005.66
39590,U28225,2,-36.879999999999995,1,1,36.9,0.020000000000003126
39591,U1041505,2,540.0,0,2,0.0,540.0
39592,U42795,2,-1197.38,1,1,1200.0,2.619999999999891
39593,U25042,2,-55.14,1,1,55.2,0.060000000000002274
39594,U30316,2,5.0,1,1,95.0,100.0
39595,U988809,2,0.05,0,2,0.0,0.05
39596,U21240,2,15.92,0,2,0.0,15.92
39597,U1214197,2,10.0,0,2,0.0,10.0
39598,U1150232,2,0.0,1,1,200.0,200.0
39599,U20549,2,-14369.0,2,0,14369.0,0.0
39600,U673085,2,20.0,0,2,0.0,20.0
39601,U599073,2,4.0,0,2,0.0,4.0
39602,U35339,2,3400.0,0,2,0.0,3400.0
39603,U1021088,2,0.0,1,1,891.0,891.0
39604,U699793,2,1000.01,0,2,0.0,1000.01
39605,U39637,1,15000.0,0,1,0.0,15000.0
39606,U38393,1,0.02,0,1,0.0,0.02
39607,U42481,1,0.01,0,1,0.0,0.01
39608,U22084,1,0.08,0,1,0.0,0.08
39609,U38323,1,1.49,0,1,0.0,1.49
39610,U30507,1,0.17,0,1,0.0,0.17
39611,U32701,1,1.26,0,1,0.0,1.26
39612,U35819,1,7.81,0,1,0.0,7.81
39613,U40813,1,0.26,0,1,0.0,0.26
39614,U35846,1,0.75,0,1,0.0,0.75
39615,U1088631,1,1055.0,0,1,0.0,1055.0
39616,U659500,1,0.04,0,1,0.0,0.04
39617,U20949,1,124.3,0,1,0.0,124.3
39618,U926733,1,-4117.6,1,0,4117.6,0.0
39619,U21354,1,-2.0,1,0,2.0,0.0
39620,U25873,1,0.54,0,1,0.0,0.54
39621,U895126,1,-386.42,1,0,386.42,0.0
39622,U28712,1,15.14,0,1,0.0,15.14
39623,U13876,1,0.09,0,1,0.0,0.09
39624,U37912,1,13.79,0,1,0.0,13.79
39625,U33709,1,3.29,0,1,0.0,3.29
39626,U24146,1,0.03,0,1,0.0,0.03
39627,U35940,1,0.1,0,1,0.0,0.1
39628,U38968,1,-49.85,1,0,49.85,0.0
39629,U21909,1,1.02,0,1,0.0,1.02
39630,U8821,1,15000.0,0,1,0.0,15000.0
39631,U30444,1,0.05,0,1,0.0,0.05
39632,U851730,1,100.0,0,1,0.0,100.0
39633,U26851,1,0.88,0,1,0.0,0.88
39634,U15174,1,6.63,0,1,0.0,6.63
39635,U32268,1,7.64,0,1,0.0,7.64
39636,U28115,1,0.1,0,1,0.0,0.1
39637,U24086,1,0.19,0,1,0.0,0.19
39638,U629044,1,0.09,0,1,0.0,0.09
39639,U23434,1,0.08,0,1,0.0,0.08
39640,U25551,1,-35896.4,1,0,35896.4,0.0
39641,U1354185,1,1000.0,0,1,0.0,1000.0
39642,U17855,1,0.77,0,1,0.0,0.77
39643,U31055,1,0.03,0,1,0.0,0.03
39644,U28365,1,1.33,0,1,0.0,1.33
39645,U22959,1,0.08,0,1,0.0,0.08
39646,U22590,1,0.22,0,1,0.0,0.22
39647,U35372,1,0.99,0,1,0.0,0.99
39648,U24095,1,0.04,0,1,0.0,0.04
39649,U31037,1,0.02,0,1,0.0,0.02
39650,U1272121,1,-50.0,1,0,50.0,0.0
39651,U15653,1,9.93,0,1,0.0,9.93
39652,U22286,1,0.17,0,1,0.0,0.17
39653,U1166706,1,50.0,0,1,0.0,50.0
39654,U1270137,1,500.0,0,1,0.0,500.0
39655,U40789,1,0.01,0,1,0.0,0.01
39656,U22411,1,0.01,0,1,0.0,0.01
39657,U585364,1,-60.0,1,0,60.0,0.0
39658,U19120,1,109.73,0,1,0.0,109.73
39659,U39618,1,0.08,0,1,0.0,0.08
39660,U42842,1,0.01,0,1,0.0,0.01
39661,U21670,1,0.13,0,1,0.0,0.13
39662,U1122721,1,-0.66,1,0,0.66,0.0
39663,U38303,1,40000.0,0,1,0.0,40000.0
39664,U14411,1,0.05,0,1,0.0,0.05
39665,U27455,1,-20000.0,1,0,20000.0,0.0
39666,U17920,1,0.07,0,1,0.0,0.07
39667,U42430,1,0.74,0,1,0.0,0.74
39668,U36258,1,5.7,0,1,0.0,5.7
39669,U1207678,1,-0.35,1,0,0.35,0.0
39670,U1213872,1,-203.5,1,0,203.5,0.0
39671,U738855,1,834.26,0,1,0.0,834.26
39672,U22815,1,0.39,0,1,0.0,0.39
39673,U8874,1,7.1,0,1,0.0,7.1
39674,U742158,1,-15.0,1,0,15.0,0.0
39675,U745593,1,0.01,0,1,0.0,0.01
39676,U19055,1,0.65,0,1,0.0,0.65
39677,U1240002,1,500.0,0,1,0.0,500.0
39678,U10074,1,0.08,0,1,0.0,0.08
39679,U599019,1,0.01,0,1,0.0,0.01
39680,U577793,1,2000.0,0,1,0.0,2000.0
39681,U27938,1,1000.0,0,1,0.0,1000.0
39682,U1118080,1,1000.0,0,1,0.0,1000.0
39683,U19651,1,20.59,0,1,0.0,20.59
39684,U32803,1,131.79,0,1,0.0,131.79
39685,U31505,1,18.32,0,1,0.0,18.32
39686,U18770,1,0.23,0,1,0.0,0.23
39687,U14040,1,0.22,0,1,0.0,0.22
39688,U35259,1,0.07,0,1,0.0,0.07
39689,U42679,1,0.08,0,1,0.0,0.08
39690,U31203,1,2.31,0,1,0.0,2.31
39691,U26689,1,0.01,0,1,0.0,0.01
39692,U11571,1,22.24,0,1,0.0,22.24
39693,U27324,1,0.09,0,1,0.0,0.09
39694,U38339,1,0.49,0,1,0.0,0.49
39695,U1229882,1,1000.0,0,1,0.0,1000.0
39696,U38454,1,0.39,0,1,0.0,0.39
39697,U23286,1,0.13,0,1,0.0,0.13
39698,U29406,1,5.63,0,1,0.0,5.63
39699,U18479,1,0.04,0,1,0.0,0.04
39700,U42672,1,0.22,0,1,0.0,0.22
39701,U25755,1,0.02,0,1,0.0,0.02
39702,U25318,1,0.02,0,1,0.0,0.02
39703,U21790,1,0.01,0,1,0.0,0.01
39704,U43959,1,0.01,0,1,0.0,0.01
39705,U29896,1,0.06,0,1,0.0,0.06
39706,U28915,1,0.07,0,1,0.0,0.07
39707,U20683,1,4.09,0,1,0.0,4.09
39708,U21780,1,0.01,0,1,0.0,0.01
39709,U18983,1,4.17,0,1,0.0,4.17
39710,U14951,1,0.27,0,1,0.0,0.27
39711,U12935,1,0.09,0,1,0.0,0.09
39712,U29480,1,0.91,0,1,0.0,0.91
39713,U22865,1,151.31,0,1,0.0,151.31
39714,U32306,1,0.05,0,1,0.0,0.05
39715,U22274,1,0.1,0,1,0.0,0.1
39716,U833414,1,298.0,0,1,0.0,298.0
39717,U1067754,1,200.0,0,1,0.0,200.0
39718,U1200167,1,10.0,0,1,0.0,10.0
39719,U41000,1,0.15,0,1,0.0,0.15
39720,U34865,1,0.06,0,1,0.0,0.06
39721,U899245,1,0.05,0,1,0.0,0.05
39722,U24912,1,0.84,0,1,0.0,0.84
39723,U11131,1,2.66,0,1,0.0,2.66
39724,U1030498,1,366.0,0,1,0.0,366.0
39725,U38233,1,0.07,0,1,0.0,0.07
39726,U899342,1,50.34,0,1,0.0,50.34
39727,U667279,1,-168.0,1,0,168.0,0.0
39728,U42851,1,0.01,0,1,0.0,0.01
39729,U1083783,1,-150.0,1,0,150.0,0.0
39730,U41018,1,300.0,0,1,0.0,300.0
39731,U39805,1,0.02,0,1,0.0,0.02
39732,U33818,1,-177.0,1,0,177.0,0.0
39733,U36280,1,0.07,0,1,0.0,0.07
39734,U41861,1,0.08,0,1,0.0,0.08
39735,U16667,1,0.01,0,1,0.0,0.01
39736,U26049,1,1.0,0,1,0.0,1.0
39737,U18489,1,0.41,0,1,0.0,0.41
39738,U10227,1,0.03,0,1,0.0,0.03
39739,U41627,1,0.27,0,1,0.0,0.27
39740,U22108,1,1.21,0,1,0.0,1.21
39741,U31814,1,3.37,0,1,0.0,3.37
39742,U637111,1,-150.0,1,0,150.0,0.0
39743,U23511,1,1.24,0,1,0.0,1.24
39744,U33890,1,0.03,0,1,0.0,0.03
39745,U10087,1,0.21,0,1,0.0,0.21
39746,U40481,1,0.03,0,1,0.0,0.03
39747,U24531,1,0.15,0,1,0.0,0.15
39748,U22579,1,-100.0,1,0,100.0,0.0
39749,U32791,1,4.29,0,1,0.0,4.29
39750,U31701,1,0.07,0,1,0.0,0.07
39751,U19965,1,0.38,0,1,0.0,0.38
39752,U1348322,1,-0.2,1,0,0.2,0.0
39753,U31768,1,0.01,0,1,0.0,0.01
39754,U42087,1,0.26,0,1,0.0,0.26
39755,U1241568,1,965.0,0,1,0.0,965.0
39756,U21917,1,4.25,0,1,0.0,4.25
39757,U650280,1,0.03,0,1,0.0,0.03
39758,U1075516,1,20.0,0,1,0.0,20.0
39759,U28503,1,0.26,0,1,0.0,0.26
39760,U1028990,1,-44.5,1,0,44.5,0.0
39761,U963254,1,130.0,0,1,0.0,130.0
39762,U28682,1,0.5,0,1,0.0,0.5
39763,U39283,1,0.14,0,1,0.0,0.14
39764,U13611,1,-105.6,1,0,105.6,0.0
39765,U30984,1,0.02,0,1,0.0,0.02
39766,U817331,1,0.05,0,1,0.0,0.05
39767,U34963,1,0.03,0,1,0.0,0.03
39768,U39372,1,0.77,0,1,0.0,0.77
39769,U25437,1,1.16,0,1,0.0,1.16
39770,U34685,1,1.85,0,1,0.0,1.85
39771,U15650,1,0.02,0,1,0.0,0.02
39772,U26268,1,0.46,0,1,0.0,0.46
39773,U30333,1,0.01,0,1,0.0,0.01
39774,U24579,1,2.36,0,1,0.0,2.36
39775,U21604,1,0.12,0,1,0.0,0.12
39776,U1085182,1,-2.85,1,0,2.85,0.0
39777,U1192233,1,100.0,0,1,0.0,100.0
39778,U11292,1,0.01,0,1,0.0,0.01
39779,U19371,1,0.03,0,1,0.0,0.03
39780,U8326,1,64.2,0,1,0.0,64.2
39781,U1107430,1,2046.56,0,1,0.0,2046.56
39782,U1309679,1,0.01,0,1,0.0,0.01
39783,U26361,1,13.33,0,1,0.0,13.33
39784,U1153563,1,-1.0,1,0,1.0,0.0
39785,U1166155,1,3.0,0,1,0.0,3.0
39786,U1156781,1,16.0,0,1,0.0,16.0
39787,U42925,1,-2320.63,1,0,2320.63,0.0
39788,U31620,1,4.67,0,1,0.0,4.67
39789,U22490,1,2.19,0,1,0.0,2.19
39790,U30660,1,0.06,0,1,0.0,0.06
39791,U891896,1,426.4,0,1,0.0,426.4
39792,U20613,1,0.04,0,1,0.0,0.04
39793,U1320987,1,0.02,0,1,0.0,0.02
39794,U19850,1,0.02,0,1,0.0,0.02
39795,U1183911,1,100.0,0,1,0.0,100.0
39796,U25067,1,0.61,0,1,0.0,0.61
39797,U22043,1,1.0,0,1,0.0,1.0
39798,U39112,1,0.02,0,1,0.0,0.02
39799,U41919,1,15.35,0,1,0.0,15.35
39800,U17933,1,0.03,0,1,0.0,0.03
39801,U23935,1,0.18,0,1,0.0,0.18
39802,U25385,1,0.27,0,1,0.0,0.27
39803,U1203010,1,0.09,0,1,0.0,0.09
39804,U31912,1,0.52,0,1,0.0,0.52
39805,U1235759,1,-25.38,1,0,25.38,0.0
39806,U15108,1,0.02,0,1,0.0,0.02
39807,U1104644,1,300.0,0,1,0.0,300.0
39808,U33684,1,0.06,0,1,0.0,0.06
39809,U10505,1,0.01,0,1,0.0,0.01
39810,U28500,1,0.01,0,1,0.0,0.01
39811,U29323,1,0.77,0,1,0.0,0.77
39812,U32851,1,0.14,0,1,0.0,0.14
39813,U30509,1,5.92,0,1,0.0,5.92
39814,U14330,1,27.4,0,1,0.0,27.4
39815,U32596,1,0.17,0,1,0.0,0.17
39816,U954070,1,670.0,0,1,0.0,670.0
39817,U694643,1,0.01,0,1,0.0,0.01
39818,U26151,1,0.04,0,1,0.0,0.04
39819,U30462,1,0.07,0,1,0.0,0.07
39820,U32244,1,30.0,0,1,0.0,30.0
39821,U1214371,1,-0.01,1,0,0.01,0.0
39822,U30007,1,0.07,0,1,0.0,0.07
39823,U18932,1,0.03,0,1,0.0,0.03
39824,U899538,1,1000.0,0,1,0.0,1000.0
39825,U651611,1,300.0,0,1,0.0,300.0
39826,U1113257,1,-625.0,1,0,625.0,0.0
39827,U35962,1,0.24,0,1,0.0,0.24
39828,U21214,1,0.64,0,1,0.0,0.64
39829,U34604,1,0.01,0,1,0.0,0.01
39830,U40821,1,0.08,0,1,0.0,0.08
39831,U31646,1,700.0,0,1,0.0,700.0
39832,U39734,1,0.07,0,1,0.0,0.07
39833,U38498,1,0.1,0,1,0.0,0.1
39834,U34076,1,0.14,0,1,0.0,0.14
39835,U1315558,1,-900.0,1,0,900.0,0.0
39836,U27810,1,6.6,0,1,0.0,6.6
39837,U21685,1,0.07,0,1,0.0,0.07
39838,U13398,1,19.03,0,1,0.0,19.03
39839,U40156,1,0.02,0,1,0.0,0.02
39840,U17824,1,0.08,0,1,0.0,0.08
39841,U23259,1,-3.67,1,0,3.67,0.0
39842,U23530,1,0.04,0,1,0.0,0.04
39843,U21764,1,0.08,0,1,0.0,0.08
39844,U32499,1,-81.0,1,0,81.0,0.0
39845,U760032,1,500.0,0,1,0.0,500.0
39846,U22191,1,0.06,0,1,0.0,0.06
39847,U10146,1,0.07,0,1,0.0,0.07
39848,U13744,1,2.69,0,1,0.0,2.69
39849,U30853,1,15.31,0,1,0.0,15.31
39850,U33359,1,0.04,0,1,0.0,0.04
39851,U1037168,1,107.0,0,1,0.0,107.0
39852,U10826,1,4.15,0,1,0.0,4.15
39853,U35172,1,0.3,0,1,0.0,0.3
39854,U27310,1,0.92,0,1,0.0,0.92
39855,U1365297,1,-0.04,1,0,0.04,0.0
39856,U19100,1,0.36,0,1,0.0,0.36
39857,U952413,1,1810.0,0,1,0.0,1810.0
39858,U9813,1,9.93,0,1,0.0,9.93
39859,U8780,1,0.63,0,1,0.0,0.63
39860,U38894,1,343750.0,0,1,0.0,343750.0
39861,U1348360,1,-4300.0,1,0,4300.0,0.0
39862,U24050,1,0.02,0,1,0.0,0.02
39863,U40948,1,0.01,0,1,0.0,0.01
39864,U26750,1,0.03,0,1,0.0,0.03
39865,U959108,1,-15.0,1,0,15.0,0.0
39866,U24650,1,0.02,0,1,0.0,0.02
39867,U1050677,1,-138.83,1,0,138.83,0.0
39868,U30258,1,5.56,0,1,0.0,5.56
39869,U34857,1,0.06,0,1,0.0,0.06
39870,U1303802,1,-0.2,1,0,0.2,0.0
39871,U1266215,1,450.0,0,1,0.0,450.0
39872,U36529,1,1.27,0,1,0.0,1.27
39873,U1187745,1,1300.0,0,1,0.0,1300.0
39874,U11164,1,1.75,0,1,0.0,1.75
39875,U20573,1,-158.0,1,0,158.0,0.0
39876,U26858,1,63.04,0,1,0.0,63.04
39877,U29643,1,-482.57,1,0,482.57,0.0
39878,U23579,1,692.0,0,1,0.0,692.0
39879,U30865,1,0.07,0,1,0.0,0.07
39880,U18398,1,0.09,0,1,0.0,0.09
39881,U9358,1,0.02,0,1,0.0,0.02
39882,U1226891,1,0.03,0,1,0.0,0.03
39883,U703680,1,5.0,0,1,0.0,5.0
39884,U36078,1,1.11,0,1,0.0,1.11
39885,U42588,1,0.09,0,1,0.0,0.09
39886,U638628,1,-150.0,1,0,150.0,0.0
39887,U27387,1,6.81,0,1,0.0,6.81
39888,U1109394,1,20.0,0,1,0.0,20.0
39889,U675800,1,500.0,0,1,0.0,500.0
39890,U19192,1,224.0,0,1,0.0,224.0
39891,U1263367,1,253.0,0,1,0.0,253.0
39892,U17240,1,0.04,0,1,0.0,0.04
39893,U903163,1,500.0,0,1,0.0,500.0
39894,U11672,1,21.66,0,1,0.0,21.66
39895,U770116,1,900.0,0,1,0.0,900.0
39896,U23444,1,0.22,0,1,0.0,0.22
39897,U1307152,1,-77.8,1,0,77.8,0.0
39898,U658675,1,0.32,0,1,0.0,0.32
39899,U20779,1,320.9,0,1,0.0,320.9
39900,U15743,1,7.09,0,1,0.0,7.09
39901,U21167,1,0.25,0,1,0.0,0.25
39902,U37527,1,0.16,0,1,0.0,0.16
39903,U837064,1,0.01,0,1,0.0,0.01
39904,U27937,1,12.9,0,1,0.0,12.9
39905,U18293,1,31.77,0,1,0.0,31.77
39906,U25362,1,0.01,0,1,0.0,0.01
39907,U32939,1,0.32,0,1,0.0,0.32
39908,U18443,1,0.03,0,1,0.0,0.03
39909,U42835,1,1.09,0,1,0.0,1.09
39910,U1084665,1,323.22,0,1,0.0,323.22
39911,U1196370,1,-199.58,1,0,199.58,0.0
39912,U963805,1,0.02,0,1,0.0,0.02
39913,U756918,1,1522.0,0,1,0.0,1522.0
39914,U25415,1,5.41,0,1,0.0,5.41
39915,U18017,1,0.38,0,1,0.0,0.38
39916,U36248,1,0.47,0,1,0.0,0.47
39917,U43073,1,0.06,0,1,0.0,0.06
39918,U715875,1,944.12,0,1,0.0,944.12
39919,U1234370,1,100.0,0,1,0.0,100.0
39920,U24499,1,0.4,0,1,0.0,0.4
39921,U31976,1,0.9,0,1,0.0,0.9
39922,U1290358,1,0.07,0,1,0.0,0.07
39923,U1076676,1,500.0,0,1,0.0,500.0
39924,U41220,1,-2251.76,1,0,2251.76,0.0
39925,U32944,1,0.14,0,1,0.0,0.14
39926,U23036,1,1.32,0,1,0.0,1.32
39927,U30897,1,2.21,0,1,0.0,2.21
39928,U678835,1,-2.8,1,0,2.8,0.0
39929,U43144,1,0.18,0,1,0.0,0.18
39930,U12278,1,0.04,0,1,0.0,0.04
39931,U591621,1,50.0,0,1,0.0,50.0
39932,U19523,1,0.58,0,1,0.0,0.58
39933,U27506,1,2.95,0,1,0.0,2.95
39934,U11582,1,0.03,0,1,0.0,0.03
39935,U10034,1,1.0,0,1,0.0,1.0
39936,U30596,1,0.11,0,1,0.0,0.11
39937,U27808,1,1.81,0,1,0.0,1.81
39938,U1053988,1,-0.44,1,0,0.44,0.0
39939,U22270,1,0.09,0,1,0.0,0.09
39940,U30951,1,0.01,0,1,0.0,0.01
39941,U19193,1,0.07,0,1,0.0,0.07
39942,U896760,1,-2100.0,1,0,2100.0,0.0
39943,U8705,1,35.66,0,1,0.0,35.66
39944,U12726,1,0.07,0,1,0.0,0.07
39945,U1371317,1,200.0,0,1,0.0,200.0
39946,U1198017,1,-3.0,1,0,3.0,0.0
39947,U12413,1,17.12,0,1,0.0,17.12
39948,U43448,1,0.15,0,1,0.0,0.15
39949,U22328,1,2.78,0,1,0.0,2.78
39950,U970578,1,0.08,0,1,0.0,0.08
39951,U20810,1,0.03,0,1,0.0,0.03
39952,U34652,1,0.58,0,1,0.0,0.58
39953,U37767,1,0.02,0,1,0.0,0.02
39954,U965089,1,0.04,0,1,0.0,0.04
39955,U31855,1,0.01,0,1,0.0,0.01
39956,U9568,1,0.55,0,1,0.0,0.55
39957,U767510,1,1.58,0,1,0.0,1.58
39958,U31984,1,0.04,0,1,0.0,0.04
39959,U1157093,1,0.06,0,1,0.0,0.06
39960,U12329,1,-671.4,1,0,671.4,0.0
39961,U35587,1,-14.86,1,0,14.86,0.0
39962,U20004,1,0.07,0,1,0.0,0.07
39963,U35979,1,15.36,0,1,0.0,15.36
39964,U24640,1,-18.6,1,0,18.6,0.0
39965,U1238594,1,10.0,0,1,0.0,10.0
39966,U10671,1,0.04,0,1,0.0,0.04
39967,U23559,1,0.04,0,1,0.0,0.04
39968,U41284,1,0.07,0,1,0.0,0.07
39969,U10501,1,0.81,0,1,0.0,0.81
39970,U1129628,1,2000.0,0,1,0.0,2000.0
39971,U929704,1,2020.0,0,1,0.0,2020.0
39972,U37097,1,0.01,0,1,0.0,0.01
39973,U1076532,1,-5.0,1,0,5.0,0.0
39974,U8378,1,0.66,0,1,0.0,0.66
39975,U34328,1,0.02,0,1,0.0,0.02
39976,U1193494,1,300.0,0,1,0.0,300.0
39977,U8077,1,-100.0,1,0,100.0,0.0
39978,U16128,1,0.01,0,1,0.0,0.01
39979,U17364,1,0.08,0,1,0.0,0.08
39980,U30142,1,0.32,0,1,0.0,0.32
39981,U33968,1,0.01,0,1,0.0,0.01
39982,U26652,1,1.36,0,1,0.0,1.36
39983,U1026086,1,0.01,0,1,0.0,0.01
39984,U897525,1,600.0,0,1,0.0,600.0
39985,U1106342,1,20.0,0,1,0.0,20.0
39986,U1208766,1,0.01,0,1,0.0,0.01
39987,U22625,1,10.71,0,1,0.0,10.71
39988,U35927,1,214.96,0,1,0.0,214.96
39989,U1269603,1,5.0,0,1,0.0,5.0
39990,U966063,1,720.0,0,1,0.0,720.0
39991,U1207147,1,50.0,0,1,0.0,50.0
39992,U20603,1,15.44,0,1,0.0,15.44
39993,U889753,1,0.21,0,1,0.0,0.21
39994,U14844,1,0.01,0,1,0.0,0.01
39995,U35737,1,0.08,0,1,0.0,0.08
39996,U1139321,1,10.0,0,1,0.0,10.0
39997,U1261264,1,320.0,0,1,0.0,320.0
39998,U22960,1,2.24,0,1,0.0,2.24
39999,U773644,1,-100.0,1,0,100.0,0.0
