,user,trd_times,total_count,B_out,C_in,out_count,in_count
0,UBD9C48,5836,2173.690000000078,5693,143,962039.7700000006,964213.46
1,U8AE05B,2589,-19.03999999986081,1232,1357,3354162.49,3354143.4500000007
2,U0015B2,2490,-13241.210000000041,1535,955,1966131.7300000002,1952890.520000002
3,U9E0C0D,2392,4145.880000000038,1117,1275,3940858.6100000003,3945004.4900000016
4,U7EF7EC,2237,-1990.9900000000284,2063,174,342173.6300000002,340182.64000000013
5,UFAA278,2230,1937.85999999946,2082,148,199587.6199999978,201525.47999999984
6,U6A0213,2214,-314.8300000000745,2056,158,3228379.9,3228065.0700000003
7,UA4826C,2124,14680.94999999968,1064,1060,3223304.4,3237985.3500000015
8,UB00ED6,1774,-0.6799999999275315,166,1608,1964195.0699999998,1964194.39
9,UDC645C,1483,-49535.32000000008,1279,204,2387598.31,2338062.9899999998
10,UF928E7,1436,2669.6699999999983,1102,334,108744.54,111414.20999999998
11,UA61CDE,1290,-40113.47999999993,484,806,38514018.84000001,38473905.35999998
12,UCA37FC,1281,-38526.98000000141,1093,188,2247169.0299999714,2208642.0500000003
13,UFC5A9E,1278,-298.6999999999877,877,401,268272.67000000016,267973.96999999986
14,UD81BAF,1254,1425.6499999999942,996,258,1246544.54,1247970.1900000002
15,U2C29AB,1233,90.70000000000002,844,389,55036.819999999985,55127.520000000186
16,U6F9FC3,1229,-191825.12,1208,21,986143.2699999998,794318.15
17,U8003E5,1204,30992.43000000014,912,292,1342548.2800000007,1373540.71
18,U36764F,1119,34465.12000000012,667,452,1307329.9300000016,1341795.0500000005
19,U2CAF13,1056,-26961.79999999998,609,447,5538953.619999998,5511991.82
20,U5E965A,1046,22508.750000000735,332,714,6970409.109999999,6992917.859999998
21,U777D63,1001,-573.6800000001058,316,685,2051772.1099999996,2051198.43
22,UC466B9,970,-4909.839999999994,477,493,363432.17000000004,358522.33000000025
23,U48FD8D,940,-232.65999999999622,464,476,145032.67,144800.01
24,U80FB6E,915,59836.29999999999,776,139,2842512.9599999995,2902349.2600000002
25,U467232,911,84.90999999996757,489,422,803554.3599999999,803639.2700000005
26,U781BBD,852,1125.7299999999395,710,142,1801424.07,1802549.8000000007
27,UF9D520,835,-341.8100000000213,455,380,796528.8999999999,796187.0899999997
28,UDDA890,830,-30154.37999999996,157,673,722243.39,692089.0100000001
29,U450AB6,820,27885.70000000001,712,108,1479621.2899999998,1507506.9899999998
30,U9E6593,806,-1696.4100000000126,780,26,865513.2100000001,863816.8000000002
31,UB99765,790,208.24000000000092,548,242,86739.71000000002,86947.94999999994
32,U975927,780,-33362.860000000146,500,280,1604301.5000000002,1570938.6400000001
33,U3C95E8,775,-4847.0299999999115,521,254,10586277.649999999,10581430.620000001
34,U0E46DF,760,25940.280000000028,617,143,2511915.75,2537856.03
35,UE86177,759,-17241.310000000234,240,519,693982.0400000004,676740.7299999982
36,U9E2913,755,14232.300000000003,725,30,223705.72999999998,237938.03
37,U6A8665,754,-140.0000000000589,526,228,1511725.9499999986,1511585.9499999997
38,U4AF6E0,743,4131.630000000019,574,169,1392729.8299999991,1396861.4600000007
39,UF69426,730,-273.7499999999957,446,284,83238.42,82964.67000000004
40,U2F0C0E,724,-44782.009999999995,454,270,1750103.54,1705321.5299999998
41,U0F0DB9,707,2127.769999999997,270,437,1014714.8199999998,1016842.5899999997
42,U8A63AF,707,-1820.480000000015,539,168,1240998.7300000011,1239178.2500000002
43,U2F6483,703,-14059.429999999948,451,252,1849053.5399999998,1834994.11
44,U82A7C9,694,7837.620000000038,374,320,1293186.63,1301024.25
45,U74D259,690,26628.38999999998,494,196,245439.77999999985,272068.17
46,UABB75C,688,41553.23999999995,379,309,1141181.8799999997,1182735.1199999996
47,U31CB74,678,97439.79000000015,477,201,2649756.16,2747195.9499999997
48,U63A95C,676,-8244.040000000008,615,61,73393.0100000001,65148.97
49,UE76E4E,659,2433909.0400000014,181,478,4627824.970000001,7061734.0100000035
50,UF68F85,643,3198.070000000024,109,534,47461.24999999999,50659.31999999991
51,U2756ED,641,401.6600000000028,389,252,341945.88999999996,342347.55
52,U7A31C5,628,-22046.30999999998,308,320,1346324.75,1324278.4400000004
53,U85C0E4,625,-12365.009999999966,585,40,388264.9599999999,375899.94999999995
54,U96F0EA,618,2945.590000000001,491,127,83006.18999999999,85951.78
55,U34B527,615,10086.590000000011,77,538,1207180.5799999998,1217267.1700000004
56,U0E37F5,605,4971.859999999997,352,253,338374.74000000005,343346.60000000003
57,U266F12,604,-4517.470000000023,404,200,865562.6199999999,861045.15
58,U986B6F,598,-21097.340000000106,524,74,2518022.879999999,2496925.540000001
59,UF91BBF,598,54.81000000008309,431,167,1375884.7000000002,1375939.5099999998
60,U1F0543,595,678691.8599999992,288,307,1036269.3700000009,1714961.2299999997
61,UC64EB9,593,-3068.910000000009,472,121,1441256.2600000007,1438187.35
62,UEF6C20,592,88.17999999999995,330,262,18613.58,18701.760000000006
63,UFE92A2,589,2189.8100000000104,330,259,301088.67,303278.47999999986
64,U7EABCA,587,40861.77000000013,526,61,5181587.87,5222449.64
65,U29B92F,582,-10480.610000000026,400,182,389367.2599999998,378886.65
66,UACA00B,580,5718.800000000026,258,322,808271.4299999998,813990.2299999994
67,U107C9F,575,720.199999999996,538,37,42137.560000000034,42857.76
68,U5B2FBF,573,50441.89000000001,269,304,1402023.5100000002,1452465.4000000001
69,UEBD77E,573,-2519.030000000193,231,342,1330548.8,1328029.7700000003
70,UB800CA,565,-5020.270000000006,305,260,434931.6700000001,429911.40000000014
71,UB7F9F3,563,260.6100000000142,358,205,948883.31,949143.92
72,U4F50E1,559,23425.280000000028,541,18,175952.86,199378.14
73,U89BC09,550,-3674.320000000007,526,24,271224.76999999996,267550.45
74,UEEE8DC,547,-8948.080000000005,349,198,355539.05000000005,346590.97000000015
75,U9828D0,541,1010.7199999999903,295,246,297443.86,298454.5799999999
76,UDE0FDE,538,4342.029999999999,477,61,196522.32,200864.35
77,U0F284E,533,-1480.4500000000019,461,72,47002.37,45521.92
78,U9CFA30,530,4193.419999999944,404,126,999469.3200000002,1003662.74
79,UCD0DCD,529,-12846.41999999998,369,160,625338.11,612491.69
80,UE809C2,523,681.7999999999865,332,191,263941.25999999983,264623.05999999994
81,U21DE75,523,10002.62000000002,321,202,666475.8600000003,676478.4799999995
82,UE3505A,523,10624.17000000016,295,228,1739998.4,1750622.5699999994
83,U717425,523,8867.350000000053,473,50,764917.4300000003,773784.7799999999
84,UFB70C2,522,-114666.47999999992,126,396,908497.4,793830.9199999985
85,U759047,521,-30179.699999999993,499,22,78012.67,47832.97
86,U327D23,520,-42824.11999999998,512,8,51082.31999999998,8258.2
87,UBC74E6,507,15585.360000000006,303,204,169236.66000000003,184822.0199999999
88,UE236BD,504,-3949.989999999999,465,39,61988.850000000006,58038.86000000001
89,U10A437,503,-364.3999999999978,412,91,70724.70000000001,70360.30000000003
90,UC2D7D4,501,-1640.1499999999953,393,108,48878.77,47238.61999999998
91,UB16DDD,501,-1049.5,401,100,331525.60999999987,330476.1099999999
92,UD46124,501,-195837.92000000022,371,130,1039269.61,843431.6900000001
93,U99F265,499,-2103.9300000000085,465,34,11276.669999999978,9172.739999999996
94,U941178,498,15056.13,459,39,336214.7699999999,351270.89999999997
95,U973393,496,-221548.3899999999,479,17,322677.4799999998,101129.09
96,U3F8E12,496,5020.77,465,31,44856.84999999998,49877.619999999995
97,U3C5E15,493,635.1699999999951,362,131,97918.47,98553.63999999996
98,UE0D243,489,-1246.2499999999984,392,97,28238.100000000017,26991.85
99,U13F838,489,3141.830000000009,338,151,350979.98,354121.81
100,UDE0C8A,488,11460.949999999992,371,117,550104.4400000001,561565.39
101,U055341,488,-8438.120000000014,351,137,369325.6000000001,360887.48
102,U7C293C,486,-4851.389999999999,467,19,60255.290000000045,55403.90000000001
103,U928AE0,486,-790037.1199999998,383,103,3222391.4600000014,2432354.3400000003
104,U864B8A,485,-2983.1500000006636,461,24,400567.5900000004,397584.44
105,U6DDAAC,483,-51875.95000000005,286,197,1503594.4400000002,1451718.4900000005
106,UB222C4,482,-831.6100000000115,402,80,394947.59,394115.9800000002
107,UF2EED9,482,-59.62999999999853,335,147,52167.53,52107.90000000001
108,UEAEE3F,482,10390.890000000083,402,80,1772735.78,1783126.67
109,U227B75,479,-892.9500000000021,420,59,173887.05,172994.1
110,U3453FB,478,1364.5200000003315,284,194,2260656.75,2262021.2699999986
111,U91F980,478,-10762.840000000006,229,249,40167.119999999995,29404.27999999998
112,U00297F,478,-1742.319999999985,233,245,771199.7400000002,769457.4200000004
113,U4F5D45,478,-3866.659999999991,423,55,60695.840000000004,56829.180000000015
114,UD476C3,477,1379.5999999999685,474,3,35620.400000000016,37000.0
115,U25BEA9,475,3796.879999999981,438,37,407646.58999999997,411443.47000000003
116,UC6B245,475,-7873.219999999754,172,303,2288585.6799999997,2280712.46
117,U037D91,473,-16164.629999999855,266,207,1217727.6599999997,1201563.0300000003
118,U5E0F3F,473,52778.44999999995,411,62,3790243.9299999974,3843022.38
119,UD795CE,472,0.7400000000094755,322,150,19106.539999999997,19107.27999999999
120,U1B3516,472,-4654.639999999959,287,185,1198412.5599999998,1193757.92
121,U4A6F76,471,-11328.559999999992,420,51,60551.280000000035,49222.72
122,U63E662,470,10301.850000000006,240,230,872431.0299999998,882732.8799999999
123,U5FC08B,470,-366371.3399999998,412,58,1820093.0999999999,1453721.76
124,UFD6C4E,470,-7619.869999999993,411,59,106976.08999999998,99356.22
125,U8B491E,469,-9587.74000000002,381,88,165407.71000000005,155819.97000000003
126,UA33A67,469,-1569.9099999999964,403,66,28204.240000000005,26634.329999999998
127,U0883BB,469,-166637.27999999997,272,197,4799234.83,4632597.549999999
128,U62D6D0,467,-14884.580000000027,347,120,677465.7,662581.1199999999
129,UBF6C87,467,-12385.529999999999,299,168,696076.7800000004,683691.25
130,U19D4A6,466,-54.220000000001534,415,51,13374.26,13320.039999999995
131,UBF9D2F,466,6843.650000000023,313,153,164235.73999999996,171079.39000000007
132,UF1BFA7,463,14341.779999999988,243,220,769857.6799999999,784199.46
133,U3B257F,462,-3293.5799999999967,373,89,105168.93999999999,101875.36
134,UC071A3,460,-10923.490000000103,131,329,592049.12,581125.6300000007
135,U3CCCF0,460,-5944.389999999898,340,120,14432794.7,14426850.309999999
136,U61A00E,458,57142.580000000075,282,176,887658.8099999988,944801.39
137,U5A7C62,458,605.0399999999845,402,56,89885.84000000007,90490.87999999998
138,U3EAC02,456,49.99000000000126,403,53,53489.43999999995,53539.43
139,UF4D674,455,12149.070000000018,203,252,682713.8399999999,694862.9099999993
140,U5A1B35,452,-39639.01000000005,341,111,3147249.4999999995,3107610.49
141,UC01548,451,-869.1000000000053,415,36,228560.83000000002,227691.73
142,UF4FE25,449,-185.42000000000155,399,50,50773.62999999999,50588.21000000001
143,UC54C41,449,-8850.419999999613,404,45,5318450.14,5309599.720000001
144,U7BAFBE,448,131773.15,301,147,261595.66000000003,393368.81000000006
145,UF9DB5B,447,98413.38000000012,405,42,4026906.449999999,4125319.8299999996
146,U6F71B7,447,-13635.760000000002,390,57,82766.74000000002,69130.98
147,U8D16FD,445,-103516.07000000002,378,67,321183.02000000014,217666.95
148,UFB19C1,443,-9945.679999999998,420,23,57350.21000000007,47404.530000000006
149,UB4E164,441,-8246.849999999999,280,161,51505.270000000004,43258.420000000006
150,U217337,440,1951.3900000000044,231,209,414126.29,416077.6800000001
151,U96BBFF,440,96269.77999999998,211,229,942410.4000000003,1038680.1799999989
152,UA1B000,438,-8078.390000000003,424,14,168711.49000000002,160633.1
153,U6D4EFF,438,2883.78,347,91,7505.679999999999,10389.460000000003
154,UA06EF3,435,3119.5099999999848,401,34,254923.16999999995,258042.67999999996
155,U4E5489,435,-663.0500000000012,304,131,67776.77000000002,67113.72000000004
156,U8B3216,432,6388.480000000082,297,135,1006691.4,1013079.8800000001
157,U5F1A71,432,17607.02999999999,382,50,98324.55000000006,115931.58000000002
158,UBA34D6,432,-5020.5099999999875,411,21,291664.12,286643.61
159,U416C8F,432,-5037.009999999997,316,116,299856.1500000001,294819.14
160,UE419E5,429,2646.690000000006,337,92,211297.85999999987,213944.54999999993
161,UE125BC,428,15936.339999999951,413,15,267113.0,283049.34
162,U813A31,428,1087.9499999996974,382,46,12405474.580000006,12406562.53
163,UAA0B47,428,7760.80999999999,340,88,104964.92000000001,112725.72999999998
164,UC0388C,425,-636.4000000000672,120,305,351783.4900000001,351147.0900000007
165,UC865F6,424,1897.7400000000064,318,106,959176.8600000001,961074.6
166,U400570,423,-2563.510000000007,378,45,243418.83,240855.31999999998
167,UECB5AC,422,7423.1400000000285,274,148,3646584.02,3654007.16
168,UBDC19E,421,18826.210000000072,204,217,1247040.1400000001,1265866.349999999
169,UFA0E4B,420,-27307.790000000008,268,152,375637.2800000001,348329.49
170,UB8F54D,419,-17828.69999999998,396,23,197471.91999999993,179643.22
171,UF9593D,419,-3371.100000000052,394,25,45293.61999999989,41922.52
172,U721319,417,-186635.12999999998,408,9,257228.44000000003,70593.31000000001
173,U20A617,415,-27099.539999999994,389,26,147156.91,120057.36999999998
174,U15F5AA,414,-1017.2999999999993,211,203,581732.53,580715.2300000002
175,U733A93,414,-1167.9499999999944,335,79,106711.12999999999,105543.18
176,U4ED5F2,413,-2760.659999999943,319,94,258140.79000000042,255380.12999999998
177,U82F8BA,412,-65942.41999999993,368,44,604781.18,538838.76
178,UF9044F,411,3120.0,204,207,12192.999999999998,15313.0
179,U7E0CB4,410,-13891.389999999968,261,149,666186.32,652294.93
180,U623170,410,845.7900000000012,387,23,27910.630000000005,28756.419999999995
181,U675D2A,408,-25157.120000000017,375,33,129754.69,104597.56999999999
182,U058703,407,-8348.119999999974,398,9,1040296.57,1031948.4500000002
183,U4127CF,407,-16950.899999999976,382,25,356691.98999999993,339741.09
184,U3CAC8F,406,22366.05000000001,208,198,559723.83,582089.8799999999
185,UE985BB,406,8929.049999999985,380,26,26036.74999999998,34965.799999999996
186,UCC6541,405,-121.00000000000182,206,199,56263.39,56142.39000000001
187,U722645,404,-34490.98000000003,251,153,518102.76000000007,483611.7800000001
188,UF5DA8A,404,-353.50999999999794,364,40,60941.80000000001,60588.29
189,UFE98E1,404,11583.990000000007,80,324,560173.6,571757.5899999999
190,U37329B,401,1670.1099999999788,252,149,573397.63,575067.7400000001
191,U0322ED,401,1827.129999999999,319,82,27051.4,28878.530000000002
192,U7BB53B,400,-151690.1799999997,244,156,5740263.6,5588573.419999999
193,U1B6544,398,-25593.599999999962,346,52,1207389.94,1181796.34
194,UE15319,397,-16447.350000000006,353,44,294751.31999999995,278303.97
195,U098BA0,396,-5048.020000000102,257,139,3468481.4499999993,3463433.43
196,UEC8CFE,396,-7649.900000000002,279,117,949420.1300000001,941770.2300000003
197,U381D15,396,-4006.179999999999,378,18,33068.59000000002,29062.41
198,U8961D3,396,-2696.559999999996,314,82,115476.57999999996,112780.02
199,UC51A50,395,26246.840000000015,299,96,110839.93000000001,137086.76999999987
200,UEF155F,395,-428.0900000000087,341,54,35404.03000000002,34975.94
201,UD118A2,394,-42293.90999999993,371,23,482325.35,440031.44
202,U343303,393,242.5500000000006,204,189,146741.17,146983.72
203,UCCBAC0,393,1666.4199999999955,264,129,362422.19999999995,364088.62000000005
204,U2CBA03,393,9496.149999999978,352,41,144893.99999999994,154390.15
205,U76A4F3,393,66355.98999999998,358,35,405737.95,472093.93999999994
206,U10C07C,393,17936.729999999967,334,59,395420.32999999984,413357.06000000006
207,U833653,392,-2265.889999999931,299,93,901133.92,898868.0299999999
208,U8D9573,390,-1486.5299999999825,371,19,63827.669999999984,62341.14
209,U5FEF60,390,1396.020000000005,366,24,35418.170000000006,36814.19
210,U521428,388,1929.7900000000004,344,44,32188.61,34118.40000000001
211,UD51175,388,-21931.259999999813,332,56,9655925.010000005,9633993.749999998
212,UF5973C,387,29162.649999999558,308,79,18712861.370000005,18742024.02
213,U157419,386,-180.46000000000004,249,137,78634.24999999999,78453.79
214,UA8D176,386,10180.599999999977,313,73,1570600.0899999999,1580780.6900000004
215,UB6142B,386,7055.090000000004,350,36,124065.25,131120.34
216,U1E5613,386,2447.2700000000004,321,65,55119.95,57567.22
217,U0604A3,384,-8825.210000000001,342,42,50105.12000000002,41279.91
218,U332870,382,2012.6299999999992,289,93,256928.5599999999,258941.18999999997
219,U850804,382,110.0400000000227,204,178,1229119.57,1229229.6099999999
220,U641DBD,382,624.4499999999935,317,65,66689.65999999999,67314.11000000002
221,UC08281,382,39813.13999999996,355,27,492432.43,532245.5700000001
222,U2E9D32,381,2577.4200000000023,325,56,14620.929999999997,17198.350000000002
223,U85B6D6,380,4834.790000000015,237,143,307435.16,312269.95000000007
224,U6A82E0,380,246.64999999999054,265,115,222941.24,223187.89000000004
225,U7E4F0A,379,-1165.3299999999635,115,264,1471101.8200000003,1469936.4899999988
226,U2AB8AD,379,-15693.359999999993,332,47,229876.4999999999,214183.14000000004
227,UB12884,379,-60758.28999999998,351,28,713114.2499999999,652355.96
228,U63EB94,378,-4306.260000000003,360,18,33933.729999999996,29627.469999999998
229,UBF9349,378,-1156.3499999999838,325,53,104029.52000000002,102873.17
230,U916290,377,4112.12000000001,221,156,652519.4900000003,656631.6100000001
231,U53E44F,376,-701.7999999999938,344,32,182718.54000000007,182016.74000000002
232,U56BBA5,375,19477.020000000015,310,65,577698.2100000001,597175.23
233,UCDAF93,375,-16749.560000000005,349,26,206492.63,189743.07
234,U75CDBA,374,10886.080000000016,285,89,345401.76,356287.84
235,U45FF99,374,752.8099999999974,229,145,79558.01,80310.81999999999
236,U0321CE,373,1389.340000000022,293,80,212487.63,213876.97000000006
237,UA99645,372,-1940.0699999999974,328,44,38386.950000000004,36446.880000000005
238,UEE56CA,371,-108.50000000000236,352,19,6311.95,6203.450000000002
239,UAF7277,371,3918.809999999985,362,9,33479.44000000002,37398.25
240,UBF2CA0,369,-23446.58,331,38,453057.50999999995,429610.93
241,UFEBAEA,369,1110.8100000000916,319,50,713349.5599999995,714460.3699999999
242,U99046B,369,-26987.979999999872,223,146,1939167.8199999998,1912179.8400000012
243,U6B2266,368,-2091.669999999989,313,55,528494.96,526403.29
244,U7B221A,368,38203.680000000015,288,80,874181.8099999999,912385.4899999999
245,U5CC9DA,367,35368.84999999998,305,62,813462.0600000003,848830.91
246,U72A188,366,4152.7000000000135,342,24,62069.00000000003,66221.70000000001
247,U3FF6F2,366,24634.869999999963,356,10,178154.80999999994,202789.68
248,U217A73,366,1778.859999999999,343,23,16613.439999999988,18392.299999999996
249,UCC81B7,366,-76964.33000000003,303,63,145434.39999999997,68470.07
250,U4ECCB6,366,37812.06000000004,250,116,1141369.04,1179181.0999999996
251,U3DAA7B,366,2898.3299999999963,313,53,1222773.9500000002,1225672.2800000003
252,U725ADE,366,-2542.6000000000013,241,125,50241.65000000001,47699.05
253,U961DBB,365,2572.360000000117,190,175,1668096.3099999998,1670668.669999999
254,U18ABA9,365,2304.8899999999976,351,14,53272.25,55577.14
255,U041223,365,-33353.040000000066,217,148,1466079.16,1432726.1199999999
256,U13C08B,364,16.350000000010823,209,155,204121.31999999995,204137.67000000007
257,U462BAA,364,4271.559999999884,349,15,462215.93,466487.49000000005
258,U4A6DC4,363,3764.9700000000034,352,11,18352.929999999997,22117.899999999998
259,U220004,363,975095.81,321,42,54647.01,1029742.8200000001
260,UE6E1CB,362,7038.640000000014,330,32,344562.1499999999,351600.79
261,U6C89D5,362,763.0900000000138,336,26,146775.33999999997,147538.43
262,UF37F49,361,-7107.290000000008,355,6,19227.370000000003,12120.080000000002
263,U699D61,361,91260.63000000006,223,138,588241.5499999996,679502.18
264,U1603EB,361,-44015.420000000006,339,22,403422.49,359407.06999999995
265,U43E226,361,-8903.650000000003,324,37,125167.56999999998,116263.92
266,UA0F1E7,360,-25542.85,351,9,50340.360000000015,24797.51
267,U02A411,360,-42325.239999999976,346,14,95755.11,53429.87000000001
268,U886DCB,360,-5776.830000000003,317,43,482574.1400000001,476797.31
269,UA279A1,360,11265.159999999989,325,35,132552.47,143817.62999999998
270,U37D082,358,-98.96999999999969,302,56,30835.179999999993,30736.210000000006
271,UA5A878,358,5037.059999999996,255,103,272417.7899999997,277454.85
272,U874DDD,357,-396.0999999999981,195,162,179492.3,179096.19999999998
273,U7D3CE6,357,-8205.780000000013,334,23,183326.14000000007,175120.36
274,UEBA468,356,4723.9400000000005,274,82,142461.3,147185.24000000002
275,U8365A8,356,-1380.1700000000033,334,22,26655.46,25275.289999999994
276,U37755B,356,13691.06000000001,311,45,167571.18000000002,181262.23999999996
277,UBA6962,355,8518.319999999983,318,37,136934.18999999997,145452.50999999998
278,UB9D9A8,355,-15774.35,228,127,152158.3,136383.95
279,UE30551,354,5226.330000000002,322,32,646632.43,651858.7599999999
280,U68AF52,354,-12832.110000000006,322,32,1276386.77,1263554.6600000001
281,U8D59FC,354,-2170.2099999999923,317,37,59637.28000000004,57467.07
282,U64AFD1,354,-908995.8899999992,263,91,7626495.570000001,6717499.679999998
283,UE5935B,354,13629.85999999997,336,18,182882.06,196511.91999999998
284,U6784D0,354,654.9699999999232,219,135,512931.18,513586.14999999997
285,U8D1356,353,960.71000000001,340,13,34232.22,35192.93
286,UEE294D,353,40593.310000000005,330,23,89834.26000000001,130427.56999999999
287,U4EF536,352,-1398.6800000000567,317,35,473299.33,471900.6499999999
288,UDADA94,351,-2319.639999999998,329,22,53011.56000000001,50691.91999999999
289,U47D06A,351,2601.290000000008,343,8,78805.69,81406.98000000001
290,UA571DD,350,10324.799999999994,321,29,73618.02999999998,83942.83
291,U2725E5,350,-1869.7400000000025,291,59,25970.360000000004,24100.62
292,U248286,349,-217492.76999999981,319,30,449085.81,231593.04000000004
293,U612583,349,303509.70999999996,290,59,437489.78999999986,740999.4999999999
294,U7D6E3E,349,2986.8600000000097,323,26,33339.92999999999,36326.78999999999
295,U95F3FF,349,128765.61999999995,288,61,613070.6100000001,741836.2300000001
296,UA18665,349,-3414.910000000001,334,15,29548.31999999998,26133.409999999996
297,UA878C6,348,-39469.80000000007,243,105,1057061.91,1017592.1099999999
298,U23CB51,348,-39295.45000000001,256,92,2253394.05,2214098.6
299,U59E40E,348,2230.4599999999336,303,45,914752.4199999998,916982.88
300,UF08451,348,-7037.609999999986,260,88,308807.80999999994,301770.20000000007
301,UD67C59,347,3881.6399999999967,336,11,31153.41999999999,35035.06
302,UD7A185,347,-385.2700000000186,273,74,870239.6999999998,869854.4300000003
303,UFC4E5E,347,-5725.460000000017,297,50,302991.48,297266.02
304,UE2FE74,346,-11049.179999999975,288,58,497721.61000000004,486672.43000000005
305,UDFDBC3,346,-1142.619999999998,327,19,10722.639999999996,9580.019999999999
306,U0E3AAE,346,-5034.730000000002,273,73,468138.23000000004,463103.50000000006
307,UFD9098,346,730.0499999999929,227,119,572585.93,573315.98
308,UBB9A3E,346,87625.70999999996,279,67,172388.99999999994,260014.71
309,UF6FBE1,346,-5256.399999999998,332,14,58395.93,53139.53
310,U2B73F7,345,-1848.3400000000015,297,48,41890.54000000001,40042.200000000004
311,U8D56B5,345,60893.869999999995,195,150,727647.5700000001,788541.4400000002
312,UD86834,344,-64129.700000000055,315,29,118305.07000000002,54175.369999999995
313,U1CF2E8,344,173911.06,306,38,1041958.2200000001,1215869.28
314,U9BF255,344,141955.27000000005,327,17,100488.13000000008,242443.4
315,UB875A7,343,28857.240000000027,316,27,116335.73000000008,145192.97
316,U7F1B85,342,72774.3599999999,323,19,1342791.01,1415565.37
317,U7DD31F,341,-142.7099999999948,299,42,72444.90999999999,72302.2
318,U7C5574,341,-14251.990000000005,227,114,247733.1700000001,233481.18
319,UA6B813,341,462831.47000000003,307,34,225390.89000000004,688222.36
320,UF90A24,340,-218.39000000000033,321,19,47507.59999999998,47289.21
321,U317AC9,340,-21588.17,226,114,838545.4800000001,816957.3099999999
322,U206C2E,339,-14583.870000000019,194,145,621753.27,607169.4
323,U292452,338,-55008.19000000002,291,47,1445803.1500000001,1390794.96
324,UF7E7A2,338,13262.519999999993,221,117,536750.6599999999,550013.18
325,U072A79,338,222045.0,253,85,226688.0,448733.0
326,U929399,337,-3706.2500000000023,326,11,42783.63999999998,39077.39
327,U963B99,337,220.68000000001848,222,115,479650.55999999994,479871.23999999993
328,U10002E,337,1474.8999999999987,319,18,11532.120000000004,13007.02
329,U983992,336,128554.47000000002,270,66,325616.97,454171.43999999994
330,U284F09,336,128116.90000000007,328,8,8165.169999999998,136282.06999999998
331,U17C282,336,-1492.9899999999952,278,58,95599.62000000005,94106.63
332,U4D75B3,336,-45426.800000000054,261,75,1922666.4199999997,1877239.62
333,U27510E,335,-57602.99999999999,327,8,220308.2,162705.2
334,U8C56FA,335,2577.5800000000036,286,49,184455.74000000002,187033.31999999998
335,U3E3993,335,5437.289999999989,272,63,189623.88,195061.16999999998
336,UA05BBD,334,-1155.4499999999998,286,48,35414.959999999985,34259.509999999995
337,U543D9E,334,250.81999999996606,281,53,149930.16999999993,150180.99
338,U021599,334,3531.839999999996,300,34,52945.37999999994,56477.22000000001
339,UA2ABE3,333,-220.91000000000057,330,3,5122.500000000001,4901.59
340,U25C18E,333,-10221.039999999986,304,29,98720.46,88499.42
341,U75AAE6,332,1767.4300000000203,276,56,152693.82000000007,154461.24999999994
342,U9C67B5,332,-24303.200000000077,280,52,1295691.3,1271388.1
343,U71E6B2,332,890.3500000000016,306,26,62769.75000000001,63660.100000000006
344,U539B64,331,2127.7899999999654,301,30,147837.26,149965.05000000002
345,U840D14,331,1856.5400000000059,309,22,47984.59000000001,49841.13
346,UD3F0FA,331,-9934.470000000007,266,65,236142.29999999987,226207.83
347,UE3CF07,330,911.8599999999408,305,25,960563.6400000001,961475.4999999999
348,UEDA706,330,-5269.260000000003,215,115,123132.20000000003,117862.93999999999
349,U0EF7F4,329,-8193.599999999999,293,36,46856.45999999999,38662.86
350,UC1140F,329,-96541.19999999998,287,42,1055560.5300000003,959019.3300000001
351,U610B0A,329,427.69000000000347,304,25,35378.36,35806.05
352,UDD7C92,328,-564.6199999999999,301,27,29585.050000000007,29020.430000000008
353,U48FFD7,328,-1530.4199999999923,154,174,61765.61,60235.190000000024
354,U57345E,328,1544.8000000000065,228,100,151158.28,152703.08000000002
355,U83F64D,328,1308.870000000001,251,77,147477.74000000002,148786.61
356,U6D37F9,328,8061.290000000003,240,88,354881.8100000001,362943.1000000001
357,U864FBA,327,12276.210000000005,303,24,323289.44,335565.65
358,U6496FE,326,11230.109999999666,240,86,491589.6100000005,502819.72000000003
359,UD12184,326,-121645.55999999997,211,115,850058.04,728412.4799999999
360,U4A9867,325,-2400.439999999998,286,39,32371.470000000016,29971.030000000002
361,U269A35,325,-1003.4100000000017,320,5,16659.88,15656.47
362,UD7990F,324,-1012.8200000000088,273,51,241665.12,240652.30000000002
363,UD45413,324,-46020.19999999991,228,96,1111202.7500000005,1065182.55
364,U7EAA2B,323,17.590000000003783,198,125,95022.42,95040.01
365,U2CD6EF,323,-6486.319999999994,268,55,87508.32999999999,81022.01000000002
366,U4BFE71,323,-374.38999999995576,262,61,1541558.6500000004,1541184.2600000002
367,U05FF30,323,-15.940000000002328,164,159,358244.83,358228.89
368,UDE726E,322,11630.329999999993,251,71,251636.47999999995,263266.81
369,U6FE9E1,322,7149.800000000003,244,78,321371.1100000001,328520.91000000003
370,UB5B083,322,47512.67,280,42,46308.63,93821.29999999999
371,UAFB882,321,86392.29999999999,304,17,9577.65,95969.95
372,U43E779,321,-718.4500000000473,302,19,151493.21,150774.75999999998
373,UE8E02C,321,-333.5999999999982,188,133,165396.59999999995,165062.99999999997
374,U4D4A3C,321,-380.97,285,36,7947.43,7566.46
375,U11FF05,321,2721.819999999996,189,132,96275.7,98997.51999999995
376,UCCE1E6,321,-6734.050000000001,204,117,110436.18,103702.12999999999
377,UEC4DE6,321,-5279.169999999998,309,12,16676.100000000002,11396.93
378,U9D1D08,320,-21688.16,311,9,51551.62000000003,29863.460000000003
379,UDC8F13,320,2191.9900000000007,299,21,10622.900000000007,12814.890000000001
380,U45B9B2,320,-1029.2600000000032,301,19,56250.37000000002,55221.11000000001
381,U61A76A,320,-30836.709999999992,305,15,61642.62,30805.91
382,U2A825C,319,286.46000000002095,274,45,313682.62999999995,313969.09
383,UF17675,319,-391.7600000000004,286,33,15993.960000000003,15602.2
384,U14FF14,319,84.03000000000347,307,12,14707.27,14791.3
385,UEF2757,319,205.11000000000604,271,48,47648.369999999995,47853.48
386,U7972A9,318,-99.23000000000184,203,115,182673.33999999997,182574.11
387,UA1A96F,318,2069.8200000000015,299,19,47569.08999999999,49638.909999999996
388,U90A9D6,317,13271.330000000005,255,62,228442.49999999997,241713.8300000001
389,U5DB775,317,23285.190000000006,270,47,530949.4400000001,554234.63
390,UD4E403,317,-2128.28,304,13,9156.279999999999,7028.0
391,U116F52,317,3813.600000000006,246,71,70681.19,74494.79000000001
392,U6ECD77,316,-4105.49,244,72,104993.87,100888.38000000002
393,U3B3236,316,2150.2199999999984,297,19,40235.18000000001,42385.4
394,U4C6E93,316,593.8399999999949,291,25,28973.439999999995,29567.280000000002
395,U5BAB2A,316,-93577.21000000005,292,24,370238.91000000003,276661.7
396,UEABD49,315,-705.1899999999999,302,13,11270.660000000003,10565.47
397,U0CB7E1,315,334.23999999983243,274,41,3103901.8399999966,3104236.08
398,UE15C69,314,1465.8600000000017,295,19,12007.889999999994,13473.750000000002
399,U0E9B02,313,16822.960000000006,283,30,2268994.39,2285817.35
400,UBCF98C,313,-14575.580000000004,267,46,145846.98999999996,131271.41
401,U1BD97C,313,-400.3900000000576,161,152,1598185.2400000002,1597784.8499999996
402,U17F23A,313,-5436.12999999999,290,23,42081.79999999999,36645.67
403,U915504,313,-2825.609999999949,263,50,1654079.4899999998,1651253.88
404,UF0DD4A,312,882.5000000000291,168,144,1045319.05,1046201.55
405,U8531A3,312,146.27999999999736,214,98,97001.56000000001,97147.84000000001
406,UD23E76,311,-1773.9199999999987,256,55,12774.449999999995,11000.53
407,U82D2E8,311,-69422.49000000002,279,32,463054.68000000005,393632.19000000006
408,UE7EB8C,310,3995.860000000008,273,37,78525.25999999997,82521.11999999998
409,U78781D,310,-472.03000000000156,216,94,269049.54000000004,268577.51
410,U7AF826,310,-395.0099999999911,281,29,280646.47999999986,280251.47
411,U2F27D7,310,-7360.969999999999,284,26,34616.49,27255.520000000004
412,U4B04C0,309,-6704.969999999993,266,43,66375.15,59670.18
413,UE4EA69,309,12674.479999999996,290,19,154526.91999999998,167201.4
414,UFA3C61,309,444964.58,285,24,149708.07000000004,594672.6500000001
415,U0F0548,309,1490.6500000000028,254,55,33706.299999999996,35196.95
416,UBD19C7,309,-173124.31999999992,293,16,392802.79999999993,219678.48
417,UA4713F,309,9326.68999999999,280,29,191647.25999999998,200973.94999999998
418,UDDA1E4,309,-2266.609999999995,206,103,2110464.6199999996,2108198.01
419,U53AE8F,308,4891.999999999996,302,6,27053.96000000001,31945.96
420,UB4311F,308,-27078.399999999987,296,12,82578.85,55500.45
421,U49D5B9,308,-11980.619999999966,228,80,735314.75,723334.13
422,UAEBFA2,308,26294.589999999993,299,9,22933.080000000005,49227.67000000001
423,UDE284B,307,-31812.079999999994,271,36,1540214.7500000007,1508402.6699999995
424,U3B3DDA,307,-22657.899999999998,293,14,63347.10999999999,40689.21
425,U04ADA3,306,2333.8199999999997,298,8,125581.86000000002,127915.68
426,UC0A624,306,19088.25,259,47,85339.09,104427.34
427,UA7D199,306,-25885.310000000052,241,65,63248.540000000015,37363.23000000001
428,U225639,306,4185.72,265,41,88189.98000000001,92375.69999999998
429,U0619C1,305,-6167.0100000001585,280,25,776205.0000000003,770037.99
430,UCF60F2,304,1128.5100000000007,225,79,71322.63999999998,72451.15000000001
431,U29E0B4,304,-3514.210000000002,204,100,60727.509999999995,57213.30000000001
432,UDD2716,304,-18309.240000000013,228,76,792283.05,773973.8099999999
433,UCCE2FF,304,574.9700000000003,298,6,8821.999999999996,9396.970000000001
434,U9CA569,304,42680.43999999999,279,25,196068.06999999986,238748.51000000004
435,U8A7EAF,304,32681.03,250,54,1309266.58,1341947.6099999999
436,UEC4EFB,303,-394099.28,261,42,729616.95,335517.6699999999
437,UC4C5D0,303,4358.10999999999,280,23,43633.62000000001,47991.73000000001
438,U98B7D5,303,27758.649999999987,282,21,145790.25,173548.90000000002
439,U5B4CC2,302,-5196.820000000003,177,125,583739.42,578542.6000000001
440,UDD9E36,302,-33478.539999999986,161,141,277075.98,243597.44
441,U499501,301,30062.530000000028,246,55,140097.48999999996,170160.02000000002
442,U7CF6C8,301,28064.340000000044,186,115,1463142.6999999997,1491207.04
443,U52CE62,301,-127761.9700000001,268,33,275771.6299999995,148009.65999999997
444,U10FFCC,301,-20647.759999999995,189,112,644090.2799999996,623442.5199999998
445,UF82F1D,301,4419.25,266,35,159355.27000000002,163774.52000000002
446,U1AD587,301,206.359999999995,292,9,19321.510000000002,19527.87
447,UFFF441,301,0.9499999999898137,205,96,245630.59999999998,245631.55
448,U6CCF4E,301,22898.2,278,23,42689.82,65588.01999999999
449,U44F356,300,902.1000000000033,287,13,34108.79,35010.89
450,UBE165A,300,114380.04999999994,259,41,1734756.1099999999,1849136.16
451,UFFDFA1,299,1856.340000000013,249,50,340951.42000000144,342807.76000000007
452,U0D9761,299,-40896.36999999994,266,33,1063636.08,1022739.71
453,U3A17AF,299,-229.13000000000648,292,7,24790.820000000007,24561.69
454,U4BB11E,299,-125.36000000001047,272,27,27848.840000000084,27723.479999999996
455,U8CA173,299,-6.839999999989232,151,148,1304204.39,1304197.5499999996
456,U9D1A53,299,-2059.810000000012,296,3,27277.240000000013,25217.43
457,U1B9BB2,299,-3098.360000000008,271,28,70763.07000000004,67664.70999999999
458,U6D786C,299,24980.48,278,21,69623.79000000001,94604.26999999999
459,U25C489,299,15685.299999999961,145,154,499140.7499999999,514826.04999999993
460,U77FABA,298,49342.84999999995,251,47,1299453.7900000005,1348796.6400000001
461,UD3C14C,298,220673.5099999997,285,13,297548.94000000024,518222.45000000007
462,U2BE5AF,298,-8071.989999999898,248,50,992167.41,984095.42
463,UCC35E4,298,8506.260000000007,276,22,30940.290000000008,39446.55
464,UBE87EA,297,-110041.33,247,50,1128430.8900000001,1018389.5600000002
465,U805F64,297,65414.42000000004,270,27,310953.6300000001,376368.0500000001
466,U900871,296,-356257.78000000014,173,123,2203558.8,1847301.02
467,UD91AB4,296,389.6599999999994,158,138,31359.43999999999,31749.100000000002
468,U026E9F,296,-188609.27,278,18,290530.99,101921.72
469,U0E76EF,296,-1816.5600000000024,256,40,48535.770000000055,46719.210000000014
470,U122530,296,-10627.299999999994,282,14,57737.810000000005,47110.509999999995
471,UF56BCB,296,-1965.4100000000005,281,15,40448.12,38482.71
472,U646A86,294,3686.4599999999955,281,13,25636.95999999999,29323.42
473,U0CE1E3,294,-483.10999999999916,276,18,13385.889999999998,12902.779999999999
474,UB439F7,294,3183.7299999999987,267,27,70021.77,73205.5
475,U5FCCEB,294,-1127.6699999999778,216,78,711369.6599999998,710241.9899999999
476,U1287F8,293,-667.0699999999979,289,4,35291.219999999994,34624.15
477,UACAA14,293,-1446.629999999976,267,26,233888.30999999997,232441.68000000002
478,UDD054F,293,20167.120000000006,242,51,465799.3200000003,485966.44
479,UC9D610,293,-3072.109999999988,271,22,56237.87999999995,53165.76999999999
480,U843B55,293,-3165.4200000000014,269,24,21882.790000000008,18717.370000000003
481,UEF3E53,292,-2250.4399999999896,211,81,732759.4,730508.9600000002
482,U01A475,292,17735.98,278,14,14306.009999999993,32041.99
483,U34C5A9,292,-48261.86000000004,200,92,564263.2599999999,516001.39999999997
484,UF87920,292,-19629.35,244,48,654834.7899999998,635205.44
485,U90EC36,291,47271.22000000003,269,22,168909.01999999996,216180.24000000005
486,U338E1A,290,18538.56999999994,258,32,120638.40999999999,139176.97999999998
487,U169828,290,-45734.45999999999,156,134,1436509.53,1390775.07
488,U8C9D8C,290,2340.630000000012,232,58,109825.38000000002,112166.01000000001
489,U8DF817,290,25761.220000000027,146,144,1015705.2300000001,1041466.4500000001
490,UED1BA5,290,27615.709999999985,268,22,161565.30999999997,189181.01999999996
491,UB86F60,289,5400.250000000002,261,28,270544.5600000001,275944.81
492,U272956,289,-2245.4900000000052,155,134,933175.7400000001,930930.2499999998
493,U523F99,289,-1021027.33,254,35,2467897.6700000004,1446870.34
494,UBEA26C,289,-6523.819999999992,229,60,281642.24,275118.42000000004
495,U066B3A,289,-68.92999999999984,282,7,13063.379999999997,12994.45
496,U461EB1,289,-32143.77999999997,269,20,304223.4899999997,272079.71
497,U267ABF,289,400.10999999999854,206,83,166034.10000000003,166434.21000000005
498,U7FD91B,289,-9684.489999999996,253,36,235393.34999999995,225708.86
499,UA52238,289,-1332.2100000000037,264,25,66755.62000000001,65423.41
500,U10C9B0,288,-395.77999999999514,166,122,167967.06,167571.28000000003
501,U0807D0,288,-24317.35,261,27,48406.79000000003,24089.44
502,UD408DE,288,147917.20999999996,256,32,141784.93999999994,289702.15
503,U0C4D1E,288,36920.030000000086,234,54,1106558.6799999997,1143478.7100000002
504,U83872B,287,15119.520000000002,279,8,19988.97,35108.49
505,UDE3607,287,42277.56000000001,247,40,114965.26,157242.82
506,UD6CAFA,287,197934.18000000005,247,40,952211.65,1150145.83
507,U55047B,287,26092.05,167,120,1446375.6800000002,1472467.7300000004
508,U163324,287,836.2299999999979,239,48,31823.890000000007,32660.11999999999
509,U2F38CD,287,-16425.46000000002,271,16,85556.06000000003,69130.59999999999
510,U5B92FA,286,-2821499.98,227,59,4429727.1,1608227.12
511,U5CBE47,286,45.33999999999892,245,41,34138.51999999999,34183.85999999999
512,UF3AE89,286,10.480000000005361,272,14,36072.750000000015,36083.23
513,UC6A9A9,286,1764.469999999993,230,56,401430.79000000004,403195.26000000007
514,UE54C84,286,10400.98,274,12,22569.129999999994,32970.11
515,UCCC412,285,-48340.21000000005,258,27,241977.84000000003,193637.63
516,UE84D27,285,3655.01,230,55,60063.22,63718.23
517,U046976,285,-753.1599999999999,270,15,36906.39000000002,36153.23
518,UAE4E9C,284,8868.890000000003,274,10,22868.720000000023,31737.61
519,U8435E7,284,56253.570000000014,200,84,167064.55999999997,223318.13000000003
520,U5BBB82,284,-24997.290000000045,234,50,852913.0,827915.71
521,U225CAA,284,9148.020000000008,263,21,74498.44999999998,83646.47
522,U6B4E83,284,7936.989999999996,248,36,123121.29999999999,131058.29000000001
523,U869530,283,219100.04000000004,232,51,1029284.8,1248384.8400000003
524,U3F685C,283,-1644.68,278,5,13747.67,12102.99
525,U45BA6B,283,1865.4100000000171,263,20,53129.89000000006,54995.3
526,UFDA774,283,19399.699999999993,235,48,324269.08,343668.78
527,UB72267,282,-5466.639999999999,267,15,28347.48,22880.84
528,U9925EA,282,-1546.7300000000014,265,17,81153.75000000001,79607.01999999999
529,U61D85B,282,-1566.2799999999943,180,102,394284.3900000001,392718.11
530,UA48DE9,282,-6102.390000000014,193,89,335692.32,329589.93
531,UCB7ECD,282,144203.85000000003,227,55,480706.62000000005,624910.4700000001
532,U81E7E5,282,41026.529999999795,256,26,1581724.76,1622751.29
533,U9718A0,282,-7401.5299999999625,267,15,208097.52,200695.99
534,U1EFD93,282,10629.629999999994,202,80,335317.3300000001,345946.96
535,U79B17D,281,-21628.21,265,16,109049.07,87420.86000000002
536,U2E05B8,281,-1623.0299999999975,276,5,31600.66999999999,29977.64
537,UDACB00,281,-4852.789999999998,269,12,127943.0500000001,123090.26
538,UF1654F,280,6040.129999999995,252,28,214759.71000000008,220799.83999999997
539,U1CD84F,280,1390.4700000000014,270,10,20393.980000000007,21784.45
540,U251E4D,280,324474.3099999999,255,25,2147555.4599999986,2472029.77
541,U8778C6,280,-925.9999999999968,195,85,123326.46000000002,122400.45999999998
542,U327D17,280,-6387.609999999999,274,6,19450.30999999999,13062.7
543,UD9392C,280,17770.060000000023,196,84,411257.55000000016,429027.61000000004
544,U688209,279,3240.309999999993,204,75,347267.36999999994,350507.68
545,U56B047,279,-6362.4299999999985,239,40,125133.08,118770.65
546,UFD20ED,279,-1057.3200000000038,249,30,102692.48999999995,101635.17
547,UF5629D,279,-2870.349999999999,235,44,137452.05,134581.69999999998
548,U051CBE,278,6381.970000000005,265,13,18922.91999999999,25304.89
549,U135746,278,-20721.639999999992,262,16,97169.75,76448.11
550,UBE475D,278,14504.460000000006,241,37,291460.1300000001,305964.58999999997
551,U1AA9E4,277,49241.7300000001,253,24,320719.0999999998,369960.83
552,U9EB6C8,277,-142759.96,272,5,153558.79,10798.83
553,UABD017,277,593.6999999999916,222,55,249008.21999999986,249601.92000000004
554,UE1E583,277,-341.8200000000023,231,46,24749.15999999999,24407.34
555,UF5A8FB,277,-9.790000000047598,135,142,75705.22000000002,75695.43
556,U923642,276,-8249.069999999972,260,16,62838.20000000007,54589.13
557,U4549DD,276,20853.87000000001,221,55,447854.04,468707.91
558,U4F919D,276,-23808.040000000023,260,16,109908.41000000003,86100.37000000001
559,UB8D177,276,-3392.249999999999,262,14,14869.650000000001,11477.4
560,UB674F0,275,9757.939999999937,249,26,1251606.5399999998,1261364.48
561,U73F40E,275,4573.630000000003,207,68,140751.75,145325.38
562,U00E5C6,275,-1004.9600000000017,261,14,17150.820000000003,16145.860000000002
563,U39578C,275,-244.0100000000008,259,16,42815.670000000006,42571.659999999996
564,UCAD5B5,275,-95.57999999999925,223,52,30297.399999999998,30201.82
565,UA8259B,274,-4267.000000000021,224,50,40884.70999999999,36617.709999999985
566,U8B4F58,274,3656.0899999999997,264,10,19882.71,23538.800000000003
567,UD52B38,274,-98794.86999999992,207,67,573793.1299999998,474998.25999999995
568,U7A9643,274,-3949.0200000000013,206,68,138304.81000000003,134355.79
569,U435A30,274,-6446.389999999994,250,24,64243.62000000003,57797.23
570,U2D4074,274,-93971.07999999981,210,64,4109437.5999999996,4015466.52
571,U5BC9FF,273,-5678.790000000004,109,164,392829.3,387150.50999999966
572,UC63E7C,273,-13855.869999999999,220,53,51270.45000000001,37414.579999999994
573,U6CD963,273,-3283.6600000003127,235,38,2403460.879999999,2400177.2199999993
574,UAF1FDC,273,19290.590000000004,216,57,99168.47999999998,118459.07
575,U710EC8,273,-6958.9,151,122,544644.4900000001,537685.59
576,U133A58,273,-47557.01000000012,199,74,214910.35999999978,167353.34999999998
577,UFB495B,272,-4018.3500000000986,64,208,330189.14999999997,326170.79999999993
578,U291F39,272,489.19999999999754,253,19,40694.05000000004,41183.25
579,U41996B,272,-6477.499999999993,251,21,28947.01999999999,22469.52
580,U6494F9,272,-143.23000000000025,263,9,13383.750000000002,13240.52
581,U4CA3ED,271,-4284.61,247,24,36747.090000000004,32462.479999999996
582,U681F36,271,1909.4300000000048,167,104,145246.06999999998,147155.5
583,UC8A8F3,271,1213.8899999999953,247,24,68802.57999999999,70016.47
584,U2DDC56,271,-7623.009999999995,226,45,126393.09,118770.08
585,U0B88CE,271,-4672.559999999995,257,14,33738.74000000001,29066.18
586,U838B25,271,-129417.20999999996,241,30,653394.4500000002,523977.24000000017
587,UB11630,270,901.1499999999995,254,16,13682.619999999995,14583.769999999999
588,UEEA684,270,2116.6500000000015,200,70,28904.53,31021.180000000004
589,U150F52,270,12805.470000000003,252,18,56996.96000000002,69802.43000000001
590,UF45A0B,270,-45742.689999999995,230,40,1090063.8900000004,1044321.2
591,U44B6A4,270,-7332.760000000014,213,57,421673.00999999983,414340.25000000006
592,U2F12CB,270,-1856.4000000000005,240,30,28915.569999999996,27059.170000000002
593,UB257ED,270,-4507.910000000014,240,30,96956.77000000002,92448.86000000002
594,UC267DD,270,29488.119999999995,150,120,352716.7999999999,382204.92000000004
595,U3D0578,270,3575.9399999999996,248,22,111914.95,115490.89
596,UD9597E,270,-1762.6200000000106,192,78,431108.2100000001,429345.59
597,U1245AF,270,-40051.75,162,108,2700325.0100000002,2660273.26
598,UE7A62F,270,-28891.46,170,100,2069078.55,2040187.09
599,UDC9D19,269,1792.0400000000154,156,113,307463.36,309255.39999999997
600,UA218A8,269,10510.769999999997,168,101,268099.84,278610.61
601,U4B0BBA,269,49216.23,253,16,27101.809999999998,76318.04
602,UDEC80F,269,-68861.92000000003,253,16,205461.13000000006,136599.21
603,U344DC6,269,251.3600000000021,249,20,89347.07999999999,89598.43999999999
604,U6F2DEF,269,9271.14,258,11,69030.69,78301.83
605,U932A30,269,1894.4900000000002,264,5,29944.439999999995,31838.93
606,UCCBC11,269,-34303.22000000003,203,66,1741392.14,1707088.9200000002
607,U05C8FF,269,-2128.249999999999,252,17,57041.44999999999,54913.200000000004
608,U9E9C45,269,-6840.59,213,56,58244.91999999998,51404.330000000016
609,U33EDD9,268,1986.2399999999893,242,26,99540.68,101526.91999999998
610,UE1DF9F,268,5031.099999999993,182,86,397404.6699999999,402435.76999999996
611,U9E53D8,268,3139.790000000002,176,92,178443.75000000017,181583.54000000004
612,UA70947,268,-79402.95000000001,173,95,576033.1099999999,496630.1599999999
613,U6C728B,268,-35463.45000000001,218,50,579470.98,544007.53
614,UB8549E,268,-261.24999999999454,174,94,254364.7499999999,254103.49999999997
615,UD707DB,268,-189.19000000000597,254,14,41284.61000000001,41095.42
616,UFACF71,268,1475.9499999999998,260,8,5437.370000000001,6913.320000000001
617,U673592,268,-3421.07,262,6,20653.16999999999,17232.1
618,UAC8720,268,-217034.24000000005,249,19,522492.9599999999,305458.72000000003
619,UC7D342,267,-11698.869999999997,236,31,105549.59000000003,93850.72000000002
620,U9A7086,267,-18.0400000000015,187,80,45532.500000000015,45514.46000000001
621,U4015A7,267,-2506.3600000000342,146,121,735504.2999999999,732997.9400000004
622,U3EC9FB,267,-2153.410000000016,240,27,199035.21000000002,196881.79999999996
623,U3F2CB3,267,-3179.3900000002614,232,35,1405958.5399999989,1402779.1500000001
624,UDE6B63,267,25170.35000000023,180,87,1984659.04,2009829.3900000001
625,U9DC7AF,266,11207.709999999972,214,52,252870.72999999995,264078.43999999994
626,UDCF316,266,-70342.57999999999,160,106,1732885.3400000003,1662542.76
627,UEEBB80,266,-20.159999999998035,199,67,221461.36999999997,221441.21
628,U6B845F,266,-9614.34,252,14,37156.03999999999,27541.699999999997
629,U23BBCF,266,3173.939999999996,207,59,329592.54999999993,332766.48999999993
630,U9ACD7A,265,-3946.590000000001,261,4,3956.4600000000014,9.87
631,U94D122,265,-7299.870000000001,248,17,20939.759999999995,13639.889999999998
632,U79DBA4,265,5670.159999999966,235,30,384452.01999999984,390122.18000000005
633,UFD7B5E,265,-3688.120000000002,240,25,11358.459999999994,7670.34
634,U126F6E,265,-44657.88000000011,189,76,4939863.42,4895205.539999998
635,U925EC2,265,-1058.859999999997,221,44,69526.86,68468.0
636,UE2E132,265,3961.2000000000066,217,48,11124.749999999998,15085.950000000006
637,U4E7A0A,265,-297.7900000000036,234,31,411672.55,411374.76
638,U752C51,265,-13884.800000000003,243,22,152395.38,138510.58000000002
639,UBBDF0E,265,-2182.3200000000033,255,10,41504.520000000026,39322.2
640,U395CBE,264,22323.77,253,11,37067.32,59391.090000000004
641,U913A3B,264,33446.35999999997,205,59,463585.31000000006,497031.67000000004
642,UB2FA4B,264,-9086.709999999995,245,19,54771.78000000001,45685.07
643,UA3C9F7,264,606.659999999999,227,37,103806.4800000001,104413.14
644,UB4EC10,264,2726.99,235,29,48621.25,51348.24
645,U5FD553,264,392.2399999999989,240,24,112091.69999999998,112483.93999999999
646,U3AE75C,264,3684.9300000000094,226,38,82744.72000000002,86429.65000000001
647,UA4A64B,263,7818.399999999998,143,120,47115.71000000001,54934.11000000001
648,U575F5D,263,-142185.0399999999,217,46,1834518.5699999994,1692333.5300000003
649,U241B01,263,-5946.049999999992,170,93,353908.60000000003,347962.55
650,U87A238,263,8945.79000000001,112,151,334292.97,343238.75999999966
651,U2A9854,262,310.7299999999923,234,28,71762.12000000002,72072.85
652,UA0EC49,262,595.2299999999889,241,21,158969.87999999998,159565.11
653,U277693,262,-5658.800000000043,184,78,474055.8700000001,468397.07
654,U53FD4B,262,-899.6800000000127,238,24,82482.66,81582.97999999998
655,UAE549E,262,-2938.9500000000317,203,59,231742.22999999998,228803.28
656,UFBEF94,262,26531.70999999997,251,11,59439.76000000001,85971.47
657,UF504D7,262,25248.61000000001,236,26,92909.2,118157.81
658,UDF23F3,261,-93790.48000000004,225,36,162683.01999999996,68892.54000000001
659,UC5A967,261,-478761.29999999993,239,22,1993692.35,1514931.05
660,U0CBBF3,261,-45975.669999999984,221,40,340649.2300000001,294673.56
661,U741960,261,12636.08999999999,219,42,99331.77999999998,111967.87000000001
662,UF61096,261,-158.68000000000757,141,120,981157.3400000001,980998.6599999999
663,U7129EF,261,558.3399999999975,255,6,15742.839999999991,16301.18
664,UD890E5,261,247.01000000000022,193,68,23376.99,23624.0
665,U592BC8,261,182209.3000000001,235,26,1127576.19,1309785.49
666,U8F7B52,260,-1213.220000000023,245,15,44313.24999999986,43100.03
667,U2CD499,260,64005.95999999996,242,18,171688.99999999994,235694.95999999996
668,UE23D23,260,-245.67000000000158,255,5,10674.889999999996,10429.220000000001
669,U1A1CC9,260,-5444.440000000006,229,31,127977.96999999997,122533.53
670,UE2A71F,260,9460.600000000006,211,49,35538.459999999985,44999.06
671,U16D2CF,260,-2217.009999999991,209,51,85149.53000000001,82932.51999999999
672,U4B7100,260,-4273.050000000001,161,99,134868.11,130595.06000000001
673,UC442EA,260,4090.1200000000053,253,7,23906.379999999997,27996.5
674,UBD27D4,259,7007.670000000001,252,7,16267.17,23274.84
675,U415734,259,-10499.00000000001,237,22,148249.84999999995,137750.85
676,U30E1D1,259,-8756.81,242,17,74383.8,65626.99
677,UB2D2A1,259,-617.4099999999994,214,45,41365.089999999975,40747.67999999999
678,U8303AC,259,725.5700000000002,248,11,18366.880000000005,19092.449999999997
679,U682FA1,258,-8940.850000000004,217,41,201477.67000000007,192536.82
680,UD20264,258,-75971.43000000001,237,21,135384.88000000003,59413.45
681,UC10612,258,-12338.539999999994,218,40,207596.70999999996,195258.16999999998
682,UE09D51,258,-32990.22,220,38,219951.28999999998,186961.06999999998
683,UD0F968,258,-454.5999999999985,245,13,29192.799999999992,28738.2
684,U3EF71F,258,-3812.929999999992,224,34,61118.800000000025,57305.87000000001
685,UE6B457,257,285381.75,201,56,881284.8400000001,1166666.5899999999
686,U86FE7D,257,695.61,220,37,41922.25000000001,42617.86
687,UF573BE,257,-1901.0899999999313,239,18,37377.82000000001,35476.73
688,U4C65AC,257,-8211.419999999993,234,23,66834.20000000001,58622.78
689,UC98D26,257,15461.500000000005,233,24,44287.599999999984,59749.1
690,UBFC360,257,458.7700000000028,245,12,25405.959999999985,25864.73
691,U6318BA,256,19289.22000000003,232,24,426625.6399999997,445914.86
692,U53E4E0,256,983194.9400000001,233,23,1986232.17,2969427.1100000003
693,U7776AB,256,-10823.319999999989,232,24,45494.89,34671.56999999999
694,UDED8E7,256,-9357.050000000001,215,41,104143.02999999998,94785.98000000003
695,U7414C4,256,-3484.3499999999985,231,25,56437.04999999999,52952.7
696,U3EF6E5,256,12004.340000000015,210,46,138473.29999999993,150477.63999999998
697,U7EEDE4,256,35441.349999999904,239,17,483143.10000000003,518584.45
698,UDE45B0,256,-1040.5599999999986,146,110,487806.41000000003,486765.85000000003
699,U56B7F4,256,674394.0099999999,164,92,9342019.89,10016413.9
700,U5F0D85,255,-5838.1600000000035,201,54,77888.76999999997,72050.60999999999
701,U2E4B97,254,29418.879999999983,226,28,97872.6,127291.48
702,UD6BC37,254,11602.680000000008,186,68,13261.729999999996,24864.410000000003
703,UC595AD,254,-13658.700000000012,203,51,326958.32,313299.62
704,U814025,254,-16962.500000000102,209,45,336261.01999999984,319298.52
705,UC98AAF,254,1863.9999999999932,234,20,235918.46,237782.46000000002
706,UAA2D4E,254,-17548.750000000004,235,19,57639.12000000001,40090.37
707,U471080,254,-12018.24,240,14,32810.82,20792.58
708,UD648FE,254,20019.36999999999,156,98,206114.76000000007,226134.12999999992
709,U3EC02F,254,11105.879999999988,169,85,234614.05,245719.93
710,UF77002,254,11576.680000000017,229,25,95499.32999999997,107076.01000000002
711,UEFB5AD,254,1116.2200000000032,239,15,42309.05,43425.270000000004
712,UFBE134,254,-1401.7800000000034,232,22,63368.060000000005,61966.28
713,UCFE03A,254,-2928.959999999983,235,19,162054.01000000004,159125.05
714,U1C94C9,254,981.7700000000059,230,24,79039.20999999999,80020.98
715,UBAFA16,253,26201.140000000003,243,10,31486.639999999992,57687.78
716,U6FAC63,253,-5913.169999999999,236,17,48235.799999999996,42322.63
717,UE801C2,253,825.5399999999952,199,54,72235.49999999999,73061.04
718,UC9C8F1,253,9332.609999999999,226,27,37869.86999999999,47202.48
719,UFCDA9E,253,4283.509999999989,116,137,310515.8300000001,314799.33999999997
720,UBD8532,253,2059.880000000003,140,113,141742.55,143802.43000000002
721,U372392,253,-62577.67000000001,215,38,429914.0099999999,367336.34
722,U6A69C9,253,-1488.6000000000022,219,34,58817.700000000004,57329.100000000006
723,UD271B1,253,10074.139999999954,236,17,106183.22000000002,116257.36
724,U8E38CF,253,-2584.8100000000013,232,21,23747.2,21162.390000000003
725,U70E0DD,253,818.4599999999939,212,41,112136.08000000002,112954.54
726,U47CBE0,253,43782.590000000004,229,24,200407.60000000003,244190.18999999994
727,U34DB0C,252,-50.10000000001021,189,63,2817150.050000001,2817099.950000001
728,U67104D,252,-18154.429999999986,229,23,44717.65000000002,26563.22
729,UCAE9AF,252,-3251.0499999999915,241,11,61994.41000000005,58743.36
730,UBBA88E,252,-95088.02000000018,205,47,580281.8499999983,485193.83
731,UB3E701,252,-912.0900000000001,149,103,70658.35,69746.26000000001
732,U69C265,252,-36899.68000000001,211,41,738962.0000000001,702062.3199999998
733,UB3E879,251,11265.919999999991,198,53,73135.29999999999,84401.21999999999
734,U64543E,251,-2850.1800000000007,182,69,133325.61000000002,130475.43
735,U7C56DB,251,-23667.739999999994,219,32,106573.03000000006,82905.29000000001
736,UCE031E,251,-4138.019999999999,216,35,115726.36999999997,111588.34999999999
737,UE11496,251,281.9700000000073,200,51,277660.6500000001,277942.62
738,U3FF387,251,-19.040000000002873,179,72,55245.24000000001,55226.2
739,UD13463,250,-694.3100000000007,154,96,15172.610000000002,14478.299999999992
740,U410F8E,250,-21164.250000000015,179,71,109447.74000000003,88283.49000000018
741,U64B5BA,250,-3499.029999999988,163,87,665200.1,661701.0700000001
742,UED4F17,250,-12808.98,245,5,17622.58,4813.6
743,U323197,250,22110.419999999955,211,39,592712.4399999998,614822.86
744,U2377CC,250,-10296.269999999999,244,6,35301.35000000002,25005.08
745,UE44044,249,-562.7899999999988,130,119,60037.20999999999,59474.42
746,UAF2711,249,-3945.969999999999,236,13,20447.02,16501.05
747,U3B1618,249,8609.90000000004,239,10,41350.650000000016,49960.55
748,U4DDD8F,249,-62069.14000000004,236,13,105985.11999999991,43915.979999999996
749,U276795,249,58.409999999999975,207,42,4171.050000000001,4229.459999999999
750,UDD096A,249,71557.21999999997,116,133,273009.70999999996,344566.93000000005
751,U8AACE3,249,1103.2499999999982,221,28,229678.57,230781.81999999998
752,U4A308A,248,267.7600000000011,228,20,38128.04000000001,38395.799999999996
753,UE54CAD,248,5017.68,217,31,37818.22,42835.899999999994
754,U2F8C17,248,-3153.020000000003,224,24,30145.630000000016,26992.609999999997
755,U387011,248,58094.29999999998,184,64,779161.9700000003,837256.2700000001
756,U3FE491,248,0.3800000000046566,192,56,588388.01,588388.39
757,U458ADA,247,9.459999999999127,149,98,360420.67,360430.12999999995
758,UDB749D,247,-9567.590000000022,197,50,648833.3300000001,639265.74
759,U028975,247,10527.54,218,29,21571.199999999997,32098.739999999998
760,U5001FE,247,5737.310000000005,236,11,33944.020000000004,39681.33
761,UB119CF,246,-2015.0499999999965,231,15,117659.95000000006,115644.9
762,UDEA0D2,246,-72661.61999999988,187,59,328371.51999999984,255709.90000000014
763,UDAB0FF,246,-37709.56999999999,216,30,209167.35999999996,171457.78999999998
764,UB4D201,246,-67569.52999999991,232,14,571571.99,504002.45999999996
765,UC45C91,246,8159.039999999992,200,46,150611.89999999997,158770.94
766,UE9E01F,246,-214.61999999999483,237,9,10842.179999999997,10627.559999999998
767,UA57014,246,-108.60000000000028,228,18,4985.65,4877.05
768,UDB4E75,245,-2148.819999999997,201,44,199720.50999999995,197571.69000000003
769,U209EF6,245,-134.89000000001033,165,80,134061.68000000002,133926.79
770,UFDF223,245,-818.689999999995,174,71,767287.3799999999,766468.6900000001
771,U7D2F5E,245,3544.3700000000017,208,37,36384.549999999996,39928.92
772,UEF6479,245,-21511.759999999987,179,66,247189.94000000003,225678.18000000002
773,UAAE172,245,362.62,128,117,4275.3,4637.92
774,U9B65EE,245,584.8299999999829,232,13,255037.58999999976,255622.41999999998
775,U94C59E,245,-2515.3100000000195,178,67,733830.53,731315.2200000001
776,UB0D36E,245,-3191.1100000000006,230,15,27533.37999999998,24342.269999999997
777,UB25F57,245,18740.359999999986,195,50,183308.67999999996,202049.04
778,U89E284,245,1216.3300000000079,172,73,121647.3399999998,122863.67
779,U766B1D,245,-6458.739999999998,212,33,89183.53000000001,82724.79
780,U5CBB0A,245,2680.7999999999824,226,19,128838.56999999996,131519.37
781,U603910,245,-9477.800000000001,243,2,50594.80000000001,41117.0
782,U84EBFC,244,1690.070000000002,207,37,30460.04,32150.109999999997
783,U0E1B69,244,-2911.4200000000014,225,19,17825.959999999992,14914.539999999999
784,UBB7EC5,244,-477872.3300000003,229,15,821771.0100000001,343898.68
785,U2B1671,244,6633.230000000009,219,25,98339.76999999997,104973.0
786,U71F17A,244,-0.22999999999547072,174,70,150157.43000000002,150157.19999999998
787,U64D6D8,244,23905.899999999987,219,25,263689.06999999995,287594.97000000003
788,U330E52,244,136200.6700000002,140,104,3347695.9599999995,3483896.6299999994
789,UA4E22D,244,50160.01000000001,194,50,543664.8399999999,593824.8499999999
790,U42D1C3,244,-845.7699999999913,178,66,202271.63999999996,201425.86999999997
791,UACC6AA,244,-40662.68,204,40,1490360.04,1449697.3599999999
792,U33D66D,244,5928.039999999994,123,121,232357.47000000003,238285.51000000007
793,U4E32BA,244,214.8300000000014,231,13,7427.239999999998,7642.07
794,U09B9E7,244,-67.84999999999674,199,45,136147.35,136079.5
795,U7D2C7B,244,32939.91999999998,118,126,768723.91,801663.8299999997
796,U7EE723,244,3092.010000000017,240,4,7260.979999999996,10352.99
797,U7A6181,243,3315.9900000000152,227,16,22415.09,25731.08
798,U7C75E0,243,19173.20999999999,220,23,160569.7699999999,179742.98
799,U65DF4F,243,144419.42000000004,219,24,256180.87000000005,400600.29
800,UB17678,243,-4385.810000000005,193,50,124024.63999999998,119638.83000000002
801,U0B6BA6,243,-4655.740000000001,163,80,50546.94,45891.200000000004
802,UB45C38,242,390.55999999999835,216,26,57752.55000000002,58143.10999999999
803,UFBCF83,242,63159.41999999997,197,45,436572.1800000001,499731.59999999986
804,U0256AC,242,4668.200000000013,155,87,132231.28999999998,136899.49
805,UDC51C7,242,79716.07999999999,209,33,225737.28999999998,305453.37
806,U63868B,242,-4088.5099999999366,226,16,521837.5299999998,517749.01999999996
807,UF31B4F,242,1448.4000000000026,233,9,11576.600000000011,13025.0
808,U893B5F,242,-6672.929999999995,139,103,64260.64999999999,57587.72
809,UC60E3F,241,-17794.310000000034,206,35,126908.44,109114.12999999998
810,UB6F2E1,241,-18043.66999999999,187,54,192720.51999999993,174676.85
811,UA25C15,241,-116896.39000000007,190,51,580984.0399999999,464087.6500000001
812,U3CAB67,241,771.6400000000001,211,30,51684.47000000003,52456.11
813,U81640E,241,2530.4099999999994,196,45,13756.150000000001,16286.56
814,U509FAA,241,-13146.170000000055,185,56,865074.8200000008,851928.65
815,U84F677,241,-7713.880000000001,227,14,200974.40999999992,193260.53000000003
816,UA23349,241,-3136.309999999999,209,32,170613.36000000004,167477.05
817,UEAA0B7,241,240390.49999999994,86,155,574505.8,814896.3
818,U7DD4E8,240,3998.5399999999995,213,27,53611.76,57610.299999999996
819,U9B18A3,240,-6139.529999999996,228,12,69364.65000000002,63225.119999999995
820,U0D3A52,240,-62696.96,210,30,355439.3,292742.33999999997
821,U4CE04C,240,-163474.2000000001,219,21,732760.9999999997,569286.8
822,UB083E8,240,-2232.359999999976,185,55,226300.68999999997,224068.33
823,UF901DC,240,630.0399999999959,223,17,26200.610000000004,26830.649999999998
824,U416671,240,-46014.160000000054,206,34,1283800.669999999,1237786.51
825,U2884A5,240,-568.3299999999973,183,57,138573.76,138005.43000000002
826,U9A5A48,240,84049.51000000001,217,23,284327.6499999999,368377.16000000003
827,UE544DD,240,30266.39999999999,205,35,328042.97,358309.37
828,U8D1973,239,-3356.6199999999562,80,159,682621.35,679264.73
829,UCA99FF,239,46988.249999999905,181,58,1160729.8099999998,1207718.0599999996
830,UB66851,239,-1783.7199999999928,182,57,668403.69,666619.9699999999
831,U53AAF6,239,57721.14999999998,136,103,735428.22,793149.37
832,UB9E5C0,239,180519.8900000001,192,47,8506179.140000002,8686699.029999997
833,U0ACD91,239,-18862.46,183,56,275364.45000000007,256501.99000000002
834,U4C4636,239,-749242.2799999999,224,15,4066496.66,3317254.3800000004
835,UAA0054,239,6214.229999999993,210,29,15759.060000000003,21973.29
836,U232F4B,239,-153.0299999999973,208,31,173460.7,173307.66999999998
837,U8259BA,239,32801.03000000002,221,18,173197.26,205998.28999999998
838,U699D04,239,684.3800000000047,226,13,38313.919999999984,38998.3
839,U4E2DD3,238,1209.8000000000015,221,17,197707.78,198917.58
840,UAA13AB,238,-150089.89,200,38,1293238.88,1143148.99
841,U70C2C2,238,318.50999999999897,215,23,17231.029999999988,17549.54
842,U2FB480,238,-16205.71,225,13,38479.62000000001,22273.909999999996
843,U61EEDE,238,139611.08000000002,221,17,14011.62,153622.7
844,UF28790,238,26964.239999999998,223,15,91284.22,118248.45999999999
845,U1AD98C,238,2495.4800000000087,131,107,884280.5900000001,886776.0700000002
846,UFAC0E8,238,-30658.400000000005,209,29,235058.16999999987,204399.77000000002
847,U655828,238,-35837.10999999999,214,24,147431.50000000006,111594.38999999998
848,U866F12,238,-3288.619999999999,191,47,69784.0,66495.38
849,UF3B44E,237,-1487.7200000000003,181,56,64027.97000000002,62540.25000000001
850,UB72BE3,237,618.0099999999956,230,7,25225.329999999984,25843.34
851,U9ECE7A,237,41979.89,182,55,381069.33,423049.22
852,U13A81D,237,39922.71999999999,191,46,269616.3400000001,309539.06
853,UC0503D,237,-1127.310000000005,224,13,65513.87000000004,64386.55999999999
854,U3B14E7,237,474.6900000000014,151,86,67079.79000000001,67554.48000000001
855,U04320F,237,-383.29999999999933,223,14,40802.51999999999,40419.22
856,UAC6712,237,-323.0400000000026,194,43,179473.01999999973,179149.97999999998
857,U7B4258,236,5206.670000000005,147,89,101991.42,107198.09000000003
858,U865AFA,236,5231.960000000004,186,50,143039.00999999998,148270.97000000003
859,UE1A4E6,236,3778.8799999999997,228,8,20417.319999999996,24196.2
860,U019BBE,236,-1490.5599999999997,174,62,102610.15999999996,101119.59999999999
861,U9B0B50,236,-621.2799999999922,197,39,332326.87000000005,331705.58999999997
862,U37438C,236,-17902.159999999996,192,44,26391.92,8489.76
863,U8E1EE3,235,1189.6500000000071,163,72,100148.23,101337.88
864,U802A74,235,7216.57,209,26,92898.86000000003,100115.43000000001
865,UAE5252,235,1447.7799999999995,222,13,32191.010000000002,33638.79
866,U0C97D8,235,-40102.29000000003,185,50,147309.77999999988,107207.48999999999
867,U698EDC,235,-4696.6100000000015,202,33,27627.110000000004,22930.5
868,U55010E,235,-22080.800000000014,188,47,521674.68,499593.88000000006
869,U9BF5F5,235,-3133.36,202,33,15667.490000000002,12534.13
870,U3B57C6,235,-122371.51000000001,218,17,619507.1900000002,497135.68
871,UCD9BCC,235,1153.200000000003,204,31,346688.54999999993,347841.75000000006
872,UA4A8B6,235,-351698.51,185,50,2513087.9599999995,2161389.450000001
873,UE6F810,235,44437.26999999949,209,26,2122189.5699999984,2166626.84
874,U63DA5E,234,50934.78999999999,203,31,320266.68,371201.47
875,U5DDFE9,234,-10781.019999999995,225,9,59729.51,48948.49
876,U6980E5,234,-11547.460000000003,163,71,518116.39999999997,506568.9400000001
877,U0FEE3A,234,-3227.2500000000027,225,9,19901.59,16674.34
878,U00F52C,234,906.3699999999762,208,26,28796.549999999967,29702.92
879,UE05970,234,26546.589999999997,225,9,53423.57000000001,79970.16
880,U5355B8,234,-160.93999999999915,155,79,115026.04000000001,114865.10000000002
881,UBD0636,234,-26452.420000000006,222,12,94292.04000000001,67839.62
882,UAE9C08,234,25469.240000000013,210,24,201951.93999999997,227421.18
883,UEA5E4F,234,-743.4300000000017,196,38,40934.47,40191.04000000001
884,UF951F1,234,59978.82000000001,219,15,108542.84000000001,168521.65999999997
885,UC237B6,234,-6776.849999999996,178,56,34177.65000000001,27400.800000000003
886,UDBBA3F,233,-10882.47,214,19,46108.270000000026,35225.799999999996
887,U21D075,233,1582.659999999978,180,53,318823.1,320405.76
888,UE3EBE3,233,4415.520000000015,211,22,34189.27,38604.79000000001
889,UDDC5F0,233,-95192.41,75,158,1177782.6099999999,1082590.2000000004
890,U95CE3E,233,-502.82000000005064,131,102,1414309.37,1413806.5500000007
891,U7F5640,233,12515.18,203,30,43064.840000000004,55580.020000000004
892,U699B18,232,-4550.63000000005,149,83,1679093.61,1674542.98
893,U3AE229,232,4594.659999999997,202,30,280461.36999999994,285056.03
894,UEFAD09,232,-12943.669999999993,154,78,116868.45,103924.78
895,UC308A1,232,-3820.4000000000005,213,19,20478.619999999995,16658.219999999998
896,U485645,232,-10.490000000012515,198,34,230065.82,230055.33
897,U101EFD,232,21603.27,108,124,52880.58,74483.84999999999
898,U5F1D82,232,-111.04999999999745,226,6,9744.959999999995,9633.91
899,UB9D3A6,231,-18491.380000000023,182,49,185832.26,167340.88000000006
900,UF05583,231,33594.45000000005,76,155,732451.2100000001,766045.66
901,U1E539E,231,-8695.120000000003,220,11,35638.619999999995,26943.5
902,U8F4BDC,231,-2260.090000000002,221,10,36045.06000000001,33784.97
903,U2CE342,231,8621.15,228,3,8245.32,16866.47
904,U3C3CD8,231,-2509.0199999999995,217,14,17442.96999999999,14933.95
905,U313665,231,-16.609999999993306,138,93,82936.03000000001,82919.42
906,UFAEA69,231,-160.11000000000183,104,127,255222.13999999998,255062.03000000006
907,UB328F9,231,705.8099999999995,218,13,21226.160000000003,21931.969999999998
908,UEF64CE,231,-14503.349999999997,214,17,62353.59000000003,47850.24
909,U7CF665,231,-3019.4299999999957,205,26,146856.81,143837.38
910,UA8D23F,231,-3040.8299999999963,143,88,68434.89,65394.05999999998
911,U8D3A34,231,-17563.559999999994,209,22,36483.76999999996,18920.21
912,U56B051,231,7767903.679999997,186,45,25872158.12,33640061.800000004
913,U9FF000,231,6411.399999999996,220,11,28331.239999999998,34742.64000000001
914,U871D9C,231,-17784.409999999993,218,13,44569.3399999999,26784.93
915,UE5C38A,230,439.9399999999674,221,9,104358.30999999995,104798.25
916,U46769D,230,-14768.729999999981,198,32,772402.9699999999,757634.24
917,U3AE134,230,99272.12000000004,141,89,797036.07,896308.1900000001
918,U2B7640,230,310.54000000000815,173,57,11839.32,12149.860000000006
919,UACB97F,230,-285.2500000000012,210,20,68837.06999999999,68551.82
920,UCF66CC,230,-4953.349999999998,217,13,65598.54,60645.19
921,UF012E6,230,6228.469999999981,158,72,834202.4299999999,840430.9000000001
922,UD48D79,230,-30709.040000000008,218,12,83369.13000000002,52660.090000000004
923,U5C58EC,230,-17632.320000000007,181,49,159271.45,141639.13
924,U3405B2,230,-1510.11,223,7,16284.429999999998,14774.320000000002
925,U8A3FD2,230,0.9900000000000126,166,64,6215.799999999999,6216.789999999996
926,UCE2449,229,-29481.869999999977,219,10,255197.37999999998,225715.51
927,U1A8926,229,4577.070000000026,212,17,343164.33,347741.4
928,U871C3E,229,21117.3699999997,207,22,2213493.899999999,2234611.27
929,U768099,229,348.09000000000935,212,17,73552.91,73901.00000000001
930,U9B2143,229,-2024.6699999999973,210,19,31090.939999999995,29066.27
931,UEF6314,229,-4143.079999999999,204,25,165028.33000000002,160885.25
932,UF960C5,229,9247.249999999993,195,34,490747.8299999999,499995.07999999996
933,U9B6985,229,14.550000000000523,208,21,8335.069999999998,8349.619999999999
934,U91456E,228,-1617.6299999999992,208,20,14596.44,12978.81
935,U1BFF73,228,7443.979999999998,140,88,176620.24000000002,184064.22
936,U669FE5,228,-417.88000000000045,138,90,33658.75,33240.87000000001
937,UA8FBD0,228,2011.1000000000859,69,159,852117.35,854128.4499999997
938,U40559F,228,10865.329999999994,213,15,87288.72000000002,98154.04999999999
939,U3C71A3,228,1163.9900000000052,215,13,23474.29,24638.28
940,U4AB76B,228,19880.90000000005,197,31,417637.29000000004,437518.19000000006
941,UE1BCDB,228,-246.2399999999756,178,50,169298.68000000002,169052.44
942,U0862C0,228,-4702.570000000001,209,19,49764.79000000002,45062.22
943,UAD0CE2,227,-942960.6900000004,156,71,1204970.9399999988,262010.25000000003
944,U0A4244,227,195.12000000000398,194,33,45910.22,46105.34
945,U9093E0,227,-16135.980000000052,147,80,659301.8800000001,643165.8999999998
946,U88E944,227,-3007.709999999999,218,9,17720.010000000002,14712.3
947,U2EDEA5,227,-4126.0300000000025,222,5,22797.340000000004,18671.309999999998
948,U2329FD,227,-9252.259999999995,215,12,53180.16000000002,43927.899999999994
949,U73127B,227,1048.5900000000029,182,45,138223.25,139271.84
950,U571305,227,-1010.81,211,16,33376.5,32365.689999999995
951,UC1DAD7,226,3823.939999999995,209,17,85931.94000000008,89755.88
952,U0E678B,226,-1353.6299999999883,193,33,210823.75999999998,209470.13
953,UB9AE63,226,-769.2900000000001,196,30,13867.489999999998,13098.2
954,UC14528,226,-3034.5399999999945,189,37,195737.56000000003,192703.02000000002
955,U628F5A,226,337.3700000000008,205,21,28591.060000000005,28928.430000000004
956,U15E4F6,226,-5592.360000000037,147,79,2186640.39,2181048.0300000003
957,UCE16F5,226,353.7200000000038,214,12,36798.210000000014,37151.93
958,U367AF7,226,14576.380000000003,211,15,6784.829999999999,21361.21
959,UD6C5C3,226,-9500.300000000001,203,23,38843.969999999994,29343.670000000002
960,UD651F1,226,7299.059999999995,219,7,42817.91999999999,50116.979999999996
961,U0EF507,226,18747.680000000004,157,69,409856.15000000014,428603.83000000013
962,U322A29,226,49817.70999999992,201,25,1402923.2,1452740.91
963,U020E2E,226,212519.30999999994,204,22,2702609.9199999985,2915129.23
964,U1A8A56,226,-8375.269999999993,212,14,84516.11000000003,76140.84
965,U038C5B,226,8799.989999999987,209,17,111274.83000000002,120074.82
966,U3DA910,225,8385.779999999999,213,12,17899.989999999998,26285.77
967,U1ED217,225,10670.020000000024,142,83,569585.78,580255.7999999999
968,UD46142,225,34.42999999999978,216,9,34490.05000000001,34524.479999999996
969,U5C0639,225,870.2599999999987,208,17,10180.339999999998,11050.600000000002
970,U5A5763,225,2048.109999999985,163,62,283967.6600000001,286015.7700000001
971,UB0B9CF,225,-36489.200000000004,190,35,96683.20999999999,60194.01
972,U2EECEA,225,171.3400000000006,213,12,12249.549999999996,12420.89
973,U22AB39,224,7778.170000000005,197,27,27094.449999999997,34872.619999999995
974,U762DA6,224,-2818.860000000003,217,7,23930.859999999997,21112.0
975,U2B4A15,224,-7886.109999999991,191,33,121793.14000000001,113907.03
976,U8D8003,224,-3418.9699999999993,210,14,28410.949999999993,24991.98
977,UF26F45,224,83147.85000000003,153,71,380333.4899999998,463481.34
978,U7D13E2,224,17018.080000000005,149,75,112162.36,129180.43999999999
979,U041801,224,4975.360000000015,173,51,849378.6900000001,854354.0499999999
980,U6CEDCC,224,-953.2799999999995,217,7,6923.820000000001,5970.54
981,U8A98C3,224,-517.389999999999,134,90,69913.68,69396.29
982,U560028,224,251760.52000000008,211,13,7194.58,258955.09999999998
983,U09240B,224,17503.67999999996,193,31,277192.95,294696.63
984,UF27624,224,2062.5600000000045,200,24,116936.83999999995,118999.4
985,U9640F5,223,-43728.29000000001,179,44,129730.67999999998,86002.39
986,U52012C,223,-1074.5900000000074,207,16,26302.47000000001,25227.88
987,U7C2F38,223,4804.619999999992,183,40,383396.18,388200.7999999999
988,UEE5AD5,223,-13287.409999999994,204,19,189190.38000000003,175902.97000000003
989,UB97BF4,223,34612.36,192,31,244878.49999999997,279490.86
990,U183BE0,223,12552.530000000026,159,64,462903.68000000005,475456.20999999996
991,UE9DD0E,223,218.6900000000076,161,62,207875.64000000004,208094.33
992,U200BB2,223,8218.35,192,31,30879.35,39097.7
993,U90B868,223,-1410.5100000000002,218,5,8791.28,7380.77
994,UFF65C1,223,-1089.6699999999973,181,42,443234.01,442144.3400000001
995,UA668DE,222,-47.41000000000113,128,94,158283.67999999996,158236.27000000002
996,U70B2E8,222,-1919.8000000000004,217,5,8361.24,6441.44
997,U4D65B2,222,-3927.519999999987,219,3,19039.239999999976,15111.720000000001
998,UFA912E,222,-1110.630000000001,134,88,124164.10000000002,123053.47
999,U9D0AFE,222,-109936.40000000024,167,55,1444790.6800000055,1334854.28
1000,UD77233,222,-1053.52,199,23,59466.10000000001,58412.579999999994
1001,UED86E2,222,4399.929999999999,205,17,16747.719999999994,21147.65
1002,UC94D5F,222,-2355.110000000004,129,93,134385.18,132030.07
1003,UB62D49,222,847.5199999999986,135,87,74109.83999999998,74957.36
1004,UB51BBE,222,15948.73,202,20,26384.37,42333.1
1005,U08E053,222,152382.71000000002,98,124,451099.54000000004,603482.2499999998
1006,U9E93E6,221,-3103.42,208,13,17210.64,14107.220000000001
1007,U25973C,221,2023.559999999999,212,9,6872.5999999999985,8896.16
1008,UCD623B,221,-832.9000000000121,213,8,64496.710000000014,63663.810000000005
1009,UA512D1,221,9970.789999999994,201,20,105036.2,115006.98999999999
1010,UFE34D6,221,13685.889999999996,199,22,130438.72,144124.61000000002
1011,UCBE041,221,-0.6900000000014188,112,109,49611.4,49610.71000000001
1012,UC11672,221,1030.900000000007,185,36,161776.26,162807.16
1013,UFEEF2C,221,-1297.8200000000008,206,15,13610.98,12313.16
1014,U9870B8,221,14.1800000000001,148,73,15545.279999999995,15559.46
1015,UD3A845,221,42.729999999997744,170,51,25687.11999999999,25729.85
1016,UF7BB82,221,-6397.310000000004,215,6,19151.450000000008,12754.14
1017,UD8250F,221,-4.809999999999945,152,69,43584.66000000001,43579.85
1018,UC7DF54,220,2502.530000000003,194,26,71900.69000000002,74403.22
1019,UB2B0FD,220,-6789.31000000002,193,27,1406449.7799999993,1399660.4700000002
1020,UFFFF38,220,139.66999999998606,143,77,267640.48,267780.14999999997
1021,U7FB2F4,220,-11248.110000000004,191,29,47867.97000000001,36619.86
1022,UD0181F,220,38.82000000000062,196,24,11842.87999999999,11881.7
1023,U8B88C0,220,-101.26000000000278,215,5,6597.81,6496.549999999999
1024,UA85BD9,220,-14947.069999999989,202,18,131279.21,116332.14
1025,U6FA314,220,-3313.6699999999996,213,7,16797.570000000003,13483.9
1026,UD71D61,220,0.03000000001702574,124,96,247080.74000000008,247080.77000000002
1027,U89926E,220,7638.389999999981,194,26,210591.96999999983,218230.36
1028,U11B4F6,219,23525.91000000001,208,11,49288.259999999995,72814.17
1029,UB6252C,219,-13601.510000000055,152,67,407019.43999999977,393417.93
1030,UB49FE5,219,2179.470000000001,109,110,51235.69,53415.159999999996
1031,U755983,219,119.33000000000017,173,46,3471.869999999995,3591.2000000000003
1032,UFFA173,219,-0.11000000000017734,124,95,5026.650000000001,5026.54
1033,U2F1E3D,219,-28452.33,191,28,308329.81,279877.48
1034,U2F3D95,218,7151.020000000043,182,36,68174.22000000002,75325.24000000002
1035,U06DAF4,218,9934.350000000008,176,42,357999.73999999993,367934.08999999997
1036,U84977A,218,22.850000000000364,192,26,53690.86000000001,53713.71
1037,U845319,218,-2285.2599999999943,197,21,16657.899999999998,14372.639999999998
1038,U434DB8,218,599.1799999999994,165,53,82024.59000000003,82623.77
1039,U6AC8A3,218,-8504.990000000034,203,15,146534.9600000002,138029.97
1040,UA6A3E5,218,4965.89,212,6,21543.0,26508.889999999996
1041,UEC7CA0,218,-2895.1799999999994,196,22,29294.47000000001,26399.29
1042,U4C320B,218,40774.05999999999,181,37,739810.6999999998,780584.76
1043,UD35ECC,218,-258.899999999999,210,8,25180.16,24921.26
1044,U8EF67C,218,18329.26000000002,136,82,48116.84000000001,66446.1
1045,U5F110C,218,51521.47999999997,163,55,93042.52999999994,144564.00999999998
1046,U34852B,218,-9054.099999999999,191,27,32287.88000000001,23233.78
1047,U7BDC9C,218,-11841.859999999991,192,26,107745.01000000001,95903.15000000001
1048,UF97565,218,-2387.399999999994,195,23,350412.87999999995,348025.48
1049,U23C793,217,-4557.690000000002,194,23,122347.96999999997,117790.28
1050,UAD4292,217,-7393.239999999998,210,7,23325.379999999994,15932.14
1051,UF3D82B,217,-156.5699999999986,185,32,119468.25999999992,119311.68999999997
1052,U11F2CC,217,2063.6500000000037,199,18,129020.96,131084.61
1053,UF148A4,217,-57968.38,201,16,285672.24,227703.86
1054,UEDCFFF,217,2309.830000000001,174,43,158788.82000000007,161098.65000000002
1055,UE42D90,217,-13372.270000000004,202,15,101707.59000000004,88335.32
1056,U3A282C,217,-4822.039999999994,163,54,386843.91000000003,382021.87
1057,UE11A7E,217,12907.080000000002,182,35,199947.31,212854.39
1058,U9AB92F,217,-119.76000000000272,188,29,27047.279999999984,26927.52
1059,UB79EDF,217,-5719.679999999984,195,22,54554.840000000055,48835.159999999996
1060,U8BCA06,217,-12025.749999999996,180,37,87984.78000000003,75959.03
1061,U12A95B,217,-501.21999999999935,208,9,10630.72,10129.5
1062,UE6E85E,217,-29904.369999999995,207,10,131756.22000000003,101851.85
1063,UE97F40,217,-5846.620000000002,210,7,40986.55000000001,35139.93
1064,U6D4603,216,-369.72,208,8,3349.720000000001,2980.0
1065,UACC897,216,-75765.92,210,6,129588.33,53822.409999999996
1066,U916F40,216,-62068.980000000025,207,9,492345.50000000006,430276.52
1067,U9CDE2F,216,-197401.24000000005,183,33,598217.57,400816.32999999996
1068,UC383D6,216,-1565.7000000000046,141,75,190048.93,188483.23
1069,U25F85F,216,5893.690000000009,136,80,116414.17,122307.86
1070,UE46478,216,-1691.0700000000145,164,52,174347.93000000008,172656.86
1071,UC8D7FD,216,-47207.06000000002,153,63,521138.1900000003,473931.1300000002
1072,UE12CB9,216,23239.690000000002,196,20,374963.17,398202.86
1073,UA89691,216,-2110.6100000000038,185,31,21296.039999999983,19185.43
1074,U4720E5,216,-612.0300000000016,143,73,32314.62,31702.59
1075,U2894FD,215,-251036.93999999992,160,55,1742103.1500000004,1491066.21
1076,U6B61BD,215,11205.440000000002,192,23,76564.98999999996,87770.42999999998
1077,UAAA643,215,-490.5199999999995,152,63,57836.85999999999,57346.34
1078,U26A989,215,875.3100000000021,206,9,25047.18,25922.489999999998
1079,UDAAB9E,215,-8978.010000000002,158,57,39370.24000000002,30392.229999999996
1080,UD0DBB3,215,32603.280000000064,185,30,527878.0399999999,560481.3200000001
1081,UF5B315,215,-12179.509999999998,206,9,34014.47000000001,21834.96
1082,UA6C3C9,215,-3107.579999999998,186,29,126101.6,122994.02
1083,UEE0BE5,215,72217.01000000001,196,19,67490.5,139707.51
1084,UFCDC32,215,9.630000000000354,210,5,3806.449999999996,3816.08
1085,UB053A5,215,36431.369999999966,142,73,1335624.4099999997,1372055.78
1086,UE74A60,214,267.61999999999716,120,94,117413.14000000001,117680.76000000001
1087,U2C34CA,214,-1990.320000000001,191,23,11733.849999999999,9743.529999999999
1088,U1D975D,214,-2394.140000000001,192,22,50768.86,48374.72
1089,UEB759D,214,-426.5599999999997,167,47,18921.64,18495.08
1090,UD70EC5,214,834.7299999999973,175,39,47109.29,47944.020000000004
1091,UA877DA,214,12658.93999999998,157,57,103742.60000000008,116401.54000000002
1092,U84C4B9,214,-3856.6500000000015,187,27,134967.41999999998,131110.77
1093,U889E9F,214,-140895.86000000002,201,13,285368.48,144472.62
1094,UD7F383,214,3816.9999999999964,143,71,162496.05999999994,166313.06000000003
1095,U521A65,214,-17354.729999999996,198,16,42758.220000000045,25403.49
1096,UCD489B,214,-2881.909999999995,179,35,313141.48,310259.56999999995
1097,U6438B0,214,11420.809999999983,178,36,426191.5,437612.30999999994
1098,UA714A2,214,682.2100000000003,154,60,102949.18,103631.38999999997
1099,U09C2B9,214,22.909999999998195,168,46,14343.209999999985,14366.120000000003
1100,U61CB24,214,18082.37,198,16,91679.33000000002,109761.69999999998
1101,U82C849,213,-37413.04,128,85,734662.8499999999,697249.81
1102,UD51F72,213,1786.3000000000102,193,20,119100.8,120887.1
1103,U56E9E5,213,84594.7,199,14,240410.29999999996,325005.00000000006
1104,U8FC1C4,213,-7050.030000000001,200,13,52980.03,45930.0
1105,UDD5496,213,632.8299999999984,194,19,26906.709999999995,27539.54
1106,U44B373,213,3703.3400000000083,183,30,240209.8899999999,243913.23
1107,U2FBD6B,213,-679.9099999999307,123,90,415330.64,414650.73
1108,UD9BC8F,213,4417.11999999998,200,13,63712.370000000024,68129.48999999998
1109,UDEE66C,213,262288.7799999994,137,76,5118955.069999999,5381243.850000001
1110,U07A7C7,213,3214.120000000006,202,11,39568.469999999994,42782.59
1111,U6A617D,213,600190.2999999992,198,15,21191.169999999995,621381.47
1112,U9D2C3C,213,-143865.72,199,14,781544.9600000001,637679.2399999999
1113,U87751D,212,-91372.16000000003,177,35,1111071.48,1019699.32
1114,U2C7F4F,212,738.6699999999873,187,25,165696.26,166434.93000000002
1115,U6649CD,212,4559.9900000000025,207,5,57337.03000000003,61897.020000000004
1116,U35A31A,212,-22281.109999999986,160,52,1587639.23,1565358.12
1117,U7EF675,212,4914.010000000005,201,11,13275.94,18189.95
1118,U125755,212,5989.6500000000015,204,8,34363.91,40353.56
1119,UC3D405,212,9792.930000000011,187,25,71853.37000000005,81646.30000000002
1120,U35729C,212,-22895.590000000004,169,43,54864.11,31968.52
1121,U4B14F9,212,2170.199999999998,196,16,9394.629999999997,11564.830000000002
1122,UFE6897,212,-1233.7999999999963,197,15,19887.83,18654.03
1123,U3372E2,212,9216.120000000006,191,21,179975.01,189191.12999999998
1124,UD2F477,211,-6169.6299999999965,128,83,94627.64000000004,88458.01000000001
1125,UADAB8D,211,-7040.489999999996,122,89,257679.78000000003,250639.29
1126,U16C58B,211,-5203.849999999997,187,24,148228.62000000002,143024.77000000002
1127,UDABF3E,211,9616.69999999999,154,57,219672.72,229289.41999999995
1128,U97371D,211,1331.7699999999973,194,17,15910.06,17241.83
1129,U59D8CE,211,-4250.23,208,3,14048.4,9798.17
1130,U0B7D58,211,11522.700000000006,173,38,48897.24999999997,60419.95
1131,U2AFCAF,211,2101.769999999998,207,4,10300.1,12401.869999999999
1132,UCC3B03,211,-5199.069999999998,180,31,42464.549999999996,37265.479999999996
1133,U2323F9,211,-76.98999999998776,153,58,66232.26,66155.26999999999
1134,U296E27,211,-1631.2300000000007,195,16,32043.029999999995,30411.800000000003
1135,UF8E435,211,-22613.329999999998,172,39,135770.71999999997,113157.38999999998
1136,U820693,211,9081.579999999989,164,47,530606.39,539687.9699999999
1137,U30A908,211,-4198.989999999996,187,24,41799.55000000002,37600.560000000005
1138,U8CAA43,211,3510.08,168,43,232651.42999999996,236161.51
1139,U7299A7,210,-4713.519999999999,204,6,17669.929999999997,12956.41
1140,UE9538A,210,-31472.920000000002,198,12,96435.43,64962.51
1141,UD77ACD,210,-6323.250000000005,168,42,66456.68000000001,60133.43000000001
1142,UEACA46,210,-47748.74000000003,189,21,176923.13000000003,129174.39
1143,UCDC149,210,-1159.22,167,43,21464.29,20305.07
1144,U7B81D4,210,12840.069999999987,200,10,27715.020000000008,40555.090000000004
1145,U98E7DA,210,-35635.649999999994,151,59,221522.03000000006,185886.38
1146,UF84CC3,210,-1957.049999999985,195,15,176712.4899999997,174755.43999999997
1147,UD485AE,210,-8677.469999999998,192,18,31659.17000000001,22981.7
1148,U8E7DB7,210,-2128.4100000000094,195,15,11301.139999999956,9172.73
1149,U057979,210,352.18999999999943,194,16,10916.749999999995,11268.94
1150,U6FF5B3,210,-2922.929999999999,187,23,19749.16000000001,16826.23
1151,U104194,210,-54737.33999999997,186,24,508620.94999999995,453883.61000000004
1152,U447404,209,439.95000000000095,192,17,21976.76,22416.71
1153,U2FB426,209,4000.8200000000033,188,21,55413.749999999985,59414.57
1154,U6A803F,209,-3263.0099999999984,188,21,112698.04999999999,109435.04
1155,UA9135D,209,172565.39999999988,119,90,141366.22000000006,313931.62000000005
1156,U0B0180,209,27948.870000000017,173,36,416561.43999999994,444510.31
1157,U9A595A,209,-195.6100000000002,203,6,15860.210000000003,15664.599999999999
1158,U827431,208,6506.850000000013,169,39,269085.06999999995,275591.92
1159,UF514B5,208,594.7599999999962,188,20,104634.30999999997,105229.06999999999
1160,UE9FAB3,208,-12295.939999999999,136,72,144892.59000000003,132596.65
1161,UE6E4CA,208,681.1399999999967,155,53,96719.76999999999,97400.91
1162,U703AF0,208,-4933.089999999996,184,24,42190.93,37257.840000000004
1163,UA189AD,208,4614.590000000005,172,36,138312.63,142927.22
1164,UE0644B,208,-1529.310000000014,137,71,84231.97999999995,82702.66999999998
1165,UB49211,208,860.6699999999873,167,41,415120.13,415980.8
1166,U7C400F,208,-2571.7199999999984,189,19,17298.59,14726.869999999999
1167,UEFD483,207,-4448.529999999999,194,13,30410.600000000006,25962.07
1168,UA9434D,207,251085.6200000001,177,30,1525884.9,1776970.52
1169,U4F9A55,207,123.7699999999952,188,19,55845.87999999999,55969.65
1170,U3CD912,207,5579.019999999983,116,91,459381.42,464960.44
1171,U922AB5,207,25646.70999999997,109,98,572173.6799999999,597820.3899999999
1172,U9F9141,207,543.340000000001,193,14,10094.94,10638.279999999999
1173,U5EBF54,207,169.9799999999995,181,26,31163.239999999998,31333.22
1174,UB894F6,207,2058.360000000001,193,14,14788.949999999999,16847.309999999998
1175,UDABFB4,207,179457.57,92,115,352595.0,532052.5700000001
1176,U69FFA4,207,-10891.94,191,16,82448.78,71556.84
1177,U481469,207,1223.8799999999999,194,13,14665.05,15888.93
1178,U6C32C9,207,-14915.910000000009,173,34,51524.55000000002,36608.64000000001
1179,U1A119A,207,72809.27,167,40,1198178.81,1270988.08
1180,UD4BF49,207,-616.6800000000005,156,51,10429.849999999999,9813.170000000002
1181,U861310,207,-188.89999999999964,169,38,11969.02,11780.119999999999
1182,U71BE18,206,-1028.720000000004,74,132,234807.2,233778.47999999998
1183,U16F310,206,31566.239999999998,145,61,36874.240000000005,68440.48000000001
1184,UD8AE1A,206,-17761.489999999998,182,24,35415.88999999999,17654.399999999998
1185,U2B3EDF,206,-264.880000000001,101,105,94340.0,94075.12
1186,U538EAE,206,-4453.840000000009,95,111,237403.90999999997,232950.0700000001
1187,U3F117A,206,3476.9699999999993,167,39,128656.65000000001,132133.62
1188,UA3D14D,206,3883.3300000000027,196,10,19909.94,23793.27
1189,U13EFDE,206,2023.369999999999,185,21,67690.03,69713.4
1190,U2BBDFD,206,3329.279999999979,163,43,142487.46,145816.74000000002
1191,U8B63F4,206,7690.4800000000005,195,11,28910.620000000006,36601.1
1192,U4F6A71,206,-17009.999999999993,188,18,845006.8199999996,827996.8199999998
1193,U6A4BC0,206,2180.9699999999993,196,10,15014.109999999999,17195.079999999998
1194,UC00D49,206,-14494.630000000001,199,7,20047.629999999994,5553.0
1195,U1AEF10,206,11869.15000000001,189,17,149809.34999999983,161678.5
1196,UE597A9,206,21117.280000000006,184,22,80746.19,101863.47
1197,UF5F17F,206,631.1499999999975,184,22,33940.749999999985,34571.899999999994
1198,UA04AA9,206,-1293.3700000000001,145,61,19494.810000000005,18201.440000000002
1199,U9B7039,206,-26082.989999999965,178,28,712914.11,686831.12
1200,UC1E4E2,205,1108.1600000000017,146,59,505377.66000000003,506485.82
1201,U4AF782,205,855.6099999999979,135,70,159008.96,159864.56999999992
1202,UE82359,205,32911.52999999999,182,23,57916.299999999996,90827.83
1203,UDD3E98,205,116488.68000000005,185,20,436298.03000000014,552786.7100000002
1204,U4193DF,205,-199.9900000000008,191,14,7396.299999999995,7196.310000000004
1205,UAD313A,204,-10157.060000000005,178,26,49541.76999999995,39384.71
1206,U7CAB22,204,-12906.749999999993,196,8,38476.24000000003,25569.490000000005
1207,U32AD45,204,367203.51000000024,130,74,536556.5499999999,903760.0600000002
1208,U28F72F,204,39421.03000000001,185,19,41898.51000000001,81319.54000000001
1209,UEE9314,204,14814.21,176,28,29122.59,43936.79999999999
1210,U2AFC22,204,-795.4800000000021,135,69,79033.41999999991,78237.94000000003
1211,U683979,203,-37808.159999999996,184,19,174894.11999999994,137085.96
1212,UFA8C44,203,-398118.74999999994,184,19,754675.1300000001,356556.38
1213,UF9EB11,203,2490.8099999999945,173,30,258130.50999999998,260621.32
1214,U130D9B,203,876.8100000000068,193,10,73644.01999999999,74520.83
1215,U244D4C,203,-15198.469999999992,172,31,58101.840000000004,42903.369999999995
1216,UBA727A,203,2936.2700000000023,186,17,27060.65,29996.92
1217,UA65039,203,252513.72999999984,118,85,1732060.9500000002,1984574.6800000004
1218,UD3E4CE,203,3927.810000000005,174,29,46987.14000000001,50914.95
1219,UE2B519,203,98139.11999999972,71,132,140958.29,239097.410000001
1220,UDA83D3,203,-11514.86000000002,165,38,305308.01,293793.15
1221,U593549,203,972.0200000000012,168,35,159203.6,160175.61999999997
1222,U5D089F,203,431.98000000013053,157,46,1036565.19,1036997.17
1223,UD45FE3,203,14957.559999999996,130,73,463199.5100000001,478157.06999999995
1224,U338183,203,-47.260000000000105,114,89,582689.76,582642.5
1225,U0919DB,203,-8853.669999999998,117,86,367324.54000000004,358470.87000000005
1226,U683A62,202,-530.9100000000008,154,48,89957.67,89426.76000000002
1227,U4E98E8,202,-32614.150000000016,166,36,494776.58,462162.43
1228,UBB27DC,202,9629.11999999999,191,11,120070.88,129700.0
1229,UFEF2C1,202,35671.51,154,48,155359.97999999998,191031.49
1230,UDA8B07,202,-2042.2000000000007,193,9,19321.219999999998,17279.020000000004
1231,U50ADC8,202,-42249.06,143,59,462763.37,420514.31000000006
1232,U90E292,202,-9278.889999999992,189,13,130913.30000000008,121634.41000000002
1233,UCAD5B7,202,-3999.599999999996,183,19,58409.380000000005,54409.780000000006
1234,U097353,202,-39657.850000000006,186,16,180487.65999999997,140829.81
1235,U0475C4,202,657.8299999999708,161,41,121675.45,122333.28000000001
1236,U48D6FC,201,10572.560000000005,188,13,9488.2,20060.760000000002
1237,UEE0D4F,201,147263.24999999994,171,30,730383.67,877646.9199999999
1238,U7D5B3E,201,-24900.85,193,8,38106.66000000002,13205.81
1239,UEB0062,201,9096.10000000001,199,2,7869.900000000001,16966.0
1240,U3A1A9F,201,-3141.9799999999987,185,16,24353.24,21211.260000000002
1241,U1FCBB1,201,2330.2500000000014,184,17,41190.03,43520.28
1242,U3221FB,201,3221.880000000001,178,23,128278.44000000002,131500.32
1243,U88B879,201,-21569.490000000005,176,25,147041.77999999994,125472.29
1244,UEEF50D,201,768.8299999999991,191,10,14849.21,15618.039999999999
1245,U4964CE,201,-9553.819999999992,178,23,141376.88,131823.06
1246,UADE11D,201,-23397.439999999995,190,11,72607.01999999999,49209.58
1247,UB56270,201,41038.95000000005,150,51,414834.66999999963,455873.6199999999
1248,U86B232,200,-94024.33000000002,194,6,155075.28000000006,61050.95
1249,U52D8F8,200,-10843.820000000003,181,19,53756.16000000001,42912.34
1250,U1E6EED,200,159196.38000000006,97,103,1725889.0599999998,1885085.44
1251,U94C8B4,200,-611.7700000000013,167,33,36049.189999999995,35437.42
1252,U96E14F,200,310.0100000000058,178,22,70586.90999999996,70896.92000000001
1253,U1554D5,200,-1815.4000000000033,145,55,79259.03000000001,77443.63
1254,UD8DC6D,200,-12111.06000000001,105,95,851681.66,839570.5999999999
1255,U245B03,200,-808.5100000000001,162,38,65963.73000000001,65155.22
1256,UAB4B6E,200,14445.369999999995,149,51,120131.18000000001,134576.55
1257,U95C943,200,-3989.539999999995,186,14,38252.469999999994,34262.93
1258,UC0AD2A,199,142.4199999999888,177,22,228865.11,229007.53
1259,U319B9C,199,471.51999999999737,186,13,19820.829999999998,20292.35
1260,U69F0A4,199,25399.430000000008,186,13,44458.82,69858.25
1261,U5A2B61,199,-3058.26,193,6,7448.409999999998,4390.15
1262,U548840,199,3753.150000000001,152,47,9804.730000000001,13557.880000000001
1263,U28929D,199,33406.409999999996,184,15,122591.38999999993,155997.8
1264,UDFF33E,199,40640.71000000003,173,26,431787.7,472428.41000000003
1265,UEAA2B8,199,-5509.219999999999,187,12,19408.67,13899.449999999999
1266,U971E37,199,-56.710000000002765,124,75,129302.04000000002,129245.33000000002
1267,UEF9F52,199,-265.8699999999996,175,24,30819.710000000017,30553.839999999997
1268,UE3277B,199,316.61000000000126,189,10,12893.279999999995,13209.89
1269,U41B667,199,79982.28000000009,132,67,16599.699999999997,96581.98000000011
1270,UD3A9ED,199,-4069.9699999999984,133,66,82309.87999999999,78239.90999999997
1271,UF4F453,198,31493.670000000002,190,8,15063.919999999996,46557.59
1272,UBE4296,198,63863.50999999998,189,9,78929.45999999999,142792.97
1273,U29A550,198,-106535.89,189,9,206813.86,100277.97
1274,U5E1F8E,198,-64540.38,178,20,350058.3000000001,285517.92
1275,UEB39A1,198,-2029.39,190,8,5047.409999999999,3018.02
1276,UB46624,198,-4850.7499999999945,182,16,42663.47,37812.72
1277,UDB3304,198,81056.33000000006,134,64,2330557.1899999995,2411613.52
1278,U6310F6,198,-29590.840000000026,165,33,281238.2500000004,251647.40999999997
1279,U4B048D,198,-3317.160000000001,181,17,81141.47999999998,77824.32
1280,U6DF03E,198,-4009.6099999999997,188,10,37505.61,33496.0
1281,UA29701,198,8761.860000000004,194,4,23456.09,32217.95
1282,U9D48C7,198,9271.739999999998,174,24,86796.58000000002,96068.32
1283,UB576D7,198,-14.900000000001455,165,33,49428.76999999999,49413.869999999995
1284,U240877,198,-10717.709999999988,195,3,27531.539999999997,16813.83
1285,UA890CE,198,-578.9799999999923,159,39,172120.69,171541.70999999996
1286,U2B238B,198,13005.210000000014,134,64,491657.07,504662.28
1287,U4E59EA,198,3124.3799999999983,183,15,16216.869999999999,19341.25
1288,UFEB9E2,197,10738.039999999999,190,7,39463.100000000006,50201.14
1289,U4261F5,197,-87.61999999999239,162,35,140045.33,139957.70999999996
1290,U31194B,197,1340.8500000000122,178,19,195938.53999999992,197279.38999999998
1291,UF3925F,197,-19109.93,188,9,53021.90000000001,33911.97
1292,U7E1592,197,1174.4300000000112,173,24,184377.48,185551.91000000003
1293,UA29541,197,1177.6199999999983,187,10,11469.650000000001,12647.27
1294,U088948,197,-94.7199999999996,188,9,12113.84,12019.12
1295,U5E952D,197,-5257.87,175,22,32809.17999999999,27551.31
1296,U50CB82,197,1295.659999999999,153,44,85364.04999999999,86659.71
1297,U8BF3BE,197,2645.4899999999984,177,20,7938.0199999999995,10583.51
1298,UF8CB35,197,906.030000000009,153,44,633051.2500000001,633957.28
1299,U79718D,197,-792252.2100000007,180,17,2327837.83,1535585.6199999999
1300,U41E00E,197,3298.499999999999,190,7,9646.849999999995,12945.35
1301,U3F0AC3,197,-957.7799999999975,188,9,36576.27999999999,35618.5
1302,U7A1C4D,197,-12744.640000000003,180,17,73923.51999999997,61178.880000000005
1303,UCCD850,197,172419.32000000007,125,72,576805.28,749224.6
1304,UC5339C,196,-20005.789999999997,177,19,159955.52999999997,139949.74
1305,UA1BF35,196,-227.50000000000654,132,64,313698.27,313470.7699999999
1306,U91688E,196,6233.250000000005,163,33,64709.590000000004,70942.84000000001
1307,U7FF94D,196,-3445.66,190,6,8353.33,4907.67
1308,U9D7ACC,196,-29443.819999999996,158,38,85253.26000000001,55809.43999999999
1309,U753E7D,196,103510.37999999996,147,49,443348.66999999987,546859.05
1310,U938415,196,945.1999999999917,183,13,115208.49999999987,116153.7
1311,UF34557,196,-2548.3299999999836,169,27,469494.59,466946.26
1312,U870246,196,-1252.7399999999989,160,36,54414.42000000002,53161.68000000001
1313,UEA1795,196,559.2899999999988,165,31,12148.66,12707.95
1314,UF40E50,196,-8560.969999999985,176,20,137362.97000000003,128802.0
1315,UBCB1DB,196,-46966.149999999994,179,17,440982.27,394016.12
1316,U578575,196,1219.5999999999963,146,50,75403.65999999999,76623.26
1317,U628F8D,196,-327.9200000000037,152,44,120836.01000000001,120508.09000000001
1318,U2AD6E0,195,-4123.800000000001,185,10,30321.56,26197.760000000002
1319,UA238BC,195,-3167.360000000004,181,14,41257.36000000001,38090.0
1320,UF97868,195,2.6799999999957436,144,51,15387.460000000001,15390.139999999994
1321,UD2ADEE,195,21877.759999999995,165,30,159608.22999999995,181485.98999999996
1322,U4F6BF2,195,-150966.1,177,18,229891.47,78925.37
1323,UB66628,195,-15806.330000000007,170,25,78169.13000000002,62362.8
1324,UB8FD25,195,19844.72999999999,157,38,198106.67,217951.4
1325,U270559,195,34384.36999999998,172,23,217691.09999999998,252075.47
1326,U9A171F,195,3274.41,169,26,31370.890000000003,34645.3
1327,U71A37E,195,-3690.4399999999987,167,28,19015.89,15325.45
1328,UE9D24F,195,6742.869999999997,179,16,191690.5699999999,198433.43999999997
1329,U423F96,195,-14424.46999999998,133,62,486497.12999999983,472072.65999999986
1330,U5A63F8,194,2218.3299999999954,188,6,7525.930000000003,9744.26
1331,UF40EAB,194,-1973.7799999999995,138,56,5739.68,3765.9
1332,U6BE45F,194,1800.9600000000137,95,99,1527255.94,1529056.9000000001
1333,UDECE12,194,-8330.800000000001,163,31,67470.27,59139.47000000001
1334,U79D0ED,194,-156.7100000000006,183,11,11205.109999999997,11048.400000000001
1335,UE7D341,194,-32881.19,151,43,200658.65,167777.46000000002
1336,UF28273,194,-1249.06,189,5,9173.539999999999,7924.4800000000005
1337,UB8547A,194,-9908.529999999997,182,12,25058.79,15150.26
1338,U8BD841,193,-52908.99000000001,110,83,2499281.5500000003,2446372.56
1339,U334930,193,-1485.6200000000013,180,13,24605.310000000012,23119.69
1340,UE75AB8,193,-5703.050000000002,188,5,13155.050000000001,7452.0
1341,U9955A7,193,-16257.789999999983,156,37,408291.5399999999,392033.75000000006
1342,U836F66,193,-3881.609999999986,174,19,413234.55,409352.94
1343,U4CEE2F,193,-12061.659999999989,170,23,57149.26,45087.600000000006
1344,U1BBB63,193,-3584.159999999996,187,6,27849.010000000002,24264.850000000006
1345,U860F3F,193,369.0600000000044,184,9,42295.630000000034,42664.69
1346,UEFEC0B,193,-21686.329999999998,163,30,98815.86000000002,77129.53000000001
1347,UD63464,193,-891.1599999999975,181,12,15337.679999999998,14446.519999999999
1348,U598F32,193,943.2000000000007,138,55,65068.87999999999,66012.08000000002
1349,U044916,193,-9076.550000000016,113,80,387248.74,378172.19
1350,U88E2CF,193,1277.8499999999929,126,67,25691.609999999997,26969.46
1351,UE66E24,193,-44.80000000000022,171,22,23049.980000000003,23005.180000000004
1352,U89F6C7,193,-15445.089999999964,127,66,423571.44999999995,408126.36
1353,UEAEDAB,193,-562.4300000000012,188,5,14494.109999999991,13931.68
1354,U02C7A0,193,-6625.829999999987,117,76,578151.65,571525.8200000001
1355,U86EDBE,193,-22827.49000000002,163,30,321652.2300000001,298824.74
1356,UFEB1FC,193,7377.5899999999965,126,67,88495.78000000003,95873.37000000001
1357,UC2F65B,193,10895.399999999534,104,89,13214852.15,13225747.55
1358,U1266DD,193,571.7600000000001,177,16,65908.86000000004,66480.62
1359,UC978CF,192,1894.3899999999992,181,11,31444.200000000004,33338.59
1360,U48941A,192,-2358.5800000000004,185,7,5619.129999999998,3260.55
1361,U7EF477,192,-41800.520000000004,182,10,60993.20000000001,19192.68
1362,UE312B7,192,52655.79999999999,156,36,351398.59,404054.38999999996
1363,UAAC74D,192,-18304.26999999999,140,52,48584.090000000004,30279.819999999996
1364,U80D7E0,192,-692.7399999999996,185,7,5402.05,4709.3099999999995
1365,U620AC5,192,495.03999999999724,164,28,52441.470000000016,52936.51
1366,UC9393E,192,100878.45000000004,113,79,347821.43999999994,448699.8900000001
1367,UA7731E,192,-12120.859999999993,153,39,77629.51000000001,65508.65000000001
1368,U7CB769,192,2135.809999999996,114,78,10958.669999999991,13094.48
1369,UD57CBA,192,483.61999999999756,165,27,8612.550000000001,9096.170000000004
1370,U9E34DC,192,-10269.599999999997,182,10,32819.530000000006,22549.93
1371,U56EC70,192,9323.689999999999,172,20,50698.100000000006,60021.79
1372,UDF886D,192,7307.390000000014,128,64,3311417.44,3318724.8299999996
1373,UA3DD2D,192,1209.79,153,39,15339.470000000003,16549.260000000002
1374,UC0ED45,192,-3124.2499999999927,186,6,20226.249999999993,17102.0
1375,UA15D69,192,-601.0399999999973,187,5,16159.649999999998,15558.61
1376,U759F03,192,2242.730000000007,148,44,194455.63999999996,196698.37
1377,U6B1C05,192,-5625.130000000003,171,21,23880.230000000003,18255.100000000002
1378,U3A92F6,192,-50357.50000000001,183,9,112392.26000000001,62034.759999999995
1379,U9C2787,191,-10271.169999999998,177,14,90951.52000000002,80680.35
1380,U2370FC,191,-2623.1600000000017,185,6,14310.759999999998,11687.6
1381,UBA323B,191,-11356.739999999998,174,17,40117.80000000001,28761.06
1382,UE5241E,191,46469.220000000016,124,67,728243.1699999999,774712.39
1383,U19C668,191,-14379.719999999998,176,15,30988.139999999996,16608.42
1384,U85C918,191,1.3700000000008004,156,35,42257.04,42258.41
1385,U243FBB,191,-39994.15999999999,82,109,683296.1,643301.9399999998
1386,UF9B25B,191,-2726.3199999999997,174,17,22744.310000000005,20017.989999999998
1387,U072D93,191,-1055.340000000001,188,3,8795.34,7740.0
1388,UEE3E36,191,9768.870000000006,164,27,93335.06000000001,103103.93
1389,U7C1111,191,-2458.9100000000026,179,12,16991.81999999999,14532.910000000002
1390,U19281C,191,-1402.8600000000015,176,15,18676.609999999997,17273.75
1391,U7C1837,191,104283.88000000005,71,120,514778.31,619062.19
1392,U72112C,191,46937.319999999985,106,85,60821.280000000006,107758.59999999996
1393,UEFC2FA,191,-4324.9000000000015,176,15,58737.259999999995,54412.36
1394,U13C0D4,191,-1759.46,176,15,25869.159999999993,24109.699999999997
1395,U551FF7,191,-143.8000000000004,161,30,17690.350000000006,17546.55
1396,UCA3841,190,-1555.149999999992,159,31,90968.38000000005,89413.23000000008
1397,U4F7F9D,190,-124.42999999999824,161,29,197370.1599999999,197245.72999999998
1398,UDEA262,190,12591.34,70,120,3646.2200000000003,16237.56
1399,UBB6BE9,190,2895.929999999999,170,20,21086.760000000006,23982.69
1400,UB179CB,190,45.42999999999938,163,27,50306.85999999999,50352.29
1401,U4F5581,190,-122601.37000000002,173,17,219755.81999999992,97154.45
1402,U87F6DB,190,44942.720000000016,132,58,200811.44999999998,245754.17
1403,U1394ED,190,-16566.5,174,16,71687.55,55121.049999999996
1404,U4AFC41,190,-9734.57,165,25,43585.71,33851.14
1405,U157CAE,190,-8454.069999999996,171,19,58214.42,49760.350000000006
1406,UB76D84,190,-3852.450000000001,186,4,16612.449999999993,12760.0
1407,U218135,189,23745.69,160,29,148339.56999999998,172085.26
1408,U2AB676,189,1202.0700000000045,140,49,25721.760000000002,26923.82999999995
1409,UE6AF7A,189,2121.1000000000004,148,41,11379.220000000005,13500.320000000003
1410,U3B1D31,189,46.970000000015716,133,56,269780.43000000005,269827.4000000001
1411,U26B998,189,-4899.740000000002,183,6,19354.31,14454.57
1412,UE3DA50,189,10105.470000000003,154,35,129667.52000000002,139772.99000000002
1413,UC6834D,189,11354.350000000019,109,80,439272.74,450627.09
1414,U23CD21,189,-148830.14000000004,146,43,863128.7199999997,714298.5800000001
1415,U60DB4C,189,-190196.68,132,57,845894.4,655697.72
1416,UA2003C,189,440.4900000000016,107,82,120076.04000000002,120516.53
1417,UE796E6,189,14338.819999999989,161,28,69052.10000000002,83390.92
1418,U1B45EF,189,7379.049999999998,160,29,70303.75999999998,77682.81
1419,U56D5FE,189,-999.3599999999988,139,50,285775.35000000003,284775.99
1420,U081D07,189,-759.9299999999961,165,24,166443.02999999997,165683.09999999998
1421,U14EC80,189,15021.759999999993,128,61,417252.9800000001,432274.73999999993
1422,UE82090,188,54151.06000000001,113,75,887255.58,941406.6399999998
1423,UBB6D42,188,-1747.18,185,3,9284.149999999998,7536.969999999999
1424,UECA0DD,188,4735.830000000001,175,13,10391.460000000001,15127.29
1425,UE208C3,188,-4467.450000000001,182,6,18944.730000000025,14477.28
1426,UCF0119,188,-20921.489999999998,161,27,139405.73000000004,118484.24
1427,U7A19B2,188,-2471.510000000004,180,8,46931.86000000001,44460.35
1428,U13B450,188,88188.44999999985,135,53,4315963.08,4404151.529999999
1429,UDEFD2E,188,-3578.2599999999948,147,41,39502.36999999984,35924.10999999997
1430,U93573E,188,33418.01000000001,146,42,297044.31999999995,330462.33
1431,U750F79,188,4656.350000000013,140,48,324738.56,329394.91
1432,U427D62,188,25899.530000000002,178,10,24772.499999999996,50672.03
1433,U97FC0E,188,-9720.560000000005,171,17,25419.629999999994,15699.07
1434,U9B8017,187,62079.20000000013,111,76,2189333.15,2251412.3499999996
1435,U1E9DF9,187,-316.2600000000005,166,21,18577.299999999996,18261.039999999997
1436,UE25081,187,-123.59999999999854,179,8,22365.789999999997,22242.19
1437,U43A833,187,2505012.0599999996,154,33,3295028.9400000004,5800040.999999999
1438,U796BB2,187,-1146.7299999999973,172,15,41377.400000000016,40230.67
1439,UED8DF5,187,3037.39,169,18,24081.000000000004,27118.39
1440,UAB8B19,187,-1333.4099999999994,152,35,21655.84,20322.43
1441,U6BB3E3,187,-5229.989999999999,132,55,414329.86,409099.87
1442,UF054AD,187,4474.660000000002,177,10,36346.86000000001,40821.52
1443,UC5C052,187,-1874.430000000002,184,3,10899.35,9024.92
1444,U9F2D43,187,118237.58000000007,121,66,696931.8499999999,815169.43
1445,UADFEA6,187,-647.3899999998082,178,9,77856.23000000036,77208.84
1446,U12341E,186,1466.8800000000006,124,62,10349.85,11816.73
1447,U01ED18,186,-568736.7600000005,170,16,634283.5500000004,65546.79
1448,U6A06A9,186,2666.9800000000005,139,47,22388.860000000008,25055.84
1449,U8B494B,186,2909.3499999999876,148,38,389406.91,392316.26
1450,UC5560A,186,-4813.6499999999905,172,14,33121.33000000003,28307.679999999997
1451,UF390D6,186,52007.71999999997,158,28,858421.0999999999,910428.8200000001
1452,U4FE8AB,186,4762.100000000035,172,14,317927.82,322689.92000000004
1453,U74E8B0,186,-26974.960000000014,134,52,71643.40000000001,44668.44
1454,U12C6AF,186,-1350.8699999999985,173,13,33109.04,31758.170000000002
1455,UA6BD1F,186,-130.0899999999998,140,46,12710.529999999999,12580.439999999999
1456,UF1E42D,186,-3803.079999999999,171,15,113757.95,109954.87
1457,U6FD847,186,5299.72,140,46,466723.9200000001,472023.64
1458,U42E82C,186,-486.6400000000001,158,28,38022.44,37535.8
1459,U6C5FC9,186,-36417.15000000002,160,26,1907630.7200000004,1871213.57
1460,UE8BE7D,186,-4620.039999999997,154,32,169166.68,164546.64
1461,UAA45FF,186,-1138.2199999999993,94,92,119743.22,118605.0
1462,UC54FEE,186,-173.30000000000086,181,5,7122.829999999999,6949.53
1463,U0BB832,186,12021.850000000017,146,40,341510.8500000001,353532.7
1464,U1B0FE9,186,-3953.5300000000007,177,9,22043.43,18089.9
1465,U473F5B,185,-2965.9400000000023,158,27,122068.01000000001,119102.07
1466,UB20C7D,185,8417.899999999994,129,56,411714.9,420132.80000000005
1467,UBAC69D,185,-930.8700000000006,172,13,20574.039999999997,19643.170000000002
1468,UD6A44C,185,-3631.749999999998,153,32,161929.6999999999,158297.95
1469,UFB9132,185,-7249.970000000045,87,98,662782.8700000001,655532.9
1470,U398745,185,110383.69999999998,162,23,196845.64999999997,307229.35
1471,UD9E2B3,185,-6599.550000000003,135,50,167420.43999999994,160820.89
1472,UC5CC2B,185,-5587.34,182,3,15425.159999999996,9837.82
1473,U35BF7A,185,-23996.419999999995,170,15,152304.44000000003,128308.01999999999
1474,U58F0F2,185,716.9399999999969,151,34,25079.420000000013,25796.359999999997
1475,UC82E5B,185,-43840.419999999955,167,18,962550.4600000007,918710.04
1476,UC7B158,185,3404.9499999999907,150,35,15822.300000000007,19227.25
1477,U49E467,185,54639.40999999999,142,43,70183.15000000001,124822.56000000001
1478,U23B3F7,185,62329.94000000002,156,29,435423.33999999997,497753.27999999997
1479,UC60E0E,185,225.73999999999984,135,50,10794.310000000001,11020.050000000001
1480,UCBFC8C,185,-140194.21000000002,157,28,3650845.039999998,3510650.83
1481,U7DAFEB,185,895.9700000000003,175,10,4229.09,5125.06
1482,U414C2F,185,2033.2499999999993,178,7,18603.999999999993,20637.25
1483,UF5D1ED,185,-841.8700000000005,180,5,8753.039999999999,7911.17
1484,U2E81B6,184,-26057.32,167,17,85136.09999999999,59078.780000000006
1485,UA2E9F9,184,48.20000000001346,86,98,1122537.22,1122585.42
1486,UC83805,184,-4559.210000000004,130,54,40679.770000000004,36120.55999999999
1487,UE41B86,184,258.5,182,2,700.39,958.89
1488,U1C59A1,184,-54922.08999999991,112,72,1380365.4700000002,1325443.38
1489,U82D267,184,4183.769999999997,124,60,274936.9600000001,279120.73
1490,U697CE3,184,1537.1500000000187,75,109,245871.59999999998,247408.75
1491,U45C73E,184,-6646.969999999998,175,9,25792.33,19145.36
1492,UC5DF2C,184,922.7799999999406,82,102,811594.43,812517.2100000003
1493,UD9BE17,184,-6683.679999999997,169,15,45150.56000000001,38466.88
1494,U6A7C2A,184,-3758.7699999999995,175,9,22123.569999999996,18364.800000000003
1495,UCCA7DE,184,1194.4000000000005,178,6,103949.43000000001,105143.83
1496,U47B14D,184,11845.619999999995,165,19,77365.9,89211.52
1497,U14BED5,184,28736.030000000042,129,55,2819427.5,2848163.5300000003
1498,U7DB470,184,13712.079999999998,142,42,206166.24999999994,219878.33
1499,U3ECA70,184,-8228.259999999998,103,81,267322.99,259094.73
1500,U5C9309,184,-149647.00000000003,168,16,246228.37,96581.37000000001
1501,UED5505,184,21.210000000002765,149,35,61612.550000000025,61633.76
1502,U1DFC67,184,-2535.6599999999994,156,28,34108.03999999999,31572.379999999997
1503,U28B571,184,-325.5200000000002,176,8,10906.58,10581.06
1504,UD2D0D6,184,74731.41000000003,117,67,1135988.93,1210720.34
1505,U87397E,184,-1593.7000000000003,172,12,70912.72000000004,69319.02
1506,UA7419F,184,-2610.219999999994,164,20,110242.69,107632.47
1507,U90F786,184,-18667.460000000003,137,47,524483.8899999999,505816.43
1508,UE139B3,183,83502.05,174,9,24405.249999999993,107907.29999999999
1509,UCFCF3D,183,-11364.600000000004,172,11,52780.76000000001,41416.159999999996
1510,UC1ECF0,183,-185609.92000000007,146,37,1816367.4,1630757.4800000002
1511,UA340D0,183,2107.029999999987,146,37,157389.64999999997,159496.68
1512,U8B031B,183,-7513.819999999999,177,6,29252.05999999999,21738.24
1513,UA58308,183,-1763.4600000000019,161,22,6687.010000000002,4923.549999999999
1514,U25064E,183,-10413.790000000005,160,23,84238.41999999998,73824.62999999999
1515,U2ACA6C,183,50396.540000000045,158,25,587629.7899999999,638026.33
1516,UB4CE94,183,-53.77999999999999,180,3,378.87999999999994,325.1
1517,U405FCE,183,-5203.03,166,17,22309.69,17106.66
1518,UD3DB0D,183,-1124.670000000001,160,23,22157.009999999995,21032.340000000004
1519,U1EC759,183,40.69999999999686,116,67,69765.63,69806.33
1520,UDDB061,183,-7377.599999999904,147,36,750966.0500000002,743588.45
1521,U061966,183,44722.59999999998,161,22,80736.24999999997,125458.84999999998
1522,U9D2157,183,-65283.350000000006,161,22,127446.63,62163.280000000006
1523,U5EB8ED,182,-31707.46000000001,156,26,66413.31000000001,34705.85
1524,UF7B6B1,182,21244.129999999997,139,43,269973.85,291217.98000000004
1525,U5B9D66,182,-2463.0399999999995,167,15,35476.57999999998,33013.54
1526,UE9E7E2,182,-6700.25,159,23,242851.28,236151.03
1527,U92FDEE,182,-30617.809999999983,161,21,192973.82999999993,162356.02000000002
1528,U0BFF5D,182,9871.349999999999,172,10,11501.409999999998,21372.760000000002
1529,U8530E3,182,-5573.730000000003,125,57,133122.89999999997,127549.17000000001
1530,U9FD0EB,182,-1200.5699999999997,168,14,116534.04000000001,115333.46999999999
1531,UF21D36,182,3211.0199999999995,170,12,3854.1899999999987,7065.210000000001
1532,UDFB1D7,182,-296.9800000000017,132,50,54929.7,54632.71999999999
1533,UD61C86,182,-11689.099999999997,179,3,19799.1,8110.0
1534,U46BF84,182,-597.3799999999997,165,17,56164.000000000015,55566.619999999995
1535,U108AE2,181,20370.68999999993,150,31,228840.80999999994,249211.5
1536,UE98453,181,-392.8999999999946,115,66,255256.90000000008,254864.00000000006
1537,U66F117,181,-193.0299999999965,160,21,24220.590000000004,24027.56
1538,U1F06F9,181,-4648.449999999998,168,13,24166.120000000003,19517.67
1539,UDDC0BF,181,-35006.58000000002,166,15,60307.38000000002,25300.8
1540,UBE410C,181,-1784.9800000000005,165,16,36306.18,34521.2
1541,U11E8FA,181,5407.439999999973,165,16,258380.26,263787.7
1542,U044BC9,181,-4575.930000000001,175,6,21636.140000000007,17060.21
1543,UCA15EE,181,-4252.860000000004,158,23,158527.55999999997,154274.7
1544,U0712C1,181,-4039.110000000003,175,6,4176.630000000003,137.51999999999998
1545,U68ACE6,181,-26774.579999999984,172,9,134590.66999999998,107816.09
1546,U5EE46C,181,-2277.580000000001,171,10,40602.27999999999,38324.7
1547,UA8720A,181,-5748.539999999995,111,70,255779.03,250030.49000000005
1548,U67C805,180,-3782.680000000004,168,12,40609.299999999996,36826.619999999995
1549,UFCFAF0,180,-684.2900000000004,132,48,28537.73,27853.44
1550,UAFCF64,180,-17113.32000000002,95,85,233596.30999999997,216482.99
1551,U8DCF1D,180,-2453.4399999999987,160,20,36185.22999999999,33731.79
1552,U575F06,180,-3942.0200000000023,166,14,13723.69,9781.67
1553,UA1580B,180,3472.209999999999,118,62,32421.239999999998,35893.450000000004
1554,U1AC05B,180,13706.590000000002,167,13,367645.89,381352.48000000004
1555,U451D8D,180,14656.949999999995,157,23,107002.67,121659.62000000001
1556,U7D4E90,180,-50870.289999999964,104,76,1519164.6500000001,1468294.36
1557,U9B4365,180,3355.810000000001,165,15,16686.010000000002,20041.82
1558,UF02F07,180,26509.360000000008,165,15,59382.67000000002,85892.03
1559,UEC6096,180,-4014.5500000000006,55,125,118539.62999999999,114525.08000000005
1560,U2898E0,180,18909.65000000001,163,17,79724.44,98634.09
1561,UBDAB7D,180,18921.340000000007,162,18,549859.9599999998,568781.3
1562,UEBC1A8,180,5694.469999999986,154,26,187383.35999999996,193077.83
1563,U157D6C,180,-1976.280000000002,168,12,13870.91,11894.63
1564,U54FD35,180,-87171.29,118,62,236059.75999999998,148888.46999999997
1565,UAFA28F,180,542.1000000000016,143,37,45122.17,45664.27000000001
1566,U458491,180,24793.939999999988,137,43,159734.67999999993,184528.62
1567,U1239E6,180,1176.0900000000006,161,19,35561.23,36737.32
1568,U3D147D,179,-6431.020000000026,139,40,1174051.0,1167619.98
1569,UFFF7F4,179,110588.38999999998,159,20,91435.3,202023.68999999997
1570,U4A6391,179,-3006.569999999996,102,77,360589.7,357583.13
1571,UF387E9,179,-40.449999999998816,133,46,76390.62000000002,76350.16999999998
1572,U176A6C,179,-3863.1300000000006,172,7,18358.360000000004,14495.23
1573,UC5CCF1,179,2419.620000000001,159,20,18987.58,21407.2
1574,U196920,179,-25136.370000000017,109,70,216961.02999999994,191824.65999999997
1575,U371D73,179,-11748.81,163,16,32532.900000000005,20784.090000000004
1576,UB0F5CE,179,-5022.369999999997,167,12,15643.27999999999,10620.91
1577,U997EA4,179,6519.300000000001,174,5,15831.699999999995,22351.0
1578,U0AC294,179,4548.4299999999985,172,7,21600.209999999985,26148.64
1579,U0E33E0,179,2273.4899999999325,150,29,321559.37000000005,323832.86
1580,U41031C,179,-8165.759999999992,155,24,68156.11999999998,59990.35999999999
1581,U461DAC,179,-10041.440000000002,140,39,27517.190000000006,17475.75
1582,UAA4465,179,63921.57000000001,124,55,477530.33,541451.8999999999
1583,U38E0B5,179,-547.5800000000017,149,30,128446.69,127899.11
1584,U38A82E,178,-21411.47,162,16,69959.32999999999,48547.86
1585,UE6AF92,178,29414.690000000002,144,34,453786.98000000004,483201.67000000004
1586,UAC5197,178,-27646.920000000002,169,9,97141.06999999999,69494.15000000001
1587,UDD9109,178,-2288.850000000006,169,9,154663.87,152375.02
1588,UDEE557,178,-97564.23999999999,161,17,406205.5600000001,308641.32
1589,UABDFD8,178,2660.919999999998,171,7,16359.139999999996,19020.06
1590,U286340,178,902.610000000006,68,110,293414.48,294317.08999999997
1591,U4C3959,178,1328.0799999999997,172,6,26406.519999999997,27734.6
1592,U24E27B,178,-1576.4100000000042,163,15,61720.72999999998,60144.32
1593,U3A3BF0,178,-3681.4700000000007,170,8,11043.359999999993,7361.89
1594,UFD3748,178,-120852.20999999995,139,39,365160.94000000006,244308.73000000004
1595,UAFCBBC,178,4657.190000000002,167,11,14664.41,19321.600000000002
1596,U953EE0,178,-5478.820000000002,139,39,23685.42,18206.600000000002
1597,UE09E43,178,10523.250000000002,146,32,49379.91999999999,59903.16999999999
1598,U3733B2,177,-22859.389999999992,152,25,139657.16000000006,116797.77
1599,UC442B3,177,7442.949999999994,111,66,334600.84,342043.7899999999
1600,U61CDBF,177,2816.4999999999986,90,87,103725.96999999999,106542.47
1601,U912A29,177,51.19999999999963,151,26,12880.24,12931.44
1602,UF0CB60,177,18101.74000000001,161,16,100670.13000000002,118771.87000000001
1603,UB3E40B,177,-21517.47999999999,168,9,46972.95,25455.47
1604,UA86B30,177,185.7500000000011,152,25,20234.420000000006,20420.17
1605,U175A85,177,-3524.1300000000024,144,33,31955.660000000007,28431.53
1606,U020123,177,-17278.020000000008,151,26,97322.63,80044.61
1607,UFB2080,177,7603.670000000011,158,19,14628.28999999999,22231.960000000003
1608,U98178B,177,-1163.3600000000008,149,28,73575.34,72411.98
1609,UCB2EED,177,-27861.11999999999,159,18,80755.27,52894.15
1610,UE51596,177,5955.5300000000025,175,2,4255.470000000001,10211.0
1611,U93256E,177,-1881.5899999999992,130,47,88912.39000000001,87030.80000000002
1612,U0043E8,177,-9703.229999999998,159,18,70489.29999999999,60786.07
1613,U7C844F,177,13273.409999999996,164,13,33522.900000000016,46796.31
1614,U09BBC9,177,20845.049999999996,142,35,464793.44999999995,485638.5
1615,U1D98AA,176,-9818.359999999999,166,10,20981.420000000006,11163.06
1616,U0D0B74,176,-8966.340000000004,135,41,335635.22,326668.88
1617,U76245C,176,-0.9799999999974034,94,82,33461.65,33460.67
1618,U92113C,176,735162.85,123,53,5970572.51,6705735.359999999
1619,U87D930,176,-43.10000000000082,131,45,33812.64,33769.54
1620,UC7B37F,176,19717.98,161,15,67193.92000000003,86911.90000000001
1621,U7353CE,176,-8747.479999999996,165,11,28281.25,19533.77
1622,UB9178A,176,-88894.54999999997,152,24,473038.76,384144.20999999996
1623,UA1D107,176,341.9400000000021,162,14,13816.330000000009,14158.27
1624,U3D0D94,176,-8132.789999999972,130,46,573164.7300000001,565031.94
1625,U648D51,176,8500.68999999961,125,51,3447426.17,3455926.86
1626,U111309,176,277397.7599999998,158,18,605261.98,882659.74
1627,UE32361,176,-18939.790000000005,86,90,347488.95,328549.16000000003
1628,U9F794D,176,-3893.900000000001,124,52,59806.82999999999,55912.92999999999
1629,UD96F50,176,-1712.8099999999995,167,9,19844.879999999997,18132.07
1630,UD40319,176,9344.3,143,33,111426.93,120771.23
1631,U84F586,176,-87742.96999999997,158,18,182139.18,94396.20999999999
1632,UBB317B,176,-148790.39,152,24,334724.28,185933.88999999998
1633,UDFC206,175,-10305.079999999998,154,21,23499.32,13194.24
1634,UDEA456,175,-105.07000000001881,90,85,1251638.5799999998,1251533.5100000002
1635,UD5649A,175,10294.159999999996,83,92,378600.24,388894.4
1636,U253B63,175,151.98999999999842,84,91,59725.84999999999,59877.840000000004
1637,UFA347F,175,2248.8800000000015,162,13,87207.42999999998,89456.31
1638,UD6AAB1,175,13696.82,154,21,96777.19000000003,110474.01000000001
1639,UF17D78,175,-10014.130000000003,86,89,549606.87,539592.74
1640,UF645E3,175,203941.97000000102,90,85,26476933.009999998,26680874.98
1641,U718E7D,175,501492.1000000001,139,36,56699.550000000025,558191.6499999998
1642,U973A93,175,-0.33999999999969077,122,53,12181.990000000007,12181.65
1643,U8AA704,175,-64235.24000000002,115,60,319882.27999999997,255647.04000000004
1644,UB29A0A,175,-495.36000000000035,157,18,21689.37,21194.01
1645,UD7FC7E,175,156.7199999999999,169,6,20984.720000000012,21141.440000000002
1646,U6E75CD,175,-36385.79,118,57,108441.73999999999,72055.95
1647,UAB9085,174,55479.360000000044,88,86,950633.0800000002,1006112.4400000001
1648,U1393E5,174,-8472.93,168,6,23704.93,15232.0
1649,UA44BD5,174,-605.5500000000003,159,15,29695.629999999997,29090.08
1650,UAB6133,174,830.8899999999999,162,12,18403.05,19233.94
1651,U131B78,174,927.7199999999982,167,7,22502.360000000008,23430.08
1652,U2D00BD,174,13922.570000000007,157,17,23030.139999999996,36952.70999999999
1653,U208195,174,-216.15999999999838,162,12,16690.08999999999,16473.93
1654,UE411BD,174,2209.8500000000017,161,13,20632.629999999997,22842.48
1655,U9D9CC5,174,-8185.449999999999,162,12,21951.790000000005,13766.34
1656,UF9D0C3,174,-9976.189999999999,166,8,58683.23999999999,48707.05
1657,UF5FE35,174,1108.1099999999992,164,10,14946.849999999999,16054.960000000001
1658,UA77E0B,174,-1107.8400000000006,168,6,9157.01,8049.17
1659,UEE1D7D,174,-1375.2900000000018,157,17,31633.339999999993,30258.049999999996
1660,U4C9C06,174,-1590.709999999998,165,9,31190.530000000013,29599.820000000003
1661,U70F7C5,174,15760.680000000002,164,10,16644.659999999993,32405.34
1662,U532187,174,24692.119999999988,137,37,79515.76000000001,104207.88
1663,UFC96F8,173,14305.560000000005,160,13,46494.34000000002,60799.9
1664,U49BA93,173,79552.43000000014,93,80,298744.6699999999,378297.1
1665,U91CB10,173,-3602.6899999999996,151,22,15925.820000000002,12323.130000000001
1666,U1534ED,173,11837.490000000009,154,19,102083.65000000001,113921.14
1667,U3B1695,173,-47823.280000000006,149,24,174970.74999999997,127147.47
1668,U009AC4,173,1642.3099999999959,113,60,15788.789999999995,17431.09999999999
1669,U9C2F9A,173,98720.17000000004,140,33,447834.27999999997,546554.45
1670,UEE8D6C,173,1401.3099999999995,154,19,44384.43000000002,45785.740000000005
1671,U9DCA4F,173,-6009.810000000001,168,5,35164.95000000001,29155.14
1672,UDF6229,173,-105090.90000000001,99,74,1316083.52,1210992.62
1673,U2FBD0A,173,-24581.009999999995,160,13,83401.45,58820.44
1674,U6CBC25,173,175515.7400000001,154,19,171889.86000000002,347405.60000000003
1675,UC5D2E4,173,-0.2100000000007185,123,50,53147.52999999999,53147.32000000001
1676,UB1C704,173,-258.2199999999997,167,6,7333.470000000005,7075.25
1677,U237794,173,118.05999999999881,129,44,36940.240000000005,37058.30000000001
1678,U9991A2,173,-2917.1499999999987,159,14,73341.54,70424.39
1679,UDD09F4,173,115335.84000000004,153,20,145845.84999999998,261181.69
1680,U95A396,173,-4397.48,168,5,20471.529999999995,16074.05
1681,UDD1013,173,785.0899999999965,139,34,30071.27,30856.359999999997
1682,U55A961,173,4253.5099999999975,164,9,28067.069999999985,32320.579999999998
1683,U84D2FD,173,-2186.33,166,7,13373.61,11187.28
1684,UDA8CFC,172,-1015.5799999999996,103,69,60313.049999999996,59297.470000000016
1685,UE167C5,172,1398.9099999999978,153,19,68613.87999999999,70012.79000000001
1686,UFA96B5,172,2855.27,147,25,16314.869999999994,19170.140000000003
1687,U730ABB,172,-16634.710000000006,146,26,97703.86999999995,81069.15999999999
1688,UEAA15E,172,286.0100000000002,150,22,104757.09999999999,105043.11
1689,UE7C719,172,3781.3400000000047,103,69,68782.79000000001,72564.13
1690,UF63EA2,172,-3665.36,137,35,45067.68999999998,41402.33
1691,U92BD64,172,927.4000000000005,134,38,20564.33,21491.730000000003
1692,U52E497,172,-803.039999999999,150,22,29652.539999999994,28849.5
1693,U618B70,172,-44248.57000000001,65,107,141794.22,97545.65000000001
1694,UEF1B6E,172,-4679045.57,145,27,4790669.85,111624.28
1695,U6D3919,172,-203654.40999999995,160,12,286808.66000000015,83154.25
1696,U3C24E8,172,-192030.76,153,19,1020303.3,828272.54
1697,UF4CFA2,172,-15657.990000000016,139,33,193659.73,178001.73999999996
1698,UDA3BC1,172,397.5499999999977,163,9,16822.68,17220.23
1699,U3292CB,172,21393.960000000006,134,38,172398.97999999995,193792.94
1700,U11E276,172,198.86000000001113,152,20,135319.71000000014,135518.57
1701,UB39D52,172,-16653.379999999997,147,25,94533.82000000004,77880.44000000003
1702,U7CDC64,172,147.81000000000026,168,4,4498.320000000001,4646.13
1703,U1F3844,172,7962.040000000004,163,9,28132.809999999994,36094.850000000006
1704,U8F1D64,172,-13089.51,112,60,130065.46,116975.94999999995
1705,UCF7C01,171,43160.33999999998,105,66,467851.66000000003,511012.0000000002
1706,UB1D90A,171,22173.220000000052,96,75,1664922.64,1687095.86
1707,UCFF341,171,-51110.64000000001,101,70,703896.8999999998,652786.26
1708,U0CB134,171,-43049.93999999997,141,30,315613.33999999997,272563.4
1709,UCE7FDE,171,-8363.969999999996,143,28,142972.8999999999,134608.93
1710,UEDB8B9,171,14423.540000000005,146,25,160603.89,175027.43
1711,U21EE99,171,-6753.640000000001,168,3,14763.559999999996,8009.92
1712,U56F9EF,171,27679.799999999992,132,39,249051.95999999993,276731.75999999995
1713,UFD3429,171,-16610.359999999986,141,30,169225.87999999998,152615.52000000002
1714,UBDFE76,171,2526.2999999999984,92,79,40784.53,43310.830000000016
1715,U38EB58,171,-31817.960000000025,153,18,1253938.6100000003,1222120.65
1716,UB3A67D,171,45770.72000000006,113,58,624584.33,670355.05
1717,UF7DE4A,171,-2368.569999999999,155,16,33317.85000000002,30949.280000000002
1718,UEC4FBF,171,-5233.630000000001,112,59,14509.599999999997,9275.970000000001
1719,UF045D3,171,5373.049999999997,161,10,65242.76,70615.81
1720,U34855D,171,338.5399999999986,147,24,52342.31,52680.85
1721,UC44A54,171,984.5699999999799,154,17,101624.21000000002,102608.78000000001
1722,U824E82,171,1138856.93,151,20,7237765.640000001,8376622.569999999
1723,U8985EC,171,5852.360000000007,157,14,112492.90999999999,118345.27
1724,U9052BA,171,-55596.38000000001,114,57,925756.3099999999,870159.9299999999
1725,U699BCB,171,-1245.5299999999997,154,17,17440.670000000002,16195.140000000003
1726,U7A9F12,171,239.73999999999995,86,85,4280.27,4520.01
1727,U78DB59,170,-2236.8200000000015,154,16,34834.66,32597.84
1728,UDEA7F9,170,-4969.959999999996,140,30,59690.02999999999,54720.06999999999
1729,U907905,170,942.1600000000017,142,28,97362.14000000001,98304.29999999999
1730,U255256,170,98443.65,155,15,66502.31,164945.96000000002
1731,U594670,170,-61596.95999999996,161,9,145298.00999999995,83701.05
1732,UB4C447,170,-24281.130000000026,154,16,141241.06999999995,116959.94
1733,U0206EA,170,-878.5000000000036,127,43,242301.02999999997,241422.53
1734,UE5F43F,170,-109370.40000000001,153,17,287300.87,177930.47
1735,U7D59F6,170,-2621.700000000003,159,11,46058.96,43437.259999999995
1736,U475D76,170,-60190.76999999996,120,50,1040668.8900000001,980478.1200000005
1737,UF12024,170,16372.080000000007,120,50,416197.19999999995,432569.28
1738,U4798BA,170,-44116.15,133,37,568450.2100000001,524334.06
1739,U323C77,170,-4874.089999999998,144,26,96565.09000000007,91691.0
1740,U77785E,170,-1375.3899999999987,143,27,196824.4799999999,195449.09000000003
1741,UF2640D,170,2.1900000000005093,149,21,71360.56,71362.75
1742,UFD0DE3,170,-18708.770000000008,84,86,531468.5,512759.73
1743,UE2547E,170,10450.989999999998,105,65,500492.75999999995,510943.75
1744,U711E29,170,-100501.71,93,77,768830.74,668329.0300000003
1745,U5FD634,170,-112035.87999999999,156,14,680429.7600000001,568393.88
1746,U018EEE,170,-2399.1200000000026,161,9,14037.489999999998,11638.37
1747,UCF236E,170,-1027.5899999999938,146,24,106119.16999999982,105091.58000000002
1748,UC31483,170,-23814.460000000003,141,29,77960.76999999999,54146.31
1749,UD5BABB,170,138.7899999999999,167,3,14800.73,14939.52
1750,U4AB61C,170,59141.88,154,16,14664.779999999997,73806.66
1751,U54C272,170,2486.299999999961,125,45,643263.32,645749.62
1752,U90BA89,170,558.7199999999809,149,21,107960.25000000025,108518.97
1753,UF991D3,169,-5935.180000000008,134,35,352264.6,346329.42
1754,UCF0BC3,169,20589.11000000002,156,13,59140.37000000001,79729.48
1755,UF0A6DB,169,-4241.509999999988,150,19,30369.549999999977,26128.04
1756,UAC169D,169,-2590.9599999999928,159,10,15619.899999999992,13028.939999999999
1757,UA4655D,169,-937.2900000000081,100,69,373158.9,372221.61000000004
1758,U3069EE,169,3198.790000000002,162,7,26245.500000000004,29444.29
1759,UD4DFD3,169,-14122.999999999998,143,26,38949.43000000001,24826.429999999997
1760,UD2048B,169,-11557.559999999998,157,12,32172.09,20614.53
1761,UE19007,169,-2714.970000000001,141,28,137542.16,134827.19
1762,UEA46C3,169,5067.060000000002,148,21,73429.07,78496.13
1763,UCC2E33,169,-289569.48000000004,144,25,685821.83,396252.3499999999
1764,U06FC45,169,261.2799999999921,105,64,248308.60000000003,248569.87999999998
1765,U6156BD,169,-620.8999999999996,156,13,16325.459999999997,15704.559999999998
1766,UDAF7B6,169,-781.3200000000007,156,13,8649.319999999996,7868.0
1767,U3B53EC,169,-11326.49,148,21,52057.13000000003,40730.64
1768,U835F5E,169,22310.679999999993,141,28,57144.630000000005,79455.31
1769,UB5FE93,169,8155.360000000004,143,26,22594.41999999999,30749.780000000002
1770,UBE7FC8,169,743.35,134,35,29476.410000000007,30219.76
1771,UED352F,169,-11776.41000000001,110,59,190037.59000000005,178261.18
1772,UDE4204,169,-155218.12999999983,133,36,2030354.7699999996,1875136.6400000001
1773,UE83880,169,-38762.71999999998,131,38,626833.8600000001,588071.1400000001
1774,U68EFD6,169,-13127.509999999995,144,25,76920.54,63793.030000000006
1775,UFF245C,169,-8111.760000000032,119,50,127944.96999999997,119833.20999999998
1776,U1B4EEC,169,-2751.56,151,18,12759.549999999997,10007.99
1777,UE41284,169,-5542.149999999987,116,53,449313.42,443771.2700000001
1778,UBF64AB,168,-98.11000000000058,50,118,37517.3,37419.19
1779,U2635DD,168,7613.520000000004,152,16,63354.98,70968.5
1780,UAADBEB,168,2081.439999999999,147,21,23345.989999999994,25427.43
1781,U39CF84,168,5602.230000000001,140,28,108402.84000000007,114005.07000000002
1782,U613E27,168,-42887.87,151,17,125568.51,82680.64
1783,U2A6055,168,-26806.040000000005,109,59,509232.72,482426.68
1784,U8F74AE,168,57451.24000000001,141,27,377632.50999999995,435083.75
1785,U63C6BC,168,-68772.79000000001,151,17,176941.30000000005,108168.51
1786,UD45DC0,168,-817.9199999999946,150,18,19992.819999999996,19174.9
1787,UB474BC,168,2770.2099999999928,135,33,48477.33,51247.54000000001
1788,UF7300E,168,14383.599999999975,139,29,151761.17000000007,166144.77000000005
1789,U81C3AC,168,6452.629999999999,157,11,20672.429999999986,27125.06
1790,UCF1942,168,3841.819999999996,104,64,234284.80000000002,238126.62000000002
1791,U4DB89E,168,-2405.689999999998,145,23,403429.3,401023.61
1792,U91655F,168,5610.200000000024,112,56,1496726.0099999998,1502336.21
1793,UE1E120,168,-12535.419999999991,157,11,58596.95,46061.53
1794,U8721A0,168,-9638.120000000006,156,12,169502.15000000002,159864.03
1795,UA5A638,168,-54067.52000000002,102,66,404434.3099999999,350366.79
1796,U650336,167,-16370.010000000035,157,10,471923.56999999995,455553.56
1797,UB25B7F,167,-2234.24,152,15,13844.91,11610.67
1798,U294E26,167,-2858.7400000000007,144,23,41518.439999999995,38659.700000000004
1799,UA436CB,167,1809.6699999999764,115,52,219173.30000000005,220982.97
1800,UE220A1,167,535.6599999999976,159,8,7794.560000000013,8330.22
1801,UC21612,167,17982.19,147,20,83622.49000000003,101604.68
1802,U627F8C,167,-4863.549999999998,110,57,33233.99,28370.439999999995
1803,U7658C8,167,552.1799999999998,151,16,22672.9,23225.080000000005
1804,UF42A97,167,-282.38000000001557,113,54,322024.2100000001,321741.83000000013
1805,U2ECB53,167,-35233.62,101,66,156216.99,120983.37
1806,U4009FD,167,-1151.0399999999981,137,30,104864.32000000002,103713.27999999998
1807,U51E5F5,167,-1605.1100000000004,155,12,8151.700000000001,6546.589999999999
1808,UF9FC16,166,8923.579999999976,153,13,40381.720000000016,49305.299999999996
1809,UC15F82,166,-4401.16,150,16,68639.02,64237.86
1810,UD5E6AE,166,-2238.800000000002,144,22,35304.189999999995,33065.39
1811,U70B3F8,166,-1703.7500000000036,116,50,12301.65,10597.90000000001
1812,U4A6275,166,110158.18999999999,157,9,250121.18000000002,360279.37
1813,U17F642,166,2266.2400000000043,153,13,25271.78,27538.02
1814,U9985A2,166,120.67000000002355,139,27,149678.30999999997,149798.98
1815,U895DFF,166,-20.71999999999555,105,61,40458.280000000006,40437.560000000005
1816,U7DA0A7,166,165.1299999999959,161,5,13696.21,13861.34
1817,U965465,166,544.6699999999992,118,48,64439.46,64984.13000000001
1818,UA29E15,166,13.989999999996144,94,72,101021.11,101035.09999999999
1819,UF6F13D,166,19670.290000000023,119,47,669104.5000000002,688774.79
1820,UA7859D,166,36396.890000000014,133,33,247936.7000000001,284333.58999999997
1821,UAFC7FE,166,38880.69,153,13,36107.01000000001,74987.7
1822,U877DC4,166,8595.59999999999,83,83,247956.12999999998,256551.72999999995
1823,U0AA9DA,166,110551.88999999998,143,23,57849.55,168401.44000000003
1824,U62D01B,166,951.7499999999998,164,2,6600.49,7552.24
1825,U1CE4FD,166,-85.16,94,72,2769.3000000000006,2684.14
1826,U29C3A1,166,5638.479999999996,130,36,587801.39,593439.8700000001
1827,UE59EF4,166,182.61000000000104,111,55,42879.270000000004,43061.88
1828,UF3B285,166,2454.6499999999987,148,18,19682.92,22137.57
1829,U7D7DBF,166,-93.41000000000098,55,111,16570.409999999996,16477.000000000004
1830,U2E6C14,166,-11470.210000000006,151,15,257913.14000000004,246442.93
1831,U0E9015,166,-109190.60000000002,117,49,828069.5399999996,718878.9400000001
1832,U8AF982,165,2669.45,155,10,24162.530000000006,26831.980000000003
1833,U8282F1,165,1782.3899999999985,137,28,86589.83,88372.22
1834,U8C2D05,165,-2717.9599999999987,149,16,86373.92,83655.95999999999
1835,U332960,165,-645.490000000002,159,6,28646.150000000005,28000.66
1836,UFD0D07,165,-5794.410000000007,119,46,278757.7199999999,272963.31
1837,U314800,165,291.929999999993,147,18,148103.94,148395.87
1838,U9CEF7C,165,-1664.9200000000073,139,26,112347.23999999999,110682.32
1839,U00148A,165,308656.16000000003,146,19,99302.70000000001,407958.86
1840,UD70BB9,165,-1504.1099999999924,133,32,256383.09000000003,254878.98
1841,U00CFF7,165,6741.850000000002,151,14,60552.42000000002,67294.27
1842,U460969,165,-801.220000000001,150,15,8936.39,8135.169999999999
1843,UF87DC0,165,-22177.06,139,26,61018.53999999999,38841.479999999996
1844,U6DB063,165,10475.109999998938,76,89,18559000.110000003,18569475.220000006
1845,UDED2C5,165,-5085.569999999985,154,11,94645.00000000003,89559.43
1846,U7ED7AF,165,2988.200000000004,153,12,56792.48000000002,59780.68000000001
1847,U4E0E04,165,-2905.1900000000023,152,13,18323.95999999999,15418.769999999997
1848,UBBBE97,165,-1892.3199999999988,103,62,96640.87,94748.55000000002
1849,U3B6714,165,32154.47999999981,70,95,12988125.23,13020279.709999999
1850,U684386,165,14113.000000000127,121,44,1671083.54,1685196.5399999998
1851,U31CFD7,165,-2714.1300000000006,161,4,11044.599999999999,8330.470000000001
1852,U3DF057,165,29510.74,133,32,71374.81999999999,100885.56000000001
1853,U8981CF,165,-1211.4300000000026,149,16,29015.550000000003,27804.119999999995
1854,UFE13BB,164,-2604.4899999999748,97,67,168773.7700000001,166169.28
1855,U604D56,164,-2445.52,154,10,11609.859999999997,9164.34
1856,U575BC2,164,-13685.620000000003,156,8,40845.49999999999,27159.879999999997
1857,U95AA8E,164,-7735.5,150,14,28464.139999999996,20728.64
1858,U8E1FFA,164,-4385.139999999989,84,80,267888.23,263503.09
1859,U662532,164,1872.9400000000014,138,26,39285.45999999999,41158.399999999994
1860,U1F6778,164,-4418.800000000001,148,16,93415.16000000002,88996.35999999999
1861,U92D3B5,164,-478946.85000000015,141,23,605964.3500000003,127017.50000000001
1862,UF80419,164,2423.8899999999994,154,10,6524.110000000001,8948.0
1863,U61C361,164,-22121.919999999984,86,78,594854.46,572732.54
1864,UD4DA67,164,872.1799999999995,157,7,8856.309999999998,9728.49
1865,U582321,164,-25269.380000000005,119,45,374529.13,349259.75
1866,UFE7D0D,164,-969.6100000000004,141,23,17332.649999999998,16363.04
1867,UB0D9CC,164,3430.810000000004,79,85,196255.22000000003,199686.03
1868,U525D6A,164,5751.279999999999,147,17,40783.70999999999,46534.99
1869,UA8B7E6,164,6963.460000000046,126,38,1090998.4799999988,1097961.94
1870,UCA47FE,164,827.4700000000003,119,45,78671.25,79498.71999999999
1871,U279286,164,67893.68,143,21,196847.27,264740.94999999995
1872,UBF4584,164,65443.29999999999,150,14,31711.229999999992,97154.53
1873,UADC4C6,164,-56.36000000000013,151,13,22886.11,22829.75
1874,U4022AB,164,-6937.439999999962,90,74,659512.8900000001,652575.45
1875,UBFD140,164,3618.499999999998,142,22,29080.150000000005,32698.65
1876,UBBF887,163,1779.720000000004,152,11,95535.45999999998,97315.18
1877,UD2BD85,163,-1126.249999999999,146,17,25722.61,24596.36
1878,U404C74,163,-1177.989999999997,125,38,93213.68000000002,92035.69000000002
1879,U8823AE,163,4561.18,93,70,101290.59,105851.77000000002
1880,U64B848,163,-14205.090000000004,139,24,521763.06999999995,507557.98
1881,U644B9E,163,-23159.380000000005,135,28,60676.29000000001,37516.90999999999
1882,UFF93AC,163,-4752.9400000000005,150,13,100230.17999999961,95477.24
1883,UA5605F,163,1204.1200000000017,159,4,16581.71000000001,17785.83
1884,UEE24F4,163,29650.76000000001,140,23,378615.14,408265.9
1885,U9E2967,163,1890.5599999999972,149,14,68664.66,70555.22
1886,U65E8C7,163,-948.1600000000035,140,23,143371.14,142422.98
1887,U246A8A,163,-12936.390000000003,151,12,40636.90000000001,27700.510000000002
1888,U5DF9EB,163,268.40999999999985,149,14,50066.17,50334.58
1889,UD92EAE,163,6988.849999999991,126,37,143023.41,150012.26
1890,UE11AC2,163,-2776.1400000000003,141,22,20084.780000000002,17308.64
1891,U9D2204,163,9316.820000000002,147,16,26770.150000000005,36086.97
1892,U39F645,163,5902.639999999997,149,14,12344.610000000002,18247.25
1893,U33450E,163,21.66000000000753,152,11,74562.84000000001,74584.5
1894,U839CFB,163,-12658.21,153,10,83030.72,70372.51000000001
1895,UE4B0FC,163,-29863.81999999998,159,4,88458.82000000011,58595.0
1896,UBFD6E3,162,36387.16,133,29,246957.55999999997,283344.72
1897,UA395CA,162,-1287.8999999999996,152,10,31874.59,30586.69
1898,U6D21CF,162,954.3299999999945,139,23,67857.34999999999,68811.68
1899,U8DAEA2,162,16047.919999999996,143,19,196972.05000000005,213019.96999999997
1900,UDA29E4,162,-1650.4200000000005,133,29,38459.99000000001,36809.57
1901,UF5BA97,162,95294.70000000001,152,10,8801.050000000001,104095.75
1902,U858F46,162,-24031.22999999999,153,9,69569.5,45538.270000000004
1903,UC48D16,162,-2517.8,153,9,8604.63,6086.83
1904,U318DF6,162,294.2099999999988,155,7,15972.269999999997,16266.48
1905,U1BA984,162,10102.119999999994,138,24,38238.66999999996,48340.79
1906,U1AD2A0,162,-5431.369999999999,140,22,64686.45999999999,59255.08999999999
1907,UCBAE02,162,-2211.0299999999997,152,10,21330.98,19119.95
1908,UD46311,162,-4924.96,141,21,62918.22,57993.259999999995
1909,UE212D9,162,1228.7000000000012,139,23,31487.460000000003,32716.159999999996
1910,U590486,161,-1366.5100000000011,135,26,130003.05000000005,128636.54
1911,U47118E,161,-1261.4300000000017,155,6,16835.359999999993,15573.93
1912,U14E59A,161,-1507.890000000014,104,57,567184.71,565676.8200000001
1913,U003D94,161,12934.580000000016,117,44,691823.87,704758.4499999998
1914,U4D99E7,161,6770.649999999987,105,56,838896.4199999998,845667.07
1915,U7B0692,161,-605.4000000000012,137,24,19915.79,19310.390000000003
1916,UE11DBB,161,3348.9599999999987,151,10,16503.18,19852.139999999996
1917,U218424,161,60419.44000000001,146,15,36931.32,97350.76
1918,UF3D994,161,149971.75000000003,149,12,14117.64,164089.39
1919,UB43AFF,161,42287.2,148,13,126078.48000000003,168365.68
1920,UFE7F07,161,-20686.52999999999,149,12,250652.96000000002,229966.43
1921,UEB684B,161,-90.59000000000087,154,7,9996.34,9905.75
1922,UBE816A,161,583.6599999999997,155,6,6463.480000000001,7047.139999999999
1923,UE1C021,161,-45985.37000000001,143,18,154068.22,108082.85
1924,U92B4F0,161,-527.3399999999999,153,8,9062.989999999998,8535.650000000001
1925,U998C85,161,20095.740000000005,130,31,75877.97000000003,95973.71
1926,UBED9C9,161,856.7999999999988,143,18,28540.159999999993,29396.96
1927,U5F682E,161,3879.4899999999984,147,14,15316.19,19195.680000000004
1928,UBA1855,161,1142.020000000004,148,13,89783.23,90925.25
1929,UF7B67A,161,57152.750000000015,143,18,312571.89,369724.64
1930,U7A816A,161,28366.71,156,5,21282.019999999997,49648.73
1931,UDD6737,161,1018.159999999986,119,42,446336.1899999999,447354.35
1932,U9FC8B6,161,532.4800000000006,116,45,21817.460000000003,22349.940000000006
1933,U43C841,161,1981.169999999999,158,3,22951.940000000013,24933.11
1934,UD33960,161,7988.6999999999925,98,63,429652.65999999986,437641.3600000001
1935,UFA30B6,160,-24407.360000000044,118,42,506049.9,481642.54
1936,U690E4C,160,-944.4099999999979,132,28,52375.920000000006,51431.51
1937,UA56F0C,160,50411.41999999999,147,13,20314.179999999993,70725.6
1938,U313DD3,160,-234.59000000000026,153,7,8181.589999999997,7947.0
1939,UF84AE2,160,15631.46,134,26,91570.38,107201.84
1940,UAAB694,160,-11295.26,146,14,57641.04000000001,46345.78
1941,U33C69B,160,-814.8100000000006,151,9,35379.69000000002,34564.88
1942,U8B835E,160,659.6900000000005,148,12,18516.980000000003,19176.67
1943,U6CFD22,160,10233.479999999985,151,9,46431.969999999994,56665.450000000004
1944,U44C245,160,-6001.580000000001,137,23,23025.140000000003,17023.56
1945,U5DCDD7,160,22218.859999999993,128,32,109728.26999999995,131947.13
1946,U4DD1C6,160,72.95999999999731,127,33,452460.1599999996,452533.11999999994
1947,UE9DAA9,160,18660.060000000023,131,29,467720.32999999996,486380.38999999996
1948,U5CCCCA,160,-672.29,140,20,24867.0,24194.71
1949,UF8250B,160,-52799.78999999998,124,36,453138.52999999997,400338.74
1950,U60F8C6,160,3442.6499999999796,115,45,964601.0200000001,968043.67
1951,U7F19B6,160,-4300.049999999999,151,9,10809.320000000002,6509.2699999999995
1952,UFF7E9E,160,-11245.56,123,37,261264.3899999999,250018.83
1953,U4270D6,160,-397.04000000000053,143,17,4552.44,4155.400000000002
1954,U6A5013,160,2.599999999999909,100,60,3920.92,3923.52
1955,U33B08D,159,-22350.23000000001,126,33,364252.0799999999,341901.85
1956,U608712,159,-11517.179999999993,100,59,194177.93,182660.75
1957,UDBDE62,159,165.6699999999988,113,46,24569.43000000001,24735.100000000002
1958,U01ED97,159,-123.49000000000916,145,14,120863.81000000001,120740.31999999999
1959,UFE790D,159,-12.580000000003196,92,67,38820.099999999984,38807.51999999999
1960,UAC1777,159,8315.979999999998,142,17,168961.09000000003,177277.07
1961,U9690D5,159,-5967.68,101,58,26827.66,20859.980000000003
1962,U9922B4,159,-35621.94000000001,156,3,53785.920000000006,18163.98
1963,UF89342,159,3168.0000000000005,153,6,8610.129999999997,11778.13
1964,UB17F5A,159,-157.26000000000147,132,27,36711.59999999999,36554.34
1965,U02A7D0,159,120.30000000000004,115,44,6073.560000000003,6193.8600000000015
1966,UF3E3A7,159,30436.180000000044,105,54,527764.3200000001,558200.5
1967,U146227,159,1147.1799999999978,150,9,8588.939999999999,9736.12
1968,U6ABB9A,159,9049.9,139,20,14540.699999999993,23590.6
1969,U5C0EB7,159,6466.539999999993,137,22,104258.42000000001,110724.95999999999
1970,U4E7EEF,159,20434.230000000014,140,19,70223.39000000001,90657.62
1971,U8DA7FE,159,-1742.4599999999955,153,6,13789.539999999997,12047.08
1972,UADEAC9,159,13028.400000000003,143,16,45414.38000000002,58442.78
1973,UD65A9C,159,-157.28000000000088,123,36,28592.869999999995,28435.590000000004
1974,U69AAAD,159,-967.0400000000039,143,16,67237.6,66270.56
1975,U596CB2,159,-34638.29,114,45,394917.34,360279.05
1976,UC4AA33,159,-11979.259999999993,139,20,25210.619999999988,13231.359999999999
1977,UBFD7E6,158,-539.8099999999991,153,5,15378.750000000002,14838.939999999999
1978,UF4DFB2,158,-582.8200000000002,149,9,5699.830000000001,5117.009999999999
1979,U2572DA,158,-34573.21999999998,136,22,138722.86999999997,104149.65
1980,UDCCEB8,158,-3604.1700000000005,153,5,6673.119999999995,3068.95
1981,UE32F51,158,175.84000000000106,142,16,58872.24,59048.08
1982,U08F519,158,-8013.390000000005,130,28,91823.61,83810.21999999999
1983,U807D2A,158,-103192.74000000006,140,18,674310.67,571117.9300000002
1984,U9E2040,158,1147.9399999999978,144,14,41203.31999999998,42351.26000000001
1985,U449ED9,158,-1213.260000000002,119,39,40164.060000000005,38950.8
1986,U6D182E,158,1803.0199999999968,120,38,110754.16999999997,112557.18999999999
1987,U07CAB3,158,-2104.4500000000007,143,15,22654.410000000003,20549.960000000003
1988,UC9DFC6,158,4206.90999999972,75,83,1438332.1500000001,1442539.0599999998
1989,UE3F8EB,158,-15889.770000000004,128,30,146401.08999999997,130511.31999999998
1990,U260A10,158,-20581.240000000016,143,15,118270.01999999999,97688.78
1991,U8FFAD8,158,-28988.890000000036,114,44,926632.78,897643.8899999999
1992,U5D6C31,158,1244.9899999999982,130,28,145733.3999999999,146978.38999999998
1993,UC52FA8,158,2878.9900000000016,149,9,40008.520000000004,42887.51
1994,U4AA873,158,-9874.730000000009,132,26,87599.47,77724.73999999998
1995,U66F59D,158,-2094.470000000001,156,2,10023.58,7929.11
1996,UB789F3,158,379274.8100000002,128,30,1947485.7199999995,2326760.53
1997,UE38FF1,157,8199.32000000001,118,39,49339.960000000014,57539.28
1998,U2D7DA0,157,-6053.189999999998,116,41,20586.86999999999,14533.68
1999,U86CC2B,157,1639.8299999999945,141,16,62215.320000000036,63855.15
2000,UBE1AAE,157,-3972.109999999992,130,27,230907.54999999996,226935.44
2001,U5C7F70,157,28.100000000033837,125,32,163912.6699999999,163940.77
2002,UFC93C5,157,-14948.439999999999,148,9,48289.68000000004,33341.24
2003,U6D767A,157,-34660.26999999999,130,27,796223.0599999999,761562.7899999999
2004,U9CEB9C,157,-9041.270000000013,144,13,323547.4100000001,314506.14
2005,U959FA4,157,-5059.90000000001,116,41,186966.49999999994,181906.6
2006,U1C7A06,157,-456.2100000000006,136,21,8379.130000000001,7922.919999999999
2007,U096A17,157,-5369.719999999983,136,21,111409.41999999998,106039.69999999998
2008,U90160C,157,842.1200000000049,132,25,82042.10999999999,82884.23
2009,UEF24D6,157,-941.8999999999993,153,4,5020.500000000003,4078.6
2010,U464611,157,-20926.970000000005,99,58,260304.87000000002,239377.90000000002
2011,UBF2F52,157,-10655.220000000016,153,4,27539.220000000012,16884.0
2012,U4C575B,157,-7559.789999999997,133,24,83713.38,76153.59
2013,U84A8D0,157,3.6900000000030104,86,71,34342.57,34346.259999999995
2014,U4B7D29,157,-42825.09000000002,145,12,78505.48000000003,35680.39
2015,U86A603,157,-5424.420000000001,138,19,53967.04000000002,48542.62
2016,U117D91,157,-6967.349999999999,148,9,22680.670000000002,15713.320000000003
2017,U304AAF,156,-46183.179999999986,143,13,164135.39999999997,117952.22
2018,U4401C2,156,7577.400000000002,104,52,233413.18000000002,240990.57999999996
2019,U361DE1,156,-3297.139999999998,137,19,30128.609999999997,26831.47
2020,U7392E6,156,44327.790000000045,126,30,685682.4800000001,730010.2699999999
2021,UC720D4,156,-2530.149999999994,125,31,169088.45,166558.3
2022,U7AC16B,156,-9403.54,150,6,33301.44000000001,23897.899999999998
2023,UE5EA78,156,1324.5400000000777,110,46,1853801.090000001,1855125.63
2024,UBFFF5B,156,867.3299999999981,64,92,191642.0,192509.32999999993
2025,U1938A9,156,-1764.91,147,9,5448.539999999997,3683.6299999999997
2026,UD6BB55,156,-17110.450000000015,120,36,76194.40999999997,59083.95999999998
2027,UF406FE,156,-238.71999999999932,127,29,4943.620000000005,4704.900000000001
2028,UE4448E,156,792.8800000000001,148,8,3403.810000000001,4196.6900000000005
2029,U24E08A,156,-1546.4400000000035,122,34,41208.719999999994,39662.28
2030,U64113D,156,-1364.280000000003,134,22,115468.78,114104.5
2031,U941E06,156,911.8399999999992,129,27,93991.98,94903.82000000002
2032,U8BEDE2,156,-8051.449999999984,132,24,213083.13,205031.68000000002
2033,UFED0FB,156,-4658.910000000007,124,32,158469.41999999987,153810.51
2034,U6DD1D1,156,-337.73999999999904,148,8,12573.28,12235.54
2035,U54CD87,156,-96453.60000000003,120,36,835309.43,738855.8300000001
2036,U6E7A27,156,0.029999999999503757,91,65,4225.069999999999,4225.099999999999
2037,U352744,156,-10794.37,132,24,74067.27000000002,63272.90000000001
2038,UDF4740,156,-6840.909999999995,104,52,145002.42999999996,138161.51999999996
2039,U30634A,156,-931.1599999999966,152,4,29651.679999999997,28720.52
2040,U627AC0,155,2105.5499999999993,132,23,32618.19,34723.74
2041,U9001C3,155,45613.82999999997,139,16,86101.01000000001,131714.84000000003
2042,UF97090,155,475.64999999999964,138,17,18591.23,19066.88
2043,UB53C59,155,-14784.499999999998,96,59,74784.50000000001,60000.0
2044,U863D0A,155,-110.32000000000068,136,19,9753.499999999998,9643.179999999998
2045,UC282A7,155,11346.919999999991,97,58,570546.4400000003,581893.3599999996
2046,U72297F,155,17444.740000000027,83,72,1043967.45,1061412.19
2047,U231AEF,155,690.2999999999975,131,24,39735.08,40425.37999999999
2048,UBD7392,155,20302.609999999997,103,52,277147.93000000005,297450.54000000004
2049,UA41A02,155,-3303.870000000028,117,38,248154.10999999996,244850.23999999996
2050,U0CCE96,155,87048.29000000001,140,15,139167.75000000003,226216.03999999998
2051,U88CE4C,155,-2819.41999999994,73,82,956406.2500000001,953586.8300000001
2052,U804E86,155,12.440000000002101,139,16,21286.249999999996,21298.690000000002
2053,UEFA2B5,155,26520.279999999977,130,25,54220.27000000001,80740.55
2054,U5D699D,155,-2803.5399999999977,112,43,30860.490000000005,28056.95
2055,UD2CAE5,155,1455.5999999999985,133,22,38911.090000000004,40366.69
2056,UF3C419,155,7997.709999999999,138,17,46073.97,54071.68
2057,U5786C9,155,-542.9599999999999,150,5,5644.260000000001,5101.3
2058,U07AEA1,155,-438.7700000000005,147,8,12614.179999999995,12175.41
2059,U936577,155,21122.719999999994,140,15,15248.789999999997,36371.509999999995
2060,U9A747C,155,-22808.170000000042,103,52,3214320.02,3191511.85
2061,UBF0839,155,-1481.870000000004,99,56,560574.2400000001,559092.3700000001
2062,U6131D0,155,14558.609999999993,115,40,179532.2,194090.81
2063,U3BF261,154,-15765.049999999997,142,12,84813.60000000005,69048.55
2064,U526BFC,154,388.3299999999437,97,57,430813.11999999994,431201.44999999995
2065,UB0004F,154,118.61999999999989,147,7,9703.54,9822.16
2066,U8B9B33,154,3668.039999999999,132,22,19953.279999999904,23621.32
2067,UCCE606,154,3913.5800000000004,138,16,12588.399999999996,16501.98
2068,U0476D0,154,-6621.1200000000035,140,14,92242.27,85621.15000000001
2069,U4F404F,154,218.7399999999986,144,10,10119.76,10338.5
2070,UCA0D25,154,2678.5700000000156,100,54,418471.6000000001,421150.17
2071,UEC8520,154,-71.66000000000045,143,11,15748.39,15676.729999999998
2072,UF1BCC3,154,-7562.649999999996,143,11,40469.89,32907.24
2073,UF474A8,154,47869.71999999994,102,52,1812214.6400000001,1860084.36
2074,U02E456,154,10037.35000000001,125,29,152659.78999999998,162697.14
2075,UE56243,154,-86725.13000000003,121,33,656617.0799999998,569891.95
2076,UED9046,154,-18851.37000000001,132,22,51261.09,32409.720000000005
2077,UABED15,154,14394.690000000002,145,9,120913.96999999999,135308.66
2078,UBC739B,154,60.04000000000178,120,34,66226.45,66286.49000000002
2079,U987E22,154,283.12999999999784,134,20,12136.380000000001,12419.51
2080,U56C4FA,154,90.03999999999883,128,26,36716.75000000001,36806.78999999999
2081,U0E3D4E,154,-11419.930000000004,132,22,186054.41,174634.48
2082,UAFC07A,154,-2845.6899999999955,143,11,26994.210000000003,24148.519999999997
2083,U6D2D4E,153,-5050.600000000001,149,4,8981.63,3931.0299999999997
2084,U2C3C8C,153,-20181.82,146,7,33576.23,13394.41
2085,UC65DDB,153,-291.43000000000086,127,26,48687.35000000001,48395.920000000006
2086,U8A350A,153,-24791.74999999994,102,51,2595872.4600000004,2571080.71
2087,UF5DFE0,153,-55.4800000000037,90,63,94800.64000000001,94745.16
2088,UDBE161,153,-180.6400000000001,136,17,21143.72,20963.08
2089,U82F941,153,155.5799999999872,132,21,268216.27,268371.85
2090,U175A4F,153,-13387.179999999993,144,9,25424.35,12037.17
2091,U45CAB5,153,-2649.16,143,10,65235.930000000015,62586.770000000004
2092,U688646,153,-786948.4500000002,127,26,1444417.62,657469.1699999999
2093,U135DA3,153,-2425.9400000000005,149,4,7114.250000000001,4688.3099999999995
2094,U67E136,153,-2880.9500000000025,121,32,73271.07,70390.12000000001
2095,U9C5CCF,153,-40648.67999999999,126,27,248753.97,208105.29
2096,UFFF6BB,153,-13967.190000000002,82,71,47756.75000000011,33789.55999999996
2097,U0108BA,153,-2921.0800000000054,134,19,51092.27999999999,48171.2
2098,U44A322,153,107352.28000000001,129,24,169490.92,276843.2
2099,U355073,153,31307.660000000014,108,45,462506.76,493814.42000000004
2100,U00E136,153,-14899.249999999996,134,19,47402.93000000002,32503.68
2101,U460CDB,153,209.1400000000007,106,47,150511.01,150720.15
2102,UD5B886,153,-46770.459999999985,132,21,73871.20999999999,27100.75
2103,UBC7DBA,153,-4165.6300000000065,141,12,70358.47000000002,66192.84
2104,U13ED07,153,6760.539999999997,139,14,32062.789999999997,38823.33
2105,U8A055E,153,-8495.979999999998,131,22,144155.88999999998,135659.90999999997
2106,UE5D218,153,10821.770000000077,117,36,820996.59,831818.36
2107,UC67417,153,1031.3099999999995,131,22,16072.759999999997,17104.07
2108,U32C128,152,-556.809999999995,106,46,372748.64,372191.8300000001
2109,U084A85,152,700.0100000000093,130,22,178943.28,179643.28999999992
2110,UF216B7,152,-1370.78000000001,137,15,80323.10999999999,78952.33
2111,UF6620A,152,5208.369999999999,93,59,37860.33,43068.7
2112,U891A03,152,-3574.949999999999,98,54,73900.05000000002,70325.1
2113,U54F6CE,152,-5806.52,148,4,18880.279999999995,13073.759999999998
2114,U579F3A,152,-75969.96999999993,138,14,248874.09,172904.12
2115,UFD872F,152,-789.8700000000017,149,3,6106.750000000002,5316.88
2116,U3D4AB9,152,1192.1999999999982,143,9,5448.530000000001,6640.73
2117,U3755E8,152,-5934.159999999996,118,34,262061.26999999993,256127.11
2118,U22C87A,152,-34697.55,132,20,162645.65999999986,127948.11
2119,UB47AB1,152,1032.5900000000001,142,10,21139.94,22172.53
2120,UE3B6CF,152,811.609999999999,143,9,10681.539999999999,11493.15
2121,U37BE2F,152,-5604324.38,128,24,10607855.49,5003531.11
2122,UE8D507,152,16498.499999999996,148,4,9320.609999999997,25819.11
2123,UA670DB,152,-234.01000000000136,139,13,20155.699999999997,19921.69
2124,UFD9925,152,-28649.680000000033,141,11,67521.21000000005,38871.530000000006
2125,U4A05C6,152,-499.0000000000009,96,56,67646.07,67147.06999999999
2126,U9D40B3,152,-509.5900000000029,124,28,81329.95999999998,80820.37
2127,U7CF60A,152,4207.589999999997,93,59,120899.1,125106.68999999999
2128,UD73F82,152,-404.72000000000133,139,13,9405.499999999998,9000.779999999999
2129,UFA6A70,152,-54301.84,130,22,70918.82,16616.98
2130,UAA163D,152,423.1699999999998,144,8,7514.33,7937.5
2131,U2A4EA5,152,106300.93999999997,70,82,415254.34,521555.2800000001
2132,UD07A12,151,458.9200000000019,139,12,45065.79,45524.71
2133,U9FA05F,151,2758.26,142,9,7238.04,9996.300000000001
2134,U977D29,151,-1501313.2400000002,114,37,2299034.6799999997,797721.44
2135,UC0095A,151,132.26000000000022,131,20,19691.499999999996,19823.760000000006
2136,U185553,151,3968.3999999999996,114,37,67132.98,71101.37999999999
2137,UA6DAFD,151,-116530.90000000005,136,15,178116.34999999998,61585.45
2138,UCA0CBF,151,-22521.82,144,7,2029087.19,2006565.3699999999
2139,UCB4D77,151,21473.97,97,54,122579.87999999998,144053.84999999998
2140,U98A871,151,2111.5999999999995,121,30,12600.539999999997,14712.140000000001
2141,UA689DD,151,36060.37000000001,141,10,98056.42000000003,134116.79
2142,U4697C3,151,681.7199999999999,139,12,17430.48,18112.2
2143,U6928AA,151,-2492.5400000000013,103,48,19276.590000000004,16784.049999999996
2144,UAEA9E8,151,-905.9900000000006,136,15,13617.619999999999,12711.630000000001
2145,UC05687,151,3185.620000000001,148,3,9375.97,12561.59
2146,U4F3A9F,151,1602.7200000000034,146,5,58929.739999999976,60532.46000000001
2147,UDE631F,151,-2116.240000000002,139,12,10675.840000000002,8559.6
2148,UE3F758,151,-60739.720000000016,141,10,97186.12,36446.399999999994
2149,UDDD5D5,151,307.90999999998166,99,52,273543.38,273851.29
2150,U092C72,151,28057.30999999999,142,9,340821.89,368879.2
2151,UD1284C,151,43995.240000000005,111,40,132268.0,176263.24
2152,UD6936A,151,-2864.8900000000003,136,15,10104.589999999998,7239.7
2153,UB991D9,151,-2082.220000000001,133,18,24813.820000000007,22731.6
2154,UDA796C,150,-99.22999999999418,123,27,216148.2700000001,216049.04
2155,UB9F887,150,889421.18,22,128,48289.6,937710.78
2156,U1D7B14,150,-3566.6300000000006,143,7,16958.28,13391.650000000001
2157,U709795,150,-6769.499999999998,138,12,50941.130000000005,44171.630000000005
2158,U08E5C7,150,-4095.100000000001,142,8,8159.109999999999,4064.01
2159,U2587BA,150,35980.13999999992,133,17,487817.47000000003,523797.61
2160,U4D44EA,150,-4118.21,144,6,27020.890000000003,22902.679999999997
2161,U8E7432,150,4715.039999999994,136,14,31641.06,36356.1
2162,UF11390,150,-1091.9099999999996,140,10,22169.440000000006,21077.53
2163,U1470F2,150,-5020.269999999995,119,31,109304.26999999997,104284.00000000004
2164,UC6B594,150,2905.609999999999,130,20,14266.559999999998,17172.170000000002
2165,UBA7483,150,-13042.120000000012,129,21,98498.43000000002,85456.31
2166,UE1945B,150,-7326.579999999994,130,20,149068.49999999997,141741.92
2167,UC52ABB,150,-394.19999999999936,136,14,15871.359999999999,15477.16
2168,UFD7ABC,150,31258.430000000015,125,25,220326.50999999998,251584.94
2169,U018AD7,150,-3257.9999999999986,113,37,18670.21,15412.209999999997
2170,U1F572B,150,3732.460000000002,145,5,15412.06,19144.52
2171,UD4B390,150,-131.3199999999997,133,17,4863.76,4732.44
2172,UF8D161,150,-2920.2000000000003,133,17,14402.02,11481.82
2173,U777658,149,-1004.9099999999971,147,2,11621.909999999996,10617.0
2174,UB55AA7,149,-1597.65,144,5,7601.410000000001,6003.76
2175,UA1A458,149,428828.5300000001,106,43,1416422.7800000003,1845251.31
2176,UB33B5C,149,813.5999999999976,137,12,147211.03,148024.63
2177,UCD46FE,149,-8347.000000000004,138,11,19551.139999999996,11204.14
2178,U184AB2,149,4088.8799999999956,121,28,247886.21000000002,251975.09
2179,UE1393D,149,8696.680000000002,139,10,13791.06,22487.74
2180,U19A04A,149,33602.29999999999,136,13,45333.380000000005,78935.68
2181,U302B39,149,42774.37999999998,133,16,385069.0699999999,427843.44999999995
2182,U6DF7C0,149,-760.8799999999956,143,6,33794.969999999994,33034.090000000004
2183,UE25742,149,8600.2,138,11,14804.800000000001,23405.0
2184,U6F7557,149,-95268.84999999992,120,29,406428.06,311159.20999999996
2185,UBA530D,149,-32055.860000000026,139,10,76349.16999999995,44293.31
2186,UEB18DE,149,30989.309999999983,134,15,73948.56999999998,104937.88
2187,UAB5674,149,-1215.6000000000015,114,35,34705.66,33490.06
2188,U230FED,149,5152.659999999987,138,11,418515.75,423668.41000000003
2189,UCAE325,149,790.2700000000004,141,8,13251.700000000003,14041.97
2190,U4DF1D4,149,-110.16000000000047,136,13,4174.820000000001,4064.6600000000008
2191,UF6660A,149,2276.57999999999,97,52,129904.16000000002,132180.74
2192,UC96180,149,-14693.120000000003,138,11,74722.34999999998,60029.23
2193,U7DFABA,149,-3932.58,106,43,292580.20999999996,288647.63
2194,U32D118,149,3723.4900000000007,125,24,19509.919999999995,23233.41
2195,UB353DA,149,62892.600000000006,118,31,218384.08999999994,281276.69
2196,U6636C3,149,168.01999999999111,110,39,169155.0,169323.02000000002
2197,UB82E96,149,-7397.629999999974,66,83,4053606.01,4046208.38
2198,UE223C4,149,-48162.28000000001,137,12,175144.17999999988,126981.9
2199,UFC8EC9,149,-764.160000000008,121,28,65955.46999999988,65191.310000000005
2200,U105026,149,342.61999999999955,129,20,6520.66,6863.280000000001
2201,U9638A3,149,16566.34000000001,81,68,223890.00999999998,240456.35
2202,U9DAD1E,148,-385432.4399999998,130,18,739935.6400000002,354503.20000000007
2203,U16BB0F,148,-1025.0199999999998,128,20,15275.92000000001,14250.9
2204,U048023,148,-11306.450000000044,127,21,332564.31,321257.86000000004
2205,U41D7CF,148,-257.7799999999993,131,17,37142.180000000015,36884.4
2206,UAC71E3,148,37579.73,139,9,41003.26999999998,78583.0
2207,U43DD57,148,17232.840000000007,122,26,27370.86999999999,44603.71000000001
2208,U771670,148,6713.349999999999,138,10,37664.65000000001,44378.0
2209,U031EC4,148,20854.920000000002,103,45,96784.23000000001,117639.14999999998
2210,UF6389D,148,-41075.41,140,8,101888.52999999998,60813.12
2211,U2A96E9,148,-2138.100000000013,133,15,205401.33999999997,203263.24
2212,UE98823,148,260398.26000000007,93,55,3913.629999999999,264311.89
2213,UCE96FD,148,535.8100000000009,116,32,90217.25000000001,90753.06
2214,UDAEBFB,148,675.0699999999995,137,11,30279.629999999997,30954.7
2215,UF23F8B,148,-6475.540000000009,139,9,22237.980000000007,15762.439999999999
2216,U595676,148,-360.9000000000002,143,5,4585.73,4224.83
2217,UB1E3D5,148,-447.6700000000002,145,3,4362.9400000000005,3915.27
2218,UA91DF8,148,-4058.950000000008,117,31,360989.63999999996,356930.69
2219,U060BA1,148,4042.930000000003,129,19,74790.71000000002,78833.64
2220,U5F292F,148,43825.49999999996,137,11,28942.649999999994,72768.15000000001
2221,UF08B20,148,236562.1800000001,128,20,346592.22000000003,583154.3999999999
2222,UE8AF24,148,36782.57000000001,129,19,13368.78,50151.350000000006
2223,UF26E51,148,53264.10000000003,96,52,384316.16000000003,437580.25999999995
2224,UAF1029,148,37112.39000000001,129,19,18407.3,55519.689999999995
2225,U51FD08,148,-5053.78,142,6,17402.089999999997,12348.31
2226,UC75BB6,148,90.20000000000073,131,17,13884.47,13974.669999999998
2227,U1387BE,148,1671.6900000000016,142,6,15302.47,16974.16
2228,U33586C,148,10375.789999999999,134,14,41115.97999999999,51491.77
2229,U18B896,148,-220.41000000000014,134,14,66865.08,66644.67
2230,U814A79,147,-1381.3000000000002,134,13,8741.47,7360.17
2231,UECD4DC,147,-2435.3200000000024,136,11,10033.580000000004,7598.260000000001
2232,U1E28AD,147,3802.469999999999,132,15,9507.0,13309.470000000001
2233,UBA5D38,147,-1448.3799999999997,118,29,27417.89000000001,25969.51
2234,U6B8B97,147,1487.8200000000024,130,17,40522.52000000001,42010.34
2235,U1D3572,147,-30611.42999999982,77,70,11011394.65,10980783.22
2236,U0261F8,147,1267.0400000000081,93,54,1194315.16,1195582.2000000002
2237,U0B1CE9,147,2041.8800000000008,97,50,20118.9,22160.78
2238,U1B3435,147,2568.6700000000023,133,14,35991.950000000004,38560.62
2239,U14E14E,147,8600.270000000002,130,17,22675.96999999999,31276.240000000005
2240,UD0B67A,147,-669.4700000000005,126,21,19404.179999999993,18734.71
2241,UD32818,147,8772.040000000005,118,29,187543.74,196315.78
2242,UFD0311,147,1814.9800000000002,135,12,36076.95000000002,37891.93
2243,UD99081,147,14334.940000000008,75,72,588384.9600000002,602719.9000000001
2244,U364551,147,1634.1700000000005,135,12,9466.220000000001,11100.390000000001
2245,U7EA509,147,597.2200000000076,137,10,42788.7,43385.92
2246,U29F3CC,147,637.240000000001,136,11,10638.009999999995,11275.25
2247,UD350C2,147,1857.380000000005,138,9,29417.539999999997,31274.92
2248,U360782,147,16677.169999999987,121,26,41674.84999999999,58352.020000000004
2249,U746EBC,147,-7638.7099999999955,133,14,104485.29999999999,96846.59
2250,U1150CB,147,15168.100000000002,141,6,18472.809999999998,33640.91
2251,UF33C63,147,-20624.73999999999,90,57,125198.27999999998,104573.54
2252,U2E0600,147,24456.320000000014,98,49,83701.47,108157.79000000002
2253,U175C22,147,-6811.410000000005,122,25,71174.41999999998,64363.01000000001
2254,U421520,146,-2820.63000000001,127,19,75088.63,72268.0
2255,U7851A9,146,-37016.45,101,45,167405.65000000002,130389.2
2256,U1E7E5B,146,1107.7200000000062,104,42,112105.23000000003,113212.94999999998
2257,U4E3BB1,146,37.770000000001346,117,29,21199.729999999996,21237.5
2258,U2EC542,146,2568.080000000001,128,18,69970.70999999999,72538.79000000001
2259,U7BB14C,146,-223811.65999999986,89,57,550156.1599999999,326344.49999999994
2260,UE7195E,146,-60506.589999999946,102,44,995625.02,935118.43
2261,U34B16D,146,148.50999999999968,138,8,5475.77,5624.280000000001
2262,U4F3EEA,146,1052.800000000002,139,7,7619.700000000008,8672.5
2263,UBA8C8C,146,-969.9699999999937,120,26,65577.37000000001,64607.4
2264,U97318C,146,10728.909999999994,113,33,196396.1,207125.01
2265,UD81DD5,146,-427.32000000000323,140,6,30324.050000000003,29896.729999999996
2266,U4DF5F0,146,-1565.2399999999998,141,5,13735.96,12170.720000000001
2267,U477908,146,6196.910000000007,134,12,43280.93999999999,49477.85
2268,UF0189C,146,62177.639999999985,142,4,29843.66,92021.3
2269,UEED3C5,146,-19554.320000000065,123,23,393736.71000000014,374182.38999999996
2270,UAF04B6,146,75767.46999999999,123,23,29616.36,105383.83
2271,U51C6A9,146,-16385.94000000001,110,36,191279.65999999992,174893.72
2272,UD00950,146,-3272.2299999999886,130,16,233653.26000000004,230381.02999999997
2273,U5BD474,146,-49550.18000000001,113,33,203235.36999999997,153685.18999999997
2274,U2F0742,146,49309.239999999976,115,31,222015.71999999997,271324.96
2275,UBEC21D,146,-66032.31999999999,84,62,121690.35999999999,55658.04
2276,U13A7D4,145,12043.930000000011,143,2,31997.349999999988,44041.28
2277,U926A0C,145,2639.0699999999997,110,35,33826.950000000004,36466.020000000004
2278,U1D22F8,145,-26088.550000000003,132,13,53737.98000000002,27649.43
2279,U3771C9,145,29260.88,138,7,16265.17,45526.049999999996
2280,U140CD4,145,-336558.4800000001,98,47,2355765.0300000007,2019206.55
2281,UFF07A9,145,-1008.19,142,3,2498.86,1490.67
2282,UF4899E,145,-3457.6900000000005,142,3,10127.11,6669.42
2283,U3D4643,145,5454.340000000001,137,8,26298.28,31752.62
2284,UD71B68,145,15466.84000000001,81,64,122553.8,138020.64
2285,UE8E717,145,-80.28999999999951,109,36,136705.59,136625.3
2286,U035D2C,145,-10324.309999999998,77,68,78004.62,67680.31000000001
2287,UC185AC,145,16442.83,140,5,57061.25,73504.08
2288,U1E5D26,145,-40321.48,118,27,244327.04000000004,204005.55999999997
2289,UC0ADF0,145,-66831.26000000001,136,9,136825.81,69994.55
2290,U98F734,145,-1085.100000000001,87,58,42437.869999999995,41352.77
2291,U5A16F2,145,-38864.75000000002,122,23,180080.6,141215.84999999998
2292,U32D8AC,145,-17805.020000000004,134,11,32591.49000000001,14786.470000000001
2293,U946296,145,22672.120000000003,97,48,176228.39000000004,198900.51
2294,UD6240C,145,16144.66,134,11,56348.84,72493.5
2295,UE1CFC2,145,-8780.66000000001,128,17,493523.3299999997,484742.67000000004
2296,U1B3CC1,145,180273.30999999997,120,25,592354.54,772627.8500000001
2297,UD555F6,145,-35414.87,123,22,115621.68,80206.81
2298,UF181C2,145,9.610000000002096,73,72,28722.8,28732.409999999996
2299,UE0A1A4,144,-9248.059999999998,102,42,83378.06999999995,74130.01
2300,UF96B9F,144,-1073.6400000000015,124,20,26371.059999999998,25297.420000000002
2301,U1E3BE8,144,1015.020000000004,118,26,105984.42,106999.43999999999
2302,UA9E62E,144,-18674.679999999993,130,14,62373.37,43698.689999999995
2303,U811168,144,-1050.7099999999998,134,10,25467.319999999996,24416.61
2304,U9C5442,144,-45.62999999999934,123,21,14247.699999999997,14202.070000000002
2305,U32A36E,144,-587.3500000000013,139,5,8260.399999999998,7673.049999999999
2306,U01B111,144,-323.21000000000106,140,4,7759.299999999999,7436.09
2307,UA91FF6,144,2844.4200000000055,140,4,53233.71,56078.13
2308,UBA2D72,144,1727.28,137,7,5181.41,6908.6900000000005
2309,U77EB7F,144,696.8899999999982,127,17,21836.03,22532.92
2310,U819AEF,144,-38709.31000000003,103,41,370502.8000000001,331793.49
2311,U624421,144,-13522.710000000006,105,39,364353.6699999999,350830.96
2312,U41AC13,144,-7849.300000000003,137,7,7940.310000000003,91.01
2313,UE118C4,144,-6085.249999999999,136,8,23811.889999999996,17726.64
2314,UD5EF14,144,-570.9400000000003,136,8,8696.859999999997,8125.92
2315,U716DDD,144,2575.0599999999986,141,3,16936.549999999992,19511.61
2316,U8DC0A2,144,481488.2299999999,120,24,513445.33,994933.56
2317,U17A7EC,144,6142.470000000003,130,14,145281.5899999999,151424.06
2318,UF8A9FA,144,-952.6400000000007,139,5,9688.299999999994,8735.66
2319,UC2F2A6,144,-7989.07999999998,131,13,657625.0900000003,649636.01
2320,U8DC2D7,144,-136.69000000000003,107,37,7590.179999999999,7453.489999999999
2321,U3988CD,144,1067.37,112,32,4627.010000000001,5694.380000000001
2322,U9C5D81,144,-21865.059999999998,124,20,25168.86,3303.8
2323,UB59472,144,-6535.590000000011,141,3,69426.44,62890.85
2324,U37C1DD,144,-5215.5300000000025,119,25,67987.96,62772.43
2325,U592FD5,144,-5986.83,139,5,7543.840000000001,1557.01
2326,U6773E4,144,208897.21000000005,126,18,64633.93,273531.14
2327,UD7FE94,144,-218522.81,112,32,596006.5300000001,377483.72000000003
2328,UDF9017,144,-200820.82999999984,113,31,2971606.509999999,2770785.68
2329,UE506B0,144,649.0500000000002,136,8,5623.750000000001,6272.8
2330,U92F677,143,-1335.100000000004,120,23,64907.030000000006,63571.93
2331,U0609E0,143,444.74000000000024,138,5,5277.460000000002,5722.200000000001
2332,UF5112A,143,245.35000000000218,121,22,86522.49000000002,86767.84
2333,U7A7C9B,143,212251.85999999917,109,34,15214286.69,15426538.55
2334,U8075DE,143,668.7600000000001,139,4,12057.929999999997,12726.689999999999
2335,UA2DEA0,143,7013.479999999996,88,55,243510.97999999998,250524.46000000002
2336,U840563,143,8908.830000000002,108,35,278561.04,287469.86999999994
2337,UD5918B,143,-3190.179999999998,135,8,37760.93000000004,34570.75
2338,U4CA026,143,20458.21999999999,134,9,55480.149999999994,75938.37
2339,UE0E8DE,143,5565.220000000001,136,7,22995.800000000003,28561.02
2340,U6252F0,143,3028.899999999997,126,17,20001.429999999997,23030.33
2341,U66837C,143,2755.2199999999993,138,5,10834.580000000002,13589.8
2342,U1E6E9D,143,-6183.409999999995,122,21,94488.38999999998,88304.98
2343,U3863A4,143,-1679.8600000000029,138,5,11854.679999999995,10174.82
2344,UEB6148,143,81.69000000000074,89,54,27310.6,27392.29
2345,UB388CC,143,191.04999999999984,84,59,19649.440000000002,19840.490000000005
2346,UA1B44D,143,-8219.449999999999,136,7,32142.66,23923.21
2347,U5E225B,143,44898.62000000026,102,41,11192135.48,11237034.1
2348,U3159EB,143,4431.080000000002,124,19,153845.62,158276.7
2349,UF272BA,143,-11334.169999999993,128,15,96647.20000000007,85313.03000000001
2350,UE4E956,143,5423.330000000009,132,11,141086.95,146510.28000000003
2351,UD55DBA,142,-9595.679999999993,115,27,290976.32999999996,281380.65
2352,U10156B,142,-4445.919999999998,116,26,188565.36999999997,184119.45
2353,U473A0C,142,-1864.9299999999996,138,4,6656.889999999998,4791.96
2354,U719BF3,142,772.9500000000005,84,58,113315.83000000002,114088.77999999998
2355,U580A15,142,-3785.109999999986,118,24,354974.88,351189.76999999996
2356,U094A5E,142,-56073.77000000002,108,34,183204.91999999998,127131.15000000001
2357,U36C097,142,-869.7500000000014,122,20,6849.709999999997,5979.959999999998
2358,U58CFF6,142,-12318.669999999998,122,20,169242.88,156924.21
2359,U0B75F4,142,-0.4100000000003803,104,38,25551.02,25550.61
2360,U55D26B,142,-17044.019999999993,134,8,42814.060000000005,25770.04
2361,U7335C0,142,19266.44999999999,107,35,94675.03000000001,113941.48
2362,U79CB14,142,330.8300000000163,90,52,701573.24,701904.0700000001
2363,U1B7467,142,-34127.729999999996,133,9,52371.979999999996,18244.25
2364,U656794,142,-3489.609999999936,95,47,1145832.23,1142342.62
2365,U565A66,142,936.2200000000037,79,63,68723.22000000002,69659.44
2366,U3B8A8B,142,1223.0500000000004,124,18,12949.76,14172.810000000001
2367,U9ABDE1,142,11103.740000000005,127,15,139683.64,150787.38
2368,U4F8866,142,-17367.49000000002,122,20,102347.75000000004,84980.26
2369,UEE389F,142,4556.110000000001,129,13,13991.619999999997,18547.73
2370,U753AD3,142,-1997.8600000000015,128,14,24330.439999999995,22332.58
2371,U222C8D,142,15892.550000000007,124,18,193857.61000000002,209750.16
2372,UB6FD4B,142,-593.8200000000002,136,6,6332.919999999997,5739.1
2373,UE1E8D8,142,-2336.6399999999717,121,21,204718.59,202381.95
2374,UF64927,142,-1442.1199999999994,114,28,21368.549999999996,19926.430000000004
2375,UFEDD74,142,599.109999999995,123,19,76021.03,76620.14
2376,U5D4C5A,142,276.3599999999983,74,68,98271.10999999999,98547.47
2377,U5055B2,142,-23.899999999997817,118,24,39070.659999999996,39046.759999999995
2378,U086E93,142,-8451.340000000002,139,3,9475.400000000001,1024.06
2379,U6EFA84,142,-762.0300000000004,132,10,45292.71000000001,44530.68000000001
2380,U4A8598,142,-6744.840000000004,115,27,37240.36000000001,30495.52
2381,U3174FB,142,10995.960000000001,113,29,32983.490000000005,43979.45
2382,U83FBF3,142,80.91000000000366,108,34,48746.760000000046,48827.670000000006
2383,U782C89,142,-921.9600000000082,89,53,94209.14999999998,93287.18999999999
2384,UE05F63,142,-2364.820000000001,127,15,8170.859999999999,5806.040000000001
2385,U4D0449,142,8220.349999999997,128,14,99591.68000000001,107812.03
2386,UE273D9,142,76916.11999999998,98,44,423143.37000000005,500059.49000000005
2387,UE87850,141,148.11,117,24,21457.749999999993,21605.86
2388,U82CBBA,141,-4387.649999999997,125,16,77070.48,72682.83000000002
2389,UB0A933,141,-2244.7499999999322,114,27,129055.66,126810.90999999999
2390,U9F04DA,141,2774.4999999999977,134,7,9804.61,12579.11
2391,UD1A198,141,-27670.010000000002,81,60,88765.23999999999,61095.23
2392,U4CE7B7,141,-33814.92000000002,126,15,130884.79999999993,97069.88
2393,U1BD54F,141,-23298.89999999999,122,19,57472.37000000002,34173.47000000001
2394,UF04A87,141,1553.2200000000105,109,32,274104.5600000001,275657.78
2395,UE27C72,141,-31462.6,117,24,237690.88999999998,206228.28999999998
2396,UC6E0CB,141,4931.62,127,14,9508.350000000002,14439.970000000001
2397,U0749E0,141,-6878.540000000001,118,23,34012.83,27134.29
2398,U19D616,141,1140.7399999999934,98,43,71520.78,72661.52
2399,U673C54,141,41.070000000000064,112,29,22614.420000000002,22655.49
2400,UFB01AD,141,3799.970000000005,129,12,41615.830000000016,45415.799999999996
2401,U7EA53F,141,-6596.560000000003,123,18,111330.73,104734.17
2402,U1A1A88,141,-8842.73,134,7,27407.4,18564.67
2403,UE2A26D,141,1280.2200000000018,132,9,14371.68,15651.9
2404,UAF1382,141,-182.50999999998749,102,39,62792.43999999999,62609.92999999999
2405,U9F7209,141,-1021.7699999999995,103,38,29440.760000000002,28418.989999999998
2406,U13C968,141,-5733.13000000001,126,15,26165.260000000002,20432.13
2407,UC475EC,141,804.5200000000259,80,61,285808.5800000001,286613.1
2408,UC95067,141,318.2099999999998,138,3,7231.1,7549.3099999999995
2409,UF022DC,140,-3618.6900000000005,124,16,35605.48999999999,31986.800000000003
2410,U250FEC,140,1162.1799999999937,129,11,62618.06000000002,63780.240000000005
2411,UFCDE5B,140,1063.8300000000015,118,22,53283.10000000001,54346.92999999999
2412,U2AB090,140,132.13999999999922,130,10,10151.169999999993,10283.310000000001
2413,U3B1660,140,-5925.530000000001,88,52,250682.52,244756.99000000002
2414,U3C5A85,140,1.239999999999668,80,60,5337.5,5338.74
2415,UACACB0,140,-8464.39,135,5,14102.269999999999,5637.88
2416,UCB130C,140,-33216.12000000004,102,38,181257.81000000003,148041.69000000003
2417,UDB4A43,140,5163.020000000033,130,10,188539.16999999995,193702.19
2418,UE0A320,140,-5784.440000000002,123,17,55641.58,49857.14
2419,U890F11,140,-5591.240000000014,126,14,31340.930000000004,25749.690000000002
2420,U48A29B,140,3423.589999999999,124,16,22813.89,26237.48
2421,UBAD9D0,140,1868.2399999999964,134,6,9825.610000000002,11693.85
2422,UB2F098,140,-257.2200000000008,123,17,17014.94,16757.72
2423,U4C489A,140,-29422.170000000002,126,14,51436.43000000001,22014.26
2424,U8DAC43,140,10416.439999999995,132,8,38867.11,49283.55
2425,U3513AA,140,-232.57999999999498,97,43,224807.48000000007,224574.9
2426,U023AA7,140,-9010.929999999998,95,45,77692.21000000002,68681.28
2427,U668F46,140,123.32999999999993,130,10,12265.939999999997,12389.27
2428,UF2A946,140,-21586.239999999998,129,11,82285.73999999999,60699.5
2429,U5180D3,140,995.7600000000122,98,42,125570.60999999988,126566.37000000001
2430,UA62460,140,-640.0299999999952,120,20,81808.48000000001,81168.45
2431,U86F3EC,140,195.78000000000327,127,13,28839.21,29034.99
2432,UC8BB6C,140,12602.900000000005,122,18,45483.61000000004,58086.509999999995
2433,U94C4C4,140,-2284.980000000001,72,68,74705.97999999995,72421.0
2434,UDE3691,140,-8985.050000000001,128,12,37399.53,28414.479999999996
2435,U1E18AB,140,-26205.909999999996,117,23,109050.21000000002,82844.3
2436,U6D808A,140,-11742.370000000214,104,36,9486636.310000002,9474893.94
2437,U06C304,140,-267.33000000000146,128,12,29209.609999999997,28942.280000000002
2438,U9D1D6C,140,4228.099999999997,128,12,19057.37999999999,23285.48
2439,UF4C8B1,140,-4.930000000013024,116,24,258305.40000000002,258300.46999999994
2440,UE927E8,140,-3885.809999999999,132,8,21259.85,17374.039999999997
2441,UA112FD,139,4889.7699999999995,107,32,30433.97,35323.740000000005
2442,U89F49C,139,-4811.650000000003,120,19,15825.750000000002,11014.1
2443,U67629E,139,3175.8599999999997,106,33,26687.24000000001,29863.1
2444,U63CF4B,139,275.18999999999846,133,6,17131.97,17407.16
2445,UC7F614,139,-11628.369999999994,123,16,39505.18,27876.809999999998
2446,U700140,139,30958.440000000002,98,41,120704.28999999998,151662.73000000004
2447,UC7F70D,139,-67.55999999999752,113,26,22467.260000000002,22399.699999999997
2448,U3A597A,139,-58606.600000000006,119,20,119228.72,60622.12
2449,UB4D20D,139,-1504.0900000000001,98,41,200341.4799999999,198837.39
2450,U0722F0,139,11.220000000001628,134,5,14311.799999999994,14323.02
2451,U15F20D,139,-2699.5799999999986,116,23,34818.63,32119.050000000003
2452,UF76279,139,-4335.2999999999965,129,10,23925.81000000001,19590.510000000002
2453,UC00316,139,749.7900000000002,84,55,20345.609999999997,21095.4
2454,UD45FAD,139,2587.8700000000017,116,23,31910.770000000004,34498.64
2455,U084538,139,-34257.02999999999,108,31,373292.07000000007,339035.04
2456,UDD962F,139,118302.31,119,20,183856.99,302159.3
2457,U399599,139,8949.920000000002,116,23,128210.52,137160.44
2458,U5DF086,139,18630.069999999985,104,35,312965.89000000025,331595.96
2459,U7FA9FE,139,-2956.1299999999987,125,14,32595.480000000018,29639.35
2460,U6B9FA3,139,4102.999999999999,123,16,47612.11000000001,51715.11
2461,U484C5C,139,11950.929999999998,132,7,59801.310000000005,71752.23999999999
2462,UDB16DC,139,-14332.729999999996,129,10,37496.060000000005,23163.329999999998
2463,UE355F9,139,-4325.879999999999,120,19,29698.43,25372.55
2464,U6F3256,139,7041.2699999999995,125,14,8882.720000000003,15923.99
2465,UDB8C04,139,-1438.9100000000008,102,37,7853.229999999998,6414.3200000000015
2466,U959E34,139,41716.70999999999,119,20,113179.06999999999,154895.78000000003
2467,UE44CC6,139,13265.479999999987,87,52,219333.81,232599.29
2468,U2EB044,139,-746.7200000000048,105,34,167500.96,166754.23999999996
2469,UCB9333,139,6233.950000000011,104,35,140851.65999999997,147085.61
2470,UB8AC60,139,348.07000000000033,117,22,20933.519999999997,21281.590000000004
2471,UE5C2EF,139,-5329.12,126,13,17924.38,12595.26
2472,U1637BB,139,-5764.280000000001,100,39,126563.62000000002,120799.34000000004
2473,UE5BFEF,138,-1872.4799999999982,135,3,5716.690000000004,3844.21
2474,UA5B39B,138,32735.53000000001,127,11,17840.879999999997,50576.409999999996
2475,U2B6B85,138,1728.489999999998,121,17,58097.37000000001,59825.86
2476,U0A49FF,138,1720.5199999999973,114,24,15785.170000000018,17505.689999999995
2477,U092DDF,138,711.64,130,8,3457.7200000000007,4169.360000000001
2478,U6593C2,138,474.6199999999997,125,13,12836.329999999996,13310.949999999999
2479,U030933,138,-6798.979999999996,124,14,40963.210000000014,34164.229999999996
2480,U696F8A,138,-6010.950000000005,98,40,200281.09,194270.13999999998
2481,UE6AAA0,138,-21361.47999999999,132,6,65436.500000000015,44075.020000000004
2482,U027930,138,-1963.3699999999994,123,15,20251.44,18288.069999999996
2483,UFAC8B1,138,-15033.239999999996,97,41,289218.88999999996,274185.64999999997
2484,UBD3CD0,138,-0.2200000000003648,120,18,10672.12,10671.899999999998
2485,UAA822E,138,-14800.12,109,29,31352.96000000001,16552.839999999997
2486,U632506,138,1333.2399999999984,131,7,16133.960000000001,17467.199999999997
2487,UCC3622,138,-251.349999999999,118,20,21321.010000000002,21069.660000000003
2488,UF395FB,138,-74.68000000000927,115,23,15702.459999999968,15627.78
2489,U2D2625,138,-5400.9400000000005,131,7,17762.760000000002,12361.820000000002
2490,U171EDD,138,-5068.610000000015,127,11,55058.970000000016,49990.36
2491,UF1C26D,138,-672.4100000000008,130,8,5143.119999999999,4470.71
2492,U6A5152,138,-5356.369999999999,134,4,27069.229999999996,21712.86
2493,U40AD4D,138,2167.36,131,7,7464.530000000001,9631.890000000001
2494,UA4243F,138,5904.100000000002,100,38,10477.35,16381.450000000003
2495,UC7D48F,138,1651.8999999999996,134,4,4534.549999999998,6186.45
2496,UE2A469,138,644.7699999999986,120,18,14267.779999999995,14912.550000000001
2497,U59F00A,138,397.0799999999999,82,56,158025.0,158422.08
2498,UE3ABCE,138,-57073.89999999999,128,10,197380.28,140306.38
2499,U9E4318,138,-3510.2299999999996,78,60,109361.60000000003,105851.37000000001
2500,U2CB368,137,-49862.28999999999,86,51,951075.3500000002,901213.06
2501,UC25B7E,137,164.87999999999823,113,24,18760.010000000006,18924.89
2502,UFEEA45,137,-5551.23,119,18,30748.91,25197.68
2503,U7A03F6,137,8106.589999999998,115,22,56540.24999999999,64646.84
2504,UE238AA,137,-17888.21999999992,85,52,1343793.59,1325905.3700000003
2505,U2C5884,137,-68.01999999999998,64,73,81653.68,81585.65999999996
2506,UDFE6DF,137,-2654.570000000001,124,13,31011.010000000002,28356.44
2507,U62E2A8,137,453.5399999999996,120,17,5135.450000000003,5588.99
2508,U8B565A,137,-2469.9599999999987,122,15,19146.260000000002,16676.3
2509,UA5751E,137,-1055.4000000000065,89,48,70610.98000000001,69555.58
2510,U224DAA,137,-31156.820000000014,97,40,277508.99000000005,246352.16999999998
2511,U6DC71D,137,7909.559999999998,73,64,170839.41,178748.97
2512,UBCCB6D,137,-4478.909999999996,122,15,35557.91000000001,31079.0
2513,UC2F777,137,28717.509999999984,118,19,151146.16000000003,179863.66999999998
2514,U337F80,137,-12431.720000000001,110,27,173664.11000000004,161232.39
2515,U566B50,137,-8758.599999999999,118,19,103391.83999999995,94633.24
2516,UE99B67,137,-1184.1100000000008,112,25,27882.78,26698.67
2517,U1AFD32,137,-66.09000000000154,117,20,12052.569999999998,11986.480000000001
2518,U4D99DB,137,235.0699999999997,126,11,6404.949999999999,6640.02
2519,UEC68FC,137,-8751.890000000003,124,13,41207.66000000001,32455.769999999997
2520,U0EEE1F,137,-1789.389999999999,100,37,360330.5899999999,358541.20000000007
2521,UEB069C,137,-33466.880000000005,122,15,80428.31999999998,46961.44000000001
2522,U08538E,137,-1475.0200000000007,123,14,13835.189999999993,12360.17
2523,U5BB34C,137,101599.30999999997,78,59,1312197.7500000005,1413797.06
2524,U21947C,137,11111.410000000002,119,18,20419.15,31530.560000000005
2525,U7C6EBB,137,-13581.51000000001,123,14,413247.82,399666.31
2526,U8FA070,137,-203.24000000000044,118,19,1845.8299999999988,1642.59
2527,U4D9F3D,136,-403.7999999999994,132,4,5111.11,4707.31
2528,U2B4BC5,136,-8914.0,111,25,68907.45999999999,59993.46000000001
2529,UF02FCC,136,1998.8100000000006,73,63,22987.53,24986.34
2530,UDFE67C,136,-2838.4799999999996,119,17,15772.069999999996,12933.59
2531,U90EF7A,136,-11864.419999999995,123,13,35013.25,23148.83
2532,UC772A9,136,-1441.0299999999916,53,83,359784.94999999995,358343.92000000004
2533,U46BDD9,136,190161.74999999997,73,63,553273.9099999999,743435.6600000001
2534,UEA0A8D,136,177.98999999999947,130,6,7720.919999999997,7898.91
2535,U582749,136,-9683.319999999996,109,27,105951.39,96268.07
2536,U2C8DFD,136,-153.07999999999944,133,3,10230.370000000006,10077.29
2537,UD74A44,136,-44776.81999999999,98,38,498124.17,453347.35
2538,UEB000F,136,46440.47999999998,121,15,864767.77,911208.25
2539,UDC077A,136,-1327.2999999999945,63,73,77849.43,76522.12999999998
2540,U0949DF,136,2886.2299999999996,129,7,8538.539999999997,11424.77
2541,UB475FE,136,-3075.2299999999896,90,46,362724.6800000001,359649.4499999999
2542,UA4AF93,136,-1289.0799999999927,81,55,364487.86,363198.7800000001
2543,U94798F,136,-6209.290000000001,125,11,12812.100000000002,6602.8099999999995
2544,UC4999D,136,-79.82000000000018,128,8,11951.399999999998,11871.579999999998
2545,UBD0829,136,-23312.809999999994,125,11,117398.39000000001,94085.58
2546,U309D1D,136,2887.3600000000224,104,32,718886.7099999996,721774.07
2547,U8815F8,136,-238.14000000000027,122,14,3977.5200000000013,3739.38
2548,U9A4D21,135,9.519999999999982,117,18,13466.239999999989,13475.759999999998
2549,U57A4C1,135,-9398.380000000003,131,4,9582.920000000002,184.54
2550,U1B88F0,135,3908.25,123,12,47780.55,51688.8
2551,U1E209D,135,-908.0200000000001,88,47,3551.2000000000003,2643.1800000000003
2552,U2976A4,135,9486.55,110,25,114647.79999999999,124134.35
2553,U1A6A25,135,297.53000000000077,71,64,34712.48999999999,35010.01999999999
2554,U70E7BA,135,-5766.369999999997,80,55,119496.37,113730.0
2555,U20CCD8,135,-11048.489999999983,106,29,301478.4600000001,290429.97
2556,UA52B70,135,-451.1100000000014,103,32,4106.370000000001,3655.2599999999998
2557,U6E1BA6,135,729.929999999993,93,42,961767.25,962497.18
2558,U2CE5C0,135,1027.8700000000003,119,16,11426.1,12453.97
2559,U76ED75,135,-2394.58,127,8,12807.379999999997,10412.8
2560,U636397,135,-989.7299999999999,130,5,6972.65,5982.92
2561,U6673FC,135,20393.58,78,57,134142.11000000002,154535.69
2562,U2072D2,135,-45268.490000000005,131,4,180302.45999999996,135033.97
2563,U44A425,135,8130.52,109,26,14870.400000000003,23000.920000000002
2564,U1BD32F,135,-15943.550000000017,112,23,881845.07,865901.52
2565,U2DBAB9,135,15105.080000000004,113,22,69926.06999999998,85031.15000000001
2566,U1F2148,135,-70.49000000000797,115,20,136419.64,136349.15
2567,U6D7CE5,135,53497.639999999956,83,52,649259.9800000001,702757.62
2568,U3A060B,135,3976.379999999999,124,11,18756.699999999997,22733.08
2569,U13EECA,135,1705.490000000001,97,38,63153.52,64859.01000000001
2570,U3BA8F0,135,-4149.820000000006,87,48,269119.70000000007,264969.87999999995
2571,U0CA57B,135,-1689.6400000000008,132,3,19594.959999999995,17905.32
2572,UDAF0C9,135,-2343.6100000000006,128,7,13072.349999999999,10728.74
2573,U0274DB,135,-21225.400000000005,131,4,138567.02999999994,117341.63
2574,UF52C2F,135,-3419.5499999999865,100,35,404610.0,401190.45000000007
2575,U3777A3,135,-21411.079999999994,105,30,232335.96999999997,210924.88999999998
2576,U9A83C9,134,-12266.019999999999,117,17,53191.420000000006,40925.4
2577,U8F7FAF,134,16.790000000000717,129,5,4083.8199999999997,4100.610000000001
2578,UCC74F6,134,-3981.959999999998,118,16,23946.870000000003,19964.910000000003
2579,U8D3202,134,1471.1099999999858,122,12,97796.18000000005,99267.29000000001
2580,U78EF86,134,1222.590000000001,109,25,24416.97000000001,25639.56
2581,U635EBB,134,5537054.509999998,57,77,15609554.870000001,21146609.380000003
2582,UC0AA1D,134,98356.34000000001,122,12,114239.85999999994,212596.2
2583,UEED1BB,134,-11046.859999999999,81,53,57138.649999999994,46091.79
2584,UD59D23,134,-3565.2300000000027,102,32,109668.90999999997,106103.68000000002
2585,U07FB78,134,12909.519999999997,118,16,96775.38999999998,109684.91
2586,U7554BE,134,867.7500000001019,118,16,1240989.6199999996,1241857.37
2587,UE31027,134,-256.48000000000263,115,19,33204.850000000006,32948.369999999995
2588,U6C3259,134,-35314.52999999999,109,25,166783.17000000004,131468.63999999998
2589,U5788C2,134,9448.469999999994,79,55,148232.94999999995,157681.42
2590,U2E3A35,134,-171.6899999999999,124,10,10785.489999999994,10613.8
2591,U3EC3B6,134,-1080.9400000000003,129,5,6708.25,5627.31
2592,U7E0B68,134,-9435.070000000003,106,28,294933.08999999997,285498.02
2593,UB0A796,134,-10780.219999999998,126,8,30568.57,19788.350000000002
2594,U18CF93,134,4339.75,130,4,8733.750000000007,13073.5
2595,UDCAED7,134,71170.65999999997,113,21,1162013.06,1233183.72
2596,UCE0CAC,134,107644.76999999999,93,41,939700.64,1047345.41
2597,U4EBEA1,134,4170.719999999999,103,31,26065.62,30236.34
2598,U96D961,134,-29344.809999999983,106,28,485843.83999999997,456499.02999999997
2599,UCEBE60,134,9724.300000000005,109,25,142188.49,151912.79
2600,UC973BA,134,4773.49,125,9,11548.389999999998,16321.88
2601,U1E118B,134,-1029.2600000000002,117,17,10141.139999999998,9111.879999999997
2602,U4841AC,134,148.70000000000073,82,52,93377.46,93526.16000000002
2603,U17C94C,134,14453.890000000003,118,16,39625.81000000001,54079.700000000004
2604,UA1466A,134,-301782.25,124,10,427340.82,125558.56999999999
2605,UC5FA80,134,-1556.4700000000018,130,4,18150.089999999997,16593.620000000003
2606,UCFA92D,133,-8542.740000000002,129,4,25394.670000000002,16851.929999999997
2607,U264CC8,133,6837.56,130,3,1450.8000000000002,8288.359999999999
2608,U04409A,133,2.849999999999909,74,59,28713.079999999998,28715.930000000004
2609,U7404C4,133,2105.7399999999925,113,20,132522.02999999997,134627.77
2610,U84D24D,133,12990.46000000001,111,22,81194.02000000005,94184.48000000001
2611,U2F061E,133,-4402.790000000002,119,14,11082.09,6679.3
2612,U56CE28,133,580.1999999999948,91,42,115130.58000000002,115710.77999999997
2613,UD9A9C0,133,-416.49000000000035,118,15,18584.170000000006,18167.68
2614,UEB513E,133,-1425.919999999999,79,54,62842.22,61416.3
2615,U2C835E,133,598.26,124,9,12065.779999999997,12664.04
2616,U780123,133,12398.890000000014,120,13,122266.01,134664.9
2617,U20CCEB,133,-56137.81,108,25,180235.55,124097.74
2618,UF4D06B,133,3071.900000000007,116,17,91684.85999999999,94756.76
2619,UE18DC8,133,-3024.2099999999978,128,5,9420.44,6396.23
2620,U671466,133,14482.609999999939,94,39,447808.14,462290.75
2621,U224819,133,-35.309999999998794,79,54,23767.019999999993,23731.71
2622,U1625BB,133,407.83000000000106,125,8,13306.38,13714.21
2623,U527D23,133,16729.100000000002,124,9,35528.619999999995,52257.719999999994
2624,U5062F6,133,3844.18,127,6,15835.37,19679.55
2625,U356D81,133,-1477.1200000000072,126,7,32697.000000000007,31219.879999999997
2626,UB66917,133,-41091.71,110,23,46767.30999999999,5675.6
2627,U885AE9,133,5.540000000000163,106,27,9669.680000000002,9675.22
2628,UE48AFB,133,-1371.870000000008,38,95,164878.97,163507.09999999998
2629,UCB64E1,133,9832.639999999996,123,10,62418.59000000001,72251.23
2630,UBB77C3,133,384.4199999999999,126,7,8274.439999999997,8658.86
2631,U1195D9,133,-4635.379999999991,114,19,90539.50000000001,85904.12
2632,U8D985B,133,859.1899999999982,92,41,80017.85,80877.04
2633,U47242A,133,22580.110000000015,123,10,155547.09000000003,178127.19999999998
2634,UEB1A50,133,1910.1599999999999,120,13,9760.159999999996,11670.32
2635,U7E8FE9,133,287.73999999995385,121,12,246693.7,246981.43999999997
2636,U877C84,133,-209.64999999999964,122,11,46359.380000000005,46149.73000000001
2637,UB0DE90,133,70568.49000000005,104,29,812109.21,882677.7
2638,UDA3ECC,133,-3108.350000000006,100,33,159987.04,156878.68999999997
2639,UBCBAA6,133,255469.08999999997,117,16,435292.49000000005,690761.5800000001
2640,UCC7606,133,1662.8099999999986,120,13,8554.84,10217.649999999998
2641,U053C28,132,8080.450000000001,119,13,21214.48999999999,29294.940000000002
2642,U52063C,132,-1028895.5899999996,108,24,5341247.13,4312351.54
2643,U439DAD,132,-45032.380000000005,116,16,108663.12999999996,63630.750000000015
2644,UD50D1F,132,-27048.220000000005,114,18,116619.40000000002,89571.18
2645,UE580BD,132,182263.36000000004,76,56,543383.5,725646.8600000001
2646,U2E223F,132,1362.719999999999,124,8,4848.960000000001,6211.68
2647,U523D87,132,1386.0499999999993,87,45,12255.699999999993,13641.750000000004
2648,U9F2A04,132,1633.2600000000018,89,43,187396.9199999999,189030.18
2649,UEBF49F,132,-22299.399999999998,120,12,68191.3,45891.9
2650,UFE34BF,132,-512184.6600000001,99,33,965944.8,453760.14
2651,UF1B6FD,132,-4024.2699999999995,120,12,20454.810000000005,16430.54
2652,UCD3E1B,132,2147.3499999999995,102,30,91914.98,94062.32999999999
2653,UD18EBE,132,-29379.48,122,10,86190.29,56810.81
2654,U6E06DB,132,-4454.450000000017,104,28,68806.52,64352.07
2655,U58DB97,132,37794.44999999998,98,34,487961.73000000004,525756.1799999999
2656,U478AEC,132,4187.1799999999985,122,10,10316.839999999997,14504.02
2657,U8A31A9,132,122.70999999999974,128,4,2494.3000000000006,2617.01
2658,U4F0E4F,132,4249.319999999997,117,15,63599.820000000014,67849.14
2659,U39B1D7,132,2088.1800000000003,122,10,73949.88999999996,76038.07
2660,U385A2E,132,2775.1400000000003,104,28,58726.61000000001,61501.75
2661,U44079A,132,4940.32,115,17,54330.63000000002,59270.950000000004
2662,U030EA7,132,-97757.66999999998,104,28,693924.7999999999,596167.13
2663,UCAB943,132,-28267.95,116,16,71583.07,43315.12
2664,U976DF2,132,-10613.359999999993,129,3,14467.279999999992,3853.92
2665,UA5D9A4,131,-114056.81999999999,126,5,165794.51,51737.69
2666,U80A40B,131,-3302.66,112,19,34658.08,31355.420000000006
2667,U4FC6C1,131,-1757.8099999999995,78,53,12872.959999999997,11115.15
2668,UE5D1E5,131,-93964.43999999997,112,19,281505.17000000004,187540.72999999995
2669,UE12E40,131,-55781.369999999995,96,35,205507.87,149726.5
2670,UE6BD21,131,11389.43,102,29,65556.94,76946.36999999998
2671,UB57545,131,-2452.2600000000007,99,32,40579.97,38127.71000000001
2672,U44B1A0,131,13306.029999999988,99,32,29773.04999999999,43079.08
2673,U1BC9B5,131,122.15999999999784,108,23,28762.989999999998,28885.15
2674,UAF3CB1,131,-4410.040000000003,112,19,23955.980000000003,19545.94
2675,UC46C58,131,2645.9100000000003,129,2,2788.829999999999,5434.74
2676,U37A4AC,131,-11.68999999999969,98,33,3606.6,3594.91
2677,U67E1DA,131,-282.0900000000047,109,22,47545.530000000006,47263.44
2678,U421AA9,131,3308.0400000000004,83,48,41779.91,45087.95
2679,UDE6EE1,131,3608.0999999999985,103,28,24003.720000000005,27611.820000000003
2680,U2549FA,131,-718.4400000000014,122,9,10602.03,9883.59
2681,U4D443D,131,5250.939999999999,94,37,9193.319999999998,14444.260000000006
2682,U536E4F,131,5829.070000000001,84,47,15542.420000000002,21371.489999999998
2683,UE7FE21,131,-3133.4399999999982,88,43,9590.770000000002,6457.33
2684,UFE218A,131,10489.399999999992,62,69,280771.3,291260.6999999999
2685,U4E1729,131,-394.80999999999966,71,60,50494.48000000001,50099.67
2686,U4E163F,131,9023.820000000002,126,5,5339.4400000000005,14363.26
2687,UC491E0,131,-1067.7,116,15,15837.069999999994,14769.369999999999
2688,UB255CC,131,2500.0600000000004,111,20,20644.35,23144.41
2689,U1924AF,131,329.7099999999964,108,23,80512.99999999999,80842.71
2690,U724E6E,131,2963.689999999997,115,16,73184.44,76148.12999999999
2691,U369027,131,134899.39,115,16,7717.290000000001,142616.68000000002
2692,U7904BD,130,-10138.3,110,20,77660.77,67522.47
2693,U7DE97E,130,142.65000000000157,112,18,36996.42000000002,37139.06999999999
2694,U249ADD,130,477.849999999999,112,18,83263.14000000003,83740.98999999999
2695,UF8F64D,130,9266.23000000001,104,26,43151.02,52417.24999999999
2696,UBBA0BB,130,8043.82,101,29,333735.82,341779.64
2697,UB1E9F3,130,-13325.169999999995,123,7,20717.16,7391.99
2698,U838214,130,13232.750000000002,126,4,6038.200000000001,19270.950000000004
2699,U764CB2,130,44.38999999999902,112,18,11716.049999999996,11760.439999999999
2700,U69AA7C,130,-0.6499999999941792,119,11,76286.8,76286.15
2701,UD35118,130,19458.88000000002,112,18,140228.34,159687.22
2702,U2676BA,130,-113991.82999999996,107,23,1348846.17,1234854.3399999999
2703,UF1FDF3,130,-15362.190000000002,117,13,66256.49999999999,50894.31
2704,U22B015,130,-1647.3100000000002,118,12,10607.42,8960.11
2705,UECC37F,130,662.7999999999987,113,17,6017.65,6680.45
2706,UC65A07,130,3553.519999999997,124,6,34379.43000000002,37932.950000000004
2707,U232021,130,92.37000000000134,112,18,15239.789999999999,15332.16
2708,U7CE332,130,7269.600000000001,117,13,29978.010000000002,37247.61
2709,U401D49,130,-416.3800000000019,87,43,79899.53999999998,79483.15999999999
2710,U804618,130,-1384.4699999999996,121,9,6888.65,5504.18
2711,U00F26F,130,1566.7000000000091,125,5,22708.269999999997,24274.969999999998
2712,UED38FC,130,-177198.75999999998,117,13,239386.87999999998,62188.12
2713,U79BD78,130,-400.07999999999976,114,16,7984.079999999999,7584.0
2714,U70457E,130,3488.769999999995,100,30,38199.04999999999,41687.82
2715,U9C1268,130,-19021.550000000007,106,24,136407.66999999998,117386.12
2716,U57FF36,130,-37014.59000000002,75,55,518429.33,481414.73999999993
2717,U034164,130,3656.859999999999,111,19,23289.14,26945.999999999996
2718,U0BEFC0,130,-1294.1799999999985,114,16,37170.05,35875.87
2719,UE65FBE,130,525.1999999999971,81,49,91338.44000000002,91863.64000000001
2720,U713646,130,6970.410000000036,74,56,865245.0900000001,872215.5000000001
2721,UF6AA4C,130,6559.489999999998,104,26,166884.84,173444.33000000002
2722,U5A2EAB,130,5821.639999999974,112,18,255671.99,261493.63
2723,U7EE2AF,130,11084.65,113,17,46128.66,57213.31
2724,UF2764B,130,1269.0500000000047,111,19,27381.47000000001,28650.52
2725,U5105A9,129,-492.9600000000007,118,11,13351.719999999998,12858.76
2726,UE835D0,129,56100.080000000045,98,31,945601.6500000001,1001701.73
2727,UBC5A54,129,5957.950000000001,97,32,44719.020000000004,50676.969999999994
2728,U8485A8,129,1972.3300000000017,109,20,67439.13,69411.45999999999
2729,UE698D8,129,-2968.67,115,14,44165.56,41196.89
2730,UAEC885,129,-1663.38,101,28,54187.409999999996,52524.03000000001
2731,U2109C6,129,1849.6500000000024,113,16,54667.40000000001,56517.049999999996
2732,UA9B31F,129,-609.8499999999999,125,4,2610.0799999999995,2000.23
2733,U770895,129,53616.25999999999,99,30,129052.96999999997,182669.22999999998
2734,U65709F,129,644.3300000000013,105,24,70706.99999999999,71351.33
2735,U957639,129,-1581.6900000000041,100,29,1191254.4699999995,1189672.78
2736,U478410,129,-20409.909999999996,99,30,157460.13,137050.22
2737,U51119D,129,11938.639999999998,115,14,48916.649999999994,60855.28999999999
2738,UE871E9,129,-8509.020000000002,91,38,38551.72,30042.7
2739,U73448F,129,-12237.370000000003,96,33,226077.00000000003,213839.63
2740,U1C6686,129,1317.5600000000923,40,89,457164.0,458481.56000000006
2741,UB2DE5F,129,-1242.8500000000004,116,13,21643.460000000006,20400.61
2742,U61E285,129,-8364.400000000373,112,17,78364043.23,78355678.83
2743,U0CDCC6,129,-470.84999999999945,119,10,23393.51,22922.660000000003
2744,UC907B7,129,1598.9599999999991,120,9,20901.839999999997,22500.8
2745,U27CAF5,129,-632.0000000000018,71,58,138667.01,138035.00999999998
2746,UFA804C,129,118.72999999999911,80,49,6742.6399999999985,6861.37
2747,UCDDE6A,129,-52794.399999999994,125,4,53141.399999999994,347.0
2748,UAE3240,129,-2114.1499999999996,95,34,124929.68000000001,122815.52999999998
2749,UC72954,129,906.8700000000014,116,13,24474.13,25381.0
2750,UB5B7CC,129,-4721.320000000001,107,22,15989.470000000001,11268.15
2751,U4ACBC4,129,-12553.660000000184,115,14,674949.01,662395.3499999999
2752,U860EEC,129,-26344.399999999987,116,13,39665.46000000001,13321.060000000001
2753,UBBE103,129,1771.5000000000005,126,3,26308.499999999993,28080.0
2754,UDCDDAA,129,-1.000000000007276,82,47,111249.53,111248.53
2755,UB5DB8C,129,3088.769999999996,89,40,180321.02000000002,183409.78999999998
2756,U79DDFD,129,-13270.679999999998,112,17,82297.72,69027.04
2757,U3860CB,129,-537.2800000000025,124,5,6740.220000000003,6202.9400000000005
2758,UF8350A,129,-16231.079999999998,120,9,27712.339999999997,11481.26
2759,UC1A371,129,-733.6299999999828,102,27,126565.34000000001,125831.70999999996
2760,UCB57BC,129,9974.640000000001,114,15,18558.159999999996,28532.800000000003
2761,U185A32,129,-5772.35,86,43,64184.91000000002,58412.56000000001
2762,UE840FC,129,-2641.26,111,18,15518.449999999999,12877.189999999999
2763,U4C9887,129,-4237.6900000000005,98,31,55227.00000000001,50989.310000000005
2764,UA2D165,129,10564.369999999999,92,37,34551.450000000004,45115.82
2765,UD37647,129,6530.000000000002,117,12,28068.699999999997,34598.7
2766,UC9D560,129,10.660000000000082,118,11,10498.800000000001,10509.460000000001
2767,U019952,129,-67309.07999999999,106,23,917254.24,849945.16
2768,U8368BB,128,-3329.1299999999956,111,17,101207.64000000003,97878.51
2769,U55BD70,128,-3332.6900000000005,120,8,17038.910000000003,13706.22
2770,UC35BF3,128,12372.91,116,12,108666.92,121039.82999999999
2771,U4EBDE2,128,8425.469999999998,74,54,87954.21,96379.68
2772,U0469CA,128,-5850.619999999994,114,14,168234.61000000004,162383.99
2773,UFFE089,128,-3876.350000000002,123,5,33160.33,29283.98
2774,UB6CD04,128,4894.0099999999975,123,5,15373.189999999993,20267.2
2775,UC7008D,128,-3827.17,105,23,25908.8,22081.63
2776,U7D7228,128,6158.319999999999,108,20,79955.08,86113.4
2777,UB68962,128,14.299999999995634,87,41,60870.310000000005,60884.61000000001
2778,UD999EC,128,2016.1799999999994,114,14,33032.15000000001,35048.33
2779,U06D15D,128,-299182.29,118,10,1793956.7500000005,1494774.46
2780,UCDD710,128,-9405.790000000008,87,41,90996.73,81590.93999999999
2781,U2BF375,128,-2437.8400000000015,124,4,16223.639999999996,13785.8
2782,UFA1CDA,128,-12981.8,118,10,23409.100000000002,10427.3
2783,UB5CDDD,128,-5474.150000000001,95,33,51851.94000000001,46377.79
2784,U09F44B,128,-183.69999999999789,96,32,142296.52000000002,142112.82
2785,U5E4586,128,10738.24,102,26,325776.68000000034,336514.92000000004
2786,U0273B6,128,1729.2399999999993,124,4,5885.06,7614.3
2787,U50852E,128,612.1700000000017,114,14,37518.33999999999,38130.509999999995
2788,U20F0E2,128,-1529796.8299999994,107,21,1768571.8899999997,238775.06
2789,UBA95D1,128,-1074.5699999999997,107,21,13516.189999999999,12441.619999999999
2790,U22D6B5,128,-162.41000000000042,105,23,14088.859999999999,13926.45
2791,U3D3B12,128,-82079.65000000008,112,16,4148823.9,4066744.25
2792,UDAC4AE,128,-11.180000000010267,113,15,55925.46,55914.28
2793,U659208,128,-3348.3699999999985,121,7,16534.969999999998,13186.6
2794,U8A35BC,128,1889.6699999999998,104,24,33056.11999999999,34945.79
2795,UBB2E40,128,-13323.79,119,9,70446.45999999999,57122.67
2796,U8EC5DE,128,-11638.680000000044,62,66,927253.1200000001,915614.44
2797,UCE0BA2,128,-10487.839999999991,90,38,85635.45000000001,75147.60999999999
2798,UEC0F7E,128,-20840.75,93,35,342414.4600000001,321573.7100000001
2799,U284965,128,-742.78999999999,57,71,35857.19,35114.40000000001
2800,U3A13E3,128,-11977.839999999997,126,2,20477.739999999998,8499.9
2801,U08F13A,128,41872.06,110,18,95881.81999999999,137753.88
2802,U40639C,128,-200493.43999999992,108,20,583094.04,382600.6
2803,U17BBC5,128,13923.14,111,17,95073.18000000001,108996.31999999999
2804,UF8461F,128,-7825.429999999996,103,25,12438.849999999995,4613.420000000005
2805,U0AAF09,128,-1174.260000000002,125,3,22420.430000000004,21246.170000000002
2806,U5D8896,128,6935.4000000000015,109,19,39297.310000000005,46232.71000000001
2807,UE473F4,128,-6371.560000000001,113,15,29484.229999999996,23112.670000000002
2808,U6FDBB4,128,-2927.989999999976,87,41,1588102.38,1585174.3900000001
2809,U0F1740,128,402.3299999999999,121,7,8616.650000000001,9018.98
2810,U8AA521,128,-1107.6800000000537,108,20,501096.1399999998,499988.45999999996
2811,U85EF22,128,55.83000000000007,119,9,11384.279999999997,11440.11
2812,U0D3BE2,127,5614.390000000002,109,18,89784.25000000003,95398.64
2813,UDDC9B4,127,104157.40000000004,106,21,203534.62000000002,307692.02
2814,U37ADB1,127,41446.01,104,23,186504.40999999997,227950.42
2815,U302B87,127,-6681.190000000003,85,42,109683.56000000001,103002.37000000001
2816,U2CE9A5,127,-141496.47,109,18,490115.29,348618.82
2817,UAB3740,127,-4518.62000000008,119,8,1062143.87,1057625.25
2818,U498A9D,127,-1832.79,121,6,43420.84999999999,41588.060000000005
2819,UF66370,127,31480.20999999997,98,29,322361.23,353841.43999999994
2820,UF2CCCB,127,106815.61000000002,108,19,676131.65,782947.26
2821,UD8EE0A,127,-390.44000000000096,114,13,19095.539999999997,18705.1
2822,U668B85,127,-31486.380000000012,93,34,154037.04999999996,122550.67
2823,U44C967,127,225.25000000000023,93,34,17250.430000000004,17475.68
2824,UE98E40,127,-10775.340000000137,88,39,3073305.17,3062529.83
2825,UE5FA3F,127,36386.24999999999,112,15,89052.06999999999,125438.32
2826,U31451E,127,2537.71,125,2,3734.1400000000003,6271.85
2827,UFCC687,127,-2223.199999999999,119,8,35643.770000000004,33420.57
2828,UEBFBF8,127,29735.4,119,8,90671.66,120407.06
2829,U969D51,127,8960.600000000002,107,20,12389.36,21349.960000000003
2830,U7383F3,127,15535.529999999984,101,26,35505.57,51041.10000000001
2831,U50D804,127,-5422.450000000004,76,51,114416.93999999997,108994.49
2832,U036517,127,-13110.83,99,28,101235.66000000005,88124.83
2833,U169D3A,127,-8982.480000000005,113,14,62556.32000000002,53573.84
2834,UF1D228,127,6727.98,93,34,14104.02,20832.0
2835,UE85FFC,127,10.719999999999999,90,37,1766.1200000000001,1776.8400000000001
2836,U49E52E,127,60.27999999999932,104,23,18038.469999999998,18098.749999999996
2837,U1715FF,127,-351.300000000163,92,35,1935569.6199999999,1935218.3199999998
2838,U7C17D1,127,-10032.160000000002,104,23,118306.23999999998,108274.08
2839,UFE8602,127,-4121.720000000003,115,12,94402.38999999998,90280.67000000001
2840,U9A3D1A,127,19020.539999999997,95,32,67810.83000000002,86831.37000000001
2841,U6FDF5D,127,-25194.10999999989,110,17,2072519.33,2047325.2200000002
2842,U6D4038,126,96204.92,113,13,28429.859999999993,124634.78000000001
2843,U5D29A9,126,-507.5299999999868,112,14,257730.31000000003,257222.78
2844,U4E211D,126,-4103.999999999997,87,39,174795.01999999996,170691.02000000002
2845,U73E089,126,-336.3999999999978,113,13,26326.1,25989.7
2846,UE28D2D,126,-34.16000000000055,111,15,5708.4400000000005,5674.280000000001
2847,UE991F6,126,-36227.270000000004,107,19,134062.21,97834.94
2848,U901983,126,-10195.449999999999,113,13,20956.790000000005,10761.34
2849,U37CEAB,126,7511.380000000004,114,12,12763.439999999999,20274.82
2850,U90E479,126,-78097.71999999999,104,22,244262.97000000003,166165.25
2851,U67994F,126,-19237.799999999985,107,19,60186.459999999985,40948.66
2852,U6E6929,126,-1414.2100000000016,123,3,4616.97,3202.76
2853,U19CF64,126,1941.3899999999985,113,13,27516.67,29458.06
2854,U4B2B81,126,-632.7900000000006,67,59,7729.169999999998,7096.38
2855,U367385,126,-3135.71,117,9,5009.8,1874.0900000000001
2856,U8EAF1B,126,-4158.470000000001,120,6,44497.93999999999,40339.47
2857,UAF712D,126,1517.3600000000008,104,22,10727.64,12245.0
2858,UD17D73,126,-11555.480000000014,89,37,252149.02,240593.54
2859,UEEB539,126,6425.780000000004,84,42,172893.53,179319.31
2860,U60A0A0,126,-2989.9800000000005,121,5,7152.419999999999,4162.4400000000005
2861,UCD200F,126,-6154.8099999999995,120,6,40583.82,34429.01
2862,U533078,126,-555.8699999999999,121,5,11974.830000000002,11418.96
2863,U4BDBCC,126,-3992.1400000000003,121,5,13511.189999999997,9519.05
2864,UF0245A,126,-65228.399999999994,113,13,92102.23,26873.83
2865,U60A702,126,-250460.24,111,15,530864.3099999999,280404.07
2866,UFAFC26,126,-21008.23000000001,106,20,340597.05999999994,319588.83
2867,U644838,126,2578.35,118,8,10752.589999999998,13330.939999999999
2868,UC54D99,126,-21807.040000000005,116,10,37570.53999999999,15763.5
2869,UEADB02,126,-334.02000000000135,110,16,32283.239999999998,31949.22
2870,UD431CB,126,1249.5300000000018,116,10,18545.340000000007,19794.870000000003
2871,U677DDE,126,-12644.169999999998,109,17,89280.34,76636.17
2872,UEA3201,126,4403.330000000016,117,9,244935.34,249338.67
2873,UE70BD6,126,-14331.509999999993,84,42,270567.16000000003,256235.6499999999
2874,U288AB4,126,-3181.540000000001,115,11,18785.29,15603.75
2875,U9FB9AA,126,-4157.1500000000015,118,8,23211.5,19054.35
2876,UACC3B7,126,-2643.429999999997,106,20,78897.37000000002,76253.94
2877,U150477,126,-3059.6499999999996,114,12,18646.489999999998,15586.84
2878,U864F8B,126,-2455.4400000000014,118,8,15550.620000000004,13095.18
2879,U6E1368,126,1359.37,113,13,4372.33,5731.7
2880,U9DB34A,126,77994.41000000002,110,16,40591.36,118585.77000000002
2881,U611EDD,126,12330.5,112,14,104500.66,116831.16
2882,U0F3DCE,125,23429.229999999996,113,12,17101.930000000004,40531.16
2883,UBD1EE7,125,-2134.6299999999987,109,16,14592.109999999999,12457.48
2884,U2F64B0,125,-14343.440000000024,68,57,533405.0700000001,519061.63000000006
2885,UA06FB3,125,-216.07999999999987,123,2,3099.1299999999997,2883.05
2886,U857951,125,25779.95,65,60,121751.04,147530.99
2887,U4D2DD2,125,-374.8700000000017,111,14,12710.909999999994,12336.04
2888,UB88A99,125,1131.4899999999993,120,5,5909.849999999999,7041.34
2889,U69953E,125,-2479.8299999999977,115,10,24948.839999999997,22469.010000000002
2890,UA7BD8E,125,2139524.41,110,15,821226.4700000002,2960750.88
2891,U5649CF,125,6318.359999999996,76,49,96863.66000000002,103182.02
2892,U591457,125,20096.999999999996,62,63,132817.90999999997,152914.91
2893,U3D308E,125,24313.699999999993,123,2,2806.06,27119.76
2894,UEB9082,125,946.9600000000008,102,23,28714.75,29661.71
2895,U6A55DB,125,4844.9600000000055,110,15,28598.42,33443.380000000005
2896,UFDF1C1,125,2026.820000000001,115,10,12507.559999999994,14534.38
2897,UFB4E58,125,-884.2799999999999,121,4,3040.4000000000005,2156.12
2898,U9FB904,125,73511.40000000002,106,19,50054.380000000005,123565.78000000001
2899,UBD9DD1,125,1014.3100000000222,78,47,253537.12,254551.43
2900,U7C035C,125,-14088.170000000004,120,5,33926.17,19838.0
2901,U3C5120,125,5139.790000000002,96,29,129639.78999999995,134779.58
2902,UE2C28E,125,22675.940000000006,114,11,19402.919999999995,42078.86
2903,UCECB16,125,714.7000000000038,118,7,19075.829999999994,19790.53
2904,U9573A0,125,9993.330000000018,99,26,1171717.78,1181711.11
2905,UEB21DC,125,-20011.800000000014,105,20,77182.93000000001,57171.130000000005
2906,U85A171,125,876.5000000000018,113,12,33314.01000000001,34190.509999999995
2907,U864435,125,-393.3499999999976,114,11,23897.61,23504.260000000002
2908,U1DF3A2,125,65.67000000000024,112,13,15048.449999999999,15114.12
2909,UF74952,125,1142.6199999999994,118,7,17252.43,18395.050000000003
2910,U435D24,125,244167.96000000002,87,38,9039946.360000005,9284114.320000002
2911,U9E72B5,125,-3726.799999999999,116,9,40163.17999999999,36436.380000000005
2912,U7F89A3,125,-4827.16,116,9,21095.309999999998,16268.15
2913,U8AEBF1,125,276.16999999999825,108,17,39979.78000000001,40255.95
2914,U4E5048,125,44116.299999999996,104,21,120848.05000000002,164964.35
2915,U344A16,124,-4452.230000000001,76,48,69650.8,65198.56999999999
2916,UCD7CE1,124,8654.079999999996,108,16,101777.86000000003,110431.94
2917,U26506D,124,-73996.93000000002,87,37,193683.63,119686.7
2918,U0A5FCD,124,-269.0,124,0,269.0,0.0
2919,U119718,124,203638.61000000002,105,19,293891.20999999996,497529.82
2920,U661965,124,10923.780000000012,118,6,21941.76,32865.54
2921,U66FBF1,124,-1836.8600000000065,93,31,43254.18000000001,41417.32000000001
2922,U4378BE,124,-555.5899999999997,111,13,4992.870000000001,4437.280000000001
2923,U661754,124,2272.9099999999994,80,44,13858.13,16131.04000000001
2924,U07B6E8,124,36676.84,50,74,144757.92000000004,181434.75999999998
2925,UE1D9E9,124,93814.88999999998,104,20,401204.58999999997,495019.48000000004
2926,U5AAAEA,124,-1473.8700000000006,118,6,4936.12,3462.2499999999995
2927,U9D1351,124,1306.9199999999996,97,27,24860.620000000003,26167.54
2928,UC7CDE7,124,-17205.80999999999,85,39,270560.85000000003,253355.04000000012
2929,UC39A5B,124,-83.86999999999999,118,6,5378.410000000001,5294.54
2930,UD3DD68,124,22029.469999999994,50,74,150294.73,172324.19999999992
2931,U6E3D28,124,-1716.7499999999927,91,33,78314.20999999999,76597.46
2932,UC2A3E1,124,-11920.239999999998,83,41,136487.19,124566.95
2933,U8D924F,124,35261.429999999986,103,21,402956.6800000002,438218.1099999999
2934,UF5E54A,124,1714.6900000000014,117,7,10613.34,12328.03
2935,U9F6B3A,124,-1076.510000000009,101,23,95431.64000000004,94355.12999999999
2936,U5BBA4D,124,-1062.27,103,21,40373.65,39311.38
2937,UAB054F,124,3619.0499999999993,81,43,17420.62,21039.670000000002
2938,U989710,124,56031.979999999996,77,47,248907.49999999994,304939.48
2939,UD68AFF,124,-549.6199999999992,118,6,32438.840000000007,31889.22
2940,U9BD9F6,123,4305.189999999997,77,46,379723.05000000005,384028.23999999993
2941,U8DE703,123,-6406.559999999995,103,20,92826.84000000001,86420.28
2942,UDA2639,123,-397.8300000000006,117,6,7854.220000000001,7456.389999999999
2943,U5FF8B4,123,24762.069999999985,104,19,77602.08,102364.15
2944,UF88B31,123,941.0400000000029,101,22,83600.90999999999,84541.95
2945,UBE6820,123,19496.609999999993,56,67,48163.219999999994,67659.83
2946,U059BD6,123,1078.1100000000006,94,29,16979.659999999996,18057.77
2947,U84DCE1,123,473823.5300000002,109,14,3579036.0500000003,4052859.5799999996
2948,UB176B3,123,9350.059999999998,87,36,133553.29,142903.34999999998
2949,UB401B9,123,-959353.7000000003,101,22,21468654.4,20509300.700000003
2950,U5B1C60,123,-14412.54,115,8,25819.309999999994,11406.77
2951,UFB04FF,123,-10141.31999999999,106,17,15268.779999999986,5127.46
2952,U5998E8,123,-297805.88,118,5,1213053.0,915247.12
2953,UC3EE9D,123,-1787.289999999999,117,6,19526.41,17739.12
2954,U3C3072,123,-6523.43,118,5,11772.690000000002,5249.26
2955,U2D48D5,123,-2285.73,110,13,20368.819999999996,18083.09
2956,UF3289C,123,2013.610000000005,67,56,56066.699999999975,58080.31
2957,U4F8D9E,123,223148.27,78,45,662095.53,885243.8
2958,U5866A8,123,-6084.010000000006,99,24,223922.94999999998,217838.93999999997
2959,UDBF6EF,123,12326.75,104,19,394056.67000000004,406383.42000000004
2960,U61AE9B,123,819.0900000000001,98,25,8468.55,9287.64
2961,UE2BEB9,123,-1299.6499999999994,102,21,15739.459999999995,14439.809999999998
2962,UD51764,123,-6372.070000000014,112,11,47857.65000000003,41485.58
2963,UE26A24,123,298.9400000000005,111,12,15159.669999999998,15458.61
2964,U664348,123,234364.77,111,12,43807.369999999995,278172.14
2965,UC01CF9,123,-29.770000000000152,106,17,12350.410000000002,12320.640000000001
2966,U9B9944,123,-14140.070000000002,111,12,83497.99,69357.92
2967,UBDB314,123,-142066.2,117,6,204228.21,62162.01
2968,U97C9E5,123,1028.03,90,33,11068.029999999997,12096.059999999998
2969,UC48A0F,122,21662.6,111,11,122694.4,144357.0
2970,U11B43C,122,-99.69999999999982,64,58,50489.72,50390.020000000004
2971,UAFB388,122,94678.43,79,43,590947.68,685626.1100000001
2972,U6DB7F1,122,-7242.559999999994,116,6,34871.29000000001,27628.73
2973,UD61982,122,2663.1800000000026,105,17,38279.37000000001,40942.55
2974,UE012DC,122,-1708.2499999999986,113,9,93426.90999999995,91718.66000000002
2975,UC7682E,122,-516.7400000000034,111,11,69219.05,68702.30999999998
2976,UE25E81,122,-4466.600000000002,109,13,20361.47,15894.869999999999
2977,U50F51D,122,4156.040000000004,118,4,24726.14,28882.18
2978,U1E8E4B,122,-39634.73000000001,114,8,75249.14,35614.41
2979,UB418E6,122,4024.9799999999996,107,15,25212.249999999996,29237.230000000003
2980,U893257,122,-366.350000000004,86,36,203909.59,203543.24
2981,U8AFADA,122,-5817.130000000001,78,44,49353.189999999995,43536.06
2982,U8877B5,122,-3991.100000000015,80,42,113086.21999999999,109095.12000000001
2983,UC00B0D,122,20836.089999999997,95,27,112378.09000000001,133214.18
2984,U106110,122,156.1699999999991,102,20,65245.470000000016,65401.64
2985,U7D0322,122,-3.6000000000004775,71,51,197933.50000000003,197929.90000000002
2986,UF22717,122,-708.6100000000004,118,4,9982.1,9273.489999999998
2987,UA61C8D,122,-11915.109999999993,97,25,1208023.1600000001,1196108.0499999998
2988,U88FAB1,122,-65.1999999999999,114,8,4399.999999999999,4334.8
2989,U67388B,122,-2189.7899999999972,102,20,44486.40999999999,42296.62000000001
2990,UA44626,122,-120734.32,104,18,264096.59,143362.27000000002
2991,U788547,122,-4500.41,108,14,11746.179999999998,7245.7699999999995
2992,UE0D509,122,9993.59,98,24,35820.53,45814.12
2993,UAEA2C1,122,-712.2900000000001,100,22,23242.65,22530.359999999997
2994,U098ED6,122,7238.240000000003,94,28,182188.38,189426.62
2995,U621ED1,122,2620.009999999999,116,6,57874.76,60494.770000000004
2996,U2BAF2A,122,-39505.850000000006,109,13,77223.29999999999,37717.45
2997,UCA4434,122,-4585.779999999997,99,23,243061.11999999994,238475.34000000003
2998,U3431B6,122,10366.17,113,9,9285.089999999998,19651.260000000002
2999,U1F552D,121,-16003.659999999996,64,57,823421.9500000001,807418.29
3000,UFDB860,121,-1980.7599999999984,92,29,43046.51,41065.75
3001,U9439D2,121,-5423.629999999999,92,29,38174.24,32750.610000000004
3002,UCA0A8C,121,1727.1099999999994,115,6,4852.050000000001,6579.16
3003,UD96F2C,121,-47899.07000000001,106,15,132636.86,84737.79000000001
3004,UF3E049,121,1934.770000000004,92,29,405889.00999999995,407823.77999999997
3005,U9B48EB,121,1857.049999999998,80,41,272674.6300000002,274531.68
3006,U35DFB8,121,-20368.070000000298,84,37,19315878.04,19295509.97
3007,U611D76,121,-19352.25,114,7,30828.250000000004,11476.0
3008,U9ABB8A,121,506.9500000000012,95,26,74234.98,74741.93000000001
3009,UD0021D,121,-1155.3400000000056,73,48,31300.36,30145.019999999968
3010,U3C59CC,121,1007.2999999999927,90,31,194917.11000000002,195924.41
3011,UD4F38F,121,-8363.56999999992,99,22,1628594.1,1620230.53
3012,U5EB352,121,-2398.28,110,11,6466.76,4068.48
3013,U850D88,121,12737.73,110,11,34668.86,47406.59
3014,U6D28D2,121,-1159.5399999999988,117,4,3503.3999999999996,2343.86
3015,U41FCA2,121,1357.470000000013,82,39,442871.12999999995,444228.5999999999
3016,UB5C3D0,121,-2259.8199999999997,116,5,9030.989999999998,6771.170000000001
3017,UCEE890,121,-691.4700000000005,88,33,28809.58,28118.11
3018,UC53B63,121,519.4999999999991,103,18,13956.970000000001,14476.469999999998
3019,U47422D,121,2912.1900000000073,90,31,273471.43999999994,276383.62999999995
3020,UC9D208,121,-1.890000000000839,73,48,20384.27,20382.38
3021,U205B13,121,-15569.749999999993,107,14,104215.10999999997,88645.36
3022,U01D8C9,121,-1792376.8599999996,99,22,4011088.59,2218711.73
3023,UFDF587,121,-380.3500000000002,117,4,1798.97,1418.62
3024,UECF87D,121,-1963.260000000001,101,20,14910.13,12946.869999999999
3025,U2F0E8F,121,-9720.470000000027,87,34,556786.8200000001,547066.35
3026,U84222A,121,5757.470000000003,76,45,92534.43000000001,98291.9
3027,U7A3977,121,-2294.689999999998,73,48,46685.28999999999,44390.6
3028,UDDAC06,121,9923.68,112,9,29078.0,39001.68
3029,U92D4FA,121,267.44000000000403,101,20,41153.590000000004,41421.03
3030,U6305FA,121,-4513.18,109,12,26353.41,21840.23
3031,U8DC2B6,121,12599.19,86,35,65712.54,78311.73000000001
3032,U62CDB4,120,192.4200000000037,74,46,73803.13999999998,73995.56000000001
3033,UD88657,120,3082.1399999999994,117,3,5228.4800000000005,8310.619999999999
3034,UD0BA0D,120,-36.86000000000058,110,10,54561.67000000001,54524.81
3035,UBB328F,120,24537.790000000015,77,43,793398.7899999998,817936.5800000001
3036,UADABFB,120,36213.88,76,44,502193.95,538407.8300000001
3037,UFEDEBB,120,3946.8500000000013,97,23,77541.58,81488.43000000001
3038,UA590A1,120,-2241.7599999999943,70,50,205134.88,202893.12
3039,U3C6050,120,16242.830000000002,79,41,246062.38999999996,262305.22000000003
3040,UFD973A,120,57687.84999999998,85,35,218940.55000000005,276628.4000000001
3041,U9C1B45,120,-960.8099999999922,86,34,407770.37999999995,406809.57
3042,U801EE6,120,-13867.249999999993,104,16,85140.73,71273.48000000001
3043,UEAA7BA,120,3578.4400000000005,92,28,29790.35999999999,33368.799999999996
3044,UDA5C49,120,-182.34999999999354,61,59,415371.43999999994,415189.09
3045,UCC5EC8,120,60170.05999999998,64,56,36622.95,96793.01
3046,UB158C9,120,251.81999999999488,113,7,30142.250000000007,30394.07
3047,U0C33BF,120,6877.4600000000055,90,30,106813.82999999999,113691.29000000001
3048,U5726EC,120,-5262.649999999999,105,15,13926.939999999991,8664.29
3049,U99D08C,120,-228.4800000000036,97,23,147263.98999999993,147035.50999999998
3050,UB95D93,120,9363.850000000004,111,9,20411.34999999999,29775.2
3051,UDC3C59,120,8617.13,92,28,17213.029999999995,25830.16
3052,U1B66BB,120,1760.85,116,4,2611.1500000000005,4372.0
3053,UE25ED9,120,-2215.930000000003,100,20,29994.99,27779.06
3054,UDDFDA4,120,-5709.039999999993,93,27,35608.99,29899.949999999997
3055,U358F66,120,-2299.889999999977,100,20,105052.12,102752.23
3056,U8C6BEB,120,2946.7300000000014,96,24,72080.91,75027.64
3057,UD4AB6E,120,-30609.379999999994,102,18,322043.89999999997,291434.52
3058,U7EAA86,120,25054.84,111,9,139852.97999999995,164907.82
3059,UCD128D,119,3093.9299999999985,111,8,9753.800000000001,12847.73
3060,U686D85,119,-18123.909999999993,110,9,52830.63999999999,34706.72999999999
3061,UA8F485,119,-3062.5499999999756,106,13,116436.77000000014,113374.22
3062,UF4900E,119,-56801.009999999995,101,18,226951.6,170150.59
3063,UF32264,119,541298.3100000005,99,20,64221.59,605519.9
3064,U14A842,119,65.95000000000078,114,5,22472.279999999995,22538.230000000003
3065,U22D0B1,119,-45602.690000000024,99,20,871243.8600000001,825641.17
3066,UB3EA20,119,-9608.560000000003,116,3,36148.01999999999,26539.46
3067,U41CF68,119,-3961.8899999999994,103,16,48187.32000000001,44225.43
3068,UD8493B,119,8127.050000000004,109,10,35694.38000000001,43821.43
3069,U6AE443,119,-778.419999999991,95,24,88730.00999999998,87951.59
3070,U4968B5,119,-19242.520000000004,100,19,195140.81,175898.29
3071,U80F289,119,513.25,91,28,19231.59,19744.84
3072,U73A3C0,119,3898.6499999999996,107,12,12849.059999999996,16747.71
3073,U23CC3E,119,1024.8800000000003,90,29,29310.459999999995,30335.340000000004
3074,U3054C4,119,-50.720000000002706,98,21,3238.050000000003,3187.33
3075,UC74A54,119,7908.660000000005,82,37,154806.22999999998,162714.89
3076,U1E7EF8,119,115.40000000000012,110,9,2605.25,2720.65
3077,U3003E2,119,-235.10999999996574,65,54,1555855.7399999995,1555620.63
3078,U229750,119,-2603.5300000000016,112,7,15669.79,13066.26
3079,U58DE88,119,242.46000000000134,109,10,12522.610000000002,12765.07
3080,U02A901,119,-4.769999999999527,65,54,48074.13,48069.36
3081,UEFEFD1,119,46422.61999999999,84,35,83877.77000000002,130300.39000000001
3082,UC381EE,119,-3220.4,98,21,9532.46,6312.0599999999995
3083,UF12834,119,15236.499999999985,96,23,195697.19,210933.69
3084,U294726,119,-1420.7000000000005,96,23,38747.68,37326.98
3085,U3BA321,119,-90218.05000000002,99,20,248266.32999999984,158048.28
3086,UE580E0,119,22150.209999999995,108,11,10264.01,32414.22
3087,U941EF6,119,-947.7799999999997,110,9,1989.18,1041.4
3088,U0A70F5,119,-2537.680000000004,95,24,161939.88,159402.19999999998
3089,U3A9339,119,1232.9699999999943,83,36,50379.83000000001,51612.79999999999
3090,U4ECD3D,119,3203.5499999999993,108,11,5856.19,9059.74
3091,UEBED86,119,667.8000000000006,87,32,21137.499999999996,21805.3
3092,UCB95E2,119,45500.24,105,14,49916.54,95416.78000000001
3093,U445A9F,119,15914.449999999986,92,27,120769.09000000003,136683.54
3094,UDE7E7C,119,-33685.84000000001,97,22,99335.35999999999,65649.51999999999
3095,UF2BD94,119,5788.5,111,8,29991.789999999994,35780.29
3096,UE95164,119,-3674.590000000002,107,12,12440.419999999998,8765.830000000002
3097,U13CAC5,119,-5294.379999999993,101,18,340132.3899999999,334838.01
3098,UDFAE1F,118,116269.10999999997,64,54,216823.0,333092.1099999999
3099,UCAB82D,118,52865.21000000001,88,30,260906.58000000005,313771.79
3100,U844AFF,118,-10361.380000000003,101,17,14326.640000000003,3965.26
3101,UF89534,118,-18062.980000000007,108,10,23588.770000000004,5525.790000000001
3102,U2C3E40,118,-3741.04,112,6,5202.780000000002,1461.74
3103,UD3B3AA,118,-427.22000000000077,83,35,9268.36,8841.140000000003
3104,U68B109,118,3805.789999999999,103,15,15680.069999999992,19485.860000000004
3105,U16C871,118,2926.7100000000087,88,30,196423.22000000006,199349.93
3106,U94AB1E,118,309.58999999999577,79,39,21098.870000000003,21408.46
3107,UB9471D,118,410.27000000000015,107,11,5062.460000000001,5472.7300000000005
3108,U750395,118,26932.140000000003,90,28,186375.23,213307.37000000002
3109,UDE97ED,118,-13989.079999999996,105,13,25046.12,11057.04
3110,UBA9C19,118,5370.680000000005,109,9,20976.26999999999,26346.95
3111,UF19289,118,-75.88999999999996,97,21,1473.96,1398.0700000000004
3112,UBC5DCC,118,-452.99000000001615,77,41,469816.7800000001,469363.79
3113,U00E22E,118,9379.980000000003,112,6,16154.44,25534.420000000002
3114,UD0E687,118,-7824.300000000002,114,4,16090.929999999995,8266.630000000001
3115,U9B927D,118,-5930.540000000003,78,40,141089.61000000002,135159.07
3116,U9B5B87,118,921159.7700000001,112,6,47080.3,968240.0700000001
3117,U1414EE,118,6846.609999999993,97,21,111882.69999999998,118729.31
3118,UD67883,118,2868.3600000000006,115,3,29415.56000000001,32283.920000000002
3119,UEC4458,118,-1162.2999999999956,111,7,9021.869999999992,7859.57
3120,UE2451C,118,445.3000000000014,99,19,38387.84999999999,38833.149999999994
3121,UF91860,118,-1296.5900000000004,107,11,16202.129999999997,14905.54
3122,UD18A38,118,-60444.60000000009,78,40,7265307.380000001,7204862.779999999
3123,UF8EAEB,118,-5617.469999999998,112,6,16548.969999999998,10931.5
3124,U9E9C1B,118,15910.460000000005,111,7,18046.13,33956.59
3125,UE285E4,118,9064.700000000003,90,28,93616.49,102681.18999999999
3126,UE81FC4,118,-42620.32999999999,104,14,94405.55000000002,51785.22
3127,UDFF950,118,1971.5800000000017,103,15,37303.08,39274.66
3128,UE389E6,118,1150.1699999999992,115,3,3347.5800000000017,4497.75
3129,U111F64,118,-12161.289999999994,81,37,140756.54000000004,128595.25
3130,UC80CDB,118,-16982.119999999984,97,21,247046.65000000002,230064.53
3131,UF8A122,118,-2448.8399999999974,106,12,28734.980000000003,26286.14
3132,U982A85,118,-11786.189999999995,102,16,84558.6,72772.41
3133,U25B493,118,-5314.170000000002,108,10,32462.12,27147.95
3134,U360E59,118,-3793.310000000011,109,9,86947.36999999997,83154.06
3135,UCC659F,118,75645.61999999997,107,11,33780.88,109426.5
3136,U652524,118,-38153.76,99,19,179891.34,141737.58000000002
3137,U207743,117,8540.3,82,35,180443.02999999994,188983.33
3138,UFC7F3C,117,2441.2699999999913,72,45,197155.8499999998,199597.12
3139,U8F501E,117,5.730000000000473,111,6,13125.119999999999,13130.849999999999
3140,U858927,117,-3892.669999999998,107,10,16394.059999999998,12501.390000000001
3141,UFFC357,117,3666.5799999999963,101,16,86180.39,89846.97
3142,U2ED026,117,4503.17,113,4,1468.1099999999997,5971.28
3143,UB40A52,117,-84896.34,62,55,458911.05,374014.70999999996
3144,U654754,117,2478.4900000000002,114,3,14127.339999999997,16605.83
3145,U792268,117,-64113.2,98,19,134231.30000000002,70118.1
3146,U5FF791,117,3958.750000000041,75,42,1025849.6299999999,1029808.3799999999
3147,U76A362,117,156.77999999999793,98,19,8580.77,8737.550000000001
3148,U4810D0,117,4796.159999999998,105,12,42211.26,47007.42
3149,UF39128,117,-13019.809999999981,87,30,305441.02999999997,292421.22
3150,U46B3E5,117,-210023.84999999992,75,42,821008.9800000001,610985.13
3151,UA8D424,117,583.13,88,29,10503.149999999998,11086.279999999999
3152,U0DB4D3,117,10.649999999999636,35,82,78666.47,78677.12
3153,UABB392,117,3737.580000000007,104,13,51836.280000000006,55573.86
3154,UF4D1E5,117,41949.81,104,13,144450.39,186400.2
3155,UDC9544,117,2998.539999999993,113,4,2714.4600000000014,5713.0
3156,U86AEF5,117,14492.799999999963,57,60,673984.22,688477.0200000003
3157,U27E17B,117,74.92000000000053,100,17,6140.33,6215.25
3158,U00F410,117,-13671.760000000006,99,18,35757.200000000004,22085.44
3159,UFB8790,117,2814.7000000000025,89,28,166137.6,168952.30000000002
3160,UB296E9,117,520.4200000000565,62,55,2204063.46,2204583.88
3161,U81BAB3,117,-3404.349999999999,92,25,40158.69999999999,36754.35
3162,UF19D8F,117,762.9499999999994,107,10,26047.13,26810.079999999998
3163,U4D6B68,117,8151.59,107,10,12548.529999999999,20700.120000000003
3164,U0F1C28,117,29644.05000000006,112,5,28256.18999999998,57900.24
3165,U83D4C0,117,6759.280000000001,99,18,11726.519999999999,18485.800000000003
3166,U827C0A,117,9189.17,101,16,29242.559999999998,38431.729999999996
3167,U132A1A,117,-1527.9600000000003,104,13,46326.54,44798.58000000001
3168,U2D89C0,117,143.21999999999113,71,46,185394.15000000002,185537.37
3169,U7ED499,116,2749.540000000001,104,12,23446.539999999928,26196.08
3170,UAA6909,116,4654.160000000002,98,18,22630.42,27284.579999999998
3171,UC41E97,116,-5754.719999999999,101,15,30603.549999999996,24848.83
3172,UCC263F,116,4841.950000000074,102,14,1044774.4699999995,1049616.42
3173,UE08C60,116,967.0699999999989,111,5,39284.19000000002,40251.26
3174,U1EED01,116,-3544.38,109,7,9671.380000000001,6127.0
3175,UF6E865,116,-7606.240000000003,101,15,132374.31999999998,124768.08
3176,UDF1A1F,116,-1345.7600000000002,87,29,53352.59999999999,52006.84
3177,U476E77,116,-5925.479999999998,109,7,39568.56000000001,33643.079999999994
3178,U08A50D,116,-183890.66999999795,101,15,19611073.019999977,19427182.349999998
3179,U8566D1,116,-4057.6100000000006,104,12,6507.010000000002,2449.4
3180,U261399,116,-1793.1400000000003,101,15,18866.399999999994,17073.26
3181,U1B8C5A,116,814.9499999999992,107,9,7517.45,8332.4
3182,U4EE3B8,116,22973.299999999996,73,43,504395.64,527368.94
3183,U136EE9,116,-590.1899999995717,100,16,5854210.680000001,5853620.49
3184,U7C7EE8,116,-5976.269999999999,85,31,71713.8,65737.53
3185,UE1134B,116,-67428.71999999993,108,8,126442.86999999994,59014.149999999994
3186,U40B79F,116,-1787.81000000001,102,14,68394.55999999998,66606.75
3187,UECE0E9,116,231309.57,53,63,201329.03,432638.6
3188,UDABEAB,116,12115.560000000001,99,17,33481.17,45596.73
3189,UEAA853,116,-744.2100000000002,103,13,20838.470000000005,20094.26
3190,U5D500D,116,-42516.369999999995,72,44,501825.1599999999,459308.79
3191,U6F6925,116,2815.149999999998,102,14,12612.449999999995,15427.599999999999
3192,UBE39B9,116,-7208.659999999998,80,36,61747.79999999997,54539.14000000001
3193,U4FB3B9,116,-3294.7799999999993,108,8,22356.93,19062.149999999998
3194,UEAAFE8,116,1801.069999999991,101,15,136874.75999999998,138675.83
3195,U1EEE79,116,-3784.31,107,9,14519.909999999998,10735.6
3196,UDE5AB2,116,3933.3099999999977,104,12,27202.530000000006,31135.84
3197,U527C6E,116,-16023.030000000006,86,30,111657.96000000002,95634.93000000001
3198,U00DED7,116,-27947.450000000008,102,14,1393255.0799999998,1365307.63
3199,UFA9119,116,-3183.7400000000007,106,10,13871.060000000001,10687.32
3200,U6E3954,116,96253.99000000003,95,21,9610.099999999997,105864.09
3201,UF922A5,116,1918.95,112,4,3550.7400000000007,5469.69
3202,UD35426,116,-9992.56000000001,89,27,114385.59000000001,104393.03
3203,U6E57F2,116,-11058.16,114,2,11283.16,225.0
3204,UFA6408,116,-1158.45,115,1,1743.7299999999998,585.28
3205,UCE8837,116,-19605.590000000004,105,11,48838.78999999997,29233.199999999997
3206,U90AF1B,116,-6677.0700000000015,105,11,33843.48,27166.41
3207,U971D47,116,5320.88,100,16,79350.21000000008,84671.09
3208,U469572,116,767.27,104,12,7123.570000000001,7890.84
3209,UE01643,116,-33350.22999999999,106,10,151749.08000000002,118398.85
3210,UCD88D2,116,2727.6700000000023,88,28,43654.78999999999,46382.45999999999
3211,UD1B79E,116,11866.72,60,56,67133.36000000002,79000.08000000002
3212,U44C749,115,-869.6200000000026,100,15,85129.02,84259.40000000001
3213,U55F117,115,3494.8500000000004,108,7,5730.609999999999,9225.460000000001
3214,U248B57,115,-18422.349999999995,110,5,25071.349999999995,6649.0
3215,U555EEB,115,-32002.069999999992,73,42,678467.12,646465.05
3216,UE8B9E4,115,11.690000000001408,80,35,13739.24999999999,13750.939999999999
3217,U936B54,115,125259.66000000006,19,96,109033.8,234293.45999999996
3218,UE22FC3,115,1259.9500000000232,106,9,87550.34,88810.29000000001
3219,UE5ABD9,115,99.55999999999767,102,13,303900.86,304000.42
3220,UA953D0,115,26230.409999999985,102,13,182267.09999999998,208497.51
3221,UAA6327,115,-6529.909999999994,96,19,60505.96,53976.049999999996
3222,U183B58,115,19455.500000000007,92,23,82898.52000000002,102354.02
3223,UE4A9E3,115,-6845.770000000019,102,13,206461.61000000002,199615.84
3224,U937CC3,115,-341.4399999999996,107,8,10691.439999999999,10350.0
3225,U6A2F3C,115,-6890.370000000001,92,23,25700.130000000005,18809.760000000002
3226,UBEE8C1,115,-7266.609999999998,106,9,14952.349999999991,7685.74
3227,UD27025,115,-9640.37,78,37,45795.38,36155.01
3228,UEE6CF4,115,55065.63000000002,103,12,566313.71,621379.3400000001
3229,U349F12,115,-107863.55,83,32,457098.13,349234.57999999996
3230,UBCEBAB,115,-5211.610000000005,106,9,45226.23000000004,40014.619999999995
3231,UE7F16E,115,1664.0300000000004,59,56,14320.04,15984.070000000002
3232,U752DA6,115,-22236.53,104,11,121635.44999999997,99398.92000000001
3233,U7A37F5,115,-80806.86999999998,102,13,157648.62999999998,76841.76
3234,U3F6FFC,115,-4093.950000000001,97,18,38714.92,34620.969999999994
3235,U7A537C,115,-2200.6900000000023,98,17,97356.42,95155.73
3236,U108852,115,1696.7099999999991,64,51,314226.29,315923.0
3237,U6912EF,115,-11602.820000000002,64,51,99961.09,88358.27
3238,UC5555E,115,1673.4899999999998,54,61,108521.58000000002,110195.06999999998
3239,U34E693,115,3550.9000000000015,103,12,77846.25,81397.15000000001
3240,UEA6B69,115,351.00999999999385,80,35,76724.02999999996,77075.04000000001
3241,UB02A2E,115,1842.0900000000001,94,21,30480.67,32322.76
3242,UE3A698,114,-246.62000000000003,101,13,24360.189999999995,24113.57
3243,U860B61,114,-273.1200000000026,107,7,13356.230000000001,13083.11
3244,UF8E321,114,169.6399999999985,102,12,42997.43,43167.07
3245,U65B9EB,114,3461.6900000000096,82,32,80723.78,84185.47
3246,UB1B069,114,17330.190000000002,73,41,138474.72,155804.90999999997
3247,UE678B5,114,20425.40999999999,104,10,42383.07,62808.48
3248,UE2B1D1,114,-7525.3900000000285,92,22,318183.55,310658.1599999999
3249,U25E383,114,61340.169999999984,59,55,376449.18,437789.35
3250,UC2C63A,114,9986.970000000003,94,20,42980.189999999995,52967.159999999996
3251,UDA888F,114,-29040.36999999999,104,10,108104.62,79064.25
3252,U145E7A,114,3876.51,100,14,9966.51,13843.02
3253,UF40926,114,-1803.0500000000047,99,15,38460.44999999996,36657.4
3254,UAC7CB3,114,-6367.139999999996,103,11,45845.63,39478.490000000005
3255,UD7FD17,114,2201.169999999953,96,18,2095578.7899999998,2097779.9600000004
3256,U807BD2,114,-5915.1500000000015,101,13,123721.03,117805.88000000002
3257,U1393FF,114,-6979.12,79,35,32013.76,25034.640000000003
3258,U0492A5,114,90218.38999999997,100,14,43856.05000000002,134074.44
3259,U2818ED,114,890.9599999999974,102,12,43235.819999999985,44126.78
3260,U23D496,114,-8375.05,89,25,111943.22000000002,103568.17000000001
3261,U37265E,114,-9836.890000000003,86,28,89961.66000000002,80124.77
3262,U708A03,114,160836.92000000004,111,3,2719.28,163556.2
3263,UA78137,114,-688.4700000000009,102,12,8539.69,7851.219999999999
3264,UE50738,114,14705.419999999991,75,39,503766.37,518471.79000000004
3265,U16C1A1,114,-7871.419999999999,97,17,22794.62,14923.200000000004
3266,U075185,114,-20502.9,84,30,138959.46000000002,118456.56000000003
3267,UF7C218,114,-6363.88,113,1,6394.680000000001,30.8
3268,UF14D88,114,5474.250000000013,77,37,7105.879999999997,12580.130000000012
3269,U48CF08,114,2522.7699999999995,89,25,11116.150000000001,13638.92
3270,U4B2604,114,2258.3899999999976,104,10,73233.48999999999,75491.88
3271,U03B804,114,1117.6800000000076,76,38,183106.24,184223.92
3272,U778F23,114,-13535.290000000003,100,14,70910.7,57375.41
3273,U445496,114,-429.95000000000084,103,11,11986.36,11556.41
3274,UDEEA76,114,-11522.550000000005,103,11,99646.2,88123.65
3275,UB8294E,114,-3323.3800000000006,92,22,40998.24,37674.86
3276,UEE9FBE,113,-4112.089999999997,83,30,104361.87000000004,100249.78
3277,UCBA146,113,-14807.679999999993,90,23,79205.65000000002,64397.969999999994
3278,U89436D,113,24800.760000000002,90,23,396758.85,421559.61
3279,U25CFC6,113,-71.06000000002422,97,16,164636.74,164565.68
3280,UE2E09B,113,49548.73999999999,88,25,162251.36,211800.1
3281,UA74F82,113,3055.380000000002,110,3,6145.379999999999,9200.76
3282,UFD7405,113,561.9999999999997,107,6,4427.07,4989.070000000001
3283,UB51AF0,113,2394.87,98,15,14104.15,16499.02
3284,U952D7C,113,-17632.919999999976,106,7,607051.6399999998,589418.7200000001
3285,UB91B8A,113,118835.67999999996,74,39,815554.24,934389.92
3286,UEEE800,113,-1399.0600000000009,104,9,13728.049999999996,12328.99
3287,U07826E,113,15852.990000000003,96,17,67042.88,82895.87
3288,U0EF0D9,113,-7568.6500000000015,106,7,33577.28,26008.629999999997
3289,U296C99,113,-310.2799999999952,85,28,198852.91,198542.62999999998
3290,U5D9950,113,36312.02999999999,80,33,482926.55,519238.57999999996
3291,U4F4D55,113,518.0400000000004,83,30,12610.279999999997,13128.320000000003
3292,U191691,113,645.5700000000008,74,39,19455.55,20101.12
3293,U6F66BE,113,-4879.780000000013,79,34,148820.03999999998,143940.26
3294,UFFF2E7,113,6646.690000000003,102,11,52841.44000000002,59488.12999999999
3295,U2D04C6,113,-2098.5599999999995,59,54,24064.780000000002,21966.22
3296,UC984DA,113,-113.56000000000063,97,16,29882.02,29768.46
3297,U7D9B8A,113,33811.31999999999,95,18,202551.75,236363.07
3298,UEDD1EE,113,-41933.97000000001,94,19,175316.57,133382.6
3299,U7AF1C2,113,-1983.1500000000005,99,14,21271.659999999993,19288.50999999999
3300,UA3CAC3,113,2916.3900000000003,84,29,33311.59,36227.979999999996
3301,UB7579A,113,129733.52,106,7,71204.73999999999,200938.26
3302,UFF9728,113,1639.9099999999999,104,9,7701.869999999997,9341.78
3303,U3DB3D0,113,-79770.83999999998,62,51,309514.54999999993,229743.71000000002
3304,U124CEC,113,-910.8999999999985,71,42,239962.48999999996,239051.59
3305,U35A6AD,113,-40047.550000000025,109,4,91531.08999999997,51483.54
3306,U9EB146,113,-5671.599999999999,94,19,17912.6,12241.000000000002
3307,U6353BC,113,618.55,79,34,5270.71,5889.259999999999
3308,UACE97B,113,22240.159999999985,94,19,196233.72999999998,218473.89
3309,UEAEDF8,112,-2906.2699999999995,96,16,3825.859999999999,919.5899999999999
3310,U2A4505,112,-530.8700000000008,83,29,9680.439999999997,9149.57
3311,U41C675,112,2378.96,65,47,45970.25,48349.20999999999
3312,UE5EAE5,112,-257.4500000000015,69,43,21702.62,21445.17
3313,U2DFF81,112,-12909.339999999998,55,57,21417.569999999996,8508.23
3314,U80B354,112,2225.8899999999985,95,17,13985.689999999999,16211.58
3315,U4D13EB,112,982.6499999999994,102,10,21532.69,22515.34
3316,U0EC4A3,112,655.7100000000028,97,15,636086.6599999999,636742.37
3317,U2DC227,112,-12132.890000000001,108,4,32671.390000000003,20538.5
3318,U07E767,112,27384.54000000002,104,8,55981.67,83366.21
3319,UCCFC54,112,29093.189999999995,52,60,233243.46999999997,262336.66000000003
3320,UD8568D,112,-106672.68999999999,109,3,111138.30999999998,4465.62
3321,UD4B3B5,112,7366.220000000002,97,15,15938.619999999995,23304.839999999997
3322,U39CF2E,112,2087.130000000002,108,4,22559.69,24646.82
3323,UEF2022,112,225.8399999999981,107,5,27454.97,27680.809999999998
3324,UFDC88A,112,24473.289999999968,87,25,1165378.75,1189852.0399999998
3325,UB53786,112,33265.530000000006,93,19,340583.71,373849.24
3326,U5B610B,112,-3006.5400000000004,92,20,22868.67,19862.13
3327,UC1C1CE,112,1521.2699999999995,90,22,19136.80999999999,20658.079999999998
3328,U2E2D99,112,-1635.819999999998,89,23,62917.04999999999,61281.229999999996
3329,U72A6C3,112,9812.740000000005,106,6,8278.72,18091.46
3330,UAC5F35,112,-135819.53000000003,101,11,238809.44,102989.91
3331,U684287,112,-5038.279999999999,107,5,8495.369999999999,3457.09
3332,U6FC6E8,112,-1172.1500000000005,111,1,3222.149999999999,2050.0
3333,UBA42E1,112,-3847.1500000000015,104,8,40996.64,37149.49
3334,UA2AA3D,112,-1289.3599999999997,90,22,19786.74,18497.379999999997
3335,UC31034,112,-4323.160000000001,92,20,45209.16000000001,40886.00000000001
3336,U2A9FA4,112,-4512.710000000002,94,18,23837.23000000001,19324.52
3337,U65C0AA,112,7863.980000000003,50,62,76161.23000000001,84025.20999999999
3338,U4374D4,112,36013.41999999998,72,40,442512.33000000013,478525.75000000006
3339,UCE5C22,112,-20933.939999999988,88,24,991718.42,970784.4800000001
3340,U86B9AF,112,131.4399999999987,104,8,23198.919999999984,23330.36
3341,UD85AD9,112,326.02000000000226,84,28,42252.020000000004,42578.04
3342,U18CFB7,112,-3385.7000000000016,101,11,66359.61,62973.91
3343,U04A089,112,255.0799999999995,94,18,36001.06,36256.14000000001
3344,U6B5193,112,8339.03,107,5,16894.649999999998,25233.68
3345,U0E773B,112,4069.690000000005,88,24,81685.13,85754.81999999999
3346,U8A0227,112,4430.780000000001,85,27,33426.55000000001,37857.329999999994
3347,U3E7F6E,112,-2897727.42,84,28,6537434.2299999995,3639706.81
3348,U9DAC15,112,-12.079999999989466,90,22,89434.37000000001,89422.29000000001
3349,UDFC1BE,112,3284.79,107,5,2314.9,5599.6900000000005
3350,U59D5F0,112,-19787.850000000006,97,15,112367.20000000001,92579.35
3351,UE36A66,111,-141.86999999999819,86,25,24631.650000000005,24489.779999999995
3352,U2D2DD5,111,-340.2199999999998,101,10,12890.74,12550.519999999999
3353,UB5E2D0,111,-34.309999999999945,81,30,24007.36,23973.05
3354,U39A27F,111,739.8500000000031,75,36,315511.8199999999,316251.67
3355,U4A5ADF,111,-72607.99,92,19,246263.64999999997,173655.66000000003
3356,UC06A0B,111,-14228.439999999997,94,17,23852.410000000003,9623.97
3357,U2BFB0E,111,92053.21,83,28,90951.29,183004.49999999997
3358,UEC6A47,111,-2599.700000000001,95,16,21290.449999999997,18690.749999999996
3359,UD3A2F8,111,18477.960000000003,91,20,23837.78,42315.740000000005
3360,U72689A,111,-52935.78,104,7,74773.26999999999,21837.490000000005
3361,UF10648,111,-808.2899999999972,83,28,47040.71000000001,46232.42
3362,UE73A44,111,-497.52000000000004,86,25,3770.3200000000006,3272.8
3363,U2A5F51,111,-7776.689999999998,75,36,55461.68000000001,47684.99
3364,U63A816,111,2477.0,51,60,44850.0,47327.0
3365,UB6EB38,111,1731.0800000000008,104,7,11415.650000000001,13146.730000000001
3366,UAB0931,111,-3022.8799999999947,77,34,31348.589999999997,28325.71
3367,UB2F5CA,111,7378.959999999999,94,17,132555.74,139934.7
3368,U0CFADA,111,-2805.299999999994,99,12,18793.93999999999,15988.64
3369,UC2C7A0,111,42215.81999999998,107,4,7880.749999999999,50096.57
3370,U72E2C4,111,11.80000000000014,95,16,2439.34,2451.14
3371,UE058E0,111,12243.97,104,7,9922.6,22166.57
3372,UC06E34,111,3363.5299999999997,108,3,26668.370000000003,30031.9
3373,U3BB2B4,111,4848.7900000000045,74,37,144214.17999999996,149062.97
3374,UFC7CF4,111,5426.550000000001,77,34,137576.29,143002.84000000003
3375,U3CDC4D,111,8452.940000000004,103,8,34319.369999999995,42772.310000000005
3376,UFEDD90,111,-17644.210000000003,93,18,76698.48999999999,59054.28
3377,UFD784A,111,-4823.580000000002,101,10,281064.85000000003,276241.27
3378,U58D9F9,111,-3684.6800000000007,102,9,5564.65,1879.9699999999998
3379,U4AEC91,111,9207.2,104,7,17725.57,26932.77
3380,UDDB027,111,-902.2999999999977,102,9,21048.669999999955,20146.370000000003
3381,U44279A,111,-326.46000000000095,96,15,16873.94,16547.48
3382,U8A90EF,111,-19975.26000000001,52,59,1608871.01,1588895.75
3383,U3D33CD,111,-339.19000000000136,79,32,76580.57000000002,76241.37999999999
3384,U85D61C,111,-10567.200000000013,90,21,304104.93,293537.73
3385,UDA803F,111,1434.7499999999986,102,9,21600.179999999997,23034.929999999997
3386,U8E581C,111,-80840.6,107,4,197473.6,116633.0
3387,U8B9502,111,-2341.8600000000015,97,14,21455.47,19113.609999999997
3388,U738EDA,111,705.0900000000074,90,21,23325.249999999993,24030.339999999997
3389,UF4235F,110,-2659.6800000000003,93,17,10313.77,7654.09
3390,U237885,110,-9016.079999999998,68,42,397300.59,388284.50999999995
3391,UD43B7D,110,-2522.6800000000003,86,24,17860.129999999997,15337.45
3392,U2FBC5B,110,235.32999999999993,78,32,47505.74,47741.07000000001
3393,UD93925,110,20.30000000000291,66,44,332269.29999999993,332289.6
3394,U0DAA0F,110,-6089.68,71,39,64537.19,58447.51
3395,U541F14,110,-2945.5999999999976,105,5,43526.93,40581.33
3396,U3D8762,110,-435.3799999999998,108,2,2771.499999999999,2336.12
3397,UCAA19A,110,28371.12999999999,77,33,62120.93000000001,90492.06
3398,U90EC1E,110,18916.050000000017,83,27,350968.93000000005,369884.98
3399,U381C89,110,-2476.689999999996,106,4,20376.760000000006,17900.07
3400,U9D36C7,110,10406.120000000014,71,39,318539.41000000003,328945.52999999997
3401,U5461AD,110,6399.070000000002,96,14,9001.47,15400.540000000003
3402,U32E005,110,-7285.619999999973,82,28,689118.56,681832.9400000001
3403,U77AE61,110,-419.660000000002,95,15,79624.78,79205.12000000001
3404,UE9C1BF,110,-5537.429999999999,100,10,9508.669999999996,3971.2400000000002
3405,UEAD9C2,110,593.6199999999999,83,27,23901.52,24495.14
3406,U4CB985,110,-3019.4,61,49,45225.64,42206.24
3407,U90FF97,110,67.80000000001019,93,17,215933.66999999995,216001.47
3408,U79D0F3,110,36625.810000000005,79,31,36293.560000000005,72919.37
3409,U62F03F,110,-6852.0499999999965,102,8,36102.899999999994,29250.85
3410,U3D971A,110,-6066.300000000001,101,9,17301.879999999997,11235.58
3411,U6179C6,110,-61684.20999999999,62,48,274567.39,212883.18
3412,U948B7A,110,-13444.739999999994,99,11,37095.16,23650.42
3413,U1E6247,110,-4193.88,103,7,11616.670000000002,7422.79
3414,UD3FEC3,110,-418.4899999999999,104,6,8849.4,8430.91
3415,UC88F8D,110,385.99999999999915,101,9,6701.339999999999,7087.34
3416,U437BF7,110,-558.5000000000001,103,7,5869.6399999999985,5311.139999999999
3417,UCB605F,110,-22111.339999999993,92,18,55134.05000000001,33022.71000000001
3418,UCFB7CA,110,-4622.509999999998,89,21,53435.57,48813.060000000005
3419,UC3D7CA,110,4552.160000000001,91,19,9361.16,13913.32
3420,UF55EF4,110,-209.51999999999953,86,24,26276.98,26067.46
3421,U823D89,110,9533.579999999996,90,20,62222.51999999998,71756.1
3422,U93D39D,110,10119.960000000001,82,28,51632.630000000005,61752.59
3423,UEA12FE,110,2910.690000000002,98,12,22247.639999999996,25158.329999999998
3424,UC3D01B,110,20238.16,100,10,22210.79,42448.95
3425,U14D16B,110,21999.84,52,58,112936.72,134936.56
3426,U2386D9,110,-3657.55,107,3,5384.07,1726.52
3427,UD09595,110,15843.759999999978,96,14,174186.94999999995,190030.71
3428,U7E857C,110,47733.2,33,77,56964.35999999999,104697.56
3429,UE01AC4,110,-530.2699999999987,102,8,22622.81,22092.54
3430,UF43E08,110,-22461.320000000014,100,10,55429.47000000003,32968.15
3431,U638357,110,-26060.590000000004,91,19,105343.42999999998,79282.84
3432,U0E6578,109,1010.6399999999999,95,14,5602.8,6613.44
3433,UA83ACD,109,72456.76000000001,75,34,610084.48,682541.24
3434,U0AD44B,109,-2833.8600000000956,63,46,1361977.2900000003,1359143.4300000002
3435,U5EE8BA,109,-93725.36,62,47,110052.78000000001,16327.42
3436,UF19A61,109,-9257.17,102,7,27862.600000000002,18605.43
3437,U6EEF68,109,2080.1500000000005,102,7,9088.01,11168.16
3438,U3D333A,109,104.62999999999951,83,26,31171.979999999996,31276.609999999997
3439,UE0D572,109,-101559.09,72,37,226026.32,124467.23
3440,U246AAB,109,-55.67999999999337,91,18,15061.390000000001,15005.710000000001
3441,U7BAD46,109,-4900.05,89,20,18608.989999999998,13708.94
3442,U93DD13,109,46436.749999999985,95,14,99720.58,146157.33000000002
3443,UFE9F77,109,2490.8299999999986,96,13,10875.38999999999,13366.22
3444,UAEC322,109,-10581.770000000004,78,31,117533.24,106951.46999999999
3445,UDE59F1,109,-227.94999999999993,106,3,1326.7,1098.75
3446,U91F937,109,-51814.69000000001,80,29,301716.91000000003,249902.21999999997
3447,U3C4717,109,-9355.059999999992,64,45,60597.090000000004,51242.03
3448,U255240,109,-2722.6500000000005,108,1,2723.1500000000005,0.5
3449,U7B1480,109,-97.22000000000116,81,28,20565.019999999997,20467.8
3450,U1CF4BA,109,-3445.3199999999993,104,5,9816.81,6371.49
3451,UBE5578,109,9345.779999999999,103,6,26178.179999999997,35523.96
3452,UA43FDF,109,-248240.12999999992,95,14,460423.16,212183.03000000003
3453,UF46487,109,-436.3600000000011,104,5,6781.33,6344.969999999999
3454,U8F37D7,109,-6632.970000000001,92,17,89344.78,82711.81
3455,UEDDEB5,109,2849.4600000000005,94,15,24163.089999999997,27012.550000000003
3456,UDFBF45,109,-97062.15999999999,90,19,168684.03999999998,71621.88
3457,U16AEF6,109,-3558.1499999999974,99,10,20176.57999999999,16618.43
3458,UFB2611,109,-7040.579999999995,88,21,120673.77999999997,113633.19999999998
3459,UEE2132,109,-10452.129999999996,105,4,20591.13,10139.0
3460,U257FA5,109,-10695.409999999998,78,31,134175.02,123479.60999999999
3461,UED62C4,109,89782.38000000002,84,25,864336.3199999998,954118.7
3462,UD2A7DA,109,-398.5100000000019,88,21,145937.82,145539.31000000003
3463,U14FD80,109,943.70999999999,92,17,99972.65,100916.35999999999
3464,UFACB8E,109,6678.190000000045,64,45,452552.48000000004,459230.67
3465,UDE72FB,109,-35263.42,89,20,107924.95000000001,72661.53
3466,U3CE54A,109,2521.0000000000005,88,21,21119.39999999999,23640.400000000005
3467,U374339,109,-55.62999999999974,86,23,199293.38999999998,199237.76
3468,U3A0E5E,109,3228.21,103,6,10724.63,13952.84
3469,UC72F4B,109,58.03999999999732,73,36,71625.63,71683.67000000001
3470,U43625E,109,-3444.890000000004,73,36,97022.99999999999,93578.11
3471,U3888D6,108,-1224.3299999999954,95,13,75709.01000000001,74484.68000000001
3472,UFF0B6F,108,-2037.1099999999901,102,6,47866.34999999999,45829.240000000005
3473,UDD4193,108,4590.879999999992,66,42,267994.02999999997,272584.91000000003
3474,UFCAB17,108,4661.030000000002,102,6,9722.150000000001,14383.18
3475,UE798CF,108,-4529.95,94,14,30184.470000000005,25654.520000000004
3476,UC0B2F2,108,35997.29999999996,81,27,235193.54000000007,271190.83999999997
3477,UCC05FD,108,-497.3399999999974,95,13,25875.550000000003,25378.21
3478,U8A1927,108,1839.0300000000007,82,26,15166.290000000003,17005.32
3479,U93C3D0,108,-8499.84000000001,85,23,490114.8100000001,481614.97000000003
3480,U0A4DD8,108,4238.010000000004,102,6,14245.42,18483.43
3481,U37B2B5,108,-10566.140000000001,71,37,66982.86000000002,56416.72
3482,UBC45DD,108,11863.640000000001,87,21,25915.409999999996,37779.049999999996
3483,UDABD1B,108,15693.850000000006,54,54,723383.9,739077.75
3484,U2CB05A,108,51.70999999999899,99,9,20820.35,20872.059999999998
3485,UC00A21,108,-203.86000000000405,85,23,56890.2,56686.34
3486,UFFDE0B,108,-25211.180000000008,72,36,275736.9800000001,250525.80000000002
3487,U4F723C,108,-30881.830000000005,95,13,80190.01999999999,49308.189999999995
3488,UBFABE8,108,-12845.249999999918,80,28,1834070.2100000002,1821224.96
3489,U16C8A1,108,-27816.249999999993,70,38,305471.3099999999,277655.06000000006
3490,U5F88E2,108,1690.5400000000045,80,28,158345.65,160036.19000000003
3491,U62D5FC,108,-331.3400000000007,95,13,14742.73,14411.39
3492,U147C65,108,-3193.34,97,11,51672.89999999999,48479.56
3493,U51C64B,108,-3178.209999999999,98,10,14791.199999999999,11612.99
3494,U28441A,108,-1446.58,100,8,35509.01,34062.43000000001
3495,U51BCE1,108,-10587.110000000015,71,37,351068.51000000007,340481.4
3496,UF97625,108,-84251.73,95,13,209796.74999999997,125545.02
3497,UDD4804,108,-41292.079999999994,104,4,74608.18,33316.100000000006
3498,UFCDA29,108,1182.6800000000007,54,54,47698.45000000001,48881.13
3499,UF27319,108,-4750.7800000000025,94,14,86025.82,81275.04000000001
3500,UFD1DBD,108,-6924.549999999997,56,52,25249.85,18325.3
3501,U86629C,107,-9964.930000000002,99,8,20270.6,10305.67
3502,UEF8230,107,1819.9800000000005,82,25,7810.76,9630.74
3503,UCCEC96,107,-13989.220000000003,66,41,95040.04000000005,81050.82000000002
3504,U09D4C3,107,1762.2000000000003,71,36,4810.660000000001,6572.8600000000015
3505,UF40DF2,107,-3038.1200000000017,85,22,24622.210000000003,21584.09
3506,U9F5296,107,225.00999999999848,103,4,4624.299999999998,4849.3099999999995
3507,UF83E74,107,-3434.419999999998,94,13,44764.860000000015,41330.44
3508,U418F61,107,-6855.090000000004,96,11,44864.58,38009.49
3509,U9FF28F,107,40.36000000000149,97,10,6027.979999999999,6068.340000000001
3510,UCA0741,107,-18715.90999999997,87,20,313774.11,295058.19999999995
3511,U078B91,107,-720.49,98,9,10553.940000000002,9833.45
3512,U8B7432,107,22559.859999999993,94,13,17222.0,39781.86
3513,UDFA778,107,9974.060000000003,87,20,47404.85,57378.91
3514,U946838,107,25381.32000000001,100,7,26397.97,51779.29000000001
3515,U06170D,107,-743.9100000000007,104,3,4370.32,3626.41
3516,UC4C5E4,107,-2676.010000000002,87,20,59441.979999999996,56765.97
3517,U24C0F0,107,-7460.099999999996,102,5,23118.71,15658.61
3518,U16320A,107,77721.02000000002,83,24,199059.13,276780.15
3519,U8D3BA8,107,960.3899999999994,80,27,225445.45999999996,226405.85000000006
3520,U9CD464,107,248.59999999999854,105,2,5776.4000000000015,6025.0
3521,UAA1738,107,-743.8100000000001,86,21,4272.4,3528.5899999999997
3522,UFE8952,107,-498.97000000000185,65,42,23741.670000000006,23242.7
3523,U3D34BB,107,58225.59,92,15,26669.4,84894.98999999999
3524,U1BA03C,107,-2269.7999999999956,98,9,20366.859999999997,18097.059999999998
3525,U0A8C09,107,-388530.06000000035,102,5,504566.1400000003,116036.08
3526,UEDD846,107,-107453.46999999997,99,8,302795.1699999999,195341.7
3527,UF84341,107,11080.739999999998,90,17,123796.86000000002,134877.6
3528,U5B5F3C,107,3874.1400000000012,98,9,33265.07,37139.21
3529,U27D735,107,4.129999999987376,86,21,202649.01,202653.14
3530,U5961BB,107,-89967.38999999998,86,21,192659.87000000008,102692.48
3531,UF32C10,107,3513.6699999999996,82,25,23858.94,27372.609999999997
3532,UE93503,107,-14026.220000000028,79,28,369478.6900000001,355452.47
3533,UC830DC,107,122.2899999999936,64,43,101249.58000000005,101371.87
3534,U36CB64,107,129.41999999999962,84,23,5382.01,5511.43
3535,U923DDD,107,-7169.489999999991,60,47,486140.12,478970.63
3536,UD3623D,107,-18910.359999999997,101,6,106538.91000000002,87628.55
3537,U841D23,107,-18367.120000000024,93,14,143919.49,125552.37
3538,UD69882,107,-13612.98,82,25,93855.79999999999,80242.81999999999
3539,UF64D80,107,10894.949999999995,68,39,57894.479999999996,68789.43
3540,U8245B7,107,-2719.5099999999998,103,4,10808.660000000005,8089.15
3541,U2D8DFE,107,3412.999999999998,96,11,12177.569999999994,15590.57
3542,U598194,107,-1510.75,74,33,44823.16,43312.41
3543,UED4E55,107,12605.470000000008,88,19,54678.94000000001,67284.41
3544,UB4A182,107,-654.3400000000001,95,12,18307.09,17652.749999999996
3545,UD60A97,107,-459.23000000000053,103,4,11422.41,10963.18
3546,UA936D7,106,90.31000000001424,95,11,169000.49,169090.8
3547,U9EEF82,106,-876.0499999999993,89,17,96995.96,96119.91
3548,UD5C526,106,1244.1399999999999,92,14,11327.409999999998,12571.55
3549,UCDDB68,106,1881.8200000000008,86,20,62127.88,64009.7
3550,UBF2D70,106,5030.76,89,17,9005.33,14036.09
3551,UE009B1,106,138.73000000000013,65,41,48671.22000000001,48809.950000000004
3552,U3A142D,106,61378.92000000003,94,12,188029.11,249408.03000000003
3553,UAEB2FA,106,-69020.47999999998,104,2,108305.35999999999,39284.880000000005
3554,U4079D1,106,5816.680000000003,94,12,68381.65,74198.33
3555,U82E3B7,106,-316.29999999999836,100,6,8658.529999999997,8342.23
3556,U533FE8,106,-10544.870000000006,99,7,51234.29000000001,40689.42
3557,UC5AD89,106,172.59999999999673,87,19,49749.47000000001,49922.07
3558,UF5E37A,106,-721.1400000000002,95,11,25408.989999999998,24687.849999999995
3559,U8083FC,106,5477.979999999999,102,4,9734.920000000006,15212.9
3560,U99DD1D,106,-608.4999999999998,104,2,4841.2,4232.700000000001
3561,UC6F10F,106,-3812.1700000000096,86,20,113283.70999999998,109471.54
3562,U2C967B,106,1577.4400000000028,93,13,34226.67000000003,35804.11
3563,U23CEFC,106,67.9000000000051,81,25,117116.43000000002,117184.32999999999
3564,U824C7F,106,-7463.6500000000015,104,2,9644.620000000003,2180.97
3565,U96B6F1,106,13201.279999999999,67,39,87169.48000000001,100370.76000000001
3566,U44FF0A,106,12126.78,98,8,54618.79,66745.56999999999
3567,UDAF04F,106,13928.239999999994,88,18,288878.31999999995,302806.56
3568,UC6DE9B,106,-9979.42,101,5,13301.429999999997,3322.01
3569,UA58382,106,-24250.190000000013,69,37,107508.79999999997,83258.61
3570,U6A8BFD,106,2859.6699999999973,84,22,49741.420000000006,52601.09
3571,U608F11,106,-3342.42,70,36,185843.47,182501.05
3572,UE62E69,106,1.1600000000022557,53,53,34078.98000000001,34080.14
3573,U20029D,106,986.8600000000015,86,20,152619.86000000002,153606.72
3574,U721E1C,106,1957.0399999999997,70,36,59863.729999999996,61820.77
3575,UC01A9A,106,193.7900000000001,99,7,2653.3100000000004,2847.1000000000004
3576,U3894F6,106,7204.1500000000015,58,48,339960.95,347165.1
3577,UF09A67,106,-134.6299999999901,67,39,986736.55,986601.92
3578,U976851,106,-44.369999999998626,76,30,38578.25000000001,38533.88
3579,U087861,106,-6155.259999999998,102,4,18790.230000000003,12634.970000000001
3580,U0D6711,106,1273.2000000000007,86,20,61381.95,62655.15
3581,U13B13D,106,-117.26999999999987,87,19,9108.139999999996,8990.87
3582,U0A7482,106,5534.010000000001,58,48,29430.190000000002,34964.2
3583,U052721,106,7232.910000000002,88,18,31664.610000000008,38897.52
3584,UEB1155,106,-2368.95,83,23,25628.730000000003,23259.780000000002
3585,UFF49D1,106,-49.17000000000007,88,18,19330.14,19280.97
3586,UEBF94E,106,-30485.630000000005,72,34,132547.46000000002,102061.83000000002
3587,U5D5941,106,-734.4399999999277,60,46,961378.9,960644.46
3588,UE3E096,106,-5538.94,84,22,27363.23,21824.289999999997
3589,UC1DFDA,105,-805.210000000003,93,12,46051.19000000001,45245.979999999996
3590,UC36348,105,19136.62999999999,45,60,459601.4,478738.03
3591,U8F6692,105,-2843.46,99,6,14944.9,12101.44
3592,U440786,105,14228.359999999997,90,15,147280.71,161509.07
3593,UA3213E,105,-3383.970000000002,94,11,44914.81,41530.840000000004
3594,U5E1ED5,105,7549.090000000004,80,25,240229.51,247778.6
3595,U0154AF,105,-10259.969999999998,99,6,29697.16,19437.19
3596,UDC8B1C,105,-2896.9600000000128,85,20,43694.740000000005,40797.78
3597,U0FA86D,105,22123.829999999976,47,58,380094.37000000005,402218.20000000007
3598,U48E695,105,7271.03,79,26,13704.41,20975.44
3599,UEEB4FF,105,-1986.8499999999995,99,6,17299.25,15312.400000000001
3600,U443D3F,105,6925.1500000000015,84,21,13797.500000000002,20722.649999999998
3601,UF81A4F,105,-80824.34,99,6,111874.20999999999,31049.870000000003
3602,UDC80DF,105,21810.749999999993,84,21,164753.05999999994,186563.81
3603,U26DE16,105,-13012.260000000004,90,15,41538.92999999999,28526.670000000002
3604,U953EA3,105,-111.15000000000002,100,5,315.19999999999993,204.05
3605,U2B9AB2,105,1511.6400000000008,98,7,11788.27,13299.910000000002
3606,UC94FCC,105,255.3000000000004,92,13,5106.069999999997,5361.37
3607,U50630E,105,32.990000000000094,102,3,1908.1899999999966,1941.18
3608,U99277C,105,1906.739999999998,52,53,74722.69999999997,76629.44
3609,U130EAB,105,7832.610000000046,93,12,1537833.05,1545665.66
3610,UEB02EC,105,-8710.780000000006,60,45,186506.55000000005,177795.76999999996
3611,U06570E,105,43199.44000000004,64,41,513461.89,556661.33
3612,UC6CDF8,105,-88.71000000000004,97,8,3537.600000000002,3448.89
3613,U419321,105,-3406.319999999999,79,26,31967.160000000007,28560.840000000004
3614,UA3D9DA,105,-2901.58,99,6,35613.58,32712.0
3615,UA3ABDD,105,1899.9500000000116,55,50,669225.2000000001,671125.1499999999
3616,UA71290,105,200273.69,95,10,117114.60999999999,317388.30000000005
3617,U5EB1B8,105,1135.2200000000055,97,8,34008.21000000001,35143.43
3618,U4F7443,105,-3619.6600000000026,84,21,20891.670000000006,17272.01
3619,U5C6269,105,30208.090000000084,70,35,435985.5,466193.59
3620,UF41520,105,-1761.46,90,15,14952.659999999996,13191.2
3621,U50BB39,105,-4997.08,99,6,14688.86,9691.78
3622,UCB1232,105,-9186.87,98,7,23447.38,14260.51
3623,U73A525,105,-2214.8700000000003,86,19,16739.82,14524.949999999999
3624,U2EA074,105,12.53000000000003,102,3,7837.609999999998,7850.139999999999
3625,U9E99C8,105,-4970.079999999998,88,17,81303.87000000001,76333.79
3626,UCD9D20,105,-28769.91999999998,53,52,42667.42000000001,13897.499999999996
3627,U0861E6,105,-829.4499999999989,95,10,19755.77999999999,18926.33
3628,UAD45C6,104,-29832.96000000001,69,35,166911.27999999997,137078.32
3629,UAB20CC,104,-1180.4899999999998,93,11,7453.960000000001,6273.47
3630,UAB09B9,104,66247.87999999999,83,21,393021.18000000005,459269.06000000006
3631,U59370B,104,-356.1099999999958,87,17,42523.869999999995,42167.76
3632,UF1FDC0,104,-31.879999999990105,50,54,42899.08000000001,42867.19999999998
3633,UED5F59,104,-46817.35999999999,80,24,430220.78999999986,383403.42999999993
3634,U43CFA4,104,252.1700000000005,75,29,9115.319999999998,9367.490000000002
3635,UFDF2D7,104,-1002.8500000000001,100,4,8884.849999999999,7882.0
3636,UEF4EC3,104,-399.2800000000032,85,19,66680.20999999999,66280.93000000001
3637,U4C2D46,104,11033.590000000004,83,21,270730.41000000003,281764.0
3638,U241D13,104,-2126.3999999999996,97,7,18510.39,16383.99
3639,UCE527C,104,-458.27999999999986,100,4,1108.92,650.6400000000001
3640,U774C33,104,-2705.269999999999,93,11,66961.99999999999,64256.73
3641,U0CEE06,104,6.250000000000085,101,3,1448.4599999999998,1454.71
3642,U205968,104,-387.6799999999962,93,11,75356.47000000002,74968.79
3643,UCAA610,104,-434.75,80,24,10879.75,10445.0
3644,UABF8EC,104,14517.429999999993,88,16,147263.68999999997,161781.11999999997
3645,UC5EFEC,104,3642.699999999999,92,12,30108.889999999992,33751.590000000004
3646,UE44257,104,-1226.4899999999998,86,18,23964.1,22737.61
3647,U0A91AE,104,-9312.000000000005,79,25,414114.79000000004,404802.79000000004
3648,U6DAE00,104,-89.73000000000013,100,4,6893.410000000001,6803.68
3649,UBFFFA9,104,973.9800000000027,64,40,32452.289999999997,33426.27000000001
3650,U02C349,104,20231.79,90,14,46784.29,67016.07999999999
3651,UFAD0CA,104,-595.3399999999975,92,12,26543.6,25948.26
3652,U4F454C,104,1042.7000000000003,96,8,13378.04,14420.740000000002
3653,UAC0A00,104,-16038.720000000001,90,14,38344.65999999999,22305.94
3654,U8852E2,104,34533.39,63,41,577304.7400000001,611838.13
3655,UD1F706,104,19.680000000000064,54,50,8539.810000000001,8559.49
3656,U903D96,104,-13356.33,101,3,17801.3,4444.969999999999
3657,U8DB7BD,104,843.49,69,35,17604.16,18447.65
3658,UD6EF17,104,1056.7600000000002,73,31,26296.13,27352.89
3659,U3DEDCA,104,-5358.130000000003,98,6,15621.679999999986,10263.55
3660,UACFD87,104,6059.5599999999995,95,9,7977.62,14037.18
3661,UFC1E6F,104,-57986.00000000023,66,38,5360864.61,5302878.609999999
3662,U981CB3,104,1391.0700000000006,99,5,6022.219999999999,7413.29
3663,U366BE7,104,-936.2500000000026,80,24,69695.81999999999,68759.57
3664,U5EFA46,104,-16112.640000000001,93,11,60213.909999999996,44101.27
3665,UF78BF7,104,2215.0800000000154,90,14,164335.20999999996,166550.29
3666,U6AE554,104,18130.050000000003,65,39,805894.85,824024.9
3667,UFF17CE,104,3686.6499999999965,91,13,34909.15,38595.8
3668,U401F7C,104,59178.56000000001,78,26,147508.22,206686.78
3669,UDBCF18,104,9956.780000000002,95,9,23939.22,33896.0
3670,U799DDC,104,-10739.02,59,45,89750.34999999999,79011.33
3671,U42F5AE,104,-2846.3799999999937,87,17,13900.829999999994,11054.45
3672,UBD9B48,104,-407.7199999999998,101,3,3478.37,3070.65
3673,UD90408,104,-1649.3099999999993,99,5,15711.279999999992,14061.970000000001
3674,UE8D2EB,104,-2587.709999999998,95,9,33488.21000000001,30900.5
3675,UF84FCC,104,6354.490000000001,95,9,60185.1,66539.59
3676,U64A33D,104,-21159.89,50,54,68930.0,47770.11
3677,U21A734,103,-1664.4500000000016,80,23,130148.61,128484.16
3678,U99B06D,103,-12305.530000000004,59,44,40282.90000000001,27977.370000000003
3679,U82BE1C,103,471647.92999999947,75,28,7303076.03,7774723.96
3680,U8F0CA8,103,-36922.900000000016,69,34,434837.60000000003,397914.7
3681,U1D8591,103,770.3100000000004,91,12,18093.35,18863.660000000003
3682,UEDB677,103,-11490.799999999994,86,17,65935.9,54445.100000000006
3683,U285804,103,-220.17000000000036,100,3,3763.1000000000004,3542.93
3684,U023E23,103,-723.7200000000007,91,12,4857.820000000001,4134.1
3685,UDFE86E,103,29084.92000000002,67,36,187985.91,217070.83
3686,U204B60,103,103.82000000000102,72,31,14165.25,14269.069999999994
3687,U2529B5,103,1702.6800000000005,80,23,34045.07000000001,35747.75
3688,U6A3AA7,103,131.22999999999956,71,32,16656.129999999997,16787.36
3689,U7DE22B,103,-1273.0099999999966,90,13,31511.28,30238.27
3690,U4FBA65,103,547.6000000000001,93,10,11992.399999999998,12540.0
3691,U482955,103,-251.96000000000168,97,6,9203.050000000003,8951.09
3692,UAA9164,103,53230.09,83,20,257732.45999999996,310962.55
3693,U4355A6,103,63323.7,35,68,97453.2,160776.9
3694,U7EE2F1,103,1605.8600000000015,86,17,60960.530000000006,62566.39
3695,UEFB96B,103,-416.9900000000007,97,6,8698.219999999998,8281.23
3696,U38B298,103,1468.0199999999977,87,16,52116.04,53584.060000000005
3697,UC6B327,103,15161.660000000002,91,12,14077.879999999997,29239.54
3698,U586AFD,103,14744.199999999999,93,10,24670.42999999999,39414.63
3699,U4B2AE4,103,30263.550000000003,90,13,37401.96,67665.51
3700,UDEC5D9,103,-579.809999999999,96,7,9975.060000000001,9395.25
3701,UFDA08C,103,-846.1500000000004,80,23,8233.39,7387.239999999999
3702,UC5D2C8,103,3049.8,100,3,6990.3,10040.1
3703,U52D699,103,3849.8899999999976,70,33,123967.73000000003,127817.61999999998
3704,U1327F9,103,-47987.75,97,6,68732.39,20744.64
3705,UCAD966,103,1851.9200000000012,92,11,25467.210000000003,27319.129999999997
3706,UFDB6FE,103,4463.879999999998,81,22,83379.14999999998,87843.03
3707,UE589DF,103,-6881.960000000003,93,10,29142.609999999997,22260.649999999998
3708,UB76459,103,-4616.93,89,14,15165.56,10548.63
3709,UFC552B,103,52664.88000000001,42,61,269810.36,322475.24
3710,U8B3851,103,3448.6100000000097,66,37,248389.04000000004,251837.65000000005
3711,U627976,103,613.1800000000038,76,27,27666.569999999996,28279.749999999996
3712,UF8259A,103,1739.7000000000028,79,24,44245.05,45984.75
3713,U42BE90,103,-5397.48,97,6,19383.760000000002,13986.279999999999
3714,UDF5553,103,-3031.4300000000003,81,22,31324.7,28293.270000000004
3715,U036ACD,103,5571.240000000004,94,9,4452.600000000001,10023.84
3716,U9A59F0,103,-240.82999999999936,93,10,4263.76,4022.9300000000007
3717,UF1BDDF,103,-2662.9699999999993,67,36,93631.43,90968.46
3718,UAE4B39,103,-519.3499999999992,82,21,14929.53,14410.179999999998
3719,U1797F2,103,5774.659999999996,75,28,35107.85,40882.509999999995
3720,UED463A,103,-4089.0799999999995,99,4,30193.62,26104.54
3721,UFA082B,103,2961.489999999998,76,27,96886.32999999999,99847.81999999999
3722,U7CF722,103,3461.580000000001,92,11,21507.51,24969.090000000004
3723,UD3270C,103,20838.270000000004,54,49,122802.36,143640.63
3724,U56B887,103,-13076.810000000001,83,20,27959.849999999995,14883.04
3725,UB03DE0,103,-3640.1200000000053,74,29,77351.33000000003,73711.20999999999
3726,U0566F2,103,12947.470000000003,88,15,44033.67,56981.14
3727,U593100,103,-3599.92,94,9,10861.770000000002,7261.85
3728,UC9826C,103,-1331.5499999999993,88,15,12469.649999999994,11138.1
3729,U4F4B1C,103,271.6899999999978,66,37,76356.82999999999,76628.52
3730,UC65E8F,103,21108.979999999978,83,20,189251.35000000003,210360.33
3731,U45CB7D,103,11983.21000000001,76,27,184536.54999999996,196519.76
3732,UCB9A74,103,105.37000000000037,88,15,7237.2300000000005,7342.6
3733,UF6075A,103,-5396.569999999997,99,4,17222.919999999995,11826.35
3734,U86930D,103,-16758.409999999996,77,26,258554.52,241796.11
3735,UA9252F,102,-9197.509999999998,97,5,19172.58,9975.07
3736,U8C0C98,102,-56443.16999999999,85,17,254452.99,198009.82
3737,UDC1D62,102,-8025.200000000001,82,20,149426.41999999998,141401.22
3738,U90B07E,102,6591.980000000011,95,7,9320.350000000002,15912.33
3739,U8DDECE,102,-889.5999999999999,95,7,8160.0,7270.399999999999
3740,U5F874F,102,15580.080000000004,93,9,42086.27000000001,57666.35
3741,U97DBDE,102,2398.960000000001,81,21,72129.25,74528.20999999999
3742,U8EF9E9,102,-2187.4999999999945,96,6,34344.99,32157.489999999998
3743,UAB727E,102,2895.269999999997,70,32,221889.39999999997,224784.66999999998
3744,U0EF866,102,-981.5000000000007,90,12,8585.710000000001,7604.210000000001
3745,U0425B8,102,30507.800000000003,88,14,7546.93,38054.729999999996
3746,UFDED3B,102,1431.8599999999985,87,15,16805.229999999996,18237.09
3747,U1FBBA7,102,111307.76000000001,98,4,79562.24,190870.0
3748,UAC07CE,102,-11454.040000000005,70,32,79360.69,67906.65
3749,U1B8507,102,-8675.55,94,8,12330.04,3654.49
3750,U870E3E,102,-5448.460000000001,98,4,9958.150000000001,4509.6900000000005
3751,UDBDE24,102,-330.0399999999995,82,20,10310.78,9980.74
3752,UA8E3D2,102,-177.20000000000024,87,15,20392.55,20215.350000000006
3753,U1047E0,102,1691.090000000017,74,28,216090.08,217781.17000000004
3754,U2FB7AA,102,326.5399999999997,90,12,38607.509999999995,38934.05
3755,UBE2D2D,102,-29100.160000000014,95,7,49747.44,20647.28
3756,UF37ED7,102,46.36999999999767,74,28,24724.780000000006,24771.149999999998
3757,UE0A92D,102,-1261.1399999999996,85,17,11193.05,9931.91
3758,UC6EB22,102,2232.060000000001,85,17,42437.41,44669.47
3759,U9AD0D4,102,-2651.040000000004,85,17,82424.12999999998,79773.09
3760,U961675,102,2157.67,89,13,13681.199999999997,15838.87
3761,U6BA7B9,102,-3881.8500000000186,82,20,53041.98000000001,49160.13
3762,UCC76A7,102,-3123.899999999991,37,65,281951.56,278827.6599999999
3763,U0E8E9A,102,3213.560000000001,93,9,21591.090000000004,24804.649999999998
3764,U0A6225,102,-1836.050000000002,98,4,19626.120000000003,17790.07
3765,UC59D21,102,123218.39,92,10,8658.08,131876.47
3766,UCC7C68,102,2595.11,90,12,10280.9,12876.01
3767,U89DF30,102,2384.5000000000055,93,9,17513.969999999994,19898.47
3768,U338E0F,102,-37750.44000000001,93,9,77303.40000000001,39552.96
3769,U3EFCCB,102,-15400.689999999995,93,9,67611.82,52211.13
3770,U85E439,102,-2562.4,99,3,12069.580000000002,9507.18
3771,U2FF8B2,102,-1079.7399999999996,86,16,20929.95,19850.21
3772,U102DB6,102,34000.5599999998,93,9,91758.28999999992,125758.85
3773,UEF571E,102,2339.7499999999973,81,21,43023.14000000001,45362.89
3774,U48EAA0,102,3961.84,95,7,20381.15,24342.99
3775,U175B5F,102,15712.349999999995,90,12,36891.84,52604.19
3776,U300B7B,102,143.83000000000118,70,32,30794.089999999997,30937.920000000002
3777,UD6F478,102,583.1200000000053,85,17,71395.42,71978.54
3778,UD4226F,102,-1221.8500000000006,92,10,18389.219999999998,17167.37
3779,U8A46CB,102,-1315.1600000000003,92,10,9625.399999999998,8310.24
3780,UB09BB4,102,-4603.62,90,12,14079.02,9475.399999999998
3781,U550A2B,102,-8717.719999999998,86,16,18980.999999999993,10263.279999999999
3782,U8EE4A6,102,-48111.240000000005,93,9,70930.58,22819.34
3783,U235C91,101,2651.039999999998,94,7,13078.169999999995,15729.21
3784,UBC94F8,101,119.47999999999956,65,36,244809.33000000002,244928.81
3785,UC1716E,101,-4002.889999999985,86,15,756872.08,752869.19
3786,U41F2DA,101,-11030.659999999998,55,46,64666.48999999999,53635.82999999998
3787,U74E6AD,101,-3921.0099999999984,88,13,199969.88000000003,196048.86999999997
3788,UEE8287,101,3486.330000000038,92,9,319821.16,323307.49
3789,U25135C,101,6334.099999999985,80,21,244607.37,250941.47
3790,UB82A72,101,69.53999999999996,98,3,379.49999999999994,449.04
3791,U8FF5AA,101,7360.459999999997,96,5,14898.73,22259.19
3792,U2DA9A1,101,19724.010000000006,80,21,50483.259999999995,70207.27
3793,UD5EF53,101,-16595.48000000001,72,29,229924.38,213328.9
3794,U398F08,101,22780.049999999996,76,25,38910.22,61690.270000000004
3795,UD3D577,101,148.76000000001727,86,15,119648.65000000001,119797.41
3796,U6C565F,101,3735.3599999999997,84,17,13805.149999999998,17540.51
3797,U01D401,101,17545.12000000001,73,28,229041.96,246587.07999999993
3798,UF11E6F,101,-41479.799999999996,73,28,163129.35000000006,121649.55
3799,U1337AB,101,17.76000000000022,84,17,8779.04,8796.8
3800,U0317F0,101,-9646.970000000001,72,29,1725417.32,1715770.3499999999
3801,U457C85,101,-401.9400000000002,66,35,24486.339999999993,24084.4
3802,U863B04,101,900.0000000000005,62,39,19316.26,20216.260000000002
3803,U8B2CB2,101,129.47999999999965,56,45,12823.479999999998,12952.960000000001
3804,U54D53A,101,-783.4100000000002,98,3,5130.619999999998,4347.21
3805,U891235,101,-62.919999999998254,81,20,55412.94,55350.02
3806,U2DC538,101,662.3099999999996,67,34,7089.4199999999955,7751.730000000002
3807,U001945,101,487.2700000000011,84,17,10813.750000000004,11301.02
3808,U42927F,101,60498.03999999999,81,20,25451.549999999996,85949.59
3809,U861DFC,101,100.63000000000125,71,30,29243.46,29344.090000000004
3810,U1023DB,101,-3275.189999999999,96,5,17969.3,14694.11
3811,UB787EE,101,-12406.629999999997,96,5,26056.779999999995,13650.150000000001
3812,UE4AA0A,101,59779.70999999998,88,13,110724.86000000002,170504.57
3813,UD5E970,101,18937.70000000001,38,63,215736.64,234674.34
3814,UF9A6B2,101,-2709.699999999997,70,31,159525.57,156815.87000000002
3815,UDB7148,101,-41838.32000000001,93,8,67006.62999999999,25168.31
3816,U1533D2,101,341.6699999999994,62,39,4829.139999999999,5170.81
3817,U70AC21,101,-51883.809999999976,80,21,237581.59,185697.78
3818,U7D6D03,101,133.04999999999967,84,17,9429.010000000004,9562.06
3819,U791F01,101,-589.0799999999989,96,5,21363.079999999994,20774.0
3820,U368F17,101,-29190.429999999993,75,26,244260.41,215069.97999999998
3821,UDCC974,101,6467.399999999616,48,53,14863758.79,14870226.190000001
3822,UEF1B58,101,358.0400000000009,76,25,6663.87,7021.91
3823,UD9724F,101,3284.490000000003,47,54,65420.23000000001,68704.72
3824,UE33363,101,-3906.4699999999993,67,34,259352.95999999996,255446.49
3825,UB1F398,101,-5375.469999999999,91,10,14251.49,8876.02
3826,U62B356,101,1377.340000000002,65,36,88679.43000000001,90056.77
3827,U7BF3E9,101,-1663.1099999999965,72,29,15100.259999999998,13437.15
3828,U35741A,101,55784.509999999995,81,20,354894.33999999997,410678.85
3829,UC1CF7A,101,6023.480000000002,94,7,12366.789999999997,18390.27
3830,UDFE4B7,100,328.3300000000001,98,2,3378.039999999999,3706.37
3831,U4C6987,100,2652.760000000001,91,9,6298.669999999999,8951.43
3832,UBD72D9,100,197.13000000000412,92,8,42917.78,43114.91
3833,UA7CABC,100,-3742.1400000000003,87,13,48188.53999999999,44446.4
3834,U18D384,100,-284.68999999999954,81,19,8848.539999999999,8563.85
3835,UDF65D7,100,-5396.15,93,7,9094.76,3698.61
3836,U3DE578,100,-49072.28000000001,96,4,91480.37000000001,42408.09
3837,U7C1B41,100,794.1000000000026,93,7,30735.51,31529.61
3838,U37C0B7,100,-4169.309999999996,77,23,94424.23,90254.92
3839,U8C1EA2,100,3166.6300000000065,74,26,105487.40999999999,108654.04
3840,U93DB8D,100,-194.03000000000043,89,11,12153.340000000004,11959.31
3841,UE1C7F0,100,13331.119999999994,84,16,31473.270000000008,44804.39
3842,UF26FA4,100,4690.190000000002,77,23,394529.08999999997,399219.2799999999
3843,U962441,100,1726.5999999999972,89,11,29933.09,31659.69
3844,UE803E1,100,2767.4000000000015,78,22,322834.41,325601.81
3845,U263148,100,-5049.429999999995,97,3,16404.349999999995,11354.92
3846,UF5966E,100,-51542.610000000015,76,24,547689.2,496146.59
3847,U8D7381,100,6569.190000000003,79,21,3812.8200000000006,10382.01
3848,UC3CD54,100,-86.98999999994703,55,45,783721.38,783634.39
3849,U83FB04,100,20423.93,73,27,396339.23,416763.16000000003
3850,UE69C72,100,457.52999999999975,69,31,23497.47,23955.0
3851,U0F1249,100,108.03000000000057,80,20,5157.01,5265.040000000001
3852,U37E707,100,-34930.42999999999,78,22,120049.85000000002,85119.42
3853,U813F94,100,-5503.989999999999,91,9,17431.690000000002,11927.7
3854,UEBD604,100,-9494.460000000001,90,10,58032.09000000001,48537.63
3855,U74676B,100,24.289999999999964,82,18,1813.1300000000003,1837.42
3856,U6DBFA1,100,-1879.2800000000004,87,13,17222.41,15343.13
3857,UEEA3B7,100,-19994.01999999999,89,11,129270.55,109276.53
3858,UE18684,100,7050.680000000002,86,14,25193.079999999998,32243.760000000002
3859,U7BADFF,100,-3902.2199999999953,95,5,23581.21999999999,19679.0
3860,UD67175,100,-8217.360000000004,55,45,91724.67000000003,83507.31
3861,U213175,100,20241.09,87,13,13346.100000000004,33587.189999999995
3862,U9B6061,100,1373.1799999999978,85,15,24594.339999999993,25967.519999999997
3863,U17E36A,100,85.98000000000138,83,17,10488.509999999998,10574.49
3864,UA19771,100,93263.57000000002,86,14,43558.12,136821.69
3865,U2A90FE,100,-38317.32000000001,70,30,102975.21,64657.889999999985
3866,U54F17A,100,425.87999999999977,91,9,9054.62,9480.5
3867,U18E3C4,100,-18098.170000000002,97,3,26075.729999999996,7977.56
3868,U206F27,100,-7695.739999999991,70,30,308230.43,300534.69
3869,UEECE5A,100,-812.470000000001,87,13,27902.640000000003,27090.17
3870,UB155A0,100,-4156.710000000003,71,29,82302.27999999998,78145.57
3871,UFF6AA9,100,-1184.1399999999994,65,35,58738.56,57554.42
3872,UF76A99,100,7219.790000000001,56,44,200435.09,207654.88000000003
3873,UFD44F1,100,-10043.93,73,27,38378.59,28334.660000000003
3874,U977D97,100,1246.1400000000008,85,15,34936.79,36182.93
3875,U02F2B0,100,-10077.619999999999,74,26,44018.03999999999,33940.420000000006
3876,UE05066,100,-402.150000000001,84,16,22267.84,21865.69
3877,U3BEA39,100,13423.359999999993,87,13,96860.01000000001,110283.37000000001
3878,UB428CA,100,23.44999999999709,55,45,70446.52,70469.97
3879,UEAAF78,100,-840.28,82,18,17013.52,16173.24
3880,U3137E6,100,1131.4000000000026,97,3,18053.82,19185.22
3881,UBA42F0,99,-7832.92,95,4,19096.62,11263.7
3882,U5D65D7,99,2268.08,86,13,7835.5999999999985,10103.68
3883,U96D20B,99,-5921.209999999999,83,16,17437.559999999998,11516.35
3884,U0FA8C2,99,-2363.8099999999986,91,8,42150.0,39786.19
3885,UDD70A2,99,-787.1400000000002,89,10,27452.78,26665.64
3886,UD1CC22,99,-21687.090000000007,67,32,198763.3299999999,177076.24
3887,UAD2C30,99,-31440.180000000015,77,22,129298.62000000002,97858.43999999999
3888,U28C910,99,4469.359999999986,62,37,613508.21,617977.5700000001
3889,U737F32,99,-3953.079999999999,69,30,31825.090000000004,27872.010000000006
3890,U748F6C,99,-6114.169999999999,87,12,19546.289999999997,13432.119999999999
3891,U76C2C6,99,155.94999999999965,83,16,27275.5,27431.45
3892,U35F843,99,-16520.18999999998,86,13,68473.07999999997,51952.89
3893,U9A3BE6,99,1577.0900000000074,80,19,81698.98000000004,83276.07
3894,U24F41D,99,-5.820000000000164,86,13,3372.06,3366.24
3895,U248270,99,159.72000000000082,72,27,21386.46,21546.179999999997
3896,U12F569,99,-744.1599999999984,96,3,10857.659999999998,10113.5
3897,U16C89D,99,16000.550000000003,80,19,133430.58000000002,149431.13
3898,U940F79,99,1444125.31,79,20,1793172.22,3237297.5300000003
3899,UE98AD7,99,221876.54000000007,58,41,924657.56,1146534.0999999999
3900,UD366FD,99,-4433.9000000000015,91,8,9469.929999999998,5036.03
3901,UEFB3ED,99,46560.479999999974,89,10,341848.87,388409.35000000003
3902,UDF62E4,99,-2432.81,85,14,57790.729999999996,55357.92
3903,U15D744,99,-1227.8500000000013,91,8,33839.049999999996,32611.199999999997
3904,U5F03A9,99,29705.930000000008,56,43,110624.72000000002,140330.65
3905,UF935C5,99,346.0399999999994,84,15,4843.469999999999,5189.51
3906,UF0B44D,99,-493.9000000000001,60,39,46144.079999999994,45650.18000000001
3907,U5EC000,99,219.31000000000017,71,28,23278.16,23497.47
3908,U1CD82A,99,70.18000000000757,93,6,155792.15,155862.33
3909,U1C26FB,99,-140498.81,85,14,226820.14,86321.33
3910,U075B9A,99,-4734.55,94,5,15046.7,10312.150000000001
3911,UB0F853,99,-31494.439999999995,70,29,87184.22000000002,55689.78000000001
3912,UA42889,99,-1109.3699999999994,87,12,7568.120000000001,6458.75
3913,U80D22E,99,-2933.959999999998,72,27,49036.13000000003,46102.170000000006
3914,UCF508B,99,9276.620000000017,87,12,110772.31000000003,120048.93000000001
3915,U2E18D9,99,-1342.359999999997,88,11,94909.43999999999,93567.08
3916,UA790C9,99,-10.469999999999686,91,8,3176.63,3166.16
3917,U89EFE1,99,1714.7900000000018,94,5,12355.979999999998,14070.77
3918,U7A8E1C,99,140684.55,70,29,173509.02000000002,314193.56999999995
3919,U2B10F3,99,48736.14000000001,80,19,90637.83000000002,139373.97
3920,UB9ADF8,98,3941.010000000003,84,14,123957.11999999998,127898.12999999999
3921,UC0C8C7,98,3.7700000000004366,55,43,18174.94,18178.71
3922,U2F83B8,98,10332.130000000001,81,17,88474.04000000001,98806.17000000001
3923,UD98010,98,-36685.780000000006,72,26,105485.12999999996,68799.34999999999
3924,UC4E50C,98,255159.91000000003,72,26,122593.48,377753.39
3925,U62C2E5,98,-1171.2100000000007,98,0,1171.2100000000007,0.0
3926,U567081,98,2646.930000000003,62,36,77887.77,80534.70000000001
3927,U64E308,98,-13765.0,90,8,26877.779999999995,13112.779999999999
3928,UF3AD6E,98,-1138.1600000000008,88,10,6416.040000000001,5277.879999999999
3929,U3072F9,98,-19105.68,87,11,84573.37,65467.69
3930,U1C9C27,98,-4256.439999999999,75,23,16324.51,12068.07
3931,U2AAFF6,98,-16539.809999999998,92,6,30072.209999999992,13532.4
3932,U849AD6,98,128.33999999999958,72,26,10907.78,11036.119999999999
3933,UD68A28,98,6654.279999999998,93,5,6202.480000000001,12856.759999999998
3934,UD9E9D2,98,-101019.0,72,26,300198.0,199179.0
3935,UCA584F,98,1274.8200000000031,82,16,80049.68000000001,81324.5
3936,U7876D0,98,92.56999999999994,69,29,10095.68,10188.250000000002
3937,U4B49D9,98,49660.97000000001,81,17,606828.26,656489.23
3938,UF6ACEC,98,62571.70999999999,72,26,406890.89,469462.6
3939,UD8378D,98,189.65000000000327,83,15,46508.41,46698.06
3940,U4327A3,98,-20257.34999999999,81,17,206504.20000000004,186246.85
3941,UDC8ACD,98,-61.57999999999811,84,14,47873.49,47811.91
3942,UE500D2,98,910.3599999999972,79,19,128305.65,129216.01
3943,U603BF5,98,-8675.759999999998,85,13,14157.07,5481.3099999999995
3944,UCE9876,98,-1023.1100000000006,92,6,6468.66,5445.55
3945,U376C53,98,993.6799999999998,92,6,4204.680000000001,5198.360000000001
3946,U1BEDE8,98,-21918.81999999999,82,16,77893.68000000001,55974.85999999999
3947,UC8B7B9,98,-933.3599999999929,84,14,55650.15000000002,54716.79
3948,U5706E4,98,-596.2900000000004,89,9,9996.55,9400.26
3949,UD71DD6,98,-32.71000000000009,86,12,6396.71,6363.999999999999
3950,U1A61D6,98,19878.740000000005,77,21,59545.979999999996,79424.72
3951,UC8DB42,98,-5394.150000000001,76,22,12339.79,6945.64
3952,U7E62F1,98,-219.28999999999974,96,2,1532.5599999999997,1313.27
3953,U2BA7DD,98,-541.9999999999975,94,4,21276.999999999996,20735.0
3954,UB5AC3D,98,84.65,55,43,13681.65,13766.300000000001
3955,U9244DC,98,420.24999999999943,92,6,6986.66,7406.91
3956,UFB5C16,98,-6228.050000000001,83,15,48910.59,42682.54
3957,U82046C,98,-19620.250000000004,87,11,103566.89000000001,83946.64
3958,U456E34,98,4714.97,83,15,75313.22999999998,80028.2
3959,UC2097F,98,6411.379999999999,71,27,65339.90000000002,71751.28000000001
3960,UD620D6,98,3653.42,78,20,11767.890000000001,15421.310000000001
3961,UB4B83B,98,50759.759999999995,89,9,14003.090000000002,64762.850000000006
3962,U415DB6,98,65223.16000000001,76,22,103991.23000000001,169214.38999999998
3963,U0B05D4,98,453.47999999999956,90,8,7761.080000000001,8214.56
3964,UD5FE67,98,138.90000000000038,91,7,2173.45,2312.35
3965,U9802F3,98,-30275.590000000004,76,22,253357.88000000003,223082.29000000004
3966,UA91E4F,98,11103.149999999963,45,53,701912.2400000001,713015.39
3967,UCE8A5B,97,-3191.8599999999924,58,39,172512.36999999997,169320.51
3968,U8FFD6F,97,-56160.039999999986,50,47,111273.37000000001,55113.33000000001
3969,U4E62AF,97,-361581.7,52,45,1661522.45,1299940.7500000002
3970,U7AD1B4,97,-139436.96000000008,86,11,535436.28,395999.32
3971,U82C2BE,97,-3199.5000000000005,88,9,6108.360000000001,2908.8599999999997
3972,U5FCE7A,97,-6465.289999999998,92,5,22382.23,15916.94
3973,UD92775,97,-8158.439999999999,77,20,72137.43000000001,63978.990000000005
3974,UCE4DBF,97,-307018.4199999999,57,40,1356818.7599999998,1049800.3399999999
3975,U310DC3,97,17564.89000000001,79,18,271692.9499999999,289257.84
3976,U3EDE42,97,-28596.17,69,28,85621.05,57024.88
3977,U6F6474,97,725.8699999999999,85,12,7061.08,7786.950000000001
3978,U017068,97,-5030.49,81,16,25585.66,20555.17
3979,UB359C5,97,164.5699999999996,75,22,15938.549999999997,16103.119999999999
3980,UA775A6,97,52.43999999999596,71,26,103713.85000000002,103766.29000000001
3981,U231DCD,97,-3.0699999999999363,64,33,6755.53,6752.459999999999
3982,U7DB2C6,97,114.70999999999026,76,21,329051.88,329166.58999999997
3983,UA21FFC,97,-15899.330000000002,86,11,30294.279999999995,14394.95
3984,U6611D0,97,-4622.689999999986,58,39,216064.91999999998,211442.23
3985,UEDE4B0,97,113437.75000000003,54,43,219376.5300000001,332814.28
3986,U40BC1A,97,40.609999999999964,86,11,6544.85,6585.46
3987,UC66A9C,97,-2284.9700000000007,78,19,16743.03,14458.060000000001
3988,U8DB5D5,97,4417.619999999994,76,21,35293.81,39711.43
3989,UA0AF61,97,1277.9599999999991,90,7,8383.039999999999,9660.999999999998
3990,U77850E,97,-1350.5500000000002,85,12,4897.939999999998,3547.3900000000003
3991,UE6D514,97,-18872.460000000003,90,7,30704.460000000003,11832.0
3992,UAA8D79,97,-2611.9900000000016,90,7,7666.950000000001,5054.96
3993,U86DB43,97,-1576.0799999999872,75,22,267262.96,265686.88
3994,U6B0291,97,-4270.64,81,16,15636.249999999995,11365.61
3995,U468C5B,97,-1070.19,88,9,4460.540000000001,3390.35
3996,U1E86A9,97,-1126.570000000002,76,21,28427.610000000015,27301.04
3997,U0C8553,97,-1418.7300000000014,87,10,31165.690000000006,29746.96
3998,U283881,97,-942.1400000000008,80,17,35142.18,34200.04
3999,U80D355,97,126.90000000000015,90,7,4221.84,4348.74
4000,UDA49B5,97,-1058.1699999999885,86,11,79924.39,78866.22
4001,U125871,97,-6814.400000000002,63,34,39763.82,32949.41999999999
4002,U18E5FF,97,0.2599999999999909,65,32,6526.0,6526.26
4003,UEB84CF,97,2117.330000000001,52,45,17701.97,19819.3
4004,UC9DDD4,97,260.47999999999956,93,4,5264.24,5524.719999999999
4005,UCAE383,97,-2870.4600000000073,78,19,200249.08000000002,197378.62
4006,UFE6675,97,74.79999999999993,93,4,483.19999999999925,558.0
4007,U42049E,97,-1747.6899999999996,95,2,4825.83,3078.1400000000003
4008,U165C89,96,2919.2099999999914,59,37,77050.43999999999,79969.65
4009,UC61F36,96,5995.339999999998,56,40,45052.83,51048.17
4010,U9F0F9D,96,-532.0900000000013,85,11,11804.159999999998,11272.07
4011,U559758,96,2892.8500000000026,81,15,13842.819999999998,16735.67
4012,UDBADF1,96,-208.8200000000004,87,9,24145.99000000001,23937.17
4013,UDADBB7,96,13898.880000000008,81,15,188958.69000000006,202857.57
4014,U44B878,96,-5332.86000000003,88,8,48944.86,43612.0
4015,UEC50EB,96,-18208.579999999994,61,35,101132.34999999999,82923.77
4016,U9B02CF,96,-4574.03,70,26,52608.89,48034.85999999999
4017,UD65BC8,96,334533.55999999994,79,17,134326.70999999996,468860.26999999996
4018,U031735,96,80.95000000000005,54,42,65973.55,66054.50000000001
4019,UF51621,96,502.30999999999904,48,48,78893.01,79395.31999999998
4020,UD735DA,96,-9953.230000000003,73,23,346616.27,336663.04000000004
4021,U10420B,96,4319.420000000001,90,6,27479.59,31799.01
4022,U2A7B25,96,-16.140000000002146,59,37,148668.90000000002,148652.76000000004
4023,UA71732,96,-16884.56,82,14,72550.31000000001,55665.75000000001
4024,U53F824,96,41365.240000000005,72,24,84496.15,125861.39
4025,UD067A8,96,-270.02999999999884,80,16,106457.27999999998,106187.24999999999
4026,U52C1FA,96,-6689.26,82,14,19029.769999999993,12340.51
4027,U27EA43,96,-725.1100000000006,87,9,6723.41,5998.300000000001
4028,UED6502,96,-14427.649999999998,85,11,127979.88,113552.23
4029,UB6F456,96,-5648.139999999999,90,6,14809.699999999997,9161.56
4030,UA96ABD,96,1672.8699999999997,93,3,2793.2000000000007,4466.07
4031,U1D87D4,96,0.6799999999998363,49,47,52036.81,52037.48999999999
4032,U9E4EF8,96,5349.34,93,3,8565.25,13914.59
4033,U845384,96,11653.650000000005,62,34,76939.06999999998,88592.71999999999
4034,U1E818A,96,-16598.660000000003,85,11,408880.69999999995,392282.04
4035,U661E5B,96,4.210000000000007,93,3,292.34000000000003,296.54999999999995
4036,U62BA7B,96,20999.48,88,8,116992.41,137991.89
4037,U55D4E9,96,-36729.67,82,14,142934.85,106205.18000000001
4038,UE92FC0,96,-5302.25,90,6,15429.99,10127.74
4039,U22EC4D,96,-9565.919999999996,79,17,12818.039999999997,3252.1200000000003
4040,U32A029,96,-9842.289999999997,89,7,44781.15999999999,34938.87
4041,U80278D,96,3163.140000000014,64,32,335495.63,338658.77
4042,U4C7CCE,96,57438.93999999999,90,6,24559.59,81998.53
4043,UCCEFF7,96,-8154.629999999997,91,5,29834.130000000005,21679.5
4044,UB0169F,96,-5303.949999999997,58,38,234449.63000000003,229145.68
4045,UE772F0,96,-4716.129999999999,86,10,9825.059999999998,5108.93
4046,U58238A,96,-1200.3699999999994,91,5,9663.209999999995,8462.84
4047,UE5964D,96,108.37000000000069,76,20,15370.100000000002,15478.47
4048,U4E5E00,96,-2094.839999999999,91,5,15346.810000000001,13251.970000000001
4049,U945B18,96,-3831.9400000000005,59,37,19881.96,16050.02
4050,UCBE23F,96,713.4499999999989,85,11,29715.249999999985,30428.7
4051,U2D825F,96,-74396.45999999999,87,9,126538.73,52142.270000000004
4052,U881940,96,26.440000000000282,73,23,8659.339999999998,8685.779999999999
4053,UCCBA44,96,-22962.639999999996,76,20,70463.74,47501.10000000001
4054,U397D9A,96,175.03999999998516,50,46,319707.61999999994,319882.66000000003
4055,UF4E735,96,-13299.669999999996,81,15,46004.87999999999,32705.21
4056,UB98B73,96,1.4499999999999935,62,34,123.50000000000011,124.95
4057,U79F0A1,96,-696.1299999999997,83,13,10435.03,9738.900000000001
4058,U7467A3,96,1409.550000000001,91,5,8525.1,9934.65
4059,UC6A44A,96,8776.41000000001,81,15,136429.59000000003,145206.0
4060,UE1BDD6,96,588.6300000000005,86,10,6667.320000000005,7255.95
4061,UBE7CCE,96,-989.7399999999996,83,13,33606.08,32616.340000000004
4062,UAAD54B,96,7085.880000000001,89,7,17501.05,24586.93
4063,UDC9B30,96,28.06999999999971,86,10,30656.9,30684.969999999998
4064,UBB219C,96,-3853.1900000000005,85,11,15060.389999999998,11207.200000000003
4065,U127C8B,96,-27.850000000000897,92,4,7872.85,7845.0
4066,U6039F2,95,-34858.649999999994,57,38,176385.76,141527.11000000002
4067,UAA99FF,95,-2827.4000000000005,88,7,10775.59,7948.1900000000005
4068,UA0D265,95,-4733.53,91,4,14844.529999999999,10111.0
4069,UE50306,95,-229.1499999999944,71,24,265644.73,265415.57999999996
4070,U683378,95,34831.80000000002,59,36,127388.75999999998,162220.56
4071,U04C368,95,48008.13,83,12,61816.98,109825.11
4072,U97BFB8,95,3261.1499999999987,78,17,2214.7099999999996,5475.86
4073,UA55C71,95,-439.03000000000924,76,19,109314.76999999997,108875.74
4074,U1314CB,95,-2736.04,80,15,23018.31,20282.27
4075,U9434BB,95,-255.75,60,35,16455.6,16199.849999999999
4076,UCD4830,95,557476.6100000001,41,54,197397.44,754874.05
4077,U4B1B3C,95,-2978.770000000001,69,26,15508.650000000007,12529.880000000001
4078,U052284,95,30819.52999999999,65,30,45164.66,75984.18999999999
4079,U1D8DA7,95,84001.15,41,54,594732.96,678734.1100000001
4080,UA87196,95,146.55999999999977,74,21,53136.54999999999,53283.11
4081,U730C12,95,-394.2300000000014,82,13,21466.77,21072.54
4082,UA203F9,95,-435.48,80,15,13588.53,13153.050000000001
4083,U59AE22,95,9222.060000000007,87,8,19480.609999999997,28702.67
4084,UC129B5,95,-10227.769999999999,92,3,15660.359999999999,5432.59
4085,U96D974,95,-1826.31,84,11,20717.450000000004,18891.14
4086,U025E03,95,1457.4700000000003,90,5,8859.719999999996,10317.19
4087,UF2D032,95,634.9499999999987,88,7,7143.590000000002,7778.54
4088,U551AFA,95,1.1368683772161603e-13,62,33,17958.67,17958.670000000002
4089,U0072DB,95,-9893.829999999998,68,27,55154.61000000001,45260.78
4090,UA84F05,95,2349.9799999999996,72,23,11212.35,13562.33
4091,U148506,95,13711.38,88,7,7903.039999999999,21614.420000000002
4092,UDB9804,95,-12539.799999999997,87,8,27098.69,14558.89
4093,U00DF75,95,-10269.490000000005,67,28,197509.78,187240.28999999998
4094,U3E0331,95,528.9100000000021,70,25,36913.19,37442.100000000006
4095,U69C678,95,-424.24000000000046,78,17,25965.769999999997,25541.53
4096,UBBE005,95,-8474.849999999999,86,9,12418.259999999998,3943.41
4097,U4E1737,95,16823.02999999999,82,13,49161.040000000015,65984.07
4098,U2E9EAF,95,-72402.57000000004,68,27,1452220.1300000006,1379817.5600000003
4099,UE67B46,95,-4075.780000000006,77,18,30724.64,26648.859999999997
4100,UB94E22,95,-147.59000000000378,49,46,299687.81,299540.22
4101,UC30985,95,17825.470000000005,53,42,242654.68,260480.15000000005
4102,UE477D9,95,1874.3400000000092,47,48,116919.57999999999,118793.92000000003
4103,U2BB8DA,95,-5688.819999999998,88,7,23199.60000000001,17510.78
4104,U7189C5,95,2200.4300000000007,77,18,21366.190000000006,23566.62
4105,UA09133,95,14481.079999999993,72,23,119355.58000000003,133836.66
4106,U111F2F,95,-4630.649999999987,63,32,246609.22000000003,241978.57
4107,UFB8268,95,-23821.960000000006,69,26,281152.87999999995,257330.92
4108,U18C172,95,-874.3900000000006,71,24,7066.01,6191.620000000003
4109,U358396,95,-1777.7499999999993,68,27,19913.579999999998,18135.83
4110,U799391,95,460.0199999999993,82,13,10249.98,10710.0
4111,U317FDA,95,-1393.0800000000002,79,16,20516.079999999998,19122.999999999996
4112,U880E03,95,-4982.049999999999,81,14,65255.600000000006,60273.55
4113,U41A813,95,-1245.8599999999997,86,9,8552.860000000002,7307.0
4114,UC66B28,95,-85007.09999999996,83,12,182607.09999999995,97600.0
4115,U7EF6D1,95,2452.030000000001,87,8,10695.369999999999,13147.4
4116,U6FF8BC,94,-1885.4100000000008,90,4,17163.18,15277.77
4117,U8D00B1,94,9002.0,86,8,5833.889999999997,14835.890000000001
4118,U8CE7E7,94,1398.329999999999,87,7,10227.99,11626.32
4119,U6EBAEE,94,-4821.34,69,25,23581.73,18760.39
4120,UD5A3D3,94,2307.4399999999987,64,30,15599.55,17906.989999999998
4121,UE9CB02,94,8.69999999999709,55,39,1864888.6199999999,1864897.32
4122,U882F4F,94,15482.95,74,20,40348.1,55831.049999999996
4123,U6C44C6,94,12395.659999999998,87,7,20129.399999999994,32525.06
4124,U36EE90,94,38606.5,75,19,336062.07,374668.57
4125,UD7F316,94,7982.870000000001,87,7,6721.490000000002,14704.36
4126,UE6E9A6,94,36651.34999999996,84,10,65489.85000000001,102141.2
4127,U0A9795,94,972.2799999999761,80,14,116322.84999999999,117295.13
4128,UE97FDC,94,1589.5399999999997,90,4,4718.979999999999,6308.52
4129,UEE76A0,94,-3880.400000000002,91,3,19961.19999999998,16080.8
4130,U12D6D3,94,-7787.999999999999,85,9,14405.22,6617.22
4131,U3CBC5D,94,-2244.9499999999994,92,2,10840.03,8595.08
4132,U9CE2C3,94,-15311.139999999992,71,23,150812.13999999998,135501.0
4133,U0EAFD7,94,462.2699999999995,70,24,20787.67,21249.94
4134,U15084E,94,-1038.510000000002,76,18,44093.689999999995,43055.18
4135,U364445,94,-39.50000000000066,67,27,3542.3200000000006,3502.8199999999997
4136,U42C86B,94,1430.1999999999998,87,7,9063.519999999999,10493.720000000001
4137,UB5ADBD,94,-238.78000000000046,92,2,554.6300000000002,315.84999999999997
4138,U2EBFC2,94,926.4699999999957,69,25,162899.34999999998,163825.81999999998
4139,U1CE7DD,94,4421.139999999999,77,17,123971.13,128392.27
4140,U190658,94,8718.1,66,28,55212.090000000004,63930.19
4141,UA702BB,94,-392.9200000000014,86,8,8552.919999999996,8160.0
4142,U62A7D7,94,572.1700000000001,84,10,16328.87,16901.04
4143,U514330,94,2899.510000000001,85,9,19145.589999999997,22045.100000000002
4144,UA8CFC8,94,59.06,72,22,2675.5,2734.56
4145,U5839F4,94,9698.79999999999,30,64,123370.95000000001,133069.74999999997
4146,UB09B05,94,137.92999999999984,83,11,4014.76,4152.6900000000005
4147,U118B06,94,-6653.410000000004,58,36,141374.05,134720.64
4148,U8F8B2F,94,938.5800000000017,87,7,38099.79,39038.37
4149,U4BAEB8,94,18.870000000000076,83,11,61498.950000000004,61517.82
4150,U976975,94,-35647.10000000011,68,26,646628.67,610981.57
4151,U3C33BD,94,-8151.009999999998,69,25,30277.01,22126.0
4152,U4AF9F9,94,-144801.53000000026,65,29,850175.68,705374.15
4153,U13403F,94,-492.5799999999995,67,27,27991.010000000002,27498.43
4154,U275364,94,-37315.08,85,9,97780.28,60465.2
4155,U4E2AEC,94,15119.940000000002,80,14,29938.379999999997,45058.32
4156,UEBA027,94,46066.610000000015,67,27,98256.12999999999,144322.74
4157,U47371F,94,-894.1700000000009,79,15,35219.880000000005,34325.71
4158,U80726E,94,-9345.979999999998,72,22,119910.31000000004,110564.33
4159,U363E3C,94,60830.509999999995,52,42,398863.95,459694.46
4160,UCBE580,94,22245.78000000001,77,17,71875.81999999998,94121.59999999999
4161,U7202B5,94,-4293.140000000001,72,22,33373.71,29080.57
4162,U753DB9,94,2315.2699999999995,80,14,16991.31,19306.579999999998
4163,U9B84D1,94,-12421.709999999963,52,42,450565.0,438143.29000000004
4164,UDFF159,94,-12476.4,89,5,17704.120000000003,5227.72
4165,U145651,94,-146.0700000000003,82,12,8790.44,8644.37
4166,UB250A0,94,-19501.930000000004,83,11,36027.730000000025,16525.8
4167,UA65326,94,42384.22000000001,55,39,134696.75,177080.97000000003
4168,UA90E58,93,1.3399999999999181,83,10,6124.43,6125.77
4169,U0782A3,93,7005.149999999996,83,10,147207.20999999996,154212.36
4170,U5DB227,93,-28314.82,71,22,112915.03000000001,84600.20999999999
4171,UAE81C6,93,273.87999999998,47,46,148031.53000000003,148305.41000000006
4172,UA161BB,93,361.6799999999982,82,11,7518.08,7879.76
4173,UD6ECA8,93,-4954.9,78,15,16862.18,11907.28
4174,UDC4EE5,93,-1873.0300000000002,81,12,12169.999999999998,10296.97
4175,UE27EA9,93,9041.03,75,18,16580.100000000002,25621.129999999997
4176,U5435E0,93,-132.3500000000023,82,11,18545.44999999999,18413.1
4177,UC89BA9,93,-29722.100000000006,57,36,58037.319999999985,28315.22
4178,UFE4A54,93,-567.119999999999,81,12,33064.26,32497.14
4179,U523EBC,93,-3391.62,90,3,6245.5,2853.88
4180,UF9EAD5,93,-400.8299999999999,83,10,12407.900000000001,12007.07
4181,U757CD2,93,702.7799999999987,84,9,17211.03,17913.81
4182,U2C7FBC,93,-31595.98000000001,87,6,37429.29000000001,5833.3099999999995
4183,UC55F23,93,-132.9100000000009,90,3,10037.909999999998,9905.0
4184,UE2D039,93,4343.250000000001,89,4,11384.269999999999,15727.52
4185,UEB5901,93,-4302.08,89,4,11128.879999999997,6826.8
4186,U8F32FD,93,698.7599999999991,68,25,7940.319999999999,8639.08
4187,UA811C4,93,12582.5,74,19,4416.35,16998.85
4188,U49F5DB,93,-7252.209999999999,89,4,11709.210000000003,4457.0
4189,UFB8D67,93,-4331.519999999995,84,9,24074.160000000007,19742.64
4190,U9DE18B,93,6461.9800000000005,78,15,11494.810000000001,17956.79
4191,U5E0A04,93,-7.700000000000017,73,20,1109.1,1101.3999999999999
4192,UB0234C,93,-3817.870000000015,48,45,415603.6399999999,411785.7699999999
4193,U477A0D,93,1630.0099999999998,91,2,2789.4100000000003,4419.42
4194,U9F1DC1,93,2494.1399999999985,83,10,8068.359999999997,10562.499999999998
4195,UC84485,93,-46111.77999999999,61,32,484176.22000000003,438064.44
4196,U708747,93,-4853.270000000048,69,24,621352.8000000002,616499.5299999999
4197,UE48AB9,93,-94107.67000000001,75,18,375692.75,281585.08
4198,UF23559,93,8671.319999999994,68,25,116008.48,124679.8
4199,U4E8152,93,2560.3199999999993,79,14,37754.78999999999,40315.11
4200,U84F6E0,93,37358.76,68,25,32152.389999999996,69511.15
4201,UEAE104,93,1162.210000000011,63,30,157717.22000000006,158879.43000000002
4202,UE7A5D7,93,-1015.9499999999994,75,18,21321.740000000005,20305.789999999997
4203,U5EFAEB,93,-34754.119999999995,64,29,616508.9300000002,581754.8100000002
4204,U9427C5,93,-120.62999999999927,89,4,4876.569999999995,4755.9400000000005
4205,UE64407,93,-59184.23999999999,69,24,249806.75999999998,190622.52
4206,U1E483F,92,23220.31,82,10,15030.859999999995,38251.17
4207,U46ABA0,92,3723.3899999999985,59,33,244028.50000000003,247751.88999999996
4208,UB2DA26,92,-682.4500000000012,68,24,79302.26000000001,78619.81
4209,UFA23F3,92,538.6800000000039,82,10,82037.42,82576.1
4210,U4D6830,92,-190825.9,89,3,203464.7,12638.8
4211,U6F36BC,92,-16872.10000000008,55,37,875843.4200000002,858971.3200000001
4212,UCB886C,92,-128085.12000000001,76,16,376557.8300000001,248472.70999999996
4213,UE192B7,92,140.5299999999991,83,9,10444.79,10585.320000000002
4214,U0554F6,92,144.57000000000153,56,36,66893.54000000001,67038.11
4215,U563855,92,-4218.460000000028,87,5,10887.920000000031,6669.459999999999
4216,UFE6C15,92,25036.54,79,13,87850.48,112887.01999999999
4217,UDC832A,92,17767.460000000006,66,26,55638.13,73405.59
4218,U371073,92,503317.09999999986,67,25,314418.88999999996,817735.9899999998
4219,UB17847,92,31.39999999999865,78,14,7429.83,7461.23
4220,U9771B3,92,-2855.739999999997,75,17,84881.99000000003,82026.25
4221,UB16CAE,92,2203.7,81,11,15971.419999999998,18175.120000000006
4222,UBE85BF,92,-82.21000000000095,44,48,912960.28,912878.07
4223,U3399B7,92,37402.4,71,21,204679.96,242082.36
4224,U1BCA47,92,-124.26000000000084,87,5,6502.800000000002,6378.54
4225,UB52A2E,92,222.51999999999975,67,25,14767.779999999995,14990.3
4226,UFEAD35,92,-7479.790000000005,80,12,128559.99000000003,121080.20000000001
4227,U5024BA,92,-1323.0500000000047,86,6,105264.93000000001,103941.88
4228,U913EF9,92,127000.12999999992,54,38,4093071.14,4220071.27
4229,UD8E844,92,2694.5099999999993,90,2,5411.900000000001,8106.41
4230,U99CFB1,92,-3109.7199999999984,79,13,62985.51000000001,59875.79
4231,U139279,92,1825.8199999999993,81,11,25900.74,27726.560000000005
4232,UA3E6FF,92,141.7600000000075,85,7,26202.449999999993,26344.21
4233,U750300,92,559.6799999999993,65,27,27863.780000000002,28423.46
4234,U1E89BB,92,24073.789999999997,81,11,11313.44,35387.23
4235,U0F8503,92,22174.690000000002,81,11,83204.99000000003,105379.68000000001
4236,UD630B9,92,36327.97,74,18,249567.58000000002,285895.55
4237,UE44D9A,92,-6533.7199999999975,56,36,155818.28,149284.56
4238,U07C608,92,4581.8,73,19,24346.31,28928.11
4239,UB75159,92,4300.519999999999,83,9,16254.779999999995,20555.3
4240,UDBA705,92,-10187.37,82,10,14171.74,3984.37
4241,U77105A,92,-22139.12000000001,82,10,109383.20999999999,87244.09000000001
4242,U658A53,92,-136.84000000000043,87,5,3657.8900000000012,3521.05
4243,U0841E1,92,-4814.17,90,2,13273.359999999997,8459.19
4244,U81314C,92,-642.130000000001,80,12,49530.770000000004,48888.64
4245,UB67343,92,1396.319999999999,80,12,3551.9700000000003,4948.289999999999
4246,UFF7B9C,92,1425.4800000000014,76,16,39320.0,40745.48
4247,U1A0D5A,92,-1015.2699999999822,57,35,352149.51,351134.24
4248,UD854E6,92,19915.999999999993,67,25,106386.00000000001,126302.0
4249,UDF0534,92,-10438.589999999997,68,24,39538.79,29100.199999999997
4250,UFBBFDE,92,-5805.640000000007,69,23,245729.44999999998,239923.80999999997
4251,U0B298D,92,-276.42000000000075,82,10,11181.47,10905.05
4252,U2D1EE7,92,-1695.9000000000012,86,6,10417.720000000001,8721.82
4253,U5AE9CA,92,9102.79,84,8,43281.17000000002,52383.96000000001
4254,UD4DDA4,92,-4789.880000000003,79,13,61536.11,56746.229999999996
4255,U71D60E,92,-2653.890000000014,85,7,73418.56999999992,70764.68
4256,U464961,92,-20705.25,86,6,27658.33,6953.08
4257,U177664,92,3639.1599999999994,64,28,8445.55,12084.710000000001
4258,U97ACC0,92,-877.0699999999993,76,16,21719.82000000001,20842.75
4259,UE1629D,91,6756.770000000006,87,4,16676.57,23433.34
4260,U87465D,91,1.5799999999995862,60,31,7121.260000000001,7122.84
4261,UDBEDB3,91,75938.47999999998,60,31,2416970.8500000006,2492909.33
4262,U10DBF7,91,-50698.649999999994,78,13,122569.6,71870.95
4263,U905F2C,91,-3325.7000000000116,75,16,240498.7,237173.0
4264,U3871D7,91,865.1499999999996,89,2,6403.1,7268.25
4265,U4BBD78,91,-31913.199999999997,77,14,69141.44,37228.24
4266,U7A2602,91,-1770.2299999999998,88,3,13433.78,11663.55
4267,U9C8C37,91,-15515.219999999996,74,17,64921.380000000005,49406.16
4268,U39F49F,91,3219.019999999997,37,54,294377.80000000005,297596.82
4269,U9B8DE0,91,1835.9400000000023,70,21,109609.01000000001,111444.95
4270,U186BC2,91,-10007.119999999997,87,4,19463.120000000003,9456.0
4271,UAED1CD,91,-1494.3499999999995,78,13,2191.0199999999986,696.67
4272,UC820C2,91,-37044.310000000005,70,21,224652.65999999997,187608.34999999998
4273,UAE33B6,91,-1022.340000000001,69,22,24007.240000000005,22984.899999999994
4274,UECEB25,91,10817.010000000004,74,17,136189.46,147006.47
4275,U317BF4,91,-44035.109999999986,51,40,1031164.8300000001,987129.72
4276,U62AA36,91,44503.48000000001,80,11,209359.79999999996,253863.28000000003
4277,UE6E6ED,91,-1645.8400000000004,60,31,27156.729999999996,25510.89
4278,U53D310,91,-3703.3599999999997,68,23,7012.59,3309.2299999999996
4279,U2D1E75,91,2016.020000000001,73,18,15479.779999999999,17495.799999999996
4280,U6A852B,91,-6188.450000000001,85,6,6586.09,397.64000000000004
4281,UA5429F,91,-3721.0599999999995,88,3,9986.580000000002,6265.52
4282,U1383C2,91,7940.270000000002,52,39,79002.94,86943.20999999998
4283,UAD1B39,91,-974.8599999999983,74,17,16340.419999999998,15365.56
4284,U12BC2E,91,1992.5900000000047,76,15,111924.91999999998,113917.51000000001
4285,U79A45E,91,31547.170000000002,82,9,27180.010000000002,58727.17999999999
4286,U2959CC,91,-3579.7200000000003,89,2,3724.9400000000005,145.22
4287,U971B65,91,6862.059999999998,75,16,52827.44999999998,59689.51
4288,UC96DD1,91,-43993.670000000006,64,27,99665.26,55671.59
4289,UCEF412,91,-7185.219999999999,77,14,33038.8,25853.58
4290,UB511D0,91,39.68000000000029,58,33,12592.199999999999,12631.88
4291,U83D005,91,15652.42,86,5,7265.17,22917.59
4292,UF1D8E1,91,-33770.130000000034,55,36,762587.3000000002,728817.1699999999
4293,U1A23C7,91,-16934.56,53,38,108600.71,91666.14999999998
4294,U82C299,91,4566.68,66,25,12253.399999999996,16820.079999999998
4295,U8F8DC0,91,-26.799999999999272,73,18,20726.41,20699.61
4296,U963D23,91,-89.69000000000037,80,11,12789.339999999995,12699.649999999998
4297,U6A284E,91,91951.96,34,57,1102354.06,1194306.02
4298,UD282D4,91,2892.86,82,9,11522.78,14415.64
4299,UE27EBB,91,0.3700000000000671,52,39,2232.5899999999997,2232.96
4300,U039107,91,-4179.790000000001,77,14,35240.61000000001,31060.82
4301,UDF090C,91,-44962.91,90,1,44963.770000000004,0.86
4302,U9A1434,91,-5875.960000000001,74,17,37512.61,31636.65
4303,U703F3A,91,1833.770000000003,82,9,225510.72999999995,227344.5
4304,U63AE3B,91,2555.660000000031,83,8,156324.47999999998,158880.14
4305,U2261C5,91,26095.589999999997,80,11,45775.34,71870.93
4306,U1E34BF,91,-4735.929999999997,75,16,99330.14000000001,94594.20999999999
4307,UA2947D,91,-565.3700000000022,78,13,31367.57,30802.2
4308,UDDE001,91,434.6399999999995,49,42,18988.57,19423.21
4309,UC933CF,91,2783.47,65,26,108667.65000000001,111451.12
4310,U3FB1BF,91,18007.489999999998,84,7,12295.5,30302.989999999998
4311,U68E6FE,91,3167.619999999998,80,11,7304.119999999998,10471.74
4312,U387178,91,-90.48000000000002,58,33,5178.830000000001,5088.35
4313,UE857ED,91,12.419999999997344,55,36,60984.630000000005,60997.049999999996
4314,U1F7EC6,91,-7320.790000000001,67,24,120043.35999999997,112722.56999999999
4315,U1DFF02,91,-29999.410000000003,72,19,336167.69,306168.28
4316,U8CE0D5,91,5251.110000000001,82,9,59428.68,64679.79
4317,U52F09E,91,-2217.91,81,10,5700.84,3482.9299999999994
4318,UA7D7F8,91,-1782.48,79,12,15172.990000000002,13390.51
4319,U1B3A9C,91,2728.989999999999,80,11,22230.960000000003,24959.95
4320,UB3849D,91,212.20999999999657,86,5,26282.74,26494.95
4321,U51EBE8,91,-8114.879999999996,70,21,33143.369999999995,25028.489999999998
4322,UE724DA,91,-1601.060000000001,84,7,18027.17,16426.11
4323,UCF5598,91,3215.080000000005,83,8,42520.93000000001,45736.01
4324,U78A207,91,445.3700000000056,86,5,56720.45,57165.82
4325,U301004,91,-99.11000000000014,85,6,12098.66,11999.55
4326,U046916,91,61274.07000000001,22,69,121849.38000000002,183123.45
4327,U09A9D0,91,-452.849999999997,81,10,25273.02,24820.170000000002
4328,UEC8D76,91,-28.34000000000077,60,31,24344.24,24315.9
4329,U50C3C5,91,-494.15000000000055,81,10,12766.92,12272.77
4330,UF402BA,91,-1361.2399999999998,42,49,12962.72,11601.48
4331,U0273C6,91,-9340.289999999994,75,16,66478.09000000001,57137.8
4332,U084136,91,-925.7199999999998,73,18,22119.63,21193.91
4333,UDBF2E9,91,402.82999999999976,35,56,948.8700000000002,1351.6999999999991
4334,UF79CB9,91,503.59000000000054,82,9,13746.740000000005,14250.330000000002
4335,UB57009,91,-5783.2699999999995,58,33,14759.370000000003,8976.1
4336,U690D78,90,1781.1600000000008,84,6,16125.35,17906.510000000002
4337,UC9E7D4,90,-4696.27,82,8,18697.39,14001.12
4338,UDCE875,90,419.4199999999969,61,29,71529.06999999996,71948.48999999999
4339,UA21235,90,33337.48000000003,70,20,209294.47000000003,242631.95
4340,U75AF7B,90,17428.26,78,12,11176.679999999998,28604.940000000002
4341,U8AED34,90,2303.5999999999995,81,9,9835.220000000001,12138.82
4342,U8A95F3,90,-212.35999999999785,64,26,65168.33000000001,64955.97
4343,U770510,90,1591.880000000001,85,5,7631.360000000002,9223.24
4344,U703FEB,90,104.95999999999991,45,45,7666.070000000001,7771.030000000001
4345,U4EC214,90,-1603.5500000000006,77,13,12226.749999999995,10623.199999999999
4346,U8D3D20,90,-42171.579999999994,64,26,224261.21,182089.63
4347,UBE9A51,90,-134.2800000000001,81,9,2184.3200000000006,2050.04
4348,U3B4979,90,-41598.29,74,16,74493.51,32895.22
4349,U3BF961,90,1050.3000000000006,72,18,17517.76,18568.06
4350,UA43177,90,16034.08999999999,74,16,41891.00000000003,57925.09
4351,UAD7187,90,-2535.7200000000016,79,11,15732.98,13197.260000000002
4352,U15B50D,90,7316.690000000013,61,29,223200.13999999998,230516.83
4353,U349708,90,4.559999999999491,45,45,16513.239999999998,16517.8
4354,U4D1303,90,-7961.710000000001,80,10,14064.169999999998,6102.459999999999
4355,U5538B0,90,-2985.7400000000007,83,7,7421.389999999999,4435.65
4356,U282F13,90,-9626.649999999998,73,17,68002.20999999999,58375.560000000005
4357,U6790E6,90,5795.699999999999,66,24,66609.99,72405.69
4358,UB68F25,90,-29496.440000000002,75,15,88260.65000000001,58764.21000000001
4359,U026AFB,90,119.72000000000014,76,14,4021.580000000001,4141.299999999999
4360,UA3F398,90,3399.779999999979,57,33,225888.65000000002,229288.43
4361,U57599E,90,20348.120000000003,79,11,50913.89,71262.01000000001
4362,UEFB6BA,90,3988.0800000000004,83,7,3955.2999999999997,7943.38
4363,U55A378,90,10004.8,85,5,18917.590000000004,28922.39
4364,U3088FE,90,-51663.47,67,23,148639.03999999998,96975.57
4365,U404387,90,-38358.20999999999,82,8,78758.58,40400.37
4366,UF839ED,90,-1835.8300000000002,72,18,5367.909999999999,3532.0800000000004
4367,UEF51D6,90,-727.7599999999984,81,9,14108.939999999999,13381.18
4368,U8B8FF4,90,-27118.719999999998,55,35,376504.59,349385.87000000005
4369,UA88228,90,9117.320000000002,68,22,68133.56,77250.87999999999
4370,U9514D8,90,-6921.390000000003,86,4,66074.38999999998,59153.0
4371,U508B07,90,2207.16,72,18,9094.86,11302.019999999999
4372,UA9ECF1,90,226.19000000000005,79,11,7681.599999999999,7907.790000000001
4373,UA0D9F5,90,-1268.6699999999996,78,12,8633.279999999995,7364.61
4374,U983C72,90,28885.739999999998,85,5,29709.34,58595.08
4375,UA0302E,90,-3250.829999999999,88,2,8123.930000000004,4873.1
4376,U7AE852,90,-49627.48,68,22,124177.35,74549.87000000001
4377,U8D2D1A,90,127.25999999999976,82,8,6703.320000000001,6830.58
4378,U6CBE6D,90,40918.61000000001,80,10,36172.56,77091.17
4379,U02058B,90,-479365.8199999999,77,13,509208.95999999996,29843.140000000003
4380,UE4D5DB,90,-3768.7899999999963,82,8,23169.499999999993,19400.71
4381,U9E542C,90,3041.5999999999985,59,31,28845.56,31887.16
4382,U4452F8,90,3124.6700000000005,76,14,12894.759999999995,16019.43
4383,UF99019,90,557.7400000000024,70,20,17837.73,18395.469999999998
4384,U72D1BE,90,782728.0700000002,68,22,3667817.04,4450545.11
4385,UFD99D0,90,13045.059999999998,72,18,250679.05000000002,263724.11
4386,U11EAAC,90,-3595.160000000001,79,11,15882.41,12287.25
4387,UFEBD37,89,3099.8499999999985,81,8,16120.169999999998,19220.02
4388,UDCBFB7,89,174.3699999999999,82,7,9656.51,9830.880000000001
4389,UD42836,89,9294.140000000027,63,26,336027.86000000004,345322.00000000006
4390,UAF7F49,89,1276.8800000000006,73,16,4075.7800000000007,5352.66
4391,U50F5B9,89,816.2899999999997,70,19,32603.63000000001,33419.92
4392,U9ED2AC,89,14070.309999999994,76,13,19900.269999999997,33970.58
4393,U04361F,89,1652.639999999998,44,45,40371.69,42024.330000000016
4394,U6224D0,89,-5858.710000000003,83,6,17138.47,11279.759999999998
4395,U164654,89,3331.9200000000014,82,7,19502.980000000003,22834.9
4396,U699F92,89,-862.13,88,1,863.13,1.0
4397,UE2709C,89,-338.9600000000002,80,9,6932.1500000000015,6593.1900000000005
4398,UF2A039,89,33512.80000000001,78,11,266860.0,300372.8
4399,UAD15E6,89,2845.0500000000006,76,13,6591.739999999999,9436.789999999999
4400,U5E6331,89,-2925.3800000000006,87,2,3592.3600000000006,666.98
4401,U037B7B,89,-1082.1999999999916,83,6,128762.18000000001,127679.98000000001
4402,UF28DDC,89,2932.9300000000017,65,24,277246.06,280178.98999999993
4403,U2B4AD1,89,-14712.84,59,30,224690.59999999998,209977.76
4404,UF46FC6,89,2101.4,82,7,5683.380000000002,7784.78
4405,UE5675B,89,-25.98000000000001,79,10,15235.18,15209.2
4406,UDCF2A2,89,-1998.2400000000052,42,47,202329.0,200330.76
4407,UD0B159,89,932.3099999999994,73,16,29262.270000000004,30194.58
4408,U66BC7F,89,1494.6499999999996,87,2,4744.35,6239.0
4409,U807DCA,89,-2669.100000000001,78,11,7312.749999999999,4643.65
4410,U34DC52,89,-3685.390000000002,83,6,11713.630000000001,8028.24
4411,U08A45D,89,-136.18000000000575,61,28,165788.01999999996,165651.84
4412,UE415E2,89,-30767.18000000002,76,13,136979.52,106212.33999999998
4413,UC20277,89,145.96000000000254,59,30,9965.519999999999,10111.479999999998
4414,UD3B459,89,-2167.5700000000115,63,26,147776.15,145608.58000000002
4415,U92ECDA,89,-826.5499999999997,76,13,7243.4,6416.85
4416,UA0CCDF,89,15139.649999999992,55,34,162990.23,178129.87999999998
4417,UA21E37,89,-21690.15,81,8,27989.15,6299.0
4418,U8C4FE6,89,-6588.700000000002,47,42,41874.07,35285.369999999995
4419,U56E398,89,2244.2299999999996,77,12,24900.89,27145.120000000003
4420,U8B2336,89,115.0800000000001,86,3,6790.92,6906.0
4421,U8EB2AD,89,-3169.650000000001,69,20,29746.58,26576.929999999997
4422,UB291BF,89,2618.799999999999,79,10,19342.32,21961.120000000003
4423,U72EA8E,89,-6761.52,66,23,21309.93,14548.41
4424,U222E45,89,313955.23000000004,74,15,107956.35,421911.5800000001
4425,U9C6A84,89,3016.5600000000018,56,33,19615.51,22632.070000000003
4426,UDD2138,89,-791.1500000000008,70,19,13538.1,12746.949999999999
4427,UEF151B,89,10225.159999999998,67,22,89257.34,99482.5
4428,U6DC94B,89,-221.01000000000096,79,10,3237.7000000000016,3016.69
4429,U2FA972,89,11755.790000000003,48,41,73657.85,85413.63999999998
4430,UE1C5A4,89,16117.320000000002,79,10,32679.11,48796.43
4431,U5074C3,89,6623.11000000001,73,16,231006.86000000002,237629.97
4432,U30C9A5,89,-0.329999999999842,67,22,14182.76,14182.43
4433,U33D12C,89,5835.42000000001,58,31,16541.739999999998,22377.16
4434,UB9094E,89,-9435.519999999999,63,26,50464.35000000001,41028.829999999994
4435,U0DAAA6,89,3121.309999999996,67,22,83434.35,86555.65999999999
4436,UC1C161,89,0.3299999999995862,56,33,10457.980000000001,10458.31
4437,U91EA90,89,7354.959999999998,83,6,17560.24,24915.2
4438,UD01757,89,-12620.689999999999,58,31,201875.51,189254.82
4439,U0E959B,89,-21103.960000000006,56,33,106013.26000000001,84909.29999999999
4440,U09FF84,89,11399.38,69,20,26104.599999999995,37503.979999999996
4441,U435E32,89,-1121.9100000000003,85,4,5459.629999999999,4337.719999999999
4442,UC2AB89,89,3620.6299999999974,71,18,50859.72000000002,54480.35
4443,UDB4DB8,89,6953.409999999994,62,27,183379.97000000003,190333.38
4444,UE29239,88,191.99999999999955,78,10,5189.91,5381.91
4445,U2B607F,88,-16304.289999999995,73,15,50805.83,34501.54
4446,UEE40B5,88,1216.6500000000015,77,11,10374.629999999996,11591.280000000002
4447,UBC332E,88,-372.55999999999995,85,3,3752.310000000001,3379.75
4448,U1CD9F5,88,135.68999999999994,51,37,3174.68,3310.37
4449,U5077C6,88,-10853.579999999996,86,2,51332.94000000001,40479.36
4450,U465182,88,6253.340000000001,66,22,49044.98000000003,55298.32
4451,U36FD5C,88,-1722.320000000006,72,16,100626.45000000001,98904.13
4452,U9B37F7,88,4389.050000000001,73,15,138816.38999999998,143205.44
4453,UCEC143,88,4383.259999999999,82,6,12009.64,16392.9
4454,U87927F,88,8414.63000000002,72,16,105517.06000000001,113931.69000000002
4455,UF9516B,88,16446.289999999997,76,12,34381.24,50827.53
4456,U080D70,88,-1743.48,81,7,12036.940000000002,10293.460000000001
4457,UBDFD36,88,2282.1699999999996,81,7,11576.739999999998,13858.91
4458,U78F616,88,3796.750000000004,82,6,6476.159999999998,10272.910000000002
4459,UAB9038,88,38404.54,70,18,82534.23999999998,120938.78
4460,U8ACD35,88,-734.809999999999,78,10,44317.57999999999,43582.770000000004
4461,U4AAE36,88,-9793.649999999998,78,10,24812.82,15019.169999999998
4462,UBD5880,88,-1273.0899999999995,73,15,20243.030000000002,18969.94
4463,U702ECA,88,392.57999999999856,55,33,37260.119999999995,37652.7
4464,U41140D,88,675.2600000000001,79,9,3400.460000000001,4075.7200000000003
4465,UAE980F,88,10439.349999999997,84,4,11761.660000000002,22201.010000000002
4466,UED6562,88,4966.090000000026,69,19,401910.98,406877.07
4467,UC01954,88,961.7999999999738,60,28,387597.69999999995,388559.5
4468,U00B774,88,4.999999999999773,46,42,13699.83,13704.830000000004
4469,UDC9C4C,88,20.039999999999417,51,37,71359.66999999998,71379.71
4470,U49B9B5,88,-6693.970000000005,53,35,77121.83,70427.86
4471,UFE1416,88,567.8500000000004,77,11,4250.59,4818.439999999999
4472,UF3AD0C,88,-1894.1099999999979,80,8,12554.01,10659.900000000001
4473,U034A9F,88,-6334.46,64,24,22256.860000000004,15922.400000000001
4474,U53A2ED,88,-985.4499999999994,78,10,82480.31000000001,81494.86
4475,U6B9649,88,6.549999999999805,81,7,1401.4099999999999,1407.96
4476,U29D075,88,348.87999999999954,84,4,5803.0599999999995,6151.9400000000005
4477,U8B0442,88,2655.2999999999997,44,44,124372.12,127027.42
4478,UA965F9,88,1045.9599999999998,84,4,4843.14,5889.099999999999
4479,U5225FC,88,7870.660000000005,75,13,13656.269999999997,21526.93
4480,U134113,88,109602.52999999998,52,36,1070626.0599999996,1180228.5899999999
4481,U89652F,88,-31932.53,80,8,70342.65,38410.12
4482,UE86D77,88,555.7099999999991,55,33,112448.64,113004.34999999999
4483,UE2F60A,88,917.3399999999965,80,8,65691.54,66608.88
4484,UF4C5FB,88,28930.11,59,29,34537.130000000005,63467.24
4485,U7E4525,88,-8409.759999999998,82,6,19377.379999999997,10967.62
4486,U18089D,88,4135.860000000001,74,14,10784.96,14920.82
4487,UD53124,88,4604.489999999998,72,16,28781.01,33385.5
4488,UE9B635,88,-7079.159999999991,68,20,55194.36000000001,48115.2
4489,UB4F63C,87,-3330.7400000000002,78,9,14545.4,11214.660000000002
4490,UDBC2C5,87,17421.510000000002,70,17,21559.619999999988,38981.130000000005
4491,UC675F4,87,12714.11,57,30,18729.0,31443.11
4492,UDFA265,87,-3625.4000000000005,46,41,38221.82000000003,34596.420000000006
4493,U0E4C46,87,-46192.13,65,22,241757.30999999994,195565.17999999996
4494,UF5B6ED,87,1781.8900000000012,50,37,48948.51,50730.4
4495,U697E00,87,2795.8200000000006,85,2,15154.449999999999,17950.27
4496,UFC4683,87,40659.16000000001,56,31,307144.81,347803.97000000003
4497,UE6E159,87,-4546.10000000002,74,13,300448.04,295901.94
4498,U779411,87,822.6800000000026,82,5,22457.800000000003,23280.48
4499,U1DB11C,87,6879.47,82,5,2067.32,8946.79
4500,U795A2F,87,11903.050000000007,62,25,84358.26,96261.31000000001
4501,U21CB35,87,-23125.07,53,34,52529.24,29404.17
4502,U008046,87,17385.21,76,11,22393.2,39778.409999999996
4503,UE98216,87,-55.059999999999995,83,4,10343.489999999998,10288.43
4504,UAB96AE,87,-15787.599999999995,61,26,35199.31,19411.71
4505,U6775D4,87,-1466.8300000000006,68,19,20388.040000000005,18921.21
4506,UC8B8DA,87,-16555.54999999999,63,24,126940.42000000001,110384.87
4507,U6E29C8,87,851.5700000000006,63,24,30686.11,31537.68
4508,U86EE41,87,-16021.87,46,41,158948.22,142926.34999999998
4509,UDD47BA,87,6712.2900000000045,56,31,11548.960000000001,18261.250000000007
4510,UE79659,87,-3335.2999999999993,78,9,10866.81,7531.509999999999
4511,UABB2D4,87,8308.839999999993,81,6,5326.820000000008,13635.66
4512,U877514,87,-4097.299999999999,71,16,19302.699999999997,15205.400000000001
4513,U1B579B,87,477.929999999999,72,15,3178.58,3656.5099999999993
4514,UCEBD31,87,-3771.269999999994,75,12,92241.74,88470.47
4515,UD083DB,87,-289.67999999999967,81,6,7156.680000000001,6867.0
4516,U3EB64B,87,-7841.929999999993,58,29,243553.01999999996,235711.08999999997
4517,UC1B5F4,87,288.6399999999997,80,7,4505.02,4793.66
4518,UC2D45E,87,37.02999999999409,70,17,15163.280000000006,15200.31
4519,U7EBAB3,87,-2279.6099999999988,83,4,10916.910000000003,8637.3
4520,U0A939E,87,30841.990000000013,72,15,125508.76000000002,156350.75
4521,U572295,87,15277.85000000001,82,5,15254.939999999999,30532.79
4522,U2F3A3B,87,5930.889999999997,73,14,148407.85000000003,154338.74000000002
4523,UB28744,87,-844.85,78,9,19061.050000000003,18216.2
4524,UEDE800,87,2132.3099999999977,69,18,831819.9099999999,833952.2200000001
4525,U3C15AC,87,-2689.9400000000014,79,8,19163.780000000006,16473.84
4526,UA8D0BC,87,3683.030000000002,71,16,76416.43000000001,80099.46
4527,U4AAB3C,87,1727.0400000000002,80,7,3740.7300000000014,5467.7699999999995
4528,U2CBBDD,87,-2811.0200000000004,76,11,16088.730000000001,13277.71
4529,UF5F236,87,107.85000000000002,71,16,166.05,273.9
4530,U9E21EC,87,-198807.55,62,25,792905.9500000001,594098.3999999999
4531,U844DB4,87,2506.9900000000007,68,19,21848.819999999992,24355.809999999998
4532,U6319B3,87,-5568.999999999999,76,11,34179.03,28610.03
4533,UEA6644,87,11851.939999999984,51,36,374542.87,386394.81
4534,U6F578C,87,-1745.7399999999943,84,3,79523.95999999999,77778.22
4535,U424344,87,-832.5099999999994,75,12,5824.639999999999,4992.13
4536,U33FF50,87,-400.25000000000045,65,22,12224.9,11824.65
4537,U4E7BDC,87,-301.2000000000007,64,23,63426.56,63125.36
4538,UEE0CAE,87,-23736.119999999995,74,13,88669.01000000001,64932.89000000001
4539,UDF5037,87,1549.270000000001,78,9,14112.83,15662.1
4540,U56D01E,87,2907.7299999999996,83,4,5020.17,7927.900000000001
4541,U9744CA,87,-1098.6599999999985,67,20,27557.67,26459.01
4542,U94EFFF,87,-148.8999999999969,74,13,233857.14999999994,233708.25
4543,U41D525,87,12705.300000000008,53,34,120302.37999999998,133007.68
4544,U384CAE,87,-1345.8299999999988,72,15,22240.089999999986,20894.259999999995
4545,U2A9602,86,6330.6,70,16,9635.79,15966.390000000001
4546,U44CA61,86,-276.2100000000021,74,12,72993.96,72717.75
4547,UB3D782,86,2239.5000000000036,57,29,146735.03000000003,148974.53
4548,U59C3C0,86,-2042.0199999999968,62,24,167448.77000000002,165406.75
4549,U7AD21F,86,5862.650000000002,49,37,62424.03,68286.68000000001
4550,U97B9F9,86,-1865.3599999999988,82,4,7482.359999999999,5617.0
4551,U2266F0,86,23822.21,74,12,47609.66999999999,71431.88
4552,U619A53,86,1580.79,54,32,64157.630000000005,65738.42
4553,UF1BDEB,86,16.920000000000577,51,35,16057.0,16073.92
4554,U4E19D2,86,-9481.540000000003,74,12,29562.850000000002,20081.309999999998
4555,U3B7FB6,86,3921.41,77,9,10597.539999999997,14518.949999999999
4556,UB739DD,86,-4319.240000000003,50,36,419700.38000000006,415381.1400000001
4557,U1DAEAD,86,1.5916157281026244e-12,44,42,43774.649999999994,43774.65
4558,U6089A0,86,-1972.2699999999995,78,8,5232.620000000001,3260.35
4559,UD76600,86,-3569.060000000001,78,8,14566.509999999998,10997.45
4560,UA2AD02,86,624.3699999999999,82,4,4263.300000000001,4887.67
4561,UF13A8E,86,31.60000000000328,79,7,6668.26,6699.86
4562,UE3D296,86,277.7399999999993,67,19,7858.740000000001,8136.48
4563,UE93527,86,-6740.970000000001,82,4,16126.969999999994,9386.0
4564,UF7BCF2,86,4766.53,72,14,40123.22000000001,44889.75
4565,U83ED36,86,-217.87000000000035,81,5,9906.55,9688.679999999998
4566,UB8C25F,86,-78192.14000000006,63,23,660508.9,582316.76
4567,UA191D6,86,39699.62,79,7,13545.68,53245.3
4568,U9A2CE1,86,864.960000000003,61,25,75444.18,76309.14
4569,U47B916,86,-42.46000000000105,49,37,16847.609999999997,16805.15
4570,UA9E003,86,-7808.380000000001,68,18,37065.46,29257.079999999998
4571,U197D8B,86,-975.3700000000003,73,13,9500.66,8525.29
4572,UE5632F,86,17.710000000000818,57,29,16920.319999999996,16938.03
4573,U4239DD,86,-2053.9,84,2,41863.55000000001,39809.65
4574,U3EC1AD,86,-652.8700000000026,56,30,89761.77,89108.9
4575,UCF4FA4,86,-1430.3599999999997,56,30,87255.09000000001,85824.73
4576,U743B76,86,2072.2299999999996,75,11,10224.849999999999,12297.08
4577,U4D9E08,86,-1135.8600000000001,80,6,1796.5500000000002,660.6899999999999
4578,UB5F776,86,-36415.7,64,22,284303.47,247887.77
4579,UF17493,86,-13845.110000000026,51,35,365211.7299999999,351366.62
4580,U3085E4,86,2955.119999999999,50,36,252786.00999999998,255741.13
4581,UBA0A33,86,7683.9299999999985,71,15,96135.71999999999,103819.65
4582,U83B007,86,-1919.2300000000005,82,4,6925.66,5006.43
4583,UAD5864,86,-1574.6200000000006,75,11,13204.219999999996,11629.599999999999
4584,U801F19,86,8220.909999999989,59,27,171008.16999999998,179229.07999999996
4585,U5250FD,86,-223.12000000000012,71,15,14899.5,14676.38
4586,UF471B4,86,126383.94999999995,64,22,470019.38,596403.3300000001
4587,UF14078,86,10478.380000000005,75,11,88098.82000000002,98577.2
4588,UE8787F,86,165.78999999999962,54,32,18227.879999999997,18393.670000000002
4589,UB556B9,86,2979.4399999999996,68,18,53854.64,56834.079999999994
4590,UAA037D,86,-39729.34000000002,64,22,111503.51,71774.17000000001
4591,U0D57F2,86,16177.530000000004,44,42,225884.48,242062.01
4592,UBEC7E5,86,53465.17,48,38,258079.51,311544.68000000005
4593,U13A9FD,86,-5857.920000000005,66,20,108369.02999999994,102511.10999999999
4594,UC675A3,86,-21596.039999999997,67,19,153782.45999999996,132186.41999999998
4595,UEBA436,86,-29736.780000000017,59,27,104866.59000000001,75129.81
4596,UECE537,86,-3752.899999999999,60,26,22348.72,18595.820000000003
4597,UF41184,86,-21863.41000000001,62,24,302593.88999999996,280730.48
4598,U4A6ABD,86,1170.1,83,3,3276.71,4446.81
4599,UA7C97E,86,20284.790000000005,44,42,106500.72000000002,126785.51
4600,U21C260,86,6266.169999999998,73,13,162820.71,169086.88
4601,U5DDD06,86,-1997.1100000000008,80,6,9110.31,7113.2
4602,U07FC5B,86,-4449.1900000000005,60,26,22318.869999999995,17869.679999999997
4603,UEC223B,85,-140.9699999999998,66,19,30566.68,30425.71
4604,U0E73E0,85,161.7400000000016,51,34,61122.67,61284.41
4605,UFC7647,85,-618.1300000000001,82,3,5453.57,4835.4400000000005
4606,U0D6DA7,85,-5253.549999999997,76,9,18366.879999999997,13113.33
4607,U3159D8,85,-2449.56,78,7,33066.340000000004,30616.780000000002
4608,U0DB462,85,-6036.859999999999,73,12,59023.09000000001,52986.23000000001
4609,U96EB9D,85,-2101.080000000001,72,13,17801.809999999994,15700.73
4610,UACD05E,85,-14183.039999999999,62,23,22982.309999999994,8799.27
4611,UA6A6A1,85,-5365.53,63,22,98743.76999999999,93378.23999999998
4612,UA11823,85,0.3999999999996362,44,41,44047.58,44047.979999999996
4613,U983A9B,85,-20.68000000000029,81,4,9070.73,9050.05
4614,U8B0F92,85,-422.9000000000033,74,11,33836.95,33414.049999999996
4615,U08F114,85,-1782.8900000000003,80,5,8783.969999999998,7001.08
4616,UC8D20E,85,-42790.31,68,17,143105.00999999998,100314.7
4617,U4B61CC,85,-498838.99000000005,73,12,504077.88000000006,5238.889999999999
4618,U75D9CF,85,4761.980000000006,63,22,201370.16,206132.14
4619,UAB2965,85,340.80999999999995,80,5,7184.529999999999,7525.34
4620,UFEFDA2,85,-6503.55,61,24,83921.14999999998,77417.59999999999
4621,UF13B6D,85,-8269.170000000002,63,22,88299.14,80029.97
4622,UE16137,85,-7970.199999999999,70,15,26931.700000000004,18961.5
4623,UA096F3,85,-4610.890000000007,50,35,345590.98,340980.08999999997
4624,UCC8563,85,2.1999999999997044,83,2,2697.7999999999997,2700.0
4625,U843937,85,3188.199999999968,63,22,653804.6900000001,656992.89
4626,U8C34C8,85,-9306.039999999997,83,2,15561.039999999997,6255.0
4627,UA5CB1C,85,-705.1099999999925,47,38,78185.96000000002,77480.85
4628,U9B4118,85,-1890.8399999999965,76,9,38740.17,36849.33
4629,U709D42,85,-7317.470000000002,54,31,110426.53000000003,103109.06
4630,U90CDEA,85,-3343.9400000000014,70,15,23787.280000000002,20443.34
4631,U274C41,85,3817.489999999999,75,10,9363.750000000004,13181.239999999998
4632,UC21584,85,-86.58000000000152,64,21,40562.079999999994,40475.5
4633,U0FB53D,85,-415.3600000000012,81,4,4688.380000000001,4273.02
4634,U84B21F,85,3579.3800000000006,75,10,14531.789999999997,18111.17
4635,U16F4D8,85,28695.199999999997,54,31,359433.06000000006,388128.26
4636,U25D1A8,85,-46424.29,74,11,128039.91,81615.62
4637,U6C483F,85,-121830.12,72,13,271534.63,149704.51
4638,UCEE47E,85,-12988.500000000005,67,18,25494.719999999998,12506.22
4639,U9DDB40,85,2240.5099999999998,80,5,8898.500000000002,11139.01
4640,UBE3AA5,85,-1795.4599999999991,72,13,30139.719999999998,28344.26
4641,U473C2A,85,4671.200000000002,57,28,37317.78,41988.98
4642,UE3F022,85,-487.21000000000015,77,8,25710.03000000001,25222.82
4643,U447ADE,85,1902.3699999999983,81,4,14151.929999999998,16054.3
4644,U81DFCC,85,-140.74000000000018,43,42,9116.260000000002,8975.52
4645,U8BA968,85,3371.679999999999,77,8,6816.209999999997,10187.89
4646,UBFAF94,85,357.4899999999995,60,25,15153.37,15510.859999999999
4647,UE5E4EC,85,13323.849999999999,71,14,61875.72000000001,75199.57
4648,UE9342A,85,10761.339999999998,67,18,115961.00000000001,126722.34
4649,U4A3E4A,85,-13463.580000000004,76,9,80484.90999999999,67021.33
4650,UBB6979,85,-40443.71,75,10,52706.04999999999,12262.339999999998
4651,UA71992,85,899.260000000002,64,21,77113.04000000001,78012.3
4652,U363691,85,5603.070000000001,50,35,47098.119999999995,52701.189999999995
4653,UD37E48,85,6856.750000000004,56,29,122674.16,129530.91000000005
4654,UC183B1,85,-1539.63,83,2,2377.26,837.63
4655,U0722A7,85,-1269.9600000000005,79,6,2462.0800000000013,1192.12
4656,U15A702,85,-1999.96999999988,44,41,2191725.8899999997,2189725.9199999995
4657,U1B2AE5,85,-575.1799999999998,78,7,4755.24,4180.0599999999995
4658,U0C76AB,85,-3605.2,78,7,19514.8,15909.6
4659,UE0BC3C,85,-504.41999999999956,78,7,6089.629999999998,5585.210000000001
4660,U8CB6CE,85,-2989.7599999999993,75,10,14574.86,11585.100000000002
4661,U0D036D,85,11135.85,58,27,48656.89,59792.740000000005
4662,UD4D07E,85,3354.4800000000005,82,3,3109.8700000000003,6464.35
4663,UCB04DD,85,1101.8399999999997,78,7,7401.16,8503.0
4664,U3E2EDC,85,28935.590000000004,75,10,58646.849999999984,87582.44
4665,U1EB401,84,-2113.7300000000014,77,7,13409.329999999998,11295.6
4666,UFD80AA,84,-1861.2299999999996,68,16,16131.88,14270.65
4667,UF23564,84,-20074.35,79,5,43318.0,23243.65
4668,U857235,84,-10401.189999999991,81,3,15875.019999999995,5473.83
4669,U9F0131,84,-1364.6800000000012,78,6,4986.190000000001,3621.51
4670,U85D1A4,84,-107466.83999999992,53,31,433820.74,326353.8999999997
4671,UBB1722,84,-25.289999999999935,42,42,11785.290000000003,11760.0
4672,U5D9415,84,-1853.3300000000027,52,32,31889.890000000003,30036.559999999994
4673,U43731F,84,-23546.9,53,31,58295.909999999996,34749.009999999995
4674,U6BD9C6,84,35467.56,69,15,62851.46,98319.02
4675,U88FF26,84,4291.850000000002,68,16,40526.520000000004,44818.369999999995
4676,UDF719C,84,-1489.6100000000006,79,5,7820.84,6331.23
4677,UC61965,84,3026.920000000001,63,21,42606.38,45633.3
4678,UA5B6AE,84,-2721.3999999999996,81,3,6006.399999999999,3285.0
4679,U3882D5,84,11628.289999999999,51,33,55095.57000000001,66723.86000000002
4680,UFBF175,84,-105.16999999999936,79,5,3998.8599999999997,3893.69
4681,U427E5A,84,3931.05000000001,50,34,277846.06999999995,281777.12
4682,UAAB3B6,84,-2808.9699999999957,69,15,91119.16000000002,88310.19
4683,UE01805,84,2900.7499999999995,63,21,42765.59,45666.34
4684,UC862DB,84,-6905.3099999999995,72,12,24632.73,17727.42
4685,U251080,84,-2064.3200000000006,71,13,12342.31,10277.989999999998
4686,UCB3F7E,84,79678.96,46,38,2044605.45,2124284.41
4687,U2D1381,84,-270.46000000000026,63,21,2957.5099999999993,2687.0499999999997
4688,UB9A8D7,84,-617.1300000000001,79,5,5204.509999999999,4587.379999999999
4689,U69E43F,84,-19686.949999999997,79,5,48498.1,28811.15
4690,UEA0968,84,-9845.21,71,13,58033.31,48188.1
4691,U67C77E,84,-1808.3999999999999,73,11,7317.199999999999,5508.8
4692,UBD32C2,84,-1412.9900000000011,68,16,55053.81000000002,53640.81999999999
4693,UF57048,84,-1175.4899999999952,49,35,377790.70999999996,376615.22
4694,UFFD61E,84,-30061.69,72,12,105416.85,75355.16
4695,U6D995D,84,99465.12999999998,45,39,443624.45,543089.58
4696,UE5CF3B,84,45906.049999999836,35,49,1770093.6600000001,1815999.7100000004
4697,UBF63A6,84,9297.039999999997,59,25,54054.55,63351.59
4698,UCBA01F,84,-5194.290000000006,55,29,110622.08999999998,105427.79999999999
4699,UF27B70,84,-7563.439999999995,70,14,77629.79000000001,70066.34999999999
4700,U4D0DAA,84,26314.07,51,33,76194.91,102508.98000000001
4701,U30F703,84,205.0599999999995,73,11,9140.270000000002,9345.33
4702,U963D21,84,-3842.000000000001,38,46,71402.52,67560.51999999999
4703,UE73824,84,-177.45000000000036,78,6,5753.209999999998,5575.76
4704,U171FF7,84,-381.7499999999998,76,8,4018.2900000000004,3636.54
4705,U7F7FC0,84,-7406.2300000000005,62,22,105816.66999999998,98410.44
4706,U1BE70B,84,-5015.760000000009,78,6,95685.56999999999,90669.81
4707,U69070F,84,792.1699999999994,73,11,19014.719999999998,19806.89
4708,U11F336,84,297.2899999999995,73,11,6511.089999999999,6808.38
4709,U23B12A,84,-207.1099999999995,80,4,4397.82,4190.71
4710,U6AE648,84,6.620000000004438,51,33,80790.87,80797.48999999999
4711,U67A819,84,-17611.429999999993,49,35,261754.05,244142.61999999994
4712,UAC2729,84,5719.0199999999995,78,6,7731.420000000002,13450.44
4713,U5BBCB5,84,889.619999999999,69,15,35580.26,36469.88
4714,U5F8AD4,84,-3871.6599999999976,65,19,103061.80999999997,99190.15
4715,U1AC7CB,84,244.3800000000001,49,35,212795.5,213039.88
4716,UC9ABFF,84,21254.710000000003,65,19,17793.909999999996,39048.619999999995
4717,UCFA35E,84,24772.739999999998,53,31,51996.26000000001,76769.0
4718,UF721A5,84,-6385.000000000002,59,25,342186.67000000004,335801.67000000004
4719,U1E94CF,84,2337.5000000000014,69,15,44361.84000000001,46699.34
4720,U98C6D3,84,-9446.66,68,16,15592.660000000002,6146.0
4721,U17AA2E,84,2963.569999999999,71,13,48270.780000000006,51234.35
4722,U19103C,84,24904.349999999995,79,5,23018.119999999995,47922.47
4723,U6F9F28,84,-1409.7000000000007,77,7,22139.030000000006,20729.33
4724,U1BF3BD,84,-14435.290000000006,84,0,14435.290000000006,0.0
4725,U2EC883,84,-73991.85999999999,58,26,653820.16,579828.3
4726,UA23550,84,-30362.43,80,4,41346.53999999999,10984.11
4727,U03BEE0,83,46463.13000000001,62,21,134198.63,180661.75999999998
4728,U533D16,83,43363.57999999999,67,16,35937.72000000001,79301.29999999999
4729,UF24A8B,83,-5.259999999998399,60,23,43145.57,43140.31
4730,UA91337,83,-1741.9100000000005,59,24,34152.520000000004,32410.610000000004
4731,U9B8E0F,83,-48198.200000000004,74,9,52693.56,4495.36
4732,U9CF2E3,83,-7368.209999999998,55,28,40111.59000000001,32743.379999999997
4733,U5BFA7D,83,-3100.2600000000007,56,27,7304.179999999999,4203.92
4734,U0016FF,83,-596.2700000000008,58,25,25856.599999999995,25260.329999999998
4735,UD7BF98,83,105.80000000000109,78,5,11375.49,11481.29
4736,U8E6CC6,83,-18145.47999999999,81,2,19469.079999999994,1323.6
4737,U4B5E8B,83,-2228.6199999999953,59,24,106726.3,104497.68000000001
4738,U149BB4,83,-21776.389999999992,76,7,46781.96,25005.57
4739,UD4C030,83,14028.039999999999,61,22,15769.179999999998,29797.22
4740,U527B7B,83,1572.6900000000023,67,16,31042.38000000001,32615.070000000003
4741,UD0EC2B,83,35704.44,59,24,25167.16999999999,60871.60999999999
4742,U5922C4,83,-959.2000000000004,52,31,5647.670000000001,4688.469999999999
4743,U5570FF,83,-7790.709999999998,79,4,11448.05,3657.34
4744,UD3C075,83,-232.5900000000056,58,25,268512.47,268279.88
4745,UEE4601,83,-23203.66,50,33,57145.189999999995,33941.53
4746,UCF3751,83,-15134.769999999999,66,17,83868.54999999999,68733.78
4747,UCEE2D3,83,-173449.10999999996,68,15,649697.9000000001,476248.7899999999
4748,UA1B6BE,83,-6664.8899999999985,71,12,17727.999999999993,11063.11
4749,U25E7A5,83,9890.26,12,71,9068.48,18958.740000000005
4750,U4A50D2,83,859.7699999999998,78,5,4324.56,5184.33
4751,UC0529A,83,-9069.320000000018,61,22,83102.04000000001,74032.72
4752,U3D8694,83,-698.3100000000007,61,22,10570.140000000005,9871.830000000007
4753,U52DB8A,83,-5529.22,79,4,11514.75,5985.530000000001
4754,U2D940B,83,1172.9400000000005,70,13,37520.58000000001,38693.520000000004
4755,U346862,83,4308.490000000003,70,13,19351.469999999998,23659.960000000003
4756,U5FE2E5,83,-65085.83999999999,40,43,65788.77,702.9300000000002
4757,UE40584,83,-4740.1000000000095,62,21,78396.98999999999,73656.89
4758,U24FA74,83,-285.3600000000007,81,2,5660.869999999999,5375.51
4759,UFFD95C,83,22145.68,59,24,152725.98,174871.66
4760,UD94F42,83,842.4300000000005,73,10,12512.669999999998,13355.1
4761,UEAFDF4,83,-742.8899999999999,64,19,21659.42,20916.53
4762,UE94B14,83,16876.819999999992,59,24,112666.1,129542.91999999998
4763,U291CF5,83,1482.279999999999,75,8,3842.3400000000006,5324.62
4764,UF4072C,83,-900.9599999999925,72,11,36278.46,35377.50000000001
4765,U512AA1,83,5214.35,66,17,92953.59000000001,98167.94
4766,U0C5D0D,83,-378.9700000000006,78,5,13391.490000000003,13012.52
4767,U1ED452,83,66.75999999999995,81,2,126.24000000000008,193.0
4768,U1F7E65,83,5720.269999999998,61,22,403190.13999999996,408910.41000000003
4769,U81744D,83,18199.37,67,16,33849.05,52048.42000000001
4770,U1CCCEB,83,-1919.4199999999994,56,27,37652.049999999996,35732.630000000005
4771,U4DA76A,83,-9212.90999999999,79,4,68459.0,59246.09
4772,U41D6E4,83,-6618.129999999999,56,27,20671.800000000003,14053.67
4773,UE26A83,83,-19130.87000000001,77,6,32389.03000000001,13258.16
4774,U4A4221,83,-4611.669999999997,68,15,35914.71000000002,31303.04
4775,U094E3C,83,-25278.58,69,14,75532.65999999999,50254.08
4776,U4F3158,83,-1.0800000000001262,55,28,8124.289999999999,8123.210000000001
4777,U3ACEE0,83,-630.3099999999996,61,22,9571.26,8940.95
4778,U7C51EA,83,-3907.3899999999935,77,6,17525.98999999999,13618.6
4779,UD54664,83,-21776.440000000002,81,2,65857.24,44080.8
4780,U4E3314,83,-2746.7700000000004,58,25,124004.79999999999,121258.03
4781,U96528E,83,-1610.8999999999933,58,25,41030.910000000025,39420.00999999998
4782,U997AC1,83,730.3799999999997,69,14,11402.979999999998,12133.36
4783,UD8236E,83,4103.830000000005,61,22,91821.35999999993,95925.19
4784,U39B069,83,-836.8500000000013,68,15,63126.530000000006,62289.68
4785,U9D9B76,83,120.33999999999969,65,18,7583.72,7704.06
4786,U433932,83,-5726.950000000001,78,5,19123.539999999997,13396.59
4787,U668893,83,110.55000000000013,69,14,4440.71,4551.26
4788,U074021,83,-36238.09000000001,62,21,189215.11,152977.02000000002
4789,U7F2B12,83,-3037.120000000001,77,6,25251.98,22214.86
4790,UD04367,83,53848.670000000006,66,17,65383.50000000001,119232.17000000001
4791,U8C8A57,83,10107.03,76,7,4989.36,15096.390000000001
4792,U8DA716,83,-90855.45,70,13,196347.27000000002,105491.82
4793,U1DA3F7,83,-260.4100000000007,72,11,9697.64,9437.23
4794,UAD799D,83,-48318.019999999975,65,18,209674.64000000004,161356.62000000002
4795,U5575BB,83,1145.53,81,2,854.47,2000.0
4796,U948025,83,4450.599999999997,64,19,186125.79,190576.39
4797,U884580,82,3927.139999999991,62,20,125597.69000000002,129524.83
4798,U0FC2DC,82,26.99999999999997,60,22,2037.5900000000001,2064.59
4799,UDBD876,82,-4.209999999991851,48,34,183839.52,183835.31
4800,U34BAC4,82,620.2600000000034,72,10,32955.469999999994,33575.73
4801,U3BEECE,82,-8689.799999999996,50,32,314307.0,305617.20000000007
4802,UA39504,82,154.56000000000014,75,7,3944.4399999999987,4099.0
4803,U38F083,82,-16542.410000000003,74,8,41711.87999999999,25169.47
4804,UBCCCA8,82,6760.35,73,9,5632.860000000001,12393.210000000001
4805,U4D7898,82,53006.89,70,12,40669.53000000001,93676.42000000001
4806,UF05D17,82,2223.9399999999996,62,20,55744.73999999999,57968.68000000001
4807,U2C4A2F,82,-24850.130000000037,20,62,297372.0,272521.8700000001
4808,U9B4CEC,82,2643.119999999998,57,25,36287.87,38930.990000000005
4809,U535480,82,-543.049999999999,47,35,14366.29,13823.240000000003
4810,U286DBE,82,2457.5899999999997,73,9,9544.51,12002.1
4811,UA82440,82,6557.049999999999,73,9,15439.240000000002,21996.29
4812,UF0FA02,82,-467.3799999999994,54,28,69100.32,68632.94
4813,U9E8D09,82,-30879.320000000003,78,4,41374.890000000014,10495.57
4814,UCDA22D,82,-42755.61000000001,58,24,504231.2,461475.59
4815,UFA0DCA,82,175.69000000000005,71,11,3565.32,3741.01
4816,UBFD67A,82,-3311.7100000000014,48,34,103102.9,99791.18999999999
4817,U553A6F,82,2728.029999999997,70,12,156208.27000000008,158936.3
4818,UAC9B45,82,-3881.87,62,20,22046.3,18164.43
4819,U24DE24,82,-20417.590000000106,65,17,1372231.63,1351814.04
4820,U13C957,82,-8071.72,65,17,36450.0,28378.279999999995
4821,U3D7C97,82,-17527.720000000005,74,8,77263.62,59735.899999999994
4822,U7C875A,82,-1088.770000000004,64,18,389356.49,388267.72
4823,UDA072A,82,7374.479999999994,69,13,120939.30000000002,128313.78
4824,U5407CE,82,2981.2599999999943,76,6,25284.439999999995,28265.7
4825,UF73BAC,82,238.27999999999884,40,42,192926.88999999996,193165.17000000004
4826,UC50A25,82,-65613.01,56,26,493499.2499999999,427886.2400000001
4827,U5EA82A,82,-1993.4599999999998,81,1,2960.0,966.54
4828,U3EB894,82,-2207.1800000000326,58,24,687821.63,685614.45
4829,UF867EB,82,-44.91999999999787,60,22,216933.06,216888.13999999998
4830,U76EEA3,82,-1453.7299999999987,28,54,53309.01,51855.28
4831,UB7672D,82,-4531.950000000001,79,3,12088.45,7556.5
4832,U744553,82,24755.199999999997,60,22,112789.22000000002,137544.42
4833,U12F769,82,-2789.319999999997,64,18,231443.96999999997,228654.65
4834,UF4644D,82,-601.4999999999945,73,9,34147.69999999999,33546.2
4835,UC0D192,82,-21103.650000000005,44,38,111453.2,90349.55000000002
4836,UE29C33,82,30821.74,63,19,427542.95999999996,458364.69999999995
4837,UEA62DB,82,-3408.319999999999,77,5,32092.749999999996,28684.43
4838,UD182B4,82,79545.08,55,27,126028.15000000001,205573.23
4839,UE57326,82,-9332.96,51,31,81103.95000000001,71770.99
4840,UBECA26,82,-776.7499999999993,77,5,28308.42,27531.67
4841,UAC0141,82,15536.760000000006,77,5,30290.879999999997,45827.64
4842,U86F9D6,82,1727.8200000000004,55,27,4698.5599999999995,6426.380000000001
4843,UE4DEB3,82,1905.3500000000013,73,9,6994.339999999998,8899.69
4844,UDFD0B9,82,60555.67000000001,59,23,306877.24,367432.91000000003
4845,UF4C4FA,82,470.85999999999694,43,39,708668.86,709139.72
4846,U9A71DC,82,12174.46,65,17,238503.1,250677.56
4847,UC7D05D,82,3611.209999999998,79,3,8488.79,12100.0
4848,U1DB37F,82,37696.36000000002,74,8,80258.34,117954.7
4849,U9AD300,82,-127.3899999999993,74,8,6888.300000000003,6760.91
4850,U26E990,82,-2839.589999999998,66,16,16008.960000000005,13169.369999999999
4851,UB2B65D,82,1.4300000000007458,58,24,22171.77,22173.199999999997
4852,U4E5709,82,1232.5100000000011,74,8,9605.49,10838.0
4853,U8D046E,82,-1057.5700000000008,63,19,6479.680000000001,5422.110000000001
4854,UD35D3F,82,-1538.0800000000006,55,27,27997.25,26459.169999999995
4855,U9ED310,82,9500.77,39,43,140224.22999999998,149725.0
4856,U3B7F56,81,41154.87,70,11,29494.470000000005,70649.34
4857,UE26571,81,-2305.110000000001,67,14,41184.9,38879.79
4858,U3CECF5,81,667.1599999999994,65,16,16681.29,17348.45
4859,U95AFDC,81,-8339.03,53,28,11094.38,2755.35
4860,U440567,81,-9.15999999999703,74,7,14829.599999999999,14820.44
4861,UE27AC6,81,-15.279999999999234,58,23,17888.100000000002,17872.82
4862,U30EEB0,81,76.45999999999185,65,16,91229.8,91306.26
4863,UF61C9B,81,19097.58999999999,70,11,94551.37,113648.95999999999
4864,U12EA56,81,-7276.570000000002,78,3,10786.569999999998,3510.0
4865,U33327C,81,-29228.35000000001,71,10,94751.08,65522.729999999996
4866,UF1EE3E,81,-941.2500000000015,70,11,81045.93999999997,80104.69
4867,U607AD4,81,5135.200000000013,57,24,141295.36999999997,146430.57
4868,UD5E3DD,81,-246.9700000000002,76,5,8592.379999999994,8345.41
4869,UBF737C,81,-389.6899999999999,59,22,1579.6600000000005,1189.9700000000003
4870,U13C0AA,81,-2054.5599999999995,75,6,5164.51,3109.9500000000003
4871,UDD2AB0,81,2741.0099999999993,64,17,5114.280000000001,7855.29
4872,U4AFEBB,81,-59499.46000000001,61,20,607154.99,547655.53
4873,UB51E73,81,-4048.690000000104,30,51,2366660.89,2362612.1999999993
4874,UCDFE7D,81,-224.63000000000102,64,17,37791.53,37566.9
4875,U244BCB,81,846.8800000000024,54,27,23090.59,23937.47
4876,UD38E2F,81,13305.690000000002,56,25,31038.609999999993,44344.3
4877,U7D6FC9,81,-219.2699999999994,63,18,9961.650000000001,9742.380000000001
4878,UF1A7CB,81,-6656.609999999999,47,34,29124.91,22468.3
4879,UAF4BBE,81,-8651.68,73,8,31536.589999999997,22884.91
4880,U376B28,81,-2697.4799999999996,70,11,11576.96,8879.48
4881,U92D547,81,-953.130000000001,66,15,20678.41,19725.28
4882,UD0DE7F,81,1158.9500000000003,59,22,4834.7699999999995,5993.719999999999
4883,UE25B5F,81,-145.10000000006585,65,16,134440.33000000002,134295.22999999998
4884,U972A00,81,22639.219999999994,72,9,10829.96,33469.18
4885,U726405,81,-10184.3,80,1,18039.300000000003,7855.0
4886,UCC79B9,81,-9846.670000000016,57,24,260679.58,250832.90999999997
4887,U1EB5EA,81,-4323.71,78,3,5527.05,1203.34
4888,U5BCCF4,81,49.64000000000124,72,9,20161.15,20210.789999999997
4889,U2CF0CF,81,-472.6300000000001,66,15,8037.7699999999995,7565.139999999999
4890,UF2F741,81,-1727.35,78,3,2620.999999999999,893.65
4891,UDDD6E7,81,55011.820000000014,63,18,598245.56,653257.38
4892,U79F454,81,452676.2000000001,70,11,2280583.8899999997,2733260.0900000003
4893,U5B5801,81,-32446.60000000001,79,2,53989.59999999999,21543.0
4894,UB301A9,81,-719.0400000000009,62,19,20824.68,20105.640000000003
4895,U8E5D1C,81,-855.7499999999998,67,14,15083.559999999998,14227.810000000001
4896,U951C91,81,-7184.689999999999,70,11,46198.650000000016,39013.96000000001
4897,U8EEC06,81,-3667.2,76,5,12837.120000000003,9169.92
4898,U858CAC,81,-38553.53,55,26,80352.85,41799.32
4899,UE6C660,81,220.23000000000013,51,30,6569.879999999999,6790.11
4900,U30E264,81,5479.029999999998,66,15,21980.879999999997,27459.91
4901,UC9056A,81,-1488.4,74,7,32546.239999999998,31057.84
4902,U81969D,81,3398.8900000000017,71,10,22892.29,26291.180000000004
4903,UB4120B,81,5218.620000000002,67,14,22683.12,27901.740000000005
4904,UCE332F,81,69.77999999999967,74,7,2480.3999999999987,2550.18
4905,U65840D,81,9591.720000000001,63,18,50889.26999999999,60480.99
4906,U924157,81,-36908.099999999926,67,14,679565.3399999997,642657.24
4907,UBA3C16,81,-9361.85,77,4,17006.75,7644.9
4908,UEC1EC2,81,26483.05000000001,45,36,282111.98000000004,308595.03
4909,U4BBAB6,81,-213.6000000000002,75,6,5128.1,4914.5
4910,UCF7A75,81,-4997.229999999992,65,16,57455.909999999996,52458.68
4911,UDBD2EC,81,-45338.47000000001,77,4,82817.81999999998,37479.35
4912,U30405F,81,55933.48999999999,26,55,86261.66,142195.15
4913,U23368A,81,1335.6199999999997,70,11,10069.48,11405.099999999999
4914,U3AF53B,81,-827.1899999999941,67,14,35474.79,34647.6
4915,UD7D4BE,81,896.829999999999,78,3,7100.310000000001,7997.139999999999
4916,U0B40C2,81,205.6999999999986,70,11,10219.279999999999,10424.98
4917,U4F3B8C,81,-90.97000000004657,65,16,1108227.6099999999,1108136.64
4918,U8395FF,81,2895.439999999996,63,18,107488.57,110384.01
4919,U335A6A,81,6462.800000000002,78,3,5757.029999999999,12219.83
4920,UEE1446,81,-4421.469999999999,72,9,21844.790000000005,17423.32
4921,U4A9CB5,81,-9594.589999999997,73,8,20772.579999999994,11177.99
4922,UA1454F,80,621.8799999999992,48,32,64593.43999999998,65215.31999999999
4923,UFB9030,80,-9574.739999999998,70,10,65108.45999999999,55533.72
4924,U1A44FA,80,38175.019999999975,59,21,430286.59,468461.6099999999
4925,UD9FA9E,80,-14631.54,71,9,126349.55,111718.01
4926,UD800BC,80,-2683.3200000000043,61,19,104262.77999999998,101579.45999999999
4927,U235221,80,-6135.360000000001,70,10,23606.51,17471.149999999998
4928,U34E0BB,80,-1176.3699999999985,74,6,21605.120000000003,20428.75
4929,U19CF38,80,469.1499999999983,43,37,85368.27000000003,85837.42
4930,U25148C,80,-8142.109999999997,50,30,70370.43000000004,62228.32000000001
4931,UFBF156,80,5257.08,62,18,10763.550000000001,16020.63
4932,U3FE9D8,80,-942.4200000000001,56,24,5531.68,4589.26
4933,UD96C0C,80,-11467.009999999995,72,8,84861.05000000005,73394.04000000001
4934,UE56F7B,80,-1449.9999999999998,56,24,7106.379999999998,5656.379999999998
4935,U43D795,80,-3514.9300000000007,78,2,5775.380000000001,2260.45
4936,UEB9791,80,-4015.9900000000007,75,5,15254.84,11238.849999999999
4937,U7DDD99,80,-3772.709999999999,61,19,25975.47,22202.760000000002
4938,U294573,80,-3868.2499999999973,45,35,256639.97999999995,252771.73
4939,UA73206,80,2422.4100000000017,72,8,11451.92,13874.33
4940,UEC2120,80,678.9200000000003,71,9,20114.36,20793.28
4941,UDC002C,80,5975.16,73,7,9486.86,15462.02
4942,U800314,80,-1187.5799999999977,60,20,62474.98000000001,61287.4
4943,U623E86,80,3385.960000000001,50,30,10673.019999999999,14058.98
4944,U33F793,80,2527.249999999995,69,11,81362.53,83889.78
4945,UF34BE9,80,12865.6,49,31,20311.320000000003,33176.92
4946,UAB9525,80,-3028.2599999999993,59,21,103007.94000000003,99979.68000000001
4947,UC2CAFA,80,-1302.7199999999998,77,3,13722.42,12419.7
4948,U0AE080,80,-988.1199999999994,76,4,10695.979999999998,9707.86
4949,U7D148E,80,175.86999999999966,74,6,4207.890000000001,4383.76
4950,UAB4968,80,-27638.760000000006,53,27,101470.78,73832.01999999999
4951,UAF2180,80,-5240.139999999999,75,5,15897.689999999999,10657.55
4952,UC4AC7A,80,95.17999999999938,48,32,28802.049999999996,28897.23
4953,U845928,80,-990.1499999999996,55,25,34096.04,33105.89
4954,U95D335,80,18674.629999999986,68,12,78071.1,96745.73000000001
4955,U2B5445,80,43925.57,60,20,49378.780000000006,93304.35
4956,UA9C6EE,80,13177.290000000003,67,13,44494.01,57671.3
4957,U662470,80,56918.30000000002,63,17,185271.91,242190.21000000005
4958,U3695F0,80,-18948.850000000006,55,25,77803.53,58854.68000000001
4959,UE59D75,80,3422.4199999999983,73,7,82824.57,86246.99
4960,U822A30,80,-2516.15,64,16,20526.230000000007,18010.08
4961,U848456,80,17202.509999999987,76,4,15445.870000000003,32648.379999999997
4962,U511E61,80,-3624.660000000001,74,6,6270.91,2646.2499999999995
4963,UADF0A7,80,9301.169999999993,69,11,154839.73,164140.9
4964,U98E60B,80,-449.57999999999987,77,3,4556.98,4107.4
4965,U6F0D09,80,-4064.199999999999,74,6,47977.329999999994,43913.130000000005
4966,UCF9023,80,116129.22000000007,60,20,2458781.22,2574910.4399999995
4967,UF5D034,80,-4088.0999999999967,59,21,109350.70000000001,105262.60000000002
4968,U5675E3,80,-507.01,78,2,747.01,240.0
4969,UF24575,80,-2424.400000000001,59,21,89044.62999999999,86620.23000000001
4970,U741626,80,34527.759999999995,66,14,82364.03,116891.79
4971,UB8480C,80,-1159.0000000000002,67,13,18243.43,17084.429999999997
4972,UAED731,80,1637.3800000000028,51,29,41369.32,43006.700000000004
4973,UCFFC00,80,-1461.5999999999997,78,2,1899.1999999999998,437.6
4974,U69F43D,80,-37289.21000000001,68,12,103361.8,66072.59
4975,U9081EE,80,-4131.500000000004,77,3,17554.050000000003,13422.55
4976,UF1FC2B,80,4117.670000000002,69,11,122674.95999999999,126792.63000000002
4977,UABE2D3,80,-1919.6900000000005,74,6,12861.579999999996,10941.890000000001
4978,U8CD99C,80,319.1400000000005,72,8,11464.899999999996,11784.04
4979,UBB0936,80,48.11999999999947,78,2,12951.879999999997,13000.0
4980,UD3DC36,80,-39415.82000000003,72,8,76535.93000000002,37120.11
4981,U0B871B,80,0.2600000000001046,65,15,7515.74,7516.0
4982,U0A9246,80,-8778.920000000002,74,6,27095.439999999984,18316.52
4983,UE8457C,79,-17881.479999999996,51,28,131340.75,113459.26999999999
4984,UE5E30C,79,1647.4799999999998,76,3,1147.1599999999999,2794.64
4985,U91B5D5,79,8231.049999999988,62,17,162796.92,171027.97
4986,U7CBED1,79,-8280.609999999999,49,30,76981.36,68700.75000000001
4987,UCCEC97,79,143.59000000000023,59,20,5044.580000000001,5188.17
4988,U14AB9C,79,-14264.8,58,21,61617.12,47352.32
4989,U7C639D,79,758.3600000000006,73,6,11074.229999999996,11832.59
4990,U11B1A8,79,-13.919999999999618,69,10,11881.77,11867.85
4991,U5E8785,79,-34.40999999995984,38,41,1249852.0,1249817.59
4992,UFD1031,79,104.8500000000291,41,38,244950.81,245055.66
4993,U24AF58,79,-2865.890000000001,70,9,7816.05,4950.16
4994,UAD410D,79,-1015.899999999999,69,10,24501.56,23485.66
4995,U0C8007,79,-22183.190000000002,69,10,85349.01999999999,63165.83
4996,U703022,79,-3381.019999999997,74,5,52391.020000000004,49010.0
4997,UB52C50,79,-646.0799999999995,62,17,25477.100000000002,24831.020000000004
4998,UD28389,79,-537.8199999999945,58,21,173653.62999999995,173115.80999999997
4999,U37A2A3,79,1326.8300000000004,64,15,17392.499999999996,18719.33
5000,U33335B,79,7221.55,75,4,3749.3900000000003,10970.940000000002
5001,U1D87E0,79,-126.13999999999669,49,30,77641.41,77515.27
5002,U41D806,79,-32.22999999999979,69,10,68674.77,68642.54000000001
5003,UFCB626,79,-2007.3600000000013,73,6,18361.43,16354.07
5004,UE5425D,79,-2483.12000000001,52,27,169724.26,167241.14
5005,UA9FD03,79,-3525.7400000000007,73,6,13235.869999999999,9710.130000000001
5006,U73EF77,79,4164.4400000000005,57,22,60785.01000000001,64949.450000000004
5007,U8429B2,79,-4971.769999999999,66,13,17048.21,12076.439999999999
5008,U12ED2D,79,-13371.81,65,14,42721.920000000006,29350.11
5009,UC6D2D9,79,12732.770000000004,71,8,17603.730000000003,30336.5
5010,U94A1AD,79,-39311.59000000002,63,16,71816.07,32504.48
5011,UE17EED,79,771.1699999999993,77,2,5887.909999999999,6659.08
5012,U4A898B,79,8494.13,56,23,39669.140000000014,48163.27
5013,UDC1F7E,79,-13085.089999999991,76,3,21858.59,8773.5
5014,UDDDC7F,79,387.1100000000001,51,28,6422.58,6809.69
5015,UEB98D5,79,30.589999999998327,43,36,45716.07,45746.66
5016,U8A03D3,79,-42784.090000000004,70,9,61769.45,18985.36
5017,U7862C7,79,-2502.130000000001,55,24,58955.24,56453.10999999999
5018,U901B8D,79,5721.809999999997,59,20,34174.49,39896.3
5019,U9ADD9A,79,-561.259999999998,70,9,16889.510000000002,16328.25
5020,U6A2BE2,79,10224.369999999994,74,5,21461.140000000003,31685.510000000002
5021,UA2536A,79,-10760.75,65,14,16588.05,5827.300000000001
5022,UFE5279,79,10773.200000000003,72,7,7022.719999999998,17795.920000000002
5023,UA491F1,79,-6740.589999999999,59,20,13131.299999999997,6390.71
5024,U66F9C9,79,-73121.34000000001,76,3,127621.63,54500.29
5025,UA7E885,79,7962.860000000001,74,5,20161.14,28124.0
5026,UF5B8E1,79,50071.200000000004,31,48,33358.68,83429.88
5027,UF1078D,79,0.06000000000008185,42,37,1844.71,1844.7700000000002
5028,U1C31E2,79,-4904.680000000001,70,9,18397.019999999997,13492.34
5029,UEBB2DB,79,76186.87,66,13,22284.78,98471.65000000001
5030,UB39D67,79,3084.76,66,13,23005.029999999995,26089.79
5031,UD1C58B,79,37125.80000000002,70,9,23026.969999999998,60152.770000000004
5032,U591D82,79,-78.23999999998341,46,33,313277.4699999999,313199.23
5033,U2E8690,79,-44994.8,70,9,127635.02,82640.22
5034,UAB1082,79,-7464.059999999998,51,28,210462.42,202998.35999999996
5035,UBC3D05,79,1436.0200000000013,60,19,25007.05,26443.07
5036,U0AFA45,79,-2644.3899999999967,72,7,49167.90999999999,46523.520000000004
5037,UA0B14A,79,-2897.2699999999986,71,8,25015.029999999995,22117.760000000002
5038,UB0AF60,79,-1935.5499999999975,68,11,49986.97,48051.42
5039,UCB6C02,78,10910.22,72,6,16444.559999999998,27354.78
5040,U407AD4,78,10058.89,47,31,145788.78000000003,155847.66999999998
5041,UB95F85,78,6014.320000000001,59,19,8213.52,14227.839999999998
5042,U5F6D72,78,3824.3599999999997,68,10,4869.78,8694.14
5043,U24570A,78,157.8900000000001,73,5,2358.77,2516.66
5044,U78D45F,78,-6.821210263296962e-13,52,26,23016.559999999998,23016.56
5045,U513897,78,-4346.209999999996,61,17,29595.629999999997,25249.42
5046,U123982,78,14654.129999999997,28,50,204479.65,219133.78000000003
5047,U6ED86F,78,-682.300000000002,61,17,148142.16,147459.86000000002
5048,U2063ED,78,-700.7699999999977,39,39,79875.02,79174.25
5049,U03A66A,78,2.650000000000091,46,32,13968.370000000003,13971.02
5050,UB83AF3,78,11382.159999999998,63,15,37978.43,49360.59
5051,UFC8416,78,-14144.37,48,30,55145.92999999999,41001.56
5052,UD9C720,78,8802.68,75,3,21947.319999999992,30750.0
5053,UC0352C,78,-313.7200000000004,74,4,6067.83,5754.11
5054,UFDC9DC,78,-4140.15,37,41,18768.660000000003,14628.510000000002
5055,U894A71,78,24251.15,63,15,45048.39000000001,69299.54
5056,U6C1C4D,78,-9342.990000000002,59,19,48895.969999999994,39552.98
5057,UD90F06,78,-11021.920000000011,63,15,256231.73,245209.81
5058,UF10B56,78,-56597.400000000016,67,11,111815.22,55217.82
5059,U20C661,78,-434.47999999999917,54,24,20589.810000000005,20155.33
5060,U4DC1A4,78,-36765.01000000001,63,15,234015.69,197250.68
5061,U6D98CE,78,7313.879999999999,57,21,9304.95,16618.83
5062,UF7C01E,78,1118.8599999999988,65,13,115601.42,116720.28000000001
5063,UA89517,78,-674.0400000000088,47,31,563344.4799999999,562670.44
5064,UB4AC49,78,-7080.070000000002,73,5,29241.73,22161.66
5065,UFE60C3,78,-178403.97000000003,31,47,210362.05,31958.079999999998
5066,UFB9937,78,-3111.9799999999973,66,12,29309.539999999997,26197.56
5067,U827CBE,78,465.9699999999998,52,26,13581.08,14047.05
5068,UE72C38,78,-1109.4100000000014,72,6,62706.12000000003,61596.71
5069,UCDD4D0,78,-5690.850000000014,50,28,255264.90000000002,249574.05000000002
5070,UCC3C88,78,-45039.090000000004,75,3,62542.950000000004,17503.86
5071,UBCAB1E,78,-1686.44,65,13,11209.359999999999,9522.92
5072,U2C809A,78,-2142.5899999999992,65,13,59538.05000000001,57395.46
5073,U45CEBC,78,-28315.940000000002,68,10,38140.090000000004,9824.150000000001
5074,U191134,78,-8940.35000000001,53,25,139688.34999999998,130747.99999999999
5075,UE64139,78,-5021.52,72,6,11383.289999999995,6361.7699999999995
5076,UBAA964,78,144.49999999999997,61,17,2976.75,3121.25
5077,U0EB538,78,3639.0699999999974,69,9,30232.120000000003,33871.189999999995
5078,UD925ED,78,-301.5299999999965,73,5,44368.31,44066.78
5079,U3BF4E8,78,4605.529999999999,73,5,12472.47,17078.0
5080,UB95A51,78,469.37999999998965,53,25,244523.14,244992.52000000002
5081,U6AFEDE,78,274.78999999999996,72,6,2237.9300000000003,2512.72
5082,U883CEB,78,651.72,76,2,5276.280000000001,5928.0
5083,U3CBEA2,78,-3519.750000000002,72,6,12519.749999999998,9000.0
5084,U14581B,78,10860.5,58,20,114637.26000000002,125497.76
5085,U99944E,78,-737.4100000000009,66,12,3239.4400000000005,2502.0299999999997
5086,U16E1A5,78,-4931.4299999999985,42,36,23995.43,19064.0
5087,U52AB0B,78,-351.80999999999403,72,6,13514.729999999996,13162.920000000002
5088,U665333,78,2.2737367544323206e-13,39,39,23780.26,23780.26
5089,UA9D182,78,-3706.960000000001,61,17,74994.27000000002,71287.31
5090,U3ECC44,78,5162.050000000002,74,4,25656.800000000003,30818.85
5091,U1ABE4A,78,623.8399999999999,68,10,4450.829999999999,5074.67
5092,U2E4D1A,78,-5594.779999999992,58,20,109857.05,104262.27
5093,UD31FBA,78,-7373.81,61,17,70699.92,63326.11
5094,U0185AB,78,-39.999999999999545,52,26,8752.65,8712.65
5095,UF84BD3,78,13604.830000000002,71,7,15296.66,28901.489999999998
5096,U82C75B,78,-8158.090000000004,68,10,55115.090000000004,46957.00000000001
5097,U4E0665,77,-115995.43999999996,65,12,427886.49,311891.05
5098,UE7953A,77,-295.5000000000018,56,21,41222.3,40926.79999999999
5099,U8AC397,77,-1354.25,70,7,6215.51,4861.26
5100,U361985,77,-58394.22999999999,43,34,251590.55000000002,193196.32000000004
5101,U6255E6,77,-1865.609999999989,67,10,54196.240000000005,52330.630000000005
5102,U12186B,77,-9328.86000000001,65,12,110659.44,101330.58
5103,U811D8B,77,-6047.46,68,9,8194.38,2146.92
5104,U05AB56,77,-1014.8000000000029,67,10,41978.3,40963.5
5105,UBFE8DD,77,-14428.680000000013,58,19,128890.79000000002,114462.11
5106,UD20BA2,77,-12428.800000000001,75,2,15128.800000000001,2700.0
5107,U40FD4C,77,-794.3399999999999,73,4,1004.79,210.45000000000002
5108,U15DE69,77,-15136.359999999979,54,23,389608.43,374472.07
5109,U1A8379,77,1892.6400000000003,57,20,31162.58,33055.22
5110,UA13E17,77,596.8100000000003,69,8,2732.6000000000004,3329.4100000000003
5111,U040EF3,77,-975.96,74,3,5126.96,4151.0
5112,U7C237E,77,4122.12999999991,57,20,559843.51,563965.6399999999
5113,UDE06CA,77,-9406.45,50,27,65913.39,56506.94
5114,U7816D6,77,-4764.7699999999995,70,7,11801.330000000002,7036.56
5115,U97A7DB,77,-724.9899999999998,72,5,8452.080000000002,7727.089999999999
5116,U75D7D4,77,-6250.720000000005,66,11,60115.68,53864.96000000001
5117,U7D76CE,77,-13939.310000000001,65,12,36171.96,22232.65
5118,U2FE005,77,-2983.7800000000025,61,16,34427.49,31443.71
5119,U4AAE97,77,-12227.490000000002,66,11,48360.409999999996,36132.92
5120,UF4A95C,77,-10903.669999999991,75,2,50383.670000000006,39480.0
5121,U2D50D4,77,-31613.03,68,9,52043.92,20430.89
5122,U31DB2F,77,0.09999999999990905,39,38,7802.9,7803.0
5123,U634D99,77,-2522.7200000000003,63,14,16928.31,14405.59
5124,U42A3B0,77,4953.799999999999,70,7,5968.240000000001,10922.04
5125,U4DEB1F,77,570.8600000000006,55,22,19968.73,20539.59
5126,U92EE61,77,-30394.840000000004,65,12,81569.06000000001,51174.219999999994
5127,U6003E5,77,14239.340000000017,57,20,420129.33,434368.67000000004
5128,U56F893,77,22938.23,66,11,44558.770000000004,67497.0
5129,U99E164,77,18650.78,57,20,57774.149999999994,76424.93000000001
5130,U97A4B7,77,36477.63,58,19,233695.25,270172.88
5131,UF63430,77,1826.819999999999,55,22,10414.419999999998,12241.24
5132,U2D9FD8,77,41043.06999999998,39,38,289299.26,330342.33
5133,U898A4E,77,-5264.23,44,33,18554.839999999997,13290.610000000002
5134,U454555,77,-3620.5100000000034,68,9,27725.50999999999,24105.0
5135,U2D87D1,77,-24948.72999999999,66,11,159377.94,134429.21000000002
5136,U657CBC,77,6989.73,71,6,19950.270000000004,26940.0
5137,UC210E2,77,4940.1299999999965,71,6,24717.870000000003,29658.0
5138,U17AD12,77,14136.989999999994,69,8,100201.52,114338.51
5139,U6D8275,77,1874.0899999999988,61,16,23980.95,25855.04
5140,UCBAE76,77,2304.3999999999987,69,8,18446.250000000007,20750.65
5141,UB8DF9F,77,-2270.9500000000016,73,4,9539.599999999999,7268.65
5142,UE7465C,77,-25369.19000000006,49,28,2364150.08,2338780.89
5143,U258835,77,7265.709999999996,69,8,40988.34,48254.05
5144,UE96FF7,77,-3178.890000000001,66,11,6380.37,3201.4800000000005
5145,UA29858,77,66035.87999999999,54,23,289581.08,355616.96
5146,U87EE2B,77,-168849.22000000012,50,27,1187496.93,1018647.7100000001
5147,U7553FE,77,9439.9,70,7,18016.5,27456.4
5148,UCD289E,77,-1780.930000000002,70,7,5853.890000000002,4072.96
5149,UFA73AC,77,1359.8499999999995,70,7,4438.279999999999,5798.13
5150,U5A194B,77,-43574.799999999996,59,18,220643.09,177068.29
5151,UC8AAF8,76,2399.4199999999983,69,7,22524.699999999917,24924.119999999995
5152,U02F806,76,52363.69000000002,44,32,748287.28,800650.97
5153,U46248C,76,-1368.7499999999998,72,4,3711.9100000000003,2343.16
5154,U47C246,76,51908.46999999999,61,15,90205.88,142114.34999999998
5155,UFD7ACA,76,20706.559999999998,60,16,146771.36,167477.91999999998
5156,UC16CE9,76,-10247.070000000018,56,20,412916.48,402669.41
5157,UE965A4,76,-31965.619999999995,44,32,333198.26,301232.64
5158,UDF151E,76,2272.4100000000026,66,10,75889.55,78161.95999999999
5159,UCDD6F3,76,-16008.88,72,4,71165.72,55156.84
5160,U8712C8,76,130754.39000000007,61,15,253161.66,383916.05
5161,U310234,76,7978.129999999998,65,11,41896.729999999996,49874.86
5162,U785222,76,0.16000000000067305,57,19,16659.05,16659.21
5163,UF90BF8,76,-39234.850000000006,49,27,2321366.0,2282131.1500000004
5164,U101C72,76,19174.37,63,13,17403.339999999997,36577.71000000001
5165,UEF3B5B,76,-13630.229999999996,57,19,69241.08,55610.85
5166,U158160,76,16059.400000000009,58,18,189133.03999999995,205192.43999999997
5167,U23DFEF,76,2062.0199999999995,72,4,14050.869999999995,16112.89
5168,U71127E,76,1409.5600000000015,73,3,10028.36,11437.92
5169,U471AC6,76,-464.3800000000007,70,6,11374.479999999996,10910.1
5170,UEDB335,76,-4397.009999999999,66,10,15839.339999999998,11442.33
5171,U127112,76,4325.19,59,17,39657.939999999995,43983.13
5172,U295CD3,76,-1922.0499999999995,64,12,24282.55,22360.5
5173,UED9A99,76,-2825.0099999999993,71,5,26959.790000000005,24134.78
5174,UD24621,76,-1043.0600000000009,56,20,84714.08,83671.01999999999
5175,UE35887,76,-2566.15,66,10,2765.1800000000003,199.03
5176,UF22D14,76,2696.74,69,7,5192.570000000001,7889.31
5177,UAB9B36,76,-108722.61,71,5,178350.51999999996,69627.91
5178,UBCED5A,76,-5349.579999999991,42,34,599246.0600000002,593896.48
5179,U7F3301,76,846.3799999999683,44,32,309642.13999999996,310488.52
5180,UC30A7B,76,6860.759999999997,66,10,33507.520000000004,40368.28
5181,U6F6752,76,10671.239999999998,48,28,31778.88,42450.12
5182,U146DAA,76,4929.959999999999,73,3,4371.47,9301.43
5183,U05E71D,76,32.52999999999929,68,8,4803.43,4835.96
5184,U3AE8B9,76,-5595.06,69,7,9910.22,4315.16
5185,U1533DE,76,272.53999999999996,55,21,13674.970000000001,13947.51
5186,U0A99AA,76,-1997.8500000000004,64,12,5553.459999999999,3555.6100000000006
5187,U41FC50,76,-8004.709999999999,58,18,32907.649999999994,24902.940000000002
5188,U7B60EF,76,681.57,55,21,7188.749999999998,7870.320000000001
5189,UCA55BF,76,11107.169999999998,65,11,16434.92,27542.089999999997
5190,U2CC78B,76,-231468.6899999999,38,38,1863903.14,1632434.45
5191,U56DDBB,76,-2446.5999999999985,68,8,24874.470000000005,22427.87
5192,UF65E53,76,-2215.0699999999997,73,3,5349.0199999999995,3133.95
5193,U355A0D,76,3457.389999999998,48,28,55632.1,59089.48999999999
5194,U098032,76,6664.650000000005,68,8,21639.74,28304.389999999996
5195,U8C054A,76,-916.5300000000013,67,9,17705.619999999995,16789.09
5196,UC0741F,76,313.5600000000036,49,27,35163.28,35476.840000000004
5197,U7D3463,76,439.1000000000006,43,33,24644.93,25084.03
5198,U85BFD5,76,293.5200000000017,72,4,10499.75,10793.27
5199,U0B5546,76,-338.27000000000874,71,5,31692.860000000004,31354.59
5200,UB44BAB,76,-12372.179999999995,70,6,24167.4,11795.220000000001
5201,U284165,76,3167.3399999999997,55,21,27402.910000000003,30570.25
5202,UCB1958,76,-212.4899999999991,42,34,22675.399999999998,22462.91
5203,U44ED47,76,-306.8600000000008,68,8,10711.58,10404.720000000001
5204,UC4E357,76,-667.4900000000011,65,11,19186.22,18518.729999999996
5205,UCB07D2,76,146.97000000000043,57,19,16959.16,17106.13
5206,UE5216C,76,-24661.22,74,2,73676.98999999999,49015.77
5207,U4A8C18,76,-1382.6299999999956,63,13,23217.409999999993,21834.78
5208,U81F933,76,-47974.659999999996,48,28,132700.71000000002,84726.05000000002
5209,UF95368,75,525.97,73,2,1129.03,1655.0
5210,UAAA632,75,-91.54999999999995,67,8,1826.0,1734.4499999999998
5211,UF8C988,75,849.5999999999999,73,2,2550.4,3400.0
5212,U65FDE9,75,20867.619999999995,56,19,84791.20000000003,105658.81999999999
5213,U6243EA,75,-1149.0700000000002,68,7,3968.9900000000002,2819.92
5214,UD47D08,75,2914.6399999999994,56,19,243902.72,246817.36
5215,UDC8662,75,125081.12000000005,43,32,668311.27,793392.39
5216,UC8E166,75,1387.3399999999992,70,5,4492.700000000001,5880.04
5217,UC26838,75,-1127.200000000004,64,11,44806.91999999999,43679.719999999994
5218,U48783C,75,10886.559999999998,36,39,6833.539999999999,17720.1
5219,U182145,75,-483.5899999999995,70,5,7300.8899999999985,6817.3
5220,U92722E,75,419.45000000000033,57,18,37895.85000000002,38315.3
5221,U29A938,75,20759.73,67,8,9264.199999999999,30023.93
5222,UCE6076,75,-2756.309999999999,71,4,17056.350000000002,14300.04
5223,UE5132F,75,-887.6999999999953,57,18,135038.87,134151.17
5224,U5EC070,75,187835.67000000004,48,27,244764.77999999997,432600.45
5225,UAF6D6D,75,-192.30000000000024,71,4,3326.3,3134.0
5226,UA4BB65,75,324.3100000000002,69,6,1514.8300000000002,1839.14
5227,U252F21,75,4681.91,63,12,3244.78,7926.690000000003
5228,U6AD353,75,2991.5499999999997,67,8,10339.9,13331.45
5229,U94276B,75,1793.9800000000005,57,18,16259.91,18053.89
5230,UC3DC13,75,52916.89,52,23,665798.97,718715.86
5231,UFB7E16,75,2028.2499999999936,51,24,191766.56,193794.81
5232,U480783,75,-2292.5799999999995,55,20,7324.990000000001,5032.41
5233,U74E40F,75,-172.7999999999998,73,2,3910.3800000000006,3737.58
5234,UCA83D5,75,-10591.930000000008,58,17,94968.27999999998,84376.34999999999
5235,UF576C2,75,-2286.110000000001,63,12,36461.74000000001,34175.630000000005
5236,U54ED06,75,-2220.04,71,4,15081.459999999995,12861.42
5237,U68F467,75,290853.8,55,20,1105523.13,1396376.93
5238,UF18AFD,75,-6062.57,49,26,22816.390000000003,16753.82
5239,U5CF202,75,-9123.730000000001,69,6,29764.71,20640.98
5240,U84D729,75,-511.01999999999975,14,61,4939.5,4428.479999999997
5241,U71A9EB,75,-691.4699999999999,73,2,3691.4699999999993,3000.0
5242,U440B8C,75,-8884.270000000002,37,38,128995.54,120111.27
5243,UF391C5,75,0.6900000000025557,65,10,17511.739999999998,17512.429999999997
5244,U3C4873,75,1032.2999999999995,72,3,4559.130000000004,5591.43
5245,UDC9F50,75,25208.80000000001,67,8,61856.22999999999,87065.03
5246,U1B9C6B,75,8448.139999999998,62,13,73050.87000000001,81499.01
5247,U3CC3A4,75,-78853.79999999999,65,10,103018.91,24165.109999999997
5248,U25A8DA,75,806.9999999999998,58,17,10364.79,11171.789999999999
5249,UCED96B,75,-53040.18000000011,44,31,1521228.3,1468188.12
5250,UBDC3D0,75,1070.3300000000002,67,8,4963.070000000001,6033.4
5251,U4880A0,75,151.43999999999957,45,30,25430.250000000004,25581.690000000002
5252,UC237A9,75,-156863.68,61,14,298908.67,142044.99000000002
5253,U7C79E7,75,0.029999999999997584,60,15,67569.98,67570.01
5254,UDFFF5C,75,-2533.59,71,4,9852.38,7318.79
5255,UF8550A,75,-1476.5500000000013,49,26,15718.43,14241.88
5256,U8E9958,75,-293.54999999999916,70,5,9362.710000000003,9069.16
5257,UB4E1A2,75,-20683.919999999984,37,38,645203.52,624519.6
5258,UFB6F1A,75,7794.119999999999,70,5,7994.829999999999,15788.949999999999
5259,U277B2A,75,31483.479999999996,32,43,1469801.7100000002,1501285.1899999997
5260,U2E1388,75,-6433.730000000001,70,5,27932.55,21498.82
5261,U0B16D1,75,-894.4700000000024,64,11,60237.1,59342.630000000005
5262,UE13739,75,23260.95,58,17,65041.46999999999,88302.42
5263,U3DF5D8,75,640.8000000000029,56,19,54861.99999999999,55502.8
5264,U62E6D3,75,-7829.540000000002,67,8,14080.310000000001,6250.7699999999995
5265,U4A03E4,75,-509.22999999999934,68,7,8032.879999999998,7523.65
5266,U3EA9E4,75,2900.459999999998,61,14,29648.28,32548.74
5267,UAD9AE2,75,16060.58,57,18,16283.57,32344.15
5268,UFFE7E4,75,-17614.21,63,12,82679.37,65065.159999999996
5269,U2858DB,75,-3469.2300000000005,49,26,79828.49000000002,76359.26000000001
5270,U2FE097,75,148.58999999999983,64,11,4878.740000000002,5027.33
5271,UF1863B,75,-32.880000000000244,72,3,4271.3,4238.42
5272,UC47DE8,75,-4752.729999999996,63,12,111523.45999999999,106770.73000000001
5273,UF74D73,75,1886.8499999999995,69,6,12545.309999999998,14432.159999999998
5274,U9D8985,74,-653.4900000000034,42,32,87568.09999999999,86914.61000000002
5275,U9D2910,74,-20617.67,63,11,67953.86,47336.189999999995
5276,UECF254,74,-13692.019999999993,49,25,224160.42,210468.40000000002
5277,U428E39,74,2116.249999999998,47,27,91547.86,93664.11
5278,U083491,74,7713.150000000001,63,11,17467.82,25180.97
5279,U08D281,74,3911.18,66,8,5952.830000000001,9864.01
5280,UDA44F4,74,2907.9699999999993,66,8,24853.350000000006,27761.320000000003
5281,UB78084,74,-2585.7700000000004,50,24,226242.01,223656.24
5282,U618258,74,17207.77999999997,54,20,165375.25999999998,182583.04
5283,U38725D,74,534.7200000000001,68,6,2748.9299999999994,3283.6499999999996
5284,UF78ACB,74,-939.6000000000005,67,7,7937.630000000006,6998.030000000001
5285,UB66A14,74,-282.0999999999996,62,12,5802.490000000001,5520.39
5286,U82EE09,74,-245.2499999999999,66,8,6546.7699999999995,6301.52
5287,U5B2FF9,74,-166.27999999999912,66,8,16163.489999999998,15997.21
5288,U3CE281,74,-495.19000000000005,66,8,5242.6900000000005,4747.5
5289,U7B4A40,74,1744.6099999999901,60,14,126501.77000000002,128246.37999999999
5290,UAB60CD,74,-15917.73,74,0,15917.73,0.0
5291,U515F90,74,3015.9399999999964,52,22,202613.91,205629.84999999998
5292,U23FCC8,74,-0.5199999999858846,56,18,419788.26999999996,419787.75
5293,U6E05F1,74,-960.3100000000159,61,13,190401.69999999998,189441.39
5294,U43BEB4,74,-2387.1999999999994,67,7,14709.719999999998,12322.52
5295,UC93CEB,74,943.3099999999997,69,5,7142.6900000000005,8086.0
5296,U0FF65D,74,-486.52000000000095,58,16,15832.91,15346.39
5297,U198F1D,74,-59449.76,70,4,84403.45,24953.69
5298,U785EE5,74,-55.18000000000036,64,10,4895.039999999999,4839.860000000001
5299,U1CEEFE,74,136.71000000000004,59,15,15591.35,15728.06
5300,U9010A9,74,85.44000000000004,46,28,15698.170000000002,15783.609999999999
5301,U89CBC8,74,-2925.2,43,31,38029.390000000014,35104.19
5302,UD3B78C,74,-850.0100000000009,72,2,13516.79,12666.78
5303,UF124BB,74,31789.98000000004,34,40,595197.94,626987.9199999999
5304,U29B32F,74,2657.630000000001,53,21,27471.48,30129.11
5305,U128D93,74,17878.819999999996,68,6,98636.56,116515.38
5306,U38570A,74,6927.889999999998,67,7,9804.12,16732.010000000002
5307,U2BC1AC,74,-15487.510000000002,69,5,22062.58,6575.07
5308,U4EC8D5,74,-1035.62,68,6,2610.7200000000003,1575.1
5309,U713FD0,74,2909.8099999999868,50,24,101493.29000000002,104403.09999999995
5310,UFB9C9D,74,407.40000000000015,40,34,7896.86,8304.26
5311,U78FA97,74,5088.43,58,16,29102.99,34191.42
5312,UFB5999,74,-2000.4599999999937,53,21,65107.56999999999,63107.11
5313,U713436,74,-499.199999999998,70,4,12098.939999999997,11599.74
5314,UD509E4,74,-18255.09,68,6,22910.780000000006,4655.6900000000005
5315,UAF6C3E,74,3368.4900000000016,60,14,46162.399999999994,49530.89
5316,U150DC9,74,-64.41000000000291,63,11,8029.720000000008,7965.31
5317,U4F56A1,74,592.9500000000003,56,18,14493.56,15086.509999999998
5318,U1B5793,74,499.09000000000015,51,23,31797.929999999997,32297.02
5319,U05B102,74,-120.39999999999834,69,5,21037.720000000005,20917.32
5320,UBF8A0B,74,6375.569999999999,54,20,71733.31,78108.88
5321,U90AB84,74,2.600000000000364,60,14,25547.620000000003,25550.22
5322,U77E81F,74,5550.379999999999,57,17,6832.930000000001,12383.31
5323,U0A0269,74,135.83000000000993,33,41,179425.4,179561.22999999998
5324,UCEC239,74,875.6799999999998,70,4,5956.099999999999,6831.780000000001
5325,U72212A,74,2243.62,49,25,8182.450000000002,10426.070000000002
5326,U1A7D0D,74,2021.2600000000011,56,18,40043.43000000001,42064.689999999995
5327,U6F35EC,74,-24320.669999999962,57,17,336429.05999999994,312108.39
5328,UBD03D7,74,-812.4000000000013,70,4,6767.919999999999,5955.52
5329,UFD2610,74,3329.9700000000025,71,3,13573.03,16903.0
5330,UDBAB48,74,-244.30000000000055,67,7,5508.63,5264.330000000001
5331,UD48EA4,74,15117.87,69,5,8954.080000000002,24071.95
5332,U3BE661,74,15635.190000000008,64,10,13062.069999999985,28697.26
5333,U485863,74,68.49000000000001,48,26,10838.289999999999,10906.779999999999
5334,U0228B7,74,-21093.35,56,18,50648.770000000004,29555.420000000002
5335,UEFC5D6,74,-211.8200000000002,66,8,6242.499999999998,6030.679999999999
5336,UEDCB92,74,-13552.120000000003,51,23,83033.86,69481.73999999999
5337,U957689,74,20999.060000000005,52,22,18844.189999999995,39843.25
5338,UE58471,74,-9393.56999999999,55,19,41538.65000000002,32145.08
5339,UA896AA,74,4147.379999999998,58,16,7805.980000000002,11953.36
5340,U62DD21,74,3497.8500000000004,53,21,6342.470000000002,9840.32
5341,U0676FD,74,-15529.039999999997,49,25,139708.16,124179.12
5342,U69715B,74,-7426.27999999999,67,7,47091.64,39665.35999999999
5343,U040865,74,-1035.729999999996,45,29,808820.5499999999,807784.8199999998
5344,U73C91C,74,-9993.299999999981,56,18,137803.88999999998,127810.58999999998
5345,U8CF52B,74,-1194.0000000000027,50,24,16458.23999999999,15264.24
5346,U3D4309,74,-630.649999999996,57,17,70026.34,69395.69
5347,U84D507,74,4975.329999999999,58,16,18712.089999999997,23687.42
5348,U57BCB5,74,21806.229999999996,62,12,54911.02999999999,76717.26000000001
5349,UBA4CD4,74,-4203.319999999999,61,13,15800.62,11597.3
5350,U8240D3,73,-1.3299999999993233,43,30,11473.55,11472.22
5351,U61D6C2,73,-2313.999999999999,60,13,58494.0,56180.0
5352,UBA2134,73,-4723.18,64,9,46029.17999999999,41306.0
5353,U5B2390,73,-23296.710000000014,72,1,23796.710000000014,500.0
5354,U6AB5A2,73,-4431.199999999997,68,5,32281.68,27850.480000000003
5355,UE671F6,73,-25691.460000000003,70,3,47231.59,21540.13
5356,UFE1137,73,-10853.459999999997,61,12,41332.39,30478.93
5357,U9939C9,73,-125.8399999999998,62,11,5058.59,4932.75
5358,U3572D4,73,-3159.640000000003,55,18,17216.940000000002,14057.3
5359,UACDBCE,73,-9158.869999999999,68,5,44923.29000000001,35764.42
5360,U889009,73,-415.7000000000008,52,21,3744.210000000001,3328.5099999999993
5361,U12E373,73,-0.25,67,6,1117.09,1116.84
5362,UB99AEF,73,-1.7099999999998658,55,18,32267.510000000002,32265.8
5363,UC1C97D,73,1946.429999999999,58,15,28150.840000000004,30097.27
5364,U7D1ECA,73,15627.35000000002,29,44,876151.53,891778.8800000001
5365,UEC7577,73,-2726.62,57,16,12549.050000000001,9822.43
5366,U27DBE5,73,6869.129999999997,51,22,138627.04000000007,145496.16999999998
5367,U4AA70A,73,-11038.640000000003,45,28,99439.50000000003,88400.86000000002
5368,U133234,73,8535.659999999996,69,4,36846.15,45381.81
5369,U072826,73,305.8799999999996,63,10,6105.630000000002,6411.51
5370,UEC08BE,73,5337.459999999999,60,13,17346.24,22683.7
5371,UDE6190,73,7521.109999999999,37,36,72556.0,80077.11
5372,U353877,73,-9656.440000000024,62,11,312602.00999999995,302945.56999999995
5373,U22A375,73,-21199.32,65,8,52077.83,30878.510000000002
5374,UAE2EF1,73,-34923.65000000001,61,12,94077.45000000003,59153.8
5375,UC92327,73,65275.71,66,7,16589.920000000002,81865.63
5376,U1D00FF,73,-5247.709999999999,55,18,73861.88999999998,68614.18000000001
5377,U27CA18,73,-26.780000000001564,71,2,5721.780000000001,5695.0
5378,UE21CB5,73,2522.9199999999987,65,8,19395.04,21917.96
5379,U978845,73,23534.800000000003,63,10,68474.75,92009.54999999999
5380,U601C94,73,56.83999999999968,68,5,5588.4299999999985,5645.27
5381,U8EB73B,73,-352.0799999999999,41,32,8390.12,8038.04
5382,U770A3F,73,-7127.93,68,5,22131.71,15003.78
5383,U5396D3,73,-9157.159999999993,58,15,38104.51,28947.35
5384,UBA906E,73,3045.0600000000004,55,18,7848.880000000001,10893.94
5385,UB67FAE,73,4937.399999999999,56,17,51210.56,56147.96
5386,U6DD15E,73,7277.490000000001,64,9,9192.819999999998,16470.31
5387,U7FFB3F,73,3517.1399999999976,69,4,8006.860000000001,11524.0
5388,UE5AACE,73,-2884.6800000000003,54,19,9484.669999999998,6599.990000000001
5389,UA21AC9,73,-16539.11,55,18,42473.420000000006,25934.309999999998
5390,UBA3F0E,73,1389.1899999999991,69,4,6658.549999999999,8047.74
5391,U6E5E05,73,97863.00999999998,64,9,49973.03,147836.03999999998
5392,UFD81E2,73,-3772.09,64,9,11546.439999999999,7774.349999999999
5393,U6BE1BA,73,8097.0199999999995,65,8,28671.21,36768.23000000001
5394,UC91549,73,6628.35,51,22,109038.36,115666.71
5395,U048700,73,-2146.920000000002,51,22,54262.5,52115.58
5396,UCFB5A7,73,-6732.450000000002,64,9,116372.53,109640.07999999999
5397,UAFF1E4,73,54909.729999999996,50,23,326686.3300000001,381596.06
5398,UD45B59,73,-35820.52,70,3,55905.56,20085.04
5399,U2410C0,73,2012.0900000000006,67,6,6401.939999999999,8414.03
5400,U05CA41,73,-17999.270000000015,49,24,510347.78,492348.50999999995
5401,UCAA21D,73,-2087.6700000000005,65,8,5740.339999999997,3652.67
5402,U0BA7F5,73,90279.11000000003,40,33,510135.45,600414.56
5403,U53185C,73,5400.960000000001,67,6,9788.349999999999,15189.310000000001
5404,U5A6E75,73,657.2100000000014,70,3,17556.12,18213.33
5405,UF7A394,73,-2396.5099999999993,63,10,9031.51,6635.0
5406,U55EFA8,73,-6568.67,57,16,39231.950000000004,32663.28
5407,UFAF535,73,-14.339999999996508,37,36,1700047.7599999998,1700033.42
5408,U292361,73,52.51000000000022,48,25,85780.59000000001,85833.09999999999
5409,UA33B86,73,184.73000000000025,69,4,1896.4700000000005,2081.2
5410,U167819,73,-15386.530000000004,57,16,71441.3,56054.77
5411,UA46147,73,6701.25,62,11,4518.120000000001,11219.37
5412,U203DAD,73,7352.9399999999805,31,42,109413.92,116766.86
5413,UD0C285,73,3457.1900000000005,67,6,9162.89,12620.08
5414,U828F81,73,-2420.3000000000015,65,8,12533.499999999998,10113.2
5415,U64F1F7,73,-1909.4700000000005,64,9,12131.339999999998,10221.869999999999
5416,U231B88,73,288553.2000000002,61,12,2446900.9800000004,2735454.18
5417,U0A3739,73,-1.0000000000000342,37,36,21528.340000000004,21527.34
5418,U2D8142,73,-5400.93,63,10,28638.33000000001,23237.400000000005
5419,UF53527,72,-3674.1400000000012,67,5,9207.410000000002,5533.27
5420,U982B18,72,-707.1899999999995,63,9,7605.700000000001,6898.51
5421,UC046FA,72,17448.390000000003,42,30,8321.39,25769.78
5422,U7996F8,72,-2679.8700000000017,61,11,20208.01,17528.14
5423,UE9923E,72,14472.47,22,50,25688.710000000003,40161.17999999999
5424,U91B1B7,72,6359.68,37,35,89355.96,95715.63999999998
5425,UD514E4,72,1930.6299999999994,46,26,3732.650000000001,5663.28
5426,UA2A73C,72,5780.410000000004,56,16,35194.799999999996,40975.21000000001
5427,U3D3635,72,-1400.300000000003,53,19,118286.3,116886.0
5428,UFB0DB7,72,-3632.0000000000005,67,5,9632.14,6000.139999999999
5429,UD3EAFB,72,818.9300000000023,59,13,21979.039999999997,22797.969999999998
5430,U28D2DA,72,-4502.12,43,29,94411.79,89909.67000000001
5431,U93DC4D,72,-3045.67,67,5,7305.58,4259.91
5432,UAD79A3,72,-1987.5200000000002,66,6,10972.6,8985.08
5433,U9205A9,72,111.98999999999754,50,22,60653.54,60765.53
5434,UAFA380,72,-2739.9799999999996,45,27,8562.779999999999,5822.8
5435,U8320A2,72,-3461.129999999971,54,18,317809.01999999996,314347.89
5436,UFB8100,72,0.9500000000001076,56,16,4199.44,4200.39
5437,U911579,72,20718.140000000003,51,21,181602.31,202320.45
5438,U862152,72,-5500.089999999998,57,15,34944.409999999996,29444.32
5439,U5BF877,72,42415.15999999999,64,8,154391.83000000002,196806.99
5440,UC14714,72,-1113.6300000000017,42,30,7794.9,6681.2699999999995
5441,UCF45BC,72,608.24,66,6,3847.6,4455.84
5442,U8B495E,72,-56332.0,39,33,233689.87,177357.87
5443,U69804A,72,-243089.55000000002,48,24,2229761.1699999995,1986671.62
5444,UFD3C4B,72,169.8499999999949,63,9,20317.860000000008,20487.71
5445,UE2F66D,72,-1928.8499999999992,70,2,4911.849999999999,2983.0
5446,U743EA7,72,835.63,68,4,2318.2399999999993,3153.87
5447,UA31347,72,51.579999999999515,66,6,986.6900000000006,1038.27
5448,UCBDBAA,72,52238.38999999998,55,17,139945.55000000002,192183.93999999997
5449,U93E09F,72,-12685.729999999998,69,3,12685.999999999996,0.27
5450,U49D667,72,-2160.42,60,12,22762.0,20601.579999999998
5451,U93EC09,72,-1902.640000000003,54,18,75323.45999999999,73420.81999999999
5452,UE0A3E8,72,-3409.240000000007,31,41,63491.009999999995,60081.77000000006
5453,U89D786,72,-6881.979999999998,58,14,41830.78,34948.8
5454,UAA62BD,72,9162.13,62,10,17299.87,26462.0
5455,U1115D4,72,100732.08000000005,32,40,939350.98,1040083.0599999999
5456,U5C08B6,72,-1194.5799999999958,65,7,25731.60999999999,24537.03
5457,U76B567,72,-1060.4000000000042,55,17,77195.72,76135.32
5458,U7F5F44,72,-855.9599999999998,68,4,9628.099999999999,8772.140000000001
5459,U35DE12,72,-8849.589999999995,64,8,18922.740000000005,10073.15
5460,U2C4743,72,-1531.32,59,13,5728.380000000001,4197.06
5461,UDEDCF2,72,3.399999999999565,63,9,24881.870000000003,24885.27
5462,UEEBFF3,72,668.6299999999994,70,2,1903.0600000000009,2571.69
5463,UBDF4DE,72,-1862.6799999999998,64,8,7072.03,5209.35
5464,U8956EE,72,-2772.599999999999,66,6,10614.599999999997,7842.0
5465,U7A1CA1,72,817.5799999999987,62,10,6988.850000000003,7806.43
5466,UD9D8FC,72,1537.08,38,34,57994.14,59531.22
5467,U29C181,72,49979.27999999997,35,37,843078.57,893057.85
5468,U49F0E9,72,-195.34000000000003,69,3,1053.16,857.8199999999999
5469,U034C3E,72,76.36000000000055,70,2,6008.240000000001,6084.6
5470,U461F52,72,119143.47,62,10,55210.030000000006,174353.5
5471,U495B39,72,141.75999999999476,46,26,465979.88,466121.64
5472,U9BBF02,72,-6360.899999999994,52,20,91070.22,84709.32
5473,UC2035D,72,-1619.7400000000011,65,7,6896.75,5277.01
5474,U96A3E9,72,-6715.719999999998,59,13,42826.32,36110.6
5475,UC0A6D0,72,647.8800000000006,45,27,15154.430000000002,15802.31
5476,UEF7E55,72,-474.4400000000001,68,4,1621.47,1147.03
5477,U059AB2,72,-1486102.2,38,34,3120362.88,1634260.68
5478,U132C9B,71,380.4299999999903,46,25,47969.169999999984,48349.6
5479,UC66D8E,71,-1596.7099999999991,34,37,466598.3,465001.58999999997
5480,U8AC1CC,71,437.6100000000001,69,2,3788.39,4226.0
5481,UE63B18,71,-558.54,54,17,54220.540000000015,53662.0
5482,U22A695,71,23.819999999993232,49,22,29076.030000000013,29099.849999999988
5483,UED2CE2,71,-1968.6399999999933,57,14,40657.32000000001,38688.68
5484,U0B5B49,71,23562.889999999996,47,24,249310.69999999995,272873.58999999997
5485,U034E7E,71,7532.920000000002,60,11,44768.57000000001,52301.49
5486,U772091,71,12084.75,62,9,62409.350000000006,74494.1
5487,UA8E9A3,71,21800.28000000001,42,29,227165.02000000002,248965.30000000002
5488,U647321,71,4417.529999999999,64,7,10090.480000000001,14508.01
5489,U06373F,71,-139.73999999999978,64,7,4723.37,4583.629999999999
5490,U3390BF,71,-14440.849999999997,40,31,104437.56999999999,89996.72
5491,U0DC660,71,-1685.3000000000002,64,7,13810.63,12125.33
5492,U1E16D8,71,4417.869999999999,68,3,6082.13,10500.0
5493,UB39EE8,71,-3524.2700000003815,56,15,1530998.8200000003,1527474.55
5494,U01B860,71,2478.129999999999,50,21,27547.439999999995,30025.569999999996
5495,UCB2848,71,308.4299999999887,62,9,80844.13000000002,81152.55999999998
5496,U0FE582,71,11240.279999999999,53,18,22506.739999999998,33747.020000000004
5497,U36BD5C,71,6767.480000000003,68,3,6782.869999999999,13550.35
5498,U504046,71,-1972.3100000000004,67,4,4890.710000000001,2918.4
5499,U801F57,71,14752.380000000001,62,9,64477.399999999994,79229.78
5500,UC9ABE5,71,39.94999999999982,39,32,4314.179999999999,4354.13
5501,UA94890,71,-1427.6400000000012,62,9,10844.169999999998,9416.529999999999
5502,U4B12AD,71,4807.72,61,10,27508.53,32316.25
5503,U451700,71,2183254.6300000004,37,34,2805273.2,4988527.83
5504,UF1EEFC,71,-1013.3100000000031,53,18,71377.15000000001,70363.84
5505,U67C9E7,71,5740.889999999992,60,11,72882.68999999999,78623.58
5506,U257747,71,-13.19999999999709,33,38,517624.0,517610.8
5507,U88F3CA,71,2812.930000000008,50,21,154858.66,157671.59
5508,UAF89EE,71,-20008.929999999997,50,21,127843.83999999998,107834.91000000002
5509,U3D66ED,71,-22618.070000000003,62,9,66315.87,43697.8
5510,U934D7A,71,-370.8199999999988,50,21,28175.729999999996,27804.91
5511,UCFEFF8,71,-34.96999999999994,55,16,2284.5299999999997,2249.5600000000004
5512,UD928E3,71,4397.570000000001,60,11,14032.929999999997,18430.500000000004
5513,UDC4804,71,945.8200000000002,55,16,9029.63,9975.449999999999
5514,U8C0179,71,16503.48,62,9,180096.52000000002,196600.0
5515,U0FA09D,71,-584.9500000000004,57,14,19798.53,19213.58
5516,U2AF07D,71,-3224.7699999999995,63,8,24371.830000000005,21147.06
5517,UF3EE35,71,1043.6600000000014,62,9,18358.970000000005,19402.63
5518,U7A0068,71,13012.55,52,19,12358.87,25371.420000000002
5519,UAC6152,71,-6774.149999999994,55,16,147070.54,140296.39
5520,U08857D,71,9165.329999999998,58,13,60385.12999999999,69550.45999999999
5521,UDB8133,71,-1392.8399999999997,70,1,3432.8399999999997,2040.0
5522,UA8D6FF,71,6920.839999999979,51,20,222106.01000000004,229026.85000000003
5523,U2890B0,71,2240.369999999999,50,21,201411.89,203652.25999999998
5524,UFAC20D,71,3649.2499999999864,47,24,230274.31,233923.56
5525,UDC66B6,71,3328.4999999999995,64,7,6432.37,9760.87
5526,U266E67,71,46595.649999999994,42,29,158685.47999999998,205281.13
5527,UEFE886,71,-6427.040000000001,57,14,23784.35,17357.31
5528,UC7B82B,71,-29738.900000000005,54,17,200162.76000000004,170423.86
5529,U9B1B7D,71,1150.4700000000032,55,16,157540.89999999997,158691.37
5530,UFB0FD6,71,3427.6800000000003,68,3,7795.009999999999,11222.69
5531,U6303C1,71,8314.439999999999,62,9,65019.41,73333.85
5532,UE955FC,71,8750.52,68,3,3616.9,12367.42
5533,U4C073F,71,-352.1899999999987,40,31,63232.73,62880.53999999999
5534,UBCA962,71,-531.0599999999995,39,32,3523.9900000000002,2992.93
5535,U88AF03,71,458653.22000000003,57,14,1023991.5100000002,1482644.73
5536,U14DD44,71,-182.5699999999987,45,26,9911.46,9728.89
5537,UF8CD65,71,-1858.5600000000002,66,5,5210.559999999999,3352.0
5538,U007807,71,-21800.89,52,19,76280.5,54479.61
5539,UF8F8B8,71,8617.970000000001,40,31,49231.52,57849.49
5540,U596620,71,1107.1199999999997,69,2,4892.88,6000.0
5541,U40E1D0,71,84791.62000000001,61,10,88208.98999999999,173000.61
5542,U47F662,71,3593.439999999998,50,21,33811.30000000002,37404.740000000005
5543,UB9B7E0,71,92.91999999999462,54,17,39263.03,39355.950000000004
5544,U2B42BD,71,-1958.5300000000004,66,5,6617.97,4659.44
5545,U503D09,71,4965.480000000001,64,7,11423.25,16388.73
5546,U9235C6,71,4232.42,36,35,26987.960000000003,31220.38
5547,U01EE63,70,-24391.44999999999,58,12,91702.13999999998,67310.69
5548,UCC45EF,70,17406.950000000004,51,19,87416.84999999999,104823.80000000002
5549,UBE3689,70,5229.819999999992,57,13,45756.21,50986.03
5550,U831DCC,70,7410.820000000002,61,9,13898.419999999996,21309.24
5551,U1C842F,70,28640.38,67,3,5845.0599999999995,34485.44
5552,UDF0E42,70,-338.73,60,10,867.7499999999999,529.02
5553,U356374,70,-1625.02,57,13,11661.830000000002,10036.810000000001
5554,U21F9FB,70,839.4400000000012,41,29,23651.719999999998,24491.16
5555,U0235C4,70,-0.13999999999992951,46,24,1752.8700000000001,1752.7300000000005
5556,U8EDD19,70,-3595.4300000000007,44,26,214679.47,211084.03999999998
5557,U110DFA,70,-1.320000000006985,39,31,1371046.75,1371045.4300000002
5558,U0BD137,70,266.8100000000017,60,10,13205.609999999997,13472.42
5559,U65F169,70,-6641.6900000000005,64,6,14520.159999999998,7878.469999999999
5560,UE65F3C,70,1243.1300000000065,26,44,202334.52000000002,203577.65000000002
5561,UDFB3CA,70,-2989.139999999999,53,17,24544.920000000002,21555.779999999995
5562,UCC552B,70,7133.380000000003,59,11,32420.540000000005,39553.92
5563,U9CEA82,70,-2444.65,60,10,15589.049999999996,13144.400000000001
5564,U6CF79E,70,-10169.910000000003,54,16,31689.58,21519.67
5565,U76F363,70,-1532.2099999999975,64,6,17601.859999999997,16069.65
5566,UF1E475,70,1599.9999999999998,37,33,3010.0,4610.0
5567,U2220D5,70,-10145.720000000003,42,28,157826.25999999995,147680.54
5568,UA951C8,70,88.79000000000201,50,20,44172.49000000001,44261.28
5569,UB02167,70,-1734.5999999999976,52,18,32720.210000000003,30985.61
5570,UBB6F4A,70,2651.8100000000018,64,6,8979.460000000001,11631.27
5571,U2D45AB,70,-3071.62,59,11,12991.839999999998,9920.220000000001
5572,UC6C46D,70,-2722.999999999998,54,16,40167.34,37444.34
5573,UE18DD5,70,-3062.42,63,7,10245.749999999998,7183.330000000001
5574,UDBB4D8,70,5860.360000000003,68,2,22491.699999999993,28352.06
5575,UECE6F0,70,6685.1900000000005,61,9,306951.2000000001,313636.39
5576,UBE889D,70,332.85000000000025,67,3,1975.5700000000002,2308.42
5577,U4E9741,70,-667.26,69,1,835.26,168.0
5578,U0D27E3,70,-17591.519999999993,46,24,120121.89,102530.37000000001
5579,UD53AE2,70,-1600.2600000000011,41,29,60754.69,59154.43
5580,U079102,70,-95.5999999999996,59,11,10414.59,10318.99
5581,UDC02CB,70,-14617.490000000002,33,37,100522.06000000001,85904.56999999999
5582,U5E5F2C,70,124940.81,42,28,275615.85,400556.66000000003
5583,U08CB10,70,18654.26000000001,50,20,150565.97999999998,169220.24000000002
5584,U93929B,70,759.5299999999991,49,21,27105.340000000004,27864.869999999995
5585,UD55169,70,-7218.4,46,24,39418.4,32200.0
5586,U97555E,70,-331.1500000000002,64,6,2461.76,2130.61
5587,UCCE6CE,70,259.5199999999986,49,21,40377.35999999999,40636.88
5588,U0B3B6F,70,-72255.34999999998,48,22,4743420.73,4671165.38
5589,UFF0CE1,70,111636.10999999999,50,20,977946.0,1089582.1099999999
5590,UCA0A64,70,3273.319999999999,62,8,42145.060000000005,45418.38
5591,U253507,70,3902.600000000004,50,20,59854.01,63756.61
5592,U11D57F,70,-1861.3799999999999,64,6,7709.38,5848.0
5593,UAD6D8F,70,592.559999999994,48,22,87322.47,87915.03
5594,UD1B571,70,6293.0199999999995,63,7,2705.1799999999994,8998.199999999999
5595,U1D8253,70,-356.24,57,13,26861.499999999996,26505.260000000002
5596,U14715E,70,-15822.55000000001,54,16,129797.20000000001,113974.65000000001
5597,UC8FAD0,70,-3272.0499999999956,61,9,89393.2,86121.15
5598,U86442D,70,-148.45000000000118,63,7,12812.36,12663.91
5599,UF24ED7,70,436.2499999999974,64,6,19622.170000000002,20058.420000000002
5600,UC0B0F7,70,8449.700000000017,54,16,199969.60999999996,208419.31
5601,U922765,70,1644.1200000000022,51,19,40665.89999999999,42310.02
5602,UF56BB1,70,398.98999999999995,45,25,42196.36,42595.34999999999
5603,UE82927,70,-2814.5500000000006,64,6,6314.349999999999,3499.8
5604,U97E065,70,376.0600000000002,61,9,4087.4700000000003,4463.53
5605,U2B2486,70,37768.47,46,24,115804.7,153573.16999999998
5606,UC21B99,70,793.6999999999998,58,12,2300.0700000000006,3093.77
5607,UCB9218,70,-2026.0900000000001,62,8,15928.229999999998,13902.14
5608,U20657A,70,461.4500000000005,42,28,3789.7999999999997,4251.25
5609,U441F40,70,114.22000000000116,55,15,70803.32,70917.54000000001
5610,UB4DC5D,70,-21383.739999999998,59,11,250261.91000000003,228878.17
5611,U70C70A,70,15381.629999999997,59,11,32152.34,47533.97
5612,UE56EBF,70,-1468.2900000000016,62,8,48982.43,47514.14
5613,U723A05,70,-3211.5800000000004,59,11,33004.13,29792.55
5614,UE354EB,70,4602.17,56,14,15771.509999999998,20373.68
5615,U0ACB15,70,4002.0099999999998,56,14,11961.89,15963.9
5616,UCC298D,70,3018.4400000000014,55,15,29290.08,32308.520000000004
5617,U696FFF,70,-1181.3399999999992,50,20,24393.85,23212.51
5618,U52BBED,70,-58612.630000000005,40,30,239660.49,181047.86
5619,UAB88C0,70,945.329999999999,60,10,7833.19,8778.52
5620,UE19ECD,70,202.61999999999995,63,7,3402.9500000000003,3605.57
5621,U346BC4,70,-530.5800000000002,60,10,20638.399999999998,20107.82
5622,UC1BD2B,70,-654.6999999999971,51,19,64766.24,64111.54
5623,U93E6F3,70,-763.6499999999975,52,18,29449.979999999996,28686.33
5624,U6F417C,70,3395.999999999999,67,3,9734.12,13130.119999999999
5625,U543291,70,-4369.660000000002,67,3,13893.639999999998,9523.98
5626,U4F5786,70,-2313.05,61,9,20894.439999999995,18581.39
5627,U0A3088,70,1282.8499999999988,45,25,30066.509999999995,31349.359999999997
5628,U322EBB,70,4110.989999999998,59,11,19503.25,23614.239999999998
5629,U789968,70,-27.5,52,18,7549.5,7522.0
5630,U6E94ED,70,-2216.5500000000015,23,47,20466.0,18249.449999999997
5631,UCD5D5B,70,1418.1600000000017,52,18,10650.190000000002,12068.35
5632,UC5E04A,70,-29.07999999999936,66,4,21029.08,21000.0
5633,U9E2BB9,70,-2721.94,46,24,29184.940000000002,26463.0
5634,U73C477,70,562.4100000000004,67,3,3631.0900000000006,4193.5
5635,U363564,70,-1133.5499999999995,66,4,4929.62,3796.07
5636,U566BC9,70,7991.790000000003,64,6,101613.15999999999,109604.95
5637,UF0EB75,69,-2189.310000000001,65,4,5729.660000000001,3540.35
5638,U4D906E,69,-11127.8,63,6,11456.82,329.02
5639,U42F527,69,-591.2000000000002,65,4,2648.350000000001,2057.15
5640,U8B53C3,69,-2876.4700000000003,63,6,13824.04,10947.57
5641,UC6564D,69,-203.91000000000028,67,2,2959.2700000000004,2755.3599999999997
5642,U106A62,69,-2238.41,41,28,14534.840000000002,12296.429999999998
5643,UFA9182,69,168805.92,47,22,291373.66000000003,460179.58
5644,U95EC50,69,-3075.0200000000023,49,20,191706.27,188631.25
5645,UFC08AA,69,-1104.73,66,3,1145.06,40.33
5646,U830007,69,-1750.8200000000008,66,3,4888.779999999998,3137.96
5647,U78C590,69,718.1700000000013,50,19,16554.399999999998,17272.57
5648,UAEA22A,69,1085.2999999999972,58,11,15677.699999999999,16763.0
5649,UEF8D4E,69,70.39000000000055,38,31,26304.33,26374.720000000005
5650,U2162A0,69,48516.21000000002,39,30,166326.19,214842.4
5651,U3609C7,69,-1796.4499999999998,44,25,37085.42,35288.97
5652,U840361,69,-136626.09999999992,41,28,236891.39999999994,100265.3
5653,U47E139,69,27626.28999999999,56,13,228692.32,256318.61000000002
5654,UDE3109,69,-0.3400000000019645,35,34,22154.45,22154.11
5655,UECD24B,69,-9728.58,61,8,20562.64,10834.06
5656,UF391C7,69,37.05999999999937,52,17,8701.909999999996,8738.97
5657,UDA1F92,69,-4797.98,47,22,9733.62,4935.64
5658,U38FA0E,69,657.4799999999968,46,23,84611.55,85269.02999999998
5659,U6E0F25,69,208.0799999999963,61,8,62030.33,62238.41
5660,U944B9E,69,2022.9500000000007,60,9,4882.770000000002,6905.720000000001
5661,U977B69,69,482.48,63,6,5510.02,5992.5
5662,U64352E,69,-32847.95,43,26,285860.97,253013.02
5663,UC05B07,69,-9340.060000000001,46,23,87536.55,78196.49
5664,U568BC7,69,67973.27999999998,51,18,31339.85,99313.13
5665,U92CB46,69,-12798.470000000001,63,6,88355.7,75557.23
5666,U595493,69,29.999999999997854,48,21,15009.770000000002,15039.769999999999
5667,U41025F,69,37309.119999999995,33,36,182628.18000000002,219937.3
5668,UEDFCF7,69,-14884.49,63,6,48026.10999999999,33141.62
5669,U1F0DB0,69,1355.1400000000021,51,18,31632.52,32987.66
5670,U22B18E,69,-8879.229999999996,51,18,110141.62,101262.39000000001
5671,UCA604B,69,-9678.189999999999,43,26,27337.98,17659.79
5672,U2BB38C,69,32.52999999999996,48,21,2345.46,2377.9900000000002
5673,U071374,69,-124177.57999999999,53,16,392153.13,267975.55
5674,U8E61A4,69,6808.0,59,10,18304.540000000005,25112.54
5675,U341516,69,-9720.700000000003,52,17,137649.56999999998,127928.87000000001
5676,U6E8732,69,9992.929999999995,58,11,99455.81000000001,109448.73999999999
5677,U6937F9,69,-570.6099999999999,54,15,3805.76,3235.15
5678,UE1562A,69,-8856.539999999997,57,12,69506.24,60649.70000000001
5679,U920DA1,69,-3625.4900000000002,59,10,14120.39,10494.900000000001
5680,U1D7F5C,69,-88444.8500000001,33,36,17610990.240000002,17522545.39
5681,UF7AD75,69,756.0199999999986,45,24,28168.249999999996,28924.27
5682,UA755CB,69,-3847.9600000000005,58,11,7998.849999999997,4150.89
5683,UE275BB,69,-20415.82,39,30,195103.07000000004,174687.25
5684,U2330E1,69,327.1000000000016,39,30,43127.49,43454.59
5685,UE52809,69,38524.799999999996,52,17,58954.21000000001,97479.01
5686,UFA4970,69,14937.209999999992,58,11,44855.28000000001,59792.49
5687,UC47F05,69,-9430.080000000002,47,22,91295.51,81865.43
5688,UCF73DD,69,-28499.78,58,11,116766.19,88266.41
5689,UCB709D,69,731.950000000003,56,13,29410.79,30142.74
5690,U071D14,69,-2724.5999999999985,59,10,20035.49,17310.89
5691,U0714DF,69,178.96000000000004,58,11,24203.14,24382.1
5692,U400DFE,69,94.44000000000017,56,13,5193.759999999999,5288.2
5693,U3B9E83,69,6119.43,63,6,2399.74,8519.17
5694,UF948B1,69,-493.61,65,4,2982.8299999999995,2489.2200000000003
5695,U00E714,69,-2673.42,68,1,4561.500000000001,1888.08
5696,U251885,69,7463.910000000003,54,15,26088.83,33552.740000000005
5697,UEC931A,69,2030.6599999999999,54,15,18862.87,20893.530000000002
5698,UD38A50,69,-30.0,35,34,41630.0,41600.0
5699,U3E7F16,69,7708.05,64,5,7538.450000000001,15246.5
5700,U08C802,69,10077.500000000002,58,11,13222.079999999996,23299.58
5701,UCA6C15,69,-95908.41000000002,53,16,212999.82,117091.40999999999
5702,U111867,69,11076.79000000001,48,21,334034.76999999996,345111.56000000006
5703,U989C2A,69,-50157.20000000001,60,9,171931.39,121774.18999999999
5704,UE9CDD6,69,-448.78000000000037,65,4,14530.37,14081.59
5705,U7788BF,69,22.0,40,29,41458.0,41480.0
5706,UFD1B10,69,-14327.45,60,9,20464.31,6136.860000000001
5707,UD90E6A,69,197.2499999999999,54,15,7682.88,7880.129999999999
5708,U19BC37,69,-425204.14999999944,52,17,6134547.980000001,5709343.83
5709,U2B13C5,69,2685.2100000000005,65,4,7551.37,10236.58
5710,U07BCA4,69,-1400.3400000000001,53,16,2613.1800000000003,1212.8399999999992
5711,U87882A,69,0.24000000000487987,52,17,85216.00000000001,85216.23999999999
5712,U76B447,69,4078.660000000007,48,21,66450.45000000001,70529.11
5713,U9AB42F,69,-916.7200000000004,63,6,2267.2299999999996,1350.51
5714,U0144EC,69,-76.53000000000065,64,5,10401.0,10324.470000000001
5715,U9AC5C5,69,-233.62999999999994,58,11,13221.500000000004,12987.87
5716,UDDD83D,69,109.34999999999218,41,28,204545.96,204655.30999999997
5717,U4BECE8,69,1588.63,63,6,4625.99,6214.62
5718,U1E09B4,69,351.51999999999896,44,25,38817.74,39169.26
5719,U6C852C,69,-125.77000000000066,49,20,35456.36,35330.590000000004
5720,UA08D97,69,-71.88000000000034,56,13,5867.960000000001,5796.08
5721,U25E3EE,69,46662.85000000001,61,8,43232.45999999999,89895.31
5722,U508CC0,69,-450.1500000000006,53,16,6453.829999999999,6003.68
5723,UE046C2,69,-3516.4299999999994,67,2,7866.43,4350.0
5724,U6F461C,69,12634.710000000005,55,14,76837.16,89471.87
5725,UD3DCF6,69,-2219.6800000000003,62,7,16981.680000000004,14762.0
5726,U514477,69,-2670.34,55,14,18674.52,16004.18
5727,U0F500F,69,-4497.509999999989,55,14,114463.34999999998,109965.83999999998
5728,UC3AD80,69,4625.629999999999,61,8,16058.480000000001,20684.11
5729,UD626D0,69,6824.819999999996,47,22,94223.18000000001,101048.0
5730,UEB9CCD,68,-1430.3399999999997,62,6,17166.5,15736.16
5731,U625AA2,68,3135.6999999999994,54,14,19973.63999999999,23109.34
5732,U1BE3F8,68,-1268.6399999999999,62,6,7943.4400000000005,6674.8
5733,U1C0874,68,-3262.9299999999976,58,10,33332.149999999994,30069.22
5734,U3963C8,68,-11661.39,57,11,66524.23000000001,54862.84
5735,UA0C06A,68,-3646.229999999996,50,18,111546.23,107900.0
5736,UB756EC,68,54060.82000000001,47,21,172418.05000000002,226478.87
5737,U599520,68,3910.1700000000005,51,17,58663.3,62573.469999999994
5738,U8B7519,68,-188.6100000000001,62,6,6774.259999999999,6585.65
5739,UCF0FC8,68,-33228.08,61,7,112413.08000000002,79185.0
5740,U2334DE,68,-3708.0499999999993,64,4,15190.859999999999,11482.81
5741,UC70C20,68,-584.1399999999999,64,4,8851.84,8267.699999999999
5742,UAFCFC3,68,198.1000000000015,60,8,13999.140000000001,14197.240000000002
5743,U802A34,68,-5.59000000000033,58,10,4933.6399999999985,4928.049999999999
5744,U50DED1,68,-461.0900000000007,49,19,5101.240000000001,4640.150000000001
5745,U27096C,68,1753.5500000000002,66,2,1912.33,3665.88
5746,U3A4A32,68,-69050.14999999998,46,22,341471.15,272421.0
5747,UB13CF5,68,10419.800000000003,57,11,8915.02,19334.82
5748,U770C5B,68,1759.369999999999,40,28,31400.36,33159.729999999996
5749,U8A24CA,68,2927.8599999999997,50,18,20528.179999999997,23456.040000000005
5750,U11D4C0,68,4117.179999999999,65,3,17348.57,21465.75
5751,U394EE0,68,785.0400000000019,55,13,64650.44,65435.48
5752,UC9903D,68,8907.089999999998,52,16,36685.08000000001,45592.17
5753,U8A72B9,68,2462.0499999999993,20,48,44073.0,46535.04999999999
5754,UB1746A,68,73780.7,55,13,59159.390000000014,132940.09
5755,UAF0881,68,6228.85,56,12,67998.84,74227.69
5756,UE2DC53,68,18310.820000000007,43,25,547596.0,565906.8200000001
5757,UABD221,68,-245.72999999999956,42,26,95723.78999999998,95478.06
5758,UA01F2D,68,46777.150000000016,61,7,7481.44,54258.590000000004
5759,U97D659,68,73.71000000000032,44,24,4591.849999999999,4665.56
5760,UFEEC6C,68,-549.4899999999999,61,7,4666.619999999999,4117.13
5761,UD9838F,68,1336.3799999999999,56,12,4358.039999999999,5694.42
5762,U6990DE,68,-34132.659999999996,64,4,57705.05000000001,23572.39
5763,U44D65C,68,24897.08,31,37,186229.14,211126.22
5764,U5D6981,68,-23006.229999999996,64,4,96694.59000000001,73688.35999999999
5765,U8E3BD2,68,-1407.6199999999974,48,20,22341.840000000004,20934.219999999998
5766,U319963,68,1159.6099999999997,65,3,5051.4400000000005,6211.049999999999
5767,U4C3741,68,805.2199999999998,50,18,5310.0599999999995,6115.280000000001
5768,U08E13E,68,-2668.1899999999987,64,4,33679.19,31011.0
5769,U960930,68,-4330.629999999998,47,21,91214.76,86884.13
5770,U1EB551,68,1888.9599999999991,65,3,4741.620000000001,6630.58
5771,U42D5F4,68,23.470000000000127,45,23,32915.40000000001,32938.87
5772,U9BFD69,68,3184.1399999999994,62,6,3755.6200000000003,6939.759999999999
5773,U61F375,68,59824.049999999974,25,43,367524.7,427348.75000000006
5774,U466B2F,68,5671.940000000003,57,11,39642.77999999999,45314.719999999994
5775,U8BB003,68,7596.170000000001,62,6,19592.25,27188.420000000002
5776,U0091D6,68,-1640.5000000000005,63,5,5081.999999999997,3441.5
5777,UD58954,68,-5545.769999999999,59,9,8595.7,3049.93
5778,U38541E,68,2040.030000000001,65,3,8655.27,10695.3
5779,UCC70D0,68,10275.929999999995,61,7,96832.42,107108.34999999999
5780,U1CD970,68,1158.4099999999999,42,26,10815.0,11973.41
5781,U8D7856,68,-14249.490000000003,48,20,286250.24,272000.75
5782,U4747D2,68,-6051.439999999999,64,4,7278.96,1227.52
5783,U1A5A99,68,281.98999999999603,63,5,14352.010000000004,14634.0
5784,U8F71B5,68,-20022.519999999997,58,10,79753.44000000002,59730.920000000006
5785,UC73853,68,143.19,66,2,256.80999999999995,400.0
5786,UF7290D,68,-1271.1200000000038,56,12,164996.78000000003,163725.66
5787,U32E90B,68,198325.24,20,48,46982.17,245307.40999999997
5788,U779B96,68,-1018.33,65,3,5185.79,4167.46
5789,U838912,68,-17252.9,47,21,136021.2,118768.30000000002
5790,U468CFB,68,282.9399999999987,42,26,180302.57,180585.51
5791,U892AB7,68,-5456.150000000001,66,2,8956.15,3500.0
5792,U68ADBC,68,-240.29000000000013,62,6,5875.2,5634.91
5793,UE2B2B6,68,-31746.309999999998,64,4,70205.33000000002,38459.020000000004
5794,U68D325,68,-1959.9200000000014,43,25,33130.920000000006,31171.00000000001
5795,U19BA67,68,-6183.320000000001,65,3,11183.379999999996,5000.0599999999995
5796,U6282EA,68,1856.369999999989,43,25,156002.21999999997,157858.59
5797,U38E0C7,68,-406.8500000000024,63,5,37683.91000000004,37277.06
5798,UCD6A68,68,14258.420000000002,45,23,224424.24999999997,238682.67
5799,UFBB5E9,68,-7192.399999999996,65,3,11037.8,3845.4000000000005
5800,U2FBF9D,68,-28487.71999999999,56,12,90884.29,62396.57000000001
5801,U5D0F96,68,6833.8,57,11,3292.2399999999993,10126.04
5802,UA01A88,68,-82271.17000000014,59,9,771195.96,688924.7899999999
5803,U4AC390,68,-5032.920000000002,61,7,28911.869999999995,23878.95
5804,UF77D8E,68,-185.0499999999996,50,18,12499.99,12314.939999999999
5805,U3AA8A3,68,1260.6700000000003,61,7,4570.95,5831.62
5806,U94B1BC,68,2303.5400000000027,45,23,48786.590000000004,51090.13
5807,U0FC73D,68,-58.650000000001455,62,6,24010.31,23951.66
5808,UE8232F,68,397.41999999999274,63,5,38118.47000000001,38515.89
5809,U51C186,68,1070.1599999999996,44,24,8796.560000000001,9866.72
5810,UC5B257,67,-95603.25,50,17,240553.12,144949.87
5811,U538CD1,67,-2457.030000000002,53,14,101164.26000000001,98707.23
5812,U416F85,67,-4867.859999999999,64,3,9360.84,4492.98
5813,U40B7DD,67,-2838.4899999999993,52,15,31458.780000000002,28620.29
5814,U2C6F9E,67,-35.30000000000102,59,8,6869.879999999998,6834.58
5815,U820DB8,67,-1133.5500000000002,59,8,30520.829999999998,29387.28
5816,U2B0C4E,67,19549.0,48,19,48769.420000000006,68318.42000000001
5817,U136B6F,67,-4822.3099999999995,63,4,9841.479999999998,5019.17
5818,U272EA8,67,6.680000000007567,55,12,119786.96,119793.64
5819,U1E7243,67,-6406.450000000001,61,6,17909.21,11502.76
5820,UD35D29,67,-1372.7899999999997,52,15,5036.77,3663.98
5821,U6C582D,67,-1547.4700000000032,49,18,42678.29000000001,41130.82
5822,U6E65E7,67,-26097.369999999995,52,15,55995.51,29898.14
5823,UBB1C47,67,-711.2099999999999,59,8,5302.969999999999,4591.76
5824,U8083B4,67,-4745.6900000000005,45,22,69319.44,64573.75000000001
5825,UC1DD6A,67,-83.14000000000027,39,28,8196.43,8113.29
5826,U9B1082,67,-1132.9900000000152,36,31,595140.0499999999,594007.06
5827,U53CE03,67,-290708.94999999995,46,21,765955.86,475246.91
5828,UF9916C,67,3062.4100000000026,43,24,48435.340000000004,51497.75
5829,U4BB7BD,67,1832.0599999999988,38,29,26610.250000000004,28442.309999999998
5830,U99A97C,67,-5385.229999999999,63,4,31294.230000000003,25909.0
5831,U1E8D39,67,29141.580000000016,22,45,1916318.58,1945460.16
5832,U4200C7,67,4178.700000000001,44,23,17096.540000000008,21275.24
5833,U80EB3A,67,-2658.3100000000004,64,3,4469.450000000002,1811.14
5834,U050024,67,201.8699999999917,32,35,453264.35000000003,453466.22
5835,U82FB79,67,-1249.0799999999972,49,18,103407.32,102158.24
5836,U5E5A32,67,179.6899999999999,62,5,2420.4300000000007,2600.12
5837,U7527EE,67,-1036.6499999999994,54,13,30302.98999999999,29266.339999999997
5838,U684C16,67,19.34000000001288,36,31,192315.0,192334.33999999994
5839,UA24DC2,67,-6475.440000000005,61,6,18498.310000000005,12022.869999999999
5840,UD48BAC,67,244.13000000000085,58,9,22961.690000000028,23205.820000000007
5841,U6B475E,67,-8089.789999999999,50,17,84941.32,76851.53
5842,U9D8F49,67,-2076.0299999999993,55,12,15984.95,13908.92
5843,U45302F,67,6762.000000000002,56,11,51439.6,58201.600000000006
5844,U5DAF30,67,2037.9800000000005,55,12,7832.12,9870.1
5845,U14D7BB,67,-6827.130000000001,59,8,28806.690000000002,21979.559999999998
5846,UE314B5,67,19965.36,34,33,156591.02000000002,176556.38
5847,U2C0526,67,-2766.059999999993,57,10,128763.23,125997.17000000001
5848,UF4C510,67,-5082.590000000003,63,4,12993.929999999998,7911.34
5849,U418E16,67,23792.999999999985,59,8,59936.44000000002,83729.44
5850,U1C8227,67,5470.869999999997,39,28,17893.129999999997,23364.0
5851,UBD4082,67,40210.68999999998,60,7,1573.3099999999997,41784.0
5852,U781DE6,67,-25805.34,47,20,63324.66,37519.32000000001
5853,UE057E2,67,-26393.660000000003,53,14,386662.2,360268.54
5854,U565168,67,-2079.8999999999996,64,3,7384.460000000001,5304.5599999999995
5855,U51AC41,67,-292.1700000000002,56,11,5931.77,5639.6
5856,U8A6404,67,-2646.640000000001,64,3,2646.9400000000005,0.30000000000000004
5857,UCF9978,67,1346.2299999999982,62,5,8393.570000000002,9739.8
5858,UF759BB,67,1715.5100000000002,59,8,8482.11,10197.619999999999
5859,U430BCF,67,-14516.42,63,4,46448.02000000001,31931.6
5860,U1FEB4E,67,-8443.3,63,4,17783.109999999997,9339.810000000001
5861,U1ABEE8,67,-146503.23000000004,41,26,849804.99,703301.76
5862,U320524,67,9479.439999999999,34,33,42909.49,52388.93
5863,UB59609,67,-818.1500000000001,62,5,1986.2899999999997,1168.14
5864,U8CB0F4,67,17921.770000000004,46,21,36954.57,54876.34
5865,U5440AC,67,-35431.86999999998,46,21,81755.06000000001,46323.19
5866,U90C847,67,38.10000000000076,41,26,14681.880000000001,14719.980000000001
5867,U009F7F,67,42023.07,62,5,11470.11,53493.18
5868,UD40A38,67,-4211.350000000004,61,6,40849.700000000004,36638.35
5869,U85742A,67,-11308.19,63,4,20209.44,8901.25
5870,U1368D2,67,798.2700000000006,44,23,7146.309999999999,7944.58
5871,U4E5EF5,67,805.0400000000006,50,17,4085.1499999999996,4890.1900000000005
5872,U5781B8,67,-12233.770000000002,56,11,141610.08,129376.31
5873,U702E74,67,-2482.9,58,9,10522.779999999999,8039.880000000001
5874,U26C5AB,67,3877.54,41,26,18846.229999999996,22723.769999999997
5875,UD49B54,67,35847.899999999994,51,16,35335.65,71183.54999999999
5876,U5E7098,67,36.099999999998545,47,20,96143.84,96179.94
5877,U02CD68,66,4110.07,60,6,5163.850000000001,9273.92
5878,U1904D9,66,-921.3199999999998,59,7,6022.52,5101.2
5879,UF3FD8A,66,18348.410000000025,41,25,296579.81,314928.22000000003
5880,U14CFB5,66,86.67000000000002,48,18,2132.85,2219.5200000000004
5881,U01E559,66,35776.69,57,9,7392.74,43169.42999999999
5882,U40B23A,66,10768.949999999997,44,22,135667.7,146436.64999999997
5883,U31EF01,66,3643.0200000000013,56,10,27762.3,31405.32
5884,UA11DD3,66,-575.3999999999996,56,10,8583.050000000001,8007.650000000001
5885,UFAA469,66,-1581.5900000000004,61,5,3191.88,1610.2899999999997
5886,U9F9353,66,993.1399999999987,48,18,86135.85999999999,87129.0
5887,U1663FD,66,15037.290000000005,61,5,16070.820000000002,31108.11
5888,U91D29A,66,740.6800000000005,58,8,9738.919999999998,10479.6
5889,U93EC24,66,-5.829999999999797,61,5,4070.7299999999996,4064.9
5890,UEF3EB3,66,4167.450000000001,49,17,57637.41,61804.86000000001
5891,UAE4160,66,-906.8699999999994,53,13,5848.040000000001,4941.17
5892,UC1B12C,66,30.080000000001746,41,25,1048810.0,1048840.08
5893,U041799,66,15.200000000000273,34,32,7837.560000000001,7852.76
5894,UCC961D,66,5258.169999999993,52,14,104660.12000000001,109918.29
5895,U2C61A7,66,3813.9900000000016,54,12,35922.09,39736.08
5896,U307FAB,66,2832.370000000004,53,13,56929.30999999999,59761.68
5897,U668B44,66,1052.9499999999996,63,3,3448.3199999999997,4501.27
5898,U058704,66,-251.30999999999983,63,3,2349.81,2098.5
5899,U0DE9FA,66,-4195.360000000001,61,5,75709.81000000001,71514.45
5900,U81E96E,66,20709.410000000003,54,12,11584.009999999998,32293.420000000002
5901,U121BC3,66,1423.4700000000014,38,28,20023.970000000005,21447.44
5902,UF05350,66,2996.5200000000004,56,10,9937.77,12934.29
5903,UF4F60F,66,-17977.040000000005,42,24,59682.18,41705.14
5904,U16C67C,66,-274.25999999999993,59,7,9877.91,9603.65
5905,U95247E,66,990.3200000000002,59,7,3518.3500000000004,4508.67
5906,UFF0ECB,66,140.40999999999966,45,21,6836.39,6976.8
5907,U8DBAAB,66,-6071.049999999999,42,24,15776.08,9705.029999999999
5908,UE75474,66,222.08000000000015,58,8,3981.9200000000005,4204.0
5909,U669325,66,41413.549999999996,46,20,43456.78999999999,84870.34000000001
5910,UF398C4,66,2683.2499999999986,62,4,13056.229999999996,15739.48
5911,U3AC570,66,-9526.539999999994,57,9,184259.64,174733.09999999998
5912,U938B97,66,772.099999999999,63,3,4807.8,5579.9
5913,UAB05B9,66,-1286.93,60,6,4453.400000000002,3166.47
5914,U76CBFE,66,-2702.770000000001,63,3,4347.1900000000005,1644.42
5915,UCB4673,66,-40758.54000000001,49,17,168584.44,127825.9
5916,U23CF0F,66,105.87999999999991,64,2,2141.12,2247.0
5917,UED4436,66,-82014.51,61,5,128449.84,46435.33
5918,U567F02,66,1582.0399999999918,45,21,16133.050000000008,17715.09
5919,U0CF469,66,-124.78999999999894,58,8,14855.0,14730.210000000001
5920,UDEB04D,66,-6692.88,47,19,54126.39000000002,47433.509999999995
5921,U8562EA,66,-376482.37000000005,39,27,953901.1799999999,577418.8099999999
5922,U42758F,66,-1248.86,63,3,1788.8899999999999,540.03
5923,UF9B35E,66,-2707.9200000000023,47,19,44458.73999999999,41750.81999999999
5924,UB16822,66,-13578.06,64,2,38347.05999999999,24769.0
5925,UB31B6A,66,-7809.31,53,13,25747.64,17938.329999999998
5926,UAC14A9,66,10839.56000000002,34,32,264738.16000000003,275577.72
5927,U1D586A,66,3287.1799999999785,31,35,2233208.69,2236495.87
5928,U89DFB8,66,24564.489999999998,60,6,17968.72,42533.21
5929,UFF9453,66,-668166.4800000001,56,10,827179.8500000001,159013.37
5930,UF6FE6E,66,-4677.450000000001,64,2,4686.47,9.02
5931,UD01C6D,66,9941.29,59,7,11794.970000000001,21736.26
5932,UD058AA,66,3053.71,49,17,19473.259999999995,22526.97
5933,U14511B,66,680.4499999999995,44,22,17443.59,18124.04
5934,UA42BFA,66,-16828.7,60,6,24043.370000000006,7214.67
5935,U952BE7,66,-28406.759999999995,61,5,34566.98,6160.22
5936,U567DDE,66,7832.310000000003,57,9,19108.02,26940.329999999998
5937,U2A61C4,66,2745.2099999999996,55,11,7085.2,9830.41
5938,UC51E9E,66,1291.56,57,9,16765.85,18057.41
5939,U55529E,66,4370.480000000002,44,22,45326.75000000001,49697.229999999996
5940,U5FB9F8,66,2510.7499999999995,56,10,5730.55,8241.3
5941,U0A101B,66,-1429.0400000000018,51,15,71062.07999999999,69633.04000000001
5942,U4F837D,66,-10948.699999999997,64,2,32646.469999999998,21697.769999999997
5943,UA1F3E6,66,-2445.5799999999995,55,11,11325.79,8880.21
5944,U39352A,66,-3052.8299999999945,44,22,157482.14,154429.31
5945,U9FE37A,66,3613.4299999999976,54,12,11392.189999999999,15005.62
5946,UF3B901,66,14562.309999999998,39,27,112850.19,127412.5
5947,U29DF4E,66,-13274.240000000002,47,19,144414.43000000002,131140.19
5948,U78E172,66,1445.7399999999989,56,10,21538.079999999998,22983.82
5949,UE5E440,66,38655.67999999999,59,7,43523.72,82179.4
5950,U8B5A2F,66,-1191.3300000000008,49,17,24667.49000000001,23476.16
5951,UD67E41,66,153.2800000000001,57,9,6043.860000000001,6197.14
5952,U246B22,66,-589.6500000000005,52,14,9394.400000000001,8804.75
5953,UE909CB,66,20805.900000000005,55,11,317560.65,338366.55
5954,U40C474,66,68.34000000000006,61,5,5349.85,5418.1900000000005
5955,U603E69,66,-9381.349999999997,62,4,10529.419999999996,1148.0700000000002
5956,U36663D,66,-6252.67,59,7,14059.28,7806.610000000001
5957,U7541C6,66,-20136.379999999994,62,4,130261.88999999998,110125.51
5958,U1138FC,66,877.2199999999993,59,7,5991.25,6868.469999999999
5959,U926336,66,38968.229999999996,55,11,54198.110000000015,93166.34
5960,U5C5C48,66,5259.100000000001,61,5,11319.77,16578.870000000003
5961,U5666FB,66,-66958.93999999999,36,30,200762.52000000002,133803.58
5962,U43C111,66,816.9500000000002,61,5,4870.550000000001,5687.5
5963,U41255E,66,-2790.8500000000076,41,25,174276.02,171485.16999999998
5964,U8C372B,66,32454.34999999999,52,14,101514.71000000002,133969.06
5965,U741FF7,66,150.22000000000025,53,13,12412.079999999998,12562.3
5966,U1C92ED,66,3729.010000000004,44,22,47876.74,51605.75
5967,UD54544,65,944.119999999999,52,13,3933.27,4877.39
5968,U3C4153,65,36916.78,60,5,6130.029999999999,43046.81
5969,U3E5E6A,65,-14771.21,38,27,84113.52,69342.31
5970,U41158D,65,-33194.95,41,24,264697.8,231502.84999999998
5971,U033946,65,-61972.41,63,2,65402.18,3429.77
5972,UB00EF5,65,16475.18,47,18,8389.029999999999,24864.21
5973,UA7609B,65,20543.49999999999,54,11,33262.61,53806.10999999999
5974,UE2DDE7,65,-1231.3000000000009,61,4,6205.170000000001,4973.87
5975,UAA2CD2,65,1328.4399999999996,54,11,11785.079999999998,13113.52
5976,UE47883,65,-2431.2499999999995,54,11,6285.790000000001,3854.5400000000004
5977,UA2B2E6,65,3961.0799999999986,63,2,9183.2,13144.279999999999
5978,U3D3E5C,65,573.6599999999991,58,7,11960.740000000005,12534.399999999998
5979,U32ACDE,65,-29786.58,53,12,140477.67000000004,110691.09
5980,U1338F9,65,-2226.9199999999987,50,15,76786.56999999999,74559.65
5981,UDEF690,65,389.74999999999983,57,8,18761.61,19151.360000000004
5982,U92BBD8,65,2311.42,35,30,49500.219999999994,51811.64
5983,UF68F38,65,-733.399999999996,38,27,66789.90000000001,66056.5
5984,U44A1CA,65,-184.70999999999992,51,14,5690.580000000001,5505.87
5985,U692980,65,495.669999999998,48,17,121232.22,121727.89
5986,UE3BEFF,65,1558247.28,26,39,1027378.4400000001,2585625.7199999997
5987,U96B0F8,65,1112.0800000000004,46,19,27620.0,28732.08
5988,U141DCF,65,2149.7999999999984,61,4,28020.96,30170.76
5989,U0C1DD6,65,253.3599999999985,44,21,63632.66,63886.020000000004
5990,U390407,65,-10.800000000000054,57,8,3200.58,3189.78
5991,U8921AB,65,-1499.4599999999996,48,17,17744.309999999998,16244.85
5992,U1C7C22,65,26918.740000000005,46,19,187246.05,214164.79
5993,U60F0B6,65,-1306.5099999999998,63,2,8406.51,7100.0
5994,U2DC7A4,65,-3264.580000000001,57,8,16281.82,13017.24
5995,UB52561,65,-688.1699999999996,60,5,11817.050000000001,11128.880000000001
5996,U54AE2E,65,645.0600000000004,58,7,10941.669999999995,11586.73
5997,U8B7555,65,2664.3899999999994,49,16,41013.439999999995,43677.829999999994
5998,U9DF8ED,65,-2727.85,59,6,26381.7,23653.85
5999,UF63464,65,-3269.3599999999988,60,5,26617.55,23348.190000000002
6000,UE486E2,65,14853.409999999998,60,5,11349.159999999998,26202.57
6001,U0CE2A5,65,-3667.350000000004,38,27,214467.84,210800.49
6002,U06B8E8,65,1254.5,53,12,35833.92,37088.42
6003,UCACC57,65,-154.04,45,20,15954.2,15800.16
6004,U48A414,65,107.01999999999977,53,12,4809.929999999999,4916.95
6005,U1CB83C,65,-656.98,55,10,6600.709999999998,5943.73
6006,UE2111A,65,-857.1300000000001,61,4,10993.25,10136.119999999999
6007,U201F35,65,10408.81,31,34,21282.140000000003,31690.95
6008,UFA0077,65,131.04999999999964,60,5,12172.41,12303.46
6009,U356E87,65,-5886.940000000002,51,14,54751.369999999995,48864.43
6010,U6FC2E3,65,1524.84,44,21,17572.98,19097.82
6011,UB9E515,65,-1853.5999999999995,48,17,44089.01000000001,42235.41
6012,UA42500,65,-5469.129999999994,62,3,15410.009999999997,9940.880000000001
6013,UBD33AE,65,-40030.86999999999,62,3,41849.52999999999,1818.6599999999999
6014,U9713BA,65,-31843.879999999946,38,27,1431172.3399999999,1399328.4600000002
6015,U551FDC,65,-3054.01,52,13,6560.110000000001,3506.1000000000004
6016,UF60F02,65,1624.2400000000052,33,32,262789.22,264413.46
6017,U18D963,65,-86392.95000000001,62,3,87800.95000000001,1408.0
6018,U14C438,65,-71692.06,58,7,140486.15,68794.09
6019,U0ED858,65,-9469.360000000004,64,1,13269.360000000006,3800.0
6020,U0686EE,65,237.5299999999993,39,26,30807.030000000006,31044.56
6021,UFF5769,65,9250.919999999998,40,25,344867.7399999999,354118.66000000003
6022,U3C076D,65,-5015.120000000005,31,34,213802.56000000003,208787.44000000003
6023,U85FC85,65,-3115.0,63,2,3309.42,194.42000000000002
6024,UDDD8EB,65,8927.510000000002,50,15,9970.529999999999,18898.039999999997
6025,U37617F,65,-6371.900000000001,59,6,8272.54,1900.6399999999999
6026,U53B58E,65,-2179.62,49,16,11772.869999999997,9593.25
6027,UCEF9CB,65,183.24000000000024,48,17,50489.979999999996,50673.22
6028,UEC9434,65,-4178.020000000004,37,28,99643.02,95465.0
6029,UE21FC1,65,-8267.29,55,10,36753.06,28485.77
6030,UE8D748,65,96.32999999999994,56,9,2394.0699999999997,2490.4
6031,U528020,65,-75.73999999999995,62,3,3191.21,3115.4700000000003
6032,U8659F8,65,2210.5300000000007,46,19,22615.75,24826.28
6033,U4258CF,65,1822.3499999999979,51,14,20771.640000000003,22593.989999999998
6034,U6DEC5F,65,-158423.8,44,21,320599.8,162176.0
6035,U5A513F,65,5536.069999999987,37,28,211864.91,217400.98
6036,U130D81,65,1990.4800000000005,63,2,4009.52,6000.0
6037,U52BAF3,65,-56699.45000000001,39,26,358878.08,302178.63
6038,U4CFCFC,65,1351.5900000000004,47,18,16521.39,17872.98
6039,U067379,65,-76.2599999999984,48,17,39154.58,39078.32
6040,UF5535E,65,-5336.44,63,2,5540.45,204.01
6041,U024694,65,1808.8700000000044,49,16,206959.62,208768.49000000002
6042,U22D255,65,-1079.21,56,9,5966.3,4887.09
6043,UEA4D59,65,12550.86,40,25,34404.78999999999,46955.64999999999
6044,UD93592,64,1283.0000000000018,46,18,39529.02000000001,40812.02
6045,U27AE62,64,21622.69,60,4,11395.460000000001,33018.15
6046,U54929E,64,-1021.6899999999996,48,16,26434.68,25412.99
6047,U616BFF,64,1330.9199999999998,54,10,6251.659999999999,7582.580000000001
6048,UB04EE0,64,-941.4699999999989,58,6,7372.380000000001,6430.91
6049,UB8F73A,64,-10322.730000000001,44,20,27508.72,17185.989999999998
6050,U11A344,64,-1833.2899999999995,60,4,4779.620000000001,2946.33
6051,UD71AE4,64,-1000.2300000000001,61,3,4554.229999999999,3554.0
6052,U83A443,64,-181.66000000001412,55,9,47648.92,47467.259999999995
6053,UF529DD,64,-68136.79,62,2,117440.89000000007,49304.1
6054,U1AB770,64,340082.62,41,23,240987.68999999997,581070.3099999999
6055,U2F24A0,64,-319.2200000000004,57,7,13670.189999999991,13350.969999999998
6056,UD38D39,64,8177.800000000003,50,14,13946.439999999999,22124.239999999998
6057,U064CB9,64,5114.810000000012,50,14,107155.66999999995,112270.47999999998
6058,UB409AD,64,149.71000000000095,52,12,24739.2,24888.91
6059,U2DB4CF,64,21981.03,51,13,105730.64000000001,127711.67000000001
6060,U5BF07C,64,-713.0000000000002,57,7,4408.28,3695.28
6061,U0F0C2E,64,-1862.800000000001,57,7,9963.140000000001,8100.34
6062,UF6170C,64,-9578.580000000002,49,15,28246.579999999994,18668.0
6063,U211F6E,64,-1790.0799999999986,59,5,26480.37,24690.29
6064,U29395D,64,715.0199999999998,59,5,7963.300000000001,8678.32
6065,U4DDBA0,64,2521.970000000001,61,3,16506.58,19028.55
6066,U76D891,64,-7508.140000000014,51,13,72415.77,64907.630000000005
6067,U664DEE,64,-2512.3299999999995,62,2,3767.49,1255.1599999999999
6068,U49EF53,64,2804.6899999999973,45,19,82141.23000000001,84945.92
6069,U521D20,64,4091.9400000000005,62,2,10908.060000000001,15000.0
6070,UEB4E67,64,-3413.9799999999996,56,8,8875.9,5461.92
6071,U1C210D,64,25131.129999999997,28,36,163655.5,188786.63
6072,UDC5192,64,-2232.7200000000007,52,12,24276.039999999997,22043.32
6073,U6832D1,64,122.85000000000059,56,8,51270.920000000006,51393.770000000004
6074,U20A70B,64,-3931.57,52,12,7572.93,3641.36
6075,U85412C,64,6526.7699999999995,61,3,6023.64,12550.41
6076,UFABB2A,64,80478.74000000002,42,22,258217.29,338696.02999999997
6077,UFABBB6,64,-100.19000000000028,32,32,8486.189999999999,8386.0
6078,UBAA5FE,64,-3275.419999999997,42,22,126789.03000000001,123513.61
6079,U4A404E,64,27661.839999999997,40,24,218182.24,245844.08000000002
6080,UF960FD,64,-499.2400000000004,52,12,6673.640000000003,6174.4
6081,UA89823,64,-929.859999999998,35,29,65207.0,64277.14
6082,UDF6CA8,64,13.210000000000036,57,7,3140.76,3153.9700000000003
6083,UEC229D,64,-8421.910000000003,50,14,328683.0,320261.08999999997
6084,U77BFE1,64,-1986.1199999999994,54,10,28512.59,26526.47
6085,UDFD88C,64,12606.029999999999,52,12,63596.99,76203.02
6086,U3DFAD9,64,-886.0599999999995,53,11,35615.28,34729.22
6087,U6FE3A1,64,-23.499999999999886,61,3,2152.22,2128.72
6088,U05DB42,64,37644.280000000006,60,4,5135.840000000001,42780.12
6089,UA6827E,64,-522.3599999999998,42,22,2381.32,1858.9599999999998
6090,U4A64B9,64,993.6899999999994,52,12,26072.850000000002,27066.539999999997
6091,UC2A633,64,-1441.2099999999996,29,35,6817.18,5375.969999999999
6092,U6B7E0D,64,251.0799999999988,47,17,11608.019999999999,11859.100000000002
6093,UC98171,64,-12201.380000000017,57,7,187295.03999999998,175093.66
6094,UC1CFD7,64,-913.54,45,19,11920.279999999999,11006.74
6095,UE3C782,64,218.12999999999965,46,18,12387.2,12605.33
6096,U0F1EFA,64,-5638.44,49,15,21766.28,16127.840000000002
6097,UFADBB8,64,-1237.2800000000002,62,2,7795.16,6557.88
6098,U555095,64,-953.0,43,21,17738.0,16785.0
6099,U130634,64,-3021.98,52,12,13074.970000000001,10052.99
6100,U2B406F,64,-14.919999999998822,34,30,105936.48999999999,105921.56999999999
6101,U7897F2,64,746.5900000000001,51,13,2863.48,3610.0699999999997
6102,U077884,64,-3878.9699999999966,48,16,90396.67,86517.7
6103,U3BC488,64,396.8299999999999,56,8,2916.7500000000014,3313.5800000000004
6104,UC7AFDA,64,5007.840000000018,51,13,567194.2500000002,572202.09
6105,U48D103,64,-651.0300000000002,54,10,11926.78,11275.750000000002
6106,U5CDBF7,64,-25935.550000000007,56,8,66325.67,40390.12
6107,U047CF6,64,-746524.0200000003,50,14,958529.8400000002,212005.82
6108,U1A6FD4,64,153184.69,28,36,72141.73,225326.42
6109,U4E8FB2,64,-422.7899999999996,50,14,51267.49,50844.7
6110,UE59F5F,64,35227.76000000002,32,32,56486.84,91714.59999999999
6111,UE0CEFA,64,-11690.780000000002,61,3,22084.83,10394.05
6112,UF77AB4,64,1055.0400000000009,38,26,13956.639999999998,15011.680000000004
6113,UFA7494,64,4158.949999999999,55,9,9426.390000000001,13585.340000000002
6114,UD09191,64,-1719.369999999998,35,29,92836.00000000001,91116.62999999998
6115,UE944AB,64,143.15000000000123,53,11,84291.34000000001,84434.48999999999
6116,U501074,64,-1207.659999999999,58,6,9170.95,7963.29
6117,U1FF5A7,64,-21740.050000000003,50,14,33746.78,12006.73
6118,UE30015,64,-463.94000000000193,53,11,15917.140000000001,15453.200000000003
6119,U95EC12,64,623.99,55,9,12813.59,13437.580000000002
6120,UEDCBC7,64,1902.7000000000066,46,18,33231.179999999986,35133.88
6121,UD34495,64,4517.289999999999,38,26,3632.760000000001,8150.05
6122,UED70F6,63,-2424.2499999999977,58,5,13447.199999999997,11022.949999999999
6123,UE13C1B,63,8422.010000000002,49,14,17015.42,25437.43
6124,U9569F4,63,2812.2599999999993,43,20,33315.61,36127.87
6125,UEF42FB,63,-2873.570000000006,44,19,67696.31999999999,64822.74999999999
6126,U0882F2,63,-3180.9699999999993,41,22,36747.02,33566.05
6127,U8B9284,63,-4460.390000000001,50,13,14387.519999999999,9927.13
6128,U90F917,63,34587.02,53,10,22011.269999999997,56598.29
6129,U817059,63,2543.9699999999984,61,2,13001.179999999997,15545.15
6130,U77650F,63,210.900000000001,35,28,12312.47,12523.369999999999
6131,U9ADB73,63,604.5100000000004,55,8,12119.18,12723.69
6132,UA1EBE4,63,-179.4100000000023,43,20,27987.209999999995,27807.800000000003
6133,UC0BB2A,63,-2.0000000000001363,60,3,972.9,970.9
6134,U292041,63,8563.520000000002,53,10,37346.380000000005,45909.9
6135,UDAE83C,63,-7573.329999999999,58,5,13144.400000000001,5571.070000000001
6136,UC5FD1B,63,-256.42000000000144,54,9,6968.339999999998,6711.92
6137,U91D810,63,-36239.030000000006,41,22,155349.87999999998,119110.85
6138,U223713,63,24628.540000000005,51,12,18119.399999999998,42747.94
6139,U861154,63,-3899.7499999999977,48,15,47103.66,43203.90999999999
6140,U6F8365,63,-10193.869999999999,61,2,18581.680000000004,8387.81
6141,UB0D5DD,63,7283.219999999999,50,13,84858.27,92141.48999999999
6142,UFE7B52,63,-38.58999999999651,41,22,49542.9,49504.31
6143,UAF867C,63,18273.399999999994,42,21,18373.96,36647.36
6144,U6BF5E8,63,2.3800000000039745,59,4,13578.169999999996,13580.55
6145,U464B36,63,-905.8300000000004,47,16,5688.429999999999,4782.6
6146,UEE4A9F,63,-10883.16,55,8,33340.26999999999,22457.109999999997
6147,U5F3610,63,51.710000000001095,58,5,16334.79,16386.5
6148,U49C6FC,63,-6097.999999999998,61,2,9058.779999999999,2960.7799999999997
6149,U770BA9,63,-94164.26,44,19,214365.08000000005,120200.81999999999
6150,U809334,63,761.6600000000002,51,12,1934.8499999999997,2696.51
6151,U31F274,63,4120.789999999999,48,15,25381.299999999992,29502.089999999997
6152,UD18E5F,63,8814.550000000001,46,17,28632.620000000003,37447.17
6153,U77CA72,63,-786.5199999999999,60,3,2116.8199999999997,1330.3
6154,UCE498B,63,451.3700000000019,49,14,23802.77,24254.14
6155,UA26961,63,-11799.799999999996,58,5,118577.21,106777.41
6156,U8505A6,63,-2023.1599999999999,44,19,54061.36,52038.2
6157,U5A602C,63,-39822.89000000001,53,10,113935.55000000002,74112.66
6158,U4347E5,63,-6641.029999999996,52,11,39170.049999999996,32529.020000000004
6159,UBE26DD,63,-8590.749999999989,47,16,432001.85000000003,423411.1
6160,UCFEB93,63,-867.5600000000015,54,9,21288.370000000003,20420.81
6161,UA683B2,63,2982.3099999999995,61,2,5017.69,8000.0
6162,U11AEDD,63,-14877.0,61,2,29615.949999999993,14738.95
6163,UCBFAF9,63,27397.109999999993,30,33,27742.660000000003,55139.77
6164,U909628,63,3415.6100000000024,55,8,19407.65,22823.26
6165,UCB60D2,63,-8142.24,54,9,44970.04999999998,36827.81
6166,U33D92E,63,-773.3899999999999,51,12,8373.599999999999,7600.21
6167,UC64F9A,63,-12974.48,40,23,27127.5,14153.02
6168,UE0CD67,63,13462.330000000007,42,21,75602.94,89065.27000000002
6169,U81CC9D,63,-791.4000000000001,57,6,2321.7499999999995,1530.35
6170,UF8C762,63,-555.7300000000032,55,8,36091.89,35536.16
6171,U5187D5,63,606.1599999999995,51,12,6224.640000000001,6830.8
6172,UD52B35,63,197.47999999999956,44,19,36304.5,36501.979999999996
6173,U299751,63,244570.36000000002,31,32,599648.64,844218.9999999999
6174,U82E22D,63,4033.6600000000017,46,17,10050.13,14083.79
6175,UF7F082,63,-2203.4000000000005,61,2,6364.4,4161.0
6176,U8B0E4D,63,-39085.98000000001,48,15,61912.86,22826.88
6177,UA82E41,63,876.8899999999986,54,9,28243.52,29120.41
6178,U23F871,63,-1037.1599999999994,50,13,40814.219999999994,39777.06
6179,UAA78A2,63,0.8999999999650754,38,25,955373.8400000001,955374.7400000001
6180,UA25D08,63,98156.74999999999,51,12,56237.41999999999,154394.17000000004
6181,U2C200B,63,276.03000000000037,60,3,1723.9699999999998,2000.0
6182,UC575AC,63,-10400.080000000005,51,12,63435.780000000006,53035.7
6183,U6D66D2,63,-2907.8599999999988,60,3,11586.98,8679.119999999999
6184,UA84946,63,-2339.120000000008,43,20,78248.24000000002,75909.12000000001
6185,U08DC00,63,7826.040000000001,35,28,34216.990000000005,42043.03
6186,U7AD28F,63,1203.9099999999999,58,5,7555.26,8759.17
6187,U805CD2,63,8946.829999999998,50,13,14497.169999999998,23444.0
6188,U16BC6C,63,1390.8999999999999,62,1,1137.64,2528.54
6189,U2B7C70,63,1650.119999999991,46,17,80306.81,81956.93
6190,U487F6C,63,13038.189999999995,36,27,102917.85,115956.04000000001
6191,UB217C3,63,1571.760000000001,60,3,27738.579999999998,29310.34
6192,U52CC29,63,-6800.2699999999995,61,2,8886.17,2085.9
6193,U365062,63,92899.62000000001,52,11,251343.28,344242.9
6194,UF84083,63,117.53999999999974,50,13,7214.040000000001,7331.579999999999
6195,UFB6150,63,-6581.7199999999975,34,29,95606.37,89024.65
6196,UB366AC,63,-1782.9199999999996,40,23,30056.93,28274.01
6197,U8CCBD4,63,-12695.619999999999,52,11,35651.41,22955.79
6198,U81D1B4,63,193.76000000000016,60,3,6166.240000000002,6360.0
6199,U09CB11,63,13319.839999999993,48,15,54859.70000000001,68179.54
6200,U6B44D3,63,3973.069999999999,34,29,234962.68,238935.74999999997
6201,UFB8896,63,-2138.5400000000004,59,4,6245.0199999999995,4106.48
6202,UF1883E,63,31099.489999999994,48,15,7684.38,38783.87000000001
6203,U50C697,63,99.66000000000014,59,4,1502.34,1602.0
6204,U3EDDE2,63,3501.7800000000225,34,29,469009.64,472511.42
6205,UEE3100,63,2755.109999999998,53,10,12196.599999999997,14951.710000000001
6206,U6C7DC1,63,-810.8199999999999,62,1,1810.82,1000.0
6207,U666A49,63,324.6499999999941,50,13,70936.88,71261.53
6208,UCF2DE6,63,5304.63,57,6,5757.25,11061.88
6209,UAE3578,63,907.1000000000004,51,12,13939.689999999999,14846.79
6210,UD09E66,63,11.300000000000438,44,19,14253.729999999998,14265.029999999999
6211,UC5A1A4,63,12028.329999999998,49,14,30172.12,42200.45
6212,UD5590C,63,456.66999999999973,54,9,10377.160000000002,10833.83
6213,U66DB3E,63,2208.1900000000005,55,8,10582.269999999999,12790.46
6214,U1F4984,63,5006.6799999999985,44,19,90413.31,95419.99
6215,UEA4800,63,2420.9499999999994,51,12,13696.830000000004,16117.779999999999
6216,UB46720,63,-8085.250000000001,48,15,35612.99,27527.74
6217,UF463FF,63,234.61000000000055,55,8,9395.82,9630.43
6218,U91CB1F,63,2599.9,51,12,6546.82,9146.72
6219,UC8EB07,63,14856.350000000002,40,23,22026.689999999995,36883.04000000001
6220,UCC58F5,63,-2382.089999999916,37,26,1724257.1499999997,1721875.0599999998
6221,U6FE715,63,980.3700000000008,61,2,16057.63,17038.0
6222,U41AA5A,63,-407.59000000000003,52,11,2630.3199999999997,2222.73
6223,U493019,63,104758.98,28,35,82996.0,187754.97999999998
6224,UB25043,63,25.520000000001346,45,18,18504.08,18529.6
6225,U073674,63,-186.98999999999978,51,12,15892.97,15705.98
6226,UC02330,63,14.090000000000117,61,2,815.9599999999999,830.05
6227,U68462A,63,24668.509999999995,58,5,16483.659999999996,41152.170000000006
6228,UD27441,63,-1778.3699999999994,56,7,10919.37,9141.0
6229,UD40698,63,-893.3400000000004,40,23,16275.189999999997,15381.85
6230,U283DE4,63,-3928.0200000000023,46,17,64776.60999999999,60848.59
6231,U9BFB77,62,-2539.480000000001,57,5,6717.36,4177.88
6232,U73DD82,62,1413.460000000004,53,9,48547.81000000001,49961.270000000004
6233,U5D95D4,62,-558.1,58,4,1811.8999999999999,1253.8
6234,UD25A3E,62,-773.0100000000002,34,28,1766.1500000000005,993.14
6235,UEF65FA,62,-3215.649999999997,48,14,45508.48000000001,42292.83
6236,UF60C5B,62,42861.28,39,23,226882.58000000002,269743.86
6237,UFD621E,62,-3705.470000000011,53,9,30207.790000000005,26502.32
6238,U2E9664,62,6096.750000000004,45,17,37296.520000000004,43393.270000000004
6239,U6CED9A,62,2681.840000000003,59,3,7926.929999999999,10608.77
6240,U69EF5A,62,277.3600000000004,58,4,4476.659999999999,4754.02
6241,U5C9E19,62,-8.5,59,3,317.0,308.5
6242,UA39FBF,62,1575.0799999999997,35,27,277071.45,278646.53
6243,U2C08C9,62,2214.3299999999977,41,21,10850.48,13064.81
6244,UC1AA06,62,-9195.89000000001,42,20,127764.85999999999,118568.96999999999
6245,UBB4469,62,-1221.3800000000003,46,16,26165.779999999995,24944.400000000005
6246,U12252E,62,5057.359999999997,48,14,30868.589999999997,35925.95
6247,U595B8B,62,-10.900000000001455,37,25,83087.90000000001,83077.0
6248,U3EA74A,62,-3367.569999999998,54,8,20180.370000000014,16812.8
6249,U3816E8,62,-782.7899999999998,57,5,3066.6200000000003,2283.8300000000004
6250,UC4806A,62,-4800.420000000002,58,4,18211.18,13410.76
6251,U1F5FBC,62,-45805.58000000001,51,11,127405.26999999997,81599.68999999999
6252,UF79743,62,8761.910000000003,53,9,73956.22,82718.13
6253,U963BB5,62,-3932.419999999998,51,11,7224.399999999998,3291.9800000000005
6254,U65C050,62,-124.91000000000001,59,3,657.91,533.0
6255,U5A4EA2,62,6385.37,51,11,14848.34,21233.71
6256,UCC5EC4,62,-3006.5800000000277,39,23,307927.7,304921.12000000005
6257,U7EC113,62,5559.420000000042,47,15,1117397.6,1122957.02
6258,U886B93,62,10207.55000000003,51,11,403794.34000000014,414001.89
6259,U291422,62,-188781.5400000001,41,21,1203985.77,1015204.23
6260,U67635F,62,14139.080000000002,40,22,67977.42,82116.5
6261,U3D9BBF,62,-1364.71,51,11,21969.820000000003,20605.11
6262,UCA699E,62,-7124.9599999999955,56,6,51729.00000000001,44604.04
6263,U457B32,62,-212.83000000000015,60,2,1412.8300000000004,1200.0
6264,U40B0BA,62,9402.180000000004,46,16,20995.100000000002,30397.28
6265,UCC9144,62,1469.8599999999933,44,18,125689.91000000002,127159.77
6266,U22B18B,62,-9578.7,55,7,20427.960000000003,10849.26
6267,U6C742F,62,-1167.8400000000001,52,10,15874.85,14707.01
6268,UD4FA13,62,2348.529999999999,60,2,10153.35,12501.880000000001
6269,U91D93B,62,2609.0499999999993,35,27,5193.48,7802.530000000002
6270,UAC8A3A,62,-8769.619999999999,52,10,22801.879999999997,14032.26
6271,UB9A14A,62,19341.37,39,23,5952.69,25294.06
6272,UF3C59D,62,-415.0999999999999,46,16,3856.9200000000005,3441.8199999999997
6273,U3CF2A1,62,456.46999999999946,49,13,7471.129999999999,7927.599999999999
6274,U797446,62,459.2899999999969,47,15,30937.26,31396.550000000003
6275,U4BC055,62,-34599.899999999994,56,6,86434.89999999998,51835.0
6276,UCC1189,62,-5817.09,42,20,21212.09,15395.0
6277,U792EE7,62,-179.12000000000006,55,7,52874.22,52695.1
6278,U2F0D13,62,308.21999999999935,56,6,2279.33,2587.55
6279,UD420DC,62,17.360000000000582,32,30,87944.15999999999,87961.52
6280,U2AB889,62,1711.8700000000013,57,5,8262.730000000001,9974.599999999999
6281,UE2C589,62,-22162.329999999998,27,35,92741.62,70579.29000000001
6282,UCA340F,62,-2210.9899999999993,58,4,20511.199999999993,18300.21
6283,U6C4E11,62,9709.179999999997,41,21,139859.06,149568.24
6284,UE626C3,62,-951.3699999999998,56,6,6276.2,5324.83
6285,U432DDB,62,-1111.4500000000007,31,31,99112.21,98000.76
6286,U96C4EC,62,-2162.210000000001,53,9,8878.079999999998,6715.87
6287,UE719BD,62,-35042.28999999999,51,11,147943.73,112901.44
6288,U3B1C2A,62,4297.9800000000005,34,28,23838.59,28136.57
6289,U42004B,62,3.900000000004365,43,19,100905.26000000001,100909.16
6290,U61445F,62,-1127.1000000000006,56,6,13860.119999999997,12733.019999999999
6291,UC1AD04,62,-15711.169999999998,53,9,43006.57000000001,27295.4
6292,U079F5A,62,-139247.87000000002,46,16,212199.44,72951.57
6293,U444C70,62,-10973.410000000002,28,34,75079.5,64106.09
6294,U230245,62,11719.90999999998,42,20,379962.37,391682.2800000001
6295,U5CEE90,62,-3324.819999999998,49,13,21124.11,17799.289999999997
6296,U418B6D,62,30989.78,41,21,74083.73,105073.51000000001
6297,U2600AE,62,-16682.48,41,21,47699.0,31016.52
6298,UC2BAC6,62,-2725.4600000000028,50,12,48068.82,45343.36
6299,U7AB97D,62,-7966.43,57,5,13533.099999999999,5566.67
6300,U1B228A,62,-262.73999999999927,40,22,6756.59,6493.85
6301,U8BEA9D,62,245.31999999999724,44,18,73633.85,73879.17
6302,UB08563,62,-129237.98999999999,55,7,178992.16,49754.17
6303,U273BF8,62,-1263.0299999999977,57,5,18852.51,17589.48
6304,UF3888C,62,-6554.249999999992,34,28,181794.39,175240.14
6305,U7805AD,62,-3466.6900000000005,59,3,16610.690000000002,13144.0
6306,UD00C78,62,20055.86999999998,45,17,56984.03,77039.9
6307,U43D5DA,62,-374.7200000000019,55,7,13885.699999999999,13510.98
6308,U255484,62,-208776.18000000002,47,15,299028.88999999996,90252.71
6309,UE797A0,62,68747.75,24,38,522039.0,590786.75
6310,U735B39,62,450169.0800000001,39,23,1141322.17,1591491.25
6311,UCD6DA8,62,-107.20000000000013,60,2,4213.080000000001,4105.88
6312,U8D7F65,62,-1348.7400000000002,53,9,13659.440000000002,12310.7
6313,U47A400,62,-1592.9800000000073,50,12,55085.51000000001,53492.53
6314,UFB0876,62,-5505.889999999999,41,21,85659.73000000001,80153.84
6315,UE5E1DC,62,-107.28999999999944,56,6,23169.329999999998,23062.04
6316,U3C9DD0,61,7625.670000000002,56,5,15065.229999999998,22690.9
6317,U335FC3,61,5603.1900000000005,35,26,17700.360000000004,23303.550000000003
6318,U6631BE,61,-2592.0199999999986,52,9,41821.23,39229.21
6319,UD9DAE4,61,-481.36000000000104,50,11,25557.109999999993,25075.75
6320,UBF46D1,61,-6403.079999999998,49,12,53641.979999999996,47238.899999999994
6321,UBAF83E,61,-4084.8799999999997,47,14,113821.64,109736.76
6322,UCDD8E8,61,3513.99,52,9,9681.91,13195.9
6323,U9017EF,61,-448.4,56,5,1674.22,1225.8200000000002
6324,U06E12B,61,5588.149999999998,39,22,14951.72,20539.87
6325,UAEAA58,61,72.1599999999994,41,20,5289.780000000002,5361.9400000000005
6326,UF324CA,61,-1723.8100000000002,59,2,1824.8100000000002,101.0
6327,U74D781,61,-23933.1,57,4,33560.66,9627.56
6328,U654FA1,61,16.249999999999176,56,5,22099.060000000005,22115.309999999998
6329,UAD48FD,61,-2651.1399999999994,54,7,8255.25,5604.110000000001
6330,UE7B346,61,219.07999999999956,47,14,10811.91,11030.99
6331,U9AD639,61,27.05999999999949,47,14,10929.42,10956.48
6332,UA6A8A9,61,2798.730000000002,55,6,14878.010000000002,17676.74
6333,U037DA1,61,537.5299999999997,57,4,3897.699999999999,4435.23
6334,UB3E13A,61,-28.080000000000098,46,15,1865.54,1837.4599999999998
6335,U33390A,61,3099.1,59,2,4288.69,7387.79
6336,U3595AF,61,7506.56,52,9,80406.64,87913.2
6337,U2FF015,61,-3695.4500000000003,56,5,8240.64,4545.19
6338,UED516D,61,-2925.1800000000076,57,4,77602.83,74677.65
6339,U718B86,61,-2867.8999999999996,43,18,52608.490000000005,49740.590000000004
6340,U5AD9F2,61,304.3300000000001,58,3,2430.1700000000005,2734.5
6341,UA13F00,61,654.9300000000007,57,4,16978.430000000004,17633.36
6342,U1CE886,61,7217.910000000007,43,18,35782.490000000005,43000.4
6343,UB0756E,61,74.1800000000005,48,13,42909.399999999994,42983.579999999994
6344,U77F800,61,20812.82,54,7,23139.500000000004,43952.32
6345,UB65410,61,316.9599999999998,56,5,3973.3,4290.26
6346,UDA4D63,61,4607.43,43,18,21420.0,26027.43
6347,U7D179B,61,6155.77,51,10,5662.82,11818.59
6348,U896292,61,-17556.26,46,15,154474.45,136918.19
6349,UEF4F1B,61,-6626.350000000002,58,3,45181.88,38555.53
6350,UE244CB,61,5022.060000000001,45,16,65258.23,70280.29
6351,U823CB2,61,-876.8700000000008,54,7,23798.26,22921.39
6352,UB0FC98,61,714.0200000000003,46,15,10860.589999999998,11574.61
6353,UEFDA6F,61,-26807.900000000005,39,22,38639.090000000004,11831.19
6354,UC0C554,61,-7.920000000000437,43,18,52445.04,52437.119999999995
6355,U821D4B,61,2818.949999999989,52,9,65351.08000000001,68170.03
6356,U32A0F0,61,-757244.66,61,0,757244.66,0.0
6357,U0C6052,61,54.319999999999936,40,21,38708.590000000004,38762.91
6358,U9D6832,61,-73648.65999999999,54,7,97148.93,23500.27
6359,U9FBF1D,61,-227261.25,40,21,438332.38,211071.12999999998
6360,U2499EC,61,-200.37000000000023,37,24,2195.83,1995.4599999999998
6361,U94C928,61,-226.79000000000087,54,7,34642.57,34415.78
6362,UCDA460,61,-984.5099999999998,59,2,3773.3100000000004,2788.8
6363,UC5F9E6,61,28030.569999999992,40,21,282356.37,310386.94
6364,UDEF8A4,61,16178.84999999999,53,8,4617.200000000002,20796.049999999996
6365,U2DE8A3,61,-388.81000000000006,57,4,3815.2,3426.39
6366,UFDEC44,61,-6616.450000000001,58,3,9683.119999999999,3066.67
6367,UF1CEAD,61,-9151.709999999992,43,18,676103.25,666951.54
6368,U28FB27,61,6419.839999999999,54,7,25165.63,31585.47
6369,UB1DB6F,61,7488.609999999999,29,32,31063.469999999998,38552.08
6370,UABA8A6,61,-26.569999999999624,56,5,9001.769999999999,8975.2
6371,U3E952C,61,4385.419999999999,59,2,6062.5700000000015,10447.99
6372,U6C9C42,61,-4225.41,48,13,25294.010000000002,21068.600000000002
6373,UA417F1,61,3657.959999999999,50,11,31606.58,35264.54
6374,U91F20D,61,34411.610000000015,42,19,48869.4,83281.01000000001
6375,U99FDE9,61,64682.369999999995,33,28,77924.62,142606.99
6376,UF6333C,61,1639.5399999999981,50,11,15644.180000000002,17283.72
6377,U72192B,61,15488.749999999998,48,13,4064.4400000000005,19553.190000000002
6378,UADBE12,61,-315.9600000000002,29,32,3883.2900000000004,3567.33
6379,U3905C8,61,1134.2099999999994,39,22,17455.81,18590.02
6380,UB245AD,61,-2237.8199999999997,52,9,8888.440000000002,6650.619999999999
6381,U159E35,61,-5337.259999999998,49,12,29686.98,24349.72
6382,U955CC5,61,70.62000000000012,57,4,3276.92,3347.54
6383,UAC7C0C,61,462.0299999999993,51,10,28702.100000000002,29164.13
6384,UD56C64,61,-672.2800000000002,58,3,3873.2200000000003,3200.94
6385,UE99E4F,61,-1345.6499999999999,56,5,2447.51,1101.86
6386,U75B0DF,61,-2290.210000000003,45,16,221978.94,219688.73
6387,U9BA0C6,61,832.3200000000002,54,7,6151.05,6983.37
6388,U0317DE,61,1891.6799999999992,58,3,7547.590000000001,9439.27
6389,U4228C9,61,9413.099999999993,43,18,65842.6,75255.70000000001
6390,U507502,61,52369.299999999996,48,13,13188.149999999998,65557.45
6391,U664CF0,61,-136.92000000000016,55,6,5992.32,5855.4
6392,UEE5BBA,61,14963.149999999998,44,17,118825.61,133788.76
6393,U5E2484,61,-22106.770000000004,46,15,130308.71,108201.94
6394,U714E40,60,-3780.4900000000016,48,12,37388.880000000005,33608.39
6395,U3A495D,60,-466.9900000000001,54,6,6881.1,6414.110000000001
6396,UF7EFF1,60,16827.92,44,16,47597.93,64425.85
6397,U4F06C4,60,-3482.4500000000016,55,5,10478.53,6996.08
6398,U4B0CBB,60,1939.2199999999998,51,9,11082.73,13021.949999999999
6399,U7C6899,60,17807.99999999997,51,9,172148.1,189956.09999999998
6400,U86CB09,60,-44512.310000000005,51,9,94012.31,49500.0
6401,U0D79D5,60,720.5199999999995,58,2,6201.4800000000005,6922.0
6402,U44B452,60,-6582.83,52,8,35448.96,28866.13
6403,U4FEE5E,60,-12469.210000000005,35,25,45399.23,32930.020000000004
6404,U29F6D0,60,-1234.22,54,6,3959.9700000000003,2725.75
6405,UD707D7,60,160.29999999999995,37,23,7929.92,8090.22
6406,U5B069A,60,-560.900000000001,51,9,15759.380000000001,15198.48
6407,U032AFE,60,-83.67999999999999,57,3,4486.969999999999,4403.29
6408,U6FC17D,60,-53052.479999999996,52,8,138119.09000000003,85066.61
6409,U8A4CF7,60,12401.310000000001,27,33,41760.88,54162.19
6410,UC85D3F,60,-676.8900000000001,57,3,2439.5000000000005,1762.6100000000001
6411,U37DAE3,60,575.8400000000001,55,5,2108.5600000000004,2684.3999999999996
6412,UBD120C,60,0.42000000000007276,27,33,25960.42,25960.84
6413,U965E4B,60,879.7699999999952,54,6,55057.89,55937.659999999996
6414,U611B5A,60,-13501.0,35,25,22337.16,8836.16
6415,U2A079E,60,9349.029999999999,43,17,112930.66000000002,122279.69
6416,U1E6FB2,60,-2509.690000000001,50,10,25524.69,23015.0
6417,UD92D2B,60,-3131.1299999999997,45,15,19333.030000000002,16201.900000000003
6418,U89032C,60,-2787.5999999999985,46,14,48837.5,46049.899999999994
6419,U86A93A,60,335.58999999999946,52,8,6704.409999999999,7040.0
6420,U974F74,60,2592.409999999998,51,9,24626.14,27218.55
6421,UEE9E49,60,-12335.150000000003,41,19,181485.33,169150.18
6422,U429886,60,-9764.009999999998,54,6,14295.109999999999,4531.1
6423,UE2AEFB,60,267.3699999999999,46,14,17317.74,17585.11
6424,U1EF680,60,-212.9500000000001,56,4,3366.03,3153.0799999999995
6425,U2C7A72,60,16078.570000000005,33,27,143923.86,160002.43
6426,U100B6A,60,10848.220000000001,54,6,7277.039999999999,18125.26
6427,U448D99,60,-417.3800000000002,58,2,6855.97,6438.59
6428,UB4757C,60,-361.64999999999975,43,17,6988.649999999998,6627.0
6429,UA3EFD7,60,-1229.1799999999987,57,3,18809.55,17580.37
6430,UC0F360,60,19668.889999999996,53,7,45908.06,65576.95000000001
6431,U7ED168,60,-134.73999999999978,44,16,7040.249999999999,6905.51
6432,UB3AE68,60,-298.9999999999999,57,3,1232.5799999999997,933.5799999999999
6433,U0E6758,60,8375.760000000031,44,16,273817.57,282193.3300000001
6434,U23C1E7,60,262.76000000000005,55,5,978.8600000000001,1241.62
6435,U49573B,60,-151.98000000000002,54,6,2761.21,2609.23
6436,U76A77D,60,5983.260000000002,30,30,60627.64,66610.9
6437,UD5C9AB,60,-20632.650000000005,48,12,195135.65000000002,174503.0
6438,UAAD3F4,60,1700.0900000000001,56,4,1229.7,2929.79
6439,UAE1A0E,60,-63.75000000000003,56,4,3054.29,2990.5400000000004
6440,U6D057A,60,4586.300000000002,50,10,37605.130000000005,42191.43
6441,U6C1623,60,-2015.6000000000022,52,8,19924.94,17909.34
6442,U132628,60,-110.25999999999999,56,4,3087.56,2977.3
6443,U00E588,60,-4.600000000000136,31,29,11058.0,11053.4
6444,U51A376,60,11.559999999986843,38,22,314371.69,314383.25
6445,UE670A5,60,-15893.110000000002,37,23,169846.12999999998,153953.02
6446,UB69EF3,60,-2702.1600000000003,45,15,28920.7,26218.54
6447,UDA7DC2,60,-946.6700000000009,57,3,3520.270000000001,2573.6
6448,UED5980,60,-160.4899999999991,38,22,21541.810000000005,21381.32
6449,U8FD49F,60,-16045.030000000002,57,3,21445.04,5400.01
6450,UCCC03C,60,-156.48000000000152,36,24,16909.530000000006,16753.050000000003
6451,U0BCF11,60,909.3999999999996,55,5,8415.279999999999,9324.68
6452,UBB6328,60,5381.289999999997,47,13,103264.87000000001,108646.15999999999
6453,U63AB0D,60,-14986.73,44,16,200256.5999999999,185269.87000000002
6454,U626BD4,60,-99.14999999999975,38,22,8671.73,8572.58
6455,U134F13,60,-1516.5800000000002,52,8,6876.269999999999,5359.69
6456,UD340BF,60,2308.25,34,26,16147.829999999998,18456.08
6457,U29B726,60,-7702.069999999995,49,11,59932.72,52230.65000000001
6458,U20EAE3,60,6765.3399999999965,22,38,407015.55000000005,413780.89
6459,UEB8169,60,22849.659999999996,51,9,13160.24,36009.9
6460,UB724E1,60,117230.93999999999,42,18,47092.4,164323.34
6461,U0A7C92,60,24396.820000000003,39,21,60230.990000000005,84627.81000000001
6462,U54B4B0,60,105363.19000000003,47,13,22272.55,127635.73999999999
6463,UE18C74,60,584.9700000000012,50,10,14682.36,15267.33
6464,U70FACC,60,-210.78000000000014,44,16,3431.4600000000005,3220.6800000000003
6465,UEC61D0,60,-755.3800000000003,58,2,10681.38,9926.0
6466,U38BC09,60,-4935.0700000000015,34,26,71665.84999999999,66730.78
6467,U85428D,60,-3921.9899999999993,56,4,6782.68,2860.69
6468,UDD8210,60,1064.3999999999996,58,2,1885.8000000000002,2950.2
6469,U5C66AC,60,-8976.569999999998,54,6,19379.979999999996,10403.41
6470,U9931EC,60,-1024.8899999999994,52,8,14723.889999999998,13699.0
6471,U114F19,60,13511.020000000002,55,5,9497.15,23008.17
6472,UF60557,60,-620.6200000000003,52,8,10963.5,10342.880000000001
6473,UAD21CE,60,-12437.389999999992,44,16,376336.87,363899.48
6474,U7D4142,60,-624.27,38,22,3621.87,2997.5999999999995
6475,UA1B9AC,60,-458.93999999999994,58,2,1053.13,594.1899999999999
6476,U25B431,60,94016.70000000001,36,24,198656.96999999997,292673.67000000004
6477,U70AB38,60,602.9700000000003,47,13,12281.27,12884.24
6478,U963771,60,-1385.0700000000004,48,12,13538.599999999997,12153.529999999999
6479,U506969,60,5205.36,57,3,24698.240000000005,29903.6
6480,U2F7076,59,-1280.7400000000005,57,2,3862.7400000000002,2582.0
6481,UCBB9AE,59,-256.2700000000001,55,4,1903.1699999999998,1646.8999999999999
6482,U67D651,59,7604.860000000001,50,9,12616.01,20220.87
6483,U44AE53,59,1319.0999999999985,50,9,25962.86,27281.96
6484,UFE9B3C,59,5015.82,54,5,5459.17,10474.989999999998
6485,U95231C,59,-28.0,54,5,4867.3099999999995,4839.3099999999995
6486,UA5B4A4,59,3200.3799999999997,52,7,4443.16,7643.54
6487,U775C82,59,10.0,49,10,7760.17,7770.17
6488,UD44727,59,-26883.309999999998,56,3,33820.5,6937.19
6489,U12C212,59,-73.8299999999997,52,7,6685.14,6611.31
6490,U579815,59,-7343.540000000007,43,16,53596.669999999984,46253.13
6491,U0C167E,59,-2042.1100000000006,51,8,29549.839999999997,27507.73
6492,U83B7D6,59,-1013.4300000000019,46,13,18540.52,17527.09
6493,U48D93E,59,-5276.199999999995,50,9,84132.94,78856.73999999999
6494,U4555F6,59,2251.66,48,11,36915.03,39166.69
6495,U424722,59,5486.919999999996,36,23,103819.62,109306.54
6496,U261CF2,59,-1098.9100000000005,44,15,2327.6200000000003,1228.7099999999998
6497,U03FB27,59,-1392.810000000001,56,3,6373.8099999999995,4981.0
6498,U92083E,59,-285.0699999999979,42,17,41853.65,41568.58
6499,UBDEAC8,59,674.6600000000012,57,2,12086.339999999998,12761.0
6500,U1F5084,59,13066.27,55,4,4565.010000000001,17631.28
6501,U420D05,59,6759.489999999997,50,9,48599.15000000001,55358.64
6502,UA3443D,59,-47049.899999999994,54,5,47393.899999999994,344.0
6503,U145EBE,59,-41117.27,56,3,61170.64,20053.370000000003
6504,U5E8194,59,6938.4400000000005,54,5,5319.580000000001,12258.02
6505,U356661,59,2482.9700000000007,55,4,4158.59,6641.56
6506,U684737,59,-3.469999999999118,47,12,14798.979999999994,14795.509999999998
6507,U876B20,59,249.21999999999858,34,25,47137.84,47387.05999999998
6508,UB83A35,59,-6253.8099999999995,55,4,11415.810000000003,5162.0
6509,U37712A,59,-4615.320000000001,55,4,6607.5,1992.1800000000003
6510,U03A870,59,4479.900000000004,43,16,34771.34,39251.24
6511,UEA59E2,59,-466.48000000000013,44,15,7513.139999999999,7046.66
6512,UF36714,59,-6498.589999999999,49,10,36536.159999999996,30037.57
6513,UEA1169,59,79.99000000000012,53,6,2764.8199999999997,2844.8100000000004
6514,UA7D7A6,59,-5927.269999999999,45,14,17913.98,11986.710000000001
6515,U0858D8,59,-10.120000000000141,33,26,4233.3,4223.179999999999
6516,U814B65,59,-6107.12,51,8,37212.49,31105.370000000003
6517,U9D523C,59,-1966.9899999999998,57,2,5120.740000000001,3153.75
6518,U7F236B,59,-20516.83,57,2,26346.83,5830.0
6519,U09092F,59,-2451.130000000002,49,10,15103.640000000001,12652.509999999998
6520,U888980,59,-1404.2800000000004,44,15,19167.58,17763.300000000003
6521,U907DC2,59,9730.319999999989,43,16,90022.41,99752.73000000001
6522,UBC0F44,59,-19980.48,50,9,26395.05,6414.57
6523,UD6B4AC,59,20589.070000000003,42,17,4303.089999999999,24892.160000000003
6524,UCD1821,59,333.08000000000015,55,4,2709.21,3042.29
6525,U591D51,59,1086.7200000000003,46,13,7825.089999999999,8911.810000000001
6526,UE48AF5,59,309.8299999999872,43,16,231010.38,231320.21
6527,U95925A,59,11704.96000000001,33,26,200059.24,211764.19999999995
6528,UFFCC76,59,-20255.829999999987,55,4,43817.569999999985,23561.739999999998
6529,UB24D7D,59,-18253.909999999993,50,9,59552.240000000005,41298.33
6530,UC78545,59,-3208.62,49,10,9818.02,6609.4
6531,U7F4BC1,59,12106.169999999991,39,20,78784.18,90890.35
6532,UCA5DEA,59,-45089.77000000001,48,11,168828.1,123738.33
6533,UA45305,59,843.2400000000002,53,6,2667.26,3510.5
6534,U61DF7D,59,0.8599999999983083,29,30,100082.0,100082.86
6535,U382731,59,170.20999999999964,52,7,24472.89,24643.1
6536,UD7C387,59,-2244.7899999999995,47,12,22295.0,20050.21
6537,U8088FE,59,9144.789999999999,36,23,42407.44,51552.229999999996
6538,U492C07,59,84363.85,38,21,259597.31,343961.1599999999
6539,U0DA19C,59,-465.4800000000009,54,5,4450.47,3984.99
6540,UE1036F,59,174.20999999999367,33,26,237244.41,237418.62
6541,UBA24E0,59,-314.28000000000065,46,13,28740.539999999997,28426.26
6542,UF2A3B9,59,1220.4300000000005,52,7,8541.279999999999,9761.71
6543,UD55AD3,59,1407.2,46,13,5960.79,7367.99
6544,U845483,59,-619.72,58,1,1135.91,516.19
6545,U321F12,59,6181.739999999994,43,16,172260.66,178442.4
6546,UE7EC09,59,-4843.28,58,1,4843.8,0.52
6547,UB33FF7,59,-15803.030000000002,51,8,89372.54,73569.51000000001
6548,U88B77A,59,-20.479999999999563,47,12,27998.490000000005,27978.010000000002
6549,U4C950A,59,-1097.2299999999998,57,2,2056.1299999999997,958.9
6550,UE0E8D7,59,-7.9399999999993724,55,4,13749.519999999999,13741.580000000002
6551,UE2B2D6,59,1252.399999999998,48,11,49882.77,51135.170000000006
6552,U2959EA,59,29050.29,53,6,3405.41,32455.7
6553,U9A07A7,59,94500.73000000003,28,31,230632.13000000003,325132.86
6554,UBC125F,59,-58.63999999999923,51,8,9778.679999999998,9720.04
6555,UDB9857,59,-415.99000000000075,44,15,6076.490000000001,5660.5
6556,U212CD7,59,214.80000000000035,44,15,20531.530000000002,20746.33
6557,UD84B0C,59,-666.32,56,3,2927.1400000000003,2260.8199999999997
6558,UFFFC56,59,701.3299999999726,33,26,224902.42000000004,225603.75
6559,U811937,59,22381.440000000002,35,24,13375.25,35756.689999999995
6560,U413AF5,59,-13299.949999999993,38,21,52683.98000000001,39384.03
6561,UB2C2AA,59,345.6500000000001,44,15,55675.719999999994,56021.369999999995
6562,UF56482,59,39942.4,55,4,25190.66,65133.06
6563,UB16254,59,-1610.37,53,6,3510.43,1900.06
6564,U850BDF,59,-5.189999999999987,43,16,660.8,655.61
6565,UA6EB13,59,998.7400000000002,53,6,1276.96,2275.7
6566,U6DA40E,59,-33201.54000000002,55,4,65796.18000000001,32594.64
6567,UA13B70,59,20862.9,49,10,16161.35,37024.25
6568,U1BA46A,59,-408.1700000000001,50,9,12012.820000000002,11604.650000000001
6569,U466DB3,59,10589.230000000007,50,9,130510.76999999999,141100.0
6570,U744BAE,59,5230.529999999999,33,26,41136.67999999999,46367.20999999999
6571,U878F96,59,-730.35,51,8,4226.55,3496.2000000000003
6572,U34FB77,59,-2349.7500000000014,48,11,32772.46,30422.71
6573,UFCB9D1,59,1946.4600000000137,41,18,207083.39999999997,209029.86000000002
6574,UD383F3,59,-2688.8599999999997,45,14,37019.9,34331.04
6575,UEDC57B,59,1032.2399999999984,45,14,51653.84000000001,52686.08
6576,U52DE1A,59,9392.350000000006,55,4,29068.199999999997,38460.55
6577,U093A46,59,-3819.74,57,2,8669.74,4850.0
6578,U1CC501,58,-476.68000000000035,40,18,3361.7600000000007,2885.08
6579,U7F9B8B,58,-13135.300000000003,52,6,26037.8,12902.5
6580,UE679F2,58,-864.2700000000004,37,21,34605.76,33741.490000000005
6581,U458CD7,58,808.0599999999904,34,24,416255.01,417063.07
6582,UBD5B90,58,-9172.449999999997,49,9,46922.00000000001,37749.55
6583,U7F0793,58,180.33999999999943,48,10,3318.01,3498.3500000000004
6584,U8EEBB5,58,-409.2399999999999,53,5,1509.4799999999998,1100.24
6585,U8FBA99,58,2794.63,51,7,5731.0700000000015,8525.7
6586,UBD13F3,58,-5843.1900000000005,42,16,64545.93999999998,58702.74999999999
6587,UCA68E3,58,3142.4100000000017,36,22,31919.27,35061.68
6588,U51EB57,58,-953.6700000000019,56,2,6038.670000000002,5085.0
6589,U49B11D,58,-911.23,51,7,7019.98,6108.75
6590,UE191F3,58,-4345.4800000000005,51,7,18433.809999999998,14088.330000000002
6591,UB57EB2,58,-626.5500000000006,53,5,6140.660000000001,5514.11
6592,U95F958,58,-3756.7599999999998,54,4,9314.0,5557.24
6593,U453615,58,-385.44000000000085,53,5,8195.07,7809.63
6594,U23BA47,58,511.1900000000023,34,24,40368.380000000005,40879.57000000001
6595,U340A01,58,-159.6800000000003,49,9,4985.209999999999,4825.530000000001
6596,U5D3816,58,-1343.770000000001,48,10,14687.909999999998,13344.140000000001
6597,U6B7A95,58,-2500.7600000000007,54,4,7735.809999999999,5235.05
6598,UD76F95,58,2569.8499999999995,48,10,2037.12,4606.97
6599,U4C9836,58,981.909999999999,38,20,53108.78,54090.69
6600,UC9B9CD,58,-8245.219999999992,42,16,87351.54000000001,79106.31999999999
6601,U3BC5EB,58,83222.96999999999,47,11,22547.3,105770.26999999999
6602,UD8C1A4,58,-2175.5599999999995,46,12,14028.369999999999,11852.81
6603,UEE3C64,58,-41236.76000000001,51,7,153953.62999999998,112716.87
6604,U51F90E,58,-18347.82,26,32,107041.54999999999,88693.73
6605,U69F102,58,-765.2299999999997,39,19,3332.5900000000006,2567.36
6606,UA5CD13,58,112.06000000000313,50,8,13647.039999999997,13759.1
6607,U8C2E55,58,-8268.73,39,19,105055.73000000001,96787.0
6608,U1F0BBE,58,-19793.58,56,2,23985.19,4191.610000000001
6609,U01725C,58,26762.340000000047,27,31,1260685.0799999998,1287447.4199999997
6610,UE598FB,58,415.28999999999917,37,21,16142.419999999998,16557.710000000003
6611,U21409B,58,1717.4099999999994,55,3,9633.81,11351.22
6612,UCA13BA,58,13084.98,38,20,19101.040000000005,32186.019999999997
6613,UED03FD,58,-75751.88,34,24,219993.41000000003,144241.53000000003
6614,U8EE123,58,-2157.91,41,17,8823.5,6665.59
6615,U4175C8,58,69689.44,41,17,79872.65999999999,149562.1
6616,U529B10,58,-303.80000000000086,49,9,9772.859999999999,9469.060000000001
6617,UFDC18E,58,690.9499999999999,50,8,3398.640000000001,4089.5899999999997
6618,U2732F2,58,-1148.6299999999974,47,11,114785.37,113636.73999999999
6619,U3194DB,58,-32863.98000000001,42,16,167288.80000000002,134424.82
6620,UE231CA,58,-501.98,44,14,739.0600000000002,237.07999999999998
6621,UBAF03D,58,-2199.999999999999,53,5,4327.33,2127.33
6622,U2C6A7B,58,-13113.07,54,4,41145.07000000001,28032.0
6623,U7B1D91,58,-16306.170000000002,53,5,21860.88,5554.71
6624,U524E19,58,-4500.469999999998,48,10,11260.34,6759.87
6625,UA50342,58,-289.8100000000008,52,6,4837.56,4547.75
6626,U624DF1,58,-3089.269999999999,45,13,37680.840000000004,34591.57
6627,U653F80,58,23.35000000000059,43,15,7554.7300000000005,7578.08
6628,UD86BE4,58,-3996.67,51,7,14109.75,10113.08
6629,U8CECA1,58,3425.6100000000006,32,26,60588.0,64013.61
6630,U56FE97,58,-40.0,31,27,20110.0,20070.0
6631,UF9B3B0,58,-7018.98,55,3,22594.36,15575.380000000001
6632,U050D08,58,-2203.95,54,4,8135.7,5931.75
6633,U1DF9FE,58,-2789.600000000001,44,14,5170.44,2380.8399999999997
6634,U0E6C93,58,-5717.700000000001,40,18,33590.12,27872.420000000002
6635,U41E08F,58,1200.7699999999995,33,25,19710.440000000002,20911.21
6636,U8178D3,58,1311.7200000000003,52,6,9511.6,10823.32
6637,U06D47F,58,-286.56,54,4,8203.199999999999,7916.639999999999
6638,UD3852A,58,-7055.600000000003,54,4,24239.99,17184.39
6639,UFAB297,58,-19861.5,53,5,30714.550000000003,10853.05
6640,UD6597F,58,-3054.9800000000005,57,1,12168.979999999996,9114.0
6641,U891996,58,-2885.12,49,9,3787.6,902.48
6642,U93B9D2,58,-3405.3200000000015,47,11,17829.159999999996,14423.84
6643,U44E519,58,12.56999999999996,51,7,2772.4999999999995,2785.07
6644,UFEA34E,58,-1672.8100000000002,33,25,8132.42,6459.610000000001
6645,UA61D37,58,-9049.96,55,3,9150.25,100.29
6646,U380ADA,58,-10801.009999999998,48,10,48355.14,37554.13
6647,UF52893,58,-16335.57,48,10,91952.52,75616.95
6648,U4EF0D6,58,-21200.92,53,5,31542.679999999997,10341.76
6649,U39D942,58,3138.6600000000035,42,16,277820.03,280958.69
6650,UECA3CD,58,-738.110000000001,48,10,6195.85,5457.74
6651,U5E4E04,58,58.26999999999983,28,30,16672.739999999998,16731.01
6652,U812886,58,-3981.89,56,2,4559.05,577.1600000000001
6653,U61E326,58,1529.5499999999995,55,3,5772.990000000001,7302.54
6654,U365A26,58,12102.460000000003,23,35,401516.9,413619.36000000004
6655,U67ED9C,58,-4452.569999999998,52,6,45606.14,41153.56999999999
6656,U0567DB,58,687.1499999999996,30,28,16158.130000000001,16845.28
6657,U47F64A,58,63947.81,39,19,12746.289999999999,76694.1
6658,UE1AEEC,58,9986.419999999998,43,15,59497.31,69483.73
6659,U53FC93,58,-3834.450000000001,33,25,28994.079999999998,25159.629999999997
6660,U11D83D,58,-1983.830000000003,45,13,86022.36,84038.53
6661,UFD214E,58,8002.379999999997,21,37,131610.51,139612.89
6662,UCC8090,58,-3022.25,56,2,3324.35,302.1
6663,U459CAA,58,57.28000000000034,52,6,3834.17,3891.45
6664,UAAFB19,58,1651.67,46,12,7973.94,9625.609999999999
6665,U4955C4,58,7095.420000000004,52,6,64612.72,71708.14
6666,U7DF27A,58,20413.119999999995,42,16,107340.68,127753.8
6667,U39C87C,58,-40054.66000000001,56,2,43386.11000000001,3331.45
6668,UD99EB5,58,-6102.889999999997,46,12,86429.88999999998,80327.0
6669,U0A2BA4,58,520.8000000000002,42,16,9098.05,9618.849999999997
6670,UF91323,58,10049.629999999996,47,11,54974.44000000001,65024.07
6671,U401198,58,-10735.080000000004,49,9,19894.28,9159.199999999999
6672,U6ECD8B,58,-727.9599999999997,52,6,9036.43,8308.470000000001
6673,UE51F29,58,21948.4,53,5,8987.9,30936.300000000003
6674,UDEC2FD,58,-1444.9599999999982,41,17,44995.91999999999,43550.96
6675,UEBCA98,58,150.23000000000138,56,2,6002.549999999998,6152.78
6676,UBCC214,58,31663.47,39,19,118371.29,150034.75999999998
6677,U27E0EC,58,-5780.470000000003,49,9,33834.01,28053.539999999997
6678,UF3919F,58,25.389999999999247,48,10,22498.18,22523.57
6679,U864687,58,61.239999999996584,45,13,68770.36999999998,68831.61
6680,U0C0A58,57,706.6599999999994,56,1,5183.4400000000005,5890.1
6681,UE25287,57,-138.3199999999988,52,5,18778.289999999997,18639.97
6682,U1EFD44,57,6225.419999999958,36,21,242747.32,248972.74
6683,U681532,57,2687.2999999999997,42,15,8806.38,11493.679999999998
6684,UF314D7,57,-7736.589999999998,33,24,100726.83,92990.24000000002
6685,U9ABE1B,57,-5195.28,54,3,7052.0599999999995,1856.78
6686,UBB0617,57,615.6300000000037,38,19,93576.62,94192.25
6687,U4EACD4,57,1321.0600000000002,50,7,27999.189999999988,29320.25
6688,U16CC48,57,-1.8189894035458565e-12,21,36,74237.63,74237.62999999998
6689,UBE88CE,57,13.899999999999636,50,7,17418.65,17432.55
6690,UD52093,57,-437.3699999999999,46,11,3459.0600000000004,3021.69
6691,UEB8791,57,-32.47,35,22,752.9700000000001,720.5
6692,U668ED3,57,-14502.200000000003,45,12,53802.39,39300.19
6693,U7AFB50,57,1737.4,53,4,2617.2799999999997,4354.68
6694,U37BEBA,57,1719.0599999999988,52,5,14369.35999999999,16088.42
6695,UEF09AA,57,-2384.66,53,4,6006.56,3621.9
6696,U1E1A09,57,6000.640000000001,28,29,27493.97,33494.61
6697,UFBDC88,57,54827.0,30,27,63298.0,118125.0
6698,UCB895F,57,-131.30999999999585,44,13,28705.140000000003,28573.83
6699,UAEF493,57,21241.54,42,15,244576.5,265818.04
6700,UA02CA7,57,-641.6699999999964,34,23,80760.79999999999,80119.13
6701,UB4F730,57,12078.97,42,15,31281.54,43360.51
6702,U39E4C8,57,606.5100000000002,53,4,19623.49,20230.0
6703,U18B878,57,-214.7800000000011,53,4,7705.840000000004,7491.06
6704,U8D10C7,57,1438.5400000000034,48,9,51623.44999999999,53061.990000000005
6705,U1CD364,57,-9641.589999999993,46,11,86917.63,77276.04
6706,U0EB208,57,-2904.67,53,4,5264.67,2360.0
6707,U2F798A,57,2633.19,43,14,4975.680000000001,7608.87
6708,U7A14F0,57,-19784.819999999996,44,13,40816.48000000001,21031.66
6709,U2CF444,57,-8031.119999999999,39,18,123196.5,115165.38
6710,U30CD62,57,-286.57000000000784,36,21,112211.88000000002,111925.31
6711,U2F56B2,57,-4197.29,41,16,15183.51,10986.220000000001
6712,U9CDE36,57,462.20999999999935,52,5,7804.62,8266.83
6713,UAB5E56,57,-38.01000000000113,50,7,44793.85,44755.84
6714,UED978C,57,18207.949999999968,41,16,341786.11,359994.06
6715,U4AF1D4,57,4486.960000000002,49,8,25876.59,30363.549999999996
6716,UA952EE,57,21016.64,42,15,32287.099999999995,53303.74
6717,U208E14,57,-840.4600000000004,43,14,16397.36,15556.900000000001
6718,U4FB4E4,57,20624.55999999995,51,6,460135.14,480759.7
6719,U2B24FE,57,-277.32000000000124,51,6,6096.120000000001,5818.799999999999
6720,U180DF8,57,734.5199999999999,50,7,25069.05,25803.57
6721,UF97EED,57,7504.549999999998,31,26,37229.16,44733.71
6722,U30D4EE,57,-30803.539999999994,48,9,81862.58,51059.04000000001
6723,UAEB413,57,8941.5,32,25,960.4,9901.9
6724,U943C45,57,-2641.4999999999995,41,16,15232.25,12590.75
6725,UF0A725,57,-837.9999999999945,30,27,117327.32,116489.31999999999
6726,U20EFA2,57,1346.6899999999996,44,13,12869.31,14216.0
6727,U3FF518,57,-177.7399999999988,51,6,34177.78,34000.04
6728,UFB63E7,57,-48489.79,55,2,51304.79,2815.0
6729,UD40A6E,57,-8326.929999999998,55,2,14393.93,6067.0
6730,UB4DE8B,57,-5375.620000000004,28,29,33708.09,28332.470000000012
6731,U45A2BD,57,-80.40999999999963,46,11,20737.539999999997,20657.129999999997
6732,U4B8992,57,38048.28999999999,46,11,62282.549999999996,100330.84000000001
6733,U93033A,57,1464.81,41,16,3289.1600000000003,4753.97
6734,UCF3926,57,11054.299999999997,50,7,35749.21000000001,46803.51
6735,UF5F18B,57,-7965.300000000003,41,16,100267.79000000001,92302.48999999999
6736,U4295F2,57,17078.890000000014,37,20,807914.79,824993.6799999999
6737,U0A3710,57,-1130.5099999999975,31,26,42751.37,41620.86
6738,U2D877A,57,50393.85,40,17,20640.829999999998,71034.68000000001
6739,UD7EBFC,57,-23870.03,52,5,33551.07,9681.04
6740,U89AA34,57,13220.659999999998,38,19,9329.92,22550.58
6741,U8F4AF2,57,-24646.06,43,14,45845.82,21199.760000000002
6742,UD167A4,57,-607.760000000002,53,4,16808.72,16200.96
6743,U9E7632,57,-932.1700000000004,50,7,2420.1300000000006,1487.96
6744,U847CBF,57,-3095.6600000000226,50,7,79330.51,76234.84999999999
6745,U418EF5,57,1067.89,50,7,2932.5299999999997,4000.42
6746,U4C1E93,57,-1337.9599999999998,49,8,6395.63,5057.67
6747,UEE463C,57,495.5399999999998,42,15,18893.93999999999,19389.480000000003
6748,U2FAB24,57,-1895.3900000000006,53,4,7908.4000000000015,6013.01
6749,U78F308,57,13361.140000000003,41,16,136171.3,149532.44
6750,U6BB8E3,57,-17635.899999999998,51,6,97305.8,79669.9
6751,U28E097,57,2797.2,28,29,12199.0,14996.2
6752,UDBC418,57,-11285.14,50,7,17839.03,6553.889999999999
6753,U645744,57,-9554.999999999998,29,28,143819.38,134264.38
6754,U522106,57,-2894.0200000000004,46,11,14836.079999999998,11942.06
6755,UB47D3C,57,-209.27000000000044,38,19,21650.61,21441.34
6756,U72667F,56,22754.970000000016,34,22,129770.96,152525.93000000002
6757,U0A40AE,56,913.1199999999949,50,6,31327.319999999996,32240.44
6758,U587952,56,867.599999999999,52,4,7927.300000000001,8794.9
6759,UD3DB3B,56,-57.720000000000255,38,18,11065.909999999998,11008.19
6760,U48048B,56,-193.03999999999178,29,27,139340.74000000002,139147.69999999998
6761,UFACF19,56,-14981.389999999994,52,4,15141.389999999996,160.0
6762,U686288,56,-27.76000000000022,48,8,13659.23,13631.47
6763,U8E2489,56,-7643.960000000003,44,12,89384.01000000001,81740.05
6764,UE2493E,56,36974.38,41,15,52800.14,89774.52
6765,U631780,56,-949.1199999999999,53,3,5527.56,4578.4400000000005
6766,U7A7545,56,-2635.8099999999995,49,7,6964.53,4328.719999999999
6767,U6EB8A6,56,690.2200000000016,46,10,36513.469999999994,37203.69
6768,U946B73,56,-46610.25999999998,47,9,153956.65999999997,107346.4
6769,UFAA34D,56,-11189.73,49,7,22948.440000000002,11758.71
6770,UBCDB63,56,-13628.090000000002,46,10,63166.25,49538.159999999996
6771,UD310D4,56,-60369.78000000001,53,3,60596.150000000016,226.37
6772,UC00A48,56,1741.6900000000082,48,8,57941.47,59683.16
6773,U4371DF,56,-5922.669999999999,35,21,152059.94000000006,146137.27
6774,UB61A09,56,229.14999999999952,43,13,12951.380000000001,13180.529999999999
6775,UE5DA69,56,-6771.639999999999,52,4,8830.76,2059.12
6776,U3DFEC9,56,857.1100000000004,36,20,20153.650000000005,21010.760000000002
6777,UE449AF,56,-771.6800000000017,45,11,34524.990000000005,33753.31
6778,UE99D1F,56,-22259.13,51,5,70800.37999999999,48541.25000000001
6779,UF3DB39,56,-19.02000000000036,47,9,19226.18,19207.16
6780,U299735,56,177.90000000000012,53,3,3006.16,3184.0600000000004
6781,UFFCCF3,56,8474.51,46,10,29148.17,37622.68
6782,UE66E68,56,-39161.72,42,14,110170.08,71008.36
6783,U391838,56,3479.5099999999998,51,5,2132.7999999999997,5612.3099999999995
6784,U9E7E7A,56,295.0100000000002,27,29,13991.0,14286.01
6785,U11DEB9,56,18502.86,29,27,41485.25,59988.10999999999
6786,U620684,56,262.78000000000014,47,9,3306.870000000001,3569.6499999999996
6787,UDFA405,56,351.84999999999997,53,3,3850.3999999999996,4202.25
6788,UFAEA80,56,-36936.03,52,4,52281.54999999999,15345.52
6789,UE0A854,56,1817.660000000001,42,14,25258.660000000003,27076.320000000003
6790,U99A728,56,-5245.310000000002,48,8,21109.459999999995,15864.15
6791,U9B33CE,56,-4755.5899999999965,40,16,214861.55,210105.96000000002
6792,U25F160,56,5812.09,33,23,59443.31,65255.4
6793,UE04C90,56,1464.1100000000042,52,4,21443.28,22907.39
6794,UE61325,56,-4585.189999999998,47,9,38200.02,33614.83
6795,UC8CD10,56,-3550.0500000000006,53,3,18565.50999999999,15015.46
6796,U7C775F,56,30675.29,44,12,6649.620000000001,37324.91
6797,U181B32,56,-618.6800000000062,41,15,72776.95000000001,72158.27
6798,UEC9821,56,48062.61999999999,44,12,173712.65999999997,221775.28
6799,UA00F01,56,97.03000000000023,53,3,996.3899999999998,1093.42
6800,U8307A5,56,-23.860000000000582,46,10,21073.790000000005,21049.93
6801,UA684D9,56,11192.03,47,9,5942.16,17134.19
6802,U708001,56,666.0899999999992,31,25,49975.69,50641.78
6803,U8061E0,56,45488.159999999996,40,16,84588.25999999998,130076.42000000001
6804,UAF279E,56,-3907.75,50,6,4716.8600000000015,809.11
6805,U8C672E,56,-5429.209999999999,46,10,32657.0,27227.79
6806,UB42D3F,56,-3462.300000000001,32,24,162425.69999999998,158963.4
6807,U728401,56,-7494.6900000000005,47,9,58922.13,51427.44
6808,U1B7B56,56,-716.5000000000002,46,10,16195.259999999998,15478.759999999998
6809,U996D27,56,-892.5,45,11,2063.3299999999995,1170.83
6810,U44293E,56,39112.649999999994,48,8,17582.75,56695.399999999994
6811,U160260,56,-9531.820000000005,45,11,82092.23999999999,72560.42
6812,U270DAD,56,-4037.0,43,13,156231.44,152194.44
6813,U7DF2BA,56,401.4200000000003,33,23,11325.500000000002,11726.920000000002
6814,U42BD5C,56,5707.19000000001,27,29,451788.87,457496.06
6815,U6D4A08,56,3241.640000000002,54,2,65274.47,68516.11
6816,UB1EC28,56,-659.0099999999984,41,15,78087.01,77428.0
6817,U3AEFB8,56,-322.9899999999986,52,4,8079.489999999998,7756.5
6818,U66A5B6,56,-4096.030000000001,42,14,12957.049999999997,8861.02
6819,UDD9446,56,-724.2400000000001,31,25,11266.75,10542.51
6820,U512368,56,-8936.75,44,12,20745.389999999996,11808.64
6821,UFF8772,56,720.5000000000002,47,9,11954.419999999998,12674.92
6822,U9CABF9,56,-199.48999999999916,49,7,11440.659999999998,11241.17
6823,U20F416,56,1965.1900000000016,41,15,55095.749999999985,57060.939999999995
6824,U4E1820,56,3295.709999999999,38,18,39760.51,43056.22
6825,UACACE7,56,447.360000000003,31,25,55443.85,55891.21000000001
6826,UBDEE00,56,3408.5899999999965,40,16,258491.54,261900.13
6827,UD6825D,56,562.0999999999995,50,6,3366.540000000001,3928.64
6828,UF069AA,56,-30463.800000000007,49,7,30745.650000000005,281.85
6829,U6D27AD,56,1161.1699999999998,48,8,7390.759999999999,8551.93
6830,U12209E,56,144914.03,50,6,24063.589999999997,168977.62
6831,UC00380,56,-97149.94,45,11,166355.29,69205.35
6832,U245DD8,56,3022.9099999999994,37,19,2476.69,5499.600000000001
6833,UE21A65,56,-1568.4800000000007,31,25,24083.889999999996,22515.41
6834,UE26488,56,3134.2,52,4,11235.799999999997,14370.0
6835,U3A925D,56,-7938.209999999997,34,22,165263.4,157325.18999999997
6836,U8C3D38,56,27.989999999999327,43,13,15276.159999999998,15304.15
6837,UFDAD69,56,329.1699999999999,48,8,978.4,1307.5699999999997
6838,U616A02,56,-10311.719999999998,49,7,42769.14000000001,32457.420000000002
6839,UBAB017,56,-1052.88,47,9,3990.5899999999997,2937.71
6840,U6C0B75,56,3268.71,49,7,30700.109999999993,33968.82
6841,UDCE766,56,-18032.8,49,7,62565.52000000001,44532.72
6842,U72BF7E,56,3357.3000000000006,48,8,12903.289999999997,16260.59
6843,U05AC02,56,-1541.3200000000008,53,3,3188.9100000000008,1647.59
6844,UD05672,56,66.42000000000007,48,8,2464.51,2530.93
6845,UDC1283,56,-943.5399999999936,38,18,166091.01,165147.47
6846,UB38CF5,56,-895.9399999999973,52,4,27536.94,26641.0
6847,U776BB5,56,-3.8400000000008845,47,9,6700.400000000001,6696.56
6848,UDD4CE3,56,39752.01,47,9,25029.09,64781.1
6849,UC0F58A,56,25051.58000000001,46,10,9322.32,34373.9
6850,U162522,56,-3946.74,54,2,7046.740000000001,3100.0
6851,U0ADFB3,56,-23726.24000000002,49,7,78456.55,54730.31
6852,U1F25C6,56,-1171.32,51,5,3897.820000000001,2726.5
6853,UE2442C,56,-17385.0,54,2,27004.05,9619.05
6854,U174D64,56,832.739999999998,30,26,170977.26,171810.0
6855,U3717E3,56,4314.579999999999,28,28,16720.18,21034.76
6856,U535E7B,56,526.6799999999994,53,3,6505.37,7032.05
6857,UB371EF,56,5711.850000000005,39,17,37182.54,42894.39
6858,U2DF937,56,-2026.4999999999998,50,6,3463.44,1436.9400000000003
6859,U5A81FA,56,-7007.96,35,21,33940.73,26932.77
6860,U429BC3,56,173747.66999999998,27,29,48366.4,222114.07
6861,UB7F98B,56,-4517.6799999999985,47,9,50569.6,46051.92
6862,U240CE8,56,-3377.029999999997,53,3,33534.07000000001,30157.04
6863,U3CCEF0,56,-4412.25,44,12,46927.229999999996,42514.979999999996
6864,UD0029B,56,-1796.889999999999,32,24,20830.950000000004,19034.06
6865,UC1DDD5,56,-429.2599999999973,47,9,25381.500000000004,24952.24
6866,U1B0841,56,9576.289999999997,27,29,163493.34,173069.63000000003
6867,UAE75D2,56,344.08000000000015,30,26,29514.440000000002,29858.52
6868,UD4E886,56,-91532.7,42,14,162417.93,70885.23000000001
6869,U5E65D3,56,3035.439999999999,49,7,5094.139999999999,8129.58
6870,U1B2ABE,56,-307.0300000000003,48,8,6753.04,6446.01
6871,U88FDAB,56,7439.639999999996,51,5,2152.330000000001,9591.97
6872,U908F86,56,4908.790000000004,44,12,43964.189999999995,48872.98
6873,U9800F0,56,-2266.1899999999996,42,14,20485.29,18219.1
6874,UFD0E92,56,2715.2799999999997,47,9,21352.50000000001,24067.780000000006
6875,UB973F5,56,16918.0,39,17,64907.34,81825.34
6876,U545C7F,55,870.0200000000004,49,6,31256.63,32126.65
6877,U645168,55,173.4000000000001,43,12,7707.73,7881.13
6878,U9AF383,55,-3669.559999999999,50,5,14738.569999999996,11069.01
6879,U137D88,55,5695.870000000002,39,16,2237.9700000000003,7933.84
6880,UB24F50,55,-490171.04000000004,47,8,681318.36,191147.31999999998
6881,U0B2C6D,55,3242.3399999999997,47,8,14942.72,18185.059999999998
6882,U8B536A,55,2594.7999999999984,48,7,13844.04,16438.84
6883,U19408D,55,43668.82,34,21,37148.86,80817.68
6884,U15D13E,55,-1815.49,43,12,12868.75,11053.26
6885,U95C406,55,4767.549999999997,49,6,43178.579999999994,47946.130000000005
6886,U4D2F97,55,76678.34000000001,45,10,124906.42,201584.76
6887,U3B02C0,55,1122.9999999999975,35,20,92238.92,93361.92
6888,U894990,55,-178.77000000000135,43,12,22261.07,22082.3
6889,U8007D7,55,1183.8499999999995,35,20,88387.34999999999,89571.2
6890,U0C4689,55,882.4599999999987,47,8,13975.829999999998,14858.29
6891,U568F41,55,-796.9399999999991,42,13,31796.94,31000.0
6892,UD73E48,55,-4779.280000000002,47,8,20226.849999999995,15447.570000000002
6893,UE9135B,55,1195.1500000000015,44,11,72779.0,73974.15
6894,U5F9DF6,55,-21081.690000000006,49,6,42456.200000000004,21374.51
6895,U8C49AB,55,17470.629999999997,42,13,20085.18,37555.81
6896,U0EFA98,55,-2171.700000000002,50,5,99846.76,97675.06
6897,U9E31E3,55,86.25999999999978,48,7,8678.54,8764.800000000001
6898,UAA7AEB,55,-4431.610000000001,45,10,7277.919999999999,2846.31
6899,UA61777,55,960.9499999999982,36,19,59153.42999999999,60114.37999999999
6900,UC36639,55,-4152.96,52,3,19182.96,15030.0
6901,UAB27A0,55,2694.790000000002,50,5,13005.21,15700.0
6902,UC42760,55,-2254.03,48,7,4627.03,2373.0
6903,UC41858,55,-13590.400000000001,51,4,19195.219999999998,5604.82
6904,UB1B8CD,55,-2775.8600000000056,39,16,48173.66999999999,45397.81
6905,U47F50F,55,-10.0,31,24,90010.0,90000.0
6906,UD2AF0D,55,-1370.0800000000006,46,9,3952.250000000001,2582.17
6907,UB1B095,55,-7489.0,30,25,23729.0,16240.0
6908,UADD6D9,55,402.69000000000005,50,5,865.6000000000001,1268.29
6909,UE490C0,55,81067.35000000002,42,13,6709.83,87777.18
6910,U4CA6A8,55,1548.0999999999997,48,7,5501.530000000001,7049.629999999999
6911,U861A43,55,-4768.670000000002,41,14,23367.73,18599.059999999998
6912,U07392D,55,-4246.98,30,25,23146.980000000007,18900.0
6913,UFA96BC,55,-4.749999999999987,53,2,59.90000000000004,55.15
6914,UCE96E3,55,-661.9799999999975,47,8,50596.5,49934.52
6915,UEA3905,55,-761.8499999999985,36,19,48887.45,48125.6
6916,U273EA4,55,6032.900000000001,43,12,60929.6,66962.50000000001
6917,UED7089,55,187.5599999999995,46,9,17932.239999999998,18119.8
6918,UEF3785,55,-659.6799999999996,51,4,15916.449999999993,15256.77
6919,U69BAD0,55,-5486.82,42,13,117597.48,112110.66
6920,U9E9E1D,55,-9658.899999999996,50,5,27037.19,17378.29
6921,U0D7F01,55,-7852.43,43,12,76795.53000000001,68943.09999999999
6922,UC716F6,55,-515.3299999999999,40,15,7602.3,7086.969999999999
6923,U705299,55,-2912.88,47,8,4668.929999999999,1756.0500000000002
6924,UDF5719,55,-1605.29,49,6,5482.150000000001,3876.86
6925,U1A77D5,55,-11199.74,44,11,32568.839999999997,21369.099999999995
6926,U48F727,55,188.73000000000013,42,13,10183.739999999996,10372.470000000001
6927,U7866D2,55,-11285.06,43,12,19485.78,8200.720000000001
6928,UCEA179,55,-7008.799999999997,42,13,47967.91000000001,40959.11
6929,U1C5904,55,10284.57,45,10,15771.570000000002,26056.14
6930,U456B1E,55,180.6099999999994,52,3,4377.830000000001,4558.4400000000005
6931,U8E955C,55,-15213.69,48,7,31815.689999999995,16602.0
6932,U394400,55,7492.120000000003,50,5,10397.98,17890.100000000002
6933,U3D8684,55,337.4500000000041,39,16,21297.19,21634.64
6934,U75B99E,55,447.1399999999994,44,11,9924.55,10371.689999999999
6935,U50A4B0,55,-1972.9400000000007,53,2,7424.39,5451.45
6936,UA4661D,55,6939.450000000023,25,30,312536.50999999995,319475.96
6937,UD2DDDD,55,-6239.16,53,2,12438.32,6199.16
6938,U52B62E,55,-8518.050000000001,39,16,47855.01,39336.96
6939,U0BDECF,55,-645.9899999999996,30,25,10869.03,10223.04
6940,UE12FD7,55,1390.2099999999996,47,8,2723.1699999999996,4113.38
6941,U491291,55,-1207.7299999999996,46,9,40918.38,39710.649999999994
6942,U30C6C6,55,9.129999999999962,52,3,907.66,916.79
6943,U53607D,55,-4.547473508864641e-13,31,24,42283.19,42283.18999999999
6944,UB7FCA2,55,-449.52999999999963,52,3,2822.36,2372.83
6945,U2B5E7B,55,-2267.23,53,2,4467.23,2200.0
6946,UC8C45F,55,-33584.63999999999,43,12,222273.37999999995,188688.74
6947,U357807,55,-2547.52,43,12,20326.570000000003,17779.050000000003
6948,U37C1C1,55,-31933.949999999993,48,7,79582.29000000001,47648.34
6949,UBD70AC,55,-10168.060000000003,47,8,49200.8,39032.74
6950,UF98C00,55,86491.06999999999,35,20,43982.3,130473.36999999998
6951,UF74714,55,2000.8500000000006,47,8,11049.299999999997,13050.15
6952,UD3583B,55,641.9000000000001,48,7,1665.3799999999999,2307.28
6953,UDAC76C,55,2901.8200000000015,43,12,37003.700000000004,39905.520000000004
6954,U3B60B5,55,32084.369999999995,26,29,96558.03000000001,128642.4
6955,U58FE37,55,52366.43999999999,46,9,61639.69000000002,114006.13
6956,UE19FC6,55,669.7799999999875,39,16,69430.43,70100.20999999999
6957,U2861DE,55,-2611.349999999993,41,14,758561.66,755950.31
6958,UDEECEE,55,14662.680000000002,36,19,30120.0,44782.68
6959,UF57E94,55,194.54999999999913,50,5,7493.700000000002,7688.25
6960,U84E985,55,58325.81000000001,35,20,621254.5800000001,679580.39
6961,U20643E,55,9649.690000000006,21,34,162229.66,171879.35
6962,UD1EF0C,55,-1839.4700000000003,38,17,81126.36999999998,79286.9
6963,U25D8F4,55,-1532.869999999999,35,20,71696.27,70163.4
6964,UCFCF0B,55,-2488.49,48,7,9348.490000000003,6860.0
6965,UC4BD67,55,14323.22,46,9,34065.72,48388.94
6966,U56D2D2,55,75527.20000000001,38,17,111231.82,186759.02
6967,U2B6E22,55,2705.25,33,22,13032.439999999999,15737.69
6968,U182D13,55,1437.7399999999998,36,19,85147.66,86585.4
6969,UCF156E,55,-2109.7099999999996,49,6,4770.47,2660.76
6970,U18BA8E,55,0.0,29,26,79000.0,79000.0
6971,U7828BF,55,1022.3999999999999,47,8,7957.669999999999,8980.07
6972,U2FA864,55,-1091.8999999999999,52,3,4093.1999999999994,3001.3
6973,UCABE11,55,230.82000000000045,46,9,1392.4599999999996,1623.28
6974,UD5388B,55,-13.659999999999968,44,11,2720.9099999999994,2707.25
6975,UF86269,55,2604.71,49,6,3939.2900000000004,6544.0
6976,U34018B,55,2365.0299999999997,43,12,42924.340000000004,45289.37
6977,U7B06A0,55,-79.02999999999975,49,6,7407.37,7328.34
6978,U4EED19,55,-211.43999999999912,42,13,35016.44,34805.0
6979,U4024D7,55,515.039999999999,52,3,8339.960000000001,8855.0
6980,U2CADB0,55,5471.000000000002,38,17,139013.59,144484.59
6981,U7B7470,55,318313.86000000004,40,15,116350.23000000001,434664.09
6982,U71F579,55,-1477.3799999999999,51,4,6677.440000000001,5200.0599999999995
6983,U3087E5,55,4405.440000000001,45,10,2061.4299999999994,6466.870000000001
6984,U6988E5,55,19534.58999999999,37,18,57962.54999999998,77497.13999999998
6985,U260D82,55,2734.5800000000004,41,14,4165.82,6900.4
6986,U2A965F,55,577.9399999999919,33,22,310873.2100000001,311451.14999999997
6987,U5CDB38,55,73.7799999999999,46,9,9212.79,9286.57
6988,UD79EFB,55,-2466.980000000003,45,10,75541.71,73074.73000000001
6989,UDA0B3D,55,-2467.279999999999,32,23,134718.72,132251.44
6990,U014103,55,-416.0800000000006,33,22,22315.510000000002,21899.429999999997
6991,U299ACC,55,-916.7000000000003,52,3,6416.700000000001,5500.0
6992,U36ED98,55,-117604.29999999997,38,17,274565.00000000006,156960.69999999998
6993,U7DBCD0,55,361.58000000000015,48,7,3405.71,3767.29
6994,UBDCF39,55,407.6300000000001,30,25,15906.560000000001,16314.19
6995,U5076B6,55,288.869999999998,46,9,16667.33,16956.2
6996,UFF7714,55,-4242.949999999998,45,10,40560.159999999996,36317.21
6997,UD719A5,55,-167.0700000000005,38,17,26135.52,25968.45
6998,U705475,55,1097.9299999999998,49,6,10319.980000000001,11417.910000000002
6999,UE720D7,55,-15159.82,52,3,28059.820000000007,12900.0
7000,UDE78E9,55,1857.3900000000012,52,3,5817.599999999999,7674.99
7001,U1FD9AE,55,-14859.92,35,20,96501.30999999998,81641.39000000001
7002,U8F4E82,55,-14469.109999999999,44,11,28055.109999999993,13586.0
7003,U47A908,55,-1582.3500000000001,29,26,22888.550000000003,21306.200000000004
7004,U6AD0D2,55,-1043.6400000000003,50,5,6739.139999999999,5695.5
7005,U8137DF,55,-2148.7999999999993,48,7,14817.800000000001,12669.0
7006,U6B641C,55,527.6600000000001,37,18,6288.97,6816.630000000001
7007,UA5F0AD,55,4397.419999999984,38,17,191779.78,196177.2
7008,U9DB147,55,6686.219999999999,34,21,12358.28,19044.499999999996
7009,U319B15,55,30.21999999999983,44,11,1588.1800000000003,1618.3999999999999
7010,UBAEE3C,55,-504.6899999999998,46,9,5989.619999999999,5484.929999999999
7011,U76D223,55,-3268.4400000000005,49,6,22634.7,19366.260000000002
7012,U86211C,55,-38931.609999999986,30,25,677575.17,638643.56
7013,U9A1B04,55,2614.789999999999,45,10,10228.940000000002,12843.729999999998
7014,U6B87A3,55,18542.509999999987,38,17,212771.65,231314.15999999997
7015,U7125FC,55,-511.08000000000004,48,7,4893.08,4382.0
7016,U4FE6AC,55,-11720.080000000016,23,32,1252283.76,1240563.68
7017,U9FD4C8,55,-525.8800000000008,48,7,18050.28,17524.399999999998
7018,UBAD0E4,55,0.7600000000000018,33,22,525.04,525.7999999999998
7019,UC4AD19,55,-543.06,48,7,4087.0600000000004,3544.0
7020,U15B76D,54,-7973.969999999999,44,10,22837.84,14863.869999999999
7021,UB0C9E1,54,-14734.380000000001,40,14,20190.7,5456.320000000001
7022,U9ABD5C,54,90.05999999999999,51,3,509.94000000000017,600.0
7023,UFF6618,54,-12232.67,48,6,35246.13,23013.46
7024,U03CE2A,54,-10626.09,49,5,13945.099999999997,3319.0099999999998
7025,UE9DDB8,54,1489.429999999999,45,9,6308.4800000000005,7797.91
7026,UD74891,54,10.179999999999836,48,6,8888.46,8898.64
7027,U5D064D,54,10119.720000000001,30,24,61985.80999999999,72105.53
7028,U6A4E74,54,-5509.200000000003,37,17,64509.2,59000.0
7029,U163AF4,54,-570.4,51,3,3107.0,2536.6
7030,U85B09D,54,106251.56000000004,48,6,71028.87999999999,177280.44
7031,U3FF319,54,-5435.32,52,2,8935.32,3500.0
7032,U9DD031,54,-629.69,52,2,2122.6900000000005,1493.0
7033,U7E1784,54,27483.430000000008,40,14,2208015.4499999993,2235498.88
7034,U4BF9A9,54,62726.11,36,18,32751.99,95478.1
7035,UEE4731,54,6131.329999999993,38,16,220288.59,226419.91999999998
7036,UABD3CA,54,6544.320000000004,47,7,7310.079999999999,13854.400000000001
7037,U82AE7C,54,663.3299999999945,44,10,34110.84,34774.17
7038,U6B7856,54,6626.620000000003,32,22,59462.64,66089.26000000001
7039,U477D1A,54,-276.2399999999995,48,6,6765.320000000001,6489.08
7040,UCE5673,54,-14066.080000000002,48,6,31452.97,17386.89
7041,U5E4CF3,54,-158.19999999999993,42,12,8647.27,8489.07
7042,U57132F,54,317.17000000000013,50,4,2882.9100000000003,3200.0800000000004
7043,UBC07B5,54,-166.17999999999947,45,9,2778.72,2612.5400000000004
7044,U26360F,54,-1618.1999999999998,48,6,5556.59,3938.39
7045,UC5E9CB,54,2153.59,40,14,41737.259999999995,43890.85
7046,U99E1EF,54,-28586.61,51,3,77758.72,49172.11
7047,U478FC1,54,-8039.28,50,4,25364.500000000007,17325.22
7048,UC6F028,54,-15472.33999999999,48,6,56781.520000000004,41309.18
7049,UA1D846,54,5698.76,41,13,8230.84,13929.6
7050,U4F0891,54,-4492.24,49,5,25492.960000000003,21000.72
7051,U0DDF4A,54,-4696.579999999998,47,7,35469.57,30772.989999999998
7052,U813996,54,20287.57,44,10,5716.219999999999,26003.79
7053,UD97063,54,-29942.17000000005,37,17,590379.78,560437.6100000001
7054,UB06B5B,54,-1272.5900000000001,51,3,3567.45,2294.8599999999997
7055,UD8DB62,54,2982.370000000001,50,4,7379.14,10361.51
7056,U83C78A,54,-1587.1799999999994,42,12,17106.779999999995,15519.6
7057,U0BBCD5,54,1011.9100000000017,49,5,32347.11,33359.020000000004
7058,U704974,54,-30071.83,34,20,69949.83,39878.0
7059,UABA8AD,54,-333.6999999999989,51,3,16541.260000000002,16207.56
7060,U396281,54,619.2199999999998,33,21,1720.13,2339.35
7061,U7BC81D,54,116.65000000000194,45,9,13564.349999999991,13681.0
7062,UE1DCDB,54,-3418.05,50,4,6825.65,3407.6
7063,UB1929F,54,-2500.25,52,2,4574.25,2074.0
7064,UBE7251,54,-2624.9,51,3,3390.7900000000004,765.89
7065,U92B8AD,54,-2120.2,51,3,2724.58,604.38
7066,U2B8AC3,54,-5491.82,44,10,14604.73,9112.91
7067,UE75BF3,54,-48.28000000000003,32,22,12245.05,12196.77
7068,U8053B2,54,42260.419999999984,39,15,384635.0,426895.42
7069,U44F78E,54,-44873.009999999995,43,11,147103.60999999996,102230.6
7070,U610501,54,-0.21000000000003638,46,8,22485.060000000005,22484.85
7071,U9F26FB,54,0.2300000000001532,51,3,5804.6,5804.83
7072,UF23BA3,54,46757.43,18,36,217110.8,263868.23
7073,UDB14F8,54,48467.91999999998,48,6,9507.199999999999,57975.119999999995
7074,U0BB160,54,14858.999999999936,47,7,720792.0199999999,735651.02
7075,UDCC633,54,45819.44,24,30,228715.24,274534.68
7076,UD2652C,54,-1025.9099999999999,52,2,9312.909999999998,8287.0
7077,UBE4C37,54,-2076.670000000002,27,27,169507.40000000002,167430.72999999998
7078,U9B7894,54,-0.5700000000018974,51,3,18945.63,18945.059999999998
7079,U77D9BF,54,39513.93999999998,39,15,10191.689999999997,49705.63
7080,U25E9CA,54,22895.989999999998,44,10,95368.95999999999,118264.95
7081,UCBB16E,54,-326.9499999999995,44,10,19161.27,18834.32
7082,UBBD270,54,28387.289999999986,30,24,247102.23999999996,275489.52999999997
7083,UAD4483,54,33.74000000000005,44,10,4066.810000000001,4100.549999999999
7084,U3E4F30,54,-715.8599999999998,50,4,3314.840000000001,2598.98
7085,UDD5ABC,54,157.34999999999968,49,5,10677.349999999999,10834.699999999999
7086,UC8EF7B,54,2321.329999999997,51,3,20329.699999999997,22651.03
7087,UBAFE61,54,130810.23000000001,29,25,271097.51,401907.74
7088,U0EB48C,54,133.63000000000056,42,12,17572.440000000002,17706.07
7089,U7E4A3A,54,-420690.0300000004,38,16,1005401.08,584711.05
7090,U386278,54,-327.26999999999975,42,12,4447.6900000000005,4120.42
7091,U50247C,54,4.190000000000117,45,9,2628.61,2632.8
7092,U4FEF91,54,3312.229999999999,24,30,7325.279999999998,10637.510000000002
7093,U26B87E,54,231.17999999999984,33,21,4056.87,4288.049999999999
7094,U6CEFEA,54,19578.670000000006,42,12,35596.69,55175.36
7095,UA2836C,54,59253.419999999984,35,19,189809.35999999993,249062.77999999997
7096,U9C58EA,54,25287.029999999988,41,13,53748.34,79035.37
7097,UFEA367,54,2125.8600000000006,38,16,91427.01000000001,93552.87
7098,U170892,54,6692.5,33,21,93705.88,100398.38
7099,U64B105,54,-3137.0300000000025,39,15,179159.68999999997,176022.65999999997
7100,UC0528C,54,891.3900000000008,42,12,12424.2,13315.589999999998
7101,UAEB5A4,54,-2193.2799999999997,28,26,9469.54,7276.26
7102,UDC42DE,54,566.9299999999996,43,11,10207.42,10774.349999999999
7103,U33D412,54,0.0,36,18,103610.0,103610.0
7104,UC19186,54,510.5399999999977,42,12,59658.33,60168.869999999995
7105,U47D4B7,54,-1396.7699999999988,49,5,24646.77,23250.0
7106,U8B4A4C,54,-1263.9299999999994,50,4,4711.27,3447.34
7107,U97C792,54,-86885.71,39,15,138099.87,51214.159999999996
7108,UF73F8C,54,21361.550000000007,43,11,82968.76999999999,104330.31999999999
7109,UF430E1,54,13599.490000000002,40,14,30121.17,43720.66
7110,U960933,54,-6295.82,46,8,72345.04000000001,66049.22
7111,U1CB31D,54,-1798.11,53,1,1799.5099999999998,1.4
7112,UE31DEF,54,1239.33,47,7,2794.76,4034.09
7113,U017C90,54,195.93000000000004,39,15,6326.45,6522.38
7114,U74E5A8,54,2443.3799999999987,43,11,16578.519999999997,19021.9
7115,U955481,53,7736.67,34,19,26400.55,34137.22
7116,U316C77,53,-2018.5099999999998,49,4,7898.37,5879.86
7117,U4372F2,53,28227.170000000006,29,24,168900.22,197127.38999999998
7118,U090233,53,759.2199999999871,40,13,71446.37,72205.59000000001
7119,UE505DD,53,-3306.2899999999895,41,12,132235.74000000002,128929.45
7120,U180091,53,0.529999999999518,41,12,6255.630000000001,6256.160000000001
7121,UD78A12,53,7067.570000000001,32,21,30538.9,37606.47
7122,UA9D5A0,53,-2026.6399999999994,44,9,21019.65,18993.010000000002
7123,UFBA701,53,-3313.6800000000003,40,13,63447.58,60133.9
7124,U02CDE9,53,59972.89000000002,43,10,50675.28999999999,110648.18
7125,U52280E,53,12885.799999999996,43,10,11650.409999999998,24536.21
7126,U1C9A4B,53,-1277.63,50,3,3889.310000000001,2611.6800000000003
7127,UF96796,53,-40127.36000000001,44,9,88382.39999999998,48255.04
7128,UE9335F,53,883.6000000000001,48,5,2499.5200000000004,3383.12
7129,U83FBEA,53,-135.1899999999997,43,10,31741.879999999997,31606.690000000002
7130,U5AC527,53,-60.67999999999907,46,7,11140.089999999997,11079.41
7131,U537B34,53,588.0400000000012,46,7,15656.89,16244.93
7132,UD4EE46,53,4301.0400000000045,29,24,80039.98000000001,84341.01999999999
7133,U07BCE5,53,746.1799999999997,49,4,7255.7,8001.88
7134,UA6D0A4,53,14049.509999999998,46,7,65055.400000000016,79104.91
7135,UFF57FA,53,-4854.85,43,10,16721.3,11866.45
7136,UC240C1,53,1985.1000000000004,30,23,18216.2,20201.3
7137,UFA8C4B,53,-1929.8299999999992,45,8,17859.75,15929.92
7138,UD64F19,53,-2101.87,50,3,3760.2200000000007,1658.35
7139,UE445D5,53,1132.0,0,53,0.0,1132.0
7140,U7C5EAE,53,-416.48999999999984,49,4,11354.98,10938.49
7141,UFABDAE,53,11297.8,40,13,3647.77,14945.57
7142,U61DCBA,53,1920.749999999999,33,20,26133.869999999995,28054.620000000003
7143,U0F795E,53,-526.3300000000004,49,4,6776.250000000002,6249.92
7144,UF5CE2E,53,-2471.0699999999997,49,4,7281.39,4810.320000000001
7145,U28AA51,53,-6958.539999999999,49,4,8287.419999999998,1328.8799999999999
7146,UBD30AE,53,41120.58,40,13,55412.590000000004,96533.17
7147,UE52254,53,-12630.239999999998,32,21,53408.84,40778.600000000006
7148,U04F033,53,-602.849999999999,30,23,44578.52,43975.67
7149,UA3EFFF,53,-268.47,32,21,613.9300000000001,345.46000000000004
7150,UAD3CA3,53,5010.519999999993,35,18,106033.47000000002,111043.98999999999
7151,U1AB84C,53,252.36000000000104,44,9,21437.08,21689.44
7152,U817BF4,53,-377.62000000000006,49,4,982.5899999999999,604.97
7153,U0033A7,53,-1830.08,49,4,2794.0,963.92
7154,U633252,53,-576.8099999999998,40,13,24519.739999999994,23942.930000000004
7155,UF7D695,53,-6832.520000000002,38,15,57476.41000000001,50643.89
7156,UC264D5,53,-1225.9400000000023,37,16,228617.5,227391.56
7157,UE4A15A,53,-8334.779999999999,51,2,13797.33,5462.55
7158,U040FB1,53,17512.260000000006,42,11,15980.539999999992,33492.8
7159,UDFE1A3,53,-6512.96,49,4,16818.959999999995,10306.0
7160,UEE2191,53,4434.780000000001,44,9,5952.58,10387.36
7161,UBA0513,53,-7012.400000000001,47,6,10929.5,3917.1
7162,U250C10,53,-0.09999999999973852,33,20,4828.91,4828.8099999999995
7163,U0F05CE,53,-23213.000000000004,27,26,473657.79000000004,450444.79000000004
7164,UF73DE9,53,-2224.0000000000005,41,12,28911.760000000002,26687.76
7165,U751854,53,2149.629999999996,32,21,35431.55000000002,37581.18
7166,UDDCE58,53,-114.72999999999979,27,26,34118.53,34003.8
7167,UE0DC4D,53,455.67000000000013,35,18,2234.0699999999997,2689.74
7168,UA1C0D0,53,759.8100000000004,36,17,5599.11,6358.92
7169,U1492B3,53,-14848.039999999994,51,2,38425.729999999996,23577.69
7170,U7A3B7F,53,-585383.3199999998,38,15,935729.46,350346.14
7171,UE88659,53,3309.8900000000003,45,8,23942.86,27252.75
7172,UC2C54C,53,-613.0900000000001,49,4,27226.59,26613.5
7173,U189995,53,2.9499999999993634,28,25,24470.82,24473.77
7174,U596D0F,53,721.6600000000003,47,6,14856.009999999998,15577.67
7175,U57A60B,53,-23370.000000000004,34,19,238103.77,214733.77000000002
7176,UBAE356,53,2896.69,26,27,12897.529999999999,15794.22
7177,U25A4E4,53,-2640.5600000000004,45,8,39848.67,37208.11
7178,U18CABD,53,-6179.6799999999985,46,7,27357.539999999997,21177.86
7179,U3AF902,53,-5453.48,51,2,5533.49,80.01
7180,UA4C0C0,53,-1191.7900000000004,50,3,7050.29,5858.5
7181,UC619B7,53,-13597.310000000001,41,12,44027.82,30430.510000000002
7182,UD7EE14,53,-712.9299999999985,47,6,17712.93,17000.0
7183,U8B9114,53,-2464.9100000000003,47,6,11379.51,8914.599999999999
7184,U93C8D7,53,3296.99,27,26,5754.0,9050.99
7185,UBB912A,53,21069.660000000003,35,18,352150.22000000003,373219.88
7186,UCB0322,53,4185.620000000001,39,14,98111.46999999999,102297.09000000001
7187,U185576,53,-137503.31999999995,33,20,470953.87999999995,333450.55999999994
7188,U4BD42E,53,-998.31,27,26,8662.42,7664.110000000001
7189,U094B98,53,-146.21000000000026,46,7,7663.26,7517.049999999999
7190,U9C3CCE,53,-1952.3200000000002,46,7,9120.699999999999,7168.38
7191,U695E34,53,-3065.31,43,10,15066.12,12000.81
7192,UCDC46C,53,1530.4300000000003,45,8,57837.96,59368.39
7193,UA5B83B,53,-252.3900000000001,48,5,8858.580000000002,8606.19
7194,UB34A2A,53,-10967.499999999998,40,13,40653.020000000004,29685.52
7195,U813671,53,-4758.39,47,6,14522.499999999998,9764.109999999999
7196,U94A706,53,-4203.9400000000005,49,4,8449.82,4245.88
7197,UFDA21E,53,15199.57,35,18,9596.93,24796.500000000004
7198,U344CDD,53,8056.179999999999,36,17,6939.55,14995.73
7199,U7FB31A,53,-11704.75,48,5,32729.749999999993,21025.0
7200,UEF500A,53,6429.610000000001,45,8,161490.71999999997,167920.33000000002
7201,UBEB714,53,-5011.320000000001,49,4,10048.52,5037.2
7202,U4A6A85,53,2011.1200000000013,48,5,13835.66,15846.78
7203,U110F6D,53,-47.069999999998345,51,2,8238.839999999998,8191.7699999999995
7204,U958B6F,53,-197.410000000001,50,3,8849.460000000001,8652.050000000001
7205,U3271DB,53,4953.840000000002,34,19,48918.76000000001,53872.6
7206,U3DCE68,53,-47816.91999999998,41,12,408954.4800000001,361137.56
7207,U45A5CB,53,207.9399999999996,43,10,11953.740000000002,12161.68
7208,U44A71E,53,1418.2000000000005,50,3,13881.099999999999,15299.3
7209,U79A146,53,4132.659999999996,20,33,61830.03,65962.69
7210,U486088,53,234.39000000000078,34,19,57511.58,57745.97
7211,U7B944B,53,12245.45,45,8,42337.55,54583.00000000001
7212,UDBD840,53,6052.2,29,24,12338.41,18390.61
7213,UECC60A,53,-2378.82,47,6,17308.8,14929.98
7214,UA6A848,53,-3114.5200000000004,42,11,4861.419999999999,1746.8999999999996
7215,U49B39F,53,-172.62999999999997,46,7,1202.67,1030.04
7216,U423B3C,53,-3302.9600000000005,51,2,12332.959999999997,9030.0
7217,U6D3261,53,369.02,43,10,4224.71,4593.73
7218,UE82438,53,-12.569999999999993,29,24,795.55,782.98
7219,UD0FC80,53,14187.890000000003,45,8,77383.81999999999,91571.70999999999
7220,U279B27,53,-148.65000000000003,49,4,3228.850000000001,3080.2
7221,UF20641,53,-10312.829999999994,29,24,118854.06999999999,108541.24
7222,U1D992D,53,489.5400000000001,49,4,12019.23,12508.769999999999
7223,U55E7EC,53,-3807.33,44,9,20653.63,16846.3
7224,UF60421,53,1865.4500000000007,43,10,13562.26,15427.71
7225,U18389D,53,-16669.039999999997,50,3,22677.52999999999,6008.49
7226,U663F28,53,5.510000000000218,28,25,90932.12,90937.63
7227,U4C6491,53,1771.6099999999997,46,7,15111.700000000003,16883.31
7228,UE3DA9C,53,67.21000000000004,29,24,8769.66,8836.87
7229,U93ADD6,53,57535.96999999998,49,4,7064.040000000001,64600.01
7230,U975E00,53,1622.4700000000012,47,6,13444.280000000002,15066.75
7231,UC8F70F,53,151.2199999999997,30,23,6316.160000000001,6467.38
7232,U824C23,52,-49.48000000000775,32,20,210326.45,210276.97000000003
7233,U6C3C73,52,1379.9099999999996,45,7,15417.759999999997,16797.67
7234,U82E1FB,52,102.52999999999957,42,10,31897.89,32000.42
7235,UD0F60F,52,-35986.560000000005,46,6,53904.020000000004,17917.46
7236,U21EDE1,52,-15152.339999999998,49,3,26706.350000000002,11554.01
7237,U491F5E,52,-599.0899999999995,38,14,6093.540000000001,5494.449999999999
7238,U41D8C6,52,141.15999999999974,49,3,4142.780000000001,4283.9400000000005
7239,U24CCC7,52,-382.1499999999919,27,25,172691.79,172309.63999999998
7240,UB79A41,52,-13202.119999999999,39,13,28279.300000000003,15077.18
7241,UB63BA0,52,-9765.349999999999,48,4,23218.7,13453.35
7242,UC73926,52,-31448.37000000002,28,24,315018.45,283570.07999999996
7243,UCFA450,52,2998.8699999999994,33,19,1525.6000000000001,4524.469999999999
7244,U4F6741,52,2092.8399999999983,41,11,24020.81,26113.649999999998
7245,UD26B62,52,-311.75999999999993,45,7,5053.3499999999985,4741.59
7246,U1E4035,52,-20.56999999999968,45,7,2663.1999999999994,2642.63
7247,UFF5628,52,-8981.759999999998,47,5,11179.51,2197.75
7248,UA0E608,52,-3620.03,49,3,9842.76,6222.73
7249,U15CB83,52,-818.9799999999977,40,12,26504.439999999995,25685.46
7250,U641E4C,52,-2019.3999999999967,42,10,56288.229999999996,54268.83
7251,UD9849B,52,2016.0499999999993,28,24,111082.18000000001,113098.22999999998
7252,UD1C08D,52,4831.549999999999,48,4,26403.45,31235.0
7253,U8583A7,52,-249.27999999999884,33,19,230564.08000000002,230314.8
7254,UAED628,52,24951.280000000013,42,10,177894.56999999998,202845.85
7255,UDFC6B4,52,-0.22999999999774445,32,20,93760.81,93760.58000000002
7256,U7AA868,52,202.53,32,20,4171.71,4374.239999999999
7257,U202000,52,-207.66999999999916,41,11,16948.469999999998,16740.8
7258,U224756,52,-1306.4100000000008,47,5,5297.580000000001,3991.1699999999996
7259,U4529F1,52,27260.480000000007,43,9,17089.34,44349.82000000001
7260,U4D68C6,52,2043.2299999999996,36,16,20383.56,22426.79
7261,U2A25F9,52,-25682.18,30,22,90198.77,64516.59
7262,U41A615,52,25240.629999999997,44,8,11165.6,36406.229999999996
7263,U1FB2C0,52,-9429.109999999997,41,11,95033.49999999999,85604.38999999998
7264,UA3C8A0,52,58102.58,31,21,207589.84,265692.42000000004
7265,U6F9CBB,52,38953.850000000006,41,11,198923.68999999997,237877.53999999998
7266,UE8D548,52,4221.560000000001,43,9,59389.69999999998,63611.26000000001
7267,U3A6BC0,52,458.4400000000051,36,16,37444.45,37902.89
7268,U8AC8E8,52,2674.680000000001,49,3,8475.55,11150.23
7269,UBD5514,52,10402.4,27,25,53083.6,63486.0
7270,U000101,52,-73.69000000000123,38,14,7902.430000000001,7828.740000000001
7271,U4D2CCB,52,-317.4100000000035,32,20,112160.57000000002,111843.16000000002
7272,U5678F7,52,1.0,26,26,2752.0,2753.0
7273,U335DBD,52,2440.6600000000103,43,9,175427.55999999997,177868.22000000003
7274,UD7E97A,52,2434.6600000000008,48,4,19964.19,22398.85
7275,U220B2E,52,-638.7099999999997,46,6,4677.389999999999,4038.68
7276,U8EEEDE,52,-2121.12,35,17,10712.949999999999,8591.830000000002
7277,U87BB6B,52,-225037.83000000005,31,21,323393.71,98355.88
7278,UAA83D2,52,-13474.650000000001,36,16,59434.02,45959.37
7279,U371635,52,6683.6900000000005,37,15,23614.519999999997,30298.21
7280,UE6C182,52,13699.529999999999,40,12,73472.79000000001,87172.32
7281,UE6D752,52,-7667.360000000001,51,1,8063.359999999999,396.0
7282,U239F2B,52,46779.20999999996,39,13,1384959.25,1431738.46
7283,U188C9E,52,405.0499999999995,44,8,17011.61,17416.659999999996
7284,U161319,52,2967.3999999999987,50,2,9932.6,12900.0
7285,UAF14C1,52,-1708.3899999999999,47,5,4732.57,3024.18
7286,UCDB367,52,23637.64,47,5,9551.359999999999,33189.0
7287,U77F791,52,-320.5199999999995,50,2,2865.5199999999995,2545.0
7288,U1703D4,52,-3855.34,42,10,34535.11,30679.769999999997
7289,U77B7C0,52,-1507.919999999986,25,27,717137.9600000001,715630.04
7290,U049C4E,52,-633.6500000000001,49,3,2386.550000000001,1752.9
7291,UE9F982,52,-589.5599999999997,37,15,5081.02,4491.46
7292,U141AF6,52,-11283.970000000003,46,6,25193.84,13909.869999999999
7293,U162833,52,-3315.7899999999986,38,14,79993.12,76677.33000000002
7294,U06C350,52,-449.5300000000016,32,20,27780.930000000004,27331.39999999999
7295,U7D68AB,52,-43.41000000000213,33,19,87163.03,87119.62000000002
7296,U8124C5,52,-14050.860000000002,43,9,35776.1,21725.239999999998
7297,U4BEBB6,52,-1252.9400000000003,41,11,3965.02,2712.08
7298,UB133F7,52,-5966.709999999997,50,2,17144.71,11178.0
7299,U19EA0F,52,-11643.680000000006,46,6,25927.860000000004,14284.18
7300,UE1A998,52,1343.8500000000008,45,7,7149.83,8493.68
7301,U89CC11,52,3010.0,24,28,1636808.1600000001,1639818.16
7302,UDD42A7,52,56.70000000000027,43,9,8328.23,8384.93
7303,UB4696E,52,226.55000000000044,43,9,2856.4800000000005,3083.0299999999997
7304,U6B4E23,52,-1244.15,38,14,2289.7100000000005,1045.56
7305,U682D98,52,-60.330000000000425,40,12,5945.91,5885.58
7306,UFE9034,52,-657.0300000000013,43,9,9767.919999999998,9110.89
7307,U16FB6B,52,-362.3100000000014,42,10,27388.69,27026.38
7308,UECE6B3,52,-986.6099999999999,48,4,21749.67,20763.06
7309,U2EAC9F,52,1266.5899999999997,46,6,5113.1900000000005,6379.78
7310,U752854,52,1573.0900000000001,44,8,18458.820000000003,20031.91
7311,U162FDB,52,6738.620000000001,40,12,14645.779999999999,21384.4
7312,U051BB1,52,13626.110000000011,35,17,162399.02,176025.13
7313,UE79145,52,30685.69,29,23,221063.57000000004,251749.26
7314,UFC1375,52,16850.26,36,16,147949.08,164799.34000000003
7315,U3DA84A,52,-0.4399999999986903,29,23,39438.64000000001,39438.2
7316,U195CFE,52,13811.210000000001,44,8,18496.809999999998,32308.02
7317,U4035D5,52,2292.7500000000005,41,11,4325.700000000001,6618.450000000001
7318,U22568B,52,-1902.159999999998,50,2,13918.0,12015.84
7319,UC967D5,52,427.8499999999993,45,7,6298.8099999999995,6726.66
7320,U255539,52,12.920000000000522,47,5,3571.96,3584.8799999999997
7321,U764BF5,52,1810.3299999999995,41,11,9902.43,11712.76
7322,UF29A9C,52,-1305.3400000000004,45,7,6895.749999999998,5590.41
7323,UE6C7B9,52,427.9700000000001,49,3,4684.230000000001,5112.2
7324,U6D1A85,52,-11.180000000000597,30,22,24731.22,24720.039999999994
7325,U55FE23,52,321.19000000000005,46,6,3809.5900000000006,4130.78
7326,U711579,52,476.81000000000057,44,8,26714.81,27191.62
7327,UEC0830,52,742.2599999999998,43,9,5252.959999999999,5995.22
7328,UCBE9AB,52,-14114.29,41,11,46707.14,32592.85
7329,U063DFE,52,-9.29999999999984,48,4,1277.6,1268.3000000000002
7330,U13FCBE,52,-907.6499999999996,30,22,79665.0,78757.35
7331,UA47A81,52,0.0,27,25,46232.31,46232.310000000005
7332,UE3DAF0,52,-68.07999999999974,49,3,7894.669999999997,7826.59
7333,U0B9F69,52,392.6100000000006,37,15,47244.5,47637.11
7334,U3C3118,52,1713.8500000000013,42,10,8524.21,10238.06
7335,U622BBC,52,-203.43000000000018,44,8,9541.15,9337.72
7336,U3C4874,52,-14014.490000000002,39,13,66430.65,52416.16
7337,UE3E050,52,91388.14,44,8,20334.510000000006,111722.65
7338,UB163D0,52,15632.639999999996,35,17,39052.880000000005,54685.52
7339,UFD070E,51,-1218.9899999999998,20,31,23988.15,22769.16
7340,U4AF93D,51,8518.56,44,7,4428.3,12946.859999999999
7341,UE144B0,51,8134.669999999998,26,25,202651.0,210785.66999999998
7342,UC5E949,51,1801.6200000000008,41,10,10384.539999999999,12186.160000000002
7343,U64B28A,51,3544.580000000002,44,7,24303.799999999992,27848.379999999997
7344,UFA03D5,51,40896.38999999999,43,8,67801.92,108698.31
7345,U282DCD,51,-9740.5,39,12,50120.49999999999,40380.0
7346,UB71B6F,51,-761.51,47,4,6679.729999999998,5918.22
7347,UF7C67D,51,-439.37999999999994,45,6,3076.5499999999997,2637.17
7348,U38BE0C,51,-751.3200000000004,49,2,7846.3600000000015,7095.04
7349,UBB0E41,51,867.529999999999,34,17,29259.360000000004,30126.89
7350,UE8F6F5,51,-2878.330000000001,33,18,13048.920000000002,10170.589999999997
7351,UB6DC77,51,-23453.49,48,3,23526.550000000003,73.06
7352,UC8F9D9,51,1810.5300000000002,37,14,11267.77,13078.300000000001
7353,UED599D,51,-15958.52999999999,32,19,190187.49,174228.96
7354,U5CDD70,51,-6971.029999999999,44,7,35706.75,28735.719999999998
7355,U1072CD,51,4713.839999999999,48,3,1370.21,6084.05
7356,U538A87,51,-2044.12,45,6,5115.279999999999,3071.16
7357,U1A7406,51,4207.299999999998,42,9,10828.8,15036.099999999999
7358,UB4EBF6,51,1267.7999999999997,49,2,5408.88,6676.68
7359,UA64EC3,51,13169.51000000001,41,10,47986.68,61156.19
7360,UBB816B,51,3142.5200000000004,42,9,27719.2,30861.72
7361,UE49A52,51,3625.770000000001,39,12,14209.58,17835.35
7362,U8C14AD,51,419.65000000000146,43,8,89381.0,89800.65
7363,U71E1C9,51,-67064.34999999998,47,4,71846.08999999998,4781.74
7364,UCF5AA3,51,-7445.609999999999,47,4,16298.69,8853.08
7365,U2347F1,51,-917.3700000000006,49,2,3997.4600000000005,3080.09
7366,U6BB950,51,1072.659999999998,39,12,4151.4000000000015,5224.06
7367,UE8B59B,51,-24777.369999999995,50,1,24808.529999999995,31.16
7368,U4C90FC,51,-846.3200000000002,45,6,4559.12,3712.7999999999997
7369,U5935E2,51,-179988.61,41,10,352957.4,172968.79
7370,U5C7374,51,-1036.7599999999989,32,19,17541.03,16504.27
7371,U0D77F2,51,1403.9800000000002,30,21,19628.34,21032.32
7372,U987EFA,51,3969.6299999999997,49,2,7604.370000000001,11574.0
7373,UF7F3FE,51,495.5100000000007,40,11,15933.5,16429.010000000002
7374,UF7D9D8,51,7.269999999552965,27,24,9528200.0,9528207.27
7375,U2B2617,51,-4000.65,37,14,22757.15,18756.5
7376,U06803E,51,907.0600000000004,48,3,19732.78,20639.84
7377,UDE209C,51,360.5300000000006,44,7,6198.66,6559.1900000000005
7378,U4B7EF0,51,-9646.540000000003,34,17,39158.0,29511.459999999995
7379,U7BA81B,51,-376.41999999999973,43,8,2776.24,2399.82
7380,U5C83CD,51,-247.1500000000051,26,25,137973.16999999998,137726.02
7381,UC26E34,51,-159.22999999999593,26,25,204834.88999999998,204675.66
7382,U3E9709,51,993.0799999999997,41,10,1200.1499999999999,2193.2299999999996
7383,U1E77E4,51,-291.7600000000002,40,11,30140.010000000002,29848.25
7384,U8372D8,51,15.84000000000307,37,14,21402.95,21418.79
7385,U1A301B,51,912.7899999999997,42,9,3426.05,4338.84
7386,U74F8CE,51,-845.8100000000001,49,2,4146.92,3301.1099999999997
7387,U5973B7,51,-24315.429999999997,31,20,97739.36,73423.93000000001
7388,UDD7B6F,51,1688.3300000000008,36,15,16162.42,17850.75
7389,U243B44,51,37149.65000000001,31,20,167647.50000000003,204797.15
7390,UC35A0F,51,-18622.149999999994,37,14,30651.629999999997,12029.480000000001
7391,U2679EF,51,-1530.090000000001,41,10,10339.830000000002,8809.74
7392,U6B6680,51,3438.749999999998,45,6,36914.36,40353.11
7393,U7D119F,51,-748.83,38,13,10576.05,9827.220000000001
7394,U12EBFD,51,-437.9100000000035,43,8,104543.86,104105.95
7395,U444F42,51,-7752.940000000001,48,3,7892.940000000001,140.0
7396,U8C0068,51,-2024.4099999999944,39,12,56975.29,54950.880000000005
7397,U9F3468,51,-613.4399999999999,47,4,6453.44,5840.0
7398,U49E11E,51,-34.23000000000013,41,10,3453.0700000000006,3418.8399999999997
7399,UAC5745,51,3116.660000000002,42,9,16152.090000000004,19268.75
7400,UC7C441,51,-11036.140000000001,49,2,13828.87,2792.73
7401,U256C53,51,1438.91,45,6,4945.82,6384.73
7402,UC2F9C7,51,1308.6199999999992,44,7,6680.41,7989.03
7403,UDA8092,51,4537.470000000001,31,20,28737.93,33275.4
7404,UB7FF88,51,-836.8900000000001,49,2,1837.4200000000005,1000.53
7405,U76245D,51,1690.83,43,8,4162.39,5853.22
7406,U8E8BF5,51,-964.1400000000003,46,5,13470.269999999999,12506.13
7407,U11F616,51,-10.0,49,2,98.0,88.0
7408,UF7F8E2,51,-28121.760000000002,39,12,131928.91999999998,103807.16
7409,U1CF778,51,-44064.8,42,9,118131.36,74066.56
7410,UAA50B6,51,-24843.579999999998,50,1,36033.58,11190.0
7411,U97B13E,51,-358.93,42,9,1644.5600000000002,1285.63
7412,U5F6ED9,51,-16.25999999999658,28,23,366808.36000000004,366792.10000000003
7413,U6FEBF1,51,-27.17999999999997,49,2,316.0,288.82
7414,UA26799,51,12550.000000000002,36,15,3787.480000000001,16337.48
7415,UCAEC38,51,-17745.44,42,9,33684.229999999996,15938.789999999999
7416,UACB8AB,51,2.01999999999947,25,26,8135.86,8137.879999999999
7417,U466028,51,-5994.579999999996,29,22,117022.44,111027.86
7418,U4D47FC,51,24657.420000000002,32,19,43902.03999999999,68559.45999999999
7419,U276F6D,51,-589.7300000000007,47,4,3376.83,2787.1
7420,UD98409,51,-8974.199999999999,44,7,13295.71,4321.51
7421,U63B210,51,-4959.699999999996,30,21,64785.560000000005,59825.86000000001
7422,U546988,51,-2721.04,41,10,28768.59,26047.55
7423,U16043D,51,-1624.299999999999,46,5,6187.97,4563.67
7424,UC567EA,51,-994.9200000000001,32,19,28773.730000000003,27778.809999999998
7425,UB258ED,51,-4313.07,46,5,25289.079999999998,20976.01
7426,U0416FF,51,-3409.59,49,2,4249.49,839.9
7427,U9B4FB7,51,-557.8000000000023,44,7,19530.279999999995,18972.48
7428,U49BA65,51,1892.2100000000034,22,29,101733.40000000001,103625.61
7429,U8C9925,51,-10665.96,37,14,86862.51,76196.55
7430,U693827,51,-1550.81,34,17,10651.48,9100.67
7431,U526B72,51,99.63000000000011,43,8,40143.0,40242.630000000005
7432,U865FDF,51,-2695.600000000013,36,15,87454.96,84759.36
7433,UD12E95,51,-11721.909999999996,31,20,161631.12,149909.21
7434,U9C7A5E,51,56965.83000000001,39,12,27240.029999999995,84205.86
7435,U18DE6A,51,4.0400000000000205,43,8,4075.51,4079.5499999999997
7436,UE9F0DE,51,-6120.619999999999,45,6,17263.62,11143.0
7437,U698214,51,-814.8699999999999,47,4,6045.1799999999985,5230.3099999999995
7438,U298A92,51,96.69000000000187,40,11,6246.999999999998,6343.69
7439,UA44DDF,51,-184.00000000000068,28,23,29429.819999999996,29245.82
7440,U8932E2,51,-27047.65,47,4,54511.85,27464.2
7441,UCC2057,51,-15874.150000000001,43,8,29058.540000000005,13184.39
7442,UEB70FE,51,2223.54,48,3,6146.239999999999,8369.78
7443,U0B3F10,51,-4675.179999999999,51,0,4675.179999999999,0.0
7444,UE1CA4E,51,-1112.62,44,7,3554.4200000000005,2441.7999999999997
7445,U371EB3,51,4519.790000000001,39,12,14045.42,18565.21
7446,U0D3320,51,-5307.250000000001,40,11,9272.8,3965.55
7447,U2CFF41,51,1383.6300000000003,46,5,7100.959999999999,8484.59
7448,UC44547,51,1347.64,48,3,2268.31,3615.95
7449,U98595F,51,1653.8699999999994,36,15,17664.29,19318.16
7450,U765ECA,51,2880.5099999999984,49,2,2404.8800000000015,5285.389999999999
7451,UB95038,51,-1706.2800000000004,43,8,5155.15,3448.87
7452,UFC35B9,51,2334.17,35,16,28925.02,31259.19000000001
7453,U57AEBB,51,-503.75,45,6,78000.75,77497.0
7454,UE8B1D4,51,4073.979999999996,42,9,21785.58,25859.559999999998
7455,U860250,51,387.28000000000014,32,19,28309.24,28696.520000000004
7456,U701EA9,51,0.7199999999993594,28,23,5528.579999999999,5529.299999999998
7457,U6FDD0C,51,100.0,23,28,74600.0,74700.0
7458,U8FDF9F,51,-180.53999999999797,41,10,12169.239999999996,11988.7
7459,U7FA648,51,709.4800000000105,44,7,162005.34999999998,162714.83000000002
7460,U3909D6,51,-22.01,50,1,50.010000000000005,28.0
7461,UEE4828,51,-577.59,50,1,577.7,0.11
7462,U0C988A,51,10980.999999999998,37,14,72734.33,83715.33
7463,U151824,51,50408.56,25,26,278944.44,329353.0
7464,UE38162,51,1649.6900000000005,28,23,37679.45,39329.14
7465,UD387BA,51,-4599.879999999999,37,14,38320.28,33720.4
7466,UFAEAE5,51,-2877.140000000001,29,22,19673.319999999996,16796.18
7467,U7A7275,51,-2035.9600000000019,26,25,249106.48,247070.52
7468,U26653A,51,-4950.0,22,29,67154.28,62204.28
7469,UBA0AC8,51,648.95,48,3,51.24999999999999,700.2
7470,UFAFB83,51,-6281.089999999999,50,1,6381.089999999999,100.0
7471,U2F446C,51,-3658.3499999999995,44,7,12602.3,8943.95
7472,UB59CE9,51,3150.4500000000103,45,6,84621.61,87772.05999999998
7473,U31B07C,51,-2991.33,51,0,2991.33,0.0
7474,U00BBA7,51,2320.2199999999984,43,8,23664.850000000002,25985.07
7475,U0A161B,51,-433.37000000000006,47,4,1975.9999999999998,1542.63
7476,U340342,51,333.0,29,22,159667.0,160000.0
7477,U726098,51,-679.02,38,13,2022.7,1343.6799999999998
7478,U5CF9CB,50,1904.520000000001,33,17,18327.649999999998,20232.170000000002
7479,UD93FD7,50,10835.500000000018,16,34,5026286.13,5037121.63
7480,UBCF077,50,280.8599999999997,44,6,7264.120000000001,7544.98
7481,U0EED60,50,1297.1100000000001,44,6,8955.4,10252.51
7482,U962F5B,50,27243.08,43,7,14758.919999999998,42002.0
7483,UBFE238,50,81.77999999999975,36,14,23941.36,24023.14
7484,U40FF95,50,310.52999999995376,32,18,345879.1500000001,346189.68
7485,UDB9BFB,50,-11864.589999999982,32,18,408041.77999999997,396177.19
7486,U27C3DA,50,1690.8700000000022,46,4,12093.9,13784.77
7487,UEB9084,50,-3243.3999999999987,45,5,20385.54,17142.14
7488,U72AADD,50,-1572.6599999999999,48,2,2986.66,1414.0
7489,U9C0132,50,-4579.65,28,22,58061.18,53481.530000000006
7490,U43624F,50,-513877.8200000001,23,27,916833.0099999999,402955.19
7491,U081E58,50,2271.4100000000003,35,15,11691.599999999999,13963.01
7492,U5CC6F5,50,-1331.8900000000012,29,21,99387.27,98055.37999999999
7493,U8CC757,50,-1755.9699999999998,41,9,7106.63,5350.66
7494,UA3B3EE,50,-2334.0099999999984,43,7,23933.769999999997,21599.76
7495,UD6828F,50,2264.35,44,6,2271.0,4535.35
7496,U0E4AD1,50,185069.88,24,26,226015.18,411085.06
7497,U3BFAC3,50,340.2800000000134,33,17,172880.93,173221.21
7498,U0EA2D4,50,1430.0800000000004,47,3,4946.279999999999,6376.36
7499,U8704AE,50,6346.840000000002,43,7,7370.639999999999,13717.48
7500,UF1AC26,50,65.6899999999986,33,17,19042.549999999996,19108.239999999998
7501,U22264E,50,-1101.43,41,9,10632.82,9531.39
7502,UE14346,50,-1051.3400000000006,36,14,18655.98,17604.64
7503,UDA5D4C,50,-8915.809999999998,49,1,15000.809999999996,6085.0
7504,U2186C3,50,-351.1899999999995,39,11,12635.91,12284.72
7505,U7A1786,50,-7071.980000000001,39,11,38501.48999999999,31429.51
7506,UC8B578,50,-3197.2599999999984,38,12,29960.620000000003,26763.359999999997
7507,UAC9360,50,-1259.68,47,3,5188.85,3929.17
7508,UD5C1E8,50,-2266.4000000000005,46,4,6966.460000000001,4700.0599999999995
7509,UB08D08,50,-348.5600000000052,46,4,12941.770000000006,12593.21
7510,UA4439B,50,1006.0,29,21,9173.0,10179.0
7511,UA9FB14,50,1380.1200000000026,46,4,45621.53,47001.65
7512,UD32BCE,50,7386.889999999999,39,11,23412.899999999998,30799.789999999997
7513,U89ACD7,50,665.7999999999993,42,8,70333.67,70999.47
7514,UF5F057,50,-7213.88,48,2,14228.079999999996,7014.2
7515,U604471,50,-5482.019999999999,28,22,39094.020000000004,33612.0
7516,UC45192,50,-26121.249999999996,40,10,26504.649999999998,383.4
7517,U00F4FC,50,-8152.720000000001,48,2,19871.789999999994,11719.07
7518,UC8EA36,50,-1210.05,40,10,2795.9500000000003,1585.9
7519,UF0ADDC,50,-0.5799999999944703,34,16,420699.8099999999,420699.23
7520,U6B993E,50,-48.96000000000049,39,11,16344.54,16295.58
7521,U8B301E,50,-9186.740000000002,41,9,31417.180000000004,22230.44
7522,U0E64EE,50,-1878.1400000000003,42,8,15097.09,13218.95
7523,UCBAFB4,50,-1496.44,40,10,3853.3000000000015,2356.8599999999997
7524,U26BD71,50,-34372.93,40,10,45323.69,10950.760000000002
7525,UDC85BA,50,-6003.68,44,6,16688.15,10684.47
7526,U41F691,50,-10341.349999999995,45,5,62682.710000000014,52341.36
7527,U609C82,50,68.03000000000003,42,8,9749.279999999999,9817.31
7528,UDE94A5,50,118.90000000000003,46,4,1073.2399999999998,1192.1399999999999
7529,UB29EF7,50,-1703.2500000000002,44,6,7919.76,6216.51
7530,U8A2FC4,50,-7.439999999999998,39,11,1000.0300000000001,992.5900000000001
7531,U851CF3,50,-1061.8399999999965,34,16,44120.270000000004,43058.43
7532,U3C93C6,50,31.670000000000073,46,4,6090.78,6122.449999999999
7533,U54D5D7,50,460.5799999999999,40,10,11746.57,12207.150000000001
7534,UED353D,50,0.0,31,19,30000.0,30000.0
7535,UEBBEF4,50,-189.31999999999996,46,4,2380.86,2191.54
7536,U0EFE3F,50,-13557.089999999997,39,11,589176.3,575619.21
7537,UCB76B6,50,-4999.990000000008,39,11,139861.7,134861.71
7538,U02C3BF,50,-112.06000000000007,48,2,1369.9100000000003,1257.85
7539,UA52C33,50,-10489.240000000002,36,14,26457.939999999995,15968.7
7540,UAC22D5,50,25011.84,32,18,44271.0,69282.84
7541,U5123C6,50,12728.349999999999,42,8,16865.480000000003,29593.83
7542,U3A4CCB,50,-1732.0900000000001,36,14,81183.35,79451.26000000001
7543,U21A11B,50,-21831.07,46,4,22475.15,644.08
7544,U235551,50,10578.169999999991,36,14,195897.75,206475.92
7545,U342005,50,1323.650000000003,33,17,42283.570000000014,43607.22
7546,UFFE71A,50,-10838.299999999996,46,4,71401.4,60563.1
7547,UFF8F73,50,-2229.1299999999983,41,9,16384.46,14155.330000000002
7548,U9AC320,50,87256.52999999997,43,7,60644.24,147900.77
7549,U60047F,50,-211.88999999999797,48,2,9254.769999999999,9042.880000000001
7550,U0DF9D2,50,108100.57999999999,42,8,29110.84,137211.41999999998
7551,U74DF78,50,16620.289999999986,17,33,308412.1,325032.39
7552,U470039,50,-1120.1699999999983,41,9,28920.309999999998,27800.14
7553,UEEC8B4,50,-20400.699999999997,25,25,376330.0,355929.3
7554,U5340B5,50,-1403.229999999996,35,15,248935.38000000003,247532.15000000002
7555,U90ADD2,50,-22276.98,49,1,22277.0,0.02
7556,U3DBEF3,50,-1851.0199999999986,48,2,15015.01,13163.99
7557,UACFF38,50,-76.98000000000141,47,3,16887.980000000003,16811.0
7558,U651881,50,-28045.139999999992,44,6,33910.459999999985,5865.320000000001
7559,U3C89CE,50,-52293.60999999999,34,16,1025041.49,972747.88
7560,UB001DF,50,-1362.6900000000005,42,8,10579.039999999999,9216.35
7561,U92C67F,50,8317.56,44,6,2032.22,10349.779999999999
7562,U10867B,50,-4886.749999999998,38,12,9154.019999999997,4267.269999999999
7563,U413209,50,-3606.8,44,6,9055.36,5448.560000000001
7564,UAFEF47,50,34623.45,40,10,8044.490000000001,42667.94
7565,U55962D,50,-307.83999999999924,33,17,13013.26,12705.42
7566,U1E61D7,50,-28693.81,50,0,28693.81,0.0
7567,U57D496,50,-769.0499999999995,42,8,7607.480000000001,6838.43
7568,UE7881E,50,2635.089999999999,34,16,8837.660000000002,11472.75
7569,UA928E1,50,5995.27,47,3,1414.73,7410.0
7570,U29E3AF,50,-11048.099999999999,34,16,37248.27000000002,26200.17
7571,U5200B1,50,-4348.529999999996,34,16,133289.64,128941.11
7572,U20BD6F,50,2302.8500000000004,29,21,18127.05,20429.9
7573,UBF7A61,50,-1760.3500000000006,46,4,4794.240000000002,3033.89
7574,U2EEDAB,50,13653.880000000001,38,12,7813.3,21467.18
7575,U440DDE,50,-1143.0499999999995,38,12,11628.489999999998,10485.44
7576,U151BDE,50,7847.670000000004,39,11,190142.35,197990.02000000002
7577,U488984,49,-6.650000000000318,29,20,43463.65,43457.0
7578,U87350B,49,17458.519999999993,37,12,24866.84000000001,42325.36000000001
7579,U0F8CC1,49,-2721.8199999999993,39,10,15905.630000000001,13183.810000000001
7580,U554FAC,49,1795.520000000002,44,5,243204.78999999992,245000.31
7581,U316776,49,-1813.5200000000007,27,22,4598.07,2784.55
7582,U329826,49,-291.4300000000003,36,13,71539.56,71248.13
7583,U7C3923,49,-6536.39,43,6,63200.93,56664.54
7584,UBE20B4,49,-10188.579999999998,29,20,355676.14,345487.56
7585,UB694C2,49,-9311.2,39,10,33526.829999999994,24215.629999999997
7586,UE58714,49,-444.5699999999998,42,7,1940.5599999999997,1495.99
7587,UE27BF3,49,-4734.0999999999985,40,9,55451.62,50717.52
7588,U8540C8,49,-55.06999999999982,38,11,5922.900000000001,5867.83
7589,U283334,49,-1300.3700000000008,40,9,11040.51,9740.14
7590,UC9324A,49,-1116.3300000000054,23,26,332561.1599999999,331444.82999999996
7591,UCC84AD,49,-3738.0400000000004,40,9,5672.279999999999,1934.24
7592,U23692A,49,17925.75999999995,15,34,1879306.61,1897232.37
7593,U29FD56,49,16542.010000000002,44,5,15094.680000000002,31636.690000000002
7594,UD8E50C,49,-12997.62,45,4,27997.779999999995,15000.16
7595,UF30F2B,49,-3651.980000000003,39,10,13504.65,9852.67
7596,U36F619,49,-14032.900000000001,33,16,70701.25000000001,56668.35
7597,U3F0604,49,-1283.7999999999995,47,2,7956.969999999998,6673.17
7598,U9218D1,49,2207.8599999999997,31,18,8008.5,10216.36
7599,U9F538F,49,-4652.229999999996,45,4,24539.64,19887.410000000003
7600,U632A95,49,-2302.37,37,12,13848.569999999996,11546.2
7601,UAA9CC5,49,-7864.23,42,7,15162.930000000004,7298.700000000001
7602,U707D9F,49,-85.51000000000013,39,10,7421.070000000001,7335.5599999999995
7603,U7A990D,49,-1202.6099999999992,43,6,10388.449999999999,9185.84
7604,U5B5014,49,-3181.680000000005,37,12,15289.56,12107.880000000001
7605,U70B80B,49,-37788.45,45,4,51913.02,14124.57
7606,U0001B8,49,1694.9899999999996,34,15,8840.98,10535.97
7607,UF6311D,49,44005.380000000005,46,3,4525.52,48530.9
7608,U389A76,49,87067.83999999998,25,24,158713.13,245780.97
7609,UA4060B,49,-5351.89,41,8,17246.579999999998,11894.69
7610,UE56334,49,19.909999999999968,31,18,14040.1,14060.01
7611,UCF7E11,49,-299877.4099999999,25,24,1486567.96,1186690.5499999998
7612,U7F11BA,49,-104.62000000000054,45,4,3396.67,3292.0499999999997
7613,U549D8B,49,41340.77000000001,40,9,18095.199999999997,59435.969999999994
7614,U89A43A,49,-23328.859999999993,37,12,88728.31,65399.45
7615,UD49A31,49,-13336.380000000003,31,18,242023.61000000002,228687.23
7616,U651B3F,49,-238471.63999999998,18,31,510663.1,272191.46
7617,U990ADB,49,37947.07,40,9,51380.27000000002,89327.34
7618,U5CCACE,49,-1554.7900000000004,45,4,3476.0800000000004,1921.2899999999997
7619,UEF2755,49,85.74000000000001,41,8,5995.2300000000005,6080.97
7620,U5700BD,49,-4264.359999999999,47,2,8404.36,4140.0
7621,U9080DA,49,30980.07,39,10,25170.0,56150.07
7622,U70DAAA,49,-372.36999999999983,44,5,1472.51,1100.14
7623,UB8F31A,49,-7770.619999999999,36,13,16515.62,8745.0
7624,U9C9B8C,49,3277.2099999999996,41,8,4775.82,8053.03
7625,UDFF622,49,-395.72000000000116,39,10,33072.0,32676.28
7626,U0690E0,49,-758.7900000000001,46,3,3498.1000000000004,2739.31
7627,U523362,49,257.79999999999427,34,15,116661.1,116918.9
7628,U1C185B,49,-2374.3100000000004,38,11,32207.03,29832.719999999998
7629,UE63B7F,49,-19673.549999999996,26,23,40934.13,21260.58
7630,UB9F9AC,49,-2504.85,45,4,4888.960000000001,2384.11
7631,U575C56,49,-205.49999999999983,43,6,4770.379999999999,4564.88
7632,U6976B4,49,4146.580000000004,46,3,64846.41999999999,68993.0
7633,UE7EB6B,49,-195.28000000000011,36,13,5547.38,5352.1
7634,U1731B9,49,7178.180000000002,33,16,28080.79,35258.97
7635,U83E479,49,14.519999999999982,42,7,15497.72,15512.239999999998
7636,U4DE871,49,810.0299999999975,19,30,120726.91,121536.94
7637,U6363F7,49,188625.82000000007,27,22,154270.12999999995,342895.94999999995
7638,U1EFF2D,49,1233.8199999999997,27,22,34036.18,35270.0
7639,U0D1D5A,49,5022.739999999997,28,21,55949.86,60972.600000000006
7640,UE00C96,49,5581.95,32,17,11853.65,17435.6
7641,U5827C5,49,-378.67000000000553,36,13,137023.86,136645.19
7642,UFBA517,49,-7762.61,38,11,36077.0,28314.39
7643,UEEAED7,49,-1236.769999999999,39,10,18354.910000000003,17118.14
7644,UF113C7,49,-37.03999999999851,42,7,21897.670000000002,21860.63
7645,U2D4592,49,9069.380000000001,40,9,14873.369999999999,23942.75
7646,UD9074A,49,-56.600000000000364,25,24,22055.6,21999.0
7647,UF27646,49,-1267.5899999999997,41,8,11122.62,9855.03
7648,UEE0F3A,49,-3983.69,36,13,10961.969999999996,6978.279999999999
7649,UFBC5DE,49,-2255.13,41,8,12204.230000000003,9949.1
7650,U1495FB,49,8389.779999999999,26,23,57572.40999999999,65962.19
7651,UADE6A7,49,-127620.18,44,5,135626.33,8006.15
7652,UA24E2A,49,-197.10999999999876,39,10,30565.82,30368.71
7653,UDCC760,49,262.36999999999944,37,12,10564.73,10827.1
7654,U703EFC,49,5600.34,45,4,4867.08,10467.42
7655,UBA5A54,49,446.10000000000014,35,14,1601.4799999999998,2047.5799999999997
7656,UB448E0,49,-1327.5999999999995,46,3,22426.309999999998,21098.71
7657,U588E02,49,-5323.670000000001,45,4,14765.15,9441.48
7658,UB9E706,49,-1851.390000000002,46,3,10203.130000000001,8351.74
7659,UEB4012,49,-639.6900000000023,26,23,252078.36,251438.66999999998
7660,UB3507B,49,111193.82,29,20,27434.350000000002,138628.16999999998
7661,UEAAD96,49,21338.47,38,11,33001.7,54340.17
7662,U9E2BFA,49,-3474.4699999999993,42,7,5887.47,2413.0
7663,U454153,49,-23564.150000000005,44,5,28887.960000000006,5323.8099999999995
7664,U3B8B5B,49,-79.41999999999962,38,11,24475.58,24396.16
7665,UFF6FA8,49,-854.3299999999995,41,8,22454.93,21600.6
7666,U3750B0,49,-1202.9199999999987,39,10,38421.920000000006,37219.0
7667,U8D1FAE,49,51263.53,42,7,4782.21,56045.74
7668,UB3AC35,49,665.8100000000044,25,24,49181.69,49847.49999999999
7669,U0856CF,49,-1021.6000000000015,40,9,45131.76,44110.159999999996
7670,U3D3568,49,-2918.690000000001,47,2,2929.730000000001,11.04
7671,U17800B,49,-2914.0099999999998,44,5,7361.589999999999,4447.58
7672,U2925FD,49,-1054.0,34,15,95304.0,94250.0
7673,UB33BB9,49,-1470.4599999999994,46,3,10720.029999999999,9249.57
7674,UCB3CC6,49,3302.95,44,5,6376.9400000000005,9679.89
7675,UD90A04,49,-49276.240000000005,35,14,154249.95,104973.71
7676,U01B089,49,350.73999999999927,43,6,12677.760000000002,13028.5
7677,UBE34D8,49,-6503.029999999995,37,12,95898.40000000001,89395.37
7678,U489C2D,49,299.1799999999995,47,2,3864.9299999999994,4164.11
7679,U42EDFD,49,598.5499999999975,42,7,71481.59999999998,72080.15
7680,UAF9B8C,49,-213.1200000000001,30,19,5002.3099999999995,4789.19
7681,UEAFA47,49,101005.51999999999,43,6,103912.48,204918.0
7682,U35215D,49,17402.469999999998,38,11,39703.48,57105.950000000004
7683,UFC1DD9,49,-7134.019999999994,32,17,54438.22,47304.2
7684,UEF9EB9,49,1063.87,30,19,11537.22,12601.09
7685,UAC4EA0,49,-13706.029999999999,43,6,28039.090000000004,14333.060000000001
7686,UE30B70,49,-5333.25,49,0,5333.25,0.0
7687,U31F9EE,49,17264.34,35,14,45365.08,62629.42
7688,UFBF96B,48,-295.4600000000104,29,19,160408.11,160112.65000000002
7689,UFB14CA,48,-276.6300000000001,45,3,2240.5000000000005,1963.87
7690,UBA3276,48,3155.1900000000023,46,2,20734.47,23889.660000000003
7691,U8E3A1C,48,-98688.43000000001,27,21,204274.00999999998,105585.57999999999
7692,U2E53C7,48,4579.639999999999,41,7,2194.9400000000005,6774.58
7693,U8DC5C0,48,-3004.490000000001,37,11,39341.909999999996,36337.42
7694,U334B7C,48,-324.29999999999995,46,2,1335.0,1010.7
7695,UBB36B1,48,740.4100000000025,41,7,17334.850000000002,18075.260000000002
7696,U32A48D,48,1.453948073049105e-12,43,5,5877.26,5877.26
7697,UD6987F,48,1856.8299999999986,41,7,8015.869999999998,9872.699999999999
7698,U37CB2D,48,2785.6199999999994,33,15,4341.79,7127.410000000001
7699,UFED93D,48,-264129.38,45,3,296094.16,31964.78
7700,U1A032F,48,-3659.129999999999,41,7,15207.62,11548.490000000002
7701,U483F64,48,-59145.700000000004,46,2,64023.16000000001,4877.46
7702,UBE530D,48,327.18000000000166,34,14,44675.0,45002.18
7703,U5699C1,48,21196.53,42,6,97228.8,118425.33
7704,UA6494B,48,-381.75,46,2,744.29,362.54
7705,UFE0FA3,48,-7.119999999999891,44,4,3157.1900000000005,3150.0699999999997
7706,UF37093,48,-112.86000000000004,42,6,1063.6399999999999,950.7800000000001
7707,UF94649,48,-2608.8100000000004,33,15,21338.38000000001,18729.57
7708,UA9ACEF,48,2298.51,40,8,18812.14,21110.649999999998
7709,U0BE345,48,1.3800000000001091,44,4,10827.77,10829.15
7710,U3F6336,48,4531.269999999997,43,5,41151.729999999996,45683.0
7711,U67C6EC,48,-16315.78,44,4,30219.36,13903.58
7712,UED3FA5,48,-13574.940000000002,31,17,122300.99,108726.05000000002
7713,U5F3C16,48,-378.19999999999993,43,5,1683.5800000000002,1305.38
7714,U410D7A,48,100.72999999999956,21,27,76490.0,76590.73000000001
7715,U2EDA88,48,-4343.859999999999,43,5,18219.57,13875.71
7716,UEDF644,48,-15704.63,45,3,44465.34,28760.71
7717,U682EA8,48,-903.0400000000005,44,4,4828.4800000000005,3925.44
7718,U7F0BFA,48,7679.91,34,14,113114.59,120794.5
7719,U5E5CBA,48,-45149.11,28,20,158062.94,112913.83
7720,UEABFA7,48,-14.7199999999998,32,16,12959.31,12944.589999999998
7721,U68A3EF,48,-385.05999999999995,40,8,1525.04,1139.98
7722,U65E6BE,48,30655.709999999995,27,21,66230.93000000001,96886.64000000001
7723,U5F5DBD,48,1150.6099999999997,46,2,5605.65,6756.26
7724,U4D9C40,48,-5877.679999999986,20,28,1028429.5000000001,1022551.8200000001
7725,U603CAE,48,0.9700000000002547,39,9,30199.03,30200.0
7726,U4092CA,48,-2869.630000000001,27,21,29715.039999999997,26845.41
7727,UEA3AC9,48,-7.270000000000437,37,11,10896.01,10888.74
7728,U5350A5,48,42067.46000000001,27,21,299558.61,341626.07
7729,U569589,48,-224.18,43,5,1856.81,1632.63
7730,UF2DFCE,48,-1028.79,46,2,2102.0899999999997,1073.3
7731,UFF9A61,48,-25021.530000000006,43,5,33239.98000000001,8218.449999999999
7732,U930682,48,-40239.200000000004,41,7,70686.23,30447.03
7733,U2E7A5D,48,-3981.3100000000004,43,5,6281.310000000001,2300.0
7734,UD87827,48,6448.669999999998,38,10,28240.14,34688.810000000005
7735,UDDE8CD,48,1.3677947663381929e-13,40,8,4794.040000000001,4794.04
7736,UCCDA53,48,10440.830000000002,38,10,28847.800000000003,39288.63
7737,U2FA3DC,48,511.18000000000393,36,12,123834.66,124345.84
7738,UCC6FFE,48,-9769.569999999998,37,11,69105.68000000001,59336.11
7739,U7622B9,48,-2426.750000000002,45,3,14026.75,11600.0
7740,UD5D8C0,48,-1.3800000000002228,31,17,23693.43,23692.050000000003
7741,U2954E8,48,-167.13000000000068,37,11,10712.619999999999,10545.489999999998
7742,U20B271,48,1772.2300000000007,45,3,12024.330000000002,13796.56
7743,U4BE3C8,48,-12878.780000000002,36,12,38205.78,25327.0
7744,UC6E29D,48,-2684.5599999999927,29,19,197270.91999999998,194586.36000000002
7745,U8D9C37,48,-13493.56,42,6,18258.590000000004,4765.030000000001
7746,U21EFE8,48,1739.2900000000004,44,4,13260.71,15000.0
7747,UCEE3D3,48,-1692.1100000000004,42,6,3503.89,1811.78
7748,UC8F442,48,-984.4399999999994,42,6,6630.189999999999,5645.75
7749,UA03C4D,48,637.8399999999992,40,8,17275.9,17913.739999999998
7750,U1A966B,48,-89.04999999999997,41,7,3941.51,3852.46
7751,UC84989,48,274.0,29,19,91736.0,92010.0
7752,U371230,48,-3739.93,38,10,6909.609999999999,3169.68
7753,UBA16F1,48,1032.8199999999993,43,5,4845.700000000001,5878.5199999999995
7754,UE46E2C,48,17237.850000000017,42,6,23612.74999999999,40850.6
7755,UA7478A,48,955.2599999999954,36,12,56733.88000000001,57689.14
7756,U62E1A8,48,4485.310000000008,29,19,318213.59,322698.89999999997
7757,U401722,48,34228.079999999994,39,9,68098.06,102326.14
7758,U0C220B,48,-17393.199999999997,35,13,30116.109999999997,12722.910000000002
7759,U43D0B4,48,1444.9400000000005,44,4,4652.499999999999,6097.4400000000005
7760,U82F986,48,-5445.140000000001,45,3,27966.14,22521.0
7761,UE1BDDB,48,-17660.17999999999,41,7,34381.41999999999,16721.239999999998
7762,U6845C0,48,353.98999999999955,34,14,7727.29,8081.280000000001
7763,UF4EED0,48,-361478.96,25,23,545097.0499999999,183618.09
7764,U79D18E,48,-117380.07999999999,40,8,125544.47,8164.389999999999
7765,UE62868,48,3149.079999999999,29,19,86956.81999999999,90105.9
7766,UDE9318,48,289.7700000000016,28,20,26179.87,26469.639999999996
7767,UFA2DF2,48,1405.4800000000007,46,2,576.4100000000002,1981.89
7768,U744378,48,26020.949999999924,22,26,660563.04,686583.9900000001
7769,UC5C24B,48,-1626.890000000001,39,9,20006.29,18379.4
7770,UC8F916,48,129.9000000000001,46,2,916.2499999999999,1046.15
7771,UD951A9,48,40483.630000000005,29,19,20755.46,61239.090000000004
7772,U8CF7D7,48,32351.180000000008,40,8,21333.12,53684.3
7773,U132918,48,2.700000000000074,36,12,1632.31,1635.01
7774,UF4A2A3,48,1034.8500000000004,43,5,3695.100000000001,4729.950000000001
7775,U09DA59,48,-380.3299999999998,40,8,4215.88,3835.55
7776,UC2D428,48,614.3500000000001,24,24,14069.019999999999,14683.37
7777,UFBC4B8,48,57.00999999999999,41,7,1152.55,1209.56
7778,U68DAD2,48,58017.03,40,8,2511.45,60528.48
7779,UB50E62,48,184.87999999999977,45,3,6598.81,6783.6900000000005
7780,UCFEE0F,48,-422.5999999999956,43,5,77444.59999999998,77022.0
7781,U4C3A2D,48,2823.1700000000005,40,8,16493.510000000002,19316.68
7782,U69262B,48,-5384.940000000011,25,23,265548.24,260163.3
7783,U7FE4C4,48,-3066.11,44,4,13993.130000000003,10927.02
7784,U58D814,48,-110.97000000000003,45,3,6638.65,6527.679999999999
7785,UD8B9B4,48,-164.01000000000005,43,5,1182.53,1018.52
7786,UF83829,48,-3751.8600000000006,41,7,19445.590000000004,15693.73
7787,U677354,48,-1148.1800000000003,45,3,4148.679999999999,3000.5
7788,U543A23,48,4268.059999999998,43,5,20156.08,24424.14
7789,UD59F9D,48,-9970.809999999907,45,3,1710104.02,1700133.21
7790,U3A7B86,48,2715.26,42,6,20189.0,22904.260000000002
7791,UC1F283,48,9723.3,20,28,17901.449999999997,27624.75
7792,UF04299,48,5188.6,34,14,117351.27,122539.87000000001
7793,U49C0B5,48,-193.9100000000035,37,11,81943.58,81749.67
7794,U3A1441,48,-2751.11,42,6,9240.12,6489.01
7795,U50A238,48,-1546.9100000000008,38,10,14548.18,13001.27
7796,UFD2BD9,48,27330.79,38,10,64275.21,91606.0
7797,U43FC63,48,-150.30999999999926,28,20,18654.589999999993,18504.280000000002
7798,UB631B4,48,-194.4200000000062,33,15,74604.76,74410.34000000001
7799,U29C53D,48,-295.5499999999999,41,7,1739.8999999999999,1444.35
7800,UC76A9A,48,14104.160000000003,36,12,64219.229999999996,78323.39
7801,UAD7694,48,-1806.24,42,6,6497.549999999999,4691.31
7802,U16CCC2,48,-904.7000000000003,38,10,5421.030000000001,4516.33
7803,UED457A,48,-4331.33,38,10,53662.490000000005,49331.16
7804,UC70E6D,48,34.5799999999972,37,11,52422.71,52457.29
7805,UA94113,48,163.0,29,19,122050.0,122213.0
7806,UC230CE,48,-24533.17,42,6,48065.91,23532.739999999998
7807,U2B04AA,48,-1372.75,43,5,5478.549999999999,4105.8
7808,UC82CE2,48,-21289.489999999998,43,5,65539.5,44250.01
7809,U92DF51,48,40204.67,41,7,7975.3,48179.97
7810,UD5306A,48,-81.93999999999943,31,17,8657.800000000001,8575.86
7811,UF9E844,48,-13950.47,35,13,38070.07000000001,24119.600000000002
7812,UF27B43,48,-31849.43000000001,31,17,69569.43000000001,37720.0
7813,UF95699,48,20330.72,24,24,34203.36,54534.08
7814,U3BDEE8,47,-1338.5400000000009,39,8,3433.44,2094.9
7815,U7E5C55,47,34533.48000000001,37,10,54345.140000000014,88878.62
7816,U86937D,47,-474.91000000000014,44,3,6059.999999999999,5585.09
7817,UCE9CB9,47,12785.069999999994,42,5,72814.93,85600.0
7818,U67CFD6,47,1366.3500000000001,35,12,2629.68,3996.0299999999997
7819,U4150B0,47,16963.66000000001,18,29,198803.08000000002,215766.74000000002
7820,U83D4C9,47,2577.3900000000003,43,4,3800.24,6377.63
7821,UD226C7,47,5957.96,42,5,10306.940000000002,16264.9
7822,UBD0BCD,47,3389.4500000000003,42,5,11243.250000000002,14632.699999999999
7823,UDB7431,47,-41384.579999999994,38,9,78901.92000000001,37517.34
7824,UB0C5DB,47,-251.5600000000004,45,2,12070.250000000002,11818.69
7825,U1EC2CD,47,-8262.67,46,1,12959.82,4697.15
7826,U4A4A11,47,2348.2699999999986,31,16,38867.73999999999,41216.009999999995
7827,U82E0C3,47,6852.0199999999995,39,8,7297.9,14149.92
7828,U076F30,47,-6659.039999999999,44,3,7631.849999999999,972.8100000000001
7829,UDB28F8,47,-29263.53999999999,41,6,159822.77000000002,130559.23000000001
7830,U441C06,47,-30089.519999999997,37,10,138085.26,107995.74000000002
7831,U5368B0,47,-2829.3800000000006,42,5,11056.359999999999,8226.98
7832,U86F532,47,-44497.26,32,15,48906.3,4409.04
7833,UEBA013,47,388.090000000001,35,12,6542.43,6930.5199999999995
7834,U78CA0D,47,-1975.7599999999995,43,4,2199.9199999999996,224.16000000000003
7835,UF2DAE4,47,-4993.81,41,6,6191.54,1197.73
7836,U90763F,47,-52.87999999999977,40,7,7292.290000000001,7239.41
7837,UDE8D3D,47,10370.599999999977,27,20,579193.73,589564.33
7838,U143FC9,47,5250.449999999999,45,2,8429.58,13680.029999999999
7839,UDC2446,47,8876.670000000002,33,14,63680.8,72557.46999999999
7840,UF1567B,47,-726.5499999999986,24,23,10687.3,9960.750000000002
7841,U5A1116,47,-702.4700000000001,28,19,1947.2699999999998,1244.7999999999997
7842,U510EFE,47,-309.24,37,10,11919.86,11610.62
7843,U42B24C,47,8193.220000000001,26,21,40960.42,49153.63999999999
7844,U59135F,47,535.0699999999997,37,10,3980.2300000000005,4515.299999999999
7845,U0D1782,47,-543.3299999999999,29,18,12725.449999999997,12182.119999999999
7846,UC81038,47,-2314.5099999999998,40,7,9192.509999999997,6878.0
7847,UDCD248,47,327.47,40,7,2376.1300000000006,2703.6000000000004
7848,U7078BE,47,-1956.8400000000056,37,10,53690.859999999986,51734.02
7849,U89EF05,47,34734.83999999999,38,9,46749.48,81484.32
7850,UDA9D3D,47,8.659999999999457,45,2,4617.79,4626.45
7851,U157E16,47,33316.4,43,4,9900.0,43216.4
7852,UF9D97F,47,3833.9800000000096,39,8,108025.13,111859.11
7853,U33A855,47,55.94999999999908,40,7,5062.039999999999,5117.99
7854,UBB9766,47,-6532.869999999999,44,3,9026.539999999999,2493.67
7855,U5F8347,47,-1237.2499999999998,33,14,4056.4900000000002,2819.24
7856,U8F5175,47,-0.6699999999998454,26,21,3892.0399999999995,3891.3700000000003
7857,UE13937,47,-3924.840000000001,43,4,9895.619999999999,5970.780000000001
7858,U9B0411,47,2081.7900000000004,38,9,24079.21,26161.0
7859,UB3C058,47,-1725.900000000001,38,9,24729.85,23003.95
7860,U99562A,47,16508.61,42,5,9309.730000000001,25818.34
7861,UCEA95B,47,2434.9800000000014,41,6,19949.1,22384.08
7862,UE60BEB,47,-122633.82,32,15,443703.67000000004,321069.85000000003
7863,U16903F,47,-11.80000000000291,27,20,98063.8,98052.0
7864,UEC5C8C,47,-63298.369999999995,27,20,306866.85000000003,243568.47999999998
7865,U7F7169,47,-355.28000000000077,41,6,8444.43,8089.150000000001
7866,U3CC992,47,3562.750000000002,34,13,18997.91,22560.660000000003
7867,U08F53E,47,1914.0399999999968,31,16,39744.68,41658.72
7868,U7FE111,47,1777.0600000000004,35,12,5421.540000000001,7198.5999999999985
7869,U420C73,47,-1887.6700000000003,35,12,5497.540000000001,3609.87
7870,UAD7217,47,-7808.029999999992,34,13,81005.78000000003,73197.75
7871,UDEFC51,47,-321.93999999999994,35,12,4997.250000000001,4675.3099999999995
7872,U7940AE,47,-759.3599999999997,30,17,9618.59,8859.23
7873,U681310,47,4019.68,41,6,8881.729999999998,12901.41
7874,U72D598,47,-6826.96,41,6,9044.289999999999,2217.33
7875,U5DA731,47,8600.690000000008,40,7,1054.8399999999997,9655.53
7876,U324058,47,-1601.7,39,8,17406.459999999995,15804.759999999998
7877,U7CAC96,47,-563.0999999999999,43,4,3806.2100000000005,3243.11
7878,U1E6B80,47,-244.26,43,4,1089.98,845.7199999999999
7879,UD6978B,47,-5116.52,42,5,14174.880000000001,9058.36
7880,U6C2CD4,47,466.80000000000007,45,2,2904.2,3371.0
7881,UE370A7,47,1959.78,34,13,6699.37,8659.15
7882,UB1A7B5,47,1308.9199999999987,36,11,14655.67,15964.590000000002
7883,U58D558,47,667.0999999999999,43,4,4107.799999999999,4774.9
7884,U821A54,47,2960.2799999999997,27,20,29783.54,32743.819999999996
7885,U09659B,47,-667.4200000000001,44,3,3839.4199999999996,3172.0
7886,U76A691,47,-4377.630000000001,42,5,12934.230000000001,8556.6
7887,UE8A878,47,-3000.0,30,17,66000.0,63000.0
7888,U18B110,47,3461.010000000001,40,7,22066.689999999995,25527.7
7889,UD5EC03,47,-6499.65,44,3,10099.669999999996,3600.02
7890,U0D6747,47,1127.3100000000024,20,27,29233.789999999997,30361.1
7891,U396DF3,47,430.07000000000005,43,4,1192.9299999999996,1623.0
7892,UAF73D2,47,4502.110000000001,21,26,31385.47,35887.58
7893,UF79FFD,47,-6716.530000000001,36,11,49923.22,43206.69
7894,U2BE85C,47,2967.6600000000008,30,17,105460.04000000002,108427.7
7895,U385FD3,47,-3459.9900000000007,34,13,9983.68,6523.690000000003
7896,U43DBB4,47,1351.6800000000007,37,10,4321.820000000001,5673.499999999999
7897,U56AC12,47,-1173.1800000000003,40,7,8939.140000000003,7765.96
7898,U543BBD,47,-6827.759999999998,35,12,76427.76000000001,69600.0
7899,U9A0C9F,47,-3530.399999999999,31,16,28270.409999999996,24740.010000000002
7900,U7B7CBE,47,-567.4199999999983,27,20,53589.0,53021.58
7901,U4B693D,47,-270.77,41,6,1704.68,1433.91
7902,U4622ED,47,-289364.77,39,8,298885.66000000003,9520.89
7903,U553DDF,47,8051.259999999998,41,6,8648.11,16699.37
7904,U2BB5B1,47,-257.41999999999996,39,8,2180.4500000000007,1923.0300000000002
7905,UCE3286,47,-31036.78,33,14,56346.93,25310.15
7906,U76E3B6,47,-963.5799999999995,32,15,14633.94,13670.36
7907,UA37FD4,47,-4530.13,27,20,89405.02000000002,84874.89
7908,UA9E837,47,-820.9899999999999,42,5,4415.85,3594.86
7909,UDFA6CA,47,-2895.6300000000033,34,13,70833.26999999999,67937.64
7910,U869761,47,215.15999999999892,38,9,17766.3,17981.46
7911,UE7C572,47,-3.1900000000023283,31,16,411626.47000000003,411623.28
7912,U0652B6,47,-1157.5099999999998,38,9,9717.73,8560.220000000001
7913,UBC7088,47,556394.1100000001,32,15,107197.97,663592.0800000001
7914,U05C6F3,47,169.46999999999957,33,14,17106.42,17275.89
7915,U6E4F8F,47,2052.71,33,14,19714.579999999998,21767.29
7916,U2A2C4A,47,-8022.0,27,20,28342.0,20320.0
7917,U98EE7C,47,523.5500000000038,34,13,53067.79999999998,53591.34999999999
7918,UECBAAD,47,-3646.790000000001,34,13,86642.22,82995.43
7919,UB636BB,47,3346.3500000000013,30,17,70582.23,73928.58
7920,U289DF5,47,-5972.63,34,13,33595.60000000002,27622.97
7921,U3252A7,47,961.8899999999994,38,9,23403.24,24365.13
7922,UCDC168,47,7043.530000000001,44,3,7492.47,14536.0
7923,UC71E96,47,-1088.1199999999983,39,8,12948.480000000001,11860.36
7924,U23BE07,47,395.44999999999936,38,9,23721.509999999995,24116.960000000003
7925,U98C0D6,47,-217.94999999999996,39,8,6524.74,6306.79
7926,U6179B7,47,-1090.139999999999,26,21,15156.72,14066.579999999998
7927,U14B457,47,21.430000000000746,29,18,50477.6,50499.02999999999
7928,UCAE6D2,47,1013.7300000000005,42,5,3780.9100000000003,4794.64
7929,U61B684,47,-3000.499999999999,45,2,10600.499999999998,7600.0
7930,U8ADE42,47,-2878.0300000000034,28,19,80454.76999999999,77576.74
7931,U6C9A26,47,-61964.550000000076,33,14,633102.13,571137.58
7932,U825951,47,11427.340000000011,42,5,46042.84000000001,57470.18
7933,U6B5D64,47,-329.6999999999998,44,3,7629.7,7300.0
7934,U66B1E5,46,-583.25,44,2,1383.25,800.0
7935,U5347AC,46,24211.230000000018,37,9,19204.93,43416.16
7936,UFF6271,46,-6863.969999999999,43,3,20120.73,13256.76
7937,U666123,46,-1681.4399999999996,33,13,22761.100000000002,21079.66
7938,U28EA8C,46,120.33000000001357,26,20,132206.16999999998,132326.5
7939,U8B5E8E,46,1.3599999999998786,25,21,2698.0399999999995,2699.4
7940,UFF1C27,46,-3824.9199999999996,42,4,10234.92,6410.0
7941,UC633A9,46,-1730.5,41,5,3740.5,2010.0
7942,U79D363,46,-1783.3100000000013,40,6,39551.56999999999,37768.259999999995
7943,U4A939E,46,-1456.3700000000547,36,10,555086.76,553630.39
7944,UF533CD,46,10149.829999999994,25,21,211538.5,221688.33
7945,U9A6B74,46,56.83000000000111,41,5,5814.18,5871.01
7946,U0359F9,46,1656.8200000000004,38,8,16806.979999999996,18463.8
7947,U1DF85A,46,321.25000000000364,26,20,124099.36000000002,124420.61000000002
7948,U4FFB36,46,12936.880000000008,22,24,102491.70999999999,115428.59000000001
7949,U48342F,46,21860.240000000005,41,5,72439.76000000001,94300.0
7950,U8C6268,46,2899.3399999999983,17,29,47964.07,50863.409999999996
7951,U777112,46,-297.31999999999977,30,16,2610.8100000000004,2313.49
7952,UF27DBF,46,-7780.69,37,9,29680.690000000006,21900.0
7953,U0F1635,46,2462.7,40,6,2153.3,4616.0
7954,UACCEFB,46,1559.2300000000002,40,6,6346.329999999997,7905.5599999999995
7955,UE8B501,46,-8251.350000000002,35,11,126401.40999999999,118150.06
7956,U90535D,46,-45019.57,33,13,57319.43,12299.859999999999
7957,UE5C4A9,46,13649.890000000003,34,12,32401.5,46051.39000000001
7958,U0EE5B9,46,-977.0500000000003,41,5,7656.610000000001,6679.5599999999995
7959,U921B83,46,-144.49999999999272,37,9,56145.799999999996,56001.3
7960,U95A857,46,1620.3099999999997,42,4,3685.6900000000005,5306.0
7961,UC28661,46,-1089.700000000004,26,20,43330.22,42240.52
7962,U60C6AA,46,-0.2899999999958527,38,8,63196.86,63196.56999999999
7963,UEF6C68,46,-1437.7,37,9,6499.099999999999,5061.400000000001
7964,UEDB601,46,-6219.390000000001,38,8,27488.58,21269.190000000002
7965,U1DAC7E,46,5858.890000000001,39,7,39878.75,45737.63999999999
7966,UF06162,46,-15812.460000000005,41,5,44863.46,29051.0
7967,UBF2423,46,25182.01,4,42,68.00999999999999,25250.019999999997
7968,U9EFC16,46,-18265.81,41,5,92865.98999999999,74600.18000000001
7969,UD9023E,46,-1874.18,31,15,4592.539999999999,2718.36
7970,U893F6C,46,54101.12999999999,34,12,184969.13,239070.25999999998
7971,U86C095,46,7234.410000000002,26,20,2210.01,9444.420000000002
7972,UFDB370,46,5.0,26,20,12010.0,12015.0
7973,U8F2BD5,46,30185.350000000002,39,7,41112.75000000001,71298.1
7974,U312B29,46,243.00000000000014,43,3,2102.2200000000003,2345.2200000000003
7975,U41734F,46,2974.34,37,9,73572.58,76546.92
7976,U8EA68F,46,-4313.13,32,14,8295.249999999998,3982.12
7977,UFE7607,46,13657.74,41,5,10746.77,24404.51
7978,U5C0D2D,46,-818.9900000000002,35,11,6940.04,6121.05
7979,U203892,46,-1170.6699999999946,41,5,25878.02,24707.35
7980,UA1A5D7,46,-5558.539999999997,37,9,21850.02,16291.48
7981,U6F2D76,46,22.97,30,16,20497.03,20520.0
7982,U4E39D3,46,3342.3399999999997,41,5,10454.32,13796.66
7983,UB6A617,46,-210.86000000000035,27,19,10525.79,10314.930000000002
7984,U0AE9C7,46,-7136.549999999998,44,2,11411.599999999997,4275.05
7985,U90DDA4,46,-5671.970000000001,23,23,23020.740000000005,17348.77
7986,U69916E,46,-12498.899999999996,36,10,42237.310000000005,29738.41
7987,U054AB1,46,-180.9099999999999,43,3,2164.6800000000003,1983.77
7988,U36FE20,46,-6633.640000000002,27,19,57633.21999999999,50999.579999999994
7989,U7DA2D8,46,-679.9599999999999,43,3,10474.959999999997,9795.0
7990,U1D73D9,46,-1156.55,24,22,9544.0,8387.449999999999
7991,U106A57,46,-22604.24,36,10,77120.4,54516.16
7992,U8F92DC,46,4206.040000000004,42,4,17015.200000000004,21221.239999999998
7993,UD81757,46,-3027.759999999993,38,8,58425.46,55397.700000000004
7994,U7CB088,46,523.53,25,21,12212.98,12736.509999999998
7995,U54DABE,46,1838.479999999999,32,14,18961.550000000003,20800.030000000002
7996,U1892C3,46,-24222.420000000002,34,12,41625.340000000004,17402.92
7997,U795ECD,46,7551.12,36,10,15584.34,23135.46
7998,U0E676C,46,-17327.440000000002,33,13,185142.27,167814.83000000002
7999,UFFCF14,46,-5.5099999999997635,32,14,3179.5299999999997,3174.0199999999995
8000,UF42BA1,46,-1066.6799999999985,42,4,9995.730000000001,8929.050000000001
8001,U376A6C,46,229.39,34,12,9261.97,9491.36
8002,UA2BADE,46,-12.639999999999873,28,18,32137.919999999995,32125.28
8003,U5F837D,46,305.1900000000003,43,3,2149.3499999999995,2454.54
8004,UC9BA2D,46,14356.55,35,11,46100.97,60457.520000000004
8005,UC53898,46,9.859999999998763,24,22,87515.55999999998,87525.42
8006,U0A3C97,46,345.07999999999953,38,8,2371.93,2717.0099999999998
8007,UB18B59,46,-2383.78,41,5,3168.2800000000007,784.5
8008,UD580E2,46,25626.819999999992,20,26,240425.51,266052.33
8009,U97C782,46,-11643.230000000003,43,3,65114.33000000001,53471.1
8010,U6D0DE9,46,-874.9100000000003,41,5,11597.949999999999,10723.039999999999
8011,UC5B708,46,-828.1300000000002,30,16,6883.150000000001,6055.020000000001
8012,UCE7460,46,32055.459999999995,41,5,28953.030000000002,61008.49
8013,U61E7D7,46,3734.0100000000016,36,10,27469.190000000002,31203.2
8014,UBA4320,46,-31.07000000000007,25,21,16665.9,16634.83
8015,UDC975C,46,-83.77000000000021,32,14,33168.170000000006,33084.4
8016,U826357,46,28.15999999999758,35,11,21389.699999999997,21417.86
8017,U52EC26,46,5933.66,32,14,48990.22,54923.88
8018,UF22B2C,46,8225.589999999998,38,8,12052.380000000001,20277.969999999998
8019,U6D6961,46,-571.6700000000002,40,6,6132.99,5561.320000000001
8020,U000437,46,-16066.719999999985,35,11,80562.19,64495.47
8021,U356E6E,46,206.35000000000048,44,2,2693.65,2900.0
8022,U8FCBCF,46,1132.9099999999999,42,4,2744.09,3877.0
8023,UCC2FC7,46,7799.82,28,18,12162.86,19962.68
8024,U87ECF1,46,-2216.6299999999983,24,22,17365.9,15149.27
8025,UDDEFE0,46,169216.91000000012,25,21,1772292.27,1941509.18
8026,U03855F,46,3441.01,30,16,11536.88,14977.89
8027,UF0B4C6,46,3231.5500000000006,39,7,13486.789999999997,16718.34
8028,U6DFBAE,46,7453.1,39,7,10195.2,17648.3
8029,U23614D,46,9876.470000000008,41,5,64146.61999999998,74023.09
8030,U294D75,46,-694.81,46,0,694.81,0.0
8031,U431EEB,46,-37.31999999999971,27,19,67566.62,67529.3
8032,U4F8A16,46,-1853.6300000000003,44,2,2231.3,377.66999999999996
8033,U784629,46,95.62000000000035,40,6,2070.6499999999996,2166.27
8034,U8701C6,46,-1154.5899999999995,33,13,9661.46,8506.869999999999
8035,UB40449,46,340.90999999999997,32,14,5272.060000000001,5612.97
8036,U1FC017,46,927.94,38,8,4184.01,5111.95
8037,U441E30,46,-1513.0999999999985,36,10,124285.45999999999,122772.35999999999
8038,U59C514,46,-18629.420000000002,35,11,58694.41,40064.99
8039,U7B0CF2,46,-230.52999999999986,41,5,4670.429999999999,4439.9
8040,U16A410,46,7929.359999999999,32,14,65235.509999999995,73164.87
8041,U5B1867,46,5602.809999999998,41,5,12602.6,18205.409999999996
8042,UDA1040,46,-517.6300000000001,36,10,19098.04,18580.41
8043,U5CFF85,46,-32521.41,43,3,40061.41,7540.0
8044,U356F93,46,-28067.720000000016,28,18,246419.00000000003,218351.28
8045,U95AE2C,46,-7133.700000000001,37,9,16633.7,9500.0
8046,U6AB00A,46,-104.78000000000014,40,6,1611.49,1506.71
8047,U1FC7F3,46,2176.0199999999995,42,4,2116.1299999999997,4292.150000000001
8048,UC51796,46,1517.8999999999996,43,3,4583.22,6101.12
8049,U03F4B9,46,2338.0299999999997,42,4,1693.5700000000002,4031.6
8050,UBBDC78,46,19629.30000000001,42,4,540690.3,560319.6
8051,U7ECDDE,46,-22337.169999999995,37,9,38104.270000000004,15767.1
8052,UACCA2A,46,11048.280000000006,35,11,15217.409999999993,26265.69
8053,U5DA79F,46,1272.4500000000003,38,8,1192.8,2465.2500000000005
8054,U77D23F,46,-644.9800000000005,41,5,11716.980000000001,11072.0
8055,UCA46BD,46,-1177.3100000000013,35,11,25693.140000000007,24515.83
8056,U5ED9A5,46,1711.840000000001,41,5,19690.600000000002,21402.440000000002
8057,U6F07FD,46,-2652.409999999999,44,2,11936.779999999999,9284.369999999999
8058,UC445E5,46,-40489.16000000001,40,6,110012.33999999998,69523.18
8059,U2BF611,46,-1611.8500000000001,36,10,3876.5100000000007,2264.66
8060,UD6D83B,46,35428.290000000015,22,24,187862.8,223291.09000000003
8061,UBF600A,46,5936.27999999997,30,16,770665.57,776601.8500000001
8062,U9DA151,46,-59177.33999999999,26,20,202773.81,143596.47
8063,U30A3C6,46,-13240.730000000001,46,0,13240.730000000001,0.0
8064,UD8D03B,46,-1008.7400000000001,42,4,3843.8400000000015,2835.1
8065,U281B9C,46,1302.11,41,5,6643.7699999999995,7945.880000000001
8066,U87D6EE,46,-22087.280000000006,38,8,35110.200000000004,13022.919999999998
8067,UB81599,46,-8787.48,34,12,43521.21000000001,34733.729999999996
8068,U514B51,46,1044.739999999998,33,13,67690.20999999999,68734.95
8069,U409642,46,-29.519999999997253,39,7,9732.199999999997,9702.68
8070,U522B47,46,308.32000000000005,43,3,4398.6,4706.92
8071,UB5A6F4,46,-7147.07,31,15,66076.74,58929.67
8072,U189B9A,46,44.690000000000055,38,8,19512.32,19557.01
8073,UEB7DA3,46,2211.5700000000006,38,8,5755.8099999999995,7967.380000000001
8074,U47ED79,46,13802.73000000001,27,19,635460.0,649262.73
8075,UE5CF9B,46,2685.01,36,10,16430.140000000003,19115.149999999998
8076,UD4E9F7,46,-3576.33,28,18,6884.200000000001,3307.87
8077,UCC0C96,45,-117.92999999999988,41,4,4802.63,4684.700000000001
8078,UDE02C4,45,-1369.2100000000005,40,5,5576.48,4207.2699999999995
8079,U0DCEA1,45,-29895.25,37,8,58919.85,29024.6
8080,U27A161,45,3329.2800000000034,38,7,59319.959999999985,62649.24
8081,U36B6CF,45,54437.00999999999,37,8,22655.680000000004,77092.69
8082,UE46FE1,45,30782.54,28,17,68298.43,99080.96999999999
8083,UF5CC7A,45,1242.3699999999953,39,6,71609.39,72851.76000000001
8084,UE05897,45,-98441.98999999999,37,8,330542.86,232100.87
8085,UF040EE,45,-3572.9699999999993,33,12,41269.57000000001,37696.600000000006
8086,U765761,45,-2144.1800000000007,38,7,7997.889999999999,5853.71
8087,UEC7298,45,-596.06,40,5,7260.0599999999995,6664.0
8088,U16EC05,45,72.49000000000086,22,23,107414.42,107486.90999999997
8089,U7904D2,45,-2917.82,35,10,9760.74,6842.92
8090,U0CDF74,45,4141.350000000001,41,4,3922.4200000000005,8063.77
8091,UC58A48,45,-1288.5399999999945,30,15,371939.99,370651.44999999995
8092,U65F2F5,45,889.3100000000002,34,11,4846.870000000003,5736.18
8093,UD457C8,45,-2970.04,32,13,34528.22,31558.18
8094,UECAA04,45,2423.6200000000003,37,8,16182.920000000002,18606.54
8095,UE07F9A,45,617.2699999999999,38,7,1283.1100000000001,1900.38
8096,U6F4280,45,-7362.780000000002,40,5,14682.85,7320.07
8097,UDC328A,45,-4206.38,40,5,6763.54,2557.16
8098,UCBDE2A,45,521.3499999999996,38,7,3084.820000000001,3606.17
8099,U590504,45,-717.2799999999999,41,4,3250.28,2533.0
8100,U510AAA,45,-7952.02,38,7,19332.33,11380.31
8101,UF9A61D,45,18637.759999999995,34,11,3445.6400000000003,22083.399999999998
8102,U68BED3,45,-13397.850000000002,34,11,48475.159999999996,35077.31
8103,UA0E81F,45,964.4499999999982,29,16,60818.880000000005,61783.329999999994
8104,U69B151,45,-62239.14999999998,41,4,124719.14999999998,62480.0
8105,UE1DC8E,45,52.73999999999928,40,5,10573.33,10626.07
8106,U2AF8A5,45,198.2799999999997,42,3,1435.63,1633.9099999999999
8107,UEF399E,45,-20521.02999999999,38,7,23598.409999999993,3077.3799999999997
8108,U18C73A,45,2521.840000000001,43,2,2502.16,5024.0
8109,U2A071A,45,-1495.4999999999995,27,18,23549.190000000002,22053.69
8110,U572A63,45,-948.7999999999984,31,14,30198.460000000003,29249.66
8111,UAD82BB,45,-2.05000000000026,24,21,3651.5400000000004,3649.49
8112,UCE7EA8,45,13995.900000000001,30,15,14635.209999999997,28631.11
8113,UFD2A64,45,-29.709999999999603,36,9,2220.33,2190.62
8114,UF02B99,45,327.54,43,2,674.3900000000001,1001.9300000000001
8115,U61542D,45,3236.129999999999,34,11,24059.209999999995,27295.34
8116,U075276,45,-7089.539999999997,27,18,17089.54,10000.0
8117,U30ACF5,45,5480.969999999998,35,10,113075.19000000003,118556.16
8118,U95B3BF,45,61.02999999999965,34,11,7809.649999999999,7870.68
8119,UE954B2,45,35754.22,35,10,9488.199999999999,45242.42
8120,UADDAD3,45,-6703.429999999999,43,2,7737.629999999998,1034.2
8121,U4C9FE4,45,28253.960000000003,30,15,70202.73,98456.68999999999
8122,U38F976,45,21922.62,38,7,67721.83,89644.45
8123,U058611,45,177.3599999999998,39,6,2439.0199999999995,2616.38
8124,U7B12AB,45,-13134.13,38,7,71813.13,58679.0
8125,UF75BDB,45,-4690.369999999995,37,8,21466.869999999995,16776.5
8126,UD02D3B,45,2272.5400000000004,37,8,8470.59,10743.130000000001
8127,U1C5796,45,-306013.72,40,5,685945.67,379931.95
8128,U89ADA9,45,-556.2500000000009,29,16,18907.68,18351.43
8129,U227AE7,45,12218.89,37,8,12028.389999999998,24247.28
8130,U5101A4,45,-81.65999999999983,31,14,7573.2699999999995,7491.61
8131,UF19195,45,12905.219999999998,23,22,51715.05,64620.27
8132,U3DCBAB,45,1586.5,39,6,4011.51,5598.01
8133,U4C2968,45,-18513.400000000005,35,10,66871.13,48357.729999999996
8134,U325746,45,3421.16,40,5,30670.78,34091.94
8135,UD3E8C8,45,-11944.890000000005,27,18,13876.580000000004,1931.69
8136,UC2FF27,45,2039.8700000000008,31,14,60646.32,62686.189999999995
8137,U4F227E,45,752.4399999999999,40,5,2953.26,3705.7
8138,UF15C8A,45,-77.28000000000156,33,12,85638.56,85561.28
8139,U9AB448,45,11241.72,36,9,10893.87,22135.59
8140,U7E4EFE,45,-310.1500000000001,43,2,4010.1499999999996,3700.0
8141,U7D02B2,45,-7866.779999999999,28,17,20406.070000000003,12539.29
8142,UC8C89D,45,12590.540000000006,33,12,8546.000000000002,21136.54
8143,UC68286,45,-268.25999999999976,36,9,3011.26,2743.0
8144,U285C68,45,-288.59,41,4,2484.0400000000004,2195.45
8145,U4BA8CB,45,-103083.39,38,7,176869.13000000006,73785.74000000002
8146,UC48F40,45,1846.1000000000004,27,18,85716.9,87563.0
8147,U737611,45,35.39000000000004,32,13,1053.7600000000002,1089.15
8148,UC51D72,45,-34.289999999999964,37,8,12824.41,12790.119999999999
8149,U57916E,45,12174.500000000002,41,4,18324.15,30498.65
8150,U2E92D6,45,-1339.58,33,12,10007.47,8667.89
8151,U10840C,45,37401.72,33,12,34372.43,71774.15
8152,U3D6D41,45,11385.289999999999,39,6,9658.829999999996,21044.12
8153,U71B127,45,22757.17,32,13,44004.03,66761.2
8154,UDADDD1,45,-5416.18,34,11,25617.509999999995,20201.33
8155,UBCD9A3,45,-18476.81,33,12,55253.92,36777.11
8156,UB84298,45,1092.1499999999996,40,5,6444.2699999999995,7536.42
8157,UD079AF,45,88257.61000000002,37,8,6519.429999999999,94777.04000000001
8158,UD802D1,45,-269.6700000000002,39,6,3345.2299999999996,3075.56
8159,U2155D6,45,426.4699999999998,38,7,1144.43,1570.9
8160,UD95673,45,-157.7300000000001,40,5,1395.0200000000002,1237.29
8161,UE6ABAA,45,328.03000000000293,42,3,13240.429999999997,13568.460000000001
8162,UF8CA0D,45,-7411.430000000001,20,25,14645.589999999997,7234.16
8163,UE994A9,45,1.5799999999999272,34,11,1974.0,1975.58
8164,U65B950,45,125243.63999999998,22,23,432028.97000000003,557272.61
8165,UED27A7,45,84.89000000001397,22,23,774087.67,774172.5599999998
8166,UED4746,45,-1253.9,36,9,2464.52,1210.6200000000001
8167,UD30CBC,45,-2653.42,37,8,4841.200000000001,2187.7799999999997
8168,U8E940D,45,-1918.549999999999,30,15,17972.370000000003,16053.82
8169,U409380,45,681.5599999999995,40,5,8053.71,8735.27
8170,U13A8A6,45,-1225.21,35,10,8503.75,7278.539999999999
8171,UEA6BAF,45,-10185.64,32,13,26361.760000000002,16176.12
8172,U9A30E8,45,-16116.779999999992,24,21,139852.09,123735.31
8173,U818590,45,-11922.689999999999,41,4,13171.73,1249.04
8174,UC701B7,45,-2812.2999999999975,28,17,284762.39999999997,281950.1
8175,U2D90CA,45,12720.409999999998,27,18,44621.84,57342.25
8176,UFA624E,45,-40.18000000000113,34,11,16614.489999999994,16574.31
8177,UAF0BBD,45,401662.98,34,11,27085.520000000004,428748.5
8178,U445A63,45,-44360.92000000001,30,15,264215.8300000001,219854.90999999997
8179,U6A863C,45,4507.010000000001,32,13,6330.679999999998,10837.69
8180,UB58931,45,7115.000000000001,38,7,1483.8100000000004,8598.81
8181,UBC6D32,45,16896.510000000002,26,19,228443.0,245339.51
8182,U6B610F,45,297.17000000000326,41,4,26022.27,26319.440000000002
8183,U0658EC,45,-1667.3699999999972,28,17,181952.74,180285.37
8184,U461EA2,45,1494.2799999999997,41,4,2030.7600000000002,3525.0399999999995
8185,UF1EB2B,45,2025.6899999999996,40,5,2350.7700000000004,4376.46
8186,U60A8AD,45,657.0299999999983,37,8,34480.89,35137.92
8187,U488536,45,44961.47999999999,28,17,98824.5,143785.97999999998
8188,U7CFC3E,45,3031.780000000001,43,2,8484.359999999999,11516.14
8189,U20A411,45,11449.07,39,6,14600.46,26049.53
8190,U2375CE,45,35.73000000000011,42,3,4066.3900000000003,4102.12
8191,U8FAB09,45,-2443.3899999999994,28,17,20959.379999999997,18515.99
8192,U1287DB,45,-948.2300000000004,38,7,7953.110000000001,7004.879999999999
8193,UC3F21C,45,-33.650000000000006,42,3,3938.7400000000007,3905.09
8194,U2FF79F,45,1245.22,32,13,67300.0,68545.22
8195,U00EDC5,45,10045.769999999993,30,15,34192.95999999999,44238.73
8196,UA21C61,44,-2028.2399999999998,28,16,21352.83,19324.59
8197,U351B09,44,-2867.9800000000005,42,2,6586.71,3718.73
8198,U4C6D3B,44,6833.440000000002,39,5,3476.640000000001,10310.08
8199,U6E52AA,44,377.4199999999996,41,3,7042.58,7420.0
8200,UD44112,44,-76.53000000000087,41,3,5226.1500000000015,5149.62
8201,UD90B15,44,-283.95999999999975,42,2,2146.46,1862.5
8202,U3779D1,44,503.6399999999999,38,6,4018.079999999999,4521.719999999999
8203,U0B0411,44,-885.9000000000005,42,2,4141.4800000000005,3255.58
8204,UF08CEC,44,-207.29000000000002,30,14,3411.4399999999996,3204.1499999999996
8205,UD87D42,44,3534.8499999999985,40,4,27151.020000000008,30685.870000000003
8206,U6B48F0,44,-2237.8,41,3,5265.37,3027.57
8207,UF51F76,44,-403.4300000000005,29,15,7211.530000000001,6808.099999999999
8208,UD4B14E,44,-14938.0,35,9,51612.66,36674.66
8209,U146C70,44,-10340.609999999999,39,5,12193.55,1852.9399999999998
8210,U1D3457,44,-31168.129999999997,26,18,124667.54000000001,93499.40999999999
8211,U84ACF3,44,-3550.29,41,3,5191.889999999999,1641.6
8212,UF52E9D,44,-719.46,26,18,20719.46,20000.0
8213,U4DC18D,44,-345.11000000000047,33,11,18124.780000000006,17779.67
8214,UC36131,44,-1406.4500000000005,42,2,4406.450000000001,3000.0
8215,UA35BA5,44,-4802.969999999998,39,5,15230.1,10427.130000000001
8216,UC8D3A7,44,1276.2599999999998,39,5,6674.87,7951.13
8217,U2C3B65,44,15419.140000000003,40,4,67104.86,82524.0
8218,U1E9180,44,-82362.66999999998,27,17,586131.99,503769.32
8219,UCFF3A7,44,16717.46,28,16,21800.43,38517.89
8220,U0F6081,44,28185.38,38,6,46421.78,74607.16
8221,U659C78,44,1500.8400000000006,31,13,19745.240000000005,21246.08
8222,UC2B9C2,44,-78.75999999999931,23,21,15326.77,15248.01
8223,U9089FD,44,448.3500000000001,19,25,3336.71,3785.0600000000004
8224,U2AE495,44,-520.45,39,5,1449.48,929.03
8225,UBE8AC2,44,-1462.4499999999998,39,5,9476.26,8013.8099999999995
8226,U96AB02,44,-28458.829999999998,34,10,58622.990000000005,30164.16
8227,U13CD95,44,-32611.999999999993,34,10,93953.74,61341.74000000001
8228,UF3318A,44,-1463.8499999999997,34,10,14961.220000000001,13497.37
8229,UE47661,44,-1912.3200000000006,28,16,11367.94,9455.620000000003
8230,U2B209F,44,-37127.53999999998,26,18,525565.0,488437.45999999996
8231,UD5643E,44,14130.089999999993,28,16,132207.21,146337.3
8232,UFFBDE5,44,-752.91,42,2,2761.7200000000003,2008.81
8233,U7A8FB1,44,-3217.0899999999992,44,0,3217.0899999999992,0.0
8234,U7A20CD,44,-488.4499999999998,27,17,8860.14,8371.69
8235,U84627B,44,18662.440000000002,24,20,497194.87999999995,515857.31999999995
8236,UC60CF8,44,120.29999999999782,36,8,101190.7,101311.0
8237,U7B657F,44,-20.08999999999958,29,15,14548.029999999999,14527.939999999999
8238,U9E1EDB,44,-2959.749999999999,39,5,13064.74,10104.99
8239,U81C492,44,-9228.919999999998,33,11,37063.89,27834.97
8240,U6442B1,44,15528.440000000002,41,3,19021.0,34549.44
8241,UF412FE,44,10406.83,31,13,16737.22,27144.05
8242,UF921C1,44,17172.800000000003,37,7,34322.85,51495.649999999994
8243,U34937F,44,-18192.730000000007,40,4,29156.020000000008,10963.29
8244,UF66697,44,4896.5,39,5,4747.16,9643.66
8245,U75B330,44,30860.229999999996,39,5,115083.76999999999,145944.0
8246,U20B8ED,44,6544.060000000003,33,11,71163.75,77707.81
8247,U6343AA,44,10488.750000000004,36,8,10727.02,21215.769999999997
8248,UF2F483,44,-12299.59,32,12,58067.73000000001,45768.14
8249,U6B43EB,44,4238.880000000001,42,2,2811.32,7050.2
8250,UD0043E,44,-1348.0599999999977,36,8,36520.490000000005,35172.43
8251,U193E3C,44,52426.30999999997,25,19,243807.16,296233.47
8252,UBB4D98,44,-8182.149999999997,42,2,20847.149999999998,12665.0
8253,UF2346F,44,-15902.320000000002,34,10,41417.420000000006,25515.100000000002
8254,U058473,44,-1964.5099999999975,31,13,47695.520000000004,45731.009999999995
8255,UBCD8F0,44,46.03000000000101,36,8,9690.249999999998,9736.28
8256,U450B21,44,-1073.92,39,5,4683.919999999999,3610.0
8257,U7E2D1A,44,199317.53000000003,26,18,115232.07,314549.6
8258,U920C90,44,2050.3,33,11,51354.05,53404.350000000006
8259,U9C483E,44,3023.4300000000007,19,25,354190.48000000004,357213.9099999999
8260,U2E058E,44,67581.87000000001,30,14,332367.04,399948.91000000003
8261,U7020F5,44,100.04999999999893,20,24,24448.73,24548.78
8262,UD4D7A1,44,-2069.9000000000024,38,6,24246.28,22176.38
8263,U9C322B,44,-2856.76,29,15,44819.61,41962.850000000006
8264,U4FA442,44,9652.929999999998,38,6,17559.01,27211.94
8265,U1228F5,44,408.0300000000032,35,9,36454.950000000004,36862.98
8266,U5667CA,44,-7596.960000000008,30,14,87488.63999999998,79891.68
8267,UFAB6DE,44,1761.9399999999994,38,6,102173.42000000001,103935.36
8268,U9BC533,44,-32733.249999999996,39,5,55936.03999999999,23202.79
8269,U30C85E,44,-1329.1600000000008,35,9,24678.04,23348.88
8270,U03EA6A,44,-81.01999999999998,41,3,2323.86,2242.84
8271,U84B78D,44,-333.369999999999,26,18,159546.0,159212.63
8272,UB037AE,44,4152.5,39,5,20154.85,24307.35
8273,UA56FE9,44,-118.37000000000003,42,2,1144.3700000000001,1026.0
8274,U299E51,44,-535.1599999999977,32,12,7354.979999999999,6819.82
8275,U3F2B0B,44,-201.3199999999994,41,3,2638.1499999999996,2436.8300000000004
8276,U1FFD02,44,-2.0700000000000216,40,4,2702.6,2700.53
8277,U34F01A,44,41.16000000000009,40,4,1823.1000000000004,1864.26
8278,U06665A,44,-2513.09,41,3,9730.830000000002,7217.74
8279,U7E7848,44,-7001.44,35,9,18708.11,11706.669999999998
8280,U3CF9C6,44,23512.39,30,14,71084.08,94596.47
8281,U197720,44,-3506.8599999999997,33,11,16928.04,13421.18
8282,U89FE98,44,-674.5899999999946,37,7,67680.59000000001,67006.0
8283,UBD6D77,44,-2921.2100000000028,26,18,23565.360000000004,20644.15
8284,U855A29,44,-771.1600000000001,30,14,29964.52999999999,29193.370000000003
8285,UB8EE7F,44,46047.81,30,14,1189.8000000000002,47237.61
8286,UA26907,44,-14356.829999999996,41,3,17512.770000000004,3155.94
8287,U60C17E,44,-9.094947017729282e-13,26,18,69684.81,69684.81
8288,U2E8D57,44,-258.0699999999999,42,2,1256.1200000000001,998.05
8289,UC3E780,44,-41048.10999999999,40,4,70607.06,29558.950000000004
8290,UF63DAB,44,-684.4200000000006,26,18,19286.510000000006,18602.09
8291,UD0FF28,44,-14121.750000000004,33,11,65483.759999999995,51362.01
8292,U0B9F2C,44,17446.8,30,14,114428.91,131875.71000000002
8293,UB8704B,44,-141.92999999999984,39,5,1305.79,1163.8600000000001
8294,UF34D4B,44,-5473.260000000002,41,3,26220.809999999998,20747.55
8295,U742574,44,-1546.88,44,0,1546.88,0.0
8296,U2DD5F0,44,-4687.18,41,3,26592.98,21905.8
8297,U523223,44,-25974.1,27,17,54890.12,28916.02
8298,U0D9156,44,10848.030000000004,38,6,5453.039999999999,16301.070000000002
8299,U9D6CF8,44,8087.17,39,5,13418.59,21505.76
8300,U625937,44,242.26999999999998,31,13,3026.86,3269.1299999999997
8301,UF10A77,44,-24872.86,23,21,150833.56999999998,125960.70999999999
8302,UE551C9,44,-40309.380000000005,44,0,40309.380000000005,0.0
8303,UF45296,44,-361.8300000000007,41,3,6283.18,5921.35
8304,UEEE38B,44,1445.1299999999999,29,15,28686.040000000008,30131.17
8305,U609732,44,-3552.4299999999985,42,2,9652.429999999997,6100.0
8306,U93229A,44,4801.609999999999,34,10,18813.319999999996,23614.93
8307,UF85345,44,-7018.92,39,5,36447.240000000005,29428.32
8308,U392E62,44,559.3199999999997,39,5,18024.739999999998,18584.059999999998
8309,UED81FF,44,-2108.690000000001,34,10,24934.239999999998,22825.55
8310,U19AA5D,44,39.06999999999971,21,23,143904.96000000002,143944.03
8311,U84A83F,44,9243.75,28,16,2138.42,11382.17
8312,U421B88,44,9336.190000000002,30,14,5201.569999999999,14537.76
8313,U123C6A,44,31814.51999999999,39,5,147925.97999999998,179740.5
8314,U963005,44,-11228.069999999996,35,9,51297.659999999996,40069.590000000004
8315,U436501,44,-1480.4100000000008,35,9,32588.739999999998,31108.329999999998
8316,UAEAC7C,44,535.0400000000002,24,20,10397.27,10932.310000000001
8317,UE4FBD0,44,-510591.64,31,13,917048.19,406456.55
8318,UC1F1B2,44,-6.250000000000682,33,11,32569.38,32563.13
8319,UFBD7D4,44,-274464.80999999994,26,18,608464.8199999998,334000.01
8320,UF38616,44,4257.3099999999995,31,13,4600.3099999999995,8857.619999999999
8321,UD9A401,44,160.11999999999966,37,7,11888.289999999999,12048.41
8322,U8E5DF8,44,0.3299999999995631,33,11,33827.49,33827.81999999999
8323,U98BF52,44,-18764.979999999996,40,4,23689.969999999994,4924.99
8324,UEED50A,44,-1761.9199999999987,38,6,7481.579999999999,5719.66
8325,U0C55EA,44,-11828.1,41,3,34732.09,22903.99
8326,U6F1603,44,-4052.87,27,17,14881.379999999997,10828.51
8327,U31CF1C,44,13588.43,19,25,272253.0,285841.43
8328,U570E17,44,-34.90999999999982,38,6,2368.82,2333.9100000000003
8329,UB0B5E5,44,-1844.8300000000002,39,5,3575.51,1730.68
8330,UE711D7,44,-438.42999999999984,39,5,5144.999999999999,4706.57
8331,U9FFBC1,44,160157.65,31,13,546174.48,706332.1300000001
8332,U9C4AC2,44,-34188.22,36,8,50177.03,15988.81
8333,UA92D71,44,323.97000000000014,40,4,7306.11,7630.08
8334,U15BC15,44,-397043.5400000001,25,19,828395.4499999998,431351.91
8335,U44495E,43,-13077.479999999996,26,17,42728.38,29650.9
8336,UD0D921,43,-19601.950000000004,35,8,89252.35999999997,69650.41
8337,U03292F,43,2264.2400000000002,33,10,89366.64000000001,91630.88
8338,U1B0B60,43,4283.78999999998,22,21,207107.51,211391.3
8339,U9BDC5E,43,10306.950000000003,27,16,22009.56,32316.51
8340,U6CB956,43,-1143.1900000000003,22,21,19635.19,18492.0
8341,UB2BB38,43,-44177.84,28,15,174203.04,130025.20000000001
8342,U8AF0E0,43,6050.43,37,6,29401.27,35451.7
8343,U746E27,43,-2862.149999999993,33,10,34762.329999999994,31900.18
8344,U32390C,43,-26.06999999999863,30,13,9228.079999999998,9202.01
8345,U678432,43,-4813.54,35,8,10068.580000000002,5255.04
8346,U3D21C3,43,172.06999999999994,22,21,7225.04,7397.11
8347,U9FFAD2,43,1442.8,26,17,12567.98,14010.779999999999
8348,UEEB76E,43,-80.76000000000063,40,3,4670.76,4590.0
8349,U6020EC,43,2250.90000000003,22,21,878474.0,880724.9
8350,U68E458,43,-1942.6199999999963,37,6,15720.15999999999,13777.54
8351,U6E5C20,43,1000.0,39,4,13347.4,14347.4
8352,UD6BE39,43,-1365.220000000002,31,12,74915.18000000001,73549.95999999999
8353,U164EBB,43,-22577.43,35,8,50694.98,28117.55
8354,U5F63F6,43,-412.4899999999989,31,12,50056.490000000005,49644.0
8355,UEFDDEB,43,7756.669999999999,33,10,14267.849999999999,22024.519999999997
8356,UFEECA5,43,-832.6100000000001,38,5,1775.1699999999998,942.56
8357,UDA8F1D,43,1420.9599999999919,31,12,73799.26,75220.22
8358,U3373FC,43,10068.240000000002,33,10,20505.909999999993,30574.149999999998
8359,U022E7B,43,-9638.380000000001,38,5,15961.92,6323.54
8360,U15891C,43,-2884.0199999999995,40,3,15752.36,12868.34
8361,U2E5F15,43,-35845.619999999995,38,5,46948.43,11102.81
8362,UC63FD8,43,-2834.3000000000006,35,8,2928.3900000000003,94.08999999999999
8363,UF623E1,43,52.419999999992434,32,11,224908.80999999997,224961.23
8364,UE2416B,43,836.1700000000001,18,25,5146.0,5982.17
8365,U11A188,43,2231.370000000001,12,31,47532.880000000005,49764.24999999999
8366,U0B9D3D,43,2284.999999999999,36,7,22446.34,24731.34
8367,UAB88E5,43,418.8599999999999,35,8,2475.2200000000003,2894.08
8368,UF5687D,43,296.0,23,20,817.0,1113.0
8369,UC135C5,43,-202.51,39,4,3277.23,3074.7200000000003
8370,U1F23A0,43,205.3199999999997,39,4,3061.6800000000003,3267.0
8371,U8C8A3E,43,17.150000000001256,27,16,62810.18,62827.329999999994
8372,UEF996C,43,-49063.11,24,19,114761.18000000001,65698.06999999999
8373,UA83F44,43,4327.16,34,9,5193.55,9520.71
8374,U070AAB,43,-1431.4099999999996,38,5,4868.920000000001,3437.51
8375,U8C8900,43,-16226.5,38,5,39903.69,23677.19
8376,UB75EC7,43,93.85999999999997,40,3,1569.72,1663.58
8377,U840F00,43,2015.4899999999989,33,10,18785.609999999993,20801.1
8378,U704615,43,1956.7399999999993,32,11,28600.000000000004,30556.74
8379,U9ADA37,43,-3645.71,36,7,17122.07,13476.36
8380,U1E7556,43,-6313.799999999999,40,3,7352.75,1038.95
8381,UF34E50,43,-11562.710000000001,38,5,29043.969999999998,17481.260000000002
8382,U59EFFC,43,1082.1900000000019,22,21,48808.67999999999,49890.86999999999
8383,U808934,43,5350.830000000001,33,10,26114.70999999999,31465.54
8384,U594E4C,43,-799.5800000000002,37,6,6078.759999999998,5279.18
8385,U7611F0,43,523.5799999999991,40,3,11044.689999999999,11568.27
8386,UF7476E,43,669.04,39,4,744.9599999999999,1414.0
8387,UFBEC5B,43,-1118.5000000000005,40,3,3123.3900000000003,2004.8899999999999
8388,U5E4914,43,4836.869999999999,37,6,16597.45,21434.32
8389,U18A9A9,43,-293.73,38,5,7392.85,7099.12
8390,U4A3570,43,255491.17,24,19,352201.10000000003,607692.27
8391,U3802E9,43,-511.50999999999976,36,7,3279.34,2767.83
8392,U39EAB0,43,-27985.239999999998,39,4,50100.24,22115.0
8393,U98C198,43,-9596.869999999997,35,8,31024.9,21428.03
8394,UD3BBE3,43,-3670.2799999999997,39,4,30351.679999999997,26681.4
8395,UBB3432,43,-5989.079999999998,39,4,31289.079999999994,25300.0
8396,U98B4CF,43,-3385.8099999999995,35,8,10841.12,7455.31
8397,UC0C8AC,43,129.76999999999987,39,4,1544.6100000000001,1674.38
8398,U4D6857,43,-136669.51999999996,27,16,617308.39,480638.87
8399,U554794,43,-109.56000000000208,28,15,36402.98,36293.42
8400,U17F1D0,43,154.4999999999995,34,9,7967.410000000003,8121.91
8401,U4E5B8B,43,4008.67,38,5,2138.46,6147.129999999999
8402,U4279DF,43,-2020.6600000000003,41,2,2501.18,480.52
8403,U1507E3,43,-12685.66,37,6,48479.31,35793.65
8404,U1ACE2E,43,-278.56000000000023,40,3,5623.65,5345.09
8405,UF0CD84,43,-7490.5099999999975,40,3,30585.99,23095.48
8406,U31E7AC,43,1700.8699999999992,38,5,8572.69,10273.56
8407,UCD8A41,43,0.2499999999998863,28,15,5921.110000000001,5921.359999999999
8408,UD09652,43,-9.190000000002328,27,16,75009.2,75000.01000000001
8409,U39F3CE,43,486.4200000000001,29,14,10457.629999999997,10944.05
8410,UE9008B,43,-4144.46,41,2,6693.56,2549.1
8411,U8259FB,43,17384.310000000005,35,8,24782.34,42166.65
8412,UEB2AFB,43,-79.12000000000269,38,5,9770.700000000003,9691.579999999998
8413,U10621C,43,-879.1500000000003,35,8,12339.940000000002,11460.79
8414,U206799,43,269.60999999999854,40,3,24070.390000000003,24340.0
8415,U6E3644,43,-4140.360000000001,38,5,10216.539999999999,6076.179999999999
8416,U2EBEFF,43,-107.21000000000005,40,3,1247.2500000000002,1140.04
8417,U0EC380,43,-2775.6399999999994,27,16,103350.47999999998,100574.84
8418,U25D544,43,-2648.5099999999998,33,10,4929.220000000001,2280.7100000000005
8419,U2478ED,43,936.5900000000292,25,18,222012.44,222949.03
8420,U0A9282,43,839.2700000000002,34,9,13934.88,14774.150000000001
8421,UB6CFD1,43,-759.87,35,8,3497.87,2738.0
8422,UBF2D05,43,-3905.51,32,11,18642.440000000002,14736.93
8423,U3F88D8,43,18053.81,27,16,103246.15000000001,121299.95999999999
8424,U501090,43,3424.7000000000007,25,18,1317.73,4742.430000000001
8425,U22CE84,43,-27949.80000000002,26,17,224177.91000000003,196228.11
8426,U2986DB,43,17422.63,28,15,9857.079999999998,27279.710000000003
8427,UAEBF9E,43,-2001.1200000000001,40,3,4407.799999999999,2406.68
8428,U4C9F1A,43,-6852.530000000001,41,2,12971.82,6119.29
8429,UE30159,43,3573.640000000001,31,12,4944.72,8518.36
8430,UBFAA78,43,7619.35,20,23,23357.190000000002,30976.540000000005
8431,U2FF126,43,4139.999999999998,21,22,61856.12,65996.12
8432,U6CB669,43,563.3499999999999,38,5,1306.01,1869.3600000000001
8433,UC40FB3,43,10195.320000000003,35,8,18579.600000000002,28774.920000000002
8434,UAA6108,43,-83.77999999999997,30,13,6008.790000000001,5925.01
8435,U03AA8B,43,-207.82000000004308,23,20,463238.85,463031.02999999997
8436,U12B4C2,43,426.39999999999975,37,6,4950.65,5377.05
8437,U7EAE86,43,-9427.829999999996,34,9,108950.6,99522.77
8438,UE12BB6,43,302132.43,20,23,471066.46,773198.89
8439,UEA839B,43,-14299.350000000004,35,8,139942.71000000002,125643.36
8440,U256999,43,-20005.539999999997,25,18,139178.41999999998,119172.87999999999
8441,UA45F31,43,3943.5600000000004,32,11,7653.919999999999,11597.48
8442,U189B4A,43,-22888.060000000012,30,13,138204.95999999996,115316.9
8443,UAC70C4,43,-1832.8399999999997,43,0,1832.8399999999997,0.0
8444,UE88218,43,-639.44,31,12,2148.4399999999996,1509.0
8445,U00F7EC,43,355.0,37,6,2569.0,2924.0
8446,U9B3481,43,316.4799999999999,20,23,3373.28,3689.7599999999998
8447,UC44CC8,43,-1814.68,39,4,6847.75,5033.07
8448,UF8094C,43,585.4300000000009,24,19,3522.58,4108.01
8449,UDC3C01,43,-905.8800000000001,31,12,3742.6,2836.7200000000003
8450,UCA8566,43,-7379.31,41,2,13076.02,5696.71
8451,UB58757,43,-1639.8600000000001,26,17,8367.7,6727.839999999999
8452,U062FC1,43,-1035.01,39,4,4159.06,3124.05
8453,U96F7D4,43,1934.3599999999997,37,6,6110.5999999999985,8044.96
8454,U7D644D,43,3706.570000000007,22,21,267363.05,271069.62
8455,U60C6A4,43,3400.4199999999996,37,6,9725.050000000001,13125.47
8456,UF54EEB,43,-10047.509999999998,38,5,51350.01,41302.5
8457,U473ABB,43,147.13,23,20,64664.5,64811.63
8458,U27CE10,43,8571.219999999992,34,9,100976.9,109548.12000000001
8459,U02529D,43,-2345.8199999999997,34,9,14249.33,11903.51
8460,U6EEECB,43,14446.25,29,14,46273.04,60719.29
8461,U7FED40,43,-2578.0899999999924,23,20,294842.24,292264.15
8462,UC4A59E,43,9632.760000000002,33,10,21260.739999999998,30893.5
8463,UCF2D87,43,-16246.399999999998,34,9,88799.90000000001,72553.5
8464,UC4438B,43,-2255.0000000000005,40,3,10804.9,8549.9
8465,UF6FCB9,43,203.55999999999938,40,3,3550.830000000001,3754.39
8466,UECF7DE,43,-36094.39000000001,41,2,82294.39,46200.0
8467,U7DAD1C,43,-961.92,40,3,3356.75,2394.83
8468,UB0A0AA,43,39935.17999999999,31,12,20899.619999999995,60834.8
8469,UE31639,43,1298.1399999999996,33,10,6061.400000000001,7359.54
8470,U7D6A6D,43,-185.72000000000025,39,4,8991.3,8805.58
8471,UA53CBE,43,802.6599999999999,27,16,21987.539999999997,22790.2
8472,U218AE0,43,-72.99999999999997,39,4,1641.36,1568.36
8473,UC749F7,43,8188.139999999993,35,8,32935.05,41123.189999999995
8474,UA6DF22,43,-838.2999999999884,24,19,362398.3,361560.0
8475,U099C8C,43,170.20000000000482,38,5,34924.59,35094.79
8476,U643401,43,-4050.71,40,3,4568.5599999999995,517.85
8477,U2FB0A6,43,-646.75,38,5,5046.75,4400.0
8478,UCB2C08,43,3078.099999999993,36,7,57229.740000000005,60307.84
8479,UB4EACB,43,669.5799999999996,40,3,2059.8300000000004,2729.41
8480,U3D47AB,43,-4507.86,28,15,17908.120000000003,13400.259999999998
8481,U38A991,43,2255.130000000001,36,7,19503.510000000006,21758.64
8482,UED6A60,43,805.4300000000005,30,13,14689.03,15494.460000000001
8483,UFC3B36,43,-194.08000000000004,26,17,2357.14,2163.06
8484,UAA90A5,43,-246.41999999999993,41,2,3127.7599999999998,2881.34
8485,UF42E08,43,-44.88000000000011,26,17,10094.02,10049.14
8486,UE1A90D,43,6312.870000000008,19,24,303537.25,309850.12
8487,U6C3892,43,597.3199999999996,35,8,9642.699999999999,10240.02
8488,U06443D,42,5698.639999999999,38,4,10167.39,15866.029999999999
8489,U4378BF,42,-5920.000000000002,36,6,53248.859999999986,47328.86
8490,U6FF985,42,-6467.999999999999,29,13,66964.78,60496.78
8491,U212A28,42,407.8000000000003,39,3,1263.37,1671.17
8492,UF35C3B,42,-8566.039999999999,40,2,18332.84,9766.8
8493,UC23A54,42,-1.3699999999999932,29,13,242.37,241.0
8494,UD31763,42,-257.89999999999986,31,11,5222.58,4964.679999999999
8495,UA29A30,42,13510.340000000004,27,15,91772.50999999998,105282.84999999999
8496,UA2EC9C,42,-7412.7699999999895,33,9,59056.74,51643.97
8497,U2D91D6,42,11045.69,35,7,38940.0,49985.69
8498,U67A01F,42,-648.3300000000002,40,2,3042.4500000000003,2394.12
8499,U05A9F7,42,529.3499999999999,33,9,11495.679999999995,12025.03
8500,U15E71C,42,-811.7199999999999,39,3,8411.970000000001,7600.25
8501,U372681,42,-2558.7800000000457,28,14,316757.58999999997,314198.80999999994
8502,U9226DF,42,466.29999999999745,36,6,23907.23,24373.53
8503,UE38D24,42,8859.0,27,15,109869.0,118728.0
8504,U5344B7,42,7515.37,33,9,2689.2000000000003,10204.57
8505,U74DE16,42,-19113.339999999997,27,15,150314.61000000002,131201.27000000002
8506,U7049E4,42,164.89999999999918,26,16,33918.12,34083.020000000004
8507,UE14689,42,357.66,35,7,4019.21,4376.869999999999
8508,UAD9A61,42,-298.2399999999999,39,3,13658.999999999998,13360.76
8509,U0717AC,42,10232.550000000001,37,5,3091.6000000000004,13324.15
8510,UD42192,42,-1190.45,36,6,6976.909999999999,5786.46
8511,U0F6FD0,42,7141.250000000006,31,11,69510.94000000002,76652.19
8512,UE5360F,42,-3919.510000000016,20,22,174338.26,170418.75
8513,U8BB541,42,1592.22,32,10,2197.0600000000004,3789.2799999999997
8514,U94E2D7,42,-409.0100000000001,38,4,6439.029999999999,6030.02
8515,UA2B5C1,42,-16423.609999999997,36,6,68595.17,52171.56
8516,U73A4D5,42,-470.9200000000017,36,6,49888.72,49417.8
8517,U7FE429,42,3978.9500000000003,29,13,5983.510000000001,9962.46
8518,U8663D4,42,908.8899999999999,38,4,2656.91,3565.8
8519,UB6D836,42,4032.8700000000026,35,7,27125.980000000003,31158.85
8520,U35C1E4,42,3098.430000000012,35,7,65966.15999999999,69064.59
8521,U27FED1,42,-297.0599999999977,24,18,129069.12000000001,128772.05999999998
8522,UF78CDD,42,818.050000000001,32,10,37079.92,37897.97
8523,UE88CED,42,-4639.529999999999,32,10,26254.75,21615.22
8524,UF10757,42,1010.0699999999996,35,7,2612.55,3622.62
8525,U028713,42,564.9200000000001,36,6,4801.08,5366.0
8526,U269ABB,42,-7094.15,37,5,22449.23,15355.08
8527,UE89AC7,42,-1328.9,39,3,10101.9,8773.0
8528,U4F26E5,42,1305.4700000000003,35,7,10713.279999999999,12018.75
8529,U7ED288,42,-5319.300000000002,36,6,18612.040000000005,13292.74
8530,U9EF0F5,42,5948.3200000000015,27,15,6703.0,12651.32
8531,UD188D6,42,207.0,27,15,19420.0,19627.0
8532,UA6F887,42,852.9300000000038,25,17,38645.25000000001,39498.18
8533,U556B53,42,-6922.82,35,7,15057.34,8134.52
8534,U249262,42,-2021.8099999999986,28,14,49842.59,47820.78
8535,U1D0DE8,42,-6761.989999999999,40,2,9859.56,3097.57
8536,U9FBC2E,42,-671.7299999999999,39,3,1591.5399999999997,919.8100000000001
8537,U1E8CE4,42,811.3799999999998,21,21,8023.21,8834.589999999998
8538,U04589C,42,-9750.43,36,6,22612.5,12862.07
8539,U77D858,42,146.28000000000006,39,3,1188.75,1335.03
8540,UCEF04B,42,1.4000000000013642,27,15,6846.45,6847.85
8541,U6B8F87,42,844.2500000000001,32,10,3755.22,4599.47
8542,UA26792,42,6682.079999999998,38,4,8831.61,15513.689999999999
8543,U7C0805,42,-409.0399999999996,33,9,6262.380000000001,5853.34
8544,U4BF1E0,42,81.00000000000021,24,18,2893.9,2974.9
8545,U77AAAA,42,-1185.8899999999999,39,3,3848.72,2662.83
8546,UF14DE3,42,-4450.179999999999,42,0,4450.179999999999,0.0
8547,UB03FF7,42,2515.4299999999994,31,11,10525.12,13040.550000000001
8548,U6168F5,42,922.819999999999,38,4,2110.2900000000004,3033.11
8549,U97C2F2,42,3607.010000000001,25,17,54012.310000000005,57619.32
8550,U333D80,42,-5055.19,26,16,7834.05,2778.86
8551,U49CF21,42,-645022.25,35,7,675271.0,30248.75
8552,UB7A30E,42,-100405.08999999998,31,11,102213.51,1808.42
8553,U384F9B,42,22505.080000000005,31,11,44044.75999999999,66549.84
8554,U992DB2,42,-4941.52999999997,36,6,561169.49,556227.96
8555,UA27F38,42,-4521.550000000001,33,9,15231.809999999998,10710.26
8556,U3BBB75,42,-34766.25000000001,30,12,87763.26999999999,52997.02
8557,U7BCFE2,42,-440.0199999999997,35,7,31601.6,31161.58
8558,UDDAB86,42,-1672.949999999997,22,20,83781.62,82108.67000000001
8559,UCA5445,42,12708.350000000002,32,10,23496.520000000004,36204.869999999995
8560,U56BC64,42,-2959.1,24,18,18242.1,15283.0
8561,UB702DB,42,34378.81,35,7,41030.96000000001,75409.77
8562,U121E8A,42,-2999.680000000003,20,22,129568.94,126569.26
8563,UFB1B3D,42,237.97000000000116,23,19,66733.59,66971.56
8564,U016B62,42,-15779.45,38,4,30560.45,14781.0
8565,U0DA016,42,-5842.349999999999,25,17,5989.37,147.01999999999998
8566,UF9329C,42,-309.98000000000013,38,4,4334.380000000001,4024.4
8567,U7C2800,42,-9.999999999999545,23,19,18739.809999999998,18729.81
8568,UF02816,42,20.01999999999687,32,10,52449.82,52469.840000000004
8569,U40B9E8,42,-363.0,35,7,16363.0,16000.0
8570,U5DE8B1,42,121614.31,31,11,23897.0,145511.31
8571,UA993B1,42,-22132.920000000002,33,9,150341.69999999998,128208.78000000001
8572,U772B12,42,0.47999999999955634,30,12,27619.410000000003,27619.890000000003
8573,UB3A26A,42,-13331.119999999999,38,4,21298.62,7967.5
8574,UA0CA3C,42,-313.32999999999674,31,11,87365.81,87052.48
8575,UE50F3B,42,-11260.84,34,8,15669.59,4408.75
8576,U4B8D1E,42,-1461.9200000000017,36,6,5546.25,4084.33
8577,UACC105,42,-1298.0800000000017,40,2,13070.080000000002,11772.0
8578,UBC6E5E,42,-3763.390000000002,18,24,102747.86000000002,98984.46999999999
8579,UBC90B9,42,-6035.449999999999,30,12,34190.60999999999,28155.160000000003
8580,UD395F5,42,1813.029999999983,28,14,137995.80000000002,139808.83000000002
8581,UAB0858,42,-6530.249999999999,24,18,67550.02,61019.770000000004
8582,UB22C67,42,1088.8899999999999,38,4,4127.210000000001,5216.1
8583,UDCFD6A,42,9163.32,17,25,32572.21,41735.53
8584,UFCCFAA,42,11185.12,35,7,19045.889999999996,30231.010000000002
8585,UDE2C9D,42,2778.3199999999997,40,2,2121.6800000000003,4900.0
8586,U3F9844,42,397.43999999999994,32,10,7469.549999999999,7866.99
8587,U7E5B5A,42,79.95000000000164,24,18,31330.34,31410.29
8588,U270363,42,-1716.0400000000004,27,15,5117.07,3401.0299999999997
8589,U139886,42,-3864.7499999999973,37,5,13226.669999999998,9361.92
8590,UFAFBAA,42,1796.8699999999997,38,4,1629.4600000000003,3426.33
8591,UC39E91,42,-38.04000000000022,24,18,29332.1,29294.059999999998
8592,UE4475C,42,469.05999999999995,37,5,15824.4,16293.46
8593,UC525F9,42,-33853.14,32,10,122222.34,88369.2
8594,U6F4B7F,42,-5997.24,35,7,7184.829999999999,1187.5900000000001
8595,UAE5C6B,42,403.40999999999894,23,19,40755.0,41158.41
8596,UED97A6,42,-57389.419999999984,23,19,1311044.47,1253655.0499999998
8597,U2D2619,42,-1225125.5500000003,30,12,1427373.0999999999,202247.55
8598,UF2BFD0,42,-11737.41,39,3,20239.66,8502.25
8599,UBA30A1,42,-3175.8099999999977,34,8,19167.989999999998,15992.18
8600,UD687C0,42,-117477.3,38,4,162524.3,45047.0
8601,U1E2D14,42,199.59000000000006,37,5,2005.0200000000002,2204.61
8602,U562461,42,-24210.64,36,6,25910.92,1700.28
8603,U41F281,42,-904.2299999999999,40,2,4114.6,3210.37
8604,U4468C7,42,-2489.2799999999997,40,2,4063.6700000000005,1574.39
8605,U2493BA,42,148921.75999999998,27,15,1256244.9200000002,1405166.68
8606,U14A804,42,27465.340000000004,34,8,81424.69999999998,108890.04000000001
8607,U7E6469,42,43265.490000000005,29,13,54566.64,97832.13
8608,UEE0EAD,42,87.65,37,5,18386.35,18474.0
8609,U69F1EB,42,51453.5,29,13,176074.82,227528.32
8610,U888A76,42,34767.75999999999,35,7,37231.4,71999.16
8611,U6E59F3,42,-27900.800000000003,20,22,90385.8,62485.0
8612,U180B50,42,-380.2900000000003,25,17,13279.109999999999,12898.82
8613,U48856F,42,172865.58999999997,24,18,43435.51000000001,216301.09999999998
8614,U7C5068,42,18184.72,17,25,249099.01,267283.73
8615,U82E1FC,42,-1156.9800000000002,40,2,3211.68,2054.7
8616,U98DBBE,42,26736.679999999986,13,29,144489.0,171225.68
8617,U03EE22,42,-2195.6499999999987,32,10,24089.87,21894.22
8618,U3B5085,42,10299.549999999997,32,10,11531.69,21831.239999999998
8619,UBC8EA7,42,-4707.540000000002,31,11,42123.7,37416.16
8620,U2EA407,42,-49520.47999999999,38,4,59588.09999999999,10067.619999999999
8621,UDCAA41,42,-2703.1000000000035,5,37,29421.43,26718.32999999999
8622,U6177E8,42,-604.9399999999998,37,5,1597.01,992.0699999999999
8623,U196843,42,-10685.940000000002,32,10,55894.96,45209.020000000004
8624,UD19BA6,42,-208.42999999999847,21,21,72478.74,72270.31000000001
8625,U500FF1,42,1676.6000000000004,32,10,9725.35,11401.95
8626,U9755BB,42,-470.70000000000016,27,15,24322.969999999998,23852.27
8627,U0D86A5,42,45.10000000000002,32,10,2393.5,2438.6
8628,UD91ED0,42,-8562.950000000003,30,12,41362.950000000004,32800.0
8629,UE352D2,42,5601.41999999994,13,29,801489.3,807090.72
8630,U31A559,42,3452.4400000000005,30,12,51562.51,55014.950000000004
8631,U0BAC4B,42,-658.6900000000005,37,5,5156.13,4497.4400000000005
8632,U9FD237,42,-132.14000000000124,33,9,14788.939999999999,14656.8
8633,UB25CE4,42,42785.99999999999,27,15,50337.59,93123.59
8634,U8D0DF5,42,-4689.890000000069,29,13,725756.9400000001,721067.05
8635,UD563D2,42,1100.1699999999998,38,4,3530.830000000001,4631.0
8636,UF5C1BC,42,5292.719999999994,37,5,60730.71,66023.43
8637,UE391BD,42,-13421.910000000003,37,5,39738.1,26316.19
8638,U0740A6,42,0.0,21,21,8536.0,8536.0
8639,UA717A4,42,-1908.6200000000026,35,7,48659.69,46751.07
8640,U6A1720,42,20.2300000000007,28,14,11180.48,11200.710000000001
8641,U02F64D,42,20894.54000000001,35,7,27988.26999999999,48882.80999999999
8642,U56FCD5,42,-2501.510000000001,38,4,54793.51000000001,52292.0
8643,UE7D61A,42,11.579999999999956,34,8,3139.41,3150.9900000000002
8644,U6470E7,42,-525.8300000000015,35,7,27381.32,26855.489999999998
8645,U8C8924,42,34475.82999999999,30,12,131710.0,166185.83
8646,U9BF153,42,3499.4699999999993,34,8,15139.76,18639.23
8647,UC28EDB,42,2151.709999999999,35,7,3069.4100000000003,5221.12
8648,U7DA62E,41,779.7900000000006,35,6,7123.960000000001,7903.75
8649,U24E344,41,7264.13,29,12,14444.079999999998,21708.209999999995
8650,U81CAB3,41,-2343.8299999999986,28,13,72505.01000000001,70161.18
8651,U1771BD,41,-202.5,36,5,8162.71,7960.21
8652,U5C3AC7,41,-2247.3999999999996,38,3,6788.3099999999995,4540.91
8653,U711B5E,41,765.2299999999998,34,7,2594.7999999999997,3360.0299999999997
8654,UA2A030,41,-43.37999999999997,38,3,6523.0,6479.62
8655,U98E9C2,41,-6861.610000000001,32,9,116970.45999999999,110108.84999999999
8656,U13062B,41,-18708.249999999985,33,8,254289.94999999995,235581.7
8657,UE6BBE4,41,-444.85999999999996,39,2,1433.3599999999997,988.5
8658,U815C97,41,-22175.050000000007,37,4,70095.48000000001,47920.43
8659,U28A6AF,41,2379.1000000000004,25,16,29261.88,31640.980000000003
8660,U00D2BE,41,-4706.669999999998,21,20,42781.21,38074.54
8661,U7814B2,41,4754.779999999999,33,8,8839.320000000002,13594.1
8662,U65C797,41,-112.46999999999991,35,6,1252.5500000000002,1140.08
8663,UDB147D,41,-1008.280000000002,28,13,46114.39000000001,45106.11
8664,U9D0B04,41,81.47999999999996,30,11,892.42,973.9000000000001
8665,U9F8D09,41,8657.19,38,3,22440.91,31098.1
8666,UA61C56,41,-7492.499999999999,39,2,10032.900000000001,2540.4
8667,UD70CE7,41,623.1500000000015,31,10,78779.48,79402.63
8668,U91F7F9,41,-8951.629999999997,35,6,23117.769999999997,14166.14
8669,U60C3A9,41,1405.3099999999995,39,2,12894.689999999999,14300.0
8670,U478356,41,18943.100000000002,38,3,78056.90000000001,97000.0
8671,U8B7A5F,41,1980.1500000000003,37,4,2830.36,4810.51
8672,U116B99,41,-955.6999999999999,39,2,1409.9999999999998,454.3
8673,U801367,41,-688.5999999999932,35,6,55870.05000000002,55181.45
8674,U0A227C,41,-12381.99,36,5,15763.07,3381.08
8675,UFCBE21,41,-64.1499999999901,32,9,247779.97,247715.81999999998
8676,UA5EE7D,41,941.7599999999984,36,5,7337.820000000001,8279.58
8677,U318919,41,10947.35,35,6,27966.3,38913.65
8678,U8D62AE,41,-10980.0,28,13,21996.0,11016.0
8679,U1B7FDA,41,-9705.460000000001,38,3,12582.01,2876.55
8680,UCA0740,41,38.879999999999924,20,21,3476.4700000000003,3515.3500000000004
8681,U48D28C,41,4591.069999999999,25,16,17525.199999999997,22116.27
8682,UD60AA6,41,-639.5699999999998,36,5,712.6099999999998,73.03999999999999
8683,U9F2309,41,1885.5499999999997,35,6,13862.84,15748.39
8684,UDB0CE0,41,-140.14000000000001,35,6,1706.7699999999998,1566.6299999999999
8685,U4A7321,41,-2012.3700000000003,34,7,5174.57,3162.2
8686,U305DE0,41,19936.089999999997,29,12,13581.599999999999,33517.69
8687,UD7D692,41,5335.959999999999,21,20,9533.1,14869.060000000001
8688,UE625D4,41,-9165.02,39,2,12098.66,2933.6400000000003
8689,U4D3678,41,-10346.339999999995,37,4,30401.39,20055.05
8690,U3414DB,41,-3053.7800000000007,25,16,17282.72,14228.939999999999
8691,U29E45D,41,-429727.7299999999,26,15,1117982.57,688254.8399999999
8692,U66C54E,41,-1533.9100000000003,39,2,3365.790000000001,1831.8799999999999
8693,U5721AA,41,-8895.350000000002,32,9,28065.800000000003,19170.45
8694,UCA7B55,41,-143.68000000000004,29,12,2157.46,2013.78
8695,UD6B339,41,6262.020000000001,33,8,3400.7400000000002,9662.759999999998
8696,UF2ADFD,41,-21.51000000000022,23,18,37131.53,37110.020000000004
8697,U260C6D,41,-388.86999999999983,36,5,2417.37,2028.5
8698,U496E72,41,6923.6,37,4,2422.4,9346.0
8699,U333E00,41,-5186.150000000001,30,11,37994.880000000005,32808.729999999996
8700,U1C6AED,41,57719.52,35,6,9280.58,67000.1
8701,U2B0251,41,-165897.36000000002,35,6,185628.38,19731.02
8702,U8148B5,41,2085.73,36,5,3797.6799999999994,5883.41
8703,UB17E7D,41,-13.460000000000946,27,14,25215.98,25202.52
8704,U768FA6,41,-487.10000000000036,24,17,22598.820000000003,22111.72
8705,U842FC8,41,-1.9899999999998883,21,20,1941.4,1939.41
8706,UEFC465,41,-538.8800000000008,27,14,6115.04,5576.160000000003
8707,U6D9CAE,41,35811.26,36,5,15979.130000000001,51790.39
8708,U73FDD4,41,3.5399999999999636,34,7,3057.07,3060.6099999999997
8709,U19E14D,41,1672.54,37,4,2530.46,4203.0
8710,UDADC62,41,1092.0099999999966,29,12,42242.19,43334.200000000004
8711,U8E2256,41,-114.10000000000004,40,1,400.8699999999999,286.77
8712,UCB6E44,41,-115.74000000000001,32,9,3395.76,3280.02
8713,UF9F962,41,5310.349999999995,32,9,75420.06999999999,80730.42
8714,U66BA04,41,-2560.1700000000005,32,9,12847.27,10287.1
8715,UDB3C75,41,-1341.799999999999,37,4,10112.1,8770.3
8716,UC9A565,41,-6363.780000000002,29,12,38645.06,32281.28
8717,UC17713,41,981.6000000000001,32,9,5845.91,6827.51
8718,U98208C,41,233235.51,20,21,943172.7999999999,1176408.31
8719,U8F56FF,41,2260.800000000001,24,17,97553.64000000001,99814.43999999999
8720,U7D9E6D,41,-1476.19,40,1,1548.07,71.88
8721,UAFE22D,41,25.010000000002037,32,9,44872.7,44897.71
8722,U2044FE,41,-4509.999999999999,24,17,36161.5,31651.5
8723,U91859F,41,14.159999999998035,29,12,45544.45,45558.60999999999
8724,UA47FBB,41,-452.4299999999997,39,2,6359.430000000001,5907.0
8725,U990B66,41,-8992.75,23,18,86252.0,77259.25
8726,U76D1C9,41,-58.99999999999761,36,5,35391.95999999999,35332.96
8727,U99558B,41,1827.8499999999997,39,2,1895.34,3723.19
8728,UCB5311,41,-1955.109999999998,35,6,21301.13,19346.02
8729,U230EA4,41,16082.49,30,11,3476.9900000000002,19559.48
8730,U1DE8EB,41,-11435.59,37,4,18070.33,6634.74
8731,U16626D,41,10.300000000000068,39,2,1099.6999999999998,1110.0
8732,UC3299A,41,-9370.130000000005,22,19,67353.93,57983.799999999996
8733,UED3655,41,10991.399999999989,33,8,96949.23999999998,107940.64
8734,UCA7B91,41,3765.0399999999995,20,21,5863.5,9628.539999999999
8735,UF0123E,41,-31676.999999999996,39,2,40677.0,9000.0
8736,UE25A39,41,-6491.229999999999,39,2,18473.059999999998,11981.83
8737,UD15CB6,41,1250.8600000000004,38,3,3949.1,5199.959999999999
8738,U6979F9,41,27335.029999999984,22,19,169864.85000000003,197199.88000000003
8739,U1FB747,41,1247.8,34,7,4171.9400000000005,5419.74
8740,UE5813F,41,-1724.2499999999998,36,5,11047.36,9323.11
8741,UDABE0E,41,649.9799999999996,29,12,11858.400000000001,12508.380000000001
8742,UC4F9AF,41,2953.7499999999964,35,6,18225.45,21179.2
8743,UB5910A,41,1344.4500000000007,31,10,20166.489999999998,21510.940000000002
8744,U4B7EEE,41,178.33999999999847,33,8,21321.66,21500.0
8745,UAF40EF,41,-3990.170000000002,38,3,20365.9,16375.73
8746,U625052,41,-2677.34,37,4,4323.83,1646.49
8747,UDF5DA3,41,-6668.8,31,10,36128.83999999999,29460.04
8748,UC50FD7,41,-28926.75,17,24,174721.0,145794.25
8749,U7AEF6C,41,115224.72999999998,24,17,51058.56,166283.29
8750,U2DC150,41,6.149999999999839,27,14,1198.4,1204.55
8751,U8176E4,41,17569.659999999996,26,15,118175.2,135744.86
8752,UE83BC5,41,-5.1000000000004775,23,18,6396.1,6391.0
8753,UB43E5E,41,16278.439999999999,36,5,11024.979999999998,27303.420000000002
8754,U61C1B6,41,148.8199999999998,26,15,4119.0,4267.82
8755,U606900,41,-47.960000000001756,28,13,40955.35,40907.39
8756,U6F87BE,41,3546.7699999999986,29,12,36011.76,39558.53
8757,U006D05,41,-1015.2000000000006,27,14,6043.100000000001,5027.9
8758,U0447BA,41,22358.36,31,10,70086.25999999997,92444.62
8759,U10A4F8,41,-8409.970000000001,32,9,16805.120000000003,8395.150000000001
8760,U10E658,41,1482.3400000000015,34,7,11359.87,12842.21
8761,UF3D6B9,41,-431.7200000000007,24,17,19981.72,19550.0
8762,U43F0CD,41,1070.65,38,3,3886.76,4957.41
8763,U4522D4,41,-8137.0,39,2,9849.0,1712.0
8764,U165C0E,41,-1670.6400000000008,37,4,9206.56,7535.92
8765,U2333D1,41,1572.729999999996,6,35,156098.0,157670.72999999998
8766,UA9B6ED,41,2374.19,2,39,4130.0,6504.1900000000005
8767,UB2854D,41,779.5,38,3,6464.0,7243.5
8768,U7BC013,41,-5338.489999999999,34,7,10539.829999999998,5201.34
8769,U5AB021,41,1803.0199999999998,35,6,65453.97,67256.99
8770,UB57B4C,41,-1268.23,22,19,115480.81,114212.58
8771,UFAFFF7,41,-1573.78,33,8,8163.120000000001,6589.34
8772,U33C114,41,-2982.299999999999,33,8,19054.370000000003,16072.07
8773,UE9297C,41,-6412.239999999999,32,9,7019.329999999999,607.09
8774,U220A27,41,891.26,35,6,2181.6499999999996,3072.91
8775,U1872F4,41,-796.4400000000007,35,6,5194.630000000001,4398.1900000000005
8776,U64B7E2,41,-4092.659999999999,32,9,15120.93,11028.27
8777,UA49F29,41,-689.08,37,4,3340.37,2651.2899999999995
8778,U356C0F,41,1191.2999999999993,29,12,78620.7,79812.0
8779,U54D025,41,4144.489999999999,37,4,3964.230000000001,8108.719999999999
8780,UD6D6C4,41,31617.390000000014,33,8,75860.81999999996,107478.20999999999
8781,U74FBCC,41,-3718.09,34,7,104881.87999999999,101163.79000000001
8782,U5F2696,41,0.8600000000001273,21,20,10297.210000000001,10298.07
8783,UED14E2,41,2774.8099999999995,31,10,19319.66,22094.47
8784,UE8C920,41,-941.1000000000001,37,4,3747.2100000000005,2806.1099999999997
8785,U3DF85F,41,-1159.98,37,4,7310.8,6150.82
8786,UFC0745,41,-113.78000000000004,38,3,936.4699999999999,822.69
8787,U72E054,41,-17663.6,39,2,18144.41,480.81
8788,U172162,41,1135.2100000000003,27,14,13274.86,14410.07
8789,U6F1F09,41,141183.47999999998,27,14,416037.19,557220.67
8790,U5EA446,41,-1950.6100000000004,30,11,10040.610000000002,8090.0
8791,U3E1665,41,5447.82,22,19,91467.59000000001,96915.41
8792,UD28773,41,-15066.449999999995,31,10,164177.15000000002,149110.7
8793,U11C640,41,-1721.6899999999998,36,5,8757.43,7035.74
8794,UF3D992,41,-7244.11,39,2,10362.11,3118.0
8795,UBE116C,41,-1209.1399999999994,32,9,80688.42,79479.28
8796,U46AA56,41,-7994.529999999999,19,22,346860.67,338866.14
8797,U995476,40,-717.0099999999996,35,5,16834.379999999997,16117.37
8798,UF88037,40,59856.80999999998,31,9,17704.739999999998,77561.55
8799,UF94C5A,40,-604.1099999999998,32,8,2218.11,1614.0
8800,U08D1BC,40,-1249.2499999999982,21,19,129696.04999999999,128446.8
8801,UFC53E7,40,1602.420000000001,29,11,24965.14,26567.559999999998
8802,UD59D1A,40,-5059.76,34,6,17240.510000000002,12180.75
8803,UF06CCE,40,2227.5800000000017,32,8,25790.550000000003,28018.13
8804,UFB809B,40,552.2900000000002,34,6,2221.31,2773.6
8805,U8D02F6,40,-255.6400000000067,33,7,53258.67,53003.02999999999
8806,U97BAB8,40,-7048.269999999997,33,7,33620.649999999994,26572.38
8807,U719E9D,40,-709.5699999999997,35,5,21344.67,20635.1
8808,U7E2719,40,4470.0,0,40,0.0,4470.0
8809,U97B280,40,-118.7099999999997,36,4,6622.7699999999995,6504.06
8810,U7791BB,40,802.0300000000001,25,15,8421.720000000001,9223.75
8811,U11B047,40,20742.170000000006,35,5,22904.87,43647.04
8812,U7ED3EC,40,-34682.090000000004,29,11,167669.31000000003,132987.22
8813,U86B55E,40,-30874.859999999997,38,2,33519.68,2644.8199999999997
8814,U4F1A55,40,120383.51000000001,17,23,144560.24,264943.75
8815,UC19C34,40,1112.1400000000008,32,8,30778.91,31891.05
8816,U874487,40,466.1199999999999,35,5,19602.030000000002,20068.149999999998
8817,UC9D6A6,40,-2401.7900000000054,31,9,53748.29000000001,51346.50000000001
8818,U1CC658,40,-1958.8500000000001,39,1,1962.0300000000002,3.18
8819,U7036FA,40,18.380000000000035,32,8,884.88,903.26
8820,U11A985,40,11845.559999999998,31,9,46799.0,58644.56
8821,U18D06B,40,42.259999999999934,26,14,3856.4,3898.66
8822,U0BF1DC,40,59940.04,21,19,31061.86,91001.9
8823,U807B63,40,-2383.1399999999994,30,10,17432.48,15049.34
8824,UD54751,40,-2557.4900000000016,34,6,15433.410000000003,12875.92
8825,U0BBA1A,40,-13097.629999999997,24,16,625159.7000000001,612062.07
8826,UFCF8C6,40,-6569.58,29,11,17845.579999999998,11276.0
8827,UF9E116,40,-8000.299999999998,25,15,40975.16,32974.85999999999
8828,U0F25C4,40,3.770000000000209,34,6,5501.6,5505.37
8829,U2C0024,40,-1384.1099999999994,36,4,20178.270000000004,18794.160000000003
8830,UA0987A,40,-2532.869999999999,28,12,64035.259999999995,61502.39
8831,U809EE6,40,-102.02000000000044,31,9,7200.610000000001,7098.589999999999
8832,U577086,40,27372.459999999995,29,11,117372.62999999999,144745.09
8833,UEBBBA7,40,2114.209999999999,29,11,73690.54000000001,75804.75
8834,U417C79,40,-387.27999999999975,32,8,9288.619999999999,8901.339999999998
8835,U0EB4FC,40,-17.650000000000006,38,2,1005.65,988.0
8836,UE0366D,40,652.3600000000001,35,5,14837.64,15490.0
8837,UD30C74,40,-69.18000000000029,23,17,25369.18,25300.0
8838,U84578C,40,7312.24,34,6,19921.04,27233.28
8839,UC5BFF6,40,15.530000000000086,21,19,17606.679999999997,17622.21
8840,UF904B3,40,16131.420000000007,33,7,40227.35999999998,56358.780000000006
8841,U9FAA02,40,-27264.400000000045,21,19,1424863.27,1397598.8699999999
8842,U06AF3B,40,7138.800000000002,33,7,6617.88,13756.68
8843,U34BE0D,40,-7366.419999999995,24,16,133440.03000000003,126073.61000000002
8844,U9260B6,40,2050.450000000001,37,3,5949.55,8000.0
8845,U328465,40,-12305.43,35,5,20597.97,8292.54
8846,UFC0717,40,-1179.8199999999997,36,4,4952.32,3772.5
8847,UFED62A,40,315.97000000000116,26,14,47479.84,47795.81
8848,UAC3F90,40,1369.7399999999998,37,3,3406.91,4776.65
8849,UC3E488,40,994.0500000000001,36,4,4417.4,5411.45
8850,UE53E24,40,-13.259999999999945,27,13,4827.53,4814.27
8851,UC965DF,40,-573.5600000000002,34,6,5506.87,4933.3099999999995
8852,U7714DC,40,-3762.1200000000144,20,20,187615.74,183853.62000000002
8853,UBBA81F,40,10866.83,22,18,4913.17,15780.0
8854,UD1ED2E,40,3473.4799999999923,22,18,126882.48000000004,130355.96
8855,U9549CD,40,315.08000000000004,26,14,1148.73,1463.81
8856,UE52533,40,53076.150000000016,30,10,108813.24,161889.38999999998
8857,U4ADB39,40,34059.28999999999,28,12,274908.95,308968.24
8858,U33ADAE,40,-4243.9,39,1,4244.0599999999995,0.16
8859,UE99F16,40,-3334.619999999998,36,4,34292.62000000001,30958.0
8860,U15335F,40,-9098.29,31,9,59262.35999999999,50164.07
8861,U59991F,40,1725.7099999999996,32,8,5127.86,6853.57
8862,U64CCD2,40,-1427.1099999999979,37,3,20837.6,19410.489999999998
8863,U35AEA2,40,-613.6900000000003,38,2,5241.5199999999995,4627.83
8864,UCE813D,40,-8637.090000000002,37,3,16825.440000000002,8188.35
8865,UFA3BE3,40,-57.09000000000003,31,9,6126.049999999999,6068.96
8866,U59F6D5,40,0.06999999999970896,20,20,52000.89,52000.96
8867,UDAB0C6,40,-2901.3700000000003,35,5,13205.630000000001,10304.26
8868,UB023AB,40,2214.6900000000005,30,10,2512.4400000000005,4727.129999999999
8869,U38D1DE,40,-3004.530000000001,35,5,9708.389999999998,6703.86
8870,U3BF22C,40,98.87000000000035,26,14,10708.91,10807.779999999999
8871,UE61209,40,-1404.5000000000002,37,3,4623.71,3219.21
8872,U637A72,40,-3795.809999999999,32,8,12318.41,8522.6
8873,U509C50,40,373.64,38,2,1953.8000000000002,2327.44
8874,UA462C3,40,-1132.2000000000003,36,4,5411.570000000001,4279.370000000001
8875,U8ADFDF,40,19361.15,21,19,41760.26,61121.41
8876,U423EA2,40,8893.810000000001,35,5,5558.69,14452.500000000002
8877,UD7AA3B,40,1916.4400000000023,21,19,66240.22,68156.66
8878,UF86B58,40,3.5800000000005454,36,4,3355.24,3358.82
8879,U55F357,40,2829.949999999991,31,9,227024.28,229854.22999999998
8880,U0A4AF6,40,-4856.740000000001,25,15,107758.93,102902.19000000002
8881,U736BA5,40,-8444.45,36,4,11632.380000000001,3187.9300000000003
8882,UE1B5F9,40,-3077.5999999999954,25,15,82564.88,79487.28
8883,U246274,40,-19170.07,35,5,19172.829999999998,2.7599999999999993
8884,UCFCDFD,40,1119.6299999999953,21,19,112719.95,113839.57999999999
8885,U5E7706,40,115.55000000000086,37,3,9462.74,9578.29
8886,U35ADF1,40,-2383.83,35,5,7958.200000000001,5574.37
8887,UE11116,40,174.54999999999973,24,16,25657.129999999997,25831.680000000004
8888,UAE1386,40,2060.7,37,3,4677.35,6738.05
8889,U2AA92A,40,308.1,26,14,14408.599999999999,14716.699999999999
8890,U66F8A7,40,-1462.9299999999992,32,8,9103.45,7640.52
8891,U5EAF8B,40,-4140.720000000008,23,17,86437.52000000002,82296.80000000002
8892,U5324F6,40,411.39000000000016,36,4,1324.4099999999999,1735.8
8893,UFCBA24,40,-2142.9499999999994,22,18,14727.19,12584.24
8894,UCA502D,40,-2622.77,38,2,6731.23,4108.46
8895,UBD0F45,40,7053.779999999998,33,7,37360.34,44414.119999999995
8896,UFCFF9D,40,-15576.460000000001,35,5,19579.46,4003.0
8897,U248C63,40,-885.3299999999998,28,12,10403.269999999999,9517.94
8898,U568490,40,7824.010000000001,33,7,11981.5,19805.510000000002
8899,U482165,40,23.240000000001707,22,18,25288.620000000003,25311.860000000008
8900,UA8B3BD,40,334.8700000000026,31,9,15742.290000000005,16077.16
8901,UA39340,40,-6275.94,30,10,18555.879999999997,12279.94
8902,U7ECDA1,40,1328.5499999999997,35,5,6669.670000000001,7998.219999999999
8903,U4AF51F,40,621.3099999999977,29,11,67202.0,67823.31
8904,U53049B,40,-2496.7899999999963,31,9,67949.4,65452.61
8905,U2B5946,40,13199.569999999998,33,7,10144.549999999997,23344.12
8906,U116529,40,2521.7000000000025,26,14,76503.05,79024.75
8907,UBB9AB3,40,225510.5,25,15,85261.87,310772.37
8908,UE5B1E2,40,-411.1399999999998,35,5,2324.7200000000003,1913.5800000000002
8909,UF7E9C9,40,71462.32,20,20,129837.68,201300.0
8910,UAF207F,40,1146.9899999999996,26,14,7662.01,8809.0
8911,UA80C1C,40,-15564.740000000005,33,7,64415.950000000004,48851.21
8912,U8086E1,40,-2380.779999999998,31,9,6550.95,4170.17
8913,U3B0D45,40,-640.2200000000023,37,3,16885.749999999996,16245.529999999999
8914,U740D65,40,141.27999999999997,33,7,2462.6,2603.88
8915,U00DEC9,40,186.8399999999998,38,2,2345.9300000000003,2532.77
8916,UA66775,40,12642.31,33,7,71885.93999999999,84528.25
8917,U6C4ED9,40,-21.629999999999754,38,2,2947.3,2925.67
8918,U13C6A5,40,-1276.23,37,3,4777.88,3501.65
8919,U506B2C,40,-2775.6000000000004,34,6,15412.039999999999,12636.439999999999
8920,UAC4E25,40,-3082.740000000001,32,8,28435.09,25352.350000000002
8921,U284B59,40,1585.6099999999997,36,4,6948.230000000002,8533.84
8922,U1721B1,40,-1424.4299999999998,34,6,4771.15,3346.72
8923,UD607E3,40,1403.63,37,3,3494.9100000000003,4898.54
8924,U647393,40,-2643.15,36,4,5380.01,2736.86
8925,UCC7A7C,40,420.27000000000004,35,5,1539.2,1959.47
8926,U1E57AD,40,223.7800000000001,31,9,4951.16,5174.9400000000005
8927,U2B8236,40,19377.590000000004,21,19,177654.8,197032.39
8928,U71F253,40,-888.9400000000002,28,12,5453.139999999999,4564.2
8929,U060C15,40,150306.09999999998,27,13,287597.9,437904.0
8930,U59A122,40,-96.04999999999993,38,2,1472.31,1376.26
8931,U53D30F,40,-6454.08,38,2,6531.63,77.55
8932,U64B12C,40,163269.15,24,16,171641.84,334910.99
8933,U455399,40,-35027.74999999999,35,5,59668.09,24640.34
8934,UF28448,40,7742.119999999999,34,6,40724.46999999999,48466.59
8935,U49E758,40,369.2400000000007,33,7,5337.509999999999,5706.75
8936,U9C56D5,40,288.80999999999983,29,11,4226.039999999999,4514.849999999999
8937,UFB9B08,40,-951.2800000000279,20,20,346954.42,346003.14
8938,UD2B45F,40,-330.9400000000001,34,6,2111.5299999999997,1780.59
8939,U69CC72,40,-31.119999999999663,31,9,2201.3500000000004,2170.23
8940,UCB4C01,40,41.17999999999954,32,8,10353.93,10395.11
8941,U722042,40,-18230.31,36,4,65171.909999999996,46941.6
8942,UDC204B,39,109.6599999999944,23,16,89674.38999999998,89784.05
8943,U2254FA,39,8860.0,35,4,8430.03,17290.03
8944,UD454E7,39,-3757.76,35,4,4871.799999999999,1114.04
8945,UA271EF,39,370.8499999999995,37,2,5145.150000000001,5516.0
8946,U220D64,39,15623.150000000009,35,4,39952.82,55575.97000000001
8947,U879ABE,39,-15118.990000000002,29,10,39169.74,24050.75
8948,UF16252,39,35250.729999999996,35,4,16611.270000000004,51862.0
8949,U6EE4E9,39,18.269999999999754,30,9,2829.71,2847.9799999999996
8950,U9DF127,39,1530.9599999999998,30,9,4044.3500000000004,5575.3099999999995
8951,UDB225F,39,2511.3299999999986,35,4,1620.2299999999998,4131.5599999999995
8952,UB95833,39,-356.80999999999983,31,8,2842.8,2485.99
8953,U3F6592,39,-547.530000000003,32,7,20897.93,20350.4
8954,U2F5D1F,39,-709.2900000000009,31,8,49620.5,48911.21
8955,U57458B,39,-2637.59,21,18,101018.23999999999,98380.65
8956,U468EE8,39,-7256.760000000001,34,5,14259.7,7002.94
8957,U17D003,39,57095.92,30,9,72533.56999999999,129629.48999999999
8958,UB63837,39,-90.2199999999998,34,5,1039.6499999999999,949.4300000000001
8959,UC10B44,39,7168.269999999999,23,16,5841.320000000001,13009.59
8960,UD388D6,39,25911.63,20,19,67853.8,93765.43000000001
8961,U8E322B,39,-6482.590000000009,27,12,113021.16,106538.57
8962,UF27ADA,39,-15684.179999999998,28,11,41994.05,26309.870000000003
8963,UC4CB78,39,-2786.75,31,8,26159.989999999998,23373.239999999998
8964,U0D1946,39,-574.5299999999999,37,2,2441.83,1867.3
8965,U345601,39,1342.9899999999998,38,1,2137.4100000000003,3480.4
8966,U4F5335,39,-89.63999999999851,22,17,31335.12,31245.480000000003
8967,U45808F,39,-3622.08,31,8,7268.45,3646.37
8968,UCE8821,39,-5.4569682106375694e-12,19,20,63422.92999999999,63422.92999999999
8969,UC276F7,39,2362.27,24,15,15780.380000000001,18142.650000000005
8970,UDC45D7,39,3426.7900000000013,27,12,69723.37,73150.16
8971,U0E44B1,39,3475.99,33,6,972.8000000000001,4448.79
8972,UE17171,39,816.3199999999999,36,3,1782.7,2599.02
8973,U4FF788,39,-76909.05999999992,27,12,731076.91,654167.8500000001
8974,UE3DD2E,39,-1384.0000000000014,33,6,9729.89,8345.89
8975,UF88BC6,39,1139.04,34,5,2676.459999999999,3815.5
8976,UDC403F,39,-829.02,35,4,7778.13,6949.11
8977,UD0AF9E,39,-402.3100000000004,19,20,12661.1,12258.79
8978,U9AB97D,39,-4069.790000000001,29,10,126695.58,122625.79000000001
8979,U33442B,39,-125.72000000000003,34,5,2420.439999999999,2294.7200000000003
8980,U6BAC94,39,7893.980000000001,27,12,36857.0,44750.98
8981,UB68362,39,7128.499999999995,31,8,29197.589999999997,36326.090000000004
8982,UE85F25,39,-37343.48999999999,25,14,79370.48999999999,42027.0
8983,UE16EA5,39,2689.7000000000016,34,5,21541.239999999998,24230.94
8984,U70BF10,39,9711.419999999998,29,10,121020.18000000001,130731.6
8985,U1768DC,39,2642.1699999999996,24,15,11523.79,14165.96
8986,U4DABC9,39,4445.98,25,14,63870.020000000004,68316.0
8987,U4CEC97,39,-9.259999999999991,23,16,1844.22,1834.96
8988,U79DFBC,39,-1405.2800000000002,32,7,2510.03,1104.75
8989,U9CC445,39,-393.99999999999994,25,14,4322.39,3928.39
8990,U6C7DD5,39,11854.55,31,8,14102.52,25957.070000000003
8991,UB524CF,39,3143.0499999999965,27,12,47405.76000000001,50548.81
8992,UDE7145,39,-13537.07,19,20,36555.0,23017.93
8993,UE0CF37,39,932.0399999999997,36,3,1183.74,2115.78
8994,U149652,39,27120.120000000017,25,14,220820.38999999998,247940.51
8995,U6A71A6,39,-5219.949999999999,32,7,22665.68,17445.73
8996,U130902,39,-3226.759999999999,31,8,15024.07,11797.310000000001
8997,UA44C96,39,-2989.0100000000007,37,2,8733.46,5744.45
8998,U6CC055,39,-342.64,31,8,2849.76,2507.12
8999,UC426F2,39,-10389.4,36,3,19949.4,9560.0
9000,UCF71A4,39,12332.630000000005,23,16,130071.31000000001,142403.93999999997
9001,U8FD896,39,-6696.499999999998,38,1,18476.5,11780.0
9002,UAA9777,39,21.10000000000082,35,4,33614.899999999994,33636.0
9003,U54711B,39,-1036.6500000000005,34,5,10653.640000000001,9616.99
9004,U2A88E3,39,-43.120000000000026,24,15,5171.650000000001,5128.530000000001
9005,U54E638,39,-7.510000000000218,28,11,17994.510000000002,17987.0
9006,U4E30C4,39,-250.5500000000003,35,4,5622.95,5372.4
9007,UC56550,39,-5789.110000000001,32,7,22769.870000000003,16980.760000000002
9008,U2874E9,39,-5928.5,29,10,11787.779999999999,5859.28
9009,UAE93B3,39,-9997652.36,29,10,20306181.34,10308528.98
9010,UE8FD15,39,-106442.78,34,5,154565.19,48122.41
9011,U97210F,39,-3631.3199999999997,35,4,7970.179999999999,4338.860000000001
9012,U9FE554,39,-10320.77,26,13,14321.13,4000.36
9013,UF82D87,39,661.7899999999995,25,14,27832.0,28493.789999999997
9014,U0CE8B5,39,3691.49,36,3,6808.509999999999,10500.0
9015,UB72619,39,1278.9,33,6,10128.9,11407.8
9016,U7484B6,39,-2473.76,35,4,10231.99,7758.23
9017,UA2A43E,39,343.9200000000001,23,16,8119.639999999999,8463.56
9018,U50F042,39,2060.5999999999985,34,5,3965.04,6025.64
9019,UF32531,39,12837.349999999999,19,20,12929.82,25767.17
9020,U01F951,39,181.3100000000001,32,7,1727.06,1908.37
9021,U4F8508,39,2563.9999999999995,34,5,3321.66,5885.66
9022,U2448CF,39,-667.0,19,20,96624.57,95957.56999999999
9023,U357B1D,39,-256.68999999999994,33,6,7482.629999999999,7225.9400000000005
9024,UA5C0F0,39,98.32000000000014,29,10,6870.86,6969.18
9025,UF79DD2,39,5583.570000000001,33,6,35217.04000000001,40800.61
9026,UAA801F,39,-2384.939999999995,24,15,87990.09,85605.15
9027,UC78365,39,9773.609999999999,27,12,45958.25,55731.86
9028,U45DE03,39,275680.6500000001,27,12,125486.76,401167.41000000003
9029,UB37AC7,39,-3822.05,21,18,13652.6,9830.55
9030,U00025B,39,5302.010000000004,37,2,24606.87,29908.88
9031,U11DD29,39,198500.82000000012,34,5,67773.15999999997,266273.98
9032,UD1AF64,39,0.010000000002037268,21,18,34776.740000000005,34776.75
9033,UFE8772,39,-7221.160000000002,32,7,27335.569999999996,20114.41
9034,UAD412E,39,-2621.330000000001,29,10,44413.130000000005,41791.8
9035,U5F9182,39,-1112.17,34,5,3948.369999999999,2836.2
9036,U433881,39,7718.980000000002,34,5,11228.53,18947.510000000002
9037,U9DEAC0,39,-691.5999999999997,34,5,13302.7,12611.099999999999
9038,U46AEC1,39,12609.71,28,11,20455.31,33065.020000000004
9039,U598381,39,-959.419999999999,31,8,6504.349999999999,5544.93
9040,UF4321C,39,46538.28,32,7,88046.73000000001,134585.01
9041,UE00BE1,39,2445.97,20,19,7012.03,9458.0
9042,U9619CE,39,498.46000000000015,33,6,1933.97,2432.43
9043,UB1A6B5,39,558.2799999999996,36,3,3427.41,3985.6900000000005
9044,UF65887,39,-3656.9700000000003,26,13,17946.54,14289.57
9045,U283C4F,39,1053.72,36,3,1941.28,2995.0
9046,U208D99,39,107.0499999999999,23,16,11027.37,11134.42
9047,U1214C3,39,-6598.069999999999,34,5,19830.57,13232.5
9048,UBF6DB4,39,6238.350000000006,26,13,93341.61,99579.96
9049,U4C6270,39,5962.52,30,9,14237.529999999999,20200.050000000003
9050,U252BAD,39,-3042.0,34,5,10761.0,7719.0
9051,UAC6827,39,-543.3700000000001,30,9,5173.37,4630.0
9052,U0EA97A,39,2494.0799999999995,32,7,3480.28,5974.360000000001
9053,U5908B0,39,15295.880000000001,30,9,18463.619999999995,33759.5
9054,U6A401A,39,6144.25,16,23,654778.72,660922.9700000001
9055,U085A21,39,5243.77,25,14,18605.02,23848.789999999997
9056,UD4DF87,39,-3.5899999999999803,24,15,3763.2900000000004,3759.7
9057,U251B0A,39,-1582.1199999999997,37,2,2742.12,1160.0
9058,UF5D204,39,41.35000000000033,33,6,46463.68000000001,46505.030000000006
9059,U99661E,39,53755.46999999998,32,7,139149.43999999997,192904.91
9060,U5BECD9,39,-189.12000000000012,29,10,3828.5399999999995,3639.42
9061,UC7CC88,39,-7355.180000000001,31,8,19632.05,12276.87
9062,UF3C65F,39,7194.039999999997,30,9,6784.27,13978.310000000001
9063,U5A52D8,39,16183.06,17,22,35910.0,52093.06
9064,UC9846F,39,-62.57999999999902,31,8,22839.629999999997,22777.05
9065,UD87E8D,39,-1558.3700000000001,32,7,23888.649999999998,22330.28
9066,U3AD558,39,-3204.619999999999,36,3,16764.94,13560.32
9067,U300319,39,-711.5399999999998,34,5,3116.730000000001,2405.19
9068,U6DCB1D,39,553.8699999999997,36,3,2228.6,2782.47
9069,U37AD98,39,-897.7700000000002,33,6,20705.63,19807.86
9070,UA861D1,39,3222.49,23,16,33962.18000000001,37184.67
9071,UC26EA6,39,3290.71,35,4,688.39,3979.1
9072,UC9BDF2,39,4640.520000000028,21,18,113486.42000000001,118126.94000000002
9073,U1C8E7F,39,8337.330000000002,33,6,64793.159999999996,73130.49
9074,UBC5977,39,93.42999999999961,21,18,4320.74,4414.170000000001
9075,U52C7EE,39,656.1399999999999,29,10,7115.959999999999,7772.099999999999
9076,U3F6F1D,39,122731.37,12,27,112710.0,235441.37
9077,U9E2985,39,-18898.070000000007,26,13,836016.39,817118.32
9078,UDBD08C,39,54.02999999999997,25,14,3026.4700000000003,3080.5
9079,U2059F2,39,-1896.9300000000003,25,14,4308.93,2412.0
9080,UF477F5,39,-334.8999999999999,30,9,1696.8799999999999,1361.98
9081,UD2DE78,39,-4772.4000000000015,27,12,28447.53,23675.129999999997
9082,UE267B5,39,-0.949999999999863,23,16,5288.68,5287.7300000000005
9083,U90D46C,39,1503.6999999999994,30,9,3257.3100000000004,4761.01
9084,UA35785,39,822550.89,35,4,75761.10999999999,898312.0
9085,UC7770F,39,-54732.50999999999,22,17,813000.0,758267.49
9086,U7854C2,39,-6.239999999999327,21,18,14286.74,14280.5
9087,U2C02FA,39,-200.98000000000002,36,3,1108.79,907.81
9088,U1A294A,39,-2079.9800000000023,33,6,18279.6,16199.619999999999
9089,U5889D3,39,15793.740000000005,26,13,92040.59999999999,107834.34
9090,U684EBB,39,-853.4100000000008,35,4,8873.54,8020.13
9091,UFA643B,39,42336.200000000004,28,11,27717.55,70053.75
9092,U02D103,39,872.0000000000005,25,14,14342.049999999997,15214.05
9093,U9D7F30,39,31712.330000000005,31,8,39016.21000000001,70728.54000000001
9094,U6B259D,39,-4927.589999999998,31,8,14050.739999999996,9123.15
9095,U3860A4,39,10799.569999999998,31,8,31157.000000000004,41956.57
9096,U3AB1DC,39,-2986.379999999999,33,6,13763.7,10777.32
9097,U987CFA,39,-125.19999999999993,35,4,3229.26,3104.06
9098,UA41FDC,39,13468.360000000002,33,6,4538.24,18006.6
9099,U3740E9,39,907.72,37,2,1534.8,2442.52
9100,U49C78C,39,-1150.050000000001,27,12,25869.3,24719.249999999996
9101,U0179B1,39,-26418.420000000006,36,3,33534.1,7115.68
9102,UFC53A2,39,1130.0,36,3,6221.389999999999,7351.389999999999
9103,UCA1F17,39,-2994.54,35,4,3808.34,813.8000000000001
9104,U0B6162,39,-241.8199999999997,24,15,39021.97,38780.149999999994
9105,U2F1660,39,426.36000000000007,35,4,4873.64,5300.0
9106,U968A3C,39,9002.759999999997,22,17,115235.80999999998,124238.56999999998
9107,UDF47D5,39,-712.39,34,5,1332.51,620.12
9108,U2DEC15,39,-12868.27,32,7,18923.32,6055.05
9109,UE932EA,39,3771.6899999999987,19,20,36594.299999999996,40365.99
9110,U389303,39,29.959999999999127,33,6,9638.04,9668.0
9111,UDF480E,39,-233.77999999999975,26,13,7847.2,7613.42
9112,U2C2F2E,39,-1048.470000000002,32,7,19070.629999999997,18022.16
9113,U46B5CB,39,-35062.16,19,20,444222.5,409160.3400000001
9114,UE7D566,39,-121.9399999999996,31,8,36923.11000000001,36801.17
9115,U6DBD91,39,1623.990000000007,27,12,54676.92,56300.909999999996
9116,U6F1F6A,39,638.0700000000006,30,9,12665.93,13304.0
9117,UB4908B,38,7230.600000000003,33,5,3350.7300000000005,10581.33
9118,U254978,38,3014.0799999999995,21,17,37406.210000000014,40420.29
9119,U88C18A,38,-257.44000000000074,32,6,8138.089999999999,7880.65
9120,U7C4371,38,22893.52,19,19,27790.33,50683.850000000006
9121,U761748,38,-19970.77,32,6,48532.3,28561.53
9122,UA8603B,38,4185.079999999999,32,6,19927.49,24112.57
9123,UB96F06,38,-1726.6000000000001,35,3,1772.7,46.1
9124,UFF7DAE,38,-76377.17000000001,29,9,221016.72,144639.55000000002
9125,U43A4DF,38,-478.2800000000002,33,5,14496.8,14018.52
9126,U0A4C12,38,34.44999999999709,20,18,284619.03,284653.48
9127,UB1ECF5,38,560.1399999999996,20,18,8894.63,9454.77
9128,U86CF17,38,23316.11,22,16,88752.54000000001,112068.65
9129,UBEEF60,38,-5164.689999999988,33,5,191767.19,186602.5
9130,UD50476,38,-708.2299999999996,23,15,21900.85,21192.62
9131,U1B7B61,38,-680.2599999999998,33,5,5148.7300000000005,4468.47
9132,U225992,38,-4201.55,24,14,35031.549999999996,30830.0
9133,U3D9A76,38,7739.930000000002,32,6,41570.149999999994,49310.08
9134,U48B876,38,3738.3599999999983,24,14,16696.160000000003,20434.52
9135,U47C71B,38,26243.16,26,12,10026.989999999996,36270.15
9136,U9EC505,38,-19745.88,36,2,22899.06,3153.1800000000003
9137,U25D03E,38,2191.94,29,9,7240.71,9432.65
9138,UE39F40,38,703.28,31,7,3731.44,4434.72
9139,U301B6C,38,-11644.48,23,15,63144.56,51500.08
9140,UFA87F1,38,-5061.9800000000005,34,4,33147.68,28085.699999999997
9141,UB2112A,38,-4164.1900000000005,29,9,48749.7,44585.51
9142,UE76026,38,2567.9400000000014,33,5,35205.49,37773.43
9143,UBD8D8A,38,134.45000000000005,31,7,1437.33,1571.7800000000002
9144,U76593C,38,243384.22,20,18,74668.51999999999,318052.74000000005
9145,UB9E842,38,-3714.0,25,13,50443.0,46729.0
9146,U47B754,38,658.9800000000001,34,4,2421.9700000000003,3080.95
9147,U1DE76B,38,-349.94000000000005,35,3,3058.3,2708.36
9148,U73BD44,38,-6743.550000000001,26,12,50523.350000000006,43779.8
9149,U2395EF,38,1198.7999999999997,34,4,4322.44,5521.24
9150,UB6EF67,38,-10285.619999999997,32,6,36119.99,25834.370000000003
9151,UEBF97F,38,-1193.0800000000004,31,7,7092.84,5899.76
9152,U18625D,38,235.20999999999913,28,10,23252.4,23487.61
9153,UCAAEAA,38,625.6800000000002,35,3,825.3199999999999,1451.0
9154,U626B71,38,-27.570000000000164,32,6,4442.71,4415.139999999999
9155,U3AC061,38,-717.81,32,6,6020.370000000001,5302.56
9156,UFA3F8B,38,116.53999999999996,20,18,8273.0,8389.539999999999
9157,U988743,38,-1577.1099999999994,30,8,21581.759999999995,20004.65
9158,U45149E,38,-1392.9700000000007,24,14,9038.51,7645.54
9159,UE23501,38,-2580.05,31,7,5180.0599999999995,2600.01
9160,U43F981,38,-4454.419999999998,33,5,21414.1,16959.68
9161,UA4087D,38,395.61,35,3,6719.39,7115.0
9162,UADB05A,38,3115.420000000001,19,19,49161.61,52277.03
9163,U2E0511,38,-630.4200000000005,36,2,5568.419999999999,4938.0
9164,U870B27,38,-24320.68,31,7,33687.0,9366.32
9165,UD1FCF3,38,-368.1500000000001,33,5,1934.38,1566.2299999999998
9166,UDEBC00,38,12438.759999999995,21,17,54019.270000000004,66458.03
9167,U6C15F5,38,-212.95000000000007,20,18,34869.14000000001,34656.19
9168,UE690B1,38,530.7900000000001,36,2,4869.21,5400.0
9169,U236E8A,38,-2108.61,28,10,7918.5,5809.889999999999
9170,U053AF9,38,737.9399999999997,35,3,3688.6800000000003,4426.620000000001
9171,UA236AE,38,454.72999999999956,30,8,8979.650000000001,9434.380000000001
9172,U0CA77A,38,-838.0499999999998,28,10,2835.5000000000005,1997.4499999999998
9173,U948562,38,18222.839999999993,24,14,21130.39,39353.229999999996
9174,U2CCC8E,38,11376.339999999998,27,11,49359.28,60735.62
9175,U33C160,38,-20168.64,27,11,69746.55,49577.91
9176,U3FC731,38,-2505.36,32,6,16223.719999999998,13718.36
9177,UE8BB7E,38,130.96000000000072,35,3,16329.939999999999,16460.899999999998
9178,UF6FB50,38,-249.89999999999998,34,4,2388.81,2138.91
9179,U4C47EE,38,-3515.5199999999986,29,9,8118.92,4603.4
9180,UEEB4D7,38,4874.37,29,9,12864.929999999998,17739.3
9181,UD8797B,38,686.1199999999994,14,24,57526.0,58212.12000000001
9182,UDBBA19,38,130081.73000000003,28,10,8959.03,139040.75999999998
9183,U50EDF0,38,-303.9999999999991,23,15,20771.3,20467.3
9184,UDEA48E,38,149.99999999999818,31,7,57211.93000000001,57361.92999999999
9185,U3B5FDE,38,152.82000000000016,32,6,9423.090000000002,9575.91
9186,U642843,38,466.9000000000002,30,8,13228.4,13695.300000000001
9187,U6D5CEF,38,-7398.0400000000045,22,16,85669.75,78271.71
9188,UED4A09,38,-658.1899999999987,32,6,11413.979999999994,10755.789999999999
9189,U02CF0A,38,4352.57,17,21,25566.57,29919.140000000003
9190,U3A8297,38,26909.969999999998,24,14,182732.80999999997,209642.78
9191,U1A8801,38,-646.4300000000005,24,14,12428.95,11782.52
9192,U01BE43,38,108.48000000000033,21,17,37471.060000000005,37579.54
9193,U75C5AC,38,1298.5199999999998,34,4,5386.039999999999,6684.56
9194,U12227A,38,-146.58000000000004,29,9,1866.0600000000004,1719.4799999999998
9195,U81B987,38,768124.6000000002,11,27,3531913.0,4300037.600000001
9196,U85281A,38,1139.949999999999,33,5,20082.620000000003,21222.57
9197,U0C8FBB,38,-510.3599999999999,32,6,2662.36,2152.0
9198,UEF1148,38,-6.900000000000091,35,3,4498.900000000001,4492.0
9199,UDD7B85,38,120.86000000000001,33,5,896.0199999999998,1016.88
9200,U9A7461,38,35.0,22,16,122593.0,122628.0
9201,UD21A6B,38,3976.4700000000003,30,8,3417.53,7394.0
9202,U59935F,38,-4497.49,35,3,8647.489999999998,4150.0
9203,UF09CFE,38,3359.8100000000004,26,12,30714.06,34073.869999999995
9204,U508DC8,38,291.1999999999989,29,9,22091.0,22382.2
9205,UE4CB96,38,-51030.729999999996,20,18,231739.63999999996,180708.91000000003
9206,UC5E5DB,38,-19488.120000000003,21,17,221886.41,202398.28999999998
9207,UEB231F,38,-4050.9100000000008,15,23,22867.82,18816.91
9208,U28F542,38,-238.95000000000005,29,9,2232.04,1993.0899999999997
9209,U761497,38,-1801.939999999998,26,12,29334.75,27532.81
9210,U91621F,38,3526.4000000000015,28,10,21534.1,25060.5
9211,U094539,38,4173.6900000000005,29,9,8803.689999999999,12977.380000000001
9212,UE33EC6,38,2974.76,31,7,14088.380000000001,17063.14
9213,UA1827D,38,-49433.17,23,15,196129.57,146696.4
9214,U728859,38,-1772.23,36,2,4608.65,2836.42
9215,U1AAE69,38,13850.200000000003,21,17,6130.93,19981.130000000005
9216,U8F53D1,38,101439.45999999999,25,13,202678.22,304117.68
9217,UE4958B,38,-2171.4100000000003,33,5,3312.4,1140.99
9218,UC26A91,38,-2909.779999999995,29,9,73603.34,70693.56
9219,UDBD3E7,38,9526.82000000001,22,16,312460.3,321987.12000000005
9220,U838874,38,-2303.3,31,7,5252.889999999999,2949.59
9221,U52BDA2,38,4205.800000000001,32,6,33602.88,37808.68
9222,U74A6DF,38,1090.0,28,10,69910.0,71000.0
9223,U0B46D0,38,1070.4799999999977,30,8,10803.65,11874.13
9224,UBC52F7,38,21975.02,22,16,20652.019999999997,42627.04
9225,UDA60A0,38,-31.240000000000236,34,4,7472.89,7441.65
9226,U532517,38,394.50000000000045,23,15,26557.76,26952.260000000002
9227,UF9A38A,38,2011.3999999999937,22,16,133102.64,135114.04
9228,U00CEC4,38,2397.270000000002,33,5,21299.949999999997,23697.22
9229,UA3B3D8,38,-2423.38,32,6,9449.259999999998,7025.880000000001
9230,UBAC552,38,-422.0300000000002,33,5,4566.400000000001,4144.37
9231,U1E6CB2,38,47891.82,35,3,58782.200000000004,106674.01999999999
9232,UF98FE6,38,2397.170000000002,28,10,62723.93000000001,65121.1
9233,UF15A06,38,10161.799999999996,18,20,83924.72,94086.52
9234,UE9A7D9,38,-21070.750000000015,28,10,343097.81,322027.05999999994
9235,U698336,38,380.35999999999973,36,2,3292.17,3672.5299999999997
9236,U3E9E30,38,16130.079999999998,15,23,25598.14,41728.22
9237,U03A6DE,38,-1425.7000000000005,24,14,30137.730000000003,28712.03
9238,UF60D89,38,34495.6,13,25,540.75,35036.35
9239,UA299A9,38,53.099999999999795,34,4,9143.72,9196.82
9240,U75DBFC,38,-4570.600000000002,31,7,31951.8,27381.2
9241,UA2175B,38,-5883.280000000001,23,15,41565.82000000001,35682.54000000001
9242,U381050,38,-37120.259999999995,38,0,37120.259999999995,0.0
9243,UF317DC,38,-2312.46,31,7,4883.099999999999,2570.64
9244,UA2FA7D,38,447.2600000000001,18,20,7078.469999999999,7525.73
9245,UD6ECF4,38,0.24000000000887645,15,23,187746.22,187746.46
9246,U608F9C,38,8030.13,36,2,5882.660000000002,13912.79
9247,U661BAD,38,1.8999999999999488,35,3,1823.76,1825.6599999999999
9248,U074A1F,38,2384.81,35,3,1945.2,4330.01
9249,U04160D,38,63.72000000000035,32,6,18569.820000000003,18633.539999999997
9250,U7059F0,38,-7075.68,31,7,34892.76000000001,27817.08
9251,U0ED3B8,38,-15220.449999999999,33,5,38583.88,23363.43
9252,UEF73EC,38,870.2199999999998,35,3,1237.5100000000002,2107.73
9253,UF15A08,38,-3172.6399999999994,35,3,11406.64,8234.0
9254,U36210D,38,7421.9,31,7,32314.43,39736.33
9255,U3BEA3A,38,-8573.779999999999,32,6,10664.48,2090.7000000000003
9256,U958A6B,38,492.96999999999986,36,2,2808.82,3301.79
9257,UF550F5,38,28987.44000000001,31,7,49320.01,78307.45000000001
9258,UF4E142,38,-71773.68000000001,26,12,116163.68000000001,44390.0
9259,U20A140,38,-5415.479999999999,34,4,20193.719999999998,14778.24
9260,UAD389F,38,-89.01999999999998,24,14,3426.390000000001,3337.37
9261,U232A95,38,2102.9500000000003,28,10,9785.569999999996,11888.519999999999
9262,U034C73,38,136.39999999999986,34,4,2290.280000000001,2426.6800000000003
9263,U2E177C,38,-1289.41,22,16,48209.60000000002,46920.19
9264,U51047A,37,-3485.279999999999,34,3,56485.28,53000.0
9265,U2DD10C,37,7.275957614183426e-12,20,17,84258.06,84258.06
9266,UA27D51,37,-49116.50000000001,26,11,222714.49999999997,173598.0
9267,U05C82B,37,-3787.8399999999983,32,5,52425.92,48638.08
9268,U27680F,37,-1866.7699999999998,28,9,25053.720000000005,23186.95
9269,U768AF0,37,-4500.900000000001,18,19,88911.93000000001,84411.03
9270,UE55F2B,37,-8818.910000000018,28,9,170822.00999999998,162003.1
9271,U3259AD,37,3256.0200000000004,34,3,9799.06,13055.08
9272,UA561B1,37,-966.26,31,6,1363.1600000000003,396.90000000000003
9273,U8CC553,37,288.49,35,2,1341.9099999999999,1630.4
9274,U0E98B0,37,-1180.3500000000004,35,2,4228.800000000001,3048.45
9275,UFD45C8,37,8131.500000000002,28,9,57570.3,65701.8
9276,U128533,37,-520.3,28,9,2214.3700000000003,1694.07
9277,UABFDF7,37,1908.9800000000005,28,9,2048.49,3957.47
9278,U007CFD,37,4285.55,6,31,3608.2999999999997,7893.8499999999985
9279,U344AA8,37,753.6700000000001,24,13,3760.5899999999997,4514.26
9280,U1A0301,37,-5484.82,26,11,97754.64,92269.81999999999
9281,UEF6492,37,-3236.4800000000014,23,14,48098.08000000001,44861.6
9282,U16EC2C,37,-0.15000000000019043,31,6,6880.01,6879.860000000001
9283,UA74110,37,4009.6199999999994,26,11,17647.24,21656.86
9284,U0EDA95,37,-1051.8799999999999,33,4,12846.989999999996,11795.11
9285,U5AD0BC,37,102.07999999999937,21,16,12981.789999999999,13083.87
9286,UB2C7F0,37,98.21000000000001,34,3,1004.6199999999998,1102.83
9287,U6AED25,37,129542.95000000001,27,10,102907.66,232450.61
9288,UC7F2F1,37,16204.53,17,20,142371.63,158576.16
9289,UE38B7B,37,-10919.75,24,13,18368.87,7449.120000000001
9290,U3782F4,37,-2078.34,30,7,8628.619999999999,6550.28
9291,U3B3F02,37,-221.52000000000407,25,12,123544.0,123322.48
9292,U897EDA,37,0.7000000000002728,31,6,5478.3,5479.0
9293,UD90279,37,9.094947017729282e-13,21,16,42698.58,42698.58000000001
9294,U5E6DF5,37,8000.0,25,12,78000.0,86000.0
9295,U037985,37,393295.1000000001,17,20,324608.0,717903.1000000001
9296,U97FC10,37,-43787.649999999994,32,5,44559.24,771.59
9297,U178DD6,37,-188.40000000000006,33,4,2898.57,2710.17
9298,UA4020F,37,-211.1800000000004,34,3,3870.21,3659.03
9299,UBB6EAC,37,86.6900000000002,34,3,737.1099999999999,823.8
9300,U1FB595,37,1251.2600000000007,30,7,7888.7699999999995,9140.03
9301,U4E7F7D,37,5352.28,34,3,21275.74,26628.02
9302,UDC5B21,37,-57486.68999999999,23,14,182242.31000000003,124755.62000000001
9303,UFF265C,37,-5037.759999999995,31,6,74959.47,69921.70999999999
9304,U97C748,37,58052.32,31,6,23315.92,81368.23999999999
9305,U209E23,37,-807.9499999999998,34,3,15463.239999999998,14655.29
9306,U8EA2CA,37,-10053.99,31,6,19770.86,9716.869999999999
9307,UA9F469,37,-1376.46,24,13,58168.89000000001,56792.43
9308,U5B7825,37,73.53999999999982,29,8,6539.350000000001,6612.89
9309,U5AE8E1,37,14243.19,28,9,15847.66,30090.85
9310,U21A3C3,37,-944.289999999999,22,15,51832.280000000006,50887.990000000005
9311,UED5BCF,37,5042.28,18,19,1647.72,6690.0
9312,UC9887A,37,34.89000000000004,32,5,1096.1100000000001,1131.0
9313,UCCEBAC,37,5013.969999999999,34,3,813.5000000000001,5827.47
9314,UDCDCF8,37,5190.17,32,5,3808.96,8999.130000000001
9315,UD6C7F6,37,2999.2299999999987,29,8,19354.27,22353.5
9316,UABD3BB,37,6679.849999999999,27,10,19089.42,25769.269999999997
9317,UDE040F,37,-283.64000000000124,31,6,23108.480000000003,22824.84
9318,UE574EB,37,-22022.379999999997,36,1,26622.379999999997,4600.0
9319,U52B64C,37,14202.26,34,3,9507.74,23710.0
9320,U1452CD,37,1102.0,31,6,3074.34,4176.34
9321,U6C2298,37,480.5799999999999,32,5,4880.97,5361.550000000001
9322,U884CDD,37,-11.0,30,7,6511.0,6500.0
9323,UF6604D,37,5533.889999999999,33,4,16436.570000000003,21970.46
9324,UA52E2F,37,-1627.6699999999998,22,15,7610.850000000001,5983.180000000001
9325,U7399A4,37,-37154.19999999999,29,8,68673.58,31519.379999999997
9326,U8B71A2,37,1138.4200000000014,26,11,16785.140000000003,17923.56
9327,U217057,37,5870.750000000002,35,2,6072.11,11942.86
9328,U0E8F00,37,-5354.110000000001,25,12,27744.170000000002,22390.06
9329,U18EDF1,37,184.77999999999997,35,2,630.99,815.77
9330,UB6EA24,37,-11166.000000000002,20,17,49991.939999999995,38825.939999999995
9331,U74BF89,37,-3186.8400000000006,22,15,56843.369999999995,53656.53
9332,U7C55FF,37,-614.1600000000003,33,4,8246.320000000002,7632.16
9333,U3C774C,37,-332.83,33,4,1631.33,1298.5
9334,U937ABE,37,-9885.59,34,3,9915.33,29.74
9335,UB836CD,37,-14680.19,29,8,56084.89,41404.7
9336,U370752,37,-2368.879999999999,30,7,10251.79,7882.91
9337,UCAD7FB,37,-864.2700000000003,31,6,2168.96,1304.69
9338,U0DB163,37,662.6099999999997,27,10,19740.32,20402.93
9339,U03E9C7,37,-39.579999999999814,26,11,2595.5199999999995,2555.94
9340,U53827D,37,9904.630000000001,31,6,5345.84,15250.47
9341,U4E770E,37,2260.0,0,37,0.0,2260.0
9342,UAA9630,37,-2067.599999999999,33,4,8296.0,6228.4
9343,U9987D5,37,468.03999999999996,35,2,3008.2,3476.2400000000002
9344,UEC9529,37,-3656.5200000000004,16,21,12931.7,9275.18
9345,U4EC015,37,-121.57000000000008,34,3,1370.19,1248.62
9346,U558328,37,31019.13999999993,15,22,1435566.58,1466585.7199999997
9347,U2DDBB4,37,-65.27000000000025,33,4,9953.75,9888.48
9348,U210EAA,37,27970.24000000005,10,27,580934.0,608904.2400000002
9349,UC019EB,37,112.08000000000034,32,5,4890.86,5002.94
9350,UFE9878,37,527.6200000000002,30,7,7416.750000000002,7944.37
9351,UDB18F8,37,-1862.7500000000005,34,3,3262.7500000000005,1400.0
9352,U702B7A,37,17293.339999999997,35,2,45129.66,62423.0
9353,UE16B57,37,24282.699999999997,22,15,2324.21,26606.909999999996
9354,U6C84B5,37,655.8499999999997,33,4,6505.939999999999,7161.79
9355,UE76AF1,37,1180.42,31,6,8089.099999999999,9269.52
9356,U883025,37,12971.900000000003,24,13,21256.0,34227.9
9357,UC66B3D,37,-1757.0099999999998,22,15,102921.09999999999,101164.09
9358,UDC6D35,37,-3298.0500000000006,35,2,10198.049999999997,6900.0
9359,U2667D1,37,161159.13999999998,27,10,171048.54,332207.68000000005
9360,U38444E,37,-1726.5900000000001,20,17,7678.0,5951.41
9361,U48D34C,37,-2345.7499999999973,34,3,30904.840000000004,28559.09
9362,UBCF4DB,37,72.59000000000742,27,10,138827.76,138900.35
9363,U6A105E,37,-8550.58,26,11,42879.53,34328.950000000004
9364,UDCBC73,37,32496.819999999996,25,12,61838.8,94335.62
9365,UFFD25E,37,-178748.79,34,3,185550.80000000002,6802.01
9366,U60C94A,37,-112.87999999999984,31,6,3577.08,3464.2
9367,U60E8D7,37,-9816.409999999998,30,7,10608.12,791.71
9368,U15CCD7,37,-4196.760000000002,30,7,25025.410000000003,20828.65
9369,U3C6994,37,7291.259999999991,31,6,95292.69000000002,102583.95
9370,UE85F92,37,224.25999999999988,32,5,3264.5300000000007,3488.790000000001
9371,U639411,37,-9.139999999999873,20,17,25819.86,25810.72
9372,UA9AC00,37,-1069.3499999999997,32,5,6341.489999999999,5272.14
9373,UBF350B,37,234.70000000000016,32,5,8933.09,9167.79
9374,UAEAE25,37,-25551.160000000003,35,2,25589.160000000003,38.0
9375,UA9213B,37,-17658.64,27,10,83306.5,65647.86
9376,U2BFD27,37,3988.16,29,8,13542.84,17531.0
9377,U79B605,37,225.38999999999967,33,4,5770.44,5995.83
9378,U5235C0,37,-699.0000000000036,23,14,71760.88,71061.88
9379,U1A256F,37,-14045.279999999999,28,9,14534.9,489.61999999999995
9380,U478010,37,-3816.5099999999998,33,4,7494.330000000002,3677.82
9381,U445578,37,14318.769999999999,30,7,38641.530000000006,52960.3
9382,U8BA60E,37,-8503.47,33,4,37120.47,28617.0
9383,U5577AE,37,31344.960000000003,28,9,607161.51,638506.47
9384,UC4A0AF,37,-1553.590000000002,31,6,15582.240000000002,14028.65
9385,U6EEFFC,37,-4839.09,33,4,31916.48,27077.39
9386,U34C320,37,76587.68999999997,18,19,532946.7,609534.39
9387,U078859,37,47906.68,29,8,110139.54000000001,158046.22
9388,UFCB4A5,37,-2044683.32,12,25,36948951.0,34904267.68
9389,U031055,37,173796.81999999998,19,18,312941.85000000003,486738.67
9390,U5247A6,37,-11719.37,34,3,16083.55,4364.18
9391,UEE5BC7,37,56500.21,24,13,117520.4,174020.61000000002
9392,UB417DD,37,2623.3399999999997,31,6,6027.58,8650.92
9393,U22D575,37,-2492.05,23,14,8232.48,5740.43
9394,UBB23E0,37,-25.030000000000086,29,8,9190.369999999999,9165.34
9395,UE97F7D,37,1183.9600000000005,34,3,15516.259999999998,16700.22
9396,UEDEBCE,37,-2212.219999999994,21,16,190912.33000000002,188700.11
9397,U4B90A4,37,-39.98000000000044,32,5,7652.06,7612.08
9398,U56DC0D,37,-781.4199999999989,31,6,15251.869999999999,14470.45
9399,UBE69E9,37,-2335.9399999999996,36,1,2930.539999999999,594.6
9400,UBE235C,37,-44.83000000000209,11,26,73289.16,73244.32999999999
9401,U2D9C1D,37,325.0,27,10,89046.2,89371.2
9402,U149081,37,153415.86000000004,27,10,35551.58,188967.43999999997
9403,UCB6E2A,37,1469.4599999999996,31,6,6142.110000000001,7611.57
9404,UD2EF54,37,-8.680000000002329,18,19,76018.3,76009.62
9405,U63A9EB,37,-726.2599999999933,29,8,16917.190000000006,16190.93
9406,U25033B,37,72012.24000000002,31,6,389525.16000000003,461537.4
9407,U2040B2,37,615.0,0,37,0.0,615.0
9408,UEF0DA0,37,7458.370000000003,31,6,3563.9700000000007,11022.34
9409,UA5D6A8,37,1671.3100000000002,36,1,1915.8,3587.11
9410,U64AC3F,37,28.799999999999393,32,5,27586.770000000008,27615.57
9411,UD52735,37,690.08,34,3,1490.3500000000001,2180.4300000000003
9412,U2E8E37,37,-7055.469999999999,28,9,50077.54000000001,43022.07
9413,U76391F,36,-98895.71999999993,23,13,1305862.25,1206966.5299999998
9414,UD27E32,36,-9993.41,17,19,27985.77,17992.359999999997
9415,UF25E1E,36,1.2323649045686835e-12,22,14,13675.199999999999,13675.2
9416,U35FDB9,36,12219.769999999993,26,10,31764.34,43984.11
9417,U9CA5A7,36,-721.7799999999997,22,14,22829.66,22107.879999999997
9418,U3D4435,36,21876.67,7,29,4600.26,26476.93
9419,U964AAA,36,852.2399999999998,28,8,7351.42,8203.66
9420,U39AA5F,36,8.149925179168349e-12,19,17,942114.77,942114.77
9421,UAC6211,36,-111674.37999999999,28,8,144510.05999999997,32835.68
9422,U62CBA5,36,-1129.6000000000008,33,3,12893.699999999999,11764.099999999999
9423,U22F918,36,4209.9100000000035,30,6,35247.75,39457.66
9424,U8B1512,36,-3862.559999999999,30,6,51119.59,47257.030000000006
9425,U35641F,36,715.9999999999998,23,13,34552.0,35268.0
9426,U3F9622,36,-152.100000000004,33,3,52287.1,52135.0
9427,U1171AE,36,-807.2900000000013,26,10,16599.55,15792.26
9428,U8434B8,36,89.40000000000146,24,12,134015.29,134104.69
9429,UBE26FC,36,2204.880000000001,28,8,38193.899999999994,40398.78
9430,UE32AB1,36,-63.22999999999956,26,10,7561.289999999999,7498.0599999999995
9431,UA59B22,36,-3302.61,36,0,3302.61,0.0
9432,UFBD2F1,36,1095.6299999999999,27,9,1298.08,2393.71
9433,U497153,36,1242.6099999999997,28,8,14087.470000000001,15330.08
9434,U0F04F9,36,-1973.81,34,2,2423.81,450.0
9435,U8C177A,36,-737.8600000000004,24,12,17020.749999999996,16282.890000000001
9436,U7479DD,36,178.53999999999724,26,10,52626.57000000001,52805.11
9437,U6F287C,36,194.58999999999833,21,15,24404.640000000003,24599.23
9438,U50F01E,36,-7374.129999999999,27,9,46885.21,39511.079999999994
9439,UAB0675,36,-10002.050000000003,18,18,222334.03999999998,212331.99000000002
9440,U776D23,36,-252.96000000001857,29,7,98438.37000000002,98185.41
9441,U320721,36,19671.709999999992,23,13,6621.750000000001,26293.459999999995
9442,UE1FA84,36,-90614.00000000001,29,7,208895.77,118281.77
9443,U1E7D4C,36,-38.04000000000008,32,4,2322.040000000001,2284.0
9444,UF2382D,36,-4510.799999999999,22,14,56709.36,52198.56
9445,U3B0CBD,36,-351.15000000000055,24,12,9832.89,9481.74
9446,U41A098,36,-2604.2000000000003,22,14,6256.74,3652.54
9447,U27DD4B,36,1463.0,22,14,13547.06,15010.06
9448,UBBEA11,36,4.940000000002328,27,9,57919.86000000001,57924.8
9449,U0BEC84,36,23797.280000000002,34,2,6209.39,30006.67
9450,UF2A98E,36,-0.6300000000000807,19,17,668.8100000000001,668.1800000000001
9451,UE32CFB,36,-4055.4300000000003,32,4,5595.2300000000005,1539.8
9452,UC4BBD2,36,-23.129999999999534,23,13,4887.820000000001,4864.6900000000005
9453,U4390E7,36,-3539.1799999999994,24,12,34837.48,31298.3
9454,UB64C61,36,-22535.629999999997,32,4,23624.05,1088.42
9455,UEB36CD,36,4280.950000000001,29,7,82401.25000000001,86682.2
9456,U174550,36,-22760.10999999999,24,12,119484.52,96724.41
9457,UDF5C4B,36,282.25999999999993,29,7,10236.969999999994,10519.23
9458,U72926F,36,-1195.44,30,6,6119.400000000001,4923.960000000001
9459,U53FF9F,36,-3339.0,22,14,63824.0,60485.0
9460,U8FF9DE,36,-4367.0,24,12,59905.0,55538.0
9461,UA071B3,36,97.1000000000002,32,4,2691.4399999999996,2788.54
9462,U7415F9,36,9.094947017729282e-12,21,15,68465.07,68465.07
9463,UBAF69B,36,-15102.51,30,6,78015.16,62912.65000000001
9464,U760B20,36,-271.0600000000013,33,3,12052.01,11780.95
9465,U7D3526,36,-28.370000000000335,22,14,106133.73000000001,106105.35999999999
9466,U672383,36,21.999999999999318,18,18,54158.3,54180.3
9467,U1F25CE,36,3601.06,26,10,4407.139999999999,8008.200000000001
9468,UC342F1,36,2563.38,31,5,446.39000000000004,3009.77
9469,U008236,36,11595.529999999999,33,3,2070.5,13666.029999999999
9470,U97B788,36,4549.91,16,20,103852.8,108402.71
9471,U4E4C92,36,-3225.3899999999994,21,15,9801.9,6576.51
9472,UC1E015,36,-2354.41,21,15,84239.46,81885.04999999999
9473,U6DCC00,36,18411.389999999992,27,9,30411.730000000007,48823.12
9474,U50926A,36,-110.84999999999991,33,3,2390.36,2279.51
9475,U966E24,36,-889.0,21,15,76587.0,75698.0
9476,UF22CBA,36,-127472.76,32,4,159747.50999999998,32274.75
9477,UE2A48A,36,-5275.18,22,14,24856.260000000006,19581.08
9478,U3DED93,36,-1880.550000000003,22,14,299712.86,297832.31
9479,UEF7855,36,-10382.300000000008,32,4,100578.10999999997,90195.81
9480,U015753,36,-43054.45999999999,26,10,71633.31,28578.85
9481,U7EDB3B,36,-3193.8199999999993,23,13,27694.17,24500.35
9482,UBB8721,36,20652.46,24,12,31354.57,52007.03
9483,UE1985D,36,-17990.679999999997,30,6,19059.399999999998,1068.72
9484,U079B6E,36,1384.4399999999991,29,7,3750.8,5135.240000000001
9485,U9FCEB4,36,22328.010000000006,19,17,65689.95,88017.95999999999
9486,U8728E2,36,-19.41000000000006,33,3,1796.4100000000003,1777.0
9487,UF63558,36,-3740.6000000000076,27,9,68267.38,64526.78
9488,U29F788,36,-1848.1799999999998,32,4,6548.18,4700.0
9489,UF7CB07,36,598.5999999999999,29,7,4773.3,5371.9
9490,UA3FC19,36,0.0,23,13,9234.46,9234.46
9491,UC09147,36,-2611.3300000000004,29,7,8532.33,5921.0
9492,U6BFF80,36,2104.850000000001,29,7,12625.01,14729.86
9493,UB28358,36,-524.859999999997,17,19,682439.49,681914.63
9494,U14654E,36,-974.5900000000001,24,12,20282.32,19307.73
9495,U6DCDF9,36,2684.2599999999998,30,6,3106.2000000000003,5790.46
9496,UE304DF,36,-129.18999999999986,30,6,5024.219999999999,4895.03
9497,U734225,36,-1460.6399999999994,30,6,10987.699999999999,9527.06
9498,UEB396E,36,444.3499999999995,30,6,16574.29,17018.64
9499,U1858FC,36,-4246.980000000001,20,16,68505.61,64258.63
9500,UC3F8E3,36,1344.8999999999983,26,10,211952.99000000005,213297.89
9501,UF62003,36,-95.05000000000007,32,4,2262.6000000000004,2167.55
9502,U98122F,36,-2859.8,33,3,12303.8,9444.0
9503,U3E88C5,36,3713.0999999999995,29,7,6309.400000000001,10022.5
9504,U8AF037,36,-7588.66,15,21,48618.02,41029.36
9505,U0D26AD,36,26906.87,30,6,14430.829999999998,41337.7
9506,UF6E703,36,19903.29,33,3,1201.6799999999998,21104.97
9507,UF44692,36,-383.48000000000025,21,15,9831.600000000002,9448.119999999999
9508,UE6975F,36,1052.8500000000004,28,8,3800.6500000000005,4853.5
9509,UB305FA,36,-2571.580000000001,26,10,33815.56,31243.98
9510,UDD25F1,36,773.4300000000003,29,7,15384.18,16157.61
9511,UF1EC85,36,-821.8599999999996,27,9,12953.38,12131.520000000002
9512,U5303EE,36,-2647.4700000000003,33,3,9592.949999999999,6945.48
9513,U785A5E,36,-11335.58,33,3,11808.109999999999,472.53
9514,UE7A41E,36,-281.51,34,2,1281.5100000000004,1000.0
9515,UEC4923,36,-162.38000000000056,32,4,3464.3300000000004,3301.95
9516,U1ABEEC,36,8000.120000000001,31,5,12593.77,20593.89
9517,UA3E0EC,36,-35.95999999999913,33,3,20036.0,20000.04
9518,UA00BFA,36,1832.5000000000005,31,5,16238.88,18071.38
9519,U05AE05,36,6594.209999999999,24,12,50155.090000000004,56749.3
9520,UFAA7F2,36,24995.31,4,32,35462.6,60457.91
9521,U57D4BA,36,-13627.199999999993,34,2,15204.099999999993,1576.9
9522,UABE8CE,36,339.3,27,9,5090.780000000001,5430.08
9523,U7AEB97,36,14.17999999999909,20,16,41893.18,41907.36
9524,U887161,36,42565.28999999999,31,5,10190.690000000002,52755.979999999996
9525,U53BE8F,36,-3876.1500000000005,31,5,9991.39,6115.24
9526,U705FED,36,725.7999999999995,32,4,16366.479999999998,17092.28
9527,UC21914,36,0.0,18,18,9600.0,9600.0
9528,U6CC99B,36,695.8399999999997,24,12,8835.5,9531.34
9529,UDFC46A,36,-26733.090000000015,26,10,59725.46,32992.369999999995
9530,U31CDDB,36,305.079999999999,28,8,49655.69,49960.770000000004
9531,U07DED4,36,-3689.3199999999997,31,5,8718.029999999999,5028.710000000001
9532,U749B4B,36,216.15000000000003,34,2,811.8499999999999,1028.0
9533,U6ECC4A,36,-4859.279999999998,33,3,8043.519999999999,3184.24
9534,U4FA88E,36,-4487.82,31,5,7694.08,3206.26
9535,U913B2E,36,-0.060000000000002274,25,11,507.53,507.46999999999997
9536,U0C9A41,36,152.21000000000004,28,8,9571.379999999997,9723.59
9537,U218488,36,-4343.5199999999995,30,6,8684.169999999998,4340.65
9538,U955013,36,85588.92,18,18,116772.64,202361.56
9539,U5F1D24,36,1186.0699999999997,21,15,5511.18,6697.25
9540,U8CEED9,36,326.9399999999998,32,4,1599.06,1926.0
9541,UB93983,36,-1012.7200000000006,28,8,4669.03,3656.3100000000004
9542,U5905D4,36,-7161.86,33,3,31616.859999999993,24455.0
9543,UFB8FA1,36,17793.879999999997,26,10,147019.85999999996,164813.74
9544,U185010,36,20687.699999999997,29,7,68949.3,89637.0
9545,U3B617F,36,-3985.5299999999997,27,9,17780.399999999998,13794.869999999999
9546,U0A4A8D,36,170.77,31,5,4476.29,4647.06
9547,U8BF0A4,36,-3456.620000000001,27,9,11106.619999999999,7650.0
9548,U7705D9,36,-469.48,32,4,3615.48,3146.0
9549,UE618E4,36,79.71999999999389,25,11,31952.2,32031.919999999995
9550,U796979,36,-2302.52,25,11,30653.769999999997,28351.25
9551,U9677AB,36,-20832.07,30,6,78365.58,57533.509999999995
9552,U42549C,36,-4862.840000000029,13,23,4679355.73,4674492.890000001
9553,U890789,36,3646.5,22,14,72340.19,75986.69
9554,UCEA1E6,36,1532.7699999999995,30,6,19566.120000000003,21098.89
9555,U2ADD99,36,-5010.780000000001,36,0,5010.780000000001,0.0
9556,UF52801,36,39146.959999999985,27,9,70130.70000000001,109277.66
9557,U27506E,36,2220.0199999999995,22,14,12790.139999999998,15010.16
9558,U18F662,36,1421.0600000000004,30,6,5271.64,6692.7
9559,UA1A071,36,-67.96999999999998,26,10,930.99,863.02
9560,UF8CD45,36,6522.900000000001,30,6,12684.7,19207.600000000002
9561,U34095B,36,3545.6499999999996,20,16,15495.07,19040.72
9562,UC08D2A,36,302.34000000000015,29,7,52631.7,52934.03999999999
9563,U93DE59,36,1651.6900000000003,24,12,10709.439999999999,12361.13
9564,U55DB7A,36,20893.340000000007,24,12,44492.979999999996,65386.32000000001
9565,U21E76B,36,-2866.2799999999997,22,14,23423.89,20557.61
9566,U4C162A,36,15683.859999999995,14,22,318464.47,334148.33
9567,UCEE0B6,36,-1058.1100000000001,32,4,13317.609999999997,12259.5
9568,U17D346,36,-1033.3999999999992,34,2,10759.620000000003,9726.22
9569,U9C10FD,36,-541.31,34,2,3541.3099999999995,3000.0
9570,U8BDAD6,36,20.0,18,18,67780.0,67800.0
9571,U03A525,36,-4895.350000000001,35,1,4921.350000000001,26.0
9572,U86C71E,36,6077.870000000004,26,10,125398.06,131475.93
9573,UE339EE,36,-1965.7300000000007,31,5,2512.1,546.37
9574,U9419C9,36,147263.6200000001,14,22,2850918.74,2998182.3600000003
9575,UDE4FED,36,-382.49,28,8,2455.28,2072.79
9576,UE3908E,36,-78771.88000000002,25,11,224919.83,146147.95
9577,U5C1F69,36,219.12000000000003,34,2,4780.880000000001,5000.0
9578,U61CB8F,35,213.88999999999942,31,4,6514.110000000001,6728.0
9579,U4CC283,35,-4906.540000000001,25,10,39504.59,34598.05
9580,UBEE363,35,5964.120000000001,31,4,3685.8800000000006,9650.0
9581,U118F85,35,-4038.1600000000003,16,19,14421.89,10383.73
9582,U11A0F2,35,32147.64,16,19,137993.48,170141.12
9583,UE1C603,35,-3764.120000000006,25,10,214781.22999999995,211017.11000000002
9584,U9A071E,35,483.240000000002,29,6,16043.25,16526.489999999998
9585,U62591B,35,415.8400000000006,30,5,4973.69,5389.53
9586,UDF46F3,35,-1907.9700000000005,26,9,28903.079999999998,26995.11
9587,U344AE1,35,2482.010000000002,27,8,57871.64000000001,60353.65
9588,UF6E52F,35,7004.749999999999,29,6,14239.45,21244.2
9589,UBD057D,35,133.05000000000052,26,9,17666.67,17799.719999999998
9590,U5A7E7E,35,18055.070000000007,28,7,575195.3400000001,593250.41
9591,U611FC1,35,50352.67,21,14,43850.799999999996,94203.47000000002
9592,U6E339F,35,-15610.25,29,6,19810.25,4200.0
9593,UD0598D,35,-6188.530000000004,31,4,36242.33,30053.8
9594,U54F8B0,35,-2823.78,28,7,28831.620000000003,26007.84
9595,UE60137,35,-1109.6900000000005,20,15,21836.050000000003,20726.36
9596,U668E74,35,297529.05999999994,11,24,450457.0,747986.0599999999
9597,UBE1B44,35,-14305.01000000001,32,3,212017.83000000002,197712.82
9598,UF1FF77,35,21885.55,25,10,12873.85,34759.4
9599,UC704ED,35,5613.099999999999,26,9,6112.469999999999,11725.57
9600,UC9BA35,35,-304.4099999999993,33,2,6961.65,6657.24
9601,UAACF3F,35,-1084.46,29,6,3664.77,2580.31
9602,U3D612A,35,1688.6400000000006,26,9,13067.18,14755.82
9603,U23A958,35,-1331.7299999999996,31,4,3835.5,2503.77
9604,U189404,35,-4605.0,31,4,11813.199999999999,7208.2
9605,U6D415B,35,-11546.859999999993,32,3,33606.02,22059.16
9606,UE8462C,35,-263.1500000000004,32,3,6263.15,6000.0
9607,U7BAEBE,35,5581.019999999999,19,16,4563.18,10144.199999999999
9608,U39324E,35,-2020.8200000000002,31,4,4141.76,2120.94
9609,UABC805,35,0.0,13,22,18988.0,18988.0
9610,U35080E,35,-0.009999999999980247,33,2,300.02,300.01
9611,UF8578C,35,-2475.81,33,2,4647.810000000001,2172.0
9612,U96443E,35,-12262.1,20,15,23951.85,11689.75
9613,U268D5C,35,-0.7199999999984357,20,15,48118.04,48117.32
9614,UFEBF9F,35,-20283.359999999997,28,7,132238.72999999998,111955.37000000001
9615,UCD3E57,35,-7116.260000000002,26,9,93846.0,86729.73999999999
9616,UC28BB1,35,1062.1499999999994,30,5,19644.22,20706.37
9617,UAED42C,35,788.1999999999998,33,2,3181.7999999999997,3970.0
9618,UAE5549,35,-623.5499999999997,32,3,4968.73,4345.18
9619,UE8B914,35,-12181.05,34,1,12237.89,56.84
9620,U2FDF0E,35,8337.339999999998,22,13,22404.41,30741.75
9621,UE2E6FE,35,25448.05,18,17,54275.16999999999,79723.21999999999
9622,U86DF97,35,1676.0199999999995,22,13,20522.39,22198.41
9623,UB08C09,35,-240237.96999999994,27,8,261561.18999999997,21323.219999999998
9624,U4E494C,35,-6862.610000000001,27,8,16123.499999999998,9260.89
9625,U99EB14,35,-1148.8599999999997,30,5,9511.45,8362.59
9626,U6F6EBF,35,-1963.2100000000055,23,12,50943.21,48980.0
9627,UC46625,35,8863.029999999999,26,9,13014.97,21878.0
9628,U5E6E2C,35,8109.780000000003,31,4,2082.3100000000004,10192.09
9629,UE44A4A,35,8581.640000000001,21,14,7580.919999999998,16162.56
9630,U656D37,35,-365.54,20,15,1796.6200000000003,1431.0800000000002
9631,U013B04,35,-4590.52,23,12,30092.630000000005,25502.11
9632,UB34F42,35,-18832.5,29,6,29117.04,10284.539999999999
9633,U77BC6C,35,976.04,33,2,1295.88,2271.92
9634,U984D08,35,75664.1,13,22,91420.26,167084.36
9635,UCC803B,35,1072.6000000000004,27,8,4459.280000000001,5531.88
9636,U60C30D,35,2497.6400000000003,25,10,2312.57,4810.210000000001
9637,U7574FC,35,5620.889999999999,26,9,6624.85,12245.74
9638,UE1234E,35,-143.22999999999956,24,11,24004.83,23861.6
9639,UAA2941,35,254.58999999999992,25,10,13513.86,13768.449999999999
9640,UF5BB51,35,-15.180000000007567,26,9,129116.6,129101.42
9641,UDEDB6B,35,-16335.39,30,5,21606.93,5271.54
9642,UC8FCD4,35,-119.38999999999993,32,3,14115.389999999998,13996.0
9643,U40AE5A,35,4489.110000000001,25,10,16949.1,21438.21
9644,U591A42,35,404.21999999999974,29,6,4059.2100000000005,4463.43
9645,UBF7561,35,4597.5,24,11,1872.5,6470.0
9646,U1AB544,35,-530.38,31,4,2619.2,2088.8199999999997
9647,U4A92D0,35,-1999.0,24,11,43999.0,42000.0
9648,UEB2F56,35,41855.82999999998,13,22,176064.2,217920.03
9649,UE0350D,35,-14151.27,32,3,17196.789999999997,3045.52
9650,U14E9A7,35,-3484.18,20,15,26630.34,23146.16
9651,UC5EFEA,35,94.92000000000002,20,15,2662.95,2757.87
9652,UEFD82F,35,-47794.139999999985,27,8,48883.539999999986,1089.4
9653,U0DE674,35,-515.640000000001,31,4,6819.75,6304.11
9654,UFA0F5B,35,-764.74,31,4,2488.75,1724.01
9655,U24D28A,35,625.8299999999995,29,6,10417.47,11043.300000000001
9656,UE64472,35,-5189.04,22,13,21371.87,16182.83
9657,UBA1268,35,-2603.1099999999997,33,2,7121.06,4517.95
9658,U7F4F31,35,-14552.679999999998,30,5,22219.92,7667.240000000001
9659,UF1EE36,35,144.72999999999996,29,6,1477.7800000000002,1622.51
9660,UFBF4BD,35,-4009.7800000000007,31,4,8090.349999999999,4080.5699999999997
9661,U1F893A,35,1893.5599999999995,29,6,9199.529999999999,11093.089999999998
9662,U569774,35,-398652.18999999994,27,8,2037713.06,1639060.8699999999
9663,UE46BF9,35,43966.48999999999,31,4,169659.81,213626.3
9664,U35653C,35,0.07000000000016371,21,14,4336.46,4336.53
9665,UBB166D,35,5891.810000000006,22,13,63032.700000000004,68924.51000000001
9666,U195413,35,-10866.18,30,5,20774.0,9907.82
9667,U95DA67,35,-930.4400000000003,28,7,3326.0700000000006,2395.63
9668,U9887CB,35,12578.800000000001,26,9,2521.36,15100.16
9669,U7443C9,35,4478.169999999998,24,11,79433.68,83911.85
9670,U8CF78E,35,-7625.180000000001,30,5,9939.699999999999,2314.52
9671,UE5A7A1,35,1992.6199999999972,28,7,71517.37999999999,73510.0
9672,U98CEA8,35,-4.599999999999795,31,4,4404.25,4399.65
9673,U09A4A9,35,1224.1899999999987,32,3,3513.05,4737.24
9674,U9D59BC,35,419.3499999999997,26,9,7783.9,8203.25
9675,U320EAF,35,-987.0799999999999,31,4,8082.0599999999995,7094.98
9676,UD9CEDC,35,-86.98000000000013,30,5,2019.45,1932.47
9677,U5018DE,35,-130248.70999999993,26,9,226092.34999999995,95843.64
9678,UA320B5,35,-1780.26,33,2,5059.3,3279.04
9679,U3CAA39,35,13319.44,18,17,13619.32,26938.76
9680,U6514C9,35,1126.5700000000008,32,3,5671.17,6797.740000000001
9681,UC641D2,35,-8188.65,22,13,36443.5,28254.850000000002
9682,UFF9036,35,0.0,18,17,18000.0,18000.0
9683,U60E10E,35,-70.04999999999902,27,8,21098.69,21028.64
9684,U97A344,35,-3196.55,30,5,12359.7,9163.150000000001
9685,U1B351E,35,17044.69,14,21,54475.0,71519.69
9686,UD18436,35,6038.539999999997,27,8,8598.000000000002,14636.54
9687,U5CF87A,35,-2573.13,31,4,3592.03,1018.9
9688,UBA26F9,35,-923.6300000000015,31,4,11635.630000000003,10712.0
9689,U3B866D,35,-1535.650000000005,25,10,64128.94,62593.28999999999
9690,U7ABB80,35,-18.21999999999997,23,12,930.38,912.16
9691,UB663B6,35,-951.3499999999995,30,5,10497.589999999998,9546.24
9692,U6F4F0C,35,3159.88,27,8,11968.140000000001,15128.02
9693,U53FD56,35,11419.679999999997,26,9,15334.070000000003,26753.749999999996
9694,UCA49DD,35,1785.0900000000001,27,8,5182.21,6967.3
9695,U516FEB,35,2508.7400000000002,24,11,27731.72,30240.459999999995
9696,U88A6AC,35,-4366.0,33,2,10475.68,6109.68
9697,UBFC695,35,1578.0100000000002,25,10,7122.01,8700.02
9698,U83B5DB,35,1217.3499999999992,29,6,1506.34,2723.69
9699,UA4D438,35,-58426.40000000001,29,6,58997.34000000001,570.9399999999999
9700,UEFE203,35,1117.9799999999998,30,5,4894.52,6012.5
9701,UB9E9C4,35,-3671.0,27,8,7163.860000000001,3492.86
9702,U21528C,35,-2223.29,25,10,17387.03,15163.74
9703,UA90E10,35,-708.7199999999999,27,8,2495.5100000000007,1786.79
9704,U2F6E81,35,4990.240000000001,30,5,9658.070000000002,14648.31
9705,U5C9374,35,-328.1700000000001,31,4,1315.23,987.0600000000001
9706,UFB1F15,35,-11133.650000000001,25,10,31945.609999999997,20811.96
9707,U113595,35,1575.3199999999993,19,16,17173.91,18749.230000000003
9708,U16B14B,35,87.02999999999992,29,6,399.29,486.32
9709,U4C9F39,35,13906.670000000002,29,6,42572.28,56478.95
9710,UC4A1AD,35,1712.71,33,2,949.6299999999998,2662.34
9711,U335140,35,176.14000000000283,29,6,25125.269999999993,25301.410000000003
9712,U3AD8EB,35,-1509.1,23,12,5581.78,4072.6800000000003
9713,U24291D,35,-2121.7500000000005,32,3,9120.569999999998,6998.82
9714,UDAB94D,35,-16045.0,19,16,228318.24,212273.24
9715,UD42E68,35,-331.02999999999975,27,8,12333.18,12002.15
9716,UB9F2C3,35,-4.0,23,12,19965.0,19961.0
9717,U80AA25,35,3177.5300000000007,31,4,3676.909999999999,6854.4400000000005
9718,UF63AD8,35,812.3900000000004,32,3,5686.09,6498.48
9719,UC2FBEA,35,-409.3200000000002,29,6,11195.710000000001,10786.390000000001
9720,UD04F09,35,-43936.88,18,17,85810.16,41873.28
9721,U6891BE,35,-46554.81,32,3,53092.82,6538.01
9722,UBD1A4E,35,18423.86,27,8,17583.12,36006.98
9723,UAF67B9,35,-8854.4,31,4,11904.720000000001,3050.32
9724,UA7930C,35,1159.9799999999996,26,9,36559.009999999995,37718.99
9725,U6E7096,35,-1503.1200000000001,32,3,3172.23,1669.11
9726,U2491A4,35,-169.4100000000003,26,9,6013.179999999999,5843.77
9727,U9F4542,35,2759.49,30,5,18415.620000000003,21175.109999999997
9728,U9EE55E,35,12040.990000000003,31,4,17687.15,29728.14
9729,UDE5E0C,35,152751.8,18,17,36313.33,189065.13
9730,U03FDEF,35,92.44999999999982,23,12,11374.029999999999,11466.480000000003
9731,UC1F245,35,-607.7900000000006,30,5,10083.06,9475.27
9732,UE5C18F,35,-776.4099999999999,24,11,40976.8,40200.39
9733,U1B47EF,35,-123655.92,34,1,129822.61,6166.69
9734,UC2A47D,35,-317.78999999999996,26,9,6848.22,6530.43
9735,U835A80,35,-65502.5,33,2,79386.22,13883.72
9736,UF4651F,35,-2950.739999999996,28,7,22132.079999999998,19181.34
9737,U22A5FD,35,21792.84,27,8,35640.64,57433.48
9738,UC9484E,35,348.68999999999886,26,9,23576.14,23924.83
9739,U88F925,35,-12924.320000000003,34,1,12924.330000000002,0.01
9740,UD5FA1B,35,-30.36999999999898,17,18,137030.37,137000.0
9741,UF3E8A1,35,77.52999999999986,19,16,2855.1499999999996,2932.6800000000003
9742,U68915F,35,6013.3899999999985,12,23,74373.26999999999,80386.66
9743,U76E3A6,35,278.3399999999999,28,7,3137.6,3415.9399999999996
9744,U9EDDA5,35,9982.909999999945,19,16,2002168.86,2012151.77
9745,U9BF78A,35,-8076.41,24,11,45444.97,37368.56
9746,U4F8FE0,35,8.860000000000127,20,15,2823.8999999999996,2832.7599999999998
9747,UD3FCEB,35,12705.18,25,10,61278.74,73983.92
9748,UB57643,35,-4110.1,33,2,5342.2300000000005,1232.13
9749,U0659BD,35,-316.27000000000044,33,2,6943.3099999999995,6627.04
9750,UB122A6,35,95807.40000000001,21,14,11662.900000000003,107470.29999999999
9751,UB95726,35,-931.2000000000004,26,9,3916.05,2984.85
9752,U7A25F5,35,5177.049999999983,15,20,143709.36,148886.40999999997
9753,U165A3F,35,-1087.0,26,9,15387.14,14300.14
9754,U8A7EC3,35,-1851.119999999999,33,2,11017.119999999999,9166.0
9755,U9A7ABD,35,2573.3400000000006,23,12,4992.350000000001,7565.6900000000005
9756,U2B10FC,35,-20237.530000000002,23,12,60588.270000000004,40350.74
9757,UBD8D05,35,551.1300000000003,30,5,8924.88,9476.01
9758,UDBA885,35,-23.210000000000008,21,14,521.21,498.0
9759,UD31814,35,-1929.6299999999976,25,10,15273.259999999998,13343.63
9760,U83721F,35,1560.0600000000004,26,9,44586.9,46146.96
9761,UE346C9,35,260.51000000000005,27,8,1085.89,1346.4
9762,U8AC927,35,12537.02,32,3,47067.98000000001,59605.0
9763,U29EA40,35,26115.809999999998,22,13,62574.68,88690.49
9764,U2C0A70,35,44761.09999999999,25,10,11844.57,56605.669999999984
9765,U5A6C06,35,-5561.310000000001,31,4,19381.46,13820.149999999998
9766,U479D6C,35,-0.7700000000004366,23,12,4187.77,4187.0
9767,UEBBFD8,35,1830.58,31,4,8266.42,10097.0
9768,U6EFE3D,35,0.30999999999983174,20,15,2573.94,2574.25
9769,U37FB21,35,4930.850000000025,19,16,556434.3899999999,561365.24
9770,U59C54E,35,-6.109999999999218,26,9,22873.36,22867.25
9771,U556A05,35,-920.0399999999981,27,8,19247.77,18327.73
9772,U55438F,35,-355.02999999999975,22,13,13602.539999999999,13247.51
9773,U901215,35,6053.520000000004,21,14,68061.16,74114.68
9774,UB6090E,34,3910.8799999999997,30,4,15088.489999999996,18999.37
9775,U513FD7,34,-4146.110000000001,30,4,15086.750000000004,10940.64
9776,U237029,34,3620.669999999999,28,6,29925.8,33546.47
9777,U3C6A10,34,-5694.040000000003,30,4,53869.56,48175.520000000004
9778,U0BE15B,34,402.2199999999999,28,6,2348.9,2751.12
9779,UE1A6B3,34,-1512.87,25,9,4750.22,3237.35
9780,UE33047,34,43.86999999999989,21,13,5879.33,5923.2
9781,U75B65D,34,1860.0100000000002,16,18,11140.79,13000.8
9782,U0091D4,34,-44701.41000000002,13,21,790004.52,745303.1100000001
9783,U487A9E,34,-9955.119999999999,31,3,11439.179999999998,1484.06
9784,U865F5D,34,7834.480000000003,31,3,22107.44,29941.92
9785,UF923B5,34,52.349999999999966,31,3,962.7500000000001,1015.1
9786,UEE9C7C,34,-2696.8700000000003,32,2,2786.7000000000003,89.83
9787,U6824D6,34,-778.9000000000003,31,3,5630.860000000001,4851.96
9788,U6F436C,34,-134.39999999999782,25,9,44461.32,44326.920000000006
9789,U173396,34,-5492.5,32,2,5512.5,20.0
9790,UF64A17,34,381.08000000000004,29,5,2315.31,2696.39
9791,UDF5C95,34,267.20000000000437,24,10,306422.37,306689.57
9792,U3E122E,34,-9874.62000000001,30,4,55404.62000000001,45530.0
9793,UE32DEB,34,-187.7800000000001,32,2,798.61,610.8299999999999
9794,U0AB1C4,34,-1256.56,34,0,1256.56,0.0
9795,UED995B,34,1147.0700000000015,31,3,13310.44,14457.510000000002
9796,U3D49A0,34,-12253.38,31,3,15818.36,3564.98
9797,U2E65ED,34,106.62999999999982,30,4,8717.080000000002,8823.710000000001
9798,UFFB39D,34,-4967.32,32,2,11581.099999999999,6613.78
9799,U133CD6,34,187.60999999999947,26,8,9936.560000000007,10124.17
9800,U03BB88,34,3359.139999999996,28,6,39560.76,42919.899999999994
9801,UF9D3C9,34,-3429.880000000001,26,8,24701.88,21272.0
9802,U690A88,34,-1924.6899999999998,29,5,10510.619999999999,8585.93
9803,U8FE33D,34,-1261.6899999999987,28,6,19367.0,18105.31
9804,U424273,34,1027.9799999999996,21,13,22668.88,23696.86
9805,U6B20B7,34,-406.7000000000005,30,4,6088.310000000001,5681.610000000001
9806,U497913,34,2425.3900000000003,23,11,5255.699999999999,7681.09
9807,U8AB0F4,34,764.6400000000002,26,8,2401.07,3165.71
9808,U226F51,34,103.16000000000004,31,3,1900.48,2003.6399999999999
9809,U49104A,34,-2244.970000000001,32,2,102255.3,100010.33
9810,U2FF283,34,-27476.660000000003,29,5,57296.100000000006,29819.440000000002
9811,UC6ABB7,34,2009.8199999999997,20,14,21392.75,23402.57
9812,UFA267A,34,285.70000000000005,30,4,1152.3000000000002,1438.0
9813,UC3E066,34,-183.19000000000003,30,4,2127.94,1944.75
9814,U788DA8,34,16.18999999999994,26,8,6679.099999999999,6695.29
9815,U8503DF,34,-22055.12,23,11,112327.37,90272.25
9816,U6D59C5,34,23.79000000000002,31,3,341.21000000000004,365.0
9817,U32DC4A,34,63.92999999999975,29,5,5434.410000000001,5498.34
9818,U950CE9,34,-3648.84,28,6,5144.610000000001,1495.7699999999998
9819,UFD3E97,34,7459.199999999997,27,7,54302.350000000006,61761.55
9820,U577785,34,2552.3500000000017,29,5,25030.529999999995,27582.88
9821,UD53AF0,34,1002.8899999999991,31,3,52760.11000000001,53763.0
9822,UD6FFC5,34,1755.88,31,3,3307.14,5063.0199999999995
9823,UD0F38A,34,38111.0,16,18,89000.0,127111.0
9824,UDBD5F9,34,-28767.500000000007,20,14,129454.21999999999,100686.72
9825,UAA502D,34,22984.7,28,6,24977.27,47961.97
9826,UFB0E98,34,-1877.1099999999997,28,6,11928.27,10051.16
9827,U8A82CD,34,51.80000000000018,29,5,5998.200000000001,6050.0
9828,UD50D2B,34,943.1900000000005,26,8,58209.87,59153.06
9829,U4519AB,34,-21186.75,29,5,27161.05,5974.3
9830,UC5AD80,34,831.6299999999981,29,5,11502.180000000002,12333.81
9831,U1A51EE,34,3514.279999999999,22,12,58488.8,62003.08
9832,U70808D,34,-65.09000000000115,22,12,30132.510000000002,30067.42
9833,UE78EA0,34,52.399999999999935,32,2,1264.77,1317.17
9834,U13D8B0,34,-14078.409999999994,25,9,70933.87,56855.46
9835,U88F937,34,1365.68,25,9,7669.82,9035.5
9836,U79FBD8,34,-12131.859999999999,32,2,15226.849999999999,3094.99
9837,U36DC61,34,2154.310000000001,27,7,4653.320000000001,6807.63
9838,UEE6A77,34,-5233.1,28,6,7875.920000000001,2642.82
9839,U468037,34,-1472.8700000000001,32,2,7404.070000000001,5931.2
9840,UE6CFF1,34,1422.4499999999991,27,7,5634.650000000001,7057.1
9841,U6DDC8B,34,-10.329999999999927,28,6,3571.8600000000006,3561.5299999999997
9842,UF485D0,34,5.2299999999999045,21,13,3215.78,3221.01
9843,U99A563,34,94.21999999999969,26,8,18008.06,18102.28
9844,UC1A7E8,34,-915.4199999999987,21,13,50521.0,49605.579999999994
9845,UA6EB9F,34,31497.150000000005,29,5,22022.85,53520.0
9846,U14CEA1,34,-6940.570000000007,21,13,337686.07000000007,330745.5
9847,U301A7B,34,-12045.580000000002,34,0,12045.580000000002,0.0
9848,U8F70E8,34,40.0,18,16,51960.0,52000.0
9849,UAA7734,34,6966.0,27,7,1216.4,8182.4
9850,U6AB153,34,11412.009999999998,25,9,11849.409999999998,23261.42
9851,UB0EFED,34,49204.54,12,22,82290.51999999999,131495.06
9852,U98FF31,34,3680.6300000000006,13,21,2365.1299999999997,6045.76
9853,UCDEB43,34,-11364.070000000002,30,4,12969.080000000002,1605.01
9854,U36ED13,34,-4559.030000000001,23,11,56469.89000000001,51910.85999999999
9855,U5C2D56,34,9644.84,19,15,117962.2,127607.04
9856,UC19E43,34,-2.1316282072803006e-14,20,14,362.68999999999994,362.69000000000005
9857,U1007A9,34,123.82000000000033,28,6,1766.9999999999998,1890.82
9858,UC7A35D,34,-255.93000000000015,28,6,1384.21,1128.28
9859,U9014D7,34,-714.6899999999994,20,14,28724.710000000006,28010.02
9860,UCC7A4F,34,-3021.5900000000024,25,9,60088.55,57066.96
9861,U0AA515,34,4.0,17,17,31566.0,31570.0
9862,U5B04FC,34,-3615.599999999986,19,15,200934.54,197318.94000000003
9863,UFEEDB1,34,148.01999999999953,29,5,7932.93,8080.950000000001
9864,U525CD3,34,6194.140000000001,21,13,7677.84,13871.98
9865,UBC2A54,34,1265.1799999999987,31,3,5101.860000000001,6367.04
9866,UEAFF43,34,-1699.4399999999998,31,3,8534.400000000001,6834.96
9867,UBAA7B9,34,-2235.2,32,2,13237.25,11002.05
9868,U98E486,34,-2771.2200000000003,31,3,7204.95,4433.73
9869,UEC9E57,34,-42235.42000000001,31,3,89421.9,47186.479999999996
9870,UB4C803,34,6553.2699999999995,27,7,3890.33,10443.6
9871,UA1F694,34,-2063.0599999999995,31,3,4588.3099999999995,2525.25
9872,U46131D,34,306.2899999999993,21,13,121193.27,121499.56
9873,UFD4312,34,-932.9600000000005,30,4,2998.96,2066.0
9874,U80F91C,34,6153.83,27,7,11968.730000000001,18122.559999999998
9875,U744F5A,34,211.06,30,4,458.34000000000003,669.4
9876,UD129CA,34,-4323.790000000001,26,8,10516.100000000002,6192.31
9877,UB7D814,34,-13159.37,20,14,39842.27999999999,26682.91
9878,U74D50B,34,-882.2400000000027,31,3,26069.079999999998,25186.839999999997
9879,UCFA4FA,34,-4610.1900000000005,31,3,9724.050000000001,5113.86
9880,U89654F,34,-684.4499999999961,29,5,74705.55000000002,74021.1
9881,UCFE4BE,34,10492.360000000002,26,8,7128.69,17621.05
9882,U4FFAD4,34,-277181.59,11,23,1725770.0,1448588.41
9883,U7666D1,34,-547.3400000000003,30,4,7918.54,7371.2
9884,U5EAB36,34,-541.5999999999977,19,15,75638.47,75096.87000000001
9885,U6BF279,34,4728.389999999999,22,12,26010.559999999994,30738.949999999997
9886,U61C274,34,-180.63,23,11,1994.15,1813.5200000000002
9887,U3A3009,34,-1334.2999999999995,28,6,2769.7,1435.4
9888,U14A747,34,-6578.610000000001,34,0,6578.610000000001,0.0
9889,U4B4B09,34,769.9199999999994,29,5,2147.22,2917.14
9890,U338CFC,34,-5115.78,29,5,38870.920000000006,33755.14
9891,UA1B5C4,34,-46.82999999999993,32,2,3215.64,3168.8100000000004
9892,U0B88A2,34,-146.0999999999999,24,10,4249.89,4103.79
9893,UB0D7C3,34,7098.08,28,6,17515.350000000002,24613.43
9894,UBB4260,34,2553.0099999999993,30,4,4472.09,7025.099999999999
9895,U30E603,34,-8719.46,21,13,26079.660000000003,17360.2
9896,U417DFE,34,-22148.160000000003,29,5,26297.89,4149.73
9897,UD5E314,34,26948.799999999996,20,14,13861.219999999998,40810.02
9898,UD4F495,34,-19986.53,19,15,171952.27,151965.73999999996
9899,U3950AF,34,-1905.58,30,4,5594.3099999999995,3688.73
9900,U8FB54C,34,5458.160000000002,29,5,13414.760000000002,18872.92
9901,U830580,34,10345.51,29,5,14066.99,24412.5
9902,UDD84EF,34,2166.1999999999953,30,4,23734.89,25901.09
9903,U08E47B,34,6842.139999999992,21,13,191992.29000000004,198834.43000000002
9904,UF1F8A4,34,-424.5599999999999,32,2,1526.1699999999998,1101.6100000000001
9905,UFA6FE0,34,-5880.09,33,1,14880.09,9000.0
9906,UDFB86D,34,15159.7,29,5,7661.259999999999,22820.960000000003
9907,U104C76,34,1558.5500000002244,26,8,3104498.2399999998,3106056.79
9908,U1A4DB0,34,235.24,32,2,2184.76,2420.0
9909,U7F1FA9,34,-18308.989999999998,23,11,46712.66,28403.670000000006
9910,U0DC426,34,-1830.2199999999998,13,21,9040.800000000001,7210.58
9911,UACBAA5,34,680.0199999999998,26,8,4195.8099999999995,4875.83
9912,UF283C0,34,-4859.689999999999,26,8,5340.969999999999,481.28000000000003
9913,U6F9069,34,-10791.39,27,7,37307.399999999994,26516.010000000002
9914,UEE470C,34,733.8999999999988,29,5,7777.149999999999,8511.05
9915,U624E07,34,13016.75,25,9,86715.23999999999,99731.98999999999
9916,UFCCFB8,34,41365.90999999998,26,8,61492.05000000001,102857.95999999999
9917,UE307BA,34,-99.77999999999992,31,3,649.7799999999997,550.0
9918,UDBF4ED,34,1975.409999999999,26,8,20336.64,22312.05
9919,UBFBA20,34,-204.96000000000004,22,12,4945.66,4740.7
9920,UDDF002,34,6342.35,22,12,18849.930000000004,25192.28
9921,U725ABE,34,201.08000000000004,32,2,888.9,1089.98
9922,U6806D9,34,5830.96,31,3,1805.6299999999999,7636.59
9923,U693B29,34,1445.0,21,13,53341.34,54786.34
9924,U4177E9,34,-123620.25999999998,25,9,165272.36999999994,41652.11
9925,U843857,34,-4272.879999999999,24,10,8792.88,4520.0
9926,U80544D,34,1515.3700000000003,31,3,3913.4,5428.77
9927,U9B0A38,34,-46728.200000000004,33,1,46740.44,12.24
9928,U226C3B,34,-315.2300000000001,29,5,1685.3799999999999,1370.1499999999999
9929,U3742D4,34,1971.9699999999975,28,6,33108.01,35079.98
9930,U1F302A,34,521.9500000000005,26,8,3693.6800000000003,4215.629999999999
9931,U6FCAC3,34,-5602.190000000002,19,15,108382.0,102779.81
9932,U20AEA8,34,33719.669999999955,16,18,2342535.31,2376254.9800000004
9933,U460D16,34,-11.999999999999545,18,16,7720.85,7708.85
9934,UBD1714,34,-7354.919999999999,30,4,14930.92,7576.0
9935,U1BDDA1,34,-5031.52,19,15,133161.0,128129.48000000001
9936,U523BF6,34,265.55,23,11,6441.83,6707.38
9937,U3CCBEC,34,-59.719999999999345,25,9,33456.80000000001,33397.08
9938,U775EB0,34,2299.439999999995,20,14,101588.18999999999,103887.62999999999
9939,U1271A6,34,116.61000000000013,26,8,1770.3400000000001,1886.95
9940,U0BA651,34,-1496.67,26,8,23530.0,22033.33
9941,U093C86,34,0.08999999999988972,17,17,40156.76,40156.850000000006
9942,UD7C03F,34,2613.0499999999997,18,16,5559.600000000002,8172.65
9943,UE84C38,34,-26092.969999999998,28,6,36901.53999999999,10808.57
9944,U28FB7A,34,-5853.170000000001,28,6,10380.35,4527.18
9945,UF01013,34,-5553.660000000001,28,6,7669.6100000000015,2115.9500000000003
9946,UDD6956,34,-1445.8299999999988,32,2,28315.83,26870.0
9947,UDFA760,34,-14.0,20,14,59987.0,59973.0
9948,U8A7F95,34,2514.2599999999993,18,16,26821.28,29335.54
9949,U1DD19E,34,3691.0800000000563,12,22,4647650.0,4651341.08
9950,U49421C,34,-22679.71,23,11,64003.7,41323.99
9951,UBC3C36,34,-814.6299999999992,28,6,13184.57,12369.939999999999
9952,U7ECCD3,34,1868.8499999999997,22,12,7585.449999999998,9454.3
9953,UC04701,34,-25959.180000000008,20,14,52499.179999999986,26540.0
9954,UD567BF,34,-11961.35,18,16,62744.530000000006,50783.18
9955,U71BDBB,34,3420.3100000000018,26,8,11527.670000000002,14947.980000000001
9956,U653ED2,34,-8625.130000000005,18,16,644128.27,635503.14
9957,U599C17,33,14584.230000000012,27,6,60896.3,75480.53
9958,U8E312D,33,-3010.0,30,3,6528.400000000001,3518.4
9959,UB43412,33,-11631.279999999999,33,0,11631.279999999999,0.0
9960,U5DF304,33,-4009.8499999999985,28,5,28959.809999999998,24949.96
9961,UBACDB9,33,-4547.0,25,8,9436.68,4889.68
9962,U30F56E,33,-12433.080000000002,28,5,23865.02,11431.94
9963,UE726C9,33,-554.7700000000077,31,2,44259.770000000004,43705.0
9964,U8762DA,33,-106.58999999999924,27,6,16410.51,16303.92
9965,UE79C9D,33,-135.22000000000116,26,7,19356.72,19221.5
9966,U08B60F,33,-1548.6,30,3,3743.81,2195.21
9967,U2DCA64,33,81083.87,27,6,70257.34,151341.21000000002
9968,U02F857,33,-1897.7399999999986,26,7,18315.159999999996,16417.42
9969,UFCEDEE,33,424.9499999999998,25,8,14957.01,15381.96
9970,UCA4494,33,65674.11000000002,16,17,92473.1,158147.21000000002
9971,U60C931,33,645.3600000000008,18,15,7590.469999999999,8235.83
9972,U559957,33,-5810.3200000000015,23,10,73579.89000000001,67769.57
9973,U37F5A4,33,-1312.4,32,1,1612.4000000000005,300.0
9974,U588568,33,-2086.4900000000002,29,4,10370.470000000001,8283.98
9975,UDC853D,33,-29888.710000000006,17,16,194150.95,164262.24
9976,U044D35,33,104.7399999999995,27,6,8080.209999999999,8184.95
9977,U4B6078,33,5844.56,26,7,2866.6000000000004,8711.160000000002
9978,U4A2131,33,33.50000000000001,17,16,482.0,515.5
9979,U748B36,33,-5339.769999999994,24,9,23830.25,18490.480000000003
9980,UEA6050,33,-1022.85,31,2,1074.0,51.15
9981,U7502DE,33,-23479.750000000004,32,1,23480.100000000002,0.35
9982,U3B5A12,33,-514.4799999999999,30,3,970.0299999999997,455.55
9983,U494D5F,33,-8717.910000000002,26,7,9305.440000000002,587.53
9984,U667A60,33,459.8700000000002,28,5,4537.92,4997.790000000001
9985,U6CFAFE,33,222.70999999999987,25,8,2968.0400000000004,3190.75
9986,U71BFE9,33,-631.4000000000001,27,6,11857.219999999998,11225.82
9987,UB0BBF8,33,153.79999999999995,29,4,404.18000000000006,557.98
9988,U61FFCA,33,-14.740000000000236,19,14,32390.960000000003,32376.219999999998
9989,U37BA19,33,-11565.77999999991,28,5,832576.3899999999,821010.6100000001
9990,UD35C13,33,-1403.0700000000002,28,5,6957.610000000001,5554.54
9991,U1F3390,33,-6049.3,23,10,13478.3,7429.0
9992,UAD282C,33,12.0,18,15,11007.170000000002,11019.17
9993,U7BD7D9,33,-2501.1099999999997,33,0,2501.1099999999997,0.0
9994,U4C62EA,33,687.999999999993,19,14,78604.43,79292.43000000001
9995,U5C9289,33,4937.43,15,18,44085.3,49022.729999999996
9996,U44BD7E,33,4167.499999999998,30,3,26211.83,30379.33
9997,U723AFC,33,1.8189894035458565e-12,22,11,23933.42,23933.42
9998,U7BFBDC,33,-3171.5699999999997,27,6,27736.870000000003,24565.3
9999,U541073,33,-445.3300000000004,31,2,3645.8,3200.47
10000,UA79D2E,33,29080.049999999996,19,14,54493.28,83573.32999999999
10001,UAF0A1F,33,729.43,24,9,17271.56,18000.989999999998
10002,U33564F,33,-1251.1599999999999,26,7,17145.949999999997,15894.79
10003,U889E22,33,-295.77999999999975,28,5,10382.7,10086.92
10004,U793AD8,33,3837.2199999999993,15,18,22198.64,26035.86
10005,U92DC3E,33,-289.60000000000014,31,2,1789.6000000000006,1500.0
10006,U6606EC,33,391.90000000000055,29,4,10872.800000000001,11264.7
10007,U089D0F,33,-2061.1,26,7,8286.079999999998,6224.98
10008,UACBFC0,33,7019.61,29,4,4775.729999999999,11795.34
10009,U096193,33,-1378.6000000000004,27,6,6755.16,5376.5599999999995
10010,UB2695D,33,3.4900000000000233,23,10,1263.85,1267.3400000000001
10011,U78E304,33,21330.760000000002,20,13,88273.95,109604.70999999999
10012,UAEBA30,33,-10559.84,29,4,69914.78000000001,59354.939999999995
10013,UCB08F3,33,-155592.18999999965,25,8,3997792.8000000003,3842200.61
10014,UED3FED,33,-13215.25,20,13,37962.86,24747.61
10015,UDBD63D,33,-90073.93,22,11,400055.85000000003,309981.92000000004
10016,U4FDD9D,33,-1510.2800000000002,27,6,11228.5,9718.22
10017,U453256,33,3907.239999999999,28,5,30600.34,34507.58
10018,U13825B,33,-2121.270000000003,29,4,22635.309999999994,20514.04
10019,U0CB2AB,33,-2067.01,30,3,2622.3,555.29
10020,UC0394E,33,-52.22000000000036,24,9,5137.200000000001,5084.98
10021,U0784AF,33,729.6500000000001,23,10,17982.59,18712.239999999998
10022,UA84F5A,33,-2959.0300000000007,22,11,44734.79,41775.759999999995
10023,U508C3C,33,-201.89999999999964,23,10,15572.37,15370.47
10024,UF6117E,33,-958.6500000000051,30,3,26187.950000000004,25229.3
10025,U04568B,33,-688.81,27,6,4884.03,4195.219999999999
10026,UA65B47,33,-21207.25,14,19,331142.05000000005,309934.8
10027,U167BCC,33,40381.390000000014,19,14,13777.640000000001,54159.030000000006
10028,UEDA20F,33,8525.009999999998,17,16,16051.380000000001,24576.389999999996
10029,UFD13FB,33,998.0299999999997,16,17,16296.920000000002,17294.95
10030,U596E54,33,-853.3899999999992,26,7,15977.99,15124.6
10031,UE1BC54,33,-1126.5,29,4,2043.46,916.9599999999999
10032,UD8DABE,33,5197.17,26,7,10315.0,15512.17
10033,U438418,33,1768.87,25,8,4179.99,5948.860000000001
10034,U9F9AA1,33,10051.670000000002,25,8,17852.06,27903.73
10035,UA717FD,33,-1507.4300000000003,29,4,4713.43,3206.0
10036,UA48200,33,-280.27,29,4,1846.1,1565.83
10037,U3BE4AE,33,818.2699999999995,23,10,69015.5,69833.76999999999
10038,U790FAB,33,21152.21,20,13,69807.0,90959.20999999999
10039,UBCCE97,33,-7318.929999999999,20,13,49794.130000000005,42475.2
10040,UB40CA3,33,-12979.81,29,4,18181.25,5201.4400000000005
10041,U4BF154,33,-978.8800000000001,28,5,7768.77,6789.89
10042,U165CFB,33,-59656.0,30,3,200465.4,140809.4
10043,U80113D,33,-27738.65,26,7,49470.12,21731.47
10044,UBF8095,33,-49863.58000000001,25,8,92500.28000000001,42636.700000000004
10045,UDC1450,33,-3868.839999999982,16,17,400670.0,396801.16000000003
10046,UD918E8,33,-1751.6200000000008,23,10,36991.60999999999,35239.99
10047,UFE6DD6,33,-1416.2699999999995,30,3,1534.2699999999995,118.0
10048,U638491,33,-13967.399999999974,18,15,313973.89999999997,300006.5
10049,UFC653C,33,0.199999999997317,25,8,21998.799999999996,21999.0
10050,U2DA9C1,33,3430.8100000000013,24,9,18409.190000000002,21840.0
10051,U4D635D,33,877.4699999999998,29,4,1931.74,2809.21
10052,UAB043E,33,-103.79999999999995,25,8,1189.2999999999997,1085.5
10053,U2F4712,33,-7050.559999999996,26,7,61683.979999999996,54633.42
10054,U84B51A,33,928.1499999999994,24,9,9709.61,10637.76
10055,U4E2167,33,-1326.7599999999995,28,5,58626.76000000001,57300.0
10056,UED9EFE,33,-2622.2299999999996,19,14,63615.32,60993.09
10057,UF375B4,33,-278.9999999999998,26,7,2127.61,1848.61
10058,UFDB0F9,33,0.28000000000002956,30,3,712.38,712.6600000000001
10059,UC9F893,33,-72.43999999999983,30,3,2670.63,2598.19
10060,U684338,33,85.84000000000006,27,6,1027.1099999999997,1112.95
10061,U54C04A,33,-3925.390000000001,31,2,9375.389999999998,5450.0
10062,U11D4F3,33,-5282.66,27,6,20634.1,15351.439999999999
10063,U339B1D,33,-50.420000000000016,31,2,699.73,649.31
10064,UE38B1B,33,2733.5200000000004,27,6,1155.4799999999996,3889.0
10065,U6CB828,33,189.04000000000042,22,11,36769.87999999999,36958.92
10066,UC4C213,33,967.1299999999994,30,3,1460.65,2427.7799999999997
10067,U28EE3D,33,-2742.7300000000014,31,2,7339.8200000000015,4597.09
10068,UFCC99C,33,257.7100000000001,29,4,2445.5,2703.21
10069,U6BE5E9,33,-1765.9700000000005,19,14,3806.0000000000005,2040.03
10070,UD765D2,33,-7326.54,26,7,11930.670000000002,4604.13
10071,UF750E2,33,-23294.06,31,2,36947.23,13653.17
10072,U749057,33,-367.19000000000017,30,3,1359.9899999999998,992.8
10073,U1D5136,33,-94.10000000000022,21,12,6501.459999999999,6407.36
10074,UCCBA7E,33,999.1899999999962,23,10,173385.09,174384.27999999997
10075,U7C2E6E,33,-11467.95,23,10,39925.3,28457.35
10076,UC5DA16,33,-83744.35000000002,32,1,83754.35000000002,10.0
10077,UE7F7EE,33,1397.5799999999995,19,14,30316.079999999994,31713.660000000003
10078,U81AADB,33,1856.1600000000078,29,4,106143.54000000002,107999.7
10079,UF046C5,33,-3848.2599999999998,30,3,4954.26,1106.0
10080,UC04075,33,-4551.859999999995,28,5,27883.59,23331.73
10081,UBD8CDD,33,8037.429999999999,28,5,2813.6000000000004,10851.029999999999
10082,U20F642,33,18734.379999999997,23,10,34705.21,53439.59
10083,U926A50,33,814.3000000000001,29,4,2015.8,2830.1
10084,U9DDB28,33,-4000.0,29,4,38000.0,34000.0
10085,U1D0398,33,-5481.53,33,0,5481.53,0.0
10086,U9207FD,33,0.0,17,16,20000.0,20000.0
10087,UABC31B,33,94088.61999999998,23,10,180257.71000000002,274346.33
10088,UC798AB,33,1458.7000000000012,28,5,10502.33,11961.029999999999
10089,U10685B,33,30.56999999999971,25,8,15354.6,15385.169999999998
10090,UC1740D,33,-3917.4300000000003,23,10,6111.88,2194.45
10091,UD242B8,33,-67.83000000000118,23,10,20253.83,20186.0
10092,U5B61A1,33,-1158.0000000000007,16,17,10282.71,9124.710000000001
10093,U34D10C,33,0.0,16,17,50000.0,50000.0
10094,UCC959A,33,259.2399999999998,20,13,54263.6,54522.84
10095,U4657D2,33,1431.1499999999996,23,10,18571.32,20002.47
10096,U14E4B1,33,720.6999999999999,29,4,1864.6800000000005,2585.38
10097,UF44A3E,33,-3419.24,30,3,21784.239999999998,18365.0
10098,UBA1686,33,-1270.48,28,5,3074.6499999999996,1804.1699999999998
10099,UDBD97A,33,2943.5299999999997,25,8,14730.8,17674.33
10100,U2EAB33,33,-3486.84,28,5,11688.84,8202.0
10101,UB24E5B,33,-11062.0,18,15,91664.0,80602.0
10102,UD4CE74,33,-2639.2,30,3,4104.889999999999,1465.69
10103,U265F55,33,1284.96,20,13,6412.230000000001,7697.1900000000005
10104,UB97C57,33,17.64,30,3,136.59999999999997,154.24
10105,U264B64,33,-983.9400000000005,25,8,32084.809999999998,31100.87
10106,U6C8B48,33,-21867.699999999997,30,3,35145.94000000001,13278.24
10107,UB58266,33,2319.0299999999997,25,8,2989.3100000000004,5308.34
10108,U157536,33,-72.2400000000001,21,12,3308.6800000000003,3236.4399999999996
10109,U188A6A,33,-209.51999999999998,30,3,1082.78,873.26
10110,U1D815D,33,-5471.77,30,3,15295.77,9824.0
10111,U0FDDEA,33,-8963.67,31,2,14906.64,5942.969999999999
10112,UD7B923,33,-3248.3200000000033,22,11,164718.8,161470.47999999998
10113,U3F124C,33,1241.8199999999997,28,5,2024.2999999999997,3266.12
10114,UDED5C3,33,-29991.5,10,23,232705.5,202714.0
10115,UBFDC98,33,-25117.750000000007,30,3,51719.75000000001,26602.0
10116,U6E41D5,33,-10096.02,24,9,44787.22,34691.2
10117,U5BEF60,33,-24159.12,26,7,52044.86000000001,27885.74
10118,UC343B1,33,1228.71,29,4,1152.38,2381.09
10119,U9ECA27,33,-1703.3900000000008,28,5,3432.4200000000005,1729.0299999999997
10120,U2AA46E,33,13620.86,26,7,85305.53,98926.39
10121,UB58D17,33,-9524.77,30,3,16823.410000000003,7298.639999999999
10122,U9DF70F,33,1055.84,31,2,4776.96,5832.799999999999
10123,U4A142F,33,-128.87000000000012,24,9,11596.650000000001,11467.78
10124,U485BBB,33,336.16999999999996,31,2,1126.93,1463.1
10125,U90D617,33,824.5799999999999,28,5,7397.81,8222.39
10126,U40BD6A,33,1795.7199999999998,24,9,3374.62,5170.34
10127,UF1C90B,33,1370.5000000000007,31,2,6702.2,8072.700000000001
10128,U5E6DCE,33,-2016.86,27,6,11940.1,9923.24
10129,U348544,33,-614.6800000000004,18,15,14412.91,13798.23
10130,U4E9137,33,-228.2199999999973,15,18,30630.72,30402.500000000004
10131,U331AC0,33,1641.1400000000012,26,7,44054.66,45695.8
10132,UFD6624,33,442.13999999999953,17,16,26633.77,27075.910000000003
10133,UCC0A5D,33,494.8400000000007,25,8,3886.1299999999997,4380.969999999999
10134,U53E36B,33,-9996.099999999999,15,18,21226.1,11230.0
10135,U440787,33,45194.66,23,10,35905.34,81100.0
10136,U13C943,33,-1770.3600000000001,31,2,7183.37,5413.01
10137,U96CB81,33,-3276.9900000000007,27,6,36280.05,33003.06
10138,UB76192,33,-345.7099999999991,24,9,26097.4,25751.690000000002
10139,UFC0812,33,51789.740000000005,18,15,153324.97999999998,205114.72
10140,U59D93A,33,-5033.370000000001,28,5,32224.000000000004,27190.630000000005
10141,UA20EBD,33,11197.529999999999,22,11,24366.509999999995,35564.04000000001
10142,U375835,33,-810.88,29,4,6004.3,5193.42
10143,U8769A5,33,50350.950000000004,20,13,54851.40000000001,105202.35
10144,U54BC90,33,5933.579999999999,21,12,26991.840000000007,32925.42
10145,UC670F8,33,680.5099999999993,31,2,7085.660000000001,7766.17
10146,U4CCD2B,33,17113.11999999999,27,6,15852.91,32966.03
10147,U7B662F,33,-374.9400000000001,28,5,3862.8000000000006,3487.86
10148,UCB1C1D,33,12821.44,26,7,10667.009999999998,23488.449999999997
10149,U7334A5,33,-124.6200000000008,21,12,29552.0,29427.379999999997
10150,U42A5D6,33,1300.5699999999997,19,14,5132.009999999999,6432.58
10151,U523C2D,33,6626.359999999998,30,3,11628.679999999998,18255.04
10152,U9BAE0A,33,632.48,28,5,2995.85,3628.33
10153,UB423C7,33,-384.69000000000005,24,9,7280.8899999999985,6896.2
10154,U4478A0,33,-13613.66,18,15,73357.56,59743.9
10155,UCD6ADA,33,12360.3,20,13,25649.399999999998,38009.700000000004
10156,U20F490,33,-4864.24,28,5,7535.95,2671.71
10157,U308043,33,-1071.24,28,5,6820.9400000000005,5749.7
10158,U22DB51,33,-56.13000000000102,27,6,18413.39,18357.260000000002
10159,UFF5FC4,33,168758.34,22,11,15440.97,184199.31
10160,U6F6BA1,33,9854.920000000006,28,5,12363.12,22218.04
10161,U91BFD2,33,-17056.370000000003,32,1,25056.370000000003,8000.0
10162,UA69E0B,33,414.7399999999993,31,2,8283.46,8698.2
10163,U43B6D9,33,26171.699999999997,30,3,47828.3,74000.0
10164,U076A89,33,-289.8299999999997,20,13,8624.31,8334.480000000001
10165,U3BE5A7,33,2580.4400000000005,8,25,18728.21,21308.65
10166,UAF4063,33,1089.2600000000002,25,8,1410.7800000000002,2500.0400000000004
10167,UF96282,33,-10797.26,31,2,18621.53,7824.27
10168,UE1BB47,33,-1004.0,31,2,1078.0,74.0
10169,U339EA9,33,-481.04,29,4,3724.1200000000003,3243.0800000000004
10170,UB94E31,33,-4054.5400000000027,19,14,5855.100000000002,1800.56
10171,UC713F8,32,-23.119999999996253,27,5,10641.539999999997,10618.42
10172,U13DA64,32,80.4,22,10,1301.3,1381.7
10173,UE573D1,32,-4403.82,29,3,10923.330000000002,6519.51
10174,UFE2472,32,-6776.999999999999,29,3,23198.2,16421.2
10175,UFEDC94,32,-1104.07,29,3,3783.22,2679.15
10176,U0B99F6,32,4855.87,18,14,17715.239999999998,22571.109999999997
10177,U85B911,32,1924.7699999999986,18,14,58030.2,59954.97
10178,U01AEE1,32,-1860.7999999999993,17,15,69315.8,67455.0
10179,U947FFC,32,4.699999999999626,17,15,4221.41,4226.110000000001
10180,U371E22,32,-480.28999999999905,25,7,19096.18,18615.89
10181,U40006B,32,1464.5100000000002,26,6,18358.96,19823.47
10182,UE8644A,32,-30.87999999999986,29,3,1418.25,1387.37
10183,UFCF0A7,32,3037.27,26,6,7349.7300000000005,10387.0
10184,U53AE93,32,32578.990000000005,20,12,192642.28,225221.27000000002
10185,UD14DA9,32,-970.7900000000001,26,6,5903.790000000001,4933.0
10186,U36E516,32,5.2500000000009095,26,6,42185.26000000001,42190.51
10187,U07EF84,32,25206.45,23,9,29361.53,54567.98
10188,UCE2248,32,-18057.630000000012,26,6,52663.42,34605.79
10189,U68961A,32,-5637.060000000002,29,3,36346.280000000006,30709.22
10190,U2556DB,32,-89.31000000000007,29,3,2201.1,2111.79
10191,U748B5B,32,13743.759999999995,15,17,183209.47,196953.23
10192,UFF42E8,32,10678.0,24,8,11277.82,21955.82
10193,UAF6E85,32,-3.0600000000002723,21,11,8735.32,8732.26
10194,U3C6CCD,32,-36969.079999999994,23,9,62599.77,25630.689999999995
10195,U08FFD5,32,1353.289999999999,14,18,64304.48,65657.76999999999
10196,U535EB5,32,-527.92,30,2,1385.92,858.0
10197,UBC04F0,32,1064.5200000000011,26,6,10956.279999999999,12020.800000000001
10198,U696553,32,-596.3500000000004,27,5,2117.65,1521.3
10199,UC715E9,32,10953.67000000001,20,12,96688.80999999998,107642.48
10200,UB06190,32,1641.1000000000013,28,4,16524.56,18165.66
10201,U1E9999,32,-5470.879999999999,27,5,31570.879999999997,26100.0
10202,UC6A16E,32,36436.87,15,17,16497.760000000002,52934.63
10203,U1E50B2,32,-2462.99,20,12,99856.0,97393.01000000001
10204,U39E250,32,-912.8999999999978,26,6,21613.670000000002,20700.77
10205,UE24E66,32,-240.89000000000004,28,4,3051.9299999999994,2811.04
10206,UFB3790,32,380.99999999999994,25,7,7410.3099999999995,7791.3099999999995
10207,U9CF08F,32,1517.3799999999997,28,4,9259.6,10776.98
10208,UB15A3F,32,-3850.2200000000003,23,9,13906.220000000001,10056.0
10209,U145DB2,32,2065.66,23,9,2893.3700000000003,4959.03
10210,UC14A00,32,-185.62999999999965,23,9,6516.22,6330.589999999999
10211,UB14E89,32,5178.639999999999,29,3,1821.36,7000.0
10212,U5D1972,32,-37277.99,17,15,43162.21,5884.219999999999
10213,UB65354,32,-9403.78,21,11,39925.61,30521.83
10214,UEEB43A,32,-8786.88,29,3,16351.88,7565.0
10215,UCC8EB6,32,1898.57,28,4,1007.0999999999999,2905.67
10216,U81B1A8,32,148.11999999999992,24,8,8381.369999999994,8529.49
10217,UF6A785,32,-4557.200000000002,28,4,5200.500000000001,643.3
10218,U30BF46,32,-4925.7699999999995,26,6,7164.7699999999995,2239.0
10219,U152C98,32,401.75999999999954,24,8,20627.97,21029.73
10220,U0BA8A0,32,-1153.4399999999998,28,4,5166.14,4012.7
10221,U4625C8,32,11267.64,16,16,14577.9,25845.54
10222,U02696D,32,7578.769999999992,24,8,74206.04000000001,81784.81
10223,U61E838,32,830.6200000000099,18,14,83048.92,83879.54000000001
10224,U1596CE,32,-5456.210000000003,17,15,92941.0,87484.79000000001
10225,U593F61,32,192.84000000000378,26,6,239739.06,239931.9
10226,UE7EF94,32,15809.960000000001,25,7,36228.58,52038.54
10227,UBAB9C8,32,223.36,19,13,1701.81,1925.17
10228,U644D62,32,1308.73,25,7,3036.04,4344.77
10229,U249303,32,-561.3800000000001,32,0,561.3800000000001,0.0
10230,U21154D,32,-439.60000000000036,22,10,15685.6,15246.0
10231,UF57FCC,32,-1967.31,26,6,11572.11,9604.8
10232,U2A8387,32,-3442.26,27,5,20009.77,16567.510000000002
10233,U9943F9,32,2833.0999999999995,29,3,839.2799999999999,3672.38
10234,U1C5D78,32,-48.03999999999985,29,3,2268.94,2220.9
10235,U5D87C6,32,1592.4400000000007,21,11,13943.68,15536.119999999999
10236,U69DDDB,32,33.340000000000146,23,9,15012.0,15045.34
10237,U3161DD,32,64.47,28,4,515.49,579.96
10238,U0DA175,32,27.83000000000004,26,6,3681.0199999999995,3708.8500000000004
10239,U345106,32,5246.830000000002,21,11,41677.350000000006,46924.18
10240,UFDB2D8,32,24.75999999999999,12,20,67199.48000000001,67224.23999999999
10241,UC992C3,32,593.0499999999997,18,14,17679.02,18272.07
10242,UFD65F7,32,-9955.569999999998,28,4,26461.78,16506.21
10243,UB4C453,32,3301.6799999999994,30,2,3456.4300000000003,6758.110000000001
10244,UC29E15,32,-3030.619999999999,18,14,101791.0,98760.38
10245,UE19D12,32,2553.2700000000013,23,9,14376.32,16929.59
10246,UE5CEB6,32,6241.8099999999995,26,6,86.67,6328.48
10247,U3244BC,32,703.49,28,4,1936.98,2640.4700000000003
10248,U50D38D,32,-478.6200000000026,25,7,20859.860000000004,20381.239999999998
10249,U82D5D3,32,7899.9800000000005,13,19,29325.570000000003,37225.549999999996
10250,U89AF72,32,-2352.55,28,4,6759.55,4407.0
10251,U57DC81,32,-1262.270000000001,29,3,3881.270000000001,2619.0
10252,UE5A154,32,10000.7,19,13,36980.13,46980.83
10253,UBC73D8,32,-3148.980000000003,24,8,14333.480000000005,11184.5
10254,U943E81,32,-1917.98,26,6,2686.89,768.91
10255,UDEFF23,32,1015.3299999999998,29,3,6683.79,7699.12
10256,U9028DF,32,4497.300000000001,30,2,5307.849999999999,9805.15
10257,U9430D5,32,20425.350000000002,15,17,31734.789999999997,52160.14
10258,UF4EDC5,32,-5.684341886080802e-14,27,5,1314.55,1314.55
10259,UB4282C,32,16391.299999999996,29,3,51208.700000000004,67600.0
10260,UFC3D22,32,-402.5900000000056,21,11,139415.5,139012.91
10261,U83E075,32,276.96999999999815,25,7,21703.65,21980.62
10262,UB876ED,32,-4049.87,21,11,13891.6,9841.73
10263,UFC9FD1,32,-89.6299999999992,24,8,12236.0,12146.370000000003
10264,U8EA62F,32,-1336.8999999999999,28,4,3759.2000000000003,2422.3
10265,UD51E69,32,28800.79,6,26,26264.48,55065.27
10266,U2A7DC6,32,14030.349999999999,17,15,34322.9,48353.25
10267,U1093D3,32,-5286.660000000004,23,9,72950.02000000002,67663.36
10268,U3A11A9,32,3618.8399999999992,27,5,6295.9400000000005,9914.779999999999
10269,U61B523,32,-939.2999999999956,21,11,43909.369999999995,42970.07
10270,UC0B255,32,-1363.22,25,7,18496.140000000003,17132.92
10271,UB03A5F,32,206.40999999999983,18,14,4889.33,5095.740000000001
10272,UEFF82E,32,-7591.730000000001,22,10,51928.61,44336.88
10273,UE35941,32,-92.58000000000015,23,9,14673.359999999999,14580.78
10274,U355952,32,96.01000000000005,30,2,703.9900000000001,800.0
10275,UDA41E9,32,1123.3899999999999,29,3,1869.25,2992.6400000000003
10276,UE5DC2B,32,-2081.3199999999997,17,15,11513.09,9431.77
10277,U574117,32,1338.8200000000002,26,6,1301.5399999999997,2640.3599999999997
10278,U8D0022,32,13098.320000000002,25,7,42728.0,55826.32
10279,U08F5E9,32,-1687.940000000008,19,13,176953.07,175265.12999999998
10280,U1DF0C2,32,82.0,27,5,39615.0,39697.0
10281,UBF8239,32,10.500000000000085,19,13,3033.8399999999997,3044.3399999999997
10282,UCED50B,32,-2080.23,29,3,3010.6599999999994,930.4300000000001
10283,UEE324B,32,466.47,22,10,1745.1299999999999,2211.6000000000004
10284,UADE3EA,32,-7198.570000000002,23,9,24817.280000000013,17618.709999999995
10285,U0887E6,32,38.570000000000164,27,5,12680.83,12719.4
10286,U8995F8,32,-25790.979999999996,22,10,56615.420000000006,30824.440000000002
10287,UA05087,32,-7539.2300000000005,21,11,23313.61,15774.380000000001
10288,U50CEE9,32,1814.8200000000002,19,13,2958.1699999999996,4772.989999999999
10289,U36F731,32,580.73,19,13,3524.2900000000004,4105.02
10290,U0CF392,32,-3853.5899999999983,23,9,26529.11,22675.52
10291,U6C8728,32,-23060.44,30,2,43432.44,20372.0
10292,U96E13F,32,743.15,27,5,537.28,1280.4299999999998
10293,U29B126,32,10581.560000000001,25,7,13858.08,24439.64
10294,U64FD19,32,-6411.289999999995,21,11,43135.7,36724.41
10295,U444643,32,-3917.3199999999997,28,4,6293.92,2376.6000000000004
10296,U4F4B97,32,-4.300000000000011,16,16,1080.3000000000002,1076.0
10297,U458C42,32,-166.85999999999913,27,5,9240.76,9073.900000000001
10298,U30D39A,32,2170.75,25,7,20804.25,22975.0
10299,UC569CA,32,267.0000000000002,27,5,2783.6400000000003,3050.6400000000003
10300,U4BCE00,32,-655.0,22,10,42457.0,41802.0
10301,U93F28B,32,-516.6400000000001,29,3,3263.3199999999997,2746.6800000000003
10302,U0EF188,32,-1936.0699999999997,25,7,25080.9,23144.83
10303,UC41682,32,-2247.519999999997,23,9,45915.24,43667.72
10304,U4C127D,32,420.85999999999984,22,10,2351.92,2772.7799999999997
10305,U4794F3,32,-2860.680000000001,27,5,5892.070000000001,3031.39
10306,U7976D8,32,27.910000000000196,22,10,11569.16,11597.07
10307,UCB6E64,32,-33162.89,24,8,108145.62000000001,74982.73000000001
10308,U9BAF3B,32,36.36999999999998,27,5,2003.1,2039.47
10309,U286195,32,-2378.840000000001,23,9,10154.249999999998,7775.410000000001
10310,U486DCD,32,-20334.65,23,9,69751.93,49417.280000000006
10311,U8FA086,32,5141.409999999996,21,11,70374.99999999999,75516.41
10312,U0A8105,32,-47346.86,23,9,54399.04,7052.18
10313,U490D84,32,-339.46000000000004,28,4,3589.13,3249.6699999999996
10314,UBC965C,32,11729.500000000004,16,16,210468.1,222197.6
10315,U4BEE90,32,-149.08000000000004,29,3,739.08,590.0
10316,U5AF21F,32,-3013.210000000001,23,9,18062.45,15049.24
10317,UB86758,32,-36.309999999999945,16,16,2705.5499999999997,2669.24
10318,UC34F0E,32,-673.1599999999999,21,11,71673.16,71000.0
10319,U7376EC,32,3049.1800000000003,29,3,2919.5799999999995,5968.76
10320,UE0CD71,32,633.6899999999999,26,6,1243.8400000000001,1877.5300000000002
10321,U7D6BC0,32,-5.239999999997963,16,16,50720.5,50715.26
10322,UEF0A30,32,-10203.910000000002,22,10,16503.07,6299.16
10323,U4570D9,32,1021.3600000000002,29,3,3984.23,5005.59
10324,UD127BF,32,16408.46,27,5,18468.68,34877.14
10325,U3246FF,32,-44.75,23,9,120045.0,120000.25
10326,UF4662A,32,-906.3299999999999,31,1,1306.33,400.0
10327,UC5C1C4,32,-8.640000000000228,20,12,3988.29,3979.65
10328,U8EB0FF,32,6817.61,28,4,18303.56,25121.17
10329,UAE6D4B,32,-1211.3200000000002,28,4,9780.83,8569.509999999998
10330,U81989B,32,-15847.570000000005,28,4,37473.75,21626.18
10331,U144D35,32,3960.1000000000004,30,2,3760.4,7720.5
10332,U2ECAAC,32,200.25,28,4,11908.970000000001,12109.220000000001
10333,U9C7A80,32,-18216.960000000003,29,3,32402.96,14186.0
10334,U167558,32,5791.740000000001,30,2,3671.9600000000005,9463.7
10335,UF3ABB3,32,94.40000000000032,24,8,2802.33,2896.73
10336,UFCA5F7,32,-1885.3,32,0,1885.3,0.0
10337,U660A94,32,-360.1499999999987,21,11,22491.38,22131.23
10338,UA7C424,32,2441.6699999999983,23,9,83723.0,86164.67
10339,U3C4B91,32,-895.8399999999995,29,3,6055.5599999999995,5159.719999999999
10340,UFFD1DA,32,38582.45999999999,26,6,163180.80000000002,201763.26
10341,U51F3D9,32,365.78999999999996,21,11,13627.339999999998,13993.130000000001
10342,UF8340B,32,714.2,30,2,1885.8,2600.0
10343,U6493E2,32,1000.2199999999998,26,6,9899.289999999999,10899.509999999998
10344,UB686F2,32,-1351.5600000000004,28,4,2018.9800000000002,667.42
10345,UAF8F74,32,1585.5700000000002,21,11,12280.33,13865.9
10346,UDD0F5C,32,10299.119999999999,11,21,99530.79,109829.91
10347,U10987C,32,165191.36000000002,21,11,524818.34,690009.7
10348,U963595,32,134.36999999999534,23,9,349753.8,349888.17
10349,UC56542,32,-3994.9500000000003,28,4,4916.25,921.3
10350,UC12DC6,32,1003.9500000000007,19,13,76407.5,77411.45
10351,UAA0B29,32,-149.53999999999883,26,6,11149.539999999999,11000.0
10352,U848E6E,32,284.78000000000003,24,8,651.8100000000001,936.5899999999999
10353,U4A3213,32,-16092.009999999998,23,9,77468.29000000001,61376.28
10354,UF24E79,32,787.9400000000005,30,2,2800.2699999999995,3588.21
10355,U3B6535,32,-1738.2699999999998,26,6,13152.200000000003,11413.929999999998
10356,U5A1E01,32,-10023.65,25,7,32591.02,22567.37
10357,U122B43,32,0.0,17,15,80815.42000000001,80815.42
10358,U21D3AD,32,893.7799999999997,28,4,1508.28,2402.06
10359,U599C7B,32,431.6299999999992,29,3,29068.37,29500.0
10360,UB5AEB1,32,-8776.790000000025,18,14,447214.24,438437.44999999995
10361,U833B6B,32,-3784.140000000001,25,7,26161.620000000003,22377.48
10362,U6EBD7C,32,-1375.28,30,2,3549.1,2173.8199999999997
10363,UF52465,32,-10291.819999999994,17,15,179810.0,169518.18000000002
10364,UA944B9,32,487.39,27,5,13261.840000000004,13749.23
10365,U52EF56,32,-485.5600000000002,29,3,1593.6699999999998,1108.1100000000001
10366,U8FC7F4,32,41476.380000000005,18,14,21253.54,62729.920000000006
10367,UA522F2,32,-523.1800000000001,28,4,7865.299999999999,7342.12
10368,UC9FFCF,32,-98.94000000000025,23,9,15185.01,15086.070000000002
10369,U41B344,32,-3537.619999999999,22,10,29002.07,25464.45
10370,U428CAB,32,-5.2399999999984175,26,6,19992.44,19987.2
10371,U0BB6F7,32,-8338.560000000001,32,0,8338.560000000001,0.0
10372,U11E9A7,32,414.8499999999999,26,6,3291.31,3706.16
10373,U672CB5,32,30947.140000000007,13,19,400685.45999999996,431632.60000000003
10374,UFA6FD0,32,-510.36,24,8,2928.58,2418.2200000000003
10375,UDFE3AB,32,-92.04999999999993,21,11,8292.07,8200.02
10376,U90CE05,32,-759.1400000000023,28,4,13480.250000000002,12721.11
10377,U809A55,32,-441.7000000000001,27,5,6458.01,6016.3099999999995
10378,U123752,32,14057.64,19,13,39751.119999999995,53808.75999999999
10379,U72B9E2,32,-10078.080000000002,28,4,13728.560000000001,3650.48
10380,UE62AFD,32,-672.9099999999994,27,5,12980.949999999999,12308.04
10381,UD05FAC,32,-12899.689999999995,28,4,166193.69,153294.0
10382,UE43F3B,32,25069.069999999992,28,4,16116.88,41185.95
10383,UBEA65F,31,2844.0,20,11,6472.62,9316.619999999999
10384,UCCC544,31,601.17,28,3,2632.83,3234.0
10385,U31321D,31,14282.16,5,26,9234.53,23516.69
10386,UD7E061,31,5128.07,25,6,13650.27,18778.34
10387,UA1FC36,31,2113.61,26,5,7350.380000000001,9463.99
10388,UE1E0D1,31,-7488.369999999999,26,5,14357.189999999999,6868.82
10389,U367D86,31,2986.8199999999997,22,9,3336.4900000000007,6323.3099999999995
10390,U5F8C61,31,201752.21,16,15,160704.73,362456.93999999994
10391,U21BCA8,31,-1557.13,27,4,10685.1,9127.97
10392,U448F18,31,-2278.0499999999993,24,7,39146.22,36868.17
10393,U1839D6,31,279.88999999999993,9,22,4784.42,5064.31
10394,U545684,31,-2765.4300000000003,27,4,22263.93,19498.5
10395,UAF7B95,31,-8733.769999999999,26,5,54848.380000000005,46114.61
10396,U760D1A,31,-13001.17,12,19,36495.0,23493.83
10397,U02BB5D,31,4473.299999999999,18,13,26906.41,31379.710000000003
10398,U35F4D5,31,-3224.190000000002,17,14,177111.14,173886.95
10399,U6054E7,31,84.23999999999978,21,10,19940.760000000002,20025.0
10400,UD5E18B,31,794.31,26,5,74849.6,75643.91
10401,U7C9596,31,3812.580000000001,27,4,4938.42,8751.0
10402,UF20134,31,-2224.92,22,9,28731.49,26506.57
10403,UF293F5,31,3730.1,24,7,14524.91,18255.010000000002
10404,UD662CC,31,1096.3599999999997,13,18,49926.0,51022.36
10405,UEC7120,31,-438.72999999999996,27,4,1665.9800000000002,1227.25
10406,U3490A4,31,4117.530000000001,24,7,3765.06,7882.59
10407,UABE304,31,36050.07999999999,23,8,96576.20000000001,132626.28
10408,UBDB41D,31,7416.76,23,8,7183.040000000001,14599.8
10409,UEE7C69,31,1169.9999999999995,29,2,8117.569999999999,9287.57
10410,UE0B826,31,19211.600000000006,27,4,108326.26999999999,127537.87
10411,UDD9ADB,31,2443.41,24,7,11564.92,14008.329999999998
10412,U8C8DF2,31,-2742.3599999999988,17,14,52291.63999999999,49549.28
10413,U631043,31,-510.62000000000006,26,5,1475.3700000000001,964.75
10414,U538FD0,31,-183.47,25,6,1579.31,1395.84
10415,U64A209,31,-1769.6299999999997,28,3,11671.65,9902.02
10416,U697DFF,31,1442.0999999999995,24,7,17058.83,18500.93
10417,U55BC9E,31,-236.3600000000001,29,2,955.45,719.0899999999999
10418,UD31B90,31,-931.54,27,4,2091.96,1160.42
10419,U3C7B3E,31,126.92999999999786,21,10,4413.2400000000025,4540.17
10420,UA0B93C,31,3805.899999999999,20,11,34623.3,38429.2
10421,U8CC9AC,31,302.0399999999988,20,11,30100.68,30402.719999999998
10422,U9FEB71,31,-9629.66,30,1,42449.66,32820.0
10423,U0D29DC,31,-1169.7199999999998,23,8,5032.219999999999,3862.5000000000005
10424,U5C54CE,31,-218.4300000000003,25,6,5350.67,5132.24
10425,U99B403,31,161.6800000000003,23,8,82852.0,83013.68
10426,U8F7025,31,-4639.099999999999,25,6,14027.1,9388.0
10427,U700E4C,31,-7061.58,26,5,23055.46,15993.88
10428,UCC044F,31,799.5200000000004,23,8,70000.0,70799.52
10429,U5DB897,31,-1024.52,26,5,3965.2799999999997,2940.76
10430,U87CF3C,31,-3867.8200000000006,21,10,29782.04,25914.22
10431,U574AB4,31,-297.79999999999995,30,1,787.3,489.5
10432,UEF782F,31,-1449.69,26,5,6321.700000000001,4872.01
10433,UFF2AFB,31,-1847.2300000000105,13,18,490251.57,488404.33999999997
10434,U912D3B,31,-4197.290000000001,18,13,102046.7,97849.41
10435,UE3D725,31,-5538.3,22,9,13053.600000000002,7515.3
10436,U85E47C,31,-689.5899999999999,29,2,3691.72,3002.1299999999997
10437,U775E4E,31,-5670.420000000003,29,2,8220.420000000004,2550.0
10438,U80CCCD,31,16332.490000000002,14,17,51015.729999999996,67348.22000000002
10439,U513EB6,31,909.84,27,4,19264.19,20174.03
10440,U24B135,31,-612.6900000000005,25,6,3266.2799999999997,2653.59
10441,U0BA8A8,31,8330.21,17,14,11679.99,20010.2
10442,UA93423,31,47.180000000000014,25,6,810.2900000000001,857.47
10443,UA8FB56,31,-1840.77,22,9,10873.03,9032.26
10444,U854ED9,31,90311.45,11,20,97751.45,188062.90000000002
10445,UC9A48B,31,-53752.29,22,9,67192.1,13439.810000000001
10446,UA31ECA,31,191.7099999999973,25,6,69802.23000000001,69993.94
10447,U4F0CAC,31,22.91000000000011,18,13,3786.47,3809.38
10448,U935FEE,31,41403.19,27,4,67189.95,108593.14
10449,U46AB83,31,12651.749999999998,18,13,28431.84,41083.59
10450,U69CAF5,31,-753.2699999999977,25,6,60351.49,59598.22
10451,UA348DD,31,2565.2800000000134,22,9,104689.23999999999,107254.52000000002
10452,U005632,31,2679.87,27,4,2350.23,5030.1
10453,U56E2E5,31,776.1399999999998,21,10,18520.600000000002,19296.74
10454,UEA3C4C,31,2575.12,26,5,11992.32,14567.439999999999
10455,U436967,31,-3590.53,24,7,14899.82,11309.29
10456,U435443,31,-25579.909999999996,17,14,35795.909999999996,10216.0
10457,U2C8F01,31,1128.5900000000001,25,6,2571.9,3700.49
10458,UED0913,31,-5368.93,26,5,22369.010000000002,17000.08
10459,U3EAA52,31,-75.99999999999973,22,9,6574.24,6498.24
10460,U96E20B,31,79538.38000000002,20,11,51494.979999999996,131033.36000000002
10461,UB037E4,31,1000.2400000000001,17,14,7597.98,8598.220000000001
10462,U8B4B23,31,-2076.650000000026,23,8,113510.14,111433.48999999999
10463,UBD8B6C,31,-236.53000000000011,24,7,2287.96,2051.43
10464,U9D6FD6,31,1295.349999999999,20,11,35863.13,37158.479999999996
10465,U1EC12D,31,133.62000000000103,19,12,45646.39000000001,45780.01
10466,UB383D2,31,1492.38,20,11,27862.69,29355.069999999996
10467,U74F570,31,23024.229999999996,27,4,6340.639999999999,29364.87
10468,U2DA227,31,5815.779999999999,25,6,27684.22,33500.0
10469,U52AF0E,31,-2027.2500000000005,27,4,5381.280000000001,3354.03
10470,U2E449C,31,-78078.68000000001,25,6,87978.68000000001,9900.0
10471,UBD7752,31,21909.909999999996,24,7,117426.34,139336.25
10472,UB82F0D,31,-6387.470000000001,25,6,7231.99,844.52
10473,UCD770F,31,-445.72,28,3,465.72,20.000000000000004
10474,U0CFE0C,31,1477.6399999999994,24,7,200646.03999999998,202123.68
10475,U290D68,31,-878.8299999999988,26,5,10906.640000000001,10027.81
10476,U24D402,31,-1324.1699999999998,27,4,4091.71,2767.54
10477,U82AF11,31,108391.75999999998,25,6,39326.549999999996,147718.31
10478,UCC6C51,31,-9957.619999999999,16,15,24714.0,14756.380000000001
10479,U3BAFF2,31,-14928.86,27,4,22368.69,7439.83
10480,UE75FA1,31,-2684.5099999999998,24,7,12644.52,9960.01
10481,U413990,31,305.59999999999957,26,5,4339.51,4645.11
10482,U0A5688,31,2319.1700000000005,29,2,6133.830000000001,8453.0
10483,U6958E2,31,-1715.5800000000006,23,8,7397.02,5681.44
10484,U04D7C5,31,4425.310000000001,26,5,17495.66,21920.97
10485,U06C2E5,31,63.0,16,15,30066.0,30129.0
10486,U3EE10F,31,91.19999999999993,25,6,657.8,749.0
10487,U723272,31,-238.68000000000143,16,15,171906.49,171667.81
10488,U520FC5,31,-946.8200000000006,28,3,6861.03,5914.21
10489,U91BDE3,31,-15307.239999999998,21,10,90834.66,75527.42
10490,U18D5E7,31,30992.550000000003,20,11,78250.43,109242.98
10491,U508596,31,-6804.139999999999,20,11,21473.8,14669.66
10492,U1FBDE4,31,-2381.1000000000004,30,1,2404.9000000000005,23.8
10493,U9EE052,31,320.5000000000032,23,8,42602.36,42922.86
10494,U44F684,31,1220.6299999999999,28,3,2432.6099999999997,3653.24
10495,UC0E523,31,-4227.51,25,6,6644.82,2417.31
10496,U5FF0EC,31,-734.9999999999989,21,10,14405.66,13670.660000000002
10497,U6847CF,31,-7052.540000000001,29,2,10573.259999999998,3520.7200000000003
10498,U13A072,31,10368.300000000008,22,9,72221.0,82589.30000000002
10499,U168180,31,896.1000000000001,29,2,5614.9,6511.0
10500,U555C81,31,780.6700000000001,23,8,5913.12,6693.79
10501,U646127,31,-242.41000000000028,30,1,1331.5100000000002,1089.1
10502,U920792,31,700.24,24,7,429.93,1130.17
10503,U340EE2,31,17261.730000000003,19,12,47072.42,64334.15
10504,U4C1CAF,31,-2197.8300000000163,19,12,228545.93999999997,226348.11
10505,UE95D1C,31,2303.4099999999994,29,2,3596.0,5899.41
10506,U2C213E,31,756.9400000000006,29,2,7070.12,7827.0599999999995
10507,U2050C9,31,-4994.99,22,9,100045.0,95050.01
10508,U3E4473,31,-268.06999999999874,23,8,21447.370000000003,21179.300000000003
10509,UEB7644,31,-421.51999999999936,29,2,8239.66,7818.14
10510,U890412,31,-3455.0900000000006,26,5,7072.270000000001,3617.1800000000003
10511,U41CC41,31,7148.2199999999975,18,13,52204.23,59352.45
10512,UEA9923,31,22990.999999999996,8,23,110551.0,133542.00000000003
10513,UEB7018,31,-1634.23,22,9,21654.29,20020.06
10514,UDE814E,31,17249.380000000005,17,14,78850.0,96099.38
10515,UF710A5,31,-2031.4099999999999,28,3,3221.53,1190.12
10516,U614910,31,8300.21,26,5,7920.1,16220.31
10517,U55C558,31,7728.839999999997,23,8,71347.37000000001,79076.20999999999
10518,U136A26,31,118825.84000000014,13,18,4654766.35,4773592.1899999995
10519,UDA2586,31,943.9600000000003,25,6,4336.89,5280.85
10520,UE4960A,31,-1431.2799999999997,30,1,4855.99,3424.71
10521,UF8AD3E,31,-2200.6,29,2,3908.6,1708.0
10522,U15965D,31,5089.97,23,8,3960.840000000001,9050.810000000001
10523,U513F20,31,-1901.4100000000003,24,7,5226.55,3325.14
10524,UCC65EC,31,-1969.6399999999999,27,4,8449.78,6480.139999999999
10525,U3D48C7,31,-4682.21,17,14,13710.210000000001,9028.0
10526,U827018,31,-1015.2599999999995,28,3,32218.879999999997,31203.62
10527,UB87C4B,31,-1844.52,15,16,11104.66,9260.14
10528,U9D348A,31,-739.2400000000001,26,5,1404.5900000000001,665.3499999999999
10529,UA1E82C,31,200.25,21,10,104967.73999999999,105167.99
10530,UF9E2CC,31,-2894.35,28,3,4153.59,1259.24
10531,U72DCF8,31,-2999.06,26,5,3403.01,403.95
10532,UAEC9C7,31,32.31999999999991,25,6,2590.78,2623.1
10533,U5EBAD4,31,784.77,24,7,1373.1000000000001,2157.87
10534,U8B71F2,31,15217.499999999998,28,3,15264.23,30481.73
10535,U1B3D14,31,42695.81,15,16,39738.0,82433.81
10536,UC4CA04,31,496143.45000000007,14,17,28874.72,525018.17
10537,U7817A9,31,-714.74,29,2,775.62,60.88
10538,U724135,31,56.0,25,6,29944.0,30000.0
10539,UC06152,31,105.68,28,3,1048.28,1153.96
10540,UDB1847,31,-9944.070000000003,28,3,11256.100000000002,1312.0300000000002
10541,UBCE483,31,-6038.570000000003,15,16,129513.20000000001,123474.62999999999
10542,UA2DCD0,31,12116.39,20,11,117867.9,129984.29000000001
10543,UB4681F,31,2489.689999999999,21,10,46632.43,49122.12
10544,UA751B7,31,1074.06,27,4,1986.1200000000001,3060.1800000000003
10545,UBDF178,31,-52.0,19,12,15653.0,15601.0
10546,UDAEF53,31,1398.25,28,3,1701.7200000000003,3099.9700000000003
10547,U08A1E7,31,1704.759999999999,18,13,40750.39000000001,42455.15000000001
10548,UFEA2DB,31,-2080.4300000000007,17,14,15155.49,13075.06
10549,U9AC08F,31,-1303.11,25,6,20515.04,19211.93
10550,U74881A,31,-1497.7100000000005,25,6,3519.22,2021.5099999999998
10551,UFFD3AF,31,1611.5200000000004,23,8,92629.48,94241.0
10552,U30670C,31,5070.6500000000015,23,8,110187.0,115257.65
10553,UA90542,31,-10.649999999999636,19,12,13241.41,13230.76
10554,UE8B728,31,-77839.11,23,8,180962.62,103123.51
10555,U33DA10,31,1452.6200000000026,21,10,39878.41,41331.030000000006
10556,UEEDFCB,31,6236.2,25,6,4359.93,10596.130000000001
10557,UF0FDF0,31,9772.24,19,12,12050.630000000001,21822.869999999995
10558,UF8CBBC,31,430.32000000000016,29,2,1006.1599999999999,1436.48
10559,U64A167,31,-24303.36,16,15,48418.99,24115.63
10560,UF7EE63,31,391.39999999999986,20,11,8492.73,8884.130000000001
10561,UF53CDC,31,8487.679999999998,28,3,18502.32,26990.0
10562,U931A9B,31,6404.6900000000005,26,5,32211.760000000002,38616.45
10563,U83262E,31,9.009999999999991,15,16,3234.0,3243.01
10564,UE0E7A5,31,-3609.87,26,5,8340.99,4731.12
10565,UB27F5A,31,22871.39,26,5,57108.1,79979.48999999999
10566,UA6E022,31,-13233.169999999998,31,0,13233.169999999998,0.0
10567,U3726AF,31,4566.5999999999985,20,11,10225.36,14791.960000000001
10568,U3082D4,31,-910.019999999995,12,19,80078.25,79168.23000000001
10569,UD159A8,31,-0.019999999999998908,24,7,136.89,136.87
10570,U07742A,31,-9599.8,28,3,17694.0,8094.2
10571,UB6C425,31,1.4699999999998,25,6,7847.9299999999985,7849.400000000001
10572,UB6A390,31,5227.580000000002,12,19,31506.859999999997,36734.44
10573,U42BE9D,31,1917.2000000000044,17,14,49797.44,51714.64
10574,U419D5B,31,-1190.4099999999999,19,12,4390.719999999999,3200.31
10575,UFE3E65,31,232.0,28,3,2310.0,2542.0
10576,U41E399,31,-274.6799999999997,14,17,18743.68,18469.0
10577,U1DAC54,31,1969.07,8,23,2946.62,4915.69
10578,U7A6959,31,-471.51,29,2,910.51,439.0
10579,UA94D82,30,-1668.7700000000004,18,12,25629.519999999997,23960.75
10580,UE0686C,30,22532.829999999998,25,5,22654.83,45187.66
10581,UC46B38,30,135.11999999999995,20,10,4235.0599999999995,4370.18
10582,U56D6E7,30,343.45000000000005,26,4,574.6999999999999,918.1500000000001
10583,UE7DA52,30,-901.9799999999989,19,11,29021.98,28120.0
10584,UEF0F8F,30,517.6600000000003,23,7,28543.760000000002,29061.420000000002
10585,U4579E4,30,-18376.9,26,4,20722.9,2346.0
10586,U72DE7F,30,3069.1500000000005,24,6,4731.800000000001,7800.95
10587,UEC68C2,30,171.5300000000001,27,3,639.88,811.4100000000001
10588,U256709,30,49952.28,20,10,4147.7300000000005,54100.01
10589,U0D8E37,30,-231.72000000000014,22,8,18823.380000000005,18591.66
10590,UCB4AEE,30,-9496.93,28,2,11497.0,2000.07
10591,UFA0DE2,30,8025.000000000001,27,3,395.28,8420.28
10592,UE0063F,30,-10432.02,28,2,26823.000000000007,16390.98
10593,U0E74C0,30,59.0799999999994,22,8,31006.829999999998,31065.91
10594,U24CD52,30,1942.9700000000003,19,11,1847.9,3790.87
10595,U98B208,30,-3589.03,20,10,17823.25,14234.22
10596,U34F3EB,30,-13868.210000000003,23,7,35653.66,21785.45
10597,U952A44,30,-64006.42999999999,18,12,106121.15,42114.72
10598,U2029B1,30,-54287.07999999999,21,9,162218.1,107931.01999999999
10599,UE716FB,30,-76.28000000000009,22,8,1567.56,1491.28
10600,UC9A748,30,181483.87999999995,9,21,161965.45,343449.33
10601,U675931,30,-100034.76999999999,22,8,202370.21,102335.44
10602,U526A7F,30,207.15000000000003,25,5,448.92,656.0699999999999
10603,U0C2049,30,-7120.450000000001,25,5,30768.859999999997,23648.41
10604,UB19A8A,30,201.44000000000003,26,4,596.56,798.0
10605,UF94D73,30,-1233.5800000000002,27,3,5703.58,4470.0
10606,UB15811,30,14299.87,25,5,2712.2100000000005,17012.08
10607,UE5FE56,30,-2946.9099999999994,26,4,6434.57,3487.66
10608,UE2AFE6,30,8345.660000000003,22,8,22301.500000000007,30647.16
10609,U0EAC2F,30,1363.2600000000002,16,14,6065.74,7429.0
10610,UF5B16D,30,-2804.21,28,2,8904.21,6100.0
10611,UE96825,30,56.379999999999995,14,16,21072.0,21128.379999999997
10612,U5FBC01,30,6132.819999999999,24,6,18742.09,24874.91
10613,UEC64AD,30,-1042.4300000000007,22,8,21113.83,20071.4
10614,U3FFD6B,30,-11352.139999999945,17,13,488005.56999999995,476653.43
10615,U98379E,30,7208.709999999999,25,5,19076.56,26285.269999999997
10616,U936E37,30,-60876.82999999999,27,3,82176.9,21300.07
10617,UC28D43,30,-1917.78,19,11,17617.78,15700.0
10618,U0DB6E5,30,-32424.89,25,5,66059.89,33635.0
10619,U955FF1,30,-172.85999999999876,25,5,15087.0,14914.140000000001
10620,UFB21FC,30,3193.62,22,8,18511.090000000004,21704.710000000003
10621,UD49842,30,101.0,18,12,47699.0,47800.0
10622,UE4546D,30,-6701.039999999996,16,14,143287.72,136586.67999999996
10623,U79AB81,30,1601.239999999998,18,12,28493.3,30094.54
10624,U1F25B6,30,31835.82,27,3,17935.399999999998,49771.22
10625,UCF7844,30,0.010000000000218279,17,13,49220.0,49220.01
10626,UCD4DED,30,-5857.0,25,5,31686.5,25829.5
10627,UA97E0A,30,1168.5199999999995,28,2,10731.480000000001,11900.0
10628,U5B5476,30,-487.5100000000007,17,13,10225.58,9738.07
10629,U66B473,30,-772.4899999999991,21,9,20672.13,19899.640000000003
10630,UE862DB,30,6115.1900000000005,20,10,23491.41,29606.6
10631,UD888AE,30,9.829999999999998,13,17,1007.84,1017.67
10632,U770364,30,-2146.88,26,4,12756.68,10609.8
10633,UE7B751,30,-2034.07,27,3,4934.07,2900.0
10634,UDF4F4C,30,-3669.5299999999997,22,8,20607.839999999997,16938.309999999998
10635,UC0D54C,30,744.7399999999998,25,5,8345.83,9090.57
10636,U645035,30,-2851.5600000000004,25,5,22420.48,19568.92
10637,U099A6F,30,-568.2000000000007,28,2,5181.540000000001,4613.34
10638,UD83B69,30,6807.4299999999985,25,5,56478.57,63286.0
10639,UDD533C,30,7512.0,22,8,31796.0,39308.0
10640,U0A6EDD,30,512.0,24,6,6358.0,6870.0
10641,UE0C486,30,-3277.880000000001,26,4,11487.880000000001,8210.0
10642,U228AF6,30,-1303.6700000000005,26,4,4084.34,2780.67
10643,UEAAC93,30,-8345.09,24,6,18108.89,9763.8
10644,UC0CA05,30,2022.4499999999998,28,2,2830.0,4852.45
10645,UEBD197,30,22616.92000000001,27,3,6745.450000000001,29362.37
10646,UAFDC27,30,1386.9000000000008,22,8,19197.23,20584.13
10647,UCCE92C,30,-90.48999999999972,22,8,4644.369999999999,4553.88
10648,UBBF510,30,6538.959999999999,26,4,707.6600000000001,7246.62
10649,U141EA8,30,-6658.700000000001,27,3,18311.41999999999,11652.720000000001
10650,UFCE74C,30,-3920.0600000000004,27,3,6138.53,2218.47
10651,U6E9243,30,34.66999999999982,28,2,872.8499999999998,907.52
10652,U559057,30,-9.094947017729282e-13,21,9,9033.0,9033.0
10653,U79F470,30,-15222.0,24,6,16255.099999999999,1033.1
10654,U88F014,30,-23477.989999999998,24,6,57688.59,34210.6
10655,UAE096C,30,791.1099999999997,17,13,7353.66,8144.7699999999995
10656,U27EA3B,30,1.0000000000004547,15,15,12316.109999999999,12317.11
10657,U6D4512,30,-2984.5,24,6,5241.4,2256.9
10658,U83FDE6,30,-2258.86,24,6,6400.1,4141.24
10659,UFF1FA7,30,2731.1399999999994,17,13,27320.62,30051.76
10660,U958AD9,30,-3369.3700000000003,22,8,7946.760000000002,4577.389999999999
10661,U9218B1,30,-193.2600000000001,18,12,2774.55,2581.29
10662,UAA0AB0,30,-900.8899999999994,18,12,89789.43,88888.54000000001
10663,U1C44CD,30,38.0,15,15,61846.0,61884.0
10664,U2892D7,30,598.8399999999997,25,5,5597.8600000000015,6196.700000000001
10665,U76EFC0,30,-1277.5399999999995,25,5,8717.4,7439.860000000001
10666,UF0BC0E,30,-8361.85,29,1,14414.1,6052.25
10667,UBF85BF,30,233.61000000000092,22,8,16435.97,16669.579999999998
10668,U05D8EB,30,200.00000000000068,21,9,3707.0599999999995,3907.06
10669,UFEB26E,30,-953.04,26,4,1903.1200000000001,950.0799999999999
10670,U5CD753,30,1261.160000000001,25,5,6962.66,8223.82
10671,U1875AF,30,4202.0300000000025,22,8,95212.45999999999,99414.49
10672,U19393A,30,6074.9500000000035,27,3,23565.250000000004,29640.2
10673,UEB55E3,30,-1123.35,22,8,3695.1299999999997,2571.78
10674,UB39547,30,332.0699999999998,21,9,21096.230000000003,21428.299999999996
10675,U08D0C3,30,33739.100000000006,19,11,22536.33,56275.43
10676,U44A5C5,30,13173.650000000009,23,7,67113.54000000001,80287.19
10677,U726E93,30,701.9300000000032,22,8,50560.46000000001,51262.39
10678,UD5C885,30,-24.56000000000006,25,5,390.52,365.96000000000004
10679,U9814BA,30,-20388.199999999997,17,13,103057.2,82669.0
10680,U580249,30,218.80000000000007,28,2,552.3,771.1
10681,U4D557C,30,-626.5699999999997,24,6,3109.6000000000004,2483.0299999999997
10682,U3D0297,30,-48.36999999999898,21,9,13676.4,13628.029999999999
10683,U39F675,30,-80.5,27,3,920.4499999999998,839.95
10684,UE9BD98,30,-26715.57999999999,27,3,41596.79,14881.210000000001
10685,U59745A,30,519.8000000000005,23,7,5828.599999999999,6348.4
10686,UE27242,30,897.0,19,11,16263.0,17160.0
10687,U584597,30,-23.3599999999999,18,12,18559.54,18536.18
10688,U80542E,30,4504.009999999998,19,11,85675.98999999999,90180.0
10689,UDD30EC,30,984.9999999999995,23,7,8845.599999999999,9830.6
10690,UC1FAFC,30,-80.03999999999985,22,8,12901.039999999999,12821.0
10691,U425BD4,30,3.2000000000043656,24,6,122613.1,122616.3
10692,UEB6A93,30,5375.66,13,17,34500.0,39875.66
10693,UDA17DD,30,1982.029999999997,21,9,20286.97,22269.0
10694,U241C5D,30,9.0,25,5,70.0,79.0
10695,UC797F9,30,25212.13999999999,18,12,57158.47,82370.61
10696,UB30AFA,30,-35959.8,29,1,40459.8,4500.0
10697,U3E2EE3,30,117.94999999999982,27,3,3044.8100000000004,3162.76
10698,U567D55,30,145278.74000000005,21,9,25402.53,170681.27000000005
10699,UFD86B1,30,-903.9999999999998,25,5,3772.56,2868.56
10700,UC96872,30,14366.59,22,8,37961.41,52328.0
10701,UF8B2AC,30,1031.98,27,3,14595.75,15627.730000000001
10702,U1C8980,30,-13686.920000000002,26,4,34375.11,20688.190000000002
10703,U2A3F4B,30,23023.910000000003,15,15,104436.11000000002,127460.02
10704,U6091DA,30,-29231.680000000004,28,2,35501.68,6270.0
10705,U7E37EB,30,1480.2799999999997,29,1,1582.8,3063.08
10706,U13EF4D,30,-13016.92,18,12,31820.82,18803.9
10707,U44583D,30,-48212.70999999999,19,11,105182.62000000001,56969.91
10708,U2EF298,30,-768.0,24,6,39228.0,38460.0
10709,U15B3BE,30,-34757.969999999994,27,3,56290.259999999995,21532.29
10710,U3B67CE,30,108547.9,20,10,2761.7400000000002,111309.64
10711,UFECA72,30,916.1700000000001,27,3,2153.9900000000002,3070.16
10712,U1D04BE,30,-135.42000000000007,28,2,7638.080000000001,7502.66
10713,UCE3755,30,-285.82,22,8,1446.3600000000001,1160.54
10714,U2E1CCC,30,284.5499999999993,25,5,5133.8099999999995,5418.36
10715,UF1FDFB,30,0.7800000000000853,21,9,2527.71,2528.4899999999993
10716,UC1D2B1,30,-1790.5000000000002,20,10,5349.379999999999,3558.8799999999997
10717,U42AB1F,30,-1517.5,15,15,39127.200000000004,37609.7
10718,U536C37,30,77996.0,15,15,97397.37,175393.37000000002
10719,UA56EF4,30,-306.08000000000084,19,11,74640.64,74334.56
10720,U748C51,30,-3557.040000000003,28,2,21849.570000000003,18292.53
10721,U5D0469,30,22218.650000000005,15,15,34482.0,56700.65
10722,U308551,30,26444.82,1,29,3498.0,29942.82
10723,U64C26E,30,-132.5700000000004,22,8,4864.549999999999,4731.98
10724,UB56DDE,30,3129.6099999999997,22,8,3565.5600000000004,6695.170000000001
10725,U9C944D,30,-254.98000000000025,20,10,6987.3099999999995,6732.33
10726,U9AAA12,30,0.0,15,15,6802.0,6802.0
10727,UD38597,30,13423.140000000003,20,10,79782.36999999998,93205.51
10728,U5A6EC1,30,17103.04,20,10,19002.46,36105.5
10729,U3D964B,30,4963.509999999999,24,6,150.11999999999998,5113.63
10730,UE5EA1C,30,-0.7999999999999545,15,15,9955.0,9954.2
10731,U45861A,30,12530.510000000002,17,13,34780.14,47310.649999999994
10732,UB95701,30,-2978.2700000000004,29,1,2992.19,13.92
10733,UBB6692,30,39.17999999999954,27,3,28495.760000000002,28534.94
10734,U7596BC,30,-635.72,20,10,4450.19,3814.4700000000003
10735,U6A37D6,30,-4134.599999999999,23,7,20942.600000000002,16808.0
10736,U84CF03,30,2746.6700000000005,24,6,2727.72,5474.39
10737,U70B20E,30,-61.670000000000016,23,7,3261.7999999999997,3200.1299999999997
10738,UF07384,30,-1331.8799999999999,25,5,1700.9,369.02
10739,UE66959,30,11045.170000000004,22,8,21439.190000000002,32484.36
10740,U565B95,30,-5064.830000000001,27,3,7594.1,2529.27
10741,U15E84C,30,362.87000000000114,22,8,61059.799999999996,61422.67
10742,UDD346D,30,-552.8800000000001,17,13,7255.15,6702.270000000001
10743,U5650BA,30,232.0,17,13,67208.0,67440.0
10744,UEC559D,30,-11632.819999999998,25,5,41906.700000000004,30273.88
10745,UEA8D4B,30,-906.6000000000004,27,3,14963.900000000001,14057.3
10746,UD0A147,30,-272.8200000000004,22,8,16733.09,16460.27
10747,U882985,30,-3985.7300000000005,28,2,4585.8,600.07
10748,U7A4E8A,30,2606.7,26,4,5126.63,7733.33
10749,UF11950,30,-29440.609999999997,28,2,40439.61,10999.0
10750,U053508,30,2577.7999999999993,15,15,1837.58,4415.38
10751,U67491B,30,183.4499999999988,18,12,35514.729999999996,35698.18
10752,UCE4508,30,7475.52,17,13,57330.0,64805.520000000004
10753,U1E6D2B,30,-216.14999999999952,27,3,2763.22,2547.07
10754,U758F52,30,6055.180000000001,23,7,19906.35,25961.530000000002
10755,UF671D1,30,-15388.65,28,2,20395.12,5006.47
10756,U0A0EB7,30,-11819.0,20,10,100190.0,88371.0
10757,UEF5F81,30,-36281.7,25,5,36374.7,93.0
10758,U6EE073,30,-13.689999999999987,17,13,1029.6999999999998,1016.01
10759,UFACFB9,30,869.72,25,5,7133.180000000001,8002.900000000001
10760,U8DC401,30,-175.23000000000002,27,3,454.8,279.57
10761,UD214E3,30,-992.120000000001,18,12,42036.46,41044.34
10762,UB48FE9,30,7550.59,22,8,21996.88,29547.47
10763,U173DC1,30,-6016.24,26,4,8464.439999999999,2448.2
10764,UBCE2D0,30,-6029.61,23,7,42429.61,36400.0
10765,UEB392F,30,4722.709999999997,18,12,15020.99,19743.7
10766,U7837A3,30,-39850.58,22,8,161415.0,121564.42
10767,UE9579D,30,-15956.640000000003,17,13,72502.68000000001,56546.04
10768,UF7749A,30,-877.6099999999999,17,13,11205.93,10328.32
10769,UA399ED,30,459.48,14,16,4799.22,5258.7
10770,U566D84,30,-867.81,18,12,4361.540000000001,3493.7300000000005
10771,U2EE775,30,-955.6500000000001,23,7,3568.8,2613.15
10772,UEA42E3,30,-14304.49,24,6,28919.690000000002,14615.2
10773,UD7022A,30,-117.54000000000087,24,6,48877.09,48759.55
10774,U8845F7,30,-8149.5,23,7,44749.5,36600.0
10775,U5077B2,30,26694.57,26,4,1824.43,28519.0
10776,U2F6B01,30,-0.8700000000002746,23,7,3469.9400000000005,3469.07
10777,U168BCB,30,27.520000000000024,22,8,2491.2,2518.72
10778,U88B0C1,30,13257.92,27,3,9142.08,22400.0
10779,U1D0345,30,1885.0000000000005,23,7,4660.89,6545.89
10780,UF527FC,30,822.0100000000001,26,4,673.0299999999999,1495.04
10781,U847F95,30,-148.8799999999999,28,2,3270.83,3121.95
10782,UD9EC3B,30,-2643.609999999999,24,6,28995.28,26351.67
10783,UDA5D3E,30,-4.940000000000509,18,12,18945.06,18940.120000000003
10784,U2A6052,30,-7053.740000000004,24,6,81706.46,74652.72
10785,UA0FC44,30,379.54999999999984,19,11,8465.93,8845.480000000001
10786,U5B24E5,30,376.01000000000005,23,7,5450.0,5826.01
10787,U50B89E,30,1231.3100000000036,9,21,429830.05,431061.36
10788,U3754AC,30,-720.0,26,4,39480.0,38760.0
10789,U47D54B,30,-86408.59,17,13,173752.24,87343.65
10790,U5B7396,30,39585.270000000004,21,9,37362.560000000005,76947.83
10791,UEA8B3B,30,623.1900000000022,26,4,4820.979999999998,5444.17
10792,U138483,30,5116.980000000001,25,5,11294.880000000001,16411.86
10793,UF6FCD5,30,2500.999999999998,25,5,24501.22,27002.219999999998
10794,UB6571E,30,-23598.809999999998,30,0,23598.809999999998,0.0
10795,U2D7008,30,1332.4500000000003,25,5,3488.3500000000004,4820.8
10796,U3213A7,30,5446.0,13,17,92068.0,97514.0
10797,UD84767,30,-5782.64,25,5,30988.300000000003,25205.66
10798,U52DB7E,30,8385.43,24,6,2549.58,10935.01
10799,U9B5181,30,-8059.960000000001,19,11,30078.0,22018.04
10800,UB25117,30,-6.839999999999918,27,3,1404.6799999999998,1397.84
10801,U0E8488,30,4.839999999997053,22,8,15829.220000000001,15834.060000000001
10802,UB2C3E0,30,-0.1899999999999622,15,15,1166.8200000000002,1166.63
10803,U896C86,30,-5381.34,28,2,5481.490000000001,100.15
10804,U40B8FA,30,-1512.4699999999998,22,8,6385.290000000001,4872.82
10805,U983FB1,30,2549.6000000000004,16,14,2674.4000000000005,5224.0
10806,UFE3A55,30,-6020.08,21,9,32738.900000000005,26718.82
10807,UE1CF27,30,-1371.1999999999996,28,2,6505.759999999999,5134.5599999999995
10808,U4EB293,30,10419.030000000004,24,6,45409.36999999999,55828.4
10809,U84DEA1,30,-6586.380000000001,28,2,7260.380000000001,674.0
10810,UD9EABF,30,-170523.68000000002,10,20,441587.12,271063.43999999994
10811,UAB7D12,30,-155.02000000000044,25,5,21710.98,21555.96
10812,UF3F306,30,706.8,25,5,4476.98,5183.78
10813,U14B55B,30,324.5199999999999,27,3,2122.4800000000005,2447.0
10814,U7B8F26,30,-7176.060000000001,23,7,24703.82,17527.760000000002
10815,UC458E6,30,-545.8399999999999,20,10,1710.9099999999999,1165.07
10816,U48ECD3,30,-4647.330000000001,23,7,12021.94,7374.61
10817,UDFACAC,29,-755.7199999999993,27,2,18377.18,17621.46
10818,U4618EE,29,127.2500000000004,21,8,10010.269999999999,10137.52
10819,U273414,29,-13206.94,24,5,39525.299999999996,26318.36
10820,U80DFEE,29,-195.79,23,6,371.41999999999996,175.63
10821,U70399A,29,8684.829999999998,22,7,27760.49,36445.32
10822,UD7F7C8,29,-1469.4999999999995,22,7,11340.72,9871.22
10823,U8FA877,29,-589.6199999999999,26,3,2622.78,2033.1599999999999
10824,UC5D327,29,93176.80000000002,14,15,10882.61,104059.41
10825,U5694EA,29,1161.1200000000013,25,4,12378.769999999999,13539.89
10826,UEF6099,29,1488.040000000001,19,10,24001.940000000002,25489.98
10827,UDDA1F1,29,-28290.380000000005,27,2,28320.350000000002,29.970000000000002
10828,UB00D55,29,-555.5699999999999,25,4,15880.889999999998,15325.32
10829,U5FCC01,29,-4800.619999999998,14,15,17932.21,13131.59
10830,UEF4D3C,29,-12871.730000000005,25,4,39873.57999999999,27001.85
10831,U9CD60C,29,-6011.889999999999,18,11,36577.53,30565.64
10832,U4CC139,29,369482.99,14,15,9605.59,379088.58
10833,UD74CAB,29,-231.77999999999926,25,4,12992.119999999999,12760.34
10834,U54ADD9,29,1920.71,17,12,16623.22,18543.93
10835,UF1F624,29,372.97000000000025,16,13,11518.880000000001,11891.849999999999
10836,UDB710C,29,0.6599999999996271,20,9,17054.03,17054.690000000002
10837,UFF7FD1,29,-1129.9699999999996,17,12,10064.289999999999,8934.320000000002
10838,U4E82FA,29,1212.7599999999998,26,3,4070.41,5283.17
10839,UE73732,29,-15370.64,25,4,31860.699999999997,16490.06
10840,U982473,29,48897.83999999997,19,10,950224.22,999122.06
10841,U4FE341,29,-2161.92,17,12,7870.01,5708.09
10842,UCE1B62,29,-9316.749999999985,20,9,142174.05000000002,132857.3
10843,U0E3CDC,29,-72.78,25,4,985.9,913.1200000000001
10844,U42872A,29,-34069.31,22,7,63541.07,29471.76
10845,U7D2A89,29,-589.9200000000001,17,12,24458.2,23868.28
10846,UF23AD7,29,-266.3900000000001,17,12,1460.73,1194.3400000000001
10847,U193412,29,3652.279999999999,21,8,30592.0,34244.28
10848,UA5F910,29,-13844.500000000004,25,4,29370.840000000004,15526.34
10849,UBCD079,29,1011.3199999999993,21,8,29261.780000000002,30273.1
10850,U147316,29,-4237.339999999999,25,4,18833.34,14596.0
10851,U35EBF4,29,-18163.340000000004,27,2,18363.340000000004,200.0
10852,U53A484,29,-779.060000000005,23,6,136994.06000000003,136215.0
10853,U1C6A4B,29,1081.5,24,5,3022.06,4103.5599999999995
10854,UED24CE,29,132090.24000000002,11,18,175651.33,307741.57
10855,U79154C,29,-272.2999999999993,16,13,41010.85,40738.55
10856,U857FDC,29,734.1599999999999,25,4,14971.7,15705.86
10857,UCF5BD4,29,722.8100000000009,27,2,9356.68,10079.49
10858,U124CEA,29,946.1000000000005,27,2,3613.3,4559.400000000001
10859,U5ED6E1,29,-173.86000000000018,26,3,9197.11,9023.25
10860,U5F5808,29,-741.3800000000001,27,2,1090.38,349.0
10861,U1B9B9E,29,6738.4,27,2,16761.6,23500.0
10862,U81A038,29,-1530.3000000000002,25,4,2631.5700000000006,1101.27
10863,U0F8132,29,54.72000000000003,24,5,733.67,788.39
10864,U2A3BDC,29,2403.4800000000005,26,3,2666.1399999999994,5069.62
10865,UCB45E2,29,0.0,21,8,3640.85,3640.8500000000004
10866,U57964F,29,-772.2300000000005,26,3,6172.23,5400.0
10867,UBDE84D,29,6355.350000000001,20,9,48032.61,54387.96000000001
10868,U54B8D9,29,-1574.35,24,5,5711.45,4137.1
10869,U4653FA,29,4001.4900000000016,24,5,16212.309999999998,20213.800000000003
10870,U2AAF25,29,703.1600000000001,23,6,1000.0,1703.16
10871,U4F2BDA,29,2956.2899999999972,19,10,31378.17,34334.46
10872,U0E966C,29,59637.270000000004,24,5,23666.63,83303.9
10873,U2C073F,29,-843.28,26,3,2853.2799999999997,2010.0
10874,UC2318C,29,10463.380000000005,15,14,1008301.51,1018764.89
10875,U6F402F,29,-574.3300000000017,16,13,103209.08,102634.75
10876,UF711CE,29,-9.237055564881302e-14,17,12,2603.7,2603.7000000000003
10877,UD426FE,29,-8810.169999999998,15,14,41263.94,32453.769999999997
10878,UB40CC1,29,23.02,20,9,25077.0,25100.02
10879,UD55227,29,0.5100000000002183,24,5,6342.0,6342.51
10880,U833495,29,5438.209999999998,15,14,23616.9,29055.11
10881,UE9CA0A,29,24526.46,20,9,14573.6,39100.06
10882,U5B0327,29,-33.669999999999675,17,12,30100.560000000005,30066.89
10883,U1C3C6A,29,-128.01999999999987,27,2,1186.47,1058.45
10884,U993460,29,10657.88,25,4,20192.4,30850.28
10885,U21CB7F,29,4381.340000000001,25,4,1718.6599999999996,6100.0
10886,U954CA9,29,1423.7099999999996,23,6,6784.06,8207.77
10887,UC51B54,29,454.8,18,11,2498.6400000000003,2953.44
10888,U42E36F,29,787.9999999999999,27,2,2543.09,3331.09
10889,UE86B23,29,-530.0200000000004,24,5,35245.56,34715.53999999999
10890,U9E1FE4,29,-4367.5,19,10,5493.42,1125.92
10891,UFAAC1D,29,-608529.81,19,10,735883.2000000001,127353.39000000001
10892,U1DC5B9,29,4705.329999999999,25,4,5727.43,10432.76
10893,UFF06F9,29,10656.71,22,7,19373.29,30030.0
10894,UDD8ADA,29,-1833.0,27,2,2257.5899999999997,424.59000000000003
10895,UEBE713,29,-15364.869999999999,19,10,63635.46,48270.59
10896,U4B5D4C,29,-13877.050000000003,21,8,113651.05,99774.0
10897,U9D2A73,29,177.5999999999999,14,15,13974.4,14152.0
10898,U3E3775,29,577.2899999999972,11,18,74800.0,75377.29000000001
10899,UD46BE5,29,-18310.15,17,12,76065.16,57755.01
10900,U9EBFA3,29,-77.42999999999938,16,13,89950.92000000001,89873.49
10901,U2E99A7,29,1371.7200000000003,24,5,2388.3100000000004,3760.0300000000007
10902,UDB0403,29,-3813.4299999999994,17,12,7626.429999999999,3813.0
10903,U9EB310,29,391.03999999999996,22,7,5789.16,6180.199999999999
10904,U16186A,29,8186.25,22,7,16491.0,24677.25
10905,U99C4D4,29,2305.31,25,4,1665.9099999999999,3971.2200000000003
10906,U6C4F52,29,-113549.32,23,6,275935.58999999997,162386.27
10907,U1ACDD7,29,2449.8199999999997,26,3,6312.260000000001,8762.08
10908,U4B8EE1,29,347.0799999999963,19,10,72999.98,73347.06
10909,UA73DBD,29,5073.56,22,7,6248.66,11322.220000000001
10910,UEB356E,29,11052.88,26,3,10950.0,22002.879999999997
10911,UAC872D,29,125.03999999999995,26,3,5192.990000000001,5318.03
10912,U14CAA9,29,-270.0,20,9,40270.0,40000.0
10913,U95903D,29,-197.0,22,7,4083.42,3886.42
10914,UC40E16,29,-1159.4000000000015,23,6,44810.9,43651.5
10915,UF3B079,29,-33.61000000000007,24,5,5999.6900000000005,5966.08
10916,UECE22B,29,-241.72000000000054,25,4,3994.3199999999997,3752.6
10917,U6002EE,29,-676.11,25,4,841.9100000000001,165.8
10918,UE80FD5,29,8630.92,10,19,17704.08,26335.0
10919,UF40861,29,2036.4199999999998,27,2,1217.27,3253.6899999999996
10920,U99DCF2,29,-326.6599999999994,22,7,6459.18,6132.52
10921,UC3A044,29,478.6499999999999,15,14,8171.349999999999,8650.0
10922,UF6AC8C,29,-37144.20000000001,22,7,186133.50000000003,148989.3
10923,U130569,29,-117803.75,23,6,273559.39999999997,155755.65000000002
10924,U9E2901,29,7638.07,9,20,43614.14,51252.21
10925,UF352B1,29,2368.459999999999,21,8,162640.0,165008.46000000002
10926,UB9DA3A,29,418.29999999999836,24,5,12730.68,13148.98
10927,UCDB618,29,403.51000000000005,25,4,477.82,881.3299999999999
10928,U9640D1,29,-1300.9499999999996,26,3,10452.949999999999,9152.0
10929,U0FDDAD,29,-4174.9,28,1,4274.9,100.0
10930,U44236A,29,4.547473508864641e-13,21,8,3602.2299999999996,3602.23
10931,U76945F,29,3.5999999999994543,18,11,20638.46,20642.06
10932,U262EDC,29,4640.959999999999,10,19,87099.0,91739.95999999999
10933,U1D3981,29,24084.08,21,8,3465.9900000000002,27550.07
10934,U2BBEB4,29,-2082.8100000000004,26,3,2172.8100000000004,90.0
10935,UB167AD,29,482.68000000000006,24,5,3715.0299999999997,4197.71
10936,U0A891A,29,13232.400000000001,16,13,5800.98,19033.38
10937,UE862D4,29,-573.7399999999999,26,3,8614.42,8040.68
10938,U85B9E9,29,365.72999999999956,23,6,5514.4800000000005,5880.21
10939,U2B3A69,29,-908.19,25,4,1808.2299999999996,900.04
10940,UFCF79E,29,-1694.9099999999996,16,13,13822.01,12127.1
10941,UA92495,29,7934.799999999997,17,12,1626.5899999999997,9561.39
10942,UEB4A79,29,-10717.499999999998,24,5,12896.5,2179.0000000000005
10943,UC9D6AD,29,-8503.460000000001,23,6,12328.6,3825.1400000000003
10944,UA0B798,29,-438.9500000000001,28,1,1969.7000000000005,1530.75
10945,U517C32,29,2123.8700000000063,15,14,144638.3,146762.16999999998
10946,UCAF0F5,29,-473.76,24,5,1033.03,559.27
10947,UF9D63E,29,7132.949999999997,23,6,30292.609999999997,37425.56
10948,U5914C0,29,-3997.18,28,1,4405.2,408.02
10949,U43451E,29,53.700000000000216,15,14,5297.300000000001,5351.000000000001
10950,UD74C31,29,431.3799999999985,16,13,25606.23,26037.61
10951,UAD3486,29,1.24,13,16,6027.34,6028.58
10952,U2BFA1F,29,-1004.94,20,9,3071.1899999999996,2066.25
10953,UEE85B7,29,6773.360000000001,26,3,8264.0,15037.36
10954,U04798B,29,-2013.45,22,7,2480.45,467.0
10955,UE3D8EF,29,-1527.2900000000002,25,4,19378.04,17850.75
10956,U6B22BC,29,56568.09,23,6,11201.68,67769.77
10957,U180E1D,29,-7898.57,24,5,33604.25000000001,25705.68
10958,U11F800,29,-5333.04,26,3,21375.0,16041.96
10959,U19FC8B,29,-1553.7600000000002,26,3,1937.7600000000002,384.0
10960,U00B050,29,4032.7900000000004,27,2,5969.209999999998,10002.0
10961,U99E6B4,29,582.1399999999999,23,6,5814.25,6396.39
10962,UBA149C,29,-11.91999999999993,25,4,1250.2199999999998,1238.3
10963,UDF0E3E,29,38595.600000000006,13,16,19606.18,58201.78
10964,U5F52B9,29,-9.990000000000691,27,2,15984.5,15974.51
10965,U0EAD29,29,4742.92,11,18,30880.859999999997,35623.780000000006
10966,U89C625,29,-4.050000000000001,17,12,35.050000000000004,31.0
10967,UB41987,29,2792.1800000000035,22,7,11492.609999999999,14284.79
10968,U89F38D,29,4930.17,24,5,17218.829999999998,22149.0
10969,U034970,29,241.6999999999989,25,4,6256.360000000001,6498.0599999999995
10970,U8E4E0D,29,631.5399999999993,25,4,9567.720000000001,10199.26
10971,UFC635D,29,167.79000000000008,27,2,3934.9000000000005,4102.6900000000005
10972,UF193B6,29,-8703.460000000001,21,8,36863.08000000001,28159.620000000003
10973,UAB91C3,29,2737.8199999999997,27,2,8103.43,10841.25
10974,UE46E16,29,-369.0,29,0,369.0,0.0
10975,UE86E78,29,1850.1800000000003,24,5,14349.8,16199.98
10976,U9B94F5,29,-78.89999999999964,17,12,29908.9,29830.0
10977,U230295,29,-725.02,23,6,1773.12,1048.1
10978,UE5F2DE,29,-1974.34,27,2,7464.9400000000005,5490.6
10979,U688FE6,29,344.07000000000005,26,3,1657.8700000000001,2001.94
10980,U8C234A,29,226.69000000000324,22,7,29319.34,29546.030000000002
10981,U9DC7DC,29,-27146.09,16,13,149846.09000000003,122700.0
10982,UC3B677,29,36652.119999999995,19,10,41700.770000000004,78352.89
10983,UF4C17F,29,0.0,18,11,2287.3,2287.3
10984,U6BB575,29,745.3999999999996,20,9,64895.29000000001,65640.69
10985,UA05C2E,29,-976.5900000000001,22,7,9476.59,8500.0
10986,UD8DEFF,29,-147.79999999999876,18,11,47679.43000000001,47531.63
10987,UAAC659,29,-1327.2199999999998,20,9,3434.49,2107.27
10988,U975664,29,-9024.21,27,2,12770.0,3745.79
10989,U7C03F1,29,-1522.7400000000018,19,10,25664.8,24142.06
10990,UF7A34E,29,604.7299999999999,24,5,1470.2700000000002,2075.0
10991,UA9760F,29,1633.8000000000002,23,6,12692.800000000001,14326.600000000002
10992,U227D45,29,-559.2,23,6,2399.2000000000003,1840.0
10993,U494D31,29,77239.15000000001,21,8,41470.95999999999,118710.11
10994,UE0DA1C,29,-9874.94,27,2,9877.029999999999,2.09
10995,U5E1DD9,29,32673.870000000003,17,12,167234.19,199908.06
10996,UCE5D58,29,-4451.290000000002,21,8,23423.449999999997,18972.16
10997,UBC9325,29,-14310.230000000003,24,5,30987.92,16677.69
10998,U7B34A0,29,833.5899999999999,24,5,4780.77,5614.36
10999,U7B7F54,29,-1728.8700000000001,22,7,5244.370000000001,3515.5
11000,U324874,29,16305.029999999999,23,6,6084.070000000001,22389.1
11001,U02E27A,29,3378.319999999999,13,16,7053.8,10432.119999999999
11002,U577D64,29,43822.64,22,7,37012.73,80835.37
11003,U01AF55,29,-879.5,22,7,5491.739999999999,4612.24
11004,U2C6F95,29,2279.3099999999995,22,7,4616.250000000001,6895.56
11005,UE817BA,29,19298.129999999997,13,16,63154.82,82452.95
11006,U9869D0,29,1288.9400000000003,27,2,2211.0599999999995,3500.0
11007,UB4036E,29,-1882.5299999999995,24,5,11287.649999999998,9405.12
11008,UAC23B5,29,898.2599999999994,27,2,4839.510000000001,5737.77
11009,U081912,29,359.62000000000035,24,5,5811.199999999999,6170.82
11010,UB4D8AA,29,-2532.989999999999,26,3,21482.989999999998,18950.0
11011,U0C587D,29,-7569.720000000001,21,8,34024.56,26454.84
11012,U5F14D9,29,-4243.829999999999,27,2,4243.889999999999,0.06
11013,U1F5AE8,29,-1080.75,18,11,7753.960000000001,6673.21
11014,U01961D,29,-378.57000000000085,27,2,2913.2000000000007,2534.63
11015,U4EC0A5,29,-11593.01,25,4,14533.19,2940.18
11016,UA8C54D,29,-1833.5,24,5,6841.5,5008.0
11017,UE6041F,29,7989.609999999998,20,9,14262.580000000002,22252.19
11018,U723DC8,29,855.2099999999991,18,11,29681.83,30537.04
11019,U0A61F8,29,-6944.51,29,0,6944.51,0.0
11020,U79AE77,29,-6062.719999999999,20,9,19268.82,13206.1
11021,U751055,29,-2.0000000000001137,18,11,2464.52,2462.52
11022,UB5CFA6,29,1246060.0,3,26,19835.0,1265895.0
11023,U8F4BD1,29,5667.38,22,7,24058.600000000002,29725.98
11024,U731C4D,29,5298.119999999997,20,9,25147.38,30445.5
11025,UF05D23,29,-24.6500000000001,18,11,26608.7,26584.05
11026,UB72E19,29,278.24,23,6,2075.12,2353.36
11027,UDF5967,29,10159.680000000002,16,13,22267.43,32427.11
11028,UD837CF,29,24617.780000000006,18,11,132943.79,157561.57
11029,UD41BC9,29,4321.950000000001,24,5,10478.4,14800.35
11030,U85AB85,29,-12672.860000000002,23,6,88357.13000000002,75684.27
11031,UC52128,29,-22693.350000000002,28,1,38267.71000000001,15574.36
11032,U952F03,29,1165.53,27,2,700.79,1866.3200000000002
11033,U27462B,29,1306.94,25,4,2100.01,3406.95
11034,UC6CBD9,29,1664.899999999999,21,8,17955.539999999997,19620.44
11035,UE0A268,29,5792.210000000001,24,5,20824.5,26616.710000000003
11036,UABB6A7,29,-6775.250000000001,22,7,11855.0,5079.75
11037,U910029,29,-0.07000000000005002,18,11,2246.59,2246.5200000000004
11038,U40B059,29,700.78,26,3,5458.24,6159.0199999999995
11039,UA30481,29,-9530.61,28,1,10730.61,1200.0
11040,U360ABD,29,98.57000000000107,16,13,15552.22,15650.79
11041,UF709FE,29,-6209.870000000002,24,5,16984.49,10774.619999999999
11042,UEFF26E,29,-289.7000000000003,27,2,5672.700000000001,5383.0
11043,U343B31,29,5034.0,24,5,1257.3899999999999,6291.389999999999
11044,U56645C,28,2163.4199999999996,24,4,15254.679999999998,17418.1
11045,U88CCA4,28,-131.1800000000003,16,12,18797.6,18666.42
11046,UAB35CD,28,-6613.84,27,1,9613.84,3000.0
11047,UD9EA9A,28,2760.0499999999997,18,10,2526.3300000000004,5286.38
11048,U6F43A0,28,-2038.8,25,3,7553.150000000001,5514.35
11049,U21DA6E,28,1397.1399999999994,23,5,12582.86,13980.0
11050,U02848C,28,365.7399999999999,26,2,584.2400000000001,949.98
11051,U58464A,28,-190.8,28,0,190.8,0.0
11052,UF088F6,28,-520.3200000000002,26,2,1433.1399999999999,912.8199999999999
11053,U0820F4,28,16486.34,8,20,18272.68,34759.02
11054,U2A7EB3,28,-6916.289999999998,25,3,24951.33,18035.04
11055,U59C406,28,830.3299999999967,23,5,400105.44,400935.77
11056,UFEF264,28,150.44999999999993,24,4,2120.3899999999994,2270.84
11057,U71BED6,28,22449.12,18,10,20558.02,43007.14
11058,U8A8B6D,28,70682.40000000002,23,5,2983.8200000000006,73666.22000000002
11059,U7D6A54,28,1972.0200000000018,23,5,15972.069999999998,17944.09
11060,UCF46A4,28,596.32,25,3,2263.7400000000002,2860.06
11061,U004D2C,28,-3335.55,22,6,18278.0,14942.45
11062,UEB4A99,28,-1143.9899999999998,22,6,3218.2299999999996,2074.24
11063,U666404,28,184.75,25,3,1159.65,1344.4
11064,UC4EDF3,28,-4515.700000000004,22,6,69830.53000000001,65314.83
11065,UF024DD,28,-542.7499999999999,23,5,1143.0499999999997,600.3
11066,U210632,28,-1165.2199999999998,25,3,1423.6100000000001,258.39
11067,U5E8A14,28,-5825.690000000001,19,9,33786.06,27960.370000000006
11068,UEF0AA9,28,-1308.9599999999882,17,11,233793.09999999998,232484.13999999998
11069,U8EEA2A,28,609.5300000000001,24,4,857.54,1467.07
11070,UF96C5E,28,1221.0200000000004,21,7,27843.6,29064.62
11071,U7774E2,28,-2982.2699999999995,26,2,4135.91,1153.6399999999999
11072,U332958,28,-16201.890000000001,22,6,16351.890000000001,150.0
11073,U3D667B,28,223.27000000000044,21,7,76596.36,76819.63
11074,UF50C83,28,5.0,15,13,11992.0,11997.0
11075,U7ED841,28,-1893.2199999999993,26,2,21350.570000000007,19457.350000000002
11076,U1B0F56,28,-97.55000000000007,17,11,1553.6799999999998,1456.1299999999999
11077,U999E51,28,-8035.39,28,0,8035.39,0.0
11078,UC16BB2,28,2164.7,23,5,6789.33,8954.029999999999
11079,U11B177,28,1131.63,19,9,8608.029999999999,9739.66
11080,U35E562,28,-724.8,25,3,3724.8,3000.0
11081,UCEF984,28,38.99999999999996,25,3,1023.0,1062.0
11082,UE6E920,28,9554.74,21,7,7437.45,16992.190000000002
11083,UAA1FB1,28,29096.32,21,7,61578.43,90674.75
11084,UFEE0CD,28,-662.44,24,4,2550.9000000000005,1888.46
11085,U49E13D,28,-2965.0,26,2,18347.43,15382.43
11086,UFEAD80,28,2094.6299999999997,23,5,1580.7599999999998,3675.39
11087,U14C424,28,-10053.579999999998,23,5,39752.48,29698.9
11088,U0D2CA8,28,0.0,14,14,94000.0,94000.0
11089,U0ED6F2,28,206.45999999999998,20,8,813.54,1020.0
11090,U55D2E5,28,-6545.840000000001,26,2,19651.68,13105.84
11091,UC38183,28,-5605.539999999999,27,1,15105.539999999999,9500.0
11092,UACA5DD,28,7200.300000000005,17,11,96182.74,103383.04000000001
11093,U8FA91E,28,4986.090000000002,11,17,20871.99,25858.08
11094,UD1BDCE,28,-14996.039999999997,24,4,29996.04,15000.0
11095,UFBC9D6,28,-2709.8099999999995,17,11,34640.0,31930.19
11096,UF3F9FE,28,-3300.4500000000003,19,9,17015.059999999998,13714.61
11097,UE833A4,28,11180.57,25,3,1605.1300000000003,12785.7
11098,U190BD7,28,29904.529999999995,22,6,40968.17,70872.7
11099,UAFB703,28,154.78999999999988,26,2,1420.45,1575.24
11100,U02546A,28,80.26999999999998,24,4,7821.78,7902.05
11101,U90ABB6,28,31146.239999999998,17,11,212498.72000000003,243644.96000000002
11102,U8B6988,28,-2282.120000000001,25,3,9099.98,6817.86
11103,U0D251D,28,6053.210000000001,21,7,32495.11,38548.32
11104,UEE7274,28,-959.39,25,3,1737.4899999999998,778.1
11105,U2C368E,28,382.69000000000005,19,9,92323.37999999998,92706.07
11106,UD0CF25,28,5508.950000000001,20,8,15975.5,21484.45
11107,UF8D1E3,28,-4347.510000000003,19,9,43604.490000000005,39256.979999999996
11108,U4A6FBB,28,423.930000000001,22,6,12263.31,12687.24
11109,U6E78F5,28,-18910.079999999998,26,2,29696.079999999998,10786.0
11110,U8D2262,28,-6739.42,26,2,8333.0,1593.58
11111,U47BFDC,28,221.9900000000004,14,14,12336.04,12558.029999999999
11112,U905EA7,28,-1161.8899999999996,25,3,3076.86,1914.97
11113,UBA84C8,28,201.96000000000004,17,11,36033.0,36234.96
11114,UC95A3C,28,-1718.0600000000559,17,11,879825.7999999999,878107.74
11115,U76BA89,28,-444.08000000000004,24,4,896.8000000000001,452.71999999999997
11116,U4DE60F,28,351.28999999999985,23,5,3115.94,3467.23
11117,U3C8BA3,28,-4037.62,28,0,4037.62,0.0
11118,U2D5325,28,-15463.720000000001,27,1,18963.72,3500.0
11119,UC2CBD4,28,-45818.88999999999,16,12,73141.09999999999,27322.21
11120,U30CCED,28,-4577.0,26,2,7077.0,2500.0
11121,UE3C313,28,-753.0,13,15,50293.0,49540.0
11122,UAF1A58,28,-90.73000000000008,20,8,5498.51,5407.78
11123,UE4B2C2,28,-5711.739999999991,20,8,188872.81000000003,183161.07
11124,U3C2E99,28,-6882.999999999998,15,13,31931.34,25048.34
11125,UDA27C2,28,39086.95,22,6,27061.190000000006,66148.14
11126,UF5687C,28,19030.350000000002,25,3,10975.48,30005.83
11127,UF3A82C,28,-221.51,23,5,834.3299999999999,612.82
11128,UE9C0A6,28,-8111.08,15,13,56380.36,48269.28
11129,UB24A88,28,-3422.97,24,4,7834.97,4412.0
11130,U848BD1,28,617.2099999999991,23,5,49317.78,49934.99
11131,U48B0F4,28,-1202.2500000000116,19,9,165373.30000000002,164171.05
11132,U5034F7,28,125740.65,22,6,10241.09,135981.74
11133,UF7E00C,28,104240.48,18,10,148419.29,252659.77
11134,U41429B,28,-8328.33,26,2,9150.81,822.48
11135,U2757A7,28,5000.459999999998,19,9,53933.81,58934.27
11136,UF637C7,28,81345.18999999999,11,17,216750.4,298095.58999999997
11137,UC6748C,28,1546.63,21,7,8339.23,9885.86
11138,U7C26F3,28,-354.7399999999998,21,7,30613.989999999998,30259.25
11139,U0EA2EB,28,-2656.0,19,9,43770.0,41114.0
11140,UEC5740,28,418.6800000000003,20,8,7331.309999999999,7749.99
11141,U300BD1,28,-6879.830000000001,26,2,17035.12,10155.289999999999
11142,U40A19F,28,-4.090000000000003,21,7,984.14,980.05
11143,U6DF964,28,1064.7000000000025,25,3,19965.039999999997,21029.74
11144,U2943F3,28,1871.119999999999,13,15,36472.08,38343.2
11145,U88C515,28,4262.3,15,13,546992.32,551254.62
11146,U59E72E,28,0.0,18,10,20000.0,20000.0
11147,U588CB8,28,395.5300000000001,23,5,1627.47,2023.0
11148,U3E547B,28,-56644.22,24,4,119695.62,63051.4
11149,UEE10D4,28,-2622.71,23,5,4295.67,1672.96
11150,U265447,28,102.27999999999963,24,4,4596.719999999999,4699.0
11151,UC03D72,28,9622.069999999998,22,6,43278.08000000001,52900.149999999994
11152,U924E7F,28,16799.45,21,7,6408.81,23208.26
11153,U3946F7,28,-7069.0599999999995,24,4,10122.76,3053.7
11154,U6A2BFE,28,24365.11,13,15,31504.0,55869.11
11155,UCEA3B6,28,-365.9699999999999,22,6,13444.04,13078.07
11156,U4CA19E,28,14090.550000000005,25,3,4664.45,18755.0
11157,U1588C4,28,2685.51,25,3,2684.6899999999996,5370.2
11158,U8F355B,28,1625.52,25,3,7074.4800000000005,8700.0
11159,U0E84D7,28,-578.9200000000001,15,13,2851.61,2272.69
11160,U6E74A2,28,-10341.3,17,11,36029.210000000014,25687.91
11161,U9CBE0C,28,-299.54000000000065,23,5,5072.410000000001,4772.87
11162,UA15964,28,-1289.5599999999995,23,5,16558.36,15268.8
11163,U486B09,28,-305.1600000000004,24,4,8520.16,8215.0
11164,U7C7B14,28,-17527.190000000002,22,6,60290.20000000001,42763.01
11165,UAB2C1E,28,-969.0600000000018,24,4,9555.389999999998,8586.33
11166,U26E6E1,28,1.4599999999999738,16,12,313.1,314.55999999999995
11167,U0A50A2,28,50748.69,13,15,27857.2,78605.89
11168,U94FD2A,28,-727.2800000000002,19,9,3661.1600000000003,2933.8800000000006
11169,U1A9134,28,-550.4199999999998,21,7,8952.869999999999,8402.45
11170,U1F8E40,28,-682.8200000000002,25,3,10784.43,10101.61
11171,U5C6DF1,28,-2316.8199999999997,18,10,3968.3,1651.48
11172,UDED297,28,4857.09,19,9,33000.0,37857.09
11173,U8B7141,28,200.51000000000022,15,13,5250.62,5451.129999999999
11174,U99257A,28,-318.59000000000015,26,2,1836.9899999999998,1518.4
11175,UED4E6E,28,-849.4099999999996,26,2,2313.9399999999996,1464.53
11176,UDABB01,28,206.6400000000005,26,2,7320.419999999999,7527.06
11177,U1ED8BE,28,-3.197442310920451e-14,22,6,712.4499999999998,712.4499999999999
11178,UD6BEC3,28,1338.87,15,13,7311.14,8650.01
11179,U5CB7E8,28,-257.20000000000005,19,9,7795.42,7538.22
11180,U4291E6,28,1794.56,17,11,10217.31,12011.869999999999
11181,U617953,28,-5285.42,21,7,15786.52,10501.1
11182,UAA3092,28,-4244.91,18,10,12854.430000000002,8609.52
11183,UA58CA3,28,-419.74000000000024,25,3,2668.4000000000005,2248.66
11184,UB6199C,28,11.700000000000045,14,14,82600.0,82611.7
11185,U7B51B7,28,69.5,24,4,6702.0,6771.5
11186,U7E3F3E,28,-2078.720000000001,20,8,51517.12,49438.4
11187,U281DDB,28,-2364.5700000000033,12,16,110108.36000000002,107743.79000000001
11188,U6C9017,28,152.30999999999995,21,7,3915.48,4067.7900000000004
11189,U92FE7F,28,-3143.94,27,1,3243.94,100.0
11190,UBE347E,28,-3204.4799999999996,26,2,3562.4799999999996,358.0
11191,UE8F4FD,28,2290.4500000000007,21,7,31850.0,34140.45
11192,U2469CE,28,4376.4800000000005,21,7,647.48,5023.96
11193,U5406C0,28,-1787.9599999999994,26,2,2579.5099999999998,791.55
11194,U6E8E79,28,-1379.9700000000003,23,5,8293.960000000001,6913.99
11195,UCA9797,28,-7787.609999999997,19,9,65054.8,57267.189999999995
11196,U127D67,28,134.4999999999999,20,8,29652.84,29787.34
11197,UEB8674,28,-45220.44,23,5,144870.13999999998,99649.70000000001
11198,UFA2EDF,28,349.13,15,13,2950.8499999999995,3299.9799999999996
11199,U706DEC,28,0.06000000000028649,24,4,3011.1799999999994,3011.24
11200,UEBBD43,28,-1335.12,22,6,13982.48,12647.36
11201,U512561,28,-319.27,17,11,5950.84,5631.57
11202,U176CBC,28,-15325.599999999997,22,6,17553.500000000004,2227.9
11203,UAF53C4,28,-247.49,24,4,1683.28,1435.79
11204,U1C069F,28,49201.71000000001,18,10,109044.85,158246.56
11205,U63F163,28,0.2,15,13,55000.0,55000.2
11206,U36CE7E,28,5757.36,22,6,5274.64,11032.0
11207,U37E50E,28,43.94999999999505,11,17,109545.0,109588.95
11208,U4DB463,28,-35702.7,23,5,85891.69999999998,50189.0
11209,UD12259,28,-2545.94,19,9,6001.650000000001,3455.71
11210,U47CEA6,28,87287.56000000001,12,16,7433.48,94721.04000000001
11211,UE4386D,28,-2772.8999999999996,28,0,2772.8999999999996,0.0
11212,UCC8A88,28,-4581.240000000001,20,8,33245.79,28664.55
11213,UF9F405,28,2517.81,22,6,7457.57,9975.380000000001
11214,U69BFA4,28,923.5699999999997,25,3,10984.43,11908.0
11215,UDC5596,28,-30496.499999999996,27,1,30501.019999999997,4.52
11216,U7FCB4D,28,-12552.95,23,5,24837.44,12284.49
11217,UF8553F,28,56042.81000000001,17,11,131157.97999999998,187200.78999999998
11218,UF5B6FC,28,-1027.27,27,1,1482.5000000000002,455.23
11219,U9B59E6,28,-1919.9500000000007,26,2,52288.69,50368.74
11220,U1FF466,28,-1937.2099999999998,27,1,1937.2199999999998,0.01
11221,UC3C5CE,28,65.36000000000013,14,14,10404.0,10469.359999999999
11222,U22F9D2,28,112.06000000000017,20,8,5537.98,5650.04
11223,UEC5472,28,3161.2699999999995,22,6,9207.219999999998,12368.49
11224,UA098CC,28,-1899.6900000000007,18,10,5046.78,3147.09
11225,UA72D66,28,1809.5999999999995,23,5,13660.4,15470.0
11226,U24F44C,28,4028.9700000000003,21,7,3598.56,7627.530000000001
11227,UC9E487,28,-4762.080000000003,18,10,52662.08,47900.0
11228,UD3726F,28,1053.31,22,6,1037.6100000000001,2090.92
11229,UD8131A,28,-6346.119999999994,17,11,245657.01,239310.88999999998
11230,U060DDE,28,38363.64000000001,10,18,6348.310000000001,44711.95
11231,U770285,28,-52.02000000000018,22,6,2661.54,2609.5200000000004
11232,U7D51E6,28,-1581.1599999999999,24,4,2564.97,983.81
11233,U746E24,28,-662.7899999999998,24,4,3187.9199999999996,2525.13
11234,UD2657D,28,-124375.32999999994,22,6,127188.71999999996,2813.3900000000003
11235,U52FE70,28,1217.67,24,4,15110.27,16327.939999999999
11236,UEF6E68,28,-1306.5700000000004,26,2,4809.54,3502.9700000000003
11237,U08F700,28,-66.02000000000044,18,10,9795.880000000001,9729.86
11238,U16A966,28,1658.47,25,3,3343.12,5001.59
11239,U596E61,28,362.5199999999994,23,5,16605.71,16968.23
11240,U585AD8,28,-10185.529999999995,26,2,26186.069999999996,16000.54
11241,UC1FBCC,28,1789.0000000000007,19,9,7878.329999999999,9667.33
11242,U3C8AE6,28,-28532.28,19,9,56033.22,27500.94
11243,UDFD9AB,28,-292.21999999999935,17,11,36043.75,35751.53
11244,U32B1DE,28,203.0,19,9,37103.0,37306.0
11245,U8380D9,28,4840.220000000001,18,10,12340.05,17180.269999999997
11246,UB6F60F,28,146.04999999999995,24,4,1190.24,1336.29
11247,U2B06DE,28,4099.12,21,7,15450.58,19549.7
11248,U13C663,28,-298.6,27,1,450.61,152.01
11249,UDF643F,28,-86551.89,28,0,86551.89,0.0
11250,UE42AB9,28,-320.4399999999999,23,5,1122.08,801.6400000000001
11251,U41BE9D,28,569.5299999999995,26,2,4389.21,4958.74
11252,U3AFF3B,28,-29334.399999999994,27,1,29336.929999999993,2.53
11253,U098F90,28,-43729.51,18,10,70080.12,26350.61
11254,UF331BA,28,-1275.88,25,3,4975.83,3699.95
11255,UF7695B,28,11225.68,23,5,4516.8,15742.48
11256,UDF4B78,28,78.67000000000625,24,4,35629.590000000004,35708.26
11257,UF8FA89,28,-20647.37000000002,19,9,700367.52,679720.15
11258,U31E259,28,1467.9299999999998,24,4,583.1299999999999,2051.06
11259,U06B85E,28,-5411.670000000002,21,7,40343.729999999996,34932.06
11260,U8E770A,28,-1991.9000000000003,25,3,8654.9,6663.0
11261,U774354,28,-299.3400000000002,23,5,3043.94,2744.6
11262,U993AE0,28,-1502.3300000000006,25,3,3647.0800000000004,2144.75
11263,UE6988C,28,-111.42000000000012,23,5,3782.4800000000005,3671.06
11264,U6EAE3A,28,-1642.77,25,3,2792.79,1150.02
11265,UDEED3D,28,272.81000000000006,26,2,1619.06,1891.8700000000001
11266,U91FC42,28,1966.55,21,7,2077.26,4043.81
11267,U96E244,28,-17541.73,19,9,53352.70000000001,35810.97
11268,U110385,28,41448.54,16,12,44141.28,85589.82
11269,UF2F879,28,815.6200000000005,20,8,9635.38,10450.999999999998
11270,U657D86,28,-6370.809999999998,20,8,28613.690000000002,22242.88
11271,UE28D46,28,-913.1299999999999,24,4,2031.13,1118.0
11272,U017769,28,-1257.999999999999,20,8,5555.259999999999,4297.26
11273,U77C158,28,-34.580000000056316,19,9,421556.59,421522.00999999995
11274,UF1B189,28,-7.399999999999636,23,5,5555.0,5547.6
11275,UCEB5AD,28,135981.97000000003,13,15,118794.77,254776.74000000002
11276,U32FA6A,28,1841.0300000000025,20,8,45792.71,47633.74
11277,UD4B112,28,-1182.9399999999998,26,2,3182.94,2000.0
11278,UC3DA75,28,-411.2600000000009,21,7,23663.79,23252.53
11279,UFD87EE,28,2136.8700000000003,19,9,17004.070000000003,19140.940000000002
11280,U48A830,28,-5294.420000000001,23,5,22297.940000000002,17003.519999999997
11281,U23E4ED,28,307931.30000000005,19,9,7739.400000000001,315670.7
11282,U15A0CB,28,-1650.1399999999999,18,10,13194.97,11544.83
11283,U83469F,28,479.11,26,2,1398.58,1877.69
11284,U3B9DB9,28,-35130.76,26,2,36233.86000000001,1103.1
11285,U4A6D0D,28,-1711.9499999999998,24,4,4092.2300000000005,2380.2799999999997
11286,U7FC614,28,-20520.93,25,3,61838.780000000006,41317.85
11287,U694016,28,-7740.079999999999,21,7,11777.12,4037.04
11288,U83BBE9,28,7158.590000000002,20,8,22275.529999999995,29434.12
11289,U2110FF,28,4.829999999999963,25,3,1852.1599999999999,1856.99
11290,UC36DAC,28,-7398.77,28,0,7398.77,0.0
11291,U1A761D,28,-1307.4900000000002,21,7,12049.49,10742.0
11292,UE0A689,28,-0.010000000002047926,17,11,52058.34000000001,52058.33
11293,U593785,28,740674.92,8,20,730010.02,1470684.9399999997
11294,U29286E,28,-47850.979999999996,16,12,159365.35000000003,111514.36999999998
11295,U52B1C4,28,-181.5600000000002,23,5,3483.4800000000014,3301.92
11296,U17205C,27,462.8599999999999,25,2,1537.46,2000.32
11297,U61F3F4,27,-8892.260000000004,21,6,59611.020000000004,50718.76
11298,U05E93D,27,4003.9500000000003,22,5,1254.7,5258.650000000001
11299,UCD8AF7,27,-177.25,18,9,60177.25,60000.0
11300,UDFBD4A,27,3612.01,21,6,1122.33,4734.34
11301,U1035D1,27,-23240.679999999993,17,10,169133.66,145892.98
11302,UF7F05B,27,-3278.4299999999985,22,5,38831.55,35553.12
11303,UC86A96,27,-52.17999999999999,15,12,902.54,850.36
11304,U23C18D,27,-392402.95,23,4,457465.51,65062.56
11305,UC4C324,27,-2817.9400000000005,26,1,4917.9400000000005,2100.0
11306,U3B2B1A,27,117.35999999999956,23,4,9188.44,9305.8
11307,U483596,27,983.1300000000001,22,5,16716.869999999995,17700.0
11308,UAA3B9E,27,339.46000000000015,22,5,1796.9900000000002,2136.45
11309,U339A65,27,424.88999999999993,18,9,8141.7699999999995,8566.66
11310,U1F8D1D,27,-3001.9799999999996,21,6,15876.0,12874.02
11311,U0DA047,27,817.0300000000002,21,6,8274.560000000001,9091.59
11312,U129848,27,-4689.4100000000035,17,10,89541.10999999999,84851.7
11313,U6DF521,27,-2882.02,24,3,3049.52,167.5
11314,U75B318,27,1168.0000000000005,21,6,9231.420000000002,10399.42
11315,U336E38,27,532.12,25,2,3699.38,4231.5
11316,U9F3712,27,0.0,13,14,39986.0,39986.0
11317,U099434,27,-6054.939999999999,15,12,27912.94,21858.0
11318,U7BA944,27,3.3800000000000523,25,2,1571.62,1575.0
11319,UDF6BB5,27,-9652.720000000001,22,5,21485.119999999995,11832.4
11320,U6D8083,27,-32019.769999999997,19,8,34291.44,2271.67
11321,U0E8C9A,27,1334.1699999999992,18,9,74561.01,75895.18
11322,U07028B,27,2437.1500000000015,20,7,28168.2,30605.35
11323,UCD984E,27,-5598.839999999999,13,14,9327.439999999999,3728.6
11324,U82EAC2,27,345.88000000000056,21,6,5720.5199999999995,6066.4
11325,U59C3CD,27,-2161.2400000000016,19,8,20728.1,18566.86
11326,U17CDF8,27,511.1100000000001,25,2,5710.82,6221.93
11327,U1CD47A,27,-3293.220000000005,21,6,25767.22,22474.0
11328,U604532,27,-2940.5300000000007,23,4,12857.78,9917.25
11329,UCBBE9D,27,65268.100000000006,19,8,52801.3,118069.4
11330,UC180E2,27,1560.5500000000002,23,4,15093.36,16653.91
11331,U5974A7,27,2384.860000000001,23,4,16464.14,18849.0
11332,U20FDB8,27,-6026.9400000000005,21,6,19862.069999999996,13835.13
11333,U69D9BE,27,3070.860000000001,12,15,4689.21,7760.07
11334,UC38FD2,27,2608.1299999999997,17,10,17053.449999999997,19661.579999999998
11335,U0AE83C,27,815.84,24,3,3073.14,3888.98
11336,UD220B5,27,-1.3300000000006378,17,10,16314.560000000001,16313.23
11337,UE03173,27,-5326.91,25,2,5327.209999999999,0.30000000000000004
11338,UE9E460,27,-60.900000000000006,16,11,1638.2900000000002,1577.39
11339,UC3B59C,27,12754.77,15,12,24003.08,36757.85
11340,U8DA570,27,-2882.109999999999,19,8,39953.54,37071.43
11341,U447673,27,-11.18999999999994,22,5,2556.85,2545.66
11342,U82F91A,27,833.0,14,13,110428.0,111261.0
11343,UC50F00,27,-4176.810000000001,19,8,48931.4,44754.590000000004
11344,UC47F59,27,-184490.97999999998,18,9,325482.74,140991.75999999998
11345,U38DC29,27,2111.100000000001,21,6,27987.45,30098.55
11346,U8AE6AD,27,-8806.859999999999,25,2,9405.859999999999,599.0
11347,U7C6A38,27,-7573.7800000000025,17,10,26234.609999999997,18660.83
11348,UB24EC2,27,-13678.66999999999,22,5,50415.05000000001,36736.38
11349,UE6213D,27,13995.45,15,12,24713.96,38709.41
11350,UAB9738,27,-324.1399999999994,19,8,19697.14,19373.0
11351,UED9C7F,27,-1005.8999999999999,21,6,2951.8999999999996,1946.0
11352,U7BFB00,27,6865.479999999988,15,12,85505.01999999999,92370.50000000001
11353,UDF377A,27,-23123.510000000002,18,9,85105.62999999999,61982.12
11354,U9B601A,27,5910.359999999986,15,12,502435.0,508345.36000000004
11355,U9F2B34,27,-4372.99,23,4,14707.0,10334.01
11356,U977C0D,27,-6398.08,21,6,15744.279999999999,9346.199999999999
11357,U56721E,27,283898.88,14,13,188273.0,472171.88
11358,U4F6D45,27,-1807.2000000000005,24,3,3327.2000000000007,1520.0
11359,UA93236,27,2026.5900000000001,8,19,5809.0,7835.59
11360,U0D958A,27,278.28,25,2,1289.9199999999998,1568.1999999999998
11361,U8F2649,27,1035.1200000000001,20,7,3755.050000000001,4790.17
11362,UA98241,27,664.03,16,11,90336.0,91000.03
11363,U973991,27,2757.899999999999,17,10,18598.939999999995,21356.84
11364,U1CF02B,27,-14463.54,14,13,115682.31,101218.76999999999
11365,UECF925,27,-7294.41,27,0,7294.41,0.0
11366,UE22402,27,-6532.209999999999,22,5,13002.98,6470.77
11367,U0FE36A,27,-427.4800000000001,17,10,7368.740000000001,6941.26
11368,U833086,27,347.4200000000005,23,4,8594.029999999999,8941.45
11369,UB8B087,27,-540.5200000000002,24,3,1540.5200000000002,1000.0
11370,U2F2600,27,-8214.74,23,4,9324.15,1109.4099999999999
11371,UBB5663,27,61220.380000000005,16,11,121306.93000000001,182527.31
11372,U88448D,27,265.0600000000003,23,4,2289.33,2554.3900000000003
11373,UAD9FC6,27,-1.5,24,3,2425.5,2424.0
11374,U8ED070,27,-1027.9799999999977,17,10,102339.98000000001,101312.0
11375,U29189B,27,6471.160000000001,19,8,8791.75,15262.91
11376,UE8A83B,27,-1313.8000000000004,22,5,19551.189999999995,18237.39
11377,U4E4866,27,9742.770000000002,25,2,1082.7800000000002,10825.55
11378,U9DEC73,27,0.4099999999998545,14,13,29999.6,30000.010000000002
11379,UE1CF52,27,-10290.770000000004,23,4,21364.840000000004,11074.07
11380,U404824,27,-2242.459999999999,21,6,34072.46,31830.0
11381,U227F72,27,-6390.870000000001,23,4,9594.8,3203.93
11382,UEFF358,27,-56.73000000000005,22,5,2076.74,2020.01
11383,U8B0A63,27,-4980.539999999999,19,8,58700.99,53720.450000000004
11384,U53125A,27,-10217.649999999996,19,8,28200.259999999995,17982.61
11385,U5220C1,27,-2008.7099999999994,20,7,11755.78,9747.07
11386,U538E5C,27,-1995.24,26,1,2609.830000000001,614.59
11387,UBA7CFA,27,-274.78,20,7,2818.6200000000003,2543.84
11388,U95D170,27,396.0199999999986,22,5,27958.379999999997,28354.4
11389,U862937,27,-4226.74,22,5,41643.44,37416.7
11390,U3D8F83,27,-646.7699999999995,20,7,26932.989999999998,26286.219999999998
11391,U47D2A0,27,-327.5100000000002,25,2,1476.8600000000001,1149.35
11392,U5C3BD5,27,132.72999999999996,24,3,649.95,782.6800000000001
11393,UCD1072,27,280.79999999999995,17,10,1889.7500000000002,2170.55
11394,U2B7FAA,27,-2379.9000000000005,24,3,15381.079999999998,13001.18
11395,U8B03EA,27,279.8900000000001,24,3,1105.98,1385.87
11396,UE46235,27,-42776.58,21,6,90264.75,47488.17
11397,UD4A567,27,-746.7400000000004,20,7,7783.930000000001,7037.1900000000005
11398,U3FF70B,27,-1005.0000000000001,23,4,6370.04,5365.04
11399,U06EA59,27,9854.350000000002,17,10,11727.899999999998,21582.25
11400,U65E953,27,-2960.2499999999995,23,4,4102.039999999999,1141.79
11401,U7DE3B9,27,-4052.84,24,3,10187.099999999999,6134.26
11402,U45F1F7,27,3045.2599999999993,19,8,13154.069999999998,16199.33
11403,UCF4461,27,1985.6999999999998,23,4,1948.6200000000001,3934.32
11404,UC9BC1B,27,-818.3,22,5,6036.3,5218.0
11405,U7B2D34,27,-13080.119999999999,19,8,47837.86,34757.74
11406,U578F9F,27,700.8199999999924,11,16,184904.03000000003,185604.85
11407,UCDF8E9,27,-1957.79,21,6,11140.83,9183.04
11408,U7F7513,27,-739.92,25,2,2401.5800000000004,1661.6599999999999
11409,UB3E301,27,-3063.7999999999993,19,8,28093.11,25029.31
11410,UD4758E,27,-4267.510000000001,22,5,23591.619999999995,19324.11
11411,UBE1EC4,27,-90.2899999999986,19,8,11823.71,11733.42
11412,U3DC3DE,27,149.16000000000076,24,3,5529.229999999998,5678.39
11413,U85851A,27,1.180000000000291,13,14,56014.53,56015.71
11414,UEED700,27,-4483.92,23,4,9608.640000000001,5124.719999999999
11415,U1A1466,27,603.1699999999985,23,4,14630.810000000001,15233.98
11416,UC7C83A,27,592.63,24,3,4005.370000000001,4598.0
11417,U9C8C97,27,1518.679999999993,16,11,97592.15,99110.83
11418,U3B83C0,27,4098.920000000001,17,10,8207.82,12306.740000000002
11419,U10E8D2,27,-232.88000000000002,23,4,2639.8800000000006,2407.0
11420,U0F0AE6,27,2126.5099999999993,19,8,6613.500000000001,8740.01
11421,U5E7ADB,27,0.0,19,8,20000.0,20000.0
11422,U7426B0,27,3002.349999999996,20,7,54366.65,57369.0
11423,UBB8B86,27,-1057.52,19,8,8376.34,7318.82
11424,U634535,27,-18950.0,20,7,22143.04,3193.04
11425,U35C50C,27,-4802.6,23,4,13421.6,8619.0
11426,U48D9F1,27,-1072.2700000000002,24,3,2744.0699999999997,1671.8
11427,UEB1BA5,27,-130.6799999999998,22,5,4228.010000000001,4097.33
11428,U5BE349,27,2196.2900000000013,17,10,20777.629999999997,22973.920000000002
11429,UEA5BD0,27,-18578.0,22,5,45480.05,26902.05
11430,U295329,27,-3117.4400000000005,16,11,47620.270000000004,44502.83
11431,U7CFDBE,27,1628.4000000000015,21,6,18164.3,19792.7
11432,U1634B8,27,13716.670000000002,16,11,35313.45,49030.12
11433,UB50DF1,27,-8564.07,23,4,8698.07,134.0
11434,UDF9D2A,27,3513.7000000000007,19,8,12542.199999999999,16055.900000000001
11435,U195F1C,27,-1132.5600000000006,25,2,3452.480000000001,2319.92
11436,UD654C7,27,-3423.0600000000004,24,3,11008.060000000005,7585.0
11437,UBBF959,27,555.7099999999999,21,6,2170.4500000000003,2726.16
11438,UD26201,27,1027.1100000000008,17,10,11862.05,12889.16
11439,UE74BB9,27,-6273.610000000001,21,6,7114.79,841.18
11440,U4C80FD,27,5499.9800000000005,16,11,8793.83,14293.81
11441,U8DC93B,27,-1309.1299999999999,16,11,12319.81,11010.68
11442,U3E343A,27,3837.8200000000006,19,8,9682.179999999998,13520.0
11443,U50EA31,27,-161.54999999999995,23,4,1787.8100000000002,1626.2599999999998
11444,U37175E,27,63.850000000000364,16,11,14532.55,14596.4
11445,UCB19BE,27,-55.539999999999964,22,5,5972.79,5917.25
11446,U0744FA,27,-237.06000000000006,20,7,2062.2,1825.1399999999999
11447,UE95788,27,56982.899999999994,12,15,83050.7,140033.6
11448,U0844BB,27,-25676.769999999997,21,6,82343.20999999999,56666.44
11449,UDFAF3E,27,1030.6999999999998,20,7,4816.34,5847.04
11450,U3C1987,27,17338.75,18,9,34633.92,51972.670000000006
11451,U18E9F6,27,-617.7399999999998,17,10,14720.48,14102.74
11452,UA55097,27,-1812.6,22,5,15912.740000000002,14100.14
11453,UE23444,27,161328.12,12,15,402293.34,563621.46
11454,U63315D,27,-37329.229999999996,19,8,71013.30000000002,33684.07
11455,UB2365F,27,514.9099999999994,12,15,84546.0,85060.91
11456,U5D6B77,27,215.9099999999998,25,2,8785.37,9001.28
11457,U89184B,27,8316.820000000002,17,10,14936.419999999998,23253.239999999998
11458,U11AE7C,27,2743.340000000001,23,4,3786.6900000000005,6530.030000000001
11459,UE68AFD,27,948.04,22,5,4204.299999999999,5152.34
11460,U2563C3,27,10077.94000000001,24,3,91922.06,102000.0
11461,U46CB87,27,318.3599999999997,14,13,12352.38,12670.740000000002
11462,UF9036E,27,-18421.75,17,10,47212.63,28790.879999999997
11463,U283E34,27,-2707.6100000000006,21,6,6457.93,3750.3199999999997
11464,UE9EAD3,27,1144.8,25,2,7356.14,8500.939999999999
11465,U4150F7,27,37590.73999999999,19,8,15212.400000000001,52803.14
11466,U92BB7B,27,-795.3200000000006,20,7,10467.970000000001,9672.65
11467,U4D21D6,27,39037.05,12,15,28154.01,67191.06
11468,U5475C0,27,47684.500000000015,6,21,218040.0,265724.5
11469,U3E9C9F,27,-90.88999999999942,25,2,63261.89,63171.0
11470,UF39287,27,-132.28000000000304,14,13,38518.36,38386.08
11471,U80FE9C,27,-1221.460000000001,17,10,17575.08,16353.619999999999
11472,UEE3AD7,27,-44524.869999999995,24,3,134774.87,90250.0
11473,UAE6D1F,27,-7517.630000000003,18,9,67498.13,59980.5
11474,UFC260D,27,24777.489999999998,15,12,69504.48000000001,94281.96999999999
11475,UCA6895,27,-1120.8600000000001,26,1,2990.86,1870.0
11476,UDEC8F3,27,286.00999999999965,24,3,10890.890000000001,11176.9
11477,U43D421,27,0.020000000000038654,20,7,16028.960000000003,16028.98
11478,UD14E64,27,241.12999999999738,18,9,47569.28,47810.409999999996
11479,U1FE7E7,27,-7366.130000000003,20,7,34641.17,27275.040000000005
11480,UDD4284,27,1110.0000000000018,19,8,41086.14,42196.14
11481,UD5ACB0,27,221.6700000000001,22,5,1449.45,1671.1200000000001
11482,UD18C5B,27,-296.1400000000001,14,13,3262.89,2966.75
11483,U2205E2,27,1215.2700000000004,19,8,76439.47,77654.74
11484,U79FD6E,27,-293.83000000000004,21,6,4209.5,3915.6699999999996
11485,UCECFE6,27,593.5,15,12,123706.5,124300.0
11486,U3F003C,27,158.39999999999998,24,3,94.61,253.01
11487,U94214A,27,79.0,10,17,31671.0,31750.0
11488,U4F5694,27,-1672.27,23,4,14423.5,12751.23
11489,U547850,27,-195.25000000000003,24,3,618.76,423.51
11490,UDCD622,27,-2291.4500000000016,25,2,24941.45,22650.0
11491,U1EECDC,27,-791.36,25,2,4240.26,3448.9
11492,U5FEA4B,27,-11085.30000000001,15,12,215109.91999999998,204024.62000000002
11493,U98619A,27,-65567.39,21,6,123707.59,58140.2
11494,U5A7BCD,27,-4847.82,22,5,26338.8,21490.98
11495,U3FFFA9,27,6097.4900000000025,16,11,7047.59,13145.08
11496,U3D3B50,27,3026.689999999999,21,6,2864.1300000000006,5890.82
11497,UD3FE95,27,9.470000000000084,22,5,1745.22,1754.69
11498,U9A360C,27,3268.4199999999983,16,11,23992.22,27260.64
11499,U5D5800,27,-464.80999999999574,22,5,13510.140000000001,13045.33
11500,U3948F7,27,-10720.7,21,6,12922.02,2201.32
11501,U2DAC31,27,6489.82,22,5,8726.75,15216.57
11502,U59417E,27,-171.00999999994366,15,12,675057.74,674886.7299999999
11503,U38FB8D,27,9573.34,24,3,5378.130000000001,14951.470000000001
11504,U4632AF,27,292.15999999999985,22,5,28617.8,28909.96
11505,U1B7DBF,27,1309.2,23,4,396.8,1706.0
11506,U3ADF42,27,-2524.12,17,10,3356.25,832.13
11507,U0031ED,27,-778.0300000000003,20,7,1818.2500000000002,1040.2200000000003
11508,U03CCC7,27,-3763.1099999999997,25,2,6927.719999999999,3164.61
11509,UCABB98,27,-60608.25000000001,24,3,65909.70000000001,5301.45
11510,U8F8EBB,27,-8811.08,14,13,17285.4,8474.32
11511,UEAF30A,27,59.80000000000007,24,3,2591.7599999999998,2651.56
11512,U4054B6,27,-1846.7000000000003,24,3,3065.0,1218.3
11513,U1B1369,27,-67607.02,19,8,84589.70999999999,16982.690000000002
11514,U8901F8,27,-26018.949999999983,1,26,60000.0,33981.05
11515,U1F8092,27,2082.0100000000007,18,9,16049.2,18131.21
11516,U03D801,27,2487.3500000000013,25,2,3788.64,6275.99
11517,U09B020,27,-3172.879999999999,19,8,20296.88,17124.0
11518,UCA2611,27,-669.1500000000001,22,5,2718.9500000000003,2049.8
11519,U138BFF,27,-3229.19,23,4,5612.99,2383.8
11520,U9D5B3A,27,2265.52,21,6,4310.87,6576.389999999999
11521,UA8FA96,27,-914.5100000000001,23,4,7026.009999999999,6111.5
11522,UA9BB17,27,10486.450000000003,21,6,79024.77,89511.22
11523,U5ACAE5,27,-337.9199999999999,21,6,11421.17,11083.25
11524,UF9123F,27,-10199.859999999999,19,8,16409.9,6210.04
11525,UF9BF54,27,266.72999999999865,14,13,26848.67999999999,27115.410000000003
11526,U7AD135,27,-351.6599999999996,18,9,5352.899999999999,5001.24
11527,U4D5FD6,27,6526.51,21,6,718.01,7244.519999999999
11528,U66D0A6,27,-52.299999999999955,20,7,8713.3,8661.0
11529,UB4196E,27,-103.23000000000002,25,2,373.2300000000001,270.0
11530,UE1E676,27,-2236.4,24,3,16136.399999999998,13900.0
11531,U39FA0E,27,3.400000000000091,19,8,5982.1,5985.5
11532,UEC157E,27,-7163.43,23,4,21033.43,13870.0
11533,U8C2091,27,-374.08000000000027,22,5,10625.67,10251.59
11534,UFDE13B,27,-4187.01,23,4,9973.5,5786.49
11535,U728E4C,27,65.17000000000024,23,4,2244.83,2310.0
11536,U76F5D2,27,-817.8699999999999,18,9,14197.869999999999,13380.0
11537,UBEC02C,27,-487.34,25,2,1349.7399999999998,862.4000000000001
11538,U69CF69,27,-494.12,21,6,7001.5599999999995,6507.4400000000005
11539,U2D3696,27,243.79999999999984,22,5,5036.92,5280.719999999999
11540,U98CCD0,27,-6130.670000000001,25,2,9743.800000000001,3613.13
11541,U7928D7,27,41641.49,21,6,126485.56999999998,168127.06
11542,U339E02,27,-30495.0,14,13,49360.6,18865.6
11543,U77DE42,27,-2687.130000000001,26,1,11704.34,9017.21
11544,UC3C119,27,24973.8,15,12,46505.41,71479.20999999999
11545,UDBA003,27,-3801.0499999999993,17,10,52762.0,48960.95
11546,U79B3E5,27,48.95000000000073,18,9,12701.09,12750.04
11547,U5551DD,27,-351.9000000000001,17,10,2382.94,2031.04
11548,UBD03F6,27,3193.5500000000025,16,11,11841.43,15034.98
11549,UB8FB44,27,-5554.650000000001,26,1,6960.650000000001,1406.0
11550,UA21D9E,26,-107.09999999999991,22,4,2657.0,2549.9
11551,U1A0D3A,26,828.1200000000017,22,4,11940.759999999998,12768.880000000001
11552,UF80938,26,3529.46,19,7,46537.3,50066.759999999995
11553,U80CC11,26,41004.52000000001,17,9,110124.19,151128.71
11554,U46C655,26,16139.900000000001,16,10,6296.1,22436.0
11555,U984E99,26,-9667.689999999999,25,1,17582.69,7915.0
11556,U62A461,26,20858.3,18,8,67316.69999999998,88175.0
11557,UF3A303,26,-21.649999999999984,18,8,703.8000000000001,682.15
11558,UE1404C,26,3010.039999999999,16,10,37440.45,40450.49
11559,U25F5A0,26,17424.92,22,4,73575.08,91000.0
11560,U6BFD77,26,-3281.79,20,6,10986.839999999998,7705.05
11561,UB79661,26,-847.0499999999997,19,7,5317.42,4470.37
11562,U796A25,26,-2649.18,24,2,6903.86,4254.68
11563,U233BCF,26,43.11999999999966,23,3,9811.989999999998,9855.11
11564,UBFFC8B,26,-4632.080000000001,20,6,6771.720000000001,2139.64
11565,U0F4451,26,-5878.27,19,7,22278.28,16400.010000000002
11566,UAD2E45,26,-4272.469999999999,23,3,10100.199999999999,5827.73
11567,U954D93,26,-12.369999999998981,14,12,43712.619999999995,43700.25
11568,UC0C3E7,26,6892.120000000001,22,4,5262.6,12154.72
11569,UC52D1B,26,-31688.320000000003,26,0,31688.320000000003,0.0
11570,U0B3F52,26,-421.22000000000037,24,2,5684.660000000001,5263.4400000000005
11571,U945578,26,186.19000000000005,23,3,2813.81,3000.0
11572,U24B870,26,2889.9799999999996,22,4,16030.029999999999,18920.010000000002
11573,UE74F2A,26,-16616.27,19,7,24749.09,8132.82
11574,U05351E,26,12313.559999999998,20,6,211794.32,224107.88
11575,U4F2A77,26,-44.65999999999997,24,2,4052.66,4008.0
11576,U294333,26,-5588.92,17,9,54102.93,48514.009999999995
11577,U1310F8,26,-3667.2300000000073,24,2,24789.920000000006,21122.69
11578,U4834E1,26,544.8999999999999,20,6,5465.1,6010.0
11579,U8D576C,26,1055.0500000000002,19,7,8262.21,9317.259999999998
11580,U46982B,26,-92.0,14,12,61918.0,61826.0
11581,UED338B,26,1113.4999999999995,23,3,13670.5,14784.0
11582,U81E643,26,-4572.689999999998,12,14,82987.0,78414.31
11583,UAB1CF5,26,-583.6999999999999,22,4,2568.3700000000003,1984.67
11584,UCB8A87,26,-2128.2300000000005,22,4,4473.2300000000005,2345.0
11585,U642BD4,26,6839.09,21,5,11422.130000000001,18261.22
11586,U7DFFD1,26,286.04,9,17,2652.2999999999997,2938.34
11587,U4B1E6B,26,-14926.11,19,7,20758.260000000002,5832.15
11588,U310CB8,26,-700.2699999999995,15,11,26894.889999999996,26194.62
11589,U5284BC,26,5996.350000000002,18,8,56754.17,62750.52
11590,U24AA32,26,-880.7199999999997,20,6,2624.85,1744.13
11591,UE2FD37,26,-7363.68,26,0,7363.68,0.0
11592,U276C1C,26,6086.21,12,14,14603.02,20689.23
11593,U578923,26,-112.25,24,2,58720.0,58607.75
11594,U464FFF,26,-486.44,23,3,1453.23,966.79
11595,U95BC30,26,-100.15000000000009,23,3,1014.5999999999999,914.45
11596,U8DE6D8,26,-7123.080000000002,14,12,47083.14,39960.06
11597,U13FF96,26,-3403.1599999999994,20,6,21017.979999999996,17614.82
11598,U285BFC,26,1494.1100000000008,24,2,7888.889999999999,9383.0
11599,U72D604,26,555.15,22,4,473.66,1028.81
11600,U912734,26,-175.5,24,2,3375.5,3200.0
11601,UB41A54,26,-368.24,24,2,12398.239999999998,12030.0
11602,U05FAF1,26,-87.75999999999999,17,9,1825.32,1737.56
11603,U7FCEFA,26,7986.34,20,6,29267.0,37253.34
11604,UFA3124,26,-2583.2700000000004,17,9,13364.79,10781.52
11605,U963347,26,303.4,17,9,1525.23,1828.63
11606,UB03128,26,-524.8,23,3,952.8100000000001,428.01
11607,U303C6E,26,-553.46,24,2,5004.46,4451.0
11608,U7B33CB,26,161.76999999999992,24,2,2605.94,2767.71
11609,U0E0572,26,201.34000000000012,20,6,1616.62,1817.96
11610,U2153C1,26,10415.959999999997,22,4,6226.57,16642.530000000002
11611,U444879,26,-13.820000000000164,15,11,9313.82,9300.0
11612,U1F49CE,26,21765.749999999996,15,11,40033.57000000001,61799.31999999999
11613,UA64B4F,26,-159.1800000000003,22,4,5332.31,5173.13
11614,U9B3567,26,492.44000000000034,21,5,9162.8,9655.24
11615,U117A6C,26,-6660.34,18,8,46194.340000000004,39534.0
11616,UE9F121,26,-314.8000000000002,22,4,10229.12,9914.32
11617,UDF9952,26,-13760.6,22,4,49410.740000000005,35650.14
11618,U256C43,26,-19533.570000000007,15,11,224528.57,204995.0
11619,U9F0053,26,-1572.13,22,4,6797.3099999999995,5225.18
11620,U7F38DE,26,-8107.469999999998,12,14,29649.339999999997,21541.87
11621,UB1FB6F,26,3.0,14,12,99997.0,100000.0
11622,UF3ACBA,26,2785.279999999995,16,10,119624.09,122409.37
11623,U03395A,26,-7668.94,24,2,12175.89,4506.95
11624,U8CD7AE,26,2.349999999998545,14,12,105095.01000000001,105097.36
11625,U8EE467,26,-1277.4899999999998,18,8,9158.0,7880.51
11626,U96EA18,26,919.5800000000002,23,3,6400.42,7320.0
11627,U5E580C,26,34983.59,15,11,62389.6,97373.19
11628,UF1EE1C,26,4776.49,20,6,3523.51,8300.0
11629,U952CF1,26,2639.159999999999,19,7,25994.82,28633.98
11630,U2BB8A0,26,-497.85000000002213,17,9,244523.49000000002,244025.63999999998
11631,U7197B9,26,-879.7199999999999,22,4,5135.42,4255.700000000001
11632,U03BC22,26,-362.0400000000001,24,2,2476.54,2114.5
11633,U26D585,26,-8252.41,26,0,8252.41,0.0
11634,U581B8C,26,91.0,12,14,23792.0,23883.0
11635,U30AE6A,26,1.3700000000001182,18,8,3225.34,3226.71
11636,U331F02,26,368.49999999999966,24,2,1948.4099999999999,2316.91
11637,U9FE634,26,46.47000000000254,18,8,13710.6,13757.07
11638,U6B2DED,26,27585.28,8,18,57431.310000000005,85016.58999999998
11639,U633519,26,34938.52,16,10,16957.07,51895.59
11640,U3AD0C9,26,15021.51,15,11,8281.9,23303.41
11641,UE6BE08,26,-562.8700000000002,19,7,6954.479999999999,6391.61
11642,UA3C40C,26,-10.4600000000001,24,2,1410.48,1400.02
11643,UA64E22,26,1565.51,19,7,2000.8899999999999,3566.4
11644,U310E89,26,3501.170000000001,22,4,11950.829999999998,15452.0
11645,U556B7C,26,362.9500000000026,7,19,31600.420000000002,31963.370000000003
11646,U43F97E,26,-539.5300000000004,24,2,5539.530000000001,5000.0
11647,UA3A707,26,0.3400000000001455,21,5,11699.75,11700.09
11648,UD47729,26,30.680000000000007,22,4,878.9,909.5799999999999
11649,U11B77A,26,-3385.27,25,1,3397.27,12.0
11650,U1B5B34,26,-3715.0499999999993,22,4,6751.34,3036.29
11651,U2AE6A4,26,93993.83,6,20,15569.75,109563.58
11652,UBE746D,26,-1342.8800000000047,16,10,48602.880000000005,47260.0
11653,U27CD77,26,10892.499999999978,13,13,118141.43999999999,129033.93999999999
11654,U1D8474,26,3591.039999999999,23,3,7227.0,10818.04
11655,UE1E50A,26,-768.0000000000005,17,9,64110.08,63342.08
11656,U5F6945,26,-408.55,25,1,958.55,550.0
11657,UA57E8A,26,-716.8499999999996,20,6,5851.600000000001,5134.75
11658,U0D5129,26,208.8599999999999,20,6,3897.99,4106.85
11659,U84F836,26,-16487.42,23,3,52634.42,36147.0
11660,U2A5427,26,173.3800000000008,23,3,5821.83,5995.21
11661,UE5CE92,26,3587.6499999999996,14,12,14515.619999999999,18103.27
11662,U52052F,26,2111.6899999999987,22,4,23146.31,25258.0
11663,UFE6C8F,26,139.88,19,7,1838.82,1978.7
11664,UB151E1,26,-2327.0800000000004,23,3,4277.2,1950.12
11665,U0D23D8,26,-524.6099999999999,15,11,2882.5699999999997,2357.96
11666,U2ECF6C,26,-31.79999999999999,19,7,4960.02,4928.22
11667,U4C740C,26,-2081.790000000001,22,4,29574.0,27492.21
11668,U1128F5,26,-3079.110000000005,24,2,31051.269999999997,27972.16
11669,U173E0F,26,3607.5699999999997,20,6,27322.210000000003,30929.78
11670,UE337BF,26,-0.03000000000102055,16,10,5282.05,5282.0199999999995
11671,UA77819,26,-8529.400000000001,23,3,14295.399999999998,5766.0
11672,U20EB51,26,13138.710000000001,20,6,1550.97,14689.680000000002
11673,U1FCB53,26,-132.41,23,3,1273.9499999999998,1141.54
11674,U1764E5,26,-706.48,20,6,3599.98,2893.5
11675,UCF8A5F,26,60.26999999999998,18,8,563.65,623.92
11676,UFF4480,26,-17937.26,25,1,31237.260000000006,13300.0
11677,U283D86,26,-20857.89,20,6,34993.579999999994,14135.69
11678,U4A3141,26,-5271.93,18,8,61134.0,55862.07
11679,U4B4CC0,26,-6276.710000000002,26,0,6276.710000000002,0.0
11680,U15C6BD,26,-9992.409999999998,18,8,19994.719999999998,10002.31
11681,UEFEC48,26,-1009.9299999999998,24,2,6509.929999999999,5500.0
11682,UBB2B65,26,-0.9699999999999704,19,7,777.03,776.0600000000001
11683,U6E23E7,26,45599.130000000005,20,6,44493.32,90092.45
11684,UFFC459,26,6170.880000000002,19,7,47656.22,53827.100000000006
11685,U76E3FA,26,4129.0,14,12,17104.94,21233.940000000002
11686,U59502E,26,0.06999999999970896,16,10,67518.73999999999,67518.81000000001
11687,UB4EC00,26,727.7999999999993,19,7,30323.989999999998,31051.79
11688,UEFB57B,26,-337.28000000000065,14,12,29092.0,28754.72
11689,U0F960D,26,-3.4300000000000637,14,12,3972.4700000000003,3969.04
11690,U93E64F,26,-1873.5099999999986,21,5,8893.51,7020.0
11691,UE1653D,26,1318.9499999999998,24,2,791.05,2110.0
11692,UBAE05E,26,79.63999999999987,14,12,12951.390000000003,13031.03
11693,UB0CD9B,26,8876.210000000003,17,9,62990.08,71866.29000000001
11694,UD60DB1,26,-199.33000000000047,18,8,16521.13,16321.8
11695,U72719C,26,-7197.200000000041,12,14,763088.2,755891.0
11696,UD856ED,26,737.7000000000003,22,4,12356.300000000001,13094.0
11697,U3CF119,26,-4282.160000000001,16,10,14765.35,10483.189999999999
11698,UAA48D3,26,-92.70999999999948,22,4,26878.209999999995,26785.5
11699,UF84D7E,26,-5067.78,25,1,5072.92,5.14
11700,UF6C0FF,26,-11211.87,19,7,21651.78,10439.91
11701,U31F5E6,26,35608.5,21,5,79756.66,115365.16
11702,U57A823,26,-39512.5,22,4,269836.79999999993,230324.3
11703,U439B81,26,-372.44000000000005,25,1,672.9,300.46
11704,U1E548C,26,59.14999999999975,16,10,3189.1800000000003,3248.33
11705,UD040E7,26,-15804.469999999998,19,7,23684.55,7880.08
11706,U349F78,26,155.07999999999947,21,5,8144.92,8300.0
11707,UA64E3F,26,-5714.0,22,4,29562.8,23848.8
11708,U268C0F,26,-6446.600000000006,14,12,151115.66,144669.06
11709,U0F773A,26,792.6700000000008,22,4,15794.01,16586.68
11710,UB89C03,26,-2574.300000000003,23,3,53877.3,51303.0
11711,U482F5D,26,-118.71000000000006,18,8,5075.61,4956.900000000001
11712,U3373C1,26,-997.1999999999998,22,4,2423.92,1426.72
11713,UBB6FF9,26,-9073.160000000002,22,4,40782.659999999996,31709.5
11714,U7C3C77,26,-4469.670000000001,19,7,20701.03,16231.36
11715,UCD389B,26,43391.45,14,12,7607.59,50999.04
11716,U208E44,26,-2784.8599999999988,18,8,43284.86,40500.0
11717,U452A2B,26,-428.0500000000002,22,4,16650.9,16222.849999999999
11718,UAB106B,26,-761.23,26,0,761.23,0.0
11719,UA46BB3,26,9797.050000000001,11,15,13440.3,23237.35
11720,U49E491,26,507.73,18,8,14563.82,15071.550000000003
11721,UECFA46,26,2434.8599999999997,14,12,22966.18,25401.040000000005
11722,UCF5083,26,-3399.0600000000013,16,10,71657.72,68258.66
11723,U2DF87D,26,-23.1,19,7,23523.1,23500.0
11724,U0AFEE3,26,8322.329999999998,17,9,19820.77,28143.1
11725,U07093D,26,77.48000000000872,20,6,67665.94,67743.42
11726,UDD16B1,26,-4690.99,26,0,4690.99,0.0
11727,U3BA57F,26,-1227.1799999999996,22,4,9564.81,8337.630000000001
11728,U3823B5,26,372.7999999999999,16,10,19600.76,19973.559999999998
11729,U34B17F,26,-1.1368683772161603e-11,12,14,176522.71,176522.71000000002
11730,U5BF21F,26,-5635.57,16,10,22852.62,17217.05
11731,U8D9B32,26,1185.8,24,2,2157.94,3343.74
11732,U9D25DB,26,-9014.0,18,8,76148.78,67134.78
11733,UE9919A,26,3468.17,19,7,33036.83,36505.0
11734,UD7F6F8,26,-1032.0800000000002,22,4,6607.24,5575.16
11735,UC36AEB,26,6120.400000000001,21,5,4912.04,11032.44
11736,UD61A00,26,5796.749999999998,19,7,10664.12,16460.87
11737,U58493F,26,-6331.51,24,2,22664.0,16332.49
11738,U3DDD83,26,344.4300000000003,15,11,6430.490000000001,6774.92
11739,U3FA757,26,-4446.87,23,3,6998.17,2551.3
11740,U3B1E61,26,-527.6000000000008,20,6,10760.7,10233.1
11741,UA46F1E,26,2214.59,22,4,1133.96,3348.55
11742,U58E277,26,1241.5099999999995,21,5,5858.870000000001,7100.38
11743,UD6FF8D,26,-8154.839999999999,23,3,8572.279999999999,417.44
11744,U9AF4B0,26,-1840.23,22,4,3678.7900000000004,1838.56
11745,U3174F4,26,-10.0,14,12,44010.0,44000.0
11746,U27D0EF,26,528.7000000000002,24,2,809.9300000000001,1338.63
11747,UB6C243,26,-2984.0,22,4,17506.440000000002,14522.439999999999
11748,UD604D4,26,-1072.04,21,5,1992.03,919.99
11749,U39C0F7,26,12.520000000004075,18,8,70813.5,70826.02
11750,UF0ACBF,26,-1053.4099999999999,24,2,2399.63,1346.22
11751,UD2D49B,26,-489.00000000000017,24,2,4014.14,3525.1400000000003
11752,UAF46CD,26,4037.4799999999996,17,9,6394.11,10431.59
11753,U1A5819,26,8840.7,16,10,25754.13,34594.83
11754,U92047D,26,768.3799999999998,21,5,1917.28,2685.66
11755,U48F34D,26,-5.684341886080802e-14,24,2,308.99,308.99
11756,U5B43F5,26,1837.6999999999998,22,4,6691.36,8529.06
11757,UD84553,26,1544.4099999999994,14,12,40385.40000000001,41929.810000000005
11758,UF3F4C7,26,-9732.01,23,3,34217.590000000004,24485.579999999998
11759,UF74288,26,6713.0,15,11,93787.0,100500.0
11760,UF09A88,26,-348.78000000000014,24,2,4170.110000000001,3821.33
11761,UF37580,26,1423.0400000000006,17,9,2576.25,3999.29
11762,UD1974B,26,-1889.4199999999994,23,3,7264.92,5375.5
11763,U018F52,26,-691.2999999999961,18,8,52533.060000000005,51841.76
11764,U86ACC5,26,623.0000000000007,14,12,9666.65,10289.650000000001
11765,U2BD226,26,3360.219999999999,19,7,7467.799999999999,10828.019999999999
11766,U120F63,26,-1149.1900000000007,22,4,12972.970000000001,11823.779999999999
11767,U938577,26,1356.1400000000003,17,9,5898.86,7255.0
11768,UD86FD1,26,10.099999999999973,20,6,286.84999999999997,296.95
11769,UE08588,26,102.98999999999992,16,10,1943.09,2046.08
11770,U4D8206,26,-136.16000000000042,24,2,9815.6,9679.439999999999
11771,UFFC37B,26,-138987.13999999998,17,9,295360.4,156373.26
11772,UC4C075,26,15152.330000000002,19,7,23348.19,38500.520000000004
11773,U2942FA,26,-5307.180000000001,22,4,13176.660000000002,7869.48
11774,UE5B1D5,26,19.699999999998766,22,4,21595.079999999998,21614.78
11775,U429271,26,5831.079999999998,17,9,65262.16,71093.24
11776,U303440,26,1036.5,22,4,17165.5,18202.0
11777,UDDC761,26,-456.61999999999995,24,2,3156.62,2700.0
11778,UAE52CD,26,-414.8799999999999,23,3,3760.8900000000003,3346.01
11779,U828A04,26,-27.59999999999991,20,6,503.80999999999995,476.21000000000004
11780,UECC566,26,2890.08,19,7,31485.409999999996,34375.49
11781,UA1E834,26,784.2400000000002,17,9,4519.57,5303.81
11782,UC780C1,26,8879.029999999999,21,5,9367.650000000001,18246.68
11783,U2857EE,26,2527.65,23,3,1837.6999999999998,4365.35
11784,UEF67D6,26,462.4299999999999,23,3,3325.4399999999996,3787.87
11785,U33C4B3,26,-2995.21,26,0,2995.21,0.0
11786,UEF1550,26,17026.450000000004,11,15,45834.450000000004,62860.9
11787,UC58507,26,127371.01000000001,20,6,20954.859999999997,148325.87
11788,U85ED81,26,-38.440000000000225,22,4,962.8000000000002,924.3599999999999
11789,UA2DAE3,26,15769.079999999996,20,6,22241.24,38010.32000000001
11790,U4BE9A7,26,2554.9400000000023,20,6,21748.089999999997,24303.03
11791,U21FC9A,26,-1932.9599999999998,19,7,12109.36,10176.4
11792,U42B2F5,26,-6.900000000001455,14,12,77290.0,77283.1
11793,UF90608,26,-64.14999999999992,18,8,7613.949999999999,7549.799999999999
11794,UA98CD9,26,19.84000000000002,23,3,1981.52,2001.3600000000001
11795,U5B7DA8,26,700.36,23,3,1232.78,1933.1399999999999
11796,U321518,26,-918.46,21,5,6724.42,5805.96
11797,UF024BF,26,-1635.81,25,1,1637.3,1.49
11798,UF770F6,26,108.89000000000033,15,11,11881.48,11990.369999999999
11799,U173871,26,94.45000000000039,19,7,1649.05,1743.5
11800,U3C4282,26,53950.189999999995,17,9,11138.81,65089.0
11801,U53D6D6,26,-576.8,24,2,4129.610000000001,3552.81
11802,U4F0C31,26,6922.24,20,6,33362.7,40284.94
11803,U6022DB,26,-35489.95,22,4,37195.17,1705.22
11804,U40EBD1,26,14733.54,19,7,92857.84999999999,107591.39
11805,UB9BC04,26,-2294.59,22,4,6266.42,3971.83
11806,UB2460E,26,261.92999999999995,19,7,1479.19,1741.12
11807,UE04978,26,1761.31,20,6,2824.19,4585.5
11808,UD4735C,26,-1859.3000000000006,20,6,6045.249999999999,4185.95
11809,UE028AA,26,-15594.93,16,10,36595.1,21000.170000000002
11810,U968302,26,17621.4,21,5,9617.87,27239.269999999997
11811,UC344C7,26,1991.8900000000008,21,5,9798.98,11790.869999999999
11812,U825636,26,-540.3400000000006,22,4,4827.400000000001,4287.06
11813,UD79C09,26,696.3299999999998,23,3,2483.6800000000003,3180.01
11814,U2C38A6,26,1120.6399999999999,23,3,473.52,1594.16
11815,U7DAC97,26,-50456.2,16,10,311172.52999999997,260716.33
11816,U68064D,26,4215.36,19,7,788.6600000000001,5004.02
11817,U1E43E3,25,323.75999999999976,12,13,14563.5,14887.26
11818,U9D443A,25,-2316.31,20,5,6372.3099999999995,4056.0
11819,U2EBEF6,25,-21484.74,19,6,24285.980000000003,2801.24
11820,U3508F2,25,48828.59,9,16,4981.740000000001,53810.33
11821,U090C9A,25,-6808.610000000001,19,6,27368.61,20560.0
11822,UF570D3,25,-595.87,20,5,2639.82,2043.95
11823,U3AC36C,25,1483.0499999999993,21,4,17168.98,18652.03
11824,U298570,25,785.24,16,9,4514.87,5300.11
11825,U940EDB,25,-453.7899999999989,18,7,10472.339999999998,10018.55
11826,U7D5F57,25,-1939.820000000001,19,6,13828.970000000001,11889.15
11827,U5D45B7,25,1345.5299999999997,12,13,3329.8199999999997,4675.35
11828,U41298F,25,5247.630000000005,22,3,34581.74,39829.37
11829,U34FDE0,25,-2396.720000000001,21,4,8390.04,5993.32
11830,U0A489B,25,1606.2999999999984,21,4,17567.33,19173.629999999997
11831,UB20020,25,81474.67000000001,13,12,29387.05,110861.72
11832,U1ABC8B,25,-6476.739999999998,14,11,49201.740000000005,42725.0
11833,UB9474D,25,-7616.28,16,9,16956.760000000002,9340.48
11834,UB9543B,25,-800.6100000000001,21,4,10432.86,9632.25
11835,UFC5C43,25,13162.82,15,10,65830.0,78992.82
11836,U97F9D9,25,-15536.149999999998,16,9,87949.18,72413.03
11837,U30756B,25,2759.8,22,3,1314.1,4073.9
11838,U49BD95,25,-187.10000000000002,20,5,1392.2,1205.1
11839,U48AD7F,25,-2011.14,22,3,6646.860000000001,4635.72
11840,U663644,25,-7056.3099999999995,21,4,12627.439999999999,5571.13
11841,U420733,25,-27.150000000000006,16,9,1531.7499999999998,1504.6000000000001
11842,U79BAED,25,-87728.44,20,5,101528.48000000001,13800.039999999999
11843,U1A1866,25,-10247.809999999998,17,8,41845.52,31597.710000000003
11844,UF0A247,25,4783.7699999999995,17,8,929.9299999999998,5713.699999999999
11845,UEE65E3,25,992.2499999999995,16,9,16584.479999999996,17576.729999999996
11846,U3FE1AF,25,-6136.98,19,6,27243.0,21106.02
11847,U290A3D,25,-966.0400000000005,24,1,5576.04,4610.0
11848,U09C21F,25,915.8800000000002,21,4,3919.9500000000003,4835.83
11849,U715574,25,-773.4300000000001,23,2,5126.75,4353.32
11850,UB32A86,25,-6837.1,23,2,7037.1,200.0
11851,U158A02,25,3588.01,12,13,13792.080000000002,17380.09
11852,U30A0B0,25,-16646.75,20,5,35121.93,18475.180000000004
11853,UF4BF70,25,-3799.3300000000004,18,7,11981.41,8182.080000000001
11854,UBD47C1,25,-2836.0200000000004,20,5,18073.02,15237.0
11855,U614F73,25,3042.9999999999995,21,4,796.78,3839.7799999999997
11856,UC23C58,25,3220.199999999999,16,9,10101.07,13321.27
11857,UA6EF66,25,-853.8800000000002,23,2,6878.15,6024.2699999999995
11858,U96AEAA,25,-28.669999999999906,22,3,1104.7599999999998,1076.0900000000001
11859,UAA19ED,25,-4027.119999999999,23,2,32704.26,28677.14
11860,UFFB97D,25,-2.4868995751603507e-14,22,3,321.0999999999999,321.1
11861,UCE877D,25,-438.8000000000029,19,6,52972.36,52533.56
11862,U9C2365,25,2524.59,23,2,7712.4,10236.99
11863,U0EB375,25,-393.0000000000018,15,10,15246.12,14853.119999999999
11864,U731103,25,-7395.389999999998,20,5,18595.399999999998,11200.01
11865,U69DEDE,25,5986.36,21,4,10777.64,16764.0
11866,U5C5132,25,-95.06999999999992,20,5,698.07,603.0
11867,UE1944E,25,482.7600000000016,16,9,51911.37000000001,52394.130000000005
11868,U58E117,25,-1011.3800000000002,23,2,6091.860000000001,5080.48
11869,U4C2EED,25,0.0,18,7,20000.0,20000.0
11870,UE40845,25,-1679.0700000000002,22,3,7273.779999999999,5594.71
11871,UB71774,25,-1158.2600000000004,18,7,14908.26,13750.0
11872,UE04F42,25,497.99999999999943,17,8,7300.0700000000015,7798.070000000001
11873,UA4E0F6,25,-2564.340000000001,20,5,56450.340000000004,53886.0
11874,U5129EC,25,302.5,17,8,1520.99,1823.49
11875,U835EB6,25,10552.790000000008,19,6,47902.509999999995,58455.3
11876,UC43AEE,25,-214.90000000000236,16,9,86867.7,86652.8
11877,UC76F02,25,-7.800000000000637,15,10,6743.51,6735.71
11878,UD24C74,25,-3618.0,13,12,53618.0,50000.0
11879,UA13E64,25,-415.4299999999996,20,5,7599.8200000000015,7184.39
11880,U674B68,25,-2071.9199999999996,20,5,13432.56,11360.640000000001
11881,U9C124E,25,-11585.96,20,5,21305.27,9719.310000000001
11882,U198A6A,25,-420.8,23,2,2093.8,1673.0
11883,U5E7356,25,-206.0,17,8,68207.18,68001.18
11884,UFD2EF5,25,10115.400000000003,20,5,15566.380000000003,25681.78
11885,U228F1D,25,2257.2599999999998,18,7,9628.21,11885.47
11886,UC2000A,25,-107149.0,21,4,117200.79000000001,10051.79
11887,U3EF339,25,-1502.94,22,3,13978.230000000005,12475.29
11888,UAFD633,25,-604613.38,11,14,720775.5,116162.12
11889,U31B24B,25,1166.1200000000001,22,3,2243.88,3410.0
11890,UF923EA,25,-35.0,17,8,19996.0,19961.0
11891,UB1D727,25,-1636.6799999999998,22,3,3907.1300000000006,2270.45
11892,U4F507E,25,-10801.710000000003,20,5,42043.939999999995,31242.229999999996
11893,U09047E,25,1986.1399999999999,17,8,7106.070000000001,9092.21
11894,U079FF4,25,-7635.060000000001,20,5,27591.260000000002,19956.2
11895,U04F1B8,25,-239.30999999999995,21,4,1137.3999999999999,898.09
11896,U8941DA,25,-2967.4000000000015,7,18,160132.0,157164.6
11897,UDCB891,25,57.80000000000001,14,11,2252.9,2310.7
11898,U23AE90,25,-10805.980000000001,20,5,14852.570000000002,4046.59
11899,U7F2FF5,25,1205.5,16,9,4843.99,6049.49
11900,UECE8D5,25,3913.76,15,10,6558.44,10472.2
11901,U7F2145,25,1412.7600000000002,17,8,8877.300000000001,10290.06
11902,UADD419,25,62.06,22,3,1393.94,1456.0
11903,U3E1756,25,1208.04,18,7,7746.31,8954.349999999999
11904,UB2C31D,25,210.06999999999994,20,5,3319.4500000000003,3529.52
11905,U839E0D,25,-7031.270000000006,19,6,66413.15000000001,59381.880000000005
11906,U4114AB,25,18188.09,15,10,31860.46,50048.55
11907,U13D780,25,2295.68,23,2,1097.32,3393.0
11908,U96F797,25,8928.470000000001,18,7,11954.480000000001,20882.950000000004
11909,UA0597B,25,-30209.060000000005,21,4,83034.06,52825.0
11910,UBBE701,25,-9285.77,17,8,13446.01,4160.24
11911,UFB7F00,25,-3045.15,21,4,5323.04,2277.8900000000003
11912,U506412,25,723.2,21,4,2599.1499999999996,3322.35
11913,UC28152,25,216.99000000000092,15,10,37623.64,37840.63
11914,UED1720,25,10421.7,15,10,10929.8,21351.5
11915,U12B065,25,-319.53999999999985,20,5,4161.089999999999,3841.55
11916,U5CF584,25,-20324.479999999996,19,6,33763.06,13438.58
11917,U54F968,25,45994.59,12,13,74902.0,120896.59
11918,U7DAD7D,25,-31397.25,18,7,64015.14,32617.89
11919,U3A88A8,25,-6211.54,24,1,8282.220000000001,2070.68
11920,U3D164E,25,-390.96000000000004,19,6,1488.97,1098.01
11921,U6C9214,25,-365.57000000000005,23,2,2976.44,2610.87
11922,U9BE613,25,2.75,12,13,60010.66,60013.41
11923,U25AC0B,25,-43660.920000000006,20,5,70743.3,27082.379999999997
11924,UB6D5EC,25,2232.05,19,6,2166.71,4398.760000000001
11925,U84314B,25,447.3000000000002,22,3,5319.6,5766.9
11926,UF3455B,25,-4965.74,18,7,43712.5,38746.76
11927,U542003,25,290.2,22,3,373.8,664.0
11928,U040DF4,25,-1192.6900000000007,19,6,10464.410000000003,9271.72
11929,U1A3E06,25,63430.6,13,12,93408.4,156839.0
11930,U860C90,25,-3000.000000000001,17,8,8253.04,5253.04
11931,UC1F25E,25,-307.64999999999964,21,4,8604.779999999999,8297.130000000001
11932,UEC350C,25,9184.66,19,6,25777.340000000004,34962.0
11933,U9AA821,25,-311.1400000000003,23,2,8211.14,7900.0
11934,UDA2BAB,25,-84.02000000000044,6,19,22595.0,22510.98
11935,U631049,25,3068.8999999999996,21,4,3761.1000000000004,6830.0
11936,UDEA8A7,25,-11457.080000000002,20,5,85375.69,73918.61
11937,U4F5717,25,4238.2699999999995,17,8,3868.5000000000005,8106.77
11938,U9B9ABF,25,3651.6,16,9,24176.280000000002,27827.88
11939,U6C1831,25,-6540.279999999999,18,7,56571.08,50030.8
11940,U6A6B32,25,-15954.379999999997,18,7,122156.2,106201.82
11941,UF10D1C,25,22693.8,18,7,23092.21,45786.01
11942,UEFF8D2,25,-3.0,13,12,10003.0,10000.0
11943,UBDD56E,25,1165.8399999999997,16,9,2332.8599999999997,3498.6999999999994
11944,UA02803,25,-431.02,21,4,733.82,302.79999999999995
11945,U9A1374,25,2864.47,20,5,3942.6000000000004,6807.07
11946,UD6E60E,25,-5962.130000000001,22,3,14865.74,8903.61
11947,UCF8494,25,-58688.369999999995,17,8,123895.7,65207.33
11948,U12A978,25,9904.090000000004,20,5,29506.3,39410.39000000001
11949,U4C698D,25,-497.71000000000004,14,11,22052.0,21554.29
11950,U94C415,25,-3606.49,16,9,23200.820000000003,19594.33
11951,U5C430F,25,-1294.78,20,5,7196.969999999998,5902.1900000000005
11952,UA8FD81,25,-5239.710000000003,22,3,60971.829999999994,55732.119999999995
11953,UD9F662,25,-244.58000000000175,16,9,184621.07,184376.48999999996
11954,UDA61F6,25,-825.79,18,7,5163.6900000000005,4337.9
11955,U36F2BE,25,-14.0,18,7,21691.9,21677.9
11956,U0DC19C,25,-3195.6600000000008,21,4,14195.66,11000.0
11957,UF820D6,25,564.4399999999999,22,3,813.5600000000001,1378.0
11958,UBD74FD,25,-822.7799999999996,22,3,11322.779999999997,10500.0
11959,U54FBA3,25,-40.950000000000244,20,5,4783.46,4742.51
11960,UCAFF29,25,27745.51,12,13,4067.1100000000006,31812.62
11961,U372FD0,25,-576.7700000000001,21,4,1795.96,1219.19
11962,U6C31B8,25,-40.719999999999686,23,2,7623.57,7582.85
11963,U2D9937,25,-228.20000000000005,22,3,3874.76,3646.56
11964,U671C92,25,468538.7899999999,20,5,214651.45999999996,683190.25
11965,UD56600,25,161.0,13,12,15800.0,15961.0
11966,U44E2A4,25,-32058.39,22,3,35582.03,3523.64
11967,UD1DAB4,25,-13821.12,17,8,51350.43,37529.31
11968,U19752F,25,-96677.9,23,2,108753.28,12075.380000000001
11969,UC898D0,25,-3455.9,19,6,12139.139999999998,8683.24
11970,U087F91,25,5677.0999999999985,17,8,101802.72,107479.82
11971,U677ACE,25,-188.0999999999998,20,5,1404.8,1216.7
11972,UDDBC95,25,141.03999999999905,18,7,20034.0,20175.04
11973,UDDB2E6,25,6832.280000000001,17,8,3066.12,9898.4
11974,UF6F5B9,25,-2225.6000000000004,24,1,6146.799999999999,3921.2
11975,U270596,25,220.0199999999998,22,3,3839.2799999999997,4059.3
11976,UECF17B,25,269.00000000000057,23,2,2061.06,2330.0600000000004
11977,U447142,25,23426.89,17,8,10984.050000000001,34410.94
11978,U87A030,25,197.62000000000262,13,12,149804.36,150001.97999999998
11979,UDA295F,25,-8310.6,23,2,15380.18,7069.58
11980,UAF97F3,25,-5150.5,23,2,6650.6,1500.1
11981,UC50F40,25,-224.87000000000003,23,2,1504.24,1279.37
11982,U39395A,25,141.16999999999945,15,10,38058.9,38200.07
11983,UF055CF,25,23734.59,17,8,8896.83,32631.42
11984,UF4B882,25,10284.439999999999,13,12,36439.56,46724.0
11985,UED42E4,25,-16482.5,19,6,47058.53,30576.03
11986,U3FFF1D,25,-26.9399999999996,20,5,4144.45,4117.51
11987,UC572BC,25,870.24,21,4,4426.74,5296.9800000000005
11988,U0F5DD0,25,-7772.579999999998,13,12,70631.44,62858.86000000001
11989,UCFE542,25,3794.4599999999978,20,5,22906.46,26700.92
11990,U1955DE,25,-16.289999999999708,19,6,6712.8,6696.509999999999
11991,UFB9609,25,-1542.3300000000017,20,5,22680.410000000003,21138.08
11992,U01A9D1,25,-3913.4300000000007,20,5,31698.49,27785.059999999998
11993,U71A4B0,25,746.3199999999988,17,8,17530.22,18276.54
11994,U50C614,25,1007.7899999999996,20,5,8192.23,9200.02
11995,UDB3BC8,25,-447.1800000000011,18,7,19494.949999999997,19047.77
11996,UD9A8B6,25,-152.2699999999981,12,13,88295.93,88143.65999999999
11997,UC6A31B,25,-251.32999999999987,18,7,3791.33,3540.0
11998,UEE55E7,25,51.80999999999987,23,2,2147.36,2199.17
11999,U2FAF83,25,1612.19,17,8,7620.14,9232.33
12000,U856B91,25,-14166.63,20,5,16694.63,2528.0
12001,UA57E57,25,-3.039999999999054,17,8,13803.22,13800.18
12002,U3313CB,25,9692.060000000056,9,16,374755.67,384447.73000000004
12003,UAD5CE0,25,-12942.4,23,2,13462.24,519.84
12004,U36BA6C,25,16.309999999999718,19,6,9743.98,9760.289999999999
12005,UAB42CB,25,-18906.26,16,9,48715.6,29809.340000000004
12006,U91704C,25,-1284.1899999999998,22,3,1468.1799999999998,183.99
12007,UC78E33,25,1700.0,15,10,30000.0,31700.0
12008,U873A9D,25,-27304.510000000002,14,11,112465.4,85160.89
12009,U019433,25,-5.869999999999891,18,7,8545.67,8539.8
12010,U05FCE0,25,-5526.280000000001,21,4,33418.04,27891.76
12011,UF6EE5E,25,11559.08,17,8,27062.600000000002,38621.68
12012,UC20017,25,-619.6,24,1,1619.6,1000.0
12013,U8909E4,25,456.14000000000084,21,4,10550.299999999997,11006.44
12014,UA598C7,25,-3745.9,23,2,19745.9,16000.0
12015,U2D9FC6,25,-1363.9699999999975,14,11,183601.44,182237.47
12016,UDD5648,25,-602.7200000000001,14,11,4471.31,3868.59
12017,U584B69,25,137526.70000000004,16,9,13059.3,150586.0
12018,U02D114,25,2393.2799999999997,23,2,2570.7200000000003,4964.0
12019,U44310C,25,-143.76,19,6,1364.1799999999998,1220.42
12020,U66695E,25,2251.1100000000006,21,4,7078.889999999999,9330.0
12021,U66FFE4,25,-9307.87,23,2,19546.0,10238.130000000001
12022,U8A411B,25,-7912.469999999999,17,8,35157.16,27244.690000000002
12023,U2C67F8,25,-4883.17,14,11,12634.49,7751.320000000001
12024,U3DC92E,25,2731.8,15,10,601.9399999999999,3333.74
12025,UF00069,25,-1539.92,22,3,2247.48,707.56
12026,U4D6092,25,4820.379999999999,20,5,5439.619999999999,10260.0
12027,UB9103E,25,2812.6499999999996,18,7,4306.199999999999,7118.85
12028,U4E4D0E,25,4421.3200000000015,20,5,9599.47,14020.789999999999
12029,U3C3038,25,43147.26,15,10,76438.73,119585.98999999999
12030,U2D3D90,25,1965.77,20,5,12662.77,14628.54
12031,U1E0D4E,25,-1513.23,21,4,1736.6000000000001,223.37
12032,UA24D0C,25,1914.1100000000006,19,6,8877.870000000003,10791.98
12033,U85C2DF,25,12851.790000000005,16,9,36451.95,49303.74
12034,UEC9354,25,929.5799999999997,21,4,2634.0800000000004,3563.66
12035,UF670CF,25,-232.0,18,7,9117.240000000002,8885.240000000002
12036,U2B5AC5,25,-510.0699999999999,23,2,3477.9099999999994,2967.84
12037,U53DB52,25,0.9199999999999591,20,5,905.16,906.0799999999999
12038,U205357,25,232.17000000000024,13,12,9830.25,10062.42
12039,U31611A,25,-8.470000000000256,14,11,8042.940000000001,8034.470000000001
12040,UDF96AD,25,1009.27,23,2,515.5,1524.77
12041,U0C205E,25,10853.460000000001,22,3,3207.7400000000002,14061.2
12042,U07C831,25,-11107.2,15,10,18000.199999999997,6893.0
12043,U437725,25,2802.6499999999996,23,2,2198.7499999999995,5001.4
12044,U0FB43A,25,-23318.309999999994,21,4,76003.78,52685.47
12045,U08BDA6,25,-676.7000000000007,17,8,28843.08,28166.38
12046,U6DD8AA,25,37010.0,3,22,6650.0,43660.0
12047,UBDA27C,25,1057.5500000000002,17,8,6082.31,7139.860000000001
12048,U9B5B8C,25,3842.7100000000005,21,4,1583.81,5426.52
12049,UF6720F,25,-5558.200000000001,23,2,18393.21,12835.009999999998
12050,U39D6DD,25,-251.79999999999995,22,3,2084.9700000000003,1833.17
12051,UF1C81A,25,1793.2899999999977,12,13,177501.0,179294.29
12052,U30A5D2,25,13635.0,19,6,9355.869999999999,22990.87
12053,UF3C4DE,25,97.5,12,13,12742.13,12839.630000000001
12054,UF705B1,25,-294.87999999999954,16,9,10934.3,10639.42
12055,U4503C5,25,-12407.68,22,3,12442.68,35.0
12056,U590EEF,25,-29662.66000000001,17,8,107692.43,78029.76999999999
12057,U0F27B5,25,-266.4900000000001,17,8,2680.8,2414.31
12058,UDBEC1A,25,-1071.7699999999963,14,11,36546.990000000005,35475.22
12059,U053EA9,25,343.5899999999999,19,6,9223.779999999999,9567.37
12060,U7F9914,25,14.3100000000004,19,6,7782.39,7796.700000000001
12061,U1FE0A8,25,3860.21,11,14,3250.14,7110.35
12062,UE901E1,25,-9037.800000000001,21,4,18548.920000000006,9511.12
12063,UA206AB,25,-1242.0599999999995,14,11,28035.539999999997,26793.48
12064,U9F126A,25,-1006.8699999999898,12,13,92924.73999999999,91917.87
12065,U8579E7,25,10699.569999999998,19,6,8581.420000000002,19280.989999999998
12066,U1C1E28,25,4960.21,24,1,6248.05,11208.26
12067,UFB5D90,25,382.130000000001,14,11,25877.04,26259.17
12068,U85C355,25,16277.0,21,4,56617.0,72894.0
12069,U641D8D,25,-1490.199999999997,17,8,65535.86000000001,64045.66
12070,U1895EB,25,-7148.0,17,8,71036.0,63888.0
12071,UDE17B8,25,-4998.0499999999965,20,5,59218.46000000001,54220.41
12072,U075BE0,25,-30716.95000000001,22,3,108380.44000000002,77663.49
12073,U7CA612,25,1721.6800000000003,15,10,44824.479999999996,46546.159999999996
12074,UB71360,25,-13189.369999999997,16,9,14837.369999999997,1648.0
12075,U2F5DFB,25,-57.28000000000003,16,9,860.34,803.06
12076,U7A9899,25,-700.7600000000002,19,6,12955.03,12254.27
12077,U51C56A,25,7008.77,19,6,16315.23,23324.0
12078,UCE7640,25,1081.160000000001,21,4,12127.999999999998,13209.16
12079,U92BE66,25,12889.819999999996,18,7,12708.49,25598.309999999998
12080,U8D7DB2,25,262.5900000000015,17,8,21218.720000000005,21481.31
12081,U8EC401,25,4632.670000000001,13,12,12443.689999999999,17076.360000000004
12082,U281351,25,-403.86,25,0,403.86,0.0
12083,U971EA3,25,0.11000000000058208,11,14,21316.93,21317.04
12084,U9E09FF,25,-0.6999999999998181,21,4,5994.700000000001,5994.0
12085,U44C7E8,25,-1250.9099999999999,20,5,14150.91,12900.0
12086,U19A99F,25,-817.9900000000007,18,7,6491.52,5673.53
12087,U8944C9,25,320.07000000000016,12,13,8585.0,8905.07
12088,U25A4E3,25,223.37999999999994,23,2,847.22,1070.6
12089,UA65014,25,-339.25,22,3,1513.28,1174.03
12090,UFF1A6B,25,-379.11999999999796,13,12,127857.13,127478.01
12091,U386A42,25,485.1100000000001,17,8,12364.95,12850.060000000001
12092,U6A9E7A,25,2075.6700000000014,20,5,13209.329999999996,15285.0
12093,U7F8D38,25,4039.19,15,10,9562.48,13601.67
12094,U0159DD,25,-4139.36,20,5,4810.9800000000005,671.62
12095,UDE7DC2,25,174.99000000000035,18,7,3718.9,3893.8900000000003
12096,UB683E2,25,-123.38999999999976,23,2,1226.46,1103.0700000000002
12097,U4FF1D8,25,753.4300000000002,22,3,2749.57,3503.0
12098,U7FD362,24,-21928.87,24,0,21928.87,0.0
12099,UD8871E,24,-1074.08,22,2,1283.46,209.38
12100,U8B1769,24,-1584.1000000000004,19,5,7359.1,5775.0
12101,UDC8A24,24,96.03000000000003,12,12,4307.13,4403.16
12102,UE7EFF7,24,-30692.010000000006,20,4,40681.98000000001,9989.970000000001
12103,UF0253E,24,2.9103830456733704e-11,11,13,135637.25,135637.25
12104,UFD790E,24,-8334.52,18,6,29883.52,21549.0
12105,UE58503,24,-12441.029999999999,21,3,30891.04,18450.010000000002
12106,UF5773F,24,-585.8299999999999,14,10,1288.1899999999998,702.3599999999999
12107,U75DBE8,24,-3596.5500000000006,19,5,9156.55,5560.0
12108,UF6C735,24,4592.53,19,5,545.89,5138.42
12109,U0D6838,24,-5262.1,24,0,5262.1,0.0
12110,UE0414D,24,11775.73,19,5,19361.42,31137.149999999998
12111,U6E7971,24,406.54,17,7,1366.53,1773.0700000000002
12112,UD38396,24,-751.6000000000004,21,3,4782.340000000001,4030.74
12113,UF7B321,24,-3576.03,22,2,10594.03,7018.0
12114,U33987D,24,13588.98,15,9,20960.019999999997,34549.0
12115,UBCED59,24,-34.969999999997526,12,12,159984.97,159950.0
12116,UA4E141,24,-732.4200000000002,21,3,5678.849999999999,4946.43
12117,UCFF9E0,24,716.9000000000003,22,2,2723.2000000000007,3440.1000000000004
12118,U1CC097,24,-652.3999999999996,15,9,45685.11,45032.71
12119,U73BB50,24,100.88999999999669,17,7,50446.71000000001,50547.6
12120,UC19219,24,32095.61,9,15,193171.0,225266.61000000002
12121,U7AAAC3,24,-11015.42,18,6,35887.42,24872.0
12122,U35D3CB,24,0.6500000000008015,15,9,18500.170000000002,18500.82
12123,UC3006F,24,7001.380000000001,22,2,2821.91,9823.29
12124,U0BE17F,24,529.0,21,3,16649.0,17178.0
12125,UE2939D,24,3.694822225952521e-13,18,6,8730.0,8730.0
12126,UD8F038,24,35.77000000000015,18,6,995.1599999999999,1030.93
12127,U0F2DFB,24,-325.6700000000002,21,3,7085.67,6760.0
12128,U9584D2,24,1673.3100000000004,19,5,10472.01,12145.320000000002
12129,UE75511,24,-9503.63,19,5,13007.499999999998,3503.8700000000003
12130,U99EC95,24,-3543.11,20,4,10556.05,7012.94
12131,U777BAE,24,12970.14,14,10,5312.210000000001,18282.35
12132,UD39A64,24,-893.1200000000008,22,2,5303.120000000001,4410.0
12133,U18C377,24,-7370.859999999999,19,5,7777.66,406.79999999999995
12134,U3D6F93,24,94.82000000000698,11,13,154360.03,154454.85
12135,U40FD22,24,-4149.94,15,9,5643.919999999999,1493.98
12136,UC428F4,24,1520.92,21,3,3709.54,5230.46
12137,UF7011C,24,-531.3099999999995,16,8,7994.31,7463.0
12138,U6C49A2,24,3148.5,11,13,32955.0,36103.5
12139,U66EFAD,24,0.0,14,10,120000.0,120000.0
12140,U292AEF,24,4353.37,17,7,6316.5,10669.87
12141,UD9FD0F,24,30360.000000000004,13,11,95342.57999999999,125702.57999999999
12142,UACDD47,24,-33190.24,14,10,50339.76,17149.52
12143,U59B6EE,24,194.51000000000008,19,5,1051.77,1246.28
12144,UA19DE7,24,-83.3899999999976,12,12,84906.40000000001,84823.01
12145,U745993,24,-5.05999999999971,19,5,6455.0599999999995,6450.0
12146,U795C19,24,-109.58999999999804,14,10,21866.030000000002,21756.44
12147,UA84FD4,24,135.21999999999542,20,4,62384.850000000006,62520.07
12148,UF69E35,24,10127.5,15,9,62510.5,72638.0
12149,U5CD1B8,24,-733.3200000000002,18,6,3714.5299999999997,2981.21
12150,UFCE404,24,-205.2999999999999,19,5,1005.3,800.0
12151,U30CE0A,24,4.470000000000141,20,4,2040.6299999999999,2045.1
12152,UFF3803,24,335.80000000000007,21,3,1184.65,1520.45
12153,UE908C9,24,1948.4999999999998,19,5,3988.32,5936.82
12154,UB61086,24,3.5399999999999636,21,3,2532.0,2535.54
12155,U8824A0,24,-13.089999999999975,22,2,397.78,384.69
12156,UAA8ED9,24,-10005.2,19,5,20641.38,10636.18
12157,U15E4D2,24,-2957.91,20,4,23121.309999999998,20163.4
12158,U2EE675,24,273.00000000000057,19,5,24183.769999999997,24456.77
12159,U1DE0B2,24,-4.539999999999964,12,12,4747.57,4743.03
12160,U60381A,24,339.97000000000014,15,9,3279.39,3619.3599999999997
12161,U4F768E,24,-2500.250000000001,19,5,16204.0,13703.75
12162,U29DF50,24,0.06000000000001954,14,10,348.9999999999999,349.06
12163,U6BA9AC,24,-8401.3,11,13,17969.949999999997,9568.65
12164,UEA7AA2,24,-1971.3300000000004,23,1,4048.2200000000003,2076.89
12165,U835203,24,-152992.51,21,3,179518.50999999998,26526.0
12166,UEF4168,24,3844.26,18,6,2110.0200000000004,5954.280000000001
12167,UCA6768,24,-3508.849999999999,19,5,4151.619999999999,642.77
12168,U5BCA50,24,2004.1000000000004,21,3,6079.22,8083.32
12169,U160DCC,24,-123.01999999999823,20,4,13894.429999999998,13771.41
12170,UF0D970,24,125.08000000000004,22,2,1072.31,1197.3899999999999
12171,UF8C7A5,24,-5481.889999999999,18,6,16471.95,10990.06
12172,U941288,24,-15355.639999999985,12,12,257066.36,241710.71999999997
12173,UA39631,24,4633.999999999999,5,19,490.22,5124.219999999999
12174,U1110EE,24,-1866.7400000000016,16,8,34086.44,32219.7
12175,U9C2917,24,-9778.029999999999,21,3,21574.28,11796.25
12176,U45EF8A,24,-19609.75,18,6,19677.500000000004,67.75
12177,UB85CDA,24,1041.080000000001,21,3,5295.0,6336.08
12178,U29277F,24,-1577.5300000000002,22,2,10311.19,8733.66
12179,U3D9830,24,465.5699999999999,16,8,1742.28,2207.85
12180,U172107,24,81.20999999999998,19,5,3768.81,3850.0200000000004
12181,U4CB235,24,-106.10999999999876,22,2,6138.109999999999,6032.0
12182,U43DF94,24,0.0,13,11,20100.0,20100.0
12183,UB0D2B3,24,0.0,21,3,686.09,686.0899999999999
12184,U8867AE,24,281.0099999999999,22,2,1117.88,1398.8899999999999
12185,U9E593F,24,446.01,23,1,1253.99,1700.0
12186,UDF784D,24,807.7799999999999,17,7,4140.79,4948.57
12187,U4E03E2,24,3814.37,21,3,1702.26,5516.63
12188,U739F0C,24,-6259.57,15,9,34803.49,28543.92
12189,UD3D83D,24,1457.02,18,6,3107.2,4564.219999999999
12190,UA0F650,24,609.2900000000004,20,4,9538.6,10147.89
12191,U2B3C42,24,-2811.37,17,7,11332.999999999998,8521.630000000001
12192,U2C7EC8,24,9471.699999999999,13,11,24820.469999999998,34292.17
12193,U92CD14,24,5835.699999999999,21,3,4310.6,10146.3
12194,U67652F,24,18.839999999999975,13,11,5227.0,5245.84
12195,U3026C5,24,293.03999999999934,17,7,4582.45,4875.49
12196,UB31E91,24,-4146.52,16,8,8696.54,4550.02
12197,UCED79C,24,137507.77000000002,15,9,33384.39,170892.16
12198,U6FF89F,24,162.20999999999958,21,3,1452.9099999999999,1615.12
12199,U98D7F7,24,-499.74000000000524,12,12,334196.0,333696.26
12200,U9A0443,24,220.74,17,7,1205.37,1426.1100000000001
12201,UFF7B84,24,-33336.15,20,4,80848.89,47512.74
12202,U91331E,24,-74.80000000000004,22,2,891.7,816.9
12203,U991441,24,4663.489999999999,22,2,14198.799999999997,18862.29
12204,U48B7CF,24,0.0,16,8,16000.0,16000.0
12205,U370BC7,24,9152.849999999999,8,16,76926.5,86079.35
12206,UF4BAA9,24,-3108.3300000000004,17,7,6823.36,3715.0299999999997
12207,U98F344,24,-9449.14,23,1,12813.560000000001,3364.42
12208,U228148,24,25974.629999999997,19,5,18710.409999999996,44685.04
12209,UB0746B,24,-6349.209999999999,17,7,54146.67,47797.46
12210,U564822,24,-1351.199999999997,17,7,23633.2,22282.0
12211,UA73210,24,567.2000000000003,12,12,2320.76,2887.9600000000005
12212,U65A7B7,24,-855.0700000000002,15,9,9175.22,8320.150000000001
12213,U535403,24,-8150.969999999999,14,10,23814.73,15663.76
12214,UE38F1E,24,7515.09,17,7,18639.0,26154.09
12215,U3524A7,24,-48196.25,24,0,48196.25,0.0
12216,UE3E2CD,24,1453.02,16,8,2476.7200000000003,3929.74
12217,U0F851F,24,15939.120000000006,15,9,31406.049999999996,47345.17
12218,U653268,24,52.77000000000044,14,10,8060.88,8113.65
12219,UFF8411,24,-1614.3799999999997,18,6,3900.5099999999993,2286.13
12220,UDFA226,24,499.8900000000003,22,2,2150.11,2650.0
12221,UBBB83B,24,68554.16,13,11,52825.84,121380.0
12222,U90E5AD,24,32002.039999999994,14,10,101940.21,133942.24999999997
12223,UE498EB,24,20043.459999999963,11,13,671100.16,691143.62
12224,UC62F64,24,-900.3500000000004,20,4,4921.01,4020.66
12225,U9F208B,24,129.83999999999997,22,2,913.6700000000001,1043.51
12226,UEE08A3,24,-2630.47,11,13,11703.28,9072.810000000001
12227,U87FA3A,24,-93.06999999999971,17,7,6331.65,6238.58
12228,UFCE0AE,24,341.0199999999999,20,4,1800.4999999999998,2141.52
12229,UC5AC4F,24,2914.05,16,8,15039.329999999998,17953.379999999997
12230,UBF5F3C,24,5179.610000000001,19,5,3591.8999999999996,8771.51
12231,U124AF7,24,-37.61000000000075,13,11,5866.53,5828.92
12232,UFECDAA,24,-5364.5599999999995,20,4,13367.14,8002.58
12233,U333C3F,24,44578.73000000001,12,12,139852.97,184431.69999999998
12234,U4C22DB,24,12193.46,15,9,3960.16,16153.62
12235,U40EBDB,24,503.9200000000002,19,5,514.54,1018.4599999999999
12236,UD1752B,24,2013.28,21,3,1444.13,3457.41
12237,U8AFFCA,24,3948.4699999999993,19,5,15453.27,19401.74
12238,UF4DE31,24,-128.6400000000001,22,2,2062.6400000000003,1934.0
12239,U6B9DA0,24,-85.00999999999985,21,3,3570.5099999999998,3485.5
12240,U6C198D,24,-12899.18,20,4,26158.359999999997,13259.18
12241,UB1D7AD,24,-1083.0700000000002,23,1,2083.07,1000.0
12242,U5EFF70,24,-6229.4,21,3,26381.38,20151.98
12243,UE00CC9,24,2226.689999999999,15,9,16475.19999999999,18701.890000000003
12244,UD3B1CE,24,-2840.94,22,2,4260.9400000000005,1420.0
12245,UBFC94D,24,295.6299999999999,22,2,1351.75,1647.38
12246,U52039F,24,-9952.28,24,0,9952.28,0.0
12247,U9F9A5B,24,1056.699999999999,21,3,7330.719999999999,8387.42
12248,UB8DEA7,24,4677.470000000003,19,5,39322.52999999999,44000.0
12249,U23A00D,24,8442.280000000002,19,5,22840.699999999997,31282.98
12250,U5303D7,24,18188.85,20,4,63784.19,81973.04000000001
12251,U9E4EB3,24,169.3199999999999,22,2,753.69,923.01
12252,UC9C07A,24,-13.57999999999629,14,10,77981.23999999999,77967.66
12253,U5A277E,24,350.46000000000004,14,10,3596.54,3947.0
12254,U7C51F6,24,-4797.73,17,7,14702.73,9905.0
12255,U5531F7,24,-263.4799999999998,21,3,2927.29,2663.8100000000004
12256,UAD1122,24,1295.5199999999998,20,4,2079.72,3375.24
12257,U576728,24,-26835.34,19,5,62627.68,35792.34
12258,U2B2708,24,7797.9400000000005,22,2,4060.73,11858.67
12259,U38BD17,24,4942.46,17,7,5275.040000000001,10217.500000000002
12260,UE29807,24,-286.9800000000006,14,10,24974.129999999997,24687.149999999998
12261,UDDA522,24,9026.43,20,4,3167.11,12193.54
12262,U40A0A9,24,-39215.770000000004,5,19,222000.0,182784.22999999998
12263,UE63C5F,24,-10780.840000000002,24,0,10780.840000000002,0.0
12264,UA55570,24,8435.44,17,7,15485.050000000003,23920.49
12265,U4AA4E8,24,10026.0,16,8,19742.39,29768.39
12266,UCAEFA1,24,33088.81,0,24,0.0,33088.81
12267,U3A28C6,24,-6120.34,24,0,6120.34,0.0
12268,U909265,24,1355.130000000001,16,8,13556.470000000001,14911.6
12269,U1831F6,24,-863.58,23,1,992.1600000000001,128.58
12270,U615317,24,430.8999999999942,14,10,143564.74,143995.64
12271,U653876,24,-2173.8899999999976,20,4,62228.090000000004,60054.2
12272,UA81298,24,-2533.5499999999993,15,9,30825.82,28292.27
12273,U124CA3,24,-4967.0,19,5,32967.0,28000.0
12274,UFD2593,24,-30.09000000001106,14,10,84942.9,84912.81
12275,U3A42A2,24,66.17000000000007,18,6,48225.479999999996,48291.649999999994
12276,U31DF86,24,-106.64000000000016,18,6,5346.79,5240.15
12277,UA2A78B,24,121.68000000000029,21,3,9061.13,9182.81
12278,UD4A94B,24,-1293.7599999999888,20,4,44541.810000000005,43248.05
12279,UB3DD31,24,615.79,20,4,2240.33,2856.12
12280,U4F6A0C,24,18283.920000000002,19,5,9984.789999999999,28268.71
12281,UC8C141,24,-8109.420000000002,19,5,96074.04000000001,87964.62
12282,UE12B94,24,1101.4600000000003,17,7,17344.9,18446.36
12283,U94DD7B,24,1270.7,19,5,6972.04,8242.74
12284,UD76660,24,-71.57999999999981,20,4,4871.579999999999,4800.0
12285,U8291B0,24,4446.29000000001,9,15,327066.11,331512.39999999997
12286,U419B1C,24,-531769.52,21,3,620219.52,88450.0
12287,U9F2780,24,-1967.8800000000028,19,5,24025.69,22057.809999999998
12288,U18B891,24,-0.980000000000004,20,4,1630.01,1629.03
12289,U214561,24,-5776.4,22,2,5936.4,160.0
12290,UCE8518,24,4559.0599999999995,21,3,1937.6400000000003,6496.7
12291,U0AE366,24,-32.879999999999995,22,2,299.59999999999997,266.72
12292,U6F7C1C,24,-804.4300000000001,20,4,26635.499999999996,25831.07
12293,UDA0076,24,821.95,21,3,1225.59,2047.54
12294,U584829,24,-10.800000000000182,20,4,6325.8,6315.0
12295,UB5F39C,24,-1432.0299999999916,16,8,92855.23999999999,91423.20999999999
12296,UF32D9C,24,-130.49000000000004,18,6,43533.16,43402.67
12297,U02C0B6,24,10849.179999999998,18,6,31563.839999999997,42413.020000000004
12298,U3396DE,24,3301.7,18,6,3698.88,7000.58
12299,UC68EB7,24,449.1799999999994,18,6,7958.75,8407.93
12300,U54CD59,24,-4296.1,22,2,6316.1,2020.0
12301,UE862DC,24,-12958.149999999998,16,8,20512.12,7553.969999999999
12302,U895247,24,-651.4700000000012,17,7,110596.82,109945.35
12303,U484392,24,9.549999999999955,18,6,7053.539999999999,7063.09
12304,U432EBD,24,-6424.8,15,9,30221.409999999996,23796.609999999997
12305,U7963FB,24,-88053.66,19,5,114053.66,26000.0
12306,U4C4F75,24,17399.190000000002,9,15,3021.11,20420.300000000003
12307,U9ECA99,24,332.90000000000003,23,1,2167.1,2500.0
12308,U633ACD,24,-66.30000000000007,18,6,1363.11,1296.81
12309,U66F66A,24,13089.899999999998,15,9,117603.40000000001,130693.3
12310,U65DDCC,24,-1890.3800000000006,18,6,8491.38,6601.0
12311,UED9716,24,-23460.530000000042,10,14,668115.0,644654.47
12312,UFF525E,24,-1638.73,21,3,8183.58,6544.85
12313,U3B2A72,24,-9599.269999999999,21,3,11018.789999999999,1419.52
12314,U2540AF,24,642.0700000000002,18,6,2868.9199999999996,3510.99
12315,U056D44,24,-6019.609999999999,20,4,6155.399999999998,135.79000000000002
12316,UD70835,24,206.48000000000008,19,5,3440.94,3647.42
12317,U13DF27,24,175.88999999999993,21,3,501.69,677.5799999999999
12318,UD99935,24,-819.47,21,3,18095.3,17275.83
12319,U147066,24,-228.6499999999998,18,6,2955.3399999999997,2726.69
12320,U938522,24,-2384.7299999999996,14,10,64034.72,61649.990000000005
12321,UE09589,24,-262.1900000000006,17,7,11669.210000000001,11407.02
12322,UF637C0,24,-10.180000000001087,13,11,11152.54,11142.36
12323,U75CF99,24,-4452.150000000001,19,5,11805.309999999998,7353.16
12324,U0DF57A,24,-14004.629999999997,16,8,42224.25,28219.620000000003
12325,U0E0869,24,381.63999999999993,22,2,1668.3600000000001,2050.0
12326,U5FBCE1,24,38959.34,18,6,46397.979999999996,85357.32
12327,U2C4AB0,24,174.06,16,8,283.0,457.06
12328,UD3565A,24,-321.38,18,6,2569.01,2247.63
12329,U4422F8,24,8070.5,20,4,63913.17999999999,71983.68
12330,U13C81A,24,12080.279999999999,15,9,81113.0,93193.28000000001
12331,U76493E,24,-6464.780000000001,17,7,49164.78,42700.0
12332,U463D60,24,-4999.25,18,6,119227.87999999999,114228.63
12333,UA404E9,24,0.0,12,12,20010.0,20010.0
12334,UE2DE2A,24,-847.4399999999999,22,2,897.45,50.01
12335,U304AAD,24,957.9300000000009,16,8,17832.86,18790.79
12336,U9DC6C2,24,410.8100000000003,20,4,1392.1399999999996,1802.9499999999998
12337,UEAB65B,24,1877.2399999999998,16,8,23197.89,25075.129999999997
12338,U668141,24,180.90000000000026,12,12,5276.1,5457.0
12339,U5604C7,24,-10.579999999999757,20,4,2910.7999999999997,2900.2200000000003
12340,U5D7DDC,24,-29325.620000000003,18,6,61417.0,32091.38
12341,U2A9B29,24,-2839.84,18,6,29018.66,26178.82
12342,UF28435,24,-7480.289999999999,18,6,14939.289999999999,7459.0
12343,UF780EA,24,-4343.460000000012,15,9,108559.15999999999,104215.7
12344,UC55E76,24,-61.100000000000364,21,3,17975.0,17913.9
12345,U6821A5,24,-734.2099999999999,18,6,1659.74,925.53
12346,U75D39B,24,-1813.3000000000002,21,3,11342.990000000002,9529.69
12347,UAF19EE,24,50.0,16,8,566.29,616.29
12348,U9FBA5B,24,3413.0,17,7,32117.0,35530.0
12349,UC1F6B3,24,214.85000000000002,22,2,1268.6399999999999,1483.49
12350,U76111B,24,-12800.99,20,4,37672.350000000006,24871.36
12351,U2D1DF6,24,3434.2099999999996,21,3,5763.589999999999,9197.800000000001
12352,U8C1531,24,-1738.9199999999998,22,2,2040.25,301.33
12353,UE6C68B,24,21.339999999999794,14,10,8006.41,8027.749999999999
12354,UA5958F,24,-1225.6500000000005,20,4,3242.1900000000005,2016.54
12355,U4B18B5,24,1161.0,15,9,118839.0,120000.0
12356,U954F1A,24,-903.2,23,1,1011.0,107.8
12357,U6D71F8,24,65.22999999999934,14,10,10034.93,10100.16
12358,UF6C309,24,10049.849999999999,18,6,17333.85,27383.699999999997
12359,U3C4C49,24,775.8999999999999,13,11,944.2,1720.1
12360,U0DEF88,24,-218.8899999999997,19,5,3931.88,3712.9900000000002
12361,U29D396,24,-23345.03,21,3,50315.03,26970.0
12362,U965418,24,-2074.3999999999996,21,3,3634.3999999999996,1560.0
12363,UE35255,24,12021.33,10,14,11106.99,23128.32
12364,UE0AF37,24,-7480.3099999999995,17,7,17771.72,10291.41
12365,U4832FD,24,-6830.75,22,2,11681.4,4850.65
12366,UAFB5D9,24,11736.599999999999,15,9,10642.75,22379.35
12367,U7504E9,24,14582.14,21,3,2413.8599999999997,16996.0
12368,U37834C,24,611.67,19,5,3265.3,3876.97
12369,UE04123,24,3.4400000000000404,21,3,576.26,579.7
12370,UD875BA,24,13628.170000000004,18,6,27793.129999999997,41421.3
12371,UEC5D47,24,-11001.44,18,6,14834.5,3833.06
12372,U959770,24,19014.71,12,12,17405.86,36420.57
12373,UDDDBD6,24,-1.1368683772161603e-13,20,4,4633.759999999999,4633.76
12374,UF595FF,24,-10881.949999999997,13,11,72355.5,61473.55
12375,U5406B4,24,-2992.6800000000003,22,2,9846.779999999999,6854.1
12376,U2AE25D,24,20813.239999999998,9,15,19615.83,40429.07000000001
12377,U9EBCB6,24,4778.43,21,3,7341.139999999999,12119.57
12378,U269BAA,24,124.16999999999825,18,6,20439.65,20563.82
12379,U11FB6D,24,-238.26999999999995,19,5,3164.97,2926.7000000000003
12380,U7452BF,24,-200675.37,20,4,202661.75,1986.38
12381,U5FD4C8,24,6919.24,18,6,10538.65,17457.890000000003
12382,U81EB82,24,3426.9800000000014,19,5,6404.8099999999995,9831.789999999999
12383,U3BDBD5,24,-134.28000000000065,20,4,10087.39,9953.109999999999
12384,U139570,24,-6493.730000000003,16,8,59900.0,53406.27
12385,UF6F4C7,24,-15566.720000000001,19,5,44711.630000000005,29144.91
12386,UD38449,24,170.4500000000013,18,6,14486.57,14657.02
12387,UAE756B,24,-7976.670000000002,14,10,152478.25,144501.58
12388,UD3F3EC,24,-1839.0,19,5,8088.0,6249.0
12389,UDBBD33,24,353.15000000000003,20,4,2484.6,2837.75
12390,U68E216,24,0.5299999999999976,20,4,226.54,227.07
12391,U175C52,24,738.8499999999988,11,13,15473.37,16212.22
12392,UB9A9A3,24,-3607.0099999999998,16,8,10256.009999999998,6649.0
12393,U36708D,24,5921.58,20,4,79237.42,85159.0
12394,U1BAFDC,24,-950.8900000000002,21,3,2395.0,1444.1100000000001
12395,U85D9EE,24,-8173.16,24,0,8173.16,0.0
12396,U62D256,24,-11132.0,18,6,100540.0,89408.0
12397,UB391B0,24,-4.879999999999882,20,4,739.94,735.06
12398,UEF8098,24,2751.6400000000003,14,10,19580.5,22332.139999999996
12399,U3DE5DA,24,3090.99,13,11,7672.650000000001,10763.64
12400,UD866C3,24,-603.0299999999997,19,5,4849.3,4246.27
12401,U61E2F4,24,-630.7500000000005,20,4,10833.81,10203.060000000001
12402,U7F17AD,24,-50758.79999999999,19,5,64531.15999999999,13772.36
12403,U8C2F87,24,4213.419999999998,17,7,47891.7,52105.119999999995
12404,U88535A,24,-79.58999999999924,14,10,20506.610000000004,20427.02
12405,U4E1564,24,-14746.560000000001,19,5,53919.560000000005,39173.0
12406,U0B5C22,24,5195.000000000001,20,4,21667.790000000008,26862.79
12407,U5DA27A,24,632.0500000000002,20,4,4853.42,5485.47
12408,UFF6673,23,6898.749999999999,18,5,13054.5,19953.25
12409,U6C6CCF,23,42.85,19,4,1021.1500000000001,1064.0
12410,U63AFC5,23,-12351.16,20,3,16151.16,3800.0
12411,UDDC37C,23,-1891.5300000000007,17,6,17429.440000000002,15537.91
12412,U74AB24,23,1006.4999999999995,19,4,3109.5,4116.0
12413,UBB7B6F,23,-6220.119999999999,23,0,6220.119999999999,0.0
12414,UACF077,23,-13036.010000000002,15,8,90523.18000000001,77487.17
12415,U788DD5,23,5156.49,20,3,4117.049999999999,9273.54
12416,U0FBDAB,23,37777.09,15,8,33197.64,70974.73
12417,U7C71BB,23,-15702.01,20,3,25710.9,10008.89
12418,UC052F4,23,-13142.61,18,5,26207.49,13064.880000000001
12419,U45C3EA,23,288.72999999999956,17,6,12084.27,12373.0
12420,U4CCC6C,23,59.95000000000205,7,16,27070.920000000002,27130.87
12421,U8284BA,23,57622.06,16,7,30695.22,88317.28
12422,UB7511D,23,19068.03,11,12,551000.0,570068.03
12423,U783CAB,23,-2957.99,20,3,3958.35,1000.36
12424,UEBE792,23,28.920000000000073,14,9,5773.4400000000005,5802.360000000001
12425,UE288E2,23,-703.4999999999992,15,8,22104.24,21400.739999999998
12426,UC4F28B,23,4053.1399999999994,14,9,81440.29,85493.43
12427,U966668,23,0.009999999999308784,20,3,10994.720000000001,10994.73
12428,UECD46D,23,-3287.459999999999,19,4,12826.23,9538.77
12429,UC22680,23,-19085.780000000006,15,8,20444.400000000005,1358.6200000000001
12430,U02AA09,23,-28506.08,17,6,61513.76,33007.68
12431,U2188C9,23,50598.76,12,11,28303.2,78901.95999999999
12432,U3360D3,23,-1223.94,23,0,1223.94,0.0
12433,U8E1FBD,23,7430.119999999999,15,8,36873.67,44303.79
12434,UB7C988,23,687.8599999999999,20,3,1366.97,2054.83
12435,U4168B0,23,-9291.0,16,7,47791.0,38500.0
12436,U6053AF,23,-353.62000000000086,21,2,6156.71,5803.09
12437,U89C049,23,5463.000000000002,7,16,1075.0,6538.0
12438,U61E3DB,23,4174.560000000004,12,11,39239.990000000005,43414.55
12439,UE0E931,23,-1134.9999999999995,16,7,11368.920000000002,10233.919999999998
12440,U590055,23,1592.3399999999997,19,4,6540.8,8133.14
12441,U8A45B2,23,-314.98999999999944,22,1,5241.45,4926.46
12442,U69C035,23,-10.890000000000292,13,10,10115.26,10104.37
12443,UE3CB51,23,-945.9900000000001,20,3,4192.77,3246.78
12444,UDD8117,23,-585.7699999999999,18,5,4745.25,4159.48
12445,U956927,23,-6226.97,21,2,7414.97,1188.0
12446,UD5A499,23,-10519.66,21,2,10920.44,400.78
12447,UA8E71B,23,-222.73000000000002,14,9,3438.02,3215.29
12448,U60A861,23,2099.4300000000003,13,10,5144.42,7243.85
12449,U0930EF,23,-76.21000000000006,21,2,2490.2100000000005,2414.0
12450,UFBC60D,23,-1533.7199999999998,22,1,1533.7399999999998,0.02
12451,UEE5ADE,23,-39670.70000000001,14,9,271019.26,231348.56
12452,UECE390,23,112978.47,16,7,36819.4,149797.87
12453,UE708D4,23,910.0,17,6,22790.0,23700.0
12454,U5169D1,23,-163.6500000000002,14,9,3445.1200000000003,3281.47
12455,U25F6DE,23,-4389.02,19,4,11256.8,6867.78
12456,UF50C03,23,-1317.2900000000009,20,3,31022.09,29704.8
12457,UDBB796,23,-514.9999999999993,22,1,4242.999999999998,3728.0
12458,UD391D2,23,24137.18,11,12,3331.58,27468.760000000002
12459,U7C4E5F,23,-137.49999999999997,19,4,3386.6000000000004,3249.1000000000004
12460,UC3F2F4,23,2810.9100000000003,19,4,5270.300000000001,8081.21
12461,UB75983,23,-5524.88,22,1,5527.88,3.0
12462,UA22C50,23,-1576.48,15,8,7085.03,5508.55
12463,UC1CE00,23,-5395.65,16,7,8239.06,2843.41
12464,U463406,23,50.86000000000081,14,9,10483.369999999999,10534.23
12465,U1F608C,23,1087.3600000000001,18,5,28468.68,29556.04
12466,U20BCA4,23,-3860.2700000000004,18,5,13074.459999999997,9214.19
12467,U176429,23,-12265.74,20,3,12278.98,13.239999999999998
12468,UA0CE79,23,-212.67999999999938,19,4,13041.18,12828.5
12469,U8A4963,23,-2.77000000000005,13,10,8649.62,8646.850000000002
12470,UA46BE2,23,102106.14000000001,11,12,122587.0,224693.13999999998
12471,UE95C04,23,-4241.2300000000005,16,7,12863.17,8621.94
12472,U832E7C,23,-1713.6699999999998,18,5,2215.43,501.76
12473,UD6CC58,23,-397.62999999999965,21,2,6113.8099999999995,5716.18
12474,U34A04D,23,-17172.640000000003,18,5,19825.91,2653.27
12475,UD7185F,23,-2460.3,20,3,4495.78,2035.48
12476,UD0AA4B,23,-289.40000000000106,16,7,14031.729999999996,13742.329999999998
12477,U23C812,23,5771.719999999999,16,7,21699.139999999996,27470.86
12478,U0D5B96,23,-504.69999999999993,21,2,1993.0,1488.3
12479,U8BEA0E,23,-8332.64,21,2,9405.48,1072.84
12480,U119384,23,203.89999999999964,19,4,19840.1,20044.0
12481,UB55709,23,9421.099999999995,14,9,71409.78,80830.88
12482,U17AD4F,23,-1515.32,21,2,3092.32,1577.0
12483,U702C9A,23,414987.24,15,8,12147.000000000002,427134.24
12484,U94056F,23,-9998.449999999999,14,9,67805.54,57807.090000000004
12485,U763A14,23,-0.8000000000010914,11,12,22338.54,22337.739999999998
12486,UB82BEC,23,46096.669999999984,15,8,3506.08,49602.75
12487,UB973A3,23,-11967.990000000002,21,2,27967.99,16000.0
12488,U2EE66E,23,-1106.7700000000432,9,14,1039003.96,1037897.19
12489,UF7D95A,23,-924.0000000000009,17,6,24600.12,23676.120000000003
12490,UB78181,23,-3359.8800000000006,17,6,3486.0100000000007,126.13
12491,U949A6A,23,-9600.39,22,1,9600.439999999999,0.05
12492,UEA7463,23,932.5,20,3,701.2,1633.7
12493,UAABFA5,23,-21899.64,18,5,38382.77,16483.129999999997
12494,UFF8BA2,23,1134.2900000000002,20,3,14417.710000000001,15552.0
12495,U6E45AE,23,1692.2400000000011,20,3,11689.96,13382.2
12496,U601706,23,13528.700000000004,19,4,42471.3,56000.0
12497,U7C649E,23,-1577.4099999999999,23,0,1577.4099999999999,0.0
12498,UE163DC,23,1339.460000000001,13,10,10753.52,12092.98
12499,U9F0EA9,23,-556.8899999999996,18,5,1556.9899999999998,1000.1
12500,U56FE9E,23,575.9100000000004,14,9,7535.18,8111.09
12501,U0ADBA1,23,-42018.54999999999,13,10,161730.91,119712.36
12502,U470A45,23,9103.0,18,5,1509.6000000000001,10612.6
12503,U9B5E84,23,0.1,13,10,550.0,550.1
12504,U30B8CD,23,1878.3299999999995,18,5,36080.060000000005,37958.39
12505,UA3A94F,23,-11607.170000000002,18,5,54807.17,43200.0
12506,UE3F2AA,23,-23632.04,21,2,24589.34,957.3
12507,U28A7AA,23,-18199.96,17,6,53768.29,35568.33
12508,UF4468F,23,-1059.57,21,2,2024.57,965.0
12509,UCAD6C9,23,-4.263256414560601e-14,19,4,646.48,646.48
12510,UF39131,23,-405.69,17,6,606.4199999999998,200.72999999999996
12511,UB40E75,23,-8860.48,19,4,11980.94,3120.46
12512,U858317,23,-2.1316282072803006e-14,18,5,778.9,778.9
12513,U7B2A73,23,-891.3100000000013,20,3,14443.98,13552.669999999998
12514,U0CF112,23,-3303.59,21,2,4216.7,913.11
12515,UBCFFF4,23,-3545.6499999999996,15,8,10936.540000000003,7390.89
12516,UC448EC,23,1172.8199999999997,20,3,648.46,1821.2799999999997
12517,U8B1700,23,-11568.98,19,4,20806.579999999998,9237.6
12518,U1EDF97,23,-2413.989999999999,21,2,17134.99,14721.0
12519,UB08CD2,23,-896.64,20,3,1642.7600000000002,746.12
12520,UDC94B0,23,-16494.94,19,4,49440.0,32945.06
12521,U539B0D,23,92.00999999999999,19,4,831.89,923.9
12522,U50FAAF,23,11993.550000000003,18,5,35256.86,47250.41
12523,UDA411A,23,-652.5899999999999,16,7,4536.8099999999995,3884.22
12524,UE724A7,23,-10347.37,20,3,11297.369999999999,950.0
12525,UCCF8D3,23,0.569999999999709,14,9,39662.46,39663.03
12526,UD426B4,23,-5752.05,20,3,13969.539999999999,8217.49
12527,UB2EF7C,23,1277.2999999999993,16,7,87057.7,88335.0
12528,U5F271B,23,-36.57999999999993,11,12,42070.740000000005,42034.16
12529,UB0BE57,23,-2004.3099999999995,13,10,29600.0,27595.690000000002
12530,UBD3BB1,23,-831.9099999999999,14,9,5440.73,4608.82
12531,UA97702,23,18006.04,11,12,9846.92,27852.96
12532,UEAD074,23,-10468.479999999998,19,4,30595.48,20127.0
12533,U6C4C04,23,2150.93,20,3,4961.009999999999,7111.9400000000005
12534,U786035,23,3683.1800000000003,16,7,5181.82,8865.0
12535,UF8A4F5,23,1152.8900000000003,15,8,3382.97,4535.86
12536,UC8FF79,23,-1231.94,14,9,3427.13,2195.19
12537,UBE312B,23,0.23999999999978172,12,11,45600.0,45600.240000000005
12538,U08AC24,23,-4805.639999999999,18,5,21805.65,17000.010000000002
12539,UE114BB,23,-704.38,19,4,1213.4199999999998,509.04
12540,UA8BA02,23,-1985.5199999999998,19,4,15544.520000000002,13559.0
12541,U832B64,23,2009.0,13,10,73954.0,75963.0
12542,U4FBF1A,23,21119.9,10,13,89917.54999999999,111037.45000000001
12543,U49BC01,23,4607.5199999999995,16,7,12120.21,16727.73
12544,U2CE789,23,-180.49999999999943,10,13,164004.02,163823.52000000002
12545,U3666C5,23,-12571.750000000007,13,10,77491.26999999999,64919.520000000004
12546,U2CCF22,23,-629.4599999999999,21,2,935.6399999999999,306.18
12547,U723929,23,401.8400000000029,14,9,44028.479999999996,44430.32
12548,UBF5557,23,-16742.89,16,7,24641.35,7898.46
12549,U38275B,23,313.0,22,1,834.5,1147.5
12550,UFF004C,23,-1454.7600000000002,17,6,49300.0,47845.24
12551,U7474D1,23,-26.48999999999978,18,5,38514.0,38487.51
12552,UDA142A,23,-1366.1899999999994,16,7,14158.159999999998,12791.970000000001
12553,UEE2E4E,23,1.4299999999997475,13,10,25407.74,25409.17
12554,UC5B8B9,23,201.77,11,12,2178.29,2380.06
12555,UB5C124,23,18112.04,17,6,39039.24,57151.28
12556,U892B93,23,-1264.81,14,9,8806.51,7541.7
12557,UC7AE87,23,-4189.7699999999995,20,3,14189.769999999997,10000.0
12558,U386F24,23,1711.9099999999999,16,7,6254.9,7966.8099999999995
12559,U262D1A,23,-16.340000000000146,15,8,7378.38,7362.04
12560,U701B36,23,187.4300000000003,18,5,7444.66,7632.09
12561,U427DEC,23,241.6899999999997,11,12,13044.56,13286.25
12562,U3616D5,23,19061.92000000001,10,13,32570.600000000002,51632.52
12563,U4B371B,23,1247.880000000001,14,9,37979.119999999995,39227.0
12564,UE66FD5,23,-2137.38,22,1,2173.38,36.0
12565,U91D3CC,23,-28235.1,21,2,53932.78,25697.68
12566,UFA861F,23,958.9799999999987,19,4,28029.399999999998,28988.379999999997
12567,U92D480,23,16.099999999999888,15,8,9178.8,9194.9
12568,U1739DF,23,89.39999999999998,21,2,775.6499999999999,865.05
12569,UF207B4,23,-581.4299999999998,15,8,14146.51,13565.08
12570,UDDFCD6,23,-12978.349999999999,12,11,160837.46999999997,147859.12
12571,U4CDBF3,23,222.92000000000013,19,4,2207.23,2430.15
12572,U0EFA89,23,-1403.3600000000001,22,1,1723.4700000000003,320.11
12573,U786924,23,8715.920000000002,13,10,9584.079999999998,18300.0
12574,UBA7C8A,23,-10281.16,17,6,17281.559999999998,7000.4
12575,UB76FA2,23,-4482.58,19,4,34740.54,30257.96
12576,UDA5D9C,23,-811843.48,19,4,815242.12,3398.6400000000003
12577,U2156D8,23,700234.94,4,19,25575.3,725810.24
12578,U00AF0A,23,202415.82000000004,8,15,371755.88,574171.7
12579,UF2AB1A,23,-425.45999999999987,19,4,867.7699999999999,442.31
12580,U100E1F,23,-23399.69,17,6,72965.92,49566.229999999996
12581,UF8C244,23,1444.7499999999984,19,4,15740.830000000004,17185.58
12582,U8A15DB,23,718.9099999999996,11,12,5028.3,5747.21
12583,U80166E,23,-20053.390000000003,18,5,47935.37,27881.98
12584,U5E9C87,23,62.409999999999854,14,9,7288.360000000001,7350.77
12585,UE4152F,23,1211.9099999999992,19,4,1717.3400000000001,2929.25
12586,U61F28A,23,31437.49,19,4,7838.090000000001,39275.58
12587,U65A8CE,23,-356.19000000000096,17,6,20042.949999999997,19686.760000000002
12588,U639BE2,23,-1811.1499999999996,15,8,21911.84,20100.690000000002
12589,UF426D1,23,19.48999999999978,18,5,2435.7600000000007,2455.25
12590,U9647B2,23,-2112.2200000000003,15,8,13327.220000000001,11215.0
12591,U4673BE,23,-7572.6600000000035,14,9,33781.740000000005,26209.08
12592,UCCAD45,23,-78.98000000000005,14,9,3051.97,2972.9900000000002
12593,U9FA8AC,23,-4645.979999999999,20,3,8316.950000000003,3670.97
12594,U239C4A,23,15563.67,19,4,5330.48,20894.15
12595,U6AC44B,23,900.1300000000001,14,9,12313.199999999999,13213.330000000002
12596,U37DB67,23,-1093.3199999999997,22,1,1127.2199999999998,33.9
12597,UF4BCD9,23,-13683.239999999998,22,1,19338.32,5655.08
12598,U917D75,23,169.99999999999886,21,2,15975.970000000001,16145.97
12599,U370257,23,-5532.139999999998,18,5,7889.799999999999,2357.66
12600,U65E289,23,-869.3899999999994,21,2,5082.389999999999,4213.0
12601,U84AD95,23,-1164.180000000001,19,4,12274.75,11110.57
12602,UB76E49,23,2429.079999999999,12,11,40176.72,42605.8
12603,U384833,23,4835.45,14,9,8939.1,13774.55
12604,U1A04FC,23,948.5,19,4,3053.2100000000005,4001.71
12605,U68D8D7,23,-8296.21,17,6,19230.21,10933.999999999998
12606,U9898E7,23,10619.06,16,7,4969.65,15588.71
12607,U7EB75F,23,-27076.280000000006,20,3,34195.39,7119.110000000001
12608,U6B230D,23,55.08999999999992,19,4,5461.34,5516.43
12609,U2B137D,23,5865.180000000001,18,5,17517.160000000003,23382.34
12610,U56F990,23,4670.539999999999,15,8,16062.199999999997,20732.739999999998
12611,U47D1D3,23,678.9999999999982,19,4,27293.739999999998,27972.739999999998
12612,U102104,23,3708.9600000000005,19,4,1291.18,5000.14
12613,UEFEAD6,23,565.4799999999996,16,7,13929.3,14494.78
12614,U6C952B,23,-4691.89,16,7,9308.27,4616.38
12615,UE6E861,23,-447.0999999999999,21,2,3099.7599999999998,2652.66
12616,UB96DF7,23,-3098.480000000001,18,5,6718.479999999999,3620.0
12617,U5443B4,23,-2232.2200000000003,20,3,2460.6100000000006,228.39000000000001
12618,UBA38DD,23,-1145.2000000000003,20,3,21624.52,20479.32
12619,U5AE162,23,-5789.94,16,7,29290.0,23500.059999999998
12620,U89160F,23,4083.0,11,12,15868.0,19951.0
12621,U86AB71,23,142.7700000000002,21,2,4337.33,4480.1
12622,U7DDD32,23,-14666.0,18,5,48514.0,33848.0
12623,UFD0DCB,23,301.9699999999999,16,7,178.57999999999998,480.55
12624,UCDCCC9,23,830.1000000000004,14,9,13383.9,14214.0
12625,UD4C47E,23,-19658.130000000005,15,8,55769.8,36111.67
12626,U8D00CD,23,-1135.650000000001,12,11,28446.07,27310.42
12627,U9CDF31,23,-320.03999999999996,15,8,9452.900000000001,9132.860000000002
12628,U06E551,23,1302.32,16,7,4238.0,5540.32
12629,U75F736,23,-1587.7700000000004,18,5,25774.879999999997,24187.11
12630,UD5FB97,23,13965.73999999999,20,3,57490.25,71455.98999999999
12631,UE30734,23,-1651.0900000000001,22,1,5190.0,3538.91
12632,U8B4BE1,23,10889.44,18,5,11414.55,22303.989999999998
12633,UD63063,23,1185.4199999999996,19,4,5110.58,6296.0
12634,U70936C,23,-895.0699999999997,17,6,4060.6,3165.5299999999997
12635,UEE9B87,23,110.10999999999967,21,2,4889.89,5000.0
12636,U82D05B,23,447.76000000000005,17,6,5370.150000000001,5817.91
12637,U410E02,23,-924.3399999999965,11,12,110307.34,109383.0
12638,U496B3B,23,1401.7800000000002,18,5,956.12,2357.9
12639,U42A112,23,24519.479999999996,14,9,70004.59,94524.07
12640,U232C74,23,21008.89,17,6,9774.04,30782.93
12641,UFBA2E1,23,-268.08000000000004,21,2,788.08,520.0
12642,U488969,23,-35916.6,17,6,40859.78,4943.18
12643,UBE3B84,23,-1963.7800000000002,23,0,1963.7800000000002,0.0
12644,UDF114F,23,2362.8400000000015,17,6,24204.160000000003,26567.0
12645,U669049,23,9961.01,19,4,3334.2,13295.21
12646,U61C293,23,55484.30999999998,16,7,210901.13999999998,266385.45
12647,U4A1FE0,23,1687.5699999999995,17,6,14857.220000000001,16544.79
12648,UFCEDB8,23,4167.229999999999,16,7,18431.5,22598.729999999996
12649,U65C095,23,-1733.63,19,4,6733.63,5000.0
12650,UE499BA,23,-228.19999999999993,15,8,3026.6300000000006,2798.4300000000003
12651,U07A820,23,-9846.420000000006,14,9,82326.3,72479.88
12652,UF4317C,23,27037.870000000003,16,7,58217.880000000005,85255.75
12653,UDC7FF0,23,7.283063041541027e-14,18,5,12646.0,12646.0
12654,UEA1DB2,23,-32.39000000001397,15,8,409825.18,409792.79000000004
12655,UB8D34D,23,-56804.17999999999,19,4,58578.17999999999,1774.0
12656,UBDDA7B,23,-7417.300000000001,19,4,14082.74,6665.4400000000005
12657,U114E1C,23,10340.039999999995,19,4,20906.66,31246.699999999997
12658,UCC2AD7,23,168.0,19,4,14031.0,14199.0
12659,UC2B4B6,23,420.72999999999956,16,7,20579.77,21000.5
12660,U5131B0,23,440.03,18,5,1727.46,2167.49
12661,UE8357C,23,-6977.939999999999,14,9,20000.98,13023.04
12662,U4CDE38,23,-2.5,17,6,19992.5,19990.0
12663,U608A0F,23,210.4200000000019,16,7,100903.20999999999,101113.62999999999
12664,UAA51B7,23,209.78000000000003,20,3,843.6400000000001,1053.42
12665,U31F742,23,7.459999999999886,13,10,3454.46,3461.92
12666,U53BB56,23,10602.24,14,9,23749.260000000002,34351.5
12667,UEB4B86,23,-15404.51000000001,14,9,169821.95,154417.44
12668,UD9917E,23,-28260.640000000007,17,6,98145.64,69885.0
12669,UBDE3D4,23,14239.42000000001,10,13,302926.16,317165.58
12670,UA85EBE,23,3127.4700000000003,12,11,35804.53,38932.0
12671,U8A0CD7,23,13306.1,18,5,1575.9999999999998,14882.1
12672,UB6E3B2,23,118.01999999999998,20,3,668.0,786.02
12673,UD80EF0,23,-46615.85,20,3,65354.99,18739.14
12674,UD4BC46,23,-15424.839999999998,19,4,31402.839999999997,15978.0
12675,U36B67E,23,793.9699999999998,15,8,4737.66,5531.63
12676,UAAFE99,23,-6623.5199999999995,18,5,51437.83,44814.31
12677,U992623,23,1130.1799999999998,18,5,9587.560000000001,10717.74
12678,UECFA64,23,4101.310000000001,17,6,40022.98,44124.29
12679,U9BDFEF,23,3701.3100000000013,18,5,50253.710000000014,53955.020000000004
12680,UD057AF,23,363.73,15,8,1016.58,1380.31
12681,UEA7435,23,-8668.0,15,8,18946.0,10278.0
12682,UEE1771,23,-3534.8,17,6,6552.0,3017.2
12683,UF3A9ED,23,13302.11,14,9,22970.0,36272.11
12684,U903989,23,-353.8399999999997,18,5,9431.84,9078.0
12685,UE1A358,23,335.83,21,2,213.57,549.4
12686,UA3525B,23,-10137.01,21,2,15778.68,5641.67
12687,UC829D0,23,151.10000000000036,13,10,7758.9,7910.0
12688,U748B57,23,84.89000000000357,12,11,119113.69,119198.58000000002
12689,U880EEC,23,-5959.0,20,3,25402.72,19443.72
12690,U247A29,23,25.48999999999978,15,8,18335.53,18361.02
12691,U7433D6,23,-35040.340000000004,20,3,56017.560000000005,20977.22
12692,U5798C4,23,-5015.18,21,2,12120.02,7104.84
12693,U2CF4E3,23,8315.609999999999,15,8,37180.42,45496.03
12694,UE5ACF8,23,336.78,20,3,2863.23,3200.01
12695,UAFB553,23,73.08000000000015,16,7,1430.5199999999998,1503.6
12696,UC220E3,23,11304.849999999999,14,9,17757.38,29062.23
12697,UE4A3D6,23,-7109.41,20,3,12086.390000000001,4976.98
12698,U42121A,23,42.490000000001146,17,6,12193.439999999997,12235.93
12699,U72B08E,23,-39558.340000000004,22,1,39558.350000000006,0.01
12700,U5FADDE,23,-6420.83,21,2,11120.83,4700.0
12701,U67F3EC,23,-310.5999999999999,21,2,484.3299999999999,173.73000000000002
12702,UCCC63F,23,7653.02,4,19,41400.0,49053.020000000004
12703,U64FE17,23,-102.800000000002,20,3,19744.300000000003,19641.5
12704,U51524E,23,449.7199999999991,21,2,11298.479999999998,11748.2
12705,UA15991,23,-1443.65,22,1,1625.7800000000002,182.13
12706,U3BF328,23,-4292.55,15,8,25753.97,21461.42
12707,UE04482,23,2937.79,21,2,7691.359999999998,10629.15
12708,U5F4C88,23,28040.39,20,3,8620.78,36661.17
12709,UF57E0D,23,-61.40000000000009,16,7,6023.0,5961.6
12710,U8ACE53,23,-16500.12,21,2,17100.14,600.02
12711,UC9054E,23,1218.3999999999978,20,3,31395.6,32614.0
12712,UB8A0EF,23,-3154.75,12,11,6276.7,3121.95
12713,UBA724A,23,2943.8999999999987,17,6,18361.18,21305.08
12714,U3A9E91,23,-166.00000000000182,16,7,27873.339999999997,27707.34
12715,UB6407B,23,10620.169999999998,11,12,27717.09,38337.259999999995
12716,UD374BB,23,561.1700000000029,20,3,15533.559999999996,16094.73
12717,U79237D,23,811.98,20,3,14233.019999999997,15045.0
12718,U3BD584,23,-1472.6299999999997,15,8,9558.63,8086.0
12719,U6C976D,23,-887.8800000000001,13,10,9557.880000000001,8670.0
12720,U8D637A,23,-11169.199999999997,15,8,56645.24,45476.04
12721,U57CE8E,23,-7292.76,19,4,15964.82,8672.06
12722,U802E6E,23,158.54000000000065,17,6,17435.210000000003,17593.75
12723,U46EA0C,23,-2434.2999999999993,11,12,54448.5,52014.200000000004
12724,UDF405E,23,-1508.42,21,2,10967.08,9458.66
12725,UE16095,23,-7360.36,20,3,9908.36,2548.0
12726,UD6F64E,23,487.5999999999999,21,2,5199.4,5687.0
12727,U62AD6C,23,-1674.2100000000005,17,6,4931.8099999999995,3257.6
12728,UA1E5FE,23,529.2999999999998,19,4,5717.53,6246.83
12729,UBF1919,23,628.9900000000036,19,4,25349.83,25978.82
12730,UCC2934,22,1589.51,12,10,1804.03,3393.54
12731,UA251A4,22,-29.590000000000032,19,3,1477.94,1448.35
12732,U5A4B9B,22,-6199.59,12,10,9651.93,3452.34
12733,U83EC81,22,7161.8099999999995,21,1,30310.19,37472.0
12734,U71B30E,22,-20039.510000000002,17,5,69373.5,49333.99
12735,UE0DF36,22,216.8199999999997,13,9,46667.0,46883.82
12736,U123A12,22,306.74999999999983,16,6,4965.17,5271.92
12737,UE19C85,22,-8556.830000000002,22,0,8556.830000000002,0.0
12738,U96E4DA,22,14767.380000000001,19,3,4056.4299999999994,18823.81
12739,U20E619,22,-143.69999999999885,10,12,41107.71,40964.01000000001
12740,UB50909,22,728.4199999999992,15,7,13736.25,14464.669999999998
12741,UE36AC0,22,9526.079999999998,17,5,14837.04,24363.12
12742,U0CD98D,22,-3227.84,18,4,6026.360000000001,2798.52
12743,U241D72,22,179.6300000000001,16,6,6121.4400000000005,6301.07
12744,U2EC4B7,22,5.849999999998548,17,5,20061.76,20067.609999999997
12745,UC91E15,22,-1522.2000000000003,18,4,12648.66,11126.46
12746,U49FE85,22,-8824.74,14,8,13581.94,4757.2
12747,U389529,22,-260.33000000000004,15,7,5040.99,4780.66
12748,UCE747B,22,2.610000000015134,9,13,330000.0,330002.61
12749,U30F3BD,22,58.5600000000004,17,5,2899.44,2958.0
12750,U323237,22,12356.589999999998,20,2,13534.58,25891.17
12751,UE975F7,22,44.13000000000022,14,8,6045.36,6089.49
12752,U4F457D,22,-221.11999999999998,21,1,233.11999999999998,12.0
12753,UC09309,22,-101782.76999999999,14,8,103317.04,1534.27
12754,U05CF16,22,4212.139999999999,16,6,2050.62,6262.76
12755,U10DE60,22,4445.16,17,5,4783.68,9228.84
12756,U9232DE,22,-2148.8400000000006,18,4,2637.34,488.5
12757,U07D6E0,22,-8590.649999999998,21,1,8590.659999999998,0.01
12758,UEF2C66,22,-442.41000000000037,19,3,5327.96,4885.55
12759,U65BE8F,22,280.42999999999995,20,2,503.80000000000007,784.23
12760,U26959A,22,-18137.660000000003,10,12,83836.65999999999,65699.0
12761,UDE01EB,22,15133.09,9,13,52753.0,67886.09
12762,U106D6A,22,6.100000000000364,13,9,35485.4,35491.5
12763,U197D9E,22,-3543.12,18,4,5664.469999999999,2121.35
12764,U530A23,22,589.6399999999996,15,7,2876.96,3466.6
12765,U6B1173,22,3178.260000000001,18,4,5157.360000000001,8335.62
12766,U72920F,22,-1550.21,20,2,1550.49,0.28
12767,U0323B7,22,61.69000000000233,15,7,29105.0,29166.690000000002
12768,U6B29A4,22,-720.1099999999998,12,10,1297.01,576.9000000000002
12769,U5068C7,22,19972.380000000005,14,8,100017.59,119989.97
12770,UFAC17C,22,-6252.280000000002,20,2,7262.280000000002,1010.0
12771,U961D58,22,79.31,20,2,577.7,657.01
12772,UFE0383,22,45.37000000000012,18,4,6590.0,6635.37
12773,U1D79C1,22,-5.684341886080802e-14,10,12,3466.19,3466.1899999999996
12774,U879FDB,22,-51.079999999999956,15,7,6208.000000000002,6156.92
12775,UE8ACCF,22,-315.28999999999996,17,5,53152.29,52837.0
12776,U3B11F5,22,-6390.36,18,4,14120.36,7730.0
12777,UE968B0,22,-4063.920000000009,8,14,116886.81000000001,112822.89
12778,U3A2589,22,2244.34,18,4,17894.54,20138.879999999997
12779,U9C8818,22,-17583.0,8,14,126733.0,109150.0
12780,U1817C4,22,-972.4800000000001,22,0,972.4800000000001,0.0
12781,UC13A5D,22,-52884.86999999998,16,6,126348.03,73463.16
12782,U36DB82,22,1877.0000000000027,13,9,28281.9,30158.9
12783,U73ACD8,22,-295.50000000000006,18,4,2277.4999999999995,1982.0
12784,U8FAC85,22,-14977.319999999949,9,13,1688928.0,1673950.68
12785,UA21BCC,22,-9785.21,15,7,38603.380000000005,28818.170000000002
12786,U5E9E1C,22,-10818.580000000002,14,8,33539.5,22720.92
12787,U72B99C,22,24367.300000000007,18,4,10039.899999999996,34407.2
12788,UF0DF83,22,489.1099999999999,16,6,4911.38,5400.49
12789,U14439B,22,-1847.82,20,2,4744.630000000001,2896.81
12790,U36889D,22,-290.89999999999964,17,5,10366.76,10075.86
12791,U480699,22,-3267.2,19,3,4460.2,1193.0
12792,UDA3BC2,22,-1868.0800000000017,14,8,49268.08,47400.0
12793,U8BB82C,22,-2610.5699999999997,21,1,3500.8800000000006,890.31
12794,U24CB56,22,876.6699999999998,10,12,5978.11,6854.78
12795,UFD6B0E,22,-18655.25,17,5,35021.72000000001,16366.47
12796,UBABADB,22,-1999.9000000000015,11,11,41512.03,39512.130000000005
12797,UE54E19,22,-880.6200000000001,12,10,4989.620000000001,4109.0
12798,UB25470,22,-80207.21,22,0,80207.21,0.0
12799,UB93955,22,-4081.2700000000004,12,10,19393.4,15312.13
12800,U1410E2,22,526.6399999999999,19,3,5173.360000000001,5700.0
12801,U169C55,22,5263.95,11,11,21378.05,26642.0
12802,UACA85E,22,9492.48,12,10,93827.28,103319.76000000001
12803,U3C3A6F,22,-8944.860000000002,19,3,24555.860000000004,15611.0
12804,U83556F,22,-569.9200000000001,20,2,6181.730000000001,5611.8099999999995
12805,U4771EF,22,-151.79999999999995,20,2,798.8,647.0
12806,U45B9EF,22,-304.28,17,5,731.26,426.98
12807,UD9A5E4,22,-12636.519999999997,22,0,12636.519999999997,0.0
12808,UD000E3,22,-1484.72,21,1,2414.6600000000003,929.94
12809,U93E868,22,765.1900000000005,10,12,16061.0,16826.190000000002
12810,UCBFB28,22,8661.57,14,8,26879.63,35541.2
12811,U48E4A0,22,-392.79999999999995,20,2,1171.1,778.3
12812,UB86546,22,-0.23000000000004264,16,6,1844.03,1843.8
12813,U5EF89D,22,-39.21999999999987,19,3,1557.28,1518.06
12814,UE639C1,22,-16130.350000000006,18,4,296130.35,280000.0
12815,U0A05AB,22,-583.7200000000003,20,2,5489.09,4905.37
12816,UF75B35,22,-1982.2700000000002,20,2,6737.27,4755.0
12817,U2000AA,22,1190.0400000000009,13,9,33828.96,35019.0
12818,UFA79A8,22,43564.04000000001,8,14,31048.0,74612.04000000001
12819,U5416F7,22,-792.9700000000004,18,4,5742.7300000000005,4949.759999999999
12820,U27071C,22,1050.9299999999998,16,6,3992.1,5043.03
12821,U27B2CB,22,-1882.2200000000003,20,2,10342.2,8459.98
12822,U4BB88A,22,50848.98999999999,13,9,4286.24,55135.229999999996
12823,UBDA65B,22,1392.44,19,3,8051.5599999999995,9444.0
12824,UB2DF20,22,1863.7400000000002,16,6,398.3,2262.0400000000004
12825,U77B6DC,22,7685.720000000003,16,6,61846.13,69531.85
12826,U471AE5,22,1045.8000000000002,10,12,1065.07,2110.87
12827,UD8304B,22,501.53,19,3,696.8,1198.33
12828,UD648F0,22,97.0899999999998,14,8,11663.94,11761.029999999999
12829,U7FFECF,22,-9593.0,14,8,31729.149999999998,22136.149999999998
12830,U78C6E0,22,1196.5499999999993,16,6,26303.5,27500.05
12831,UA713FD,22,44870.350000000006,14,8,54309.67,99180.01999999999
12832,U76912A,22,-5547.310000000001,14,8,49928.05,44380.74
12833,U6DB074,22,8541.830000000002,21,1,2627.17,11169.0
12834,U4EC1A7,22,0.009999999999990905,15,7,2079.0,2079.01
12835,U1B44BD,22,47077.09999999999,17,5,64073.8,111150.9
12836,U3C56B5,22,-375.0,15,7,8375.0,8000.0
12837,U5002FF,22,-2471.629999999999,17,5,14530.409999999998,12058.78
12838,U1BF6BA,22,97.99999999999982,13,9,23788.170000000002,23886.17
12839,U6120CC,22,5728.01,17,5,10785.17,16513.18
12840,UDCCB0B,22,-2408.100000000001,21,1,9722.100000000002,7314.0
12841,U046C40,22,3.2999999999999474,20,2,1194.0,1197.3
12842,UF444AA,22,2064.0600000000013,19,3,16437.940000000002,18502.0
12843,U7F0BF2,22,5283.67,15,7,7030.08,12313.75
12844,UC39FDA,22,-3816.07,21,1,5243.07,1427.0
12845,U56B20B,22,-3958.88,16,6,7136.88,3178.0
12846,U1D2CBD,22,-0.8099999999994907,16,6,9344.36,9343.55
12847,U1BDBD9,22,1877.9699999999998,17,5,3495.26,5373.23
12848,UA284BD,22,0.0,9,13,10000.0,10000.0
12849,UCCBB58,22,-3517.43,22,0,3517.43,0.0
12850,U05BDBE,22,-7317.95,22,0,7317.95,0.0
12851,U7C2890,22,683.25,6,16,4125.0,4808.25
12852,UF2DF2F,22,424.1999999999998,17,5,10271.1,10695.3
12853,U07A78E,22,-7748.310000000001,17,5,15493.0,7744.689999999999
12854,UB80347,22,2.5499999999992724,18,4,17647.120000000003,17649.67
12855,U8003F2,22,-12923.0,16,6,50208.0,37285.0
12856,UD7EBEE,22,-24271.620000000003,17,5,45465.36,21193.74
12857,U772B31,22,826.8500000000004,17,5,14635.07,15461.92
12858,U41F8F1,22,-4297.9800000000005,18,4,10769.85,6471.870000000001
12859,U898B3E,22,1109.9099999999999,13,9,40490.09,41600.0
12860,UD45905,22,-996.0300000000007,19,3,15350.41,14354.38
12861,U96E7FF,22,-37.339999999999975,20,2,435.44000000000005,398.1
12862,UF9C0E2,22,-6321.219999999998,15,7,7717.699999999999,1396.48
12863,U7710DB,22,5.699999999999932,12,10,13817.840000000002,13823.54
12864,U65C728,22,-2427.4799999999996,19,3,16892.39,14464.91
12865,UD9632C,22,-265.6,17,5,1322.35,1056.75
12866,UDB17F1,22,-1492.2399999999993,18,4,10932.519999999997,9440.28
12867,U0E5B50,22,-9278.740000000002,17,5,56095.54,46816.8
12868,U88BA86,22,-4747.4,21,1,5747.4,1000.0
12869,U19B203,22,-11899.539999999999,20,2,12405.539999999999,506.0
12870,U01AD29,22,-668.2900000000004,14,8,24654.45,23986.16
12871,U068B44,22,-8986.839999999997,20,2,33036.84,24050.0
12872,UBF71D4,22,16.19000000000117,18,4,14819.64,14835.83
12873,UA641D7,22,-149.82999999999993,18,4,3500.0,3350.17
12874,U08EAFB,22,4113.3099999999995,15,7,12488.04,16601.35
12875,U0E3A06,22,-3224.0100000000007,16,6,11210.69,7986.68
12876,U930CCD,22,1522.7999999999984,15,7,8699.57,10222.369999999999
12877,U3DB525,22,405.68999999999994,18,4,2336.05,2741.74
12878,U6FEF84,22,6580.35,20,2,4880.32,11460.67
12879,U5C9C61,22,15514.64,15,7,14879.61,30394.25
12880,U5B7EAC,22,24445.940000000002,16,6,1246.48,25692.420000000002
12881,U99175F,22,34475.009999999995,14,8,56672.200000000004,91147.21
12882,U8C5789,22,-1477.2800000000007,13,9,58078.0,56600.72
12883,U662B38,22,8627.919999999998,12,10,35676.119999999995,44304.04
12884,U778B65,22,-25729.88,22,0,25729.88,0.0
12885,U904C9A,22,-45339.84,16,6,61736.0,16396.16
12886,U936C20,22,1391.5000000000002,20,2,1901.4400000000003,3292.94
12887,U147257,22,-620.6700000000003,19,3,4583.54,3962.87
12888,U40FCB4,22,-253.51000000000005,19,3,1713.1100000000004,1459.6
12889,U65A641,22,-10000.0,11,11,16686.67,6686.67
12890,U49D24D,22,20102.140000000003,14,8,30697.92,50800.06
12891,U203F0A,22,81.10999999999962,19,3,12768.239999999998,12849.349999999999
12892,UBEDB6C,22,-4781.71,20,2,5408.71,627.0
12893,U6B94FB,22,-74.40000000000055,20,2,5164.5,5090.1
12894,UFC5E15,22,196.07999999999993,14,8,4114.0,4310.08
12895,U1EAE30,22,7654.700000000001,14,8,30348.339999999997,38003.04
12896,U9F3218,22,2370.7400000000007,17,5,10247.149999999998,12617.89
12897,U88C693,22,-2010.100000000013,9,13,223350.0,221339.9
12898,U41CE51,22,-12850.25,19,3,14947.830000000002,2097.58
12899,U047661,22,-8093.459999999999,15,7,26785.579999999998,18692.120000000003
12900,U540EB7,22,1663.19,17,5,14916.820000000002,16580.010000000002
12901,UBEBEC0,22,-30554.719999999998,18,4,30664.719999999998,110.0
12902,UE07653,22,760.3300000000014,12,10,25301.32,26061.65
12903,UD14625,22,-1820.670000000002,10,12,50947.0,49126.33
12904,U21FC5F,22,48281.5,15,7,203613.5,251895.0
12905,UC79B18,22,-122.0,13,9,10432.0,10310.0
12906,UE611E8,22,5266.48,16,6,23483.0,28749.48
12907,UA59067,22,9789.500000000002,17,5,7969.05,17758.55
12908,U26EED0,22,3172.5599999999995,9,13,15600.0,18772.559999999998
12909,UB96E91,22,10895.56,19,3,43024.520000000004,53920.08
12910,U98259F,22,-650.79,17,5,1734.12,1083.33
12911,UB84B6A,22,-16589.82,21,1,16645.82,56.0
12912,U5BB1A4,22,886.8,19,3,1281.73,2168.5299999999997
12913,UA19274,22,958.98,18,4,666.02,1625.0
12914,U94451B,22,-7993.599999999999,22,0,7993.599999999999,0.0
12915,U1F5B7B,22,492.0,17,5,57608.0,58100.0
12916,UB83153,22,1798.15,15,7,6003.71,7801.860000000001
12917,UCC7198,22,5350.3600000000015,20,2,961.3999999999999,6311.76
12918,UF05146,22,5461.919999999998,17,5,75073.55,80535.47
12919,UB31E5C,22,108.87999999999978,16,6,3089.9700000000003,3198.8500000000004
12920,U69CE63,22,-184.3899999999998,14,8,8947.4,8763.01
12921,U5F82E1,22,988.55,18,4,1295.4499999999998,2284.0
12922,U22BCB6,22,887.85,16,6,421.15,1309.0
12923,U1D6172,22,136.0,16,6,15909.0,16045.0
12924,UCE59B9,22,-42214.390000000014,22,0,42214.390000000014,0.0
12925,U39FAC5,22,6076.670000000001,16,6,7649.4400000000005,13726.11
12926,U95BE37,22,-7605.62,16,6,7692.62,87.0
12927,U37F136,22,-9853.34,20,2,21053.34,11200.0
12928,U307CFE,22,-25502.88,13,9,42030.479999999996,16527.600000000002
12929,UFD1825,22,1.0,17,5,870.0,871.0
12930,U906159,22,-16036.64,14,8,49000.58,32963.94
12931,U38F089,22,282.69999999999953,19,3,8431.300000000001,8714.0
12932,UC3E164,22,3267.1899999999932,14,8,63549.34000000001,66816.53
12933,U49AB7E,22,-17687.540000000005,18,4,19993.36,2305.82
12934,U01DD02,22,-6805.060000000001,17,5,12780.060000000001,5975.0
12935,U2AB52F,22,-583.1600000000001,17,5,22422.979999999996,21839.82
12936,U2B9807,22,1989.38,11,11,2048.82,4038.2
12937,UA3060A,22,-20347.050000000003,19,3,32098.97,11751.92
12938,UC21A8A,22,24478.039999999997,19,3,26056.69,50534.729999999996
12939,U2D331D,22,-4021.57,20,2,7449.99,3428.42
12940,UC0A86A,22,-263.07000000000033,20,2,4700.04,4436.969999999999
12941,U838A49,22,-6885.050000000001,20,2,6890.68,5.630000000000001
12942,UA253DE,22,5649.429999999999,19,3,4238.41,9887.840000000002
12943,U510CF9,22,-778.0499999999993,15,7,16786.75,16008.7
12944,U9A4111,22,-191.1400000000001,16,6,2025.4000000000003,1834.26
12945,UFF4508,22,424.4200000000001,9,13,15486.5,15910.919999999998
12946,U0A53E7,22,34276.45999999999,12,10,75344.76000000001,109621.22
12947,U9A8B44,22,-3.694822225952521e-13,17,5,3444.3999999999996,3444.3999999999996
12948,U54B86D,22,36612.62000000001,13,9,31831.139999999996,68443.76000000001
12949,UB1CE32,22,-2073.2,18,4,8484.0,6410.8
12950,U815F5D,22,-1355.79,21,1,1356.1599999999999,0.37
12951,UF713DF,22,118905.68000000002,7,15,70922.39,189828.07
12952,U8DC177,22,2748.0599999999977,11,11,31620.4,34368.46000000001
12953,U315BED,22,12.079999999999927,18,4,3902.0,3914.08
12954,U89AF19,22,-1915.8600000000006,17,5,51725.86,49810.0
12955,UEFD83A,22,693.4999999999998,20,2,2244.5,2938.0
12956,UDB7088,22,2477.19,20,2,1988.46,4465.65
12957,U0A953C,22,1833.44,20,2,4166.5599999999995,6000.0
12958,U630337,22,10698.999999999995,17,5,51673.92,62372.92
12959,UE5D4D8,22,539.1800000000021,9,13,151860.01,152399.19
12960,UEDF7C7,22,10.48,13,9,11990.0,12000.48
12961,U2E3353,22,256.7799999999999,20,2,1447.2700000000002,1704.05
12962,UEBD18A,22,16.10000000000001,18,4,397.8299999999999,413.93
12963,U6E4FC1,22,6034.979999999981,15,7,4563780.0,4569814.98
12964,U859194,22,-2958.7800000000007,20,2,16610.0,13651.22
12965,U7C647D,22,16.539999999999964,18,4,2723.06,2739.6000000000004
12966,U864309,22,-5032.580000000001,22,0,5032.580000000001,0.0
12967,U32C44A,22,-3426.13,21,1,3430.9400000000005,4.81
12968,UBBDB8E,22,-16887.25,18,4,72527.5,55640.25
12969,UF542A9,22,36027.329999999994,14,8,12778.710000000001,48806.04
12970,U153114,22,-4351.84,18,4,9878.999999999998,5527.16
12971,U32C350,22,-0.5600000000004002,14,8,5507.700000000001,5507.14
12972,UA9A395,22,174.81000000000012,16,6,1013.6999999999999,1188.5100000000002
12973,U7F20A1,22,1445.0,12,10,36985.0,38430.0
12974,U82FB8F,22,-2088.37,18,4,4088.56,2000.19
12975,UEE1A4F,22,66.11999999999989,14,8,9131.77,9197.89
12976,U4451EA,22,1805.7100000000082,14,8,88249.61,90055.31999999999
12977,UC716A8,22,-6461.0099999999875,18,4,58964.67999999999,52503.67
12978,U9F8F48,22,665.5500000000001,20,2,1834.45,2500.0
12979,U6E403A,22,2655.0500000000006,19,3,7588.73,10243.78
12980,U2088C9,22,329.0799999999997,12,10,64133.05,64462.13
12981,U66D33A,22,-3438.04,20,2,7938.04,4500.0
12982,UDA9918,22,-13469.179999999998,18,4,14519.219999999998,1050.04
12983,U282794,22,17701.610000000008,10,12,197553.76,215255.37
12984,U4B41FA,22,-2770.260000000002,16,6,20463.61,17693.35
12985,U8FED10,22,0.0,19,3,54260.909999999996,54260.91
12986,U5FD899,22,138897.57,11,11,149098.0,287995.57000000007
12987,UDE848F,22,2.2737367544323206e-13,15,7,1372.02,1372.02
12988,U952CB1,22,-17798.81,20,2,20387.43,2588.62
12989,U7BFD51,22,1356.27,15,7,10269.749999999998,11626.02
12990,U1E40BC,22,15099.43,10,12,734.4,15833.83
12991,UF512BE,22,-2624.0200000000004,21,1,2723.92,99.9
12992,UC64B2A,22,2626.97,20,2,3852.81,6479.78
12993,U5922BE,22,-26426.95,14,8,76637.65999999999,50210.71
12994,U22C838,22,352.1,21,1,547.9000000000001,900.0
12995,U32DB3B,22,486.0,11,11,6182.75,6668.75
12996,U336EF2,22,-333.67999999999995,18,4,10673.68,10340.0
12997,U96F372,22,-1650.0,14,8,35756.66,34106.66
12998,UD2B8C9,22,1148.860000000001,15,7,22162.190000000002,23311.05
12999,U8B8F68,22,-20.0,11,11,120020.0,120000.0
13000,UFCA8F2,22,-3461.6199999999994,16,6,15399.210000000001,11937.59
13001,U396B48,22,-234.9999999999999,17,5,8673.09,8438.09
13002,UCA27C9,22,-8356.149999999998,16,6,23648.699999999997,15292.55
13003,UFF835D,22,-100.00000000000003,20,2,1107.82,1007.82
13004,UA9B855,22,9.409999999999982,21,1,490.59000000000003,500.0
13005,UB984C8,22,-5258.85,17,5,6384.72,1125.87
13006,UE9FC7D,22,-528.0,15,7,5450.299999999999,4922.3
13007,U8097DE,22,-535.0,19,3,1435.0,900.0
13008,U2E1C58,22,244198.11000000007,15,7,6936.660000000001,251134.77000000002
13009,U433365,22,-346.2,20,2,1262.2799999999997,916.08
13010,U7DD2FA,22,-1186.1400000000012,13,9,60086.14,58900.0
13011,UDAB35B,22,-307.8,21,1,456.19,148.39
13012,U7F0C9D,22,-7793.909999999999,8,14,14378.96,6585.05
13013,UFC8150,22,3.3599999999996544,12,10,67602.62,67605.98
13014,UB42591,22,-130682.4,20,2,154389.8,23707.4
13015,UDEC484,22,-504.0599999999997,20,2,3899.729999999999,3395.67
13016,UAA7114,22,-4407.71,18,4,8278.8,3871.09
13017,U9C32AE,22,-16522.280000000002,21,1,16522.3,0.02
13018,U203854,22,-10433.080000000002,11,11,69817.0,59383.92
13019,U5F3CAF,22,-5000.720000000001,14,8,29676.21,24675.489999999998
13020,U2F3EDC,22,-236.13999999999942,8,14,54005.46,53769.32
13021,U07A3EC,22,-2797.67,15,7,30007.61,27209.94
13022,U91EE29,22,-31002.42,18,4,57402.42,26400.0
13023,U3CEDEA,22,22522.04,17,5,45372.96,67895.0
13024,UE67209,22,-440.96999999999827,12,10,342941.8,342500.82999999996
13025,U78EFDF,22,-2185.630000000003,9,13,49774.6,47588.97
13026,UFDDB5F,22,3641.67,9,13,14420.83,18062.5
13027,UBEBEDB,22,-9187.539999999999,20,2,15564.93,6377.39
13028,UCE25A5,22,-17254.449999999997,16,6,81853.38,64598.93
13029,UB2AC34,22,19.409999999999748,10,12,8060.589999999999,8080.0
13030,U7A35A1,22,244.3100000000013,14,8,16030.0,16274.31
13031,U58048D,22,-1859.3999999999996,13,9,9263.99,7404.59
13032,U14AC30,21,76.41000000000004,11,10,4817.55,4893.96
13033,UE68992,21,-3653.44,17,4,4654.74,1001.3000000000001
13034,UD3CCF4,21,-312379.77,9,12,874209.0,561829.23
13035,U7C7B75,21,599609.85,1,20,24000.0,623609.85
13036,UD00542,21,-10.0,13,8,54010.0,54000.0
13037,U19CB2B,21,-5545.090000000001,14,7,20484.579999999994,14939.490000000002
13038,UB1D9AA,21,9936.600000000004,18,3,10506.62,20443.22
13039,UD3D1C4,21,340.0,19,2,905.0,1245.0
13040,U24F459,21,-1683.4099999999999,17,4,4470.5599999999995,2787.15
13041,U634E3F,21,1951.6100000000001,19,2,2413.58,4365.1900000000005
13042,UADD816,21,-5565.339999999999,21,0,5565.339999999999,0.0
13043,U343901,21,-968.4,15,6,2013.9,1045.5
13044,U56721F,21,-2996.1899999999996,17,4,18629.190000000002,15633.0
13045,U23DEE7,21,1375.44,14,7,3744.06,5119.5
13046,U6A9ECC,21,-3272.77,17,4,3293.5699999999997,20.8
13047,UB69D76,21,47318.639999999985,15,6,298090.2,345408.83999999997
13048,U035CC8,21,-694.9000000000005,12,9,10419.56,9724.66
13049,UBEA596,21,-978.7199999999985,15,6,24077.989999999998,23099.27
13050,U4A6663,21,0.1000000000003638,11,10,25999.9,26000.0
13051,UAF03D7,21,-3395.76,17,4,8087.76,4692.0
13052,U7FB3AB,21,-2986.0000000000005,20,1,5967.47,2981.47
13053,UBCB655,21,-680.6400000000002,19,2,6105.68,5425.04
13054,U36389A,21,-1.1199999999998909,10,11,7998.0,7996.88
13055,UAA2D4F,21,2776.6699999999996,16,5,7323.43,10100.1
13056,U0F3DE6,21,-520.3399999999999,18,3,1227.49,707.15
13057,U5A3424,21,-955.9000000000013,14,7,33055.96,32100.06
13058,U18E88A,21,-3577.74,15,6,5883.5199999999995,2305.78
13059,UC1B09D,21,236.89999999999995,10,11,5299.5,5536.400000000001
13060,U7B5E01,21,3988.490000000001,17,4,2062.32,6050.8099999999995
13061,U43F062,21,1946.5200000000016,16,5,12637.49,14584.01
13062,U5D38E7,21,2632.709999999998,9,12,33509.84,36142.55
13063,U4A09B0,21,600.7199999999997,13,8,11082.720000000001,11683.44
13064,UA30A8E,21,-13528.42,20,1,13529.76,1.34
13065,UF240A0,21,27.110000000000003,18,3,1481.7800000000002,1508.89
13066,U98B4FB,21,-21978.14,19,2,30978.14,9000.0
13067,U456141,21,1847.86,18,3,22752.14,24600.0
13068,U2B6B64,21,-107.71999999999844,11,10,24917.999999999996,24810.28
13069,U899AFB,21,2.0600000000004,12,9,13288.04,13290.1
13070,UEA4BB2,21,-11928.26,14,7,25308.67,13380.41
13071,UF56F8E,21,454.7800000000002,19,2,4815.77,5270.55
13072,UC31CC6,21,-17795.170000000002,10,11,67942.9,50147.73
13073,U069892,21,-18645.540000000023,8,13,212877.18,194231.64
13074,U3E4A36,21,-73042.95999999999,17,4,156540.6,83497.64
13075,UBC132A,21,9090.52,15,6,18575.940000000002,27666.46
13076,UE89387,21,150.39999999999964,15,6,11655.6,11806.0
13077,U74ACC8,21,-3545.0499999999997,14,7,6130.12,2585.0699999999997
13078,U2C22B0,21,-689.0299999999988,15,6,13491.869999999999,12802.84
13079,U86032E,21,-1308.3399999999997,17,4,15425.1,14116.759999999998
13080,U1CDD6D,21,-14288.91,12,9,50387.369999999995,36098.46
13081,U45B6D5,21,7564.940000000005,15,6,44731.229999999996,52296.17
13082,UE19390,21,2075.8100000000004,18,3,294.19,2370.0
13083,UDEE5B1,21,7452.980000000001,16,5,6419.239999999999,13872.220000000001
13084,U95C06F,21,-19407.770000000004,18,3,19727.800000000003,320.03
13085,U0C4973,21,-49.5299999999999,13,8,1141.68,1092.15
13086,U41FE87,21,1639.0700000000015,12,9,43347.92999999999,44987.0
13087,U680898,21,-7509.449999999992,13,8,93884.54999999999,86375.1
13088,U4F68C3,21,11996.869999999999,16,5,18867.380000000005,30864.25
13089,U5DE7E1,21,-143.0,20,1,376.1,233.1
13090,UEE474B,21,-2310.7499999999854,14,7,254359.32,252048.57
13091,U489C27,21,102.1300000000002,19,2,3329.1699999999996,3431.3
13092,U457B6C,21,-5994.619999999999,16,5,10099.679999999997,4105.0599999999995
13093,U60C125,21,-24114.42,16,5,25412.35,1297.93
13094,U779D21,21,-714.5,13,8,39508.68000000001,38794.18
13095,U125291,21,15902.899999999998,19,2,16029.099999999999,31932.0
13096,UF74F7E,21,-636.6700000000002,19,2,6138.54,5501.87
13097,U04971E,21,2229.0,12,9,7171.0,9400.0
13098,UBBAE43,21,16096.78,9,12,273.51,16370.289999999999
13099,UAA5CDC,21,-288.8900000000001,18,3,1833.18,1544.29
13100,U10D7CA,21,406.2499999999991,8,13,64532.939999999995,64939.189999999995
13101,UB37756,21,-0.6400000000012084,11,10,19559.600000000006,19558.96
13102,U9BDF9D,21,-0.8999999999999773,13,8,785.9,785.0
13103,UC001DD,21,1229.5000000000002,17,4,4452.879999999999,5682.38
13104,U8C431E,21,-4595.250000000001,20,1,5795.250000000001,1200.0
13105,U61726A,21,24.060000000000073,13,8,1086.55,1110.6100000000001
13106,U713B14,21,-4830.620000000002,18,3,36632.83,31802.21
13107,U66B166,21,-818.3399999999998,16,5,2129.17,1310.8300000000002
13108,UB04034,21,-12275.41,18,3,24860.65,12585.24
13109,U6660D1,21,-1141.620000000002,17,4,24859.620000000003,23718.0
13110,UDDED05,21,25.299999999999994,18,3,45.69999999999999,71.0
13111,U52C4A3,21,-2830.0299999999997,18,3,10431.28,7601.25
13112,U0BBACB,21,107.5,14,7,1046.13,1153.6299999999999
13113,U0B4210,21,-6636.129999999999,18,3,13886.2,7250.07
13114,U8C9D07,21,8942.59,16,5,7047.84,15990.43
13115,U284963,21,-815.54,12,9,32352.99,31537.45
13116,UE57CE8,21,34085.09999999999,13,8,7452.79,41537.89
13117,UCD5875,21,2633.66,17,4,6613.480000000001,9247.14
13118,U54DF76,21,37908.600000000006,13,8,93371.51999999999,131280.12
13119,U1DBB0E,21,16627.699999999993,19,2,2196.1800000000003,18823.88
13120,U3F113E,21,3973.1499999999996,19,2,1534.95,5508.099999999999
13121,UA726EC,21,-2999.9999999999964,11,10,54816.59,51816.590000000004
13122,UD73D6B,21,95.0,0,21,0.0,95.0
13123,UFFF623,21,215.68999999999997,18,3,1049.1799999999998,1264.87
13124,U92F7B1,21,-6030.460000000001,19,2,9030.460000000001,3000.0
13125,U8E9241,21,569.88,18,3,3305.6200000000003,3875.5
13126,UBDA94C,21,-21285.53,15,6,50317.439999999995,29031.91
13127,U06AD9D,21,-222.32999999999993,9,12,10509.59,10287.26
13128,UE7A206,21,-278.46000000000004,14,7,10999.79,10721.33
13129,U3D0918,21,-4241.029999999999,13,8,73327.5,69086.47
13130,U314858,21,-10509.29,14,7,35109.7,24600.41
13131,U0077CF,21,-476.86999999999966,15,6,3083.32,2606.4500000000003
13132,U612EB8,21,-330.95000000000164,14,7,19990.66,19659.71
13133,U745C32,21,121.41999999999996,18,3,768.09,889.51
13134,U57D6F0,21,-22166.670000000002,18,3,31730.47,9563.8
13135,UF3E2BD,21,-3172.92,17,4,4322.240000000001,1149.32
13136,UFF41D1,21,-717.5799999999999,14,7,1690.16,972.5799999999999
13137,UC69EE1,21,-798.63,17,4,2213.66,1415.03
13138,U2052A5,21,623.8799999999999,17,4,14155.92,14779.8
13139,U654215,21,-23192.739999999998,14,7,47912.97,24720.23
13140,UC789CF,21,-3043.0,17,4,12286.76,9243.76
13141,UDD3B90,21,40.0,15,6,10010.0,10050.0
13142,U53831A,21,1746.5100000000002,12,9,1085.6599999999999,2832.17
13143,U1CCCD3,21,3200.0,17,4,10933.1,14133.1
13144,UA24CE7,21,-4260.75,8,13,90400.0,86139.25000000001
13145,U5F2568,21,32432.18000000002,8,13,633008.73,665440.9099999999
13146,U5E6B05,21,-214.36,16,5,973.25,758.8900000000001
13147,U8859B6,21,-3.6300000000010186,17,4,15534.94,15531.31
13148,U25EA57,21,-8456.64,17,4,29306.66,20850.02
13149,U5911B2,21,-15285.18,14,7,36808.0,21522.82
13150,UBA29F2,21,3015.469999999992,11,10,454217.58999999997,457233.06
13151,U0A22FD,21,-4005.9900000000007,18,3,8965.760000000002,4959.77
13152,UF3EE40,21,-23975.1,13,8,71600.44,47625.34
13153,UFEE033,21,-7.330000000000837,19,2,12083.58,12076.25
13154,UA7818F,21,1781.5600000000013,15,6,15031.210000000001,16812.77
13155,U43286A,21,270.0999999999988,17,4,17334.64,17604.74
13156,U866890,21,-624.9599999999991,13,8,27340.96,26716.0
13157,U8D52CE,21,50.99999999999994,17,4,645.03,696.03
13158,U5CBC31,21,10967.660000000002,16,5,2083.23,13050.89
13159,UB6A35E,21,-1.9895196601282805e-13,16,5,7072.3,7072.3
13160,UB34B3A,21,-17.44999999999891,14,7,24908.36,24890.91
13161,U6D1BA1,21,773.8000000000005,16,5,11728.710000000001,12502.51
13162,U4D134A,21,445.9000000000001,17,4,4419.0,4864.9
13163,UCE1134,21,10326.130000000001,18,3,55573.87,65900.0
13164,U8C7C54,21,18000.0,12,9,484.51,18484.51
13165,U167C88,21,180.85999999999973,11,10,28752.8,28933.66
13166,UA7851D,21,-1048.93,14,7,5676.740000000001,4627.8099999999995
13167,UFADE6B,21,-292.0,16,5,16003.8,15711.8
13168,U2157CA,21,13632.1,15,6,5081.16,18713.260000000002
13169,U23F024,21,-8215.560000000001,20,1,8315.560000000001,100.0
13170,U6AAE70,21,72.11000000000001,17,4,754.8899999999999,827.0
13171,U84E2DD,21,0.0,14,7,30516.0,30516.0
13172,U52D791,21,-496.33000000000004,19,2,2066.55,1570.22
13173,UB9750E,21,-7777.74,19,2,7882.74,105.0
13174,UE94F67,21,-3066.11,17,4,6780.279999999999,3714.17
13175,U2AD6D7,21,2069.62,12,9,1513.01,3582.6300000000006
13176,U76F954,21,-382.0,16,5,15593.0,15211.0
13177,U4FA3B6,21,-581.4299999999998,13,8,8723.83,8142.4
13178,UA1ED5C,21,7.0,11,10,27993.0,28000.0
13179,UBA7A52,21,0.020000000000436557,10,11,20000.0,20000.02
13180,U5A128A,21,458.9999999999982,18,3,8851.68,9310.68
13181,U3BDE21,21,5295.949999999993,14,7,136180.49999999994,141476.45
13182,UE4FFDD,21,-179.8500000000006,16,5,20179.86,20000.01
13183,U8DFFB5,21,-3065.000000000002,15,6,44993.9,41928.9
13184,UADA035,21,119.4999999999996,13,8,5281.27,5400.77
13185,UE41AF0,21,-4166.54,18,3,5702.88,1536.34
13186,UF08C7C,21,-4280.499999999999,19,2,9758.699999999999,5478.2
13187,U8F3EA7,21,-6426.949999999999,16,5,10689.78,4262.83
13188,U77C2E1,21,-1522.1299999999997,17,4,5008.85,3486.7200000000003
13189,U52CF0A,21,-3898.6000000000004,17,4,4395.610000000001,497.01000000000005
13190,U4F9DC6,21,2751.839999999999,11,10,16428.559999999998,19180.4
13191,UD924C2,21,-87.47999999999956,17,4,7716.0,7628.52
13192,UDE4466,21,-16017.76,18,3,20217.82,4200.06
13193,U6E9031,21,-300.0299999999997,20,1,6862.9800000000005,6562.95
13194,UC28584,21,-2601.97,17,4,4505.72,1903.75
13195,UEA1763,21,-2045.68,18,3,2447.9000000000005,402.21999999999997
13196,U8888CF,21,-4678.33,16,5,22367.339999999997,17689.010000000002
13197,U7E15AA,21,1136.02,15,6,1426.08,2562.1000000000004
13198,U5348DE,21,762.3599999999997,12,9,24799.64,25562.0
13199,U9BAC9D,21,3.2599999999997635,19,2,1295.8000000000002,1299.06
13200,U895A25,21,592.7800000000001,17,4,2437.87,3030.65
13201,U70A20A,21,7378.770000000002,18,3,36665.0,44043.770000000004
13202,U471671,21,844.1899999999999,17,4,24.800000000000004,868.99
13203,UF0B583,21,-3370.46,18,3,4870.469999999999,1500.01
13204,UC9FD50,21,-16122.0,14,7,30944.0,14822.0
13205,UAE877A,21,-1848.21,17,4,3214.2200000000003,1366.01
13206,U9AE81C,21,-2026.4900000000002,19,2,2362.4900000000002,336.0
13207,U3620FF,21,-100.42,16,5,100970.70999999999,100870.29
13208,UE45631,21,21718.67,9,12,7703.21,29421.88
13209,UB98E4C,21,-1258.6800000000005,17,4,11429.36,10170.68
13210,U2E6F0F,21,75009.79000000001,11,10,31017.99,106027.78
13211,U79C51E,21,-1595.8000000000006,19,2,11833.589999999998,10237.79
13212,U5F836F,21,-513.0,9,12,19481.0,18968.0
13213,U025BFF,21,448.48,10,11,399.87,848.3499999999999
13214,U2CD143,21,244.60000000000022,19,2,1816.1799999999998,2060.78
13215,U8EB42A,21,-521.76,16,5,1419.4099999999999,897.65
13216,U696A45,21,-389.7900000000004,19,2,3557.92,3168.13
13217,U986C14,21,2839.95,18,3,8114.05,10954.0
13218,U42CF80,21,-10188.0,20,1,10238.0,50.0
13219,U089724,21,46205.67,4,17,61677.0,107882.66999999998
13220,U9FBE7C,21,3683.6499999999983,14,7,8059.770000000001,11743.42
13221,UE90E2F,21,-13529.13,17,4,21329.13,7800.0
13222,UC33C68,21,16555.66,17,4,2792.71,19348.37
13223,U5E2F17,21,8959.0,14,7,23841.0,32800.0
13224,U7ECB7C,21,3921.0,17,4,11707.96,15628.96
13225,UF7717D,21,451.6999999999998,18,3,6064.5,6516.2
13226,UFBAEA7,21,-3697.000000000002,9,12,73003.2,69306.2
13227,U56C47D,21,-1133.0800000000017,15,6,76526.0,75392.92
13228,U7FDE91,21,-3122.37,17,4,9434.85,6312.48
13229,U623A2B,21,-6131.08,20,1,6894.58,763.5
13230,U8C673D,21,797.4999999999995,18,3,4511.52,5309.0199999999995
13231,UE0FAE1,21,0.0,13,8,40000.0,40000.0
13232,U4C9770,21,7410.9000000000015,18,3,10209.61,17620.510000000002
13233,UB970FE,21,77.01,13,8,475.2,552.21
13234,U7023A7,21,89.41999999999993,19,2,743.58,833.0
13235,U432B8B,21,19746.759999999995,9,12,60369.61,80116.37
13236,UE49680,21,2276.97,12,9,7788.14,10065.11
13237,U163C16,21,-4599.199999999997,16,5,56702.0,52102.8
13238,UDBA797,21,577.0300000000001,19,2,4055.8,4632.83
13239,U33259C,21,1637.6499999999996,12,9,14044.7,15682.349999999999
13240,UBCE71F,21,-2589.27,17,4,9469.99,6880.72
13241,U033A50,21,2396.5899999999997,20,1,997.6,3394.19
13242,U1D7C6E,21,48479.229999999996,17,4,134833.47,183312.7
13243,UCF1474,21,-4889.830000000001,21,0,4889.830000000001,0.0
13244,U098901,21,-10485.880000000001,20,1,12184.18,1698.3
13245,UD0969E,21,9426.32,15,6,49520.29,58946.61
13246,U659409,21,-4036.2999999999984,19,2,19850.87,15814.57
13247,U788636,21,4039.619999999999,19,2,3381.56,7421.18
13248,UD3A2EA,21,970.9500000000003,19,2,3497.2799999999997,4468.2300000000005
13249,U3DF34E,21,43934.03999999999,15,6,9185.0,53119.04
13250,UB568AF,21,-5341.32,19,2,5821.39,480.07
13251,U061775,21,548.7099999999973,9,12,45646.0,46194.71
13252,U611642,21,-24987.18,14,7,133963.18,108976.0
13253,UABA92A,21,-1952.8000000000002,21,0,1952.8000000000002,0.0
13254,U6493B3,21,-1981.79,20,1,2001.6,19.81
13255,U536967,21,1173.0699999999993,16,5,2402.38,3575.45
13256,U72EA4D,21,-4273.969999999999,18,3,5254.97,981.0
13257,U1C1998,21,3553.5,15,6,7871.039999999999,11424.54
13258,UF7DB78,21,-26748.700000000004,12,9,97684.74999999999,70936.05
13259,U5ACE1B,21,-3726.14,16,5,7044.829999999999,3318.69
13260,U93357B,21,16694.340000000004,11,10,89287.65000000001,105981.99
13261,UF87739,21,-2622.52,21,0,2622.52,0.0
13262,UB8EE9C,21,795.91,11,10,86124.0,86919.91
13263,UE983CF,21,-294.9499999999997,19,2,2044.95,1750.0
13264,UC8E9A5,21,-755.0,16,5,4722.6900000000005,3967.69
13265,U18CAC3,21,857.46,17,4,3906.5,4763.96
13266,UF07EAF,21,-10399.560000000001,20,1,10515.560000000001,116.0
13267,U87873F,21,5.200000000000728,11,10,70414.8,70420.0
13268,UA5383D,21,2224.03,16,5,16311.39,18535.42
13269,UED26FA,21,2890.34,14,7,25121.82,28012.16
13270,U5240AD,21,-37292.619999999995,20,1,38292.619999999995,1000.0
13271,UE17F7D,21,-820.2000000000003,20,1,2106.2000000000003,1286.0
13272,U58F02C,21,1295.0,15,6,18705.0,20000.0
13273,U520846,21,-17118.660000000003,18,3,21555.13,4436.47
13274,U764508,21,110.09999999999991,14,7,9739.9,9850.0
13275,U7D2E52,21,3187.0,13,8,86813.0,90000.0
13276,UB0219B,21,2999.0,18,3,730.03,3729.0299999999997
13277,UD35D69,21,-18.75,16,5,338.0,319.25
13278,U8B1F0B,21,-13145.0,16,5,23832.36,10687.36
13279,U651471,21,5803.569999999997,16,5,26220.2,32023.77
13280,UE04D47,21,-42356.04000000001,19,2,55956.04000000001,13600.0
13281,U77434C,21,15301.0,16,5,25298.240000000005,40599.24
13282,U548F12,21,-2637.52,15,6,2856.73,219.20999999999998
13283,UD24537,21,-20833.289999999997,18,3,36404.87,15571.58
13284,UF5A48A,21,2487.34,18,3,2105.66,4593.0
13285,U00BFC5,21,40143.439999999995,8,13,16468.420000000002,56611.86
13286,U009C8A,21,-289.05999999999995,13,8,3095.67,2806.6099999999997
13287,U1BFA70,21,1466.0700000000002,18,3,4082.9699999999993,5549.04
13288,U73B8C7,21,-899.49,20,1,899.9000000000001,0.41
13289,UD31509,21,3887.5000000000005,16,5,11834.31,15721.81
13290,UD24873,21,120499.1,8,13,55028.020000000004,175527.12
13291,U1C65B3,21,-347.64,16,5,1265.9,918.26
13292,UF0EB91,21,-1373.1100000000024,16,5,19364.499999999996,17991.39
13293,UEF5019,21,-1939.96,14,7,8389.96,6450.0
13294,U11FBE9,21,-286.84,16,5,303.79,16.950000000000003
13295,U13A194,21,-1655.09,18,3,1955.02,299.92999999999995
13296,U3F0CCB,21,-48.08999999999999,19,2,995.74,947.65
13297,U3F1FCE,21,2248.41,14,7,8079.780000000001,10328.19
13298,U341FB0,21,39.30999999999994,11,10,4865.67,4904.9800000000005
13299,U487D8B,21,-27540.030000000006,18,3,69915.03,42375.0
13300,U215F89,21,5118.58,11,10,528.3,5646.879999999999
13301,U61F79F,21,13390.580000000004,16,5,8362.420000000002,21753.0
13302,U9370C1,21,18005.48,10,11,64883.170000000006,82888.65000000001
13303,U0BD53B,21,1226.5700000000002,14,7,9420.150000000001,10646.720000000001
13304,UCDB12B,21,21714.63,14,7,8153.18,29867.81
13305,U58A781,21,18441.07,19,2,1483.17,19924.239999999998
13306,U0D199D,21,3122.1100000000006,16,5,28396.8,31518.91
13307,U9487E2,21,-8536.449999999999,18,3,14140.0,5603.55
13308,U702355,21,-306.0999999999998,18,3,5037.3,4731.2
13309,UABBE08,21,-28.979999999999563,12,9,16761.0,16732.02
13310,UE88026,21,-13887.939999999999,16,5,49956.79,36068.850000000006
13311,UB4F554,21,-10037.150000000003,15,6,35765.76,25728.61
13312,U7243DF,21,58900.55,8,13,3479.59,62380.14
13313,UE1EF53,21,4100.01,5,16,945.5899999999999,5045.6
13314,UE91479,21,957.9399999999998,11,10,15521.4,16479.34
13315,UEBB737,21,-387.0,12,9,10946.0,10559.0
13316,U3B2E31,21,-3780.51,14,7,11802.140000000001,8021.630000000001
13317,UF9E806,21,-7485.780000000001,18,3,9195.86,1710.0800000000002
13318,U5CF7F9,21,-61.25999999999988,17,4,2594.96,2533.7
13319,U782369,21,38294.590000000004,13,8,17684.11,55978.7
13320,UFEF40F,21,482.03999999999996,16,5,4008.0099999999998,4490.05
13321,U32BB37,21,823.9300000000003,10,11,53660.0,54483.93
13322,UB1E63F,21,-546.8499999999979,19,2,30551.14,30004.29
13323,U88FC86,21,1283.2000000000007,17,4,9061.91,10345.11
13324,UD4102B,21,-10182.029999999999,19,2,37533.35,27351.32
13325,U0E4484,21,0.0,18,3,2589.3100000000004,2589.31
13326,U84F8F3,21,-1964.0999999999997,20,1,5325.159999999999,3361.06
13327,UE8D691,21,4785.18,14,7,6555.57,11340.75
13328,U61528B,21,3287.8399999999965,9,12,107483.66,110771.5
13329,U5C3CC4,21,-30317.85,19,2,31393.35,1075.5
13330,UB332E1,21,559.68,19,2,76.32,636.0
13331,UF570A0,21,413.65,18,3,1045.51,1459.16
13332,U8FC374,21,-2240.210000000001,19,2,5406.950000000001,3166.74
13333,UD15FB4,21,-3.8900000000003274,13,8,7870.950000000001,7867.06
13334,U234A7C,21,-1104.1699999999996,18,3,6464.169999999999,5360.0
13335,U2DCBFC,21,-33.090000000000146,18,3,5867.0,5833.91
13336,U17E929,21,-704.7499999999998,15,6,1346.5999999999997,641.85
13337,U86AEB5,21,49999.649999999994,11,10,102610.99999999999,152610.65
13338,U4594DC,21,2050.0800000000004,17,4,5558.860000000001,7608.94
13339,UEFA0D0,21,-9857.0,18,3,29959.0,20102.0
13340,UE6E04C,21,-17609.419999999995,12,9,73677.32,56067.899999999994
13341,U697256,21,-657.5200000000004,13,8,9453.9,8796.380000000001
13342,UD9C78E,21,954.1200000000003,18,3,14801.5,15755.62
13343,U8137BF,21,-49705.15,17,4,88048.59,38343.44
13344,U5D4198,21,6914.490000000001,15,6,10975.449999999999,17889.94
13345,U33AF21,21,3113.52,18,3,5486.48,8600.0
13346,U2468E4,21,605.8099999999993,18,3,14094.2,14700.01
13347,U3263E8,21,1951.81,18,3,448.24,2400.05
13348,U5C2833,21,23985.5,9,12,72296.0,96281.5
13349,U976814,21,-45240.66,18,3,48251.0,3010.34
13350,U910EEF,21,-343.1500000000003,18,3,6066.39,5723.24
13351,UF09189,21,-7484.96,18,3,16949.96,9465.0
13352,U157299,21,40503.87,15,6,13594.959999999997,54098.83
13353,U05B3D3,21,-1115.17,17,4,2953.95,1838.78
13354,U43AF6F,21,353.2200000000001,18,3,966.78,1320.0
13355,UF7D10D,21,-6068.360000000001,15,6,36239.36,30171.0
13356,U9334D5,21,736.3399999999999,17,4,6013.66,6750.0
13357,UD14F7D,21,-276.0,21,0,276.0,0.0
13358,U8261E1,21,17347.3,15,6,43552.7,60900.0
13359,U06406D,21,-6171.0599999999995,18,3,7171.4,1000.34
13360,UCDE27C,21,0.5800000000031287,11,10,95864.47999999998,95865.06
13361,UD92662,21,-2551.460000000001,13,8,6455.170000000001,3903.71
13362,U197D00,21,-104.92000000004191,11,10,703378.16,703273.24
13363,U4F9288,21,820.7999999999996,15,6,10684.8,11505.6
13364,UF66206,21,-3318.9899999999993,19,2,4136.25,817.26
13365,UEE80EC,21,5235.269999999999,13,8,25255.26,30490.53
13366,U88EFBA,21,-69307.41,17,4,84914.24,15606.83
13367,UAD8BBD,21,993.0,10,11,5507.0,6500.0
13368,U2FDBDC,21,-11254.48,19,2,15606.48,4352.0
13369,U03AEA2,21,-74.60999999999997,16,5,680.94,606.33
13370,U7E35F0,21,4233.36,19,2,1266.6399999999999,5500.0
13371,U1EA3FC,21,-155.99999999999977,16,5,13553.630000000001,13397.63
13372,U948374,21,-12.16999999999999,14,7,3345.2,3333.03
13373,UD1B15E,21,8822.769999999997,7,14,42293.32,51116.09
13374,UAAC192,21,1084.4,17,4,7810.6,8895.0
13375,U2A3C75,21,-872.9000000000001,15,6,5711.38,4838.48
13376,UAC5747,21,-52257.94,16,5,67306.0,15048.06
13377,UC7C67B,21,0.32999999999995566,15,6,324.08000000000004,324.40999999999997
13378,U11EB1A,21,15197.769999999999,10,11,20477.780000000002,35675.55
13379,UDC86A1,21,12371.03,12,9,9699.4,22070.43
13380,U0C2D23,21,582.4,11,10,2918.53,3500.9300000000003
13381,UE6BF7B,21,0.0,13,8,26000.0,26000.0
13382,U04B5FE,21,480.9000000000001,19,2,1319.1,1800.0
13383,U674252,21,802.3699999999999,17,4,10236.22,11038.59
13384,U9EF74F,21,-189.2499999999992,11,10,41112.259999999995,40923.01
13385,UC6A2D9,21,1.7000000000005002,17,4,9918.490000000002,9920.19
13386,UFBC9FC,21,80.4899999999999,19,2,3986.51,4067.0
13387,UCE17AB,21,2000.4700000000003,11,10,9652.09,11652.56
13388,U55A5BF,21,4028.6100000000006,16,5,13922.819999999998,17951.43
13389,U50980B,20,1201.6300000000006,15,5,43594.10999999999,44795.740000000005
13390,UD01FED,20,-1299.9699999999996,17,3,9964.619999999999,8664.65
13391,U741373,20,49.98999999999978,13,7,23219.699999999997,23269.69
13392,UE66D74,20,-1689.7800000000002,12,8,7769.78,6080.0
13393,UE1F061,20,-4216.0,12,8,78926.0,74710.0
13394,UAD9940,20,12331.169999999998,15,5,16295.0,28626.17
13395,U0886C0,20,-537.35,13,7,1183.3500000000001,646.0000000000001
13396,UA82490,20,82106.42,6,14,89020.0,171126.41999999998
13397,U59B029,20,-4738.84,20,0,4738.84,0.0
13398,U2166EB,20,-9136.79,16,4,11090.01,1953.22
13399,UF54E17,20,-15302.220000000001,12,8,49477.91,34175.69
13400,U206798,20,-513.3399999999999,15,5,8531.75,8018.41
13401,UE17A94,20,-2978.6499999999996,15,5,6298.8,3320.15
13402,U48D23B,20,-2747.1200000000003,14,6,3057.1200000000003,310.0
13403,U26EC28,20,-28384.940000000006,11,9,64718.899999999994,36333.96
13404,U9BE37E,20,27988.800000000003,15,5,44533.2,72522.0
13405,U25298E,20,5520.76,13,7,11034.599999999999,16555.360000000004
13406,U805497,20,-274.4799999999999,18,2,750.3299999999999,475.85
13407,U031DD2,20,15106.78,13,7,22625.820000000003,37732.6
13408,U9DCF8A,20,-412.9499999999998,16,4,8435.28,8022.33
13409,UE6F81D,20,0.0,10,10,45980.0,45980.0
13410,U2ABB5D,20,2593.029999999999,12,8,49475.0,52068.03
13411,U9FDC90,20,-1348.0400000000009,15,5,8065.540000000001,6717.5
13412,UB48F49,20,-7515.62,20,0,7515.62,0.0
13413,U61F750,20,74099.56,10,10,744086.05,818185.6100000001
13414,U7E66C2,20,1497.4200000000005,16,4,4341.68,5839.1
13415,UD41B1C,20,-6993.269999999999,14,6,17643.11,10649.84
13416,UE52740,20,-97.99999999999909,16,4,17221.739999999998,17123.74
13417,U5F7F75,20,1763.2599999999995,13,7,10222.21,11985.47
13418,UF0D5E8,20,48978.66999999996,12,8,771185.13,820163.8
13419,UAB1932,20,-2027.4100000000003,13,7,8153.41,6126.0
13420,U84F257,20,-18.98999999999978,15,5,4619.24,4600.25
13421,UDF7650,20,-80.68,14,6,533.6400000000001,452.96000000000004
13422,UEDB71B,20,24.0,10,10,19976.0,20000.0
13423,UAEF1E7,20,-1000.72,15,5,2379.71,1378.99
13424,U98D9C4,20,2753.4000000000005,12,8,9846.529999999999,12599.93
13425,UC9D5DC,20,625.1200000000003,16,4,3195.08,3820.2000000000003
13426,UED50DE,20,-12.399999999999782,18,2,4240.3099999999995,4227.91
13427,U95DF88,20,-4398.360000000001,20,0,4398.360000000001,0.0
13428,U94F051,20,65947.59999999999,14,6,25654.160000000003,91601.76000000001
13429,UBA66E0,20,-1733.2699999999995,13,7,17576.11,15842.840000000002
13430,UAE778A,20,-7099.35,18,2,15586.350000000002,8487.0
13431,U0689EE,20,3991.5800000000004,13,7,6233.09,10224.67
13432,UBE5FFC,20,2472.9,14,6,1332.9199999999998,3805.8199999999997
13433,U60AFF5,20,-5108.4000000000015,9,11,47344.399999999994,42236.0
13434,UF64038,20,547.56,13,7,1162.7,1710.26
13435,U1545B1,20,-565.66,12,8,5540.160000000001,4974.5
13436,U1AC295,20,0.0,10,10,69701.0,69701.0
13437,U72F84B,20,-8744.95,17,3,9752.180000000002,1007.2300000000001
13438,U633B5E,20,-50063.969999999994,16,4,87336.32,37272.350000000006
13439,U0D5A6D,20,-1891.4100000000008,13,7,26636.05,24744.639999999996
13440,UB8F429,20,475.3800000000001,11,9,22204.32,22679.7
13441,U5C0253,20,-1536.1800000000003,17,3,3553.36,2017.1799999999998
13442,UDDDBC5,20,-7587.66,10,10,16466.59,8878.93
13443,U69FA27,20,113.33999999999975,11,9,5411.33,5524.67
13444,U33D685,20,91.29999999999984,12,8,2084.41,2175.71
13445,UEA85D5,20,-3364.95,16,4,16886.0,13521.05
13446,UF4779C,20,174.31999999999982,18,2,1685.68,1860.0
13447,U3674A3,20,-21778.5,13,7,94283.07,72504.57
13448,U875996,20,-1879.56,12,8,2101.39,221.82999999999998
13449,U989D3B,20,-62306.03999999999,10,10,83475.9,21169.86
13450,UC0B815,20,-2269.4100000000003,18,2,3664.7800000000007,1395.37
13451,UE15CA7,20,270.1999999999998,17,3,4769.16,5039.360000000001
13452,U385BAE,20,-143.82000000000062,19,1,2543.82,2400.0
13453,U8EFF30,20,-3016.26,18,2,3797.71,781.45
13454,UBA5189,20,-11318.07,20,0,11318.07,0.0
13455,U07789A,20,-4011.0,20,0,4011.0,0.0
13456,UCBA095,20,1825.3400000000001,14,6,618.21,2443.55
13457,U500182,20,91.82999999999996,14,6,806.4599999999999,898.2900000000001
13458,U1D548D,20,313.46000000000004,14,6,12352.259999999998,12665.720000000001
13459,UA9A68A,20,-4654.430000000002,11,9,22975.750000000007,18321.320000000003
13460,UC8BA4D,20,187.71999999999994,18,2,991.6,1179.32
13461,U13A7E7,20,8546.599999999999,12,8,3723.7700000000004,12270.369999999999
13462,UC2273E,20,8.090000000000146,15,5,11096.11,11104.2
13463,U69BB2D,20,-13289.27,15,5,62409.130000000005,49119.86000000001
13464,UA6B2A3,20,43.480000000000004,17,3,585.96,629.4399999999999
13465,U72880E,20,1591.7999999999997,17,3,156.2,1748.0
13466,U69F106,20,-7116.0,12,8,83816.0,76700.0
13467,UAED6C6,20,14634.02,9,11,22602.809999999998,37236.829999999994
13468,UD4A722,20,-11934.820000000002,19,1,11934.860000000002,0.04
13469,UA8AE2D,20,35485.409999999974,14,6,216194.94,251680.34999999998
13470,U3C2A5E,20,16275.41,8,12,10026.5,26301.91
13471,U2E9D9C,20,-162.91,16,4,371.99,209.08
13472,UCA8C3A,20,-3142.999999999999,18,2,15802.389999999998,12659.39
13473,UBA611F,20,-1171.4100000000017,8,12,79193.40999999999,78022.0
13474,UB64E6C,20,-21181.73,13,7,26631.760000000002,5450.03
13475,UE7425E,20,4214.360000000001,13,7,9300.0,13514.36
13476,UA5D6AF,20,1240.73,13,7,6225.049999999999,7465.78
13477,UDC51E1,20,31.980000000000018,14,6,3223.9700000000003,3255.95
13478,U4B7B8B,20,0.8599999999999,17,3,1379.14,1380.0
13479,U4C9327,20,548.2000000000007,12,8,46123.8,46672.0
13480,U9732A4,20,3.0,12,8,29997.0,30000.0
13481,U9BD5BC,20,0.9599999999996669,19,1,3999.04,4000.0
13482,U420F9F,20,279.11000000000035,8,12,21689.47,21968.579999999994
13483,U856C50,20,4574.120000000002,12,8,21931.57,26505.690000000002
13484,U429B8E,20,1609.8199999999997,13,7,8044.15,9653.970000000001
13485,UC39044,20,-2504.3,17,3,4054.3,1550.0
13486,U9318EC,20,-19.0,9,11,29896.0,29877.0
13487,U344E98,20,-936.8699999999999,16,4,13999.330000000002,13062.46
13488,U04A3B2,20,-30637.23,19,1,61537.23,30900.0
13489,UE1D295,20,214.04999999999984,17,3,4152.53,4366.58
13490,UA37C33,20,7093.01,14,6,13297.2,20390.21
13491,UD866FD,20,167.57000000000016,13,7,3901.9700000000003,4069.54
13492,U986BED,20,-52.3,17,3,591.3000000000001,539.0
13493,UD540DC,20,10302.529999999999,9,11,44340.21000000001,54642.740000000005
13494,UD39FAE,20,-768.2599999999998,12,8,14468.259999999997,13700.0
13495,UE334FC,20,3.75,16,4,2300.76,2304.51
13496,U16A172,20,11520.869999999999,15,5,7252.429999999999,18773.3
13497,UDBB538,20,-1303.31,16,4,5418.77,4115.46
13498,UAF24D3,20,-9403.18,15,5,44342.46,34939.28
13499,UDECBC8,20,15599.500000000002,14,6,1240.52,16840.02
13500,U0789C0,20,-820.710000000001,14,6,18170.079999999998,17349.37
13501,UE89ACE,20,-3243.960000000001,16,4,18745.78,15501.820000000002
13502,UD9C1B1,20,383.47999999999996,12,8,2334.0,2717.4799999999996
13503,UB3D32F,20,2500.5499999999993,16,4,12941.0,15441.55
13504,U94D20D,20,-406.59999999999997,17,3,672.2099999999998,265.61
13505,UF55AC1,20,1442.1800000000003,17,3,218.58,1660.76
13506,UA90108,20,-380.0799999999999,15,5,4113.76,3733.68
13507,U0CB955,20,-514.4,19,1,514.41,0.01
13508,U747077,20,-1.0099999999999818,12,8,2009.54,2008.53
13509,U0332CE,20,44.64000000000033,18,2,15834.599999999999,15879.24
13510,U981EA5,20,-7890.0,17,3,14160.77,6270.77
13511,U814703,20,11873.859999999999,9,11,20818.0,32691.86
13512,U6749B2,20,-13237.0,12,8,111317.99,98080.99
13513,U4F14EB,20,22018.78,16,4,36134.22,58153.0
13514,U929745,20,4998.8499999999985,14,6,5912.66,10911.51
13515,U095881,20,-356.22000000000025,18,2,7266.22,6910.0
13516,U9BF41F,20,2193.74,12,8,8208.26,10402.0
13517,U7CA617,20,15.0,16,4,20015.0,20030.0
13518,UBB96E6,20,9.039999999999987,10,10,1401.12,1410.1599999999999
13519,UC4FEDC,20,-167656.0,12,8,214459.78,46803.78
13520,U052E32,20,-731.7000000000002,18,2,3577.54,2845.84
13521,U269A92,20,-102.99999999999955,18,2,6721.209999999999,6618.21
13522,U3E6482,20,735.5199999999996,18,2,6105.58,6841.1
13523,U29AF37,20,17938.54,10,10,26490.46,44429.0
13524,UC25162,20,515.52,16,4,4356.700000000001,4872.219999999999
13525,UC88C3A,20,-14.380000000000003,12,8,268.3,253.92000000000002
13526,U56C9D7,20,-11899.939999999999,10,10,183474.38,171574.44
13527,U5AB749,20,-693.2300000000005,14,6,95228.23000000001,94535.0
13528,UFE679E,20,2204.8900000000012,16,4,31995.82,34200.71
13529,UB33D0C,20,-1792.06,13,7,8115.65,6323.59
13530,U59B10E,20,-1234.85,18,2,2660.850000000001,1426.0
13531,U391105,20,124.90000000000009,11,9,17945.0,18069.9
13532,U757A26,20,-1924.3,18,2,2065.6600000000003,141.36
13533,U264B44,20,65.52000000000004,14,6,2659.17,2724.69
13534,U1CFE3E,20,-7818.510000000003,14,6,72305.29000000001,64486.77999999999
13535,U8FE286,20,-2410.4600000000028,13,7,20388.8,17978.339999999997
13536,UBD48BC,20,-59.98000000000072,17,3,5456.469999999999,5396.49
13537,U4AE305,20,1.099999999999909,8,12,5477.0,5478.1
13538,UE9ACD8,20,-22319.79,11,9,67238.95999999999,44919.17
13539,UF2BAE3,20,309.5699999999997,16,4,11694.779999999999,12004.349999999999
13540,U337509,20,-211.18000000000004,18,2,1056.41,845.23
13541,U57B915,20,559.6199999999997,9,11,4105.04,4664.66
13542,UFA5F21,20,447.6999999999996,16,4,11020.199999999999,11467.9
13543,U3B3AB7,20,-19000.0,17,3,23786.44,4786.4400000000005
13544,U2E9AF1,20,121982.08,14,6,5996.4,127978.48
13545,U658645,20,-34749.74,18,2,45619.119999999995,10869.38
13546,U41D108,20,5911.95,2,18,7823.99,13735.94
13547,U4D30FE,20,-1787.7499999999998,13,7,12197.779999999999,10410.030000000002
13548,U68F90C,20,168.0,14,6,25502.0,25670.0
13549,UC9AD8A,20,-73.84,19,1,673.8399999999999,600.0
13550,U7655F5,20,-4524.079999999999,18,2,12905.22,8381.14
13551,U5C3E4D,20,-156.52000000001135,9,11,51928.280000000006,51771.76
13552,U11574C,20,2289.2099999999996,16,4,1010.79,3300.0
13553,UE792EF,20,-127.30000000000018,18,2,11809.3,11682.0
13554,UD68DA5,20,-16975.11,16,4,27324.14,10349.03
13555,UF5748B,20,612.65,17,3,859.78,1472.43
13556,UDC9BC4,20,-17779.699999999997,17,3,17959.699999999997,180.0
13557,UE15796,20,556.09,18,2,243.91,800.0
13558,U078FE3,20,-9.960000000000036,14,6,1630.2,1620.24
13559,U7E48B0,20,-857.6599999999999,13,7,17460.0,16602.34
13560,U177E27,20,48786.20000000001,10,10,110956.90999999999,159743.11000000002
13561,U6A15FA,20,-391.4300000000003,14,6,8054.5,7663.07
13562,U32AD0E,20,-2954.3599999999997,18,2,3166.3599999999997,212.0
13563,U697671,20,3.8200000000001175,8,12,4128.110000000001,4131.93
13564,U0C59A3,20,-62.899999999999324,11,9,14237.499999999998,14174.6
13565,U179FC3,20,11287.279999999997,17,3,6632.76,17920.04
13566,UF61626,20,394.0000000000009,14,6,10954.96,11348.960000000001
13567,U9C84EA,20,2355.989999999998,11,9,28709.0,31064.989999999998
13568,UC8651B,20,8.340000000000192,18,2,3327.99,3336.33
13569,U866332,20,-5172.06,18,2,9572.060000000001,4400.0
13570,U51DEFF,20,10054.630000000001,15,5,5838.6,15893.23
13571,U6367F9,20,362.7200000000001,16,4,1028.4699999999998,1391.19
13572,U8F59BA,20,1430.2499999999986,10,10,110298.58,111728.83
13573,U315FDB,20,-458.1400000000001,12,8,3663.48,3205.34
13574,U89BB63,20,3612.9200000000005,14,6,12694.71,16307.63
13575,U7D8DDB,20,158.61,12,8,985.9,1144.51
13576,U532AB1,20,7.230000000000018,17,3,5492.7699999999995,5500.0
13577,U013055,20,-35088.61,14,6,93525.87,58437.26
13578,U301A68,20,7841.099999999995,11,9,44978.479999999996,52819.579999999994
13579,UF15480,20,1080.52,16,4,5729.48,6810.0
13580,U0DEA2D,20,-1183.0700000000008,12,8,52384.07,51201.0
13581,U76D06A,20,617.5299999999997,18,2,2682.4700000000003,3300.0
13582,U9E6837,20,-768.1399999999999,13,7,9039.22,8271.08
13583,U5FD610,20,-5650.26,19,1,11150.25,5499.99
13584,UD224F4,20,7030.530000000001,13,7,24524.04,31554.57
13585,U3945DC,20,-83.39000000000124,10,10,14769.39,14686.0
13586,U937AA9,20,17490.71,7,13,34680.0,52170.71
13587,U358385,20,-74.26000000000003,19,1,477.25999999999993,403.0
13588,U5E176C,20,3632.54,15,5,2318.0,5950.54
13589,U67FD82,20,8981.800000000001,13,7,12608.2,21590.0
13590,UD5673D,20,-1257.6200000000008,18,2,8733.62,7476.0
13591,U85D84F,20,-6697.469999999999,18,2,19937.770000000004,13240.3
13592,UEAE26B,20,-4184.99,14,6,8240.22,4055.23
13593,UD7EE03,20,570.33,16,4,1237.26,1807.5900000000001
13594,U0C3B11,20,-2563.269999999999,17,3,8822.42,6259.15
13595,UB9B8B4,20,-24.369999999999983,16,4,891.7299999999999,867.3599999999999
13596,U7D3169,20,1568.320000000007,13,7,294721.64999999997,296289.97
13597,U12DAB8,20,-3962.1000000000004,16,4,15462.099999999999,11500.0
13598,U3E7F73,20,-1735.9,12,8,5873.4,4137.5
13599,UA92B17,20,149.03999999999996,18,2,2560.9199999999996,2709.96
13600,U495D0F,20,-738.8700000000008,14,6,7439.180000000001,6700.3099999999995
13601,U69CFFF,20,1033.9500000000003,14,6,9378.3,10412.25
13602,U8236F5,20,11.929999999999723,16,4,2392.9300000000003,2404.86
13603,U688256,20,486.26,17,3,861.54,1347.8
13604,U809872,20,96386.65000000001,10,10,914.3499999999999,97301.0
13605,UFEDA4B,20,-365.52,12,8,1914.0099999999998,1548.4899999999998
13606,U02213D,20,-28568.76,17,3,59717.9,31149.140000000003
13607,U6992E1,20,157.39999999999986,18,2,2068.74,2226.14
13608,UC741F1,20,-9981.48,17,3,15381.879999999996,5400.4
13609,UFF213E,20,-42228.35,16,4,48495.590000000004,6267.24
13610,U33C936,20,-14388.36,19,1,14388.400000000001,0.04
13611,U1569F6,20,172.31999999999988,16,4,3234.6800000000003,3407.0
13612,U2D90AF,20,5138.5999999999985,13,7,6003.500000000001,11142.1
13613,U16CE97,20,1064.1,18,2,425.6299999999999,1489.73
13614,UF639A6,20,188.70999999999984,16,4,1074.95,1263.6599999999999
13615,UD5C202,20,44359.229999999996,15,5,56247.48,100606.71
13616,U48089C,20,1504.1499999999994,13,7,7386.150000000001,8890.300000000001
13617,U8D6D99,20,12004.39,13,7,23066.36,35070.75
13618,UF794DF,20,559.35,15,5,1920.9699999999996,2480.32
13619,U053BCA,20,5235.73,16,4,6527.27,11763.0
13620,U1CE6FE,20,-14124.55,17,3,18829.27,4704.72
13621,U90559C,20,4788.21,9,11,22500.01,27288.22
13622,UD37BD2,20,-312.99,13,7,78553.1,78240.11
13623,UDCC226,20,-0.050000000001773515,12,8,58201.049999999996,58201.0
13624,U3BC629,20,1103.8299999999997,18,2,5962.27,7066.1
13625,U7C1412,20,8706.520000000002,12,8,5013.48,13720.0
13626,U62E993,20,-1567.72,2,18,1891.72,324.0
13627,U792A22,20,-49997.36999999997,12,8,570330.64,520333.27
13628,U42C924,20,-8.799999999999272,11,9,38235.0,38226.200000000004
13629,U52EB00,20,-1609.7399999999998,16,4,11686.64,10076.9
13630,UB3821F,20,-226.80000000000015,17,3,1523.8000000000002,1297.0
13631,UED5F4F,20,-17438.300000000007,17,3,161074.21,143635.91
13632,U1C6740,20,-11760.5,18,2,31760.5,20000.0
13633,U7B8AF1,20,10708.069999999992,14,6,357176.6,367884.67
13634,U4B5509,20,409.73,17,3,2354.7,2764.43
13635,U163A94,20,2735.0,12,8,43775.0,46510.0
13636,UA2EB23,20,2623.899999999999,11,9,15642.96,18266.86
13637,U94A592,20,0.0,10,10,56000.0,56000.0
13638,UE24387,20,224.0,16,4,81800.0,82024.0
13639,U78BCC6,20,-4826.669999999996,12,8,35817.5,30990.83
13640,UD0B447,20,60.79999999999982,11,9,6179.2,6240.0
13641,UCC12AB,20,-12941.7,17,3,31441.699999999997,18500.0
13642,U60600A,20,2729.6800000000003,19,1,26675.22000000001,29404.9
13643,U1ABBCC,20,1860.5900000000001,11,9,3490.0,5350.59
13644,UDFCB45,20,-4186.320000000001,15,5,21790.8,17604.48
13645,U8D5BE9,20,24553.0,8,12,59585.0,84138.0
13646,U7306A9,20,-25793.599999999995,15,5,40343.2,14549.6
13647,UCB59B6,20,-1815.8100000000002,17,3,4188.5,2372.69
13648,UB84CC2,20,2406.22,15,5,10799.779999999999,13206.0
13649,U9A5912,20,0.0,10,10,18000.0,18000.0
13650,U3895F9,20,-1169.42,17,3,3673.0,2503.58
13651,U3F0CD4,20,-844.6700000000019,10,10,24422.31,23577.64
13652,U6C3984,20,718.2800000000002,18,2,6195.130000000001,6913.41
13653,U7FB2E1,20,1105.92,16,4,2547.0800000000004,3653.0
13654,UAB4951,20,-15863.450000000006,11,9,104430.94,88567.48999999999
13655,UFF2A92,20,682.2399999999999,13,7,4374.5,5056.74
13656,U6F0955,20,-7708.710000000001,17,3,27956.84,20248.129999999997
13657,UE8F3C2,20,-763.9600000000002,15,5,8123.1900000000005,7359.23
13658,UC8924E,20,13257.0,13,7,16705.8,29962.8
13659,U8EDF27,20,23.06000000000003,9,11,609.77,632.8299999999999
13660,UB2520E,20,-2379.540000000001,18,2,13737.859999999999,11358.32
13661,UD31989,20,-13979.759999999998,16,4,34052.71,20072.95
13662,UDAB8C0,20,-127542.20000000001,14,6,187928.03,60385.829999999994
13663,U160200,20,-7122.74,20,0,7122.74,0.0
13664,U7F92AF,20,-117363.19,10,10,163536.97,46173.780000000006
13665,UF829AF,20,-20391.760000000002,19,1,21848.760000000002,1457.0
13666,UF9B090,20,1913.3700000000001,12,8,4474.41,6387.779999999999
13667,UEF7942,20,-2000.0400000000002,18,2,5402.94,3402.8999999999996
13668,U3D1A24,20,-34871.28,13,7,151080.9,116209.62000000001
13669,UBFFD18,20,1014.8700000000001,10,10,682.66,1697.53
13670,U30315F,20,405.6899999999998,18,2,8911.22,9316.91
13671,U9409C7,20,11562.0,7,13,80518.0,92080.0
13672,UC00520,20,-440.17000000000024,16,4,4325.22,3885.05
13673,U419635,20,125.06999999999971,12,8,63663.08,63788.15
13674,UFF0CF7,20,59.95000000000073,14,6,21125.5,21185.45
13675,U947265,20,-70.71000000000095,12,8,46871.44,46800.729999999996
13676,U531972,20,-3129.74,14,6,12936.380000000001,9806.64
13677,U2D797C,20,18217.860000000004,9,11,56000.0,74217.86
13678,UEFDEB1,20,-295.46999999999935,14,6,21932.5,21637.03
13679,U21D4CC,20,-164.94000000000008,17,3,6577.869999999999,6412.93
13680,UA832D0,20,-2372.630000000001,17,3,12320.36,9947.73
13681,UD43B90,20,5467.260000000001,13,7,10591.479999999998,16058.74
13682,U5BA5FE,20,17622.940000000002,16,4,25034.469999999998,42657.41
13683,UD20C8B,20,20118.120000000003,13,7,58495.670000000006,78613.79000000001
13684,UAE7989,20,-3407.7799999999997,14,6,7047.780000000002,3640.0
13685,U1814E0,20,231.51999999999992,16,4,1348.1599999999999,1579.68
13686,U872237,20,460.8899999999994,9,11,51792.78999999999,52253.68
13687,UDC68C9,20,1807.1200000000017,14,6,21123.28,22930.399999999998
13688,U2A0A7E,20,4347.300000000001,16,4,1145.85,5493.15
13689,U028316,20,1322.3400000000004,17,3,9458.56,10780.9
13690,UA801C0,20,4280.0,11,9,100340.0,104620.0
13691,U17CB47,20,2422.0299999999997,14,6,11887.970000000003,14310.0
13692,U896F3C,20,-2540.13,18,2,11086.169999999998,8546.04
13693,U4CD044,20,40.92000000000189,12,8,39601.47,39642.39
13694,UF5A894,20,-1897.54,15,5,6421.12,4523.58
13695,UF1FF5B,20,1173.2599999999989,18,2,39512.740000000005,40686.0
13696,U8B942C,20,1896.31,4,16,10406.0,12302.31
13697,U81C341,20,6513.470000000003,12,8,67521.8,74035.26999999999
13698,U932EC6,20,0.7499999999999716,16,4,295.03000000000003,295.78
13699,U1192F8,20,852.48,13,7,1651.7,2504.1800000000003
13700,U8936E5,20,5132.000000000002,15,5,7294.699999999999,12426.7
13701,U4183D4,20,-3669.64,20,0,3669.64,0.0
13702,UE49B69,20,-1505.9999999999998,17,3,4700.21,3194.21
13703,U04A776,20,909.3100000000001,18,2,2484.9900000000002,3394.3
13704,U5A22B5,20,-2520.17,15,5,8402.779999999999,5882.610000000001
13705,U2761D4,20,-118.0,18,2,32644.0,32526.0
13706,U0BBC3E,20,3.5699999999998226,12,8,7893.69,7897.26
13707,U935A75,20,880.6199999999999,15,5,4905.0,5785.62
13708,U74D1BD,20,-11878.189999999999,18,2,24052.78,12174.59
13709,UAA18F3,20,16461.0,12,8,82166.0,98627.0
13710,U8E706E,20,-9749.210000000001,13,7,11109.340000000002,1360.13
13711,UC4DBBE,20,63856.7,8,12,389105.85,452962.55
13712,UD5D309,20,-170.99999999999955,15,5,11071.77,10900.77
13713,U02E77B,20,-17442.60999999997,13,7,397618.94000000006,380176.33
13714,U48DDA3,20,6451.700000000001,18,2,15949.099999999999,22400.8
13715,UF524E2,20,-1181.7000000000003,12,8,6620.9,5439.2
13716,U2991B6,20,971.4000000000001,13,7,10055.6,11027.0
13717,U4B2313,20,-1.1900000000006,11,9,6001.18,5999.99
13718,UD956F0,20,653.0200000000004,18,2,3624.11,4277.13
13719,U73F180,20,28316.18,15,5,1025.25,29341.43
13720,U44FE8F,20,-3.1000000000058208,11,9,181224.28999999998,181221.19
13721,U748928,20,-1547.2000000000003,15,5,3229.04,1681.84
13722,U26CD47,20,375.36,14,6,1485.6399999999999,1861.0
13723,UE51D1D,20,0.0,18,2,25011.0,25011.0
13724,UC15F8C,20,-9566.099999999999,19,1,20566.099999999995,11000.0
13725,UFEAE26,20,-12903.179999999998,19,1,13289.97,386.79
13726,UBBD8B3,20,-6298.370000000001,20,0,6298.370000000001,0.0
13727,U0424B6,20,-277.82,18,2,3027.82,2750.0
13728,UC1593F,20,-7643.999999999998,16,4,35979.979999999996,28335.98
13729,U7FB141,20,292.8199999999999,13,7,13493.470000000001,13786.29
13730,UA3EF72,20,-82.78999999999996,13,7,11982.11,11899.32
13731,U7EFA8D,20,-3795.64,16,4,5106.5,1310.8600000000001
13732,U9877D2,20,-113.4800000000032,12,8,180224.01,180110.53
13733,UB33BE5,20,-2041.3499999999967,17,3,34042.899999999994,32001.550000000003
13734,UDBFBC9,20,-9.889999999999418,10,10,41259.0,41249.11
13735,UFB3777,20,-786.9700000000037,10,10,50289.43000000001,49502.46000000001
13736,UC3DC11,20,1711.9000000000005,13,7,42495.58000000001,44207.48
13737,UC7731D,20,-2638.8199999999997,14,6,8150.62,5511.8
13738,UB5FF13,20,924.14,16,4,2360.0,3284.1400000000003
13739,U3993B4,20,-7787.0,8,12,107336.0,99549.0
13740,UFB41AA,20,-1.8899999999985653,13,7,57437.15,57435.26
13741,U59C84E,20,2390.7300000000005,12,8,74742.14,77132.87
13742,UA784DF,20,2.5,18,2,25.0,27.5
13743,U99D9FC,20,-2940.0299999999997,15,5,4172.91,1232.88
13744,U92F0EB,20,533.9999999999991,16,4,47315.25,47849.25
13745,U94A1EB,20,212.5799999999998,19,1,3020.0,3232.58
13746,UC5EFE1,20,41955.61,9,11,24659.889999999996,66615.50000000001
13747,U040F17,20,8546.55,14,6,22492.4,31038.949999999997
13748,UE06E0A,20,5441.12,13,7,18163.8,23604.92
13749,U12CF37,20,0.08999999999923602,13,7,13140.039999999999,13140.130000000001
13750,U0C1D2B,20,12919.089999999997,12,8,314644.19999999995,327563.29
13751,UD7FD50,20,-4512.6600000000035,11,9,88816.87000000001,84304.21
13752,U9996A2,20,-1253.800000000003,12,8,69513.8,68260.0
13753,U247088,20,-46204.740000000005,18,2,52534.48000000001,6329.74
13754,UB20FD4,20,-3483.7099999999996,17,3,6939.71,3456.0
13755,U8BA324,20,-0.040000000000873115,15,5,21026.36,21026.32
13756,U79B1C8,20,4098.1399999999985,13,7,18631.05,22729.190000000002
13757,U330A18,20,373.60000000000025,18,2,2212.3999999999996,2586.0
13758,UAD51A7,20,-203.70000000000005,19,1,603.7,400.0
13759,U500CB8,20,-341.36,17,3,2257.7399999999993,1916.38
13760,U8D1573,20,667.79,16,4,5232.209999999999,5900.0
13761,UC63FEB,20,-11.840000000000032,10,10,7288.25,7276.41
13762,UADB4B3,20,-1778.74,18,2,3778.74,2000.0
13763,U23A2DB,20,2992.99,11,9,12132.01,15125.0
13764,U76CEC1,20,-468894.76,14,6,688542.2,219647.44
13765,U921992,20,4590.700000000001,18,2,9409.3,14000.0
13766,U0A2DA3,20,-6982.419999999998,16,4,106363.0,99380.58
13767,U8ABAC3,20,-9114.28,20,0,9114.28,0.0
13768,U051240,20,-2569.019999999999,18,2,8651.68,6082.66
13769,UB963DA,20,44.83999999999969,13,7,7870.18,7915.0199999999995
13770,UE847A9,20,-43245.99,17,3,48143.41,4897.42
13771,U7DCE99,20,-11694.720000000001,17,3,17363.64,5668.92
13772,U1CA839,20,188.4399999999996,16,4,9815.0,10003.439999999999
13773,U8EB519,20,-5364.440000000002,15,5,107364.45000000001,102000.01
13774,U8B92B1,20,4463.730000000001,14,6,26894.710000000003,31358.44
13775,UD095C5,20,1000.0,7,13,47010.0,48010.0
13776,U0BFF27,20,-2084.619999999994,16,4,48172.159999999996,46087.54
13777,U6EEAFC,20,-12724.580000000002,20,0,12724.580000000002,0.0
13778,UACFF7D,20,-18160.03,16,4,24474.300000000003,6314.27
13779,U3FD191,20,-3250.4600000000005,14,6,19203.85,15953.39
13780,U023831,20,3385.15,13,7,12507.989999999998,15893.14
13781,U62C99A,20,-7463.27,17,3,9936.8,2473.53
13782,U65B24E,20,-1049.4799999999996,15,5,15762.439999999999,14712.96
13783,U57397A,20,751.0900000000001,17,3,2608.83,3359.92
13784,U61A8DE,20,-1825.9000000000005,14,6,3859.5000000000005,2033.6
13785,U849313,20,393.0599999999995,18,2,7366.44,7759.5
13786,UF7E634,20,1587.0,14,6,43106.4,44693.4
13787,UE86671,20,4956.08,13,7,114804.56999999999,119760.65
13788,UFD94F7,20,-1.9999999999990905,11,9,28002.0,28000.0
13789,U69FB49,20,516.55,19,1,1083.45,1600.0
13790,UEAE0F0,20,69550.87000000001,12,8,115509.92,185060.79
13791,U950657,20,-3145.280000000008,17,3,22233.480000000003,19088.199999999997
13792,U543B49,20,6839.9000000000015,14,6,40972.7,47812.6
13793,U84151F,20,-1136.68,14,6,6449.869999999999,5313.19
13794,U3B70CA,20,76.05999999999997,16,4,935.94,1012.0
13795,UDDE433,20,-1963.92,16,4,5165.759999999999,3201.84
13796,U54624D,20,1435.6000000000008,12,8,8664.84,10100.44
13797,U99651A,20,-1066.94,17,3,7226.229999999999,6159.29
13798,U4D4E66,20,34.0,16,4,706.0,740.0
13799,U60A0A1,20,11029.849999999999,17,3,7847.3099999999995,18877.16
13800,UF29C7F,20,1161.739999999998,13,7,27367.5,28529.239999999998
13801,UBF06BD,20,-64.87000000000273,9,11,31265.649999999998,31200.78
13802,UF3668E,20,-522.1,16,4,1169.1000000000001,647.0
13803,U765F5C,20,9646.0,17,3,391354.61,401000.61
13804,U3E7241,19,28083.409999999996,9,10,14963.46,43046.87
13805,UA93F45,19,-4869.99,11,8,22660.0,17790.010000000002
13806,UF70DE3,19,2046.1900000000003,9,10,6077.449999999999,8123.64
13807,UF50BC6,19,24835.010000000002,10,9,61435.0,86270.01000000001
13808,U93CD92,19,-366.0599999999995,15,4,26702.68,26336.620000000003
13809,U19F96E,19,7449.82,14,5,10099.8,17549.620000000003
13810,UA70C3F,19,4886.5,15,4,16743.5,21630.0
13811,UD3B7DC,19,24000.07,1,18,10000.0,34000.07
13812,U271A28,19,15986.57,11,8,40826.43,56813.0
13813,U211A35,19,478.77000000000044,16,3,3417.2299999999996,3896.0
13814,UF3EFA0,19,-1263.1899999999996,16,3,12222.18,10958.99
13815,UE5B05D,19,1973.9799999999996,17,2,1026.02,3000.0
13816,U8EC155,19,1649.6699999999996,14,5,5775.0,7424.669999999999
13817,U31BD4E,19,423.0,16,3,14877.0,15300.0
13818,UBD7F71,19,-680.3000000000004,16,3,4661.07,3980.77
13819,UE808C2,19,-699.4000000000002,12,7,3866.1900000000005,3166.79
13820,UE0FD24,19,-194.4300000000004,12,7,7537.13,7342.7
13821,U4DA802,19,-3835.9,16,3,14336.0,10500.1
13822,U0660EE,19,-454.76000000000005,14,5,524.37,69.61
13823,U1349C5,19,-1776.2400000000016,13,6,46300.0,44523.759999999995
13824,U249748,19,955.8199999999996,16,3,2801.3,3757.12
13825,U809454,19,7731.560000000001,13,6,3728.7599999999998,11460.32
13826,U756394,19,9277.0,15,4,29599.0,38876.0
13827,U1506F9,19,-43.539999999999964,15,4,4369.38,4325.84
13828,U03AE61,19,-1056.27,16,3,6972.929999999999,5916.66
13829,U8240E9,19,-5990.0,14,5,11665.3,5675.3
13830,U16914C,19,-1965.6000000000001,12,7,3422.9600000000005,1457.3600000000001
13831,UD13B1E,19,-13018.0,12,7,72895.0,59877.0
13832,U04F8FD,19,281.1600000000001,17,2,804.8999999999999,1086.06
13833,U0171C4,19,-2683.6600000000017,17,2,3672.7000000000016,989.04
13834,U64E862,19,-794.7399999999999,15,4,5209.69,4414.950000000001
13835,UA7D83C,19,-591857.63,8,11,2623103.0,2031245.37
13836,UDF455F,19,6654.060000000001,10,9,40349.65,47003.71000000001
13837,U5EEF0A,19,4670.36,10,9,2529.1699999999996,7199.530000000001
13838,U2EF141,19,-84.68999999999971,14,5,6938.15,6853.46
13839,U1CFC3B,19,1217.3400000000001,16,3,1783.1099999999997,3000.45
13840,U9B2528,19,3600.509999999984,8,11,149183.08000000002,152783.59000000003
13841,U46D3B7,19,-221.3800000000008,16,3,3830.4400000000005,3609.06
13842,U48B771,19,332.22999999999973,12,7,6325.88,6658.11
13843,UAADA8A,19,172.29999999999984,16,3,1633.3600000000001,1805.66
13844,U7C1993,19,2261.3100000000013,16,3,13118.69,15380.0
13845,UDF55C6,19,-506.7299999999997,11,8,15534.0,15027.269999999999
13846,U50472D,19,-464.37,17,2,1413.39,949.02
13847,U3CF513,19,2157.09,16,3,595.8399999999999,2752.9300000000003
13848,U526C56,19,922.8600000000015,8,11,39288.53,40211.39
13849,U4EA4D1,19,-8690.130000000001,15,4,35433.26,26743.13
13850,UFE6F24,19,2051.7999999999993,17,2,6009.219999999999,8061.02
13851,U5B6E0A,19,-268.53000000000003,16,3,608.9799999999999,340.45
13852,U0BECA4,19,-13.849999999999909,15,4,4853.0,4839.15
13853,U82349F,19,-5347.860000000002,15,4,32848.37,27500.51
13854,UD20A0E,19,-6956.000000000002,17,2,8643.139999999998,1687.14
13855,U01BF1B,19,-50.0,12,7,44050.0,44000.0
13856,U4E0A7C,19,1.0199999999999978,10,9,107.17,108.19
13857,UD8491C,19,2931.3999999999987,9,10,8420.91,11352.310000000001
13858,U3D5C15,19,56506.08,13,6,46325.4,102831.48
13859,U3B7E27,19,-130.99000000000024,14,5,7300.99,7170.0
13860,UC2F041,19,-2423.5699999999997,17,2,9728.5,7304.93
13861,U2A30A9,19,-1410.73,15,4,2279.5699999999997,868.84
13862,UB8FD89,19,6999.75,10,9,66797.15,73796.9
13863,U9AC297,19,-20150.76,16,3,32761.76,12611.0
13864,U4D270F,19,-1294.4000000000005,12,7,56051.92999999999,54757.530000000006
13865,UD9C51D,19,68.50000000000003,12,7,905.4399999999999,973.94
13866,U2C34BE,19,-3562.0,17,2,4024.44,462.44
13867,U71C3F5,19,-1782.1,18,1,1911.0,128.9
13868,UE5E475,19,526.7399999999998,14,5,3081.4300000000003,3608.17
13869,U032C10,19,89.75,8,11,68469.35,68559.1
13870,U8AB654,19,-2309.08,11,8,3891.8599999999997,1582.7800000000002
13871,UE28DA3,19,15336.630000000001,0,19,0.0,15336.630000000001
13872,UE19F87,19,-4522.9,17,2,4522.94,0.04
13873,UADEAE9,19,480.0,13,6,27020.0,27500.0
13874,U142DB0,19,-177.76000000000005,10,9,10758.03,10580.27
13875,UFEC1CF,19,-9012.0,17,2,18946.390000000003,9934.390000000001
13876,UAC4C97,19,-16942.58,13,6,42361.98,25419.4
13877,U3FC9B4,19,23969.28,15,4,7356.610000000001,31325.89
13878,U199D49,19,-866.2599999999989,16,3,17604.260000000002,16738.0
13879,UC3643F,19,18208.92,11,8,18861.739999999998,37070.659999999996
13880,U9B20D0,19,28427.150000000005,9,10,64340.0,92767.15000000002
13881,U9FFFC8,19,-1984.5599999999997,17,2,3245.5699999999997,1261.01
13882,U54734F,19,99.40000000000009,11,8,8000.6,8100.0
13883,U4F7DF4,19,-1233.9999999999998,17,2,1703.9999999999998,470.0
13884,UACB8DE,19,951039.4000000001,13,6,1124425.02,2075464.42
13885,U115B79,19,-49983.510000000024,10,9,759877.5499999999,709894.0399999999
13886,UDAD8FE,19,-10996.989999999998,11,8,71982.0,60985.01
13887,U171866,19,-244.26000000000113,14,5,97750.0,97505.74
13888,UAFD0C1,19,6233.599999999999,6,13,244.89,6478.49
13889,U5ABE5D,19,321.99999999999955,16,3,7750.4,8072.4
13890,U0E2786,19,0.0,9,10,36000.0,36000.0
13891,UAC1D7A,19,2336.7099999999996,13,6,11658.33,13995.039999999999
13892,U7502BC,19,-266.6500000000001,15,4,2279.59,2012.94
13893,U00B7A5,19,655.3000000000002,17,2,1500.6999999999998,2156.0
13894,U30A2EC,19,-137.01000000000022,14,5,9077.0,8939.990000000002
13895,UCDBEC1,19,2762.1,11,8,57338.0,60100.1
13896,U1D10FF,19,69009.6,10,9,2624.57,71634.17000000001
13897,U3650D2,19,-13562.91,16,3,32832.71,19269.8
13898,U98E2B2,19,1275.630000000001,10,9,14518.689999999999,15794.32
13899,U4F82BF,19,15841.6,17,2,2944.0,18785.6
13900,UA89D06,19,98.74000000000001,14,5,1201.26,1300.0
13901,UD7BEE6,19,5242.75,14,5,863.79,6106.54
13902,U42AC2A,19,-4987.909999999999,6,13,7060.4,2072.49
13903,UDD0639,19,504.2600000000002,15,4,12217.74,12722.0
13904,U70F627,19,2985.84,15,4,2629.03,5614.87
13905,UDE218F,19,710.6600000000008,15,4,10288.8,10999.46
13906,U73FD8F,19,-3865.5800000000004,17,2,7633.379999999999,3767.8
13907,U95C9A8,19,48.98999999999921,16,3,5418.910000000001,5467.900000000001
13908,U0D2E8E,19,-614.86,19,0,614.86,0.0
13909,U73550C,19,886.8400000000003,10,9,6081.8099999999995,6968.65
13910,U80937E,19,-26317.7,16,3,44571.7,18254.0
13911,U843379,19,-200.81999999999994,17,2,801.29,600.47
13912,UD96465,19,-2877.9999999999995,15,4,4071.36,1193.3600000000001
13913,UE2BCEE,19,2029.0000000000005,14,5,4953.42,6982.42
13914,U9A7279,19,-2619.6000000000004,14,5,2919.6000000000004,300.0
13915,U35EFF4,19,-969.0,16,3,4500.0,3531.0
13916,U8FE863,19,852.5900000000001,18,1,6247.41,7100.0
13917,UAA14D6,19,-4325.38,10,9,90138.2,85812.82
13918,UCD0259,19,2430.1800000000003,10,9,57170.0,59600.18
13919,UF56C18,19,305.70000000000005,14,5,2044.3,2350.0
13920,UE950CC,19,-4465.070000000001,15,4,12659.500000000002,8194.43
13921,UDAFCA1,19,-1852.1500000000015,10,9,48782.81,46930.66
13922,UE1439E,19,-158844.64,13,6,266162.0,107317.36
13923,U896FB1,19,215.92000000000007,17,2,2644.08,2860.0
13924,U423F52,19,14270.6,14,5,7274.21,21544.81
13925,U7269A8,19,-51.80000000000109,8,11,20196.07,20144.27
13926,U68CCE2,19,148514.96,9,10,160591.64,309106.6
13927,U821ACD,19,-430.88000000000034,13,6,3320.7900000000004,2889.91
13928,UF7FD07,19,-5127.54,14,5,13230.539999999999,8103.0
13929,UD079E6,19,-1492.6400000000003,15,4,5939.639999999999,4447.0
13930,U8C82BB,19,-7635.920000000002,16,3,15850.920000000002,8215.0
13931,U597719,19,-99.98000000000005,14,5,450.18,350.2
13932,U05364A,19,3356.290000000001,16,3,16398.32,19754.61
13933,UD7B71B,19,150.0399999999999,16,3,411.03000000000003,561.0699999999999
13934,UAF8CE4,19,-4421.9,13,6,8231.0,3809.1
13935,UF04D16,19,26009.280000000002,10,9,65910.59000000001,91919.87000000001
13936,UE86DBC,19,188.77999999999997,7,12,3892.5099999999998,4081.29
13937,U53BEDC,19,-709.01,17,2,3177.01,2468.0
13938,UD2A32D,19,259.51000000000016,12,7,4933.5599999999995,5193.07
13939,UC7916D,19,30.619999999999983,16,3,128.67,159.29
13940,UA07B72,19,-726.6499999999994,13,6,9410.7,8684.05
13941,U9084F6,19,608.9500000000004,16,3,4616.12,5225.07
13942,U481FDC,19,264.9500000000003,13,6,2822.31,3087.26
13943,UE86EE0,19,5182.35,9,10,6570.610000000001,11752.96
13944,U2B2309,19,-7419.299999999999,16,3,7636.299999999999,217.0
13945,U42EB41,19,-10000.95,18,1,13634.279999999997,3633.33
13946,UBF30BD,19,-7929.880000000001,16,3,13210.019999999999,5280.14
13947,UA6417D,19,3264.41,17,2,18996.94,22261.35
13948,U35BB88,19,-232.45000000000005,11,8,6081.96,5849.51
13949,UD83393,19,0.5900000000000318,13,6,9869.64,9870.23
13950,U0B6507,19,14421.79,14,5,60471.420000000006,74893.20999999999
13951,UF8D1D7,19,255.2799999999998,13,6,12196.72,12452.0
13952,U683D64,19,-3885.2700000000004,17,2,8016.4800000000005,4131.21
13953,UBB1864,19,-20118.0,14,5,33544.78,13426.779999999999
13954,UC8B851,19,4224.890000000002,9,10,11240.140000000001,15465.03
13955,U5A2439,19,4268.189999999998,12,7,501870.69000000006,506138.88
13956,U5CF97B,19,5524.060000000001,9,10,32885.09,38409.15
13957,U1EF83D,19,6507.530000000001,13,6,14315.16,20822.690000000002
13958,U87BDAD,19,-553.8199999999997,15,4,1665.6999999999998,1111.88
13959,UF68F69,19,-3198.2000000000003,13,6,9974.3,6776.099999999999
13960,U2249C1,19,-5706.999999999998,15,4,29735.5,24028.5
13961,U8CB01B,19,-3554.59,18,1,3554.67,0.08
13962,U3BF6E7,19,-6829.879999999997,18,1,7329.879999999997,500.0
13963,UDE9B88,19,-165.49999999999972,17,2,1175.2999999999997,1009.8
13964,U0E9FEC,19,4467.36,11,8,15659.68,20127.04
13965,U7941B3,19,-838.5000000000002,18,1,1964.19,1125.69
13966,UDF00AF,19,-22016.800000000003,8,11,41530.47,19513.67
13967,UC91416,19,3603.7200000000084,13,6,76851.79999999999,80455.52
13968,U82593E,19,-4.547473508864641e-13,15,4,7500.64,7500.639999999999
13969,U67C50A,19,4147.379999999999,14,5,38732.57,42879.95
13970,U5881DD,19,20.0,13,6,24103.79,24123.79
13971,UCFA2F5,19,-12137.8,16,3,18670.0,6532.2
13972,U019347,19,5596.12,15,4,4208.0599999999995,9804.18
13973,U5E799A,19,723.4700000000001,11,8,4226.21,4949.68
13974,UA98BAA,19,-14454.330000000002,17,2,32078.239999999998,17623.91
13975,UC529D1,19,-2370.2200000000003,12,7,4259.589999999999,1889.37
13976,U01794A,19,252.84999999999997,18,1,1347.15,1600.0
13977,U3ABE9B,19,-14731.099999999999,12,7,27970.449999999997,13239.35
13978,UE53B3D,19,-2109.970000000001,13,6,19509.32,17399.35
13979,UA80342,19,1627.9900000000252,8,11,1384208.97,1385836.9599999997
13980,U849D22,19,9619.759999999998,11,8,60862.490000000005,70482.25
13981,U1407E9,19,-5402.77,15,4,11600.220000000001,6197.450000000001
13982,U65786E,19,9650.0,8,11,24270.0,33920.0
13983,U5B1A5E,19,12273.04,10,9,58041.5,70314.54
13984,UBDB16D,19,651.1600000000001,15,4,885.8399999999999,1537.0
13985,U5E1BC9,19,9772.9,14,5,653.4999999999999,10426.4
13986,UDBCDEC,19,-1405.3,18,1,1405.31,0.01
13987,UA90455,19,1631.8,16,3,2768.2000000000003,4400.0
13988,U932F84,19,385.5699999999997,15,4,19800.399999999998,20185.97
13989,U57BDD1,19,541.2299999999999,16,3,2758.66,3299.8900000000003
13990,U6F411C,19,-3323.5099999999998,17,2,4820.51,1497.0
13991,U2EDB87,19,9196.49,13,6,8046.05,17242.54
13992,UEFB7A2,19,37723.540000000015,5,14,814808.1,852531.64
13993,U606450,19,-2800.0,13,6,85900.0,83100.0
13994,U0A1A27,19,336.44999999999993,6,13,2454.0,2790.45
13995,U5BF230,19,723.4599999999991,9,10,73914.54000000001,74638.0
13996,UEE1068,19,2972.9399999999987,12,7,25708.6,28681.54
13997,U9EE21F,19,-18.020000000000437,16,3,10664.8,10646.779999999999
13998,U281328,19,-118.80000000000074,17,2,16341.75,16222.95
13999,UB10A8C,19,-6160.159999999996,14,5,58418.149999999994,52257.99
14000,U409EC6,19,-74433.90000000001,9,10,106919.2,32485.300000000003
14001,U465B92,19,755.8600000000002,16,3,1003.8,1759.66
14002,U75F4D7,19,-423.0799999999998,17,2,1713.8,1290.72
14003,U9D3938,19,6941.480000000001,14,5,6498.610000000001,13440.09
14004,U861197,19,-11.400000000000022,17,2,348.40000000000003,337.0
14005,U432E90,19,-88.59999999999972,14,5,2188.4000000000005,2099.8
14006,U202778,19,62608.4,7,12,75870.97,138479.37
14007,U1D3962,19,1023.8999999999996,17,2,1225.1500000000003,2249.05
14008,U784088,19,-3296.6099999999997,12,7,30086.619999999995,26790.010000000002
14009,U4E0C70,19,2.2737367544323206e-13,9,10,4469.66,4469.66
14010,U179614,19,22.750000000000092,16,3,1797.5000000000002,1820.25
14011,U3729D9,19,450.95000000000005,16,3,296.2,747.1500000000001
14012,UC5BF64,19,109.21000000000004,9,10,8710.0,8819.210000000001
14013,UDDD696,19,24.99999999999966,11,8,4976.45,5001.450000000001
14014,U04CA89,19,1678.9899999999998,17,2,18321.010000000002,20000.0
14015,U042AC4,19,-1561.3700000000001,17,2,3635.37,2074.0
14016,UE1A33C,19,-658.9100000000001,12,7,2337.2599999999998,1678.35
14017,U654181,19,45653.07,9,10,26000.0,71653.07
14018,U392699,19,2392.0,8,11,33468.0,35860.0
14019,UFD7E20,19,41.049999999999955,17,2,719.1600000000001,760.21
14020,U6063CC,19,-352.23000000000013,16,3,3975.79,3623.56
14021,UE560DA,19,-33010.159999999996,16,3,37211.600000000006,4201.4400000000005
14022,UD88D3B,19,2373.5800000000004,12,7,6357.540000000001,8731.12
14023,UBBFE0A,19,-22208.500000000007,18,1,47099.6,24891.1
14024,UE41CCA,19,-1731.0,16,3,37075.0,35344.0
14025,U5785A8,19,1403.6899999999987,16,3,42328.31,43732.0
14026,U30E465,19,-6040.95,15,4,12039.369999999999,5998.42
14027,U73FB96,19,-2579.26,15,4,3881.56,1302.3
14028,U8F0E9C,19,-207.9900000000016,14,5,49743.83,49535.84
14029,UEE1B63,19,36726.52999999999,14,5,27110.470000000005,63837.0
14030,U3C44A4,19,-343.8000000000002,13,6,11615.8,11272.0
14031,UA7EEA1,19,-149.70999999999998,12,7,480.2499999999999,330.54
14032,UA90BC1,19,436.0,14,5,14544.32,14980.32
14033,U7EF1E5,19,1287.8900000000003,16,3,3574.23,4862.120000000001
14034,U699DD3,19,8216.800000000001,9,10,47423.2,55640.0
14035,U68E224,19,-229637.94,14,5,341238.93,111600.98999999999
14036,U3137BE,19,-383.71000000000004,11,8,29921.88,29538.17
14037,U05CB0E,19,16115.96,11,8,15941.0,32056.96
14038,UFBE42E,19,14783.580000000002,3,16,36.8,14820.380000000001
14039,U032D13,19,1501.29,10,9,3150.0,4651.29
14040,U815F1A,19,1693.2599999999984,14,5,27098.06,28791.32
14041,UF3D927,19,-403.64000000000004,17,2,1203.1599999999999,799.52
14042,U59985B,19,-30906.4,15,4,36565.71,5659.31
14043,U069B0C,19,-3762.800000000001,14,5,16318.119999999999,12555.32
14044,U5DD9D7,19,2149.9300000000003,14,5,4242.24,6392.17
14045,U63106E,19,180.93000000000006,11,8,7965.52,8146.45
14046,UD63BE4,19,-1238.3700000000003,14,5,11574.82,10336.45
14047,UC967CA,19,-1547.37,17,2,3273.29,1725.92
14048,UA7A8CB,19,-1591.809999999999,16,3,9765.75,8173.9400000000005
14049,U84B572,19,4322.320000000001,13,6,5586.419999999999,9908.74
14050,U16E19D,19,43333.02999999999,9,10,93419.78,136752.81
14051,U4453BB,19,28109.18,8,11,16366.0,44475.17999999999
14052,U920C72,19,499.33,9,10,832.03,1331.3600000000001
14053,U3AAE29,19,5069.72,16,3,4630.28,9700.0
14054,U9F63C6,19,3.2600000000002183,10,9,18232.74,18236.0
14055,U4F9128,19,19671.03,11,8,12824.0,32495.03
14056,U09412C,19,932.9500000000007,16,3,6329.0999999999985,7262.05
14057,U95E88E,19,702.0000000000001,10,9,10981.41,11683.41
14058,UB3A33B,19,901.5900000000001,15,4,8865.0,9766.59
14059,UB017B0,19,8468.849999999999,17,2,2485.01,10953.86
14060,U05BF9B,19,-2987.7999999999993,8,11,80981.0,77993.2
14061,U8F24C3,19,1933.0,12,7,9321.0,11254.0
14062,UE7C312,19,3928.199999999999,14,5,22629.6,26557.8
14063,UBD6B7F,19,25791.65,15,4,5064.9,30856.550000000003
14064,UBF9BD6,19,47115.81,9,10,310437.0,357552.81
14065,U0CE8ED,19,-2266.1200000000003,16,3,3310.05,1043.93
14066,U90AC22,19,-1564.3299999999997,18,1,4964.33,3400.0
14067,U3E2634,19,-1947.0500000000466,10,9,2510000.0,2508052.95
14068,U0DA28C,19,-47.47000000000082,13,6,14580.0,14532.529999999999
14069,U2B7920,19,6817.699999999999,10,9,16112.8,22930.5
14070,U26DD08,19,-35.07000000000153,8,11,64848.79000000001,64813.72
14071,U81C9FA,19,9494.99,13,6,1543.1799999999998,11038.17
14072,U35E495,19,-96.99999999999996,17,2,762.5000000000001,665.5
14073,UBD89DA,19,-1311.43,17,2,4913.429999999999,3602.0
14074,UC18469,19,559.4800000000032,14,5,82742.85,83302.33
14075,UE30BF8,19,0.0,15,4,20000.0,20000.0
14076,UC6A914,19,5988.51,11,8,43071.079999999994,49059.59
14077,UA6F048,19,-3.0999999999994543,15,4,3755.0,3751.9000000000005
14078,UDFA0DD,19,-1567.4700000000003,9,10,9041.74,7474.2699999999995
14079,U531F19,19,-1207.73,15,4,2838.6299999999997,1630.9
14080,UB0D4BF,19,-2762.05,12,7,12239.48,9477.429999999998
14081,UF4A407,19,7855.389999999999,14,5,19096.730000000003,26952.12
14082,U596932,19,-3251.9399999999996,17,2,6402.800000000001,3150.8599999999997
14083,U95E724,19,222.01999999999978,10,9,3955.51,4177.53
14084,U14C388,19,9565.47,16,3,9092.12,18657.59
14085,UFA3D91,19,185.42000000000036,13,6,4220.429999999999,4405.85
14086,U32D3C9,19,0.029999999999972715,15,4,2274.94,2274.9700000000003
14087,U7C238F,19,648.5300000000004,12,7,60101.48000000001,60750.01
14088,U3D50D8,19,-499.43000000000006,7,12,1812.0,1312.5700000000002
14089,U53D174,19,-330.71000000000004,14,5,2167.98,1837.27
14090,U6C7D9D,19,-4.89,10,9,9964.0,9959.11
14091,U3F00C5,19,139144.75,3,16,2000000.0,2139144.75
14092,U3FAB16,19,3.0,12,7,25998.8,26001.8
14093,U2BFDC0,19,-112.32000000000022,16,3,3082.31,2969.99
14094,U2BFA00,19,1733.5300000000002,11,8,31485.0,33218.53
14095,U07B73C,19,12581.929999999998,15,4,14500.349999999999,27082.28
14096,UCD3845,19,-918.2200000000018,13,6,116919.2,116000.98
14097,U96C518,19,-3909.8199999999997,12,7,20156.75,16246.93
14098,UA22CF2,19,-434.18,15,4,1585.64,1151.46
14099,U5B5976,19,23868.93,10,9,14177.9,38046.83
14100,U7C7D0C,19,8360.059999999998,10,9,190585.7,198945.76
14101,U4852EA,19,400.0399999999999,16,3,4969.369999999999,5369.41
14102,U01ECE0,19,-310.7600000000001,17,2,2475.2200000000003,2164.46
14103,UFA29F9,19,1439.2500000000018,9,10,43094.0,44533.25
14104,U0A3516,19,-4289.29,18,1,4489.29,200.0
14105,U675CD3,19,225.23999999999998,10,9,604.21,829.4499999999999
14106,UCC0AAB,19,-1086.15,14,5,2785.7,1699.55
14107,UC63F9B,19,2.842170943040401e-14,12,7,833.84,833.84
14108,U240B4E,19,-19735.3,16,3,34735.310000000005,15000.01
14109,U34B8C8,19,-653.75,9,10,19916.12,19262.37
14110,U46479B,19,-17648.74,19,0,17648.74,0.0
14111,U727E84,19,-887.8600000000006,15,4,7923.91,7036.05
14112,UE7840F,19,144.4,4,15,213.68,358.08
14113,UA0AF46,19,-80.62999999999997,16,3,2035.11,1954.48
14114,U922CCE,19,142.82000000000002,11,8,4001.22,4144.040000000001
14115,UB312EC,19,-12616.189999999999,16,3,20180.81,7564.62
14116,U2AAC5E,19,-22977.8,11,8,67454.8,44477.0
14117,U8E8D20,19,14272.0,13,6,10464.400000000001,24736.4
14118,U46F12F,19,-112.19000000000005,17,2,878.1899999999999,766.0
14119,U723C55,19,12945.529999999997,13,6,23143.870000000003,36089.4
14120,UBA7E7A,19,-3492.19,16,3,22769.22,19277.03
14121,U8F9D0D,19,5564.820000000001,9,10,149.06,5713.879999999999
14122,UE0631C,19,1219.1199999999994,16,3,5087.35,6306.469999999999
14123,U6E5FEA,19,11008.0,14,5,19029.41,30037.41
14124,U31C0FF,19,-45.37999999999865,15,4,18621.38,18576.0
14125,U2AD4CF,19,-27803.79,9,10,46010.0,18206.21
14126,UAFE953,19,623.3600000000001,16,3,746.6399999999999,1370.0
14127,U0D91A8,19,6640.659999999998,8,11,3216.92,9857.58
14128,U992807,19,13914.330000000004,10,9,8098.93,22013.260000000002
14129,UDA6F1D,19,26430.0,2,17,10.0,26440.0
14130,U08888B,19,-6027.000000000002,14,5,37438.66,31411.660000000003
14131,UC71B35,19,39.30000000000018,11,8,7920.7,7960.0
14132,U80F5D5,19,1001.0,15,4,19244.0,20245.0
14133,U829EDF,19,-13521.0,14,5,30500.199999999997,16979.2
14134,U438F55,19,-565.5,9,10,6465.5,5900.0
14135,UF42510,19,-2894.4900000000052,8,11,67345.0,64450.509999999995
14136,UF1F2D5,19,2478.7499999999995,10,9,9855.94,12334.69
14137,UEA31C2,19,2112.2,14,5,14116.94,16229.14
14138,UF8FB43,19,-61.81999999999971,15,4,13372.119999999999,13310.3
14139,U595762,19,-289.1,16,3,928.0,638.9
14140,UE279BA,19,-2318.3000000000006,13,6,11184.16,8865.86
14141,UB08900,19,288.4500000000007,13,6,16387.57,16676.02
14142,UA23CB0,19,283.9100000000001,15,4,1636.33,1920.24
14143,U54C8F9,19,-78.86000000000001,13,6,482.9,404.04
14144,UEDBC45,19,177.12999999999988,12,7,2803.3900000000003,2980.52
14145,U173103,19,160355.84,9,10,11435.5,171791.34
14146,UC71D39,19,-6474.540000000001,14,5,66184.0,59709.46
14147,U46A0DC,19,-7811.77,17,2,8687.900000000001,876.13
14148,U04B5C2,19,394.2399999999998,15,4,3552.6900000000005,3946.9300000000003
14149,U7DED63,19,-436.28999999999996,17,2,1136.29,700.0
14150,U48B75B,19,64.43000000000006,9,10,21650.0,21714.43
14151,UF8E315,19,-1983.66,18,1,1994.86,11.2
14152,U39BE8B,19,85.28999999999999,16,3,1344.71,1430.0
14153,U34C489,19,7089.0,7,12,13910.0,20999.0
14154,UA9EEB1,19,-2107.9399999999996,10,9,8710.06,6602.12
14155,U23030E,19,3504.7100000000005,14,5,9360.03,12864.74
14156,U01FFBB,19,5778.540000000001,13,6,46251.159999999996,52029.7
14157,UD58358,19,279.0,17,2,1221.0,1500.0
14158,U13A233,19,-998.6299999999994,17,2,5072.339999999999,4073.71
14159,U26F2FE,19,14973.210000000003,13,6,11336.130000000001,26309.34
14160,U68B0CA,19,6400.16,16,3,4011.41,10411.57
14161,U8810BF,19,12584.779999999999,11,8,18675.0,31259.78
14162,UC0063A,19,-6815.809999999999,18,1,6832.289999999999,16.48
14163,U84E16E,19,41454.51,14,5,39179.35,80633.86
14164,UC61F7F,19,-3563.94,13,6,4243.94,680.0
14165,UA53471,19,3120.7,14,5,5419.75,8540.45
14166,U5B4D89,19,-2095.1200000000003,14,5,5195.1500000000015,3100.0299999999997
14167,UC50CB9,18,681.1300000000001,10,8,9187.69,9868.82
14168,U9A2ACD,18,-3581.2599999999993,15,3,10704.26,7123.0
14169,U5999D6,18,1502.97,13,5,2547.7700000000004,4050.74
14170,U6A92BA,18,2474.39,12,6,6789.88,9264.269999999999
14171,UD8BDF5,18,826.4499999999998,14,4,1935.4,2761.85
14172,U7CB047,18,1180.1,14,4,1574.9,2755.0
14173,U3E0034,18,0.0,9,9,100000.0,100000.0
14174,U1CD753,18,-2904.61,14,4,2907.6200000000003,3.01
14175,UC52BA0,18,-132.9,18,0,132.9,0.0
14176,UDA94FF,18,-5280.39,17,1,5330.39,50.0
14177,U56AAA8,18,-238.95999999999998,14,4,663.97,425.01000000000005
14178,U9038E6,18,-909.46,15,3,11241.140000000001,10331.68
14179,U019714,18,-5204.15,16,2,19022.149999999998,13818.0
14180,UD888DE,18,-884.2600000000001,16,2,3142.1000000000004,2257.84
14181,U0A0722,18,-0.18000000000000416,11,7,76.74000000000001,76.56
14182,U16E030,18,255.05,16,2,744.2099999999999,999.26
14183,UDB3EAC,18,-7801.719999999999,15,3,21175.480000000003,13373.76
14184,U2BDE52,18,-17466.200000000004,15,3,21466.250000000004,4000.05
14185,UCC7758,18,17747.090000000004,6,12,36386.009999999995,54133.100000000006
14186,U046EFD,18,-22991.72,15,3,27218.960000000003,4227.24
14187,UB10BBB,18,25724.28,7,11,8217.58,33941.86
14188,U23A37E,18,25458.63,14,4,57325.29,82783.92
14189,U8FB5D7,18,-8779.919999999998,13,5,38992.92,30213.0
14190,U122BEF,18,-6875.5199999999995,17,1,10775.52,3900.0
14191,U895DF2,18,-382.23,9,9,1394.36,1012.13
14192,U479B04,18,2506.7,13,5,4201.46,6708.16
14193,UE2F046,18,1138.2000000000007,12,6,15163.8,16302.0
14194,U75BDE8,18,-5988.6,15,3,14594.9,8606.3
14195,UF9CED2,18,-42399.9100000001,6,12,1425109.8699999999,1382709.96
14196,UE162A6,18,1223.1000000000004,13,5,17960.0,19183.1
14197,U4FB5C6,18,255.51999999999998,11,7,3687.830000000001,3943.35
14198,U4931F6,18,-81.69,15,3,586.99,505.3
14199,U8FFB1E,18,-10523.800000000001,15,3,16739.61,6215.8099999999995
14200,U2B008B,18,-539.19,11,7,28452.2,27913.01
14201,UC7E628,18,96.55000000000004,11,7,624.6999999999998,721.25
14202,UDD956F,18,0.0,9,9,31105.0,31105.0
14203,U5A3223,18,378.0,15,3,1589.96,1967.96
14204,U721D49,18,-837.0199999999999,16,2,837.04,0.02
14205,U543D63,18,145.46000000000004,15,3,10986.32,11131.78
14206,U468679,18,-24.729999999999563,11,7,19964.0,19939.27
14207,U6DF3EC,18,-2970.5699999999997,14,4,6866.73,3896.16
14208,UDEB3DF,18,-1544.92,17,1,1545.0,0.08
14209,UC92F7A,18,14762.259999999998,10,8,27167.5,41929.759999999995
14210,UA96DC0,18,1.0300000000002,11,7,4443.969999999999,4445.0
14211,UFF3743,18,-1232.0500000000002,15,3,8050.050000000001,6818.0
14212,UBB90BF,18,3858.5800000000017,16,2,2641.42,6500.0
14213,U193A6F,18,-1205.1800000000003,14,4,17805.18,16600.0
14214,U838E6B,18,89.00000000000006,13,5,825.5999999999999,914.6
14215,UD0F917,18,-381.74999999999994,12,6,6472.14,6090.389999999999
14216,U04B1FB,18,-4389.449999999999,12,6,8171.039999999999,3781.59
14217,UB8BA99,18,5353.29,9,9,7125.91,12479.199999999999
14218,U7925D3,18,-236.9,15,3,1406.9,1170.0
14219,UFA0B46,18,-5105.3,16,2,6378.129999999999,1272.83
14220,U0C22F8,18,-6.73999999999986,16,2,1450.9399999999998,1444.2
14221,U75EC78,18,-5431.919999999999,13,5,15517.940000000002,10086.02
14222,U2AC103,18,4830.409999999998,10,8,30693.59,35524.0
14223,U97F5BF,18,-24489.269999999997,17,1,33489.26999999999,9000.0
14224,U11BA1D,18,1041.6000000000004,16,2,21356.800000000003,22398.4
14225,UE01C53,18,287.82,15,3,2512.18,2800.0
14226,UC6358E,18,68.72000000000025,14,4,3395.0,3463.7200000000003
14227,UE4139D,18,10975.25,14,4,12906.5,23881.75
14228,UFC5659,18,2485.01,14,4,8862.54,11347.550000000001
14229,UE89B51,18,-1678.03,11,7,9007.140000000001,7329.110000000001
14230,UACDF83,18,300.89000000000027,15,3,2576.3,2877.19
14231,UBA054B,18,-30.640000000000033,14,4,2430.64,2400.0
14232,U2F7D07,18,0.0,9,9,34994.0,34994.0
14233,U211ED4,18,-38040.45,16,2,38240.45,200.0
14234,UEC284D,18,-142.5599999999995,10,8,20797.8,20655.239999999998
14235,U8D68DE,18,-2.1316282072803006e-14,16,2,316.40999999999997,316.40999999999997
14236,U029937,18,13287.849999999999,12,6,18009.0,31296.85
14237,U4A1EA1,18,-9.05000000000001,16,2,409.06,400.01
14238,U5C2D05,18,7469.030000000003,14,4,33016.659999999996,40485.69
14239,U075826,18,2838.46,15,3,8724.579999999998,11563.04
14240,UB5BF35,18,-1962.0,12,6,43529.0,41567.0
14241,U132012,18,-24033.94,15,3,25095.0,1061.06
14242,U37723F,18,998794.1,13,5,27251.870000000003,1026045.97
14243,U22CB9D,18,408.0,14,4,7860.5,8268.5
14244,U57AE89,18,1711.0799999999997,16,2,7490.889999999999,9201.970000000001
14245,U0E66F5,18,-804.32,18,0,804.32,0.0
14246,U39491F,18,-17202.3,15,3,19802.299999999996,2600.0
14247,U3929D9,18,18463.45,14,4,1109.4099999999999,19572.86
14248,U5692F5,18,-4.0,10,8,16004.0,16000.0
14249,U03F32B,18,-243.67999999999938,12,6,27000.0,26756.32
14250,U46FA36,18,-8162.37,16,2,11818.79,3656.42
14251,U97BF1A,18,-15107.61,15,3,18543.43,3435.8199999999997
14252,UE4920B,18,-578.1899999999998,17,1,637.1899999999998,59.0
14253,U9CBCFF,18,-8336.919999999998,14,4,46736.920000000006,38400.0
14254,UEE54CC,18,2713.52,15,3,1097.55,3811.07
14255,UD66BD1,18,1.4210854715202004e-14,14,4,533.5400000000001,533.54
14256,UB23398,18,45599.42,11,7,1227.9,46827.32
14257,UE3E6CC,18,-120.43999999999997,12,6,5245.44,5125.0
14258,U7CB26D,18,-9805.66,12,6,12404.550000000001,2598.89
14259,U89348F,18,-10338.649999999998,13,5,36701.95,26363.3
14260,U7B0448,18,-3571.27,18,0,3571.27,0.0
14261,U3F999C,18,-399.8999999999993,16,2,20849.899999999998,20450.0
14262,U292F91,18,10552.580000000002,7,11,153500.0,164052.58000000002
14263,U48F8D9,18,29968.119999999995,12,6,70033.88,100002.0
14264,U76B37D,18,33.39999999999998,10,8,997.73,1031.13
14265,U67DDD3,18,-212.25999999999726,14,4,11473.170000000002,11260.91
14266,U2CE931,18,15652.15,11,7,64242.75,79894.9
14267,U2E45C7,18,2441.9,15,3,2854.1700000000005,5296.07
14268,U5DDD6F,18,-2610.02,17,1,2615.02,5.0
14269,U3F8D93,18,11136.649999999994,8,10,72927.27,84063.92000000001
14270,U1388B1,18,-4078.7700000000004,16,2,6083.790000000001,2005.02
14271,UF0EEC5,18,1123.08,10,8,12700.0,13823.08
14272,U0AC3CD,18,5998.07,14,4,7453.0,13451.07
14273,UC67B63,18,-6799.120000000002,18,0,6799.120000000002,0.0
14274,U9AF7F3,18,494.2900000000027,13,5,32835.06,33329.35
14275,U06D870,18,4907.720000000005,15,3,17455.390000000003,22363.11
14276,UE1370E,18,943.9499999999998,17,1,2240.69,3184.64
14277,U532C29,18,-319.41000000000025,14,4,8942.76,8623.349999999999
14278,U0130A8,18,-1165.749999999999,10,8,18283.0,17117.25
14279,UCA4AED,18,43.24000000000001,10,8,4165.76,4209.0
14280,UE4E8D2,18,-15620.289999999999,13,5,20840.6,5220.3099999999995
14281,U3E7D45,18,602.1299999999993,14,4,8017.4800000000005,8619.61
14282,U5F78DC,18,-249.73999999999995,16,2,387.88999999999993,138.15
14283,U4863C1,18,-2654.06,18,0,2654.06,0.0
14284,UFA2751,18,853.3600000000006,16,2,5589.7,6443.06
14285,U885A08,18,-609.5800000000002,12,6,8077.3099999999995,7467.73
14286,U98A66C,18,12011.060000000001,14,4,23388.39,35399.45
14287,UB47AD9,18,3597.88,13,5,7958.440000000001,11556.32
14288,U304F1A,18,203.58000000000004,16,2,174.67000000000004,378.25
14289,UC2391B,18,8934.85,12,6,29407.0,38341.85
14290,UFCCB7F,18,-360.1200000000008,9,9,23650.0,23289.88
14291,U04151D,18,-7360.650000000001,16,2,7510.650000000001,150.0
14292,UF139B1,18,-648.7500000000001,13,5,2069.8,1421.05
14293,U72AADB,18,-111.0,10,8,835.63,724.63
14294,UF4936F,18,620.3499999999998,11,7,13587.470000000001,14207.82
14295,UE4592C,18,548.9499999999997,15,3,6322.349999999999,6871.299999999999
14296,U1A25CD,18,2669.03,13,5,6098.78,8767.810000000001
14297,U03C976,18,-13732.56,17,1,13767.68,35.12
14298,U7590AA,18,-711.6700000000001,9,9,9879.09,9167.42
14299,U601732,18,-37306.97,13,5,91370.01000000001,54063.04
14300,UCB3DAB,18,-1044.9200000000008,13,5,19605.259999999995,18560.34
14301,U5120A4,18,-82301.91,13,5,152866.43000000002,70564.52
14302,U229B1B,18,-1639.6200000000001,16,2,1839.72,200.1
14303,UEDAEFB,18,478.9200000000001,14,4,986.75,1465.67
14304,U44D8A7,18,-2709.4300000000003,15,3,2919.43,210.0
14305,UC4AE3B,18,-9035.76,15,3,29513.9,20478.14
14306,U287665,18,952.0499999999993,9,9,62718.0,63670.05
14307,U94AEFA,18,1208.79,9,9,8909.71,10118.5
14308,UE73361,18,205.10000000000002,11,7,1157.32,1362.42
14309,U3C52AB,18,10222.19,11,7,9200.33,19422.52
14310,U47B37B,18,-3060.0,14,4,16460.0,13400.0
14311,U69FDF9,18,8459.419999999991,4,14,212999.81,221459.23
14312,U82CC44,18,-340.5999999999999,16,2,5386.629999999999,5046.03
14313,U920225,18,29639.069999999992,8,10,52640.93000000001,82280.0
14314,U6A6358,18,0.0,10,8,18025.0,18025.0
14315,U3C386C,18,65238.21,8,10,3961.9399999999996,69200.15
14316,UEFEC08,18,311.04,14,4,317.76,628.8
14317,U10997B,18,362.3899999999994,11,7,4525.610000000001,4888.0
14318,U275DD2,18,-13203.349999999999,14,4,15031.09,1827.7399999999998
14319,UB59431,18,-1067.410000000005,9,9,84868.31000000001,83800.90000000001
14320,U8F760B,18,-73.4700000000004,16,2,19859.11,19785.64
14321,UBDCC4A,18,2213.2999999999997,14,4,2023.83,4237.13
14322,U4B5A11,18,-575.2999999999986,12,6,21307.34,20732.04
14323,U2EF493,18,814.4300000000003,16,2,5966.0,6780.43
14324,U463379,18,-749.93,13,5,6038.91,5288.98
14325,U278940,18,5330.529999999999,12,6,131579.5,136910.03
14326,U3D97FD,18,-22.060000000000286,17,1,1922.06,1900.0
14327,UCD4DE8,18,0.060000000000002274,11,7,604.79,604.85
14328,U44C371,18,-2168.9699999999903,12,6,240180.12,238011.15
14329,U5B9682,18,2146.0999999999985,7,11,26738.21,28884.309999999998
14330,U18AB0A,18,3999.57,8,10,5417.25,9416.82
14331,U6939AD,18,5057.59,10,8,10856.98,15914.57
14332,UE7381F,18,-9457.56,17,1,14857.560000000001,5400.0
14333,U880936,18,24008.64,15,3,55077.92999999999,79086.57
14334,U8D8082,18,-4043.56,16,2,5599.11,1555.55
14335,UB4625E,18,-14481.41,13,5,27492.719999999998,13011.31
14336,UDCC206,18,-1575.8300000000002,10,8,3021.86,1446.03
14337,U9E9811,18,-3747.7,13,5,4802.82,1055.12
14338,U92EAA5,18,5.258016244624741e-13,15,3,6237.36,6237.360000000001
14339,UAE0C74,18,-503.8999999999998,14,4,6492.900000000001,5989.0
14340,UF22A4D,18,0.0,8,10,37491.700000000004,37491.700000000004
14341,U632BCB,18,24588.84,10,8,9070.18,33659.020000000004
14342,U20CB8A,18,-51.0,16,2,1217.5,1166.5
14343,U3B161A,18,693.7799999999993,12,6,8320.029999999999,9013.81
14344,U091FE6,18,4.240000000000691,10,8,6051.199999999999,6055.44
14345,U0CA2C4,18,501.56999999999925,15,3,6389.5,6891.07
14346,UBF23D1,18,1254.12,11,7,3720.5,4974.62
14347,UAC480F,18,59.0,15,3,592.88,651.88
14348,U74ABCB,18,361.6800000000001,14,4,588.6800000000001,950.36
14349,U24F518,18,1262.95,11,7,1191.5499999999997,2454.5
14350,U32DFA2,18,3775.57,10,8,7650.3,11425.869999999999
14351,U814FD7,18,86891.01999999999,12,6,7110.98,94002.0
14352,U672C8A,18,-258.20000000000016,16,2,722.9700000000001,464.77
14353,U7A4E34,18,958.8299999999981,16,2,43941.17,44900.0
14354,U2FDE60,18,2243.4,13,5,7657.6,9901.0
14355,U7C92DE,18,7076.37,15,3,14413.63,21490.0
14356,UDEBBD5,18,-154682.22,12,6,211336.1,56653.88
14357,UB18F28,18,4842.1,16,2,4159.08,9001.18
14358,UB061A7,18,-129.45000000000016,9,9,88780.0,88650.55
14359,U442E0A,18,-3176.47,13,5,23566.18,20389.71
14360,UC95C1A,18,-1290.98,11,7,5297.4,4006.42
14361,U830DF4,18,-12279.0,12,6,34929.0,22650.0
14362,UF58C23,18,27.260000000000094,16,2,3922.74,3950.0
14363,UF95BE7,18,-8547.36,18,0,8547.36,0.0
14364,U374000,18,-3.1700000000000728,15,3,686.25,683.0799999999999
14365,U4B87CF,18,1355.7399999999993,14,4,8989.24,10344.980000000001
14366,UF1C37C,18,-3193.01,16,2,10934.49,7741.48
14367,U1FE024,18,491.96000000000004,14,4,3068.04,3560.0
14368,U9C0C98,18,6607.5,10,8,2395.1,9002.6
14369,U47AE89,18,348.35000000000014,16,2,1543.2800000000002,1891.63
14370,U4228DB,18,-5.780000000000873,12,6,8844.310000000001,8838.53
14371,U3A74B4,18,636.3199999999999,14,4,823.15,1459.47
14372,U891555,18,-9041.0,16,2,14141.0,5100.0
14373,U9CFD8A,18,-20.979999999999947,15,3,1171.32,1150.3400000000001
14374,UC70D9A,18,-788.7799999999999,17,1,1188.7799999999997,400.0
14375,UB7D1D9,18,741.2999999999995,12,6,6903.200000000001,7644.5
14376,U93ECBB,18,5130.0,13,5,23291.440000000002,28421.440000000002
14377,U4DB388,18,239.77999999999886,16,2,7868.120000000001,8107.9
14378,UB21D38,18,6173.679999999999,14,4,4182.36,10356.04
14379,U321D4F,18,1627.0299999999995,16,2,5772.740000000001,7399.77
14380,U85F971,18,-1926.4800000000002,14,4,4845.530000000001,2919.05
14381,U8E3C22,18,-1506.7800000000002,10,8,6417.660000000001,4910.88
14382,UB33AB2,18,350.30999999999995,9,9,10249.71,10600.02
14383,UC60E70,18,-5.81756864903582e-13,9,9,14104.36,14104.36
14384,U5D7784,18,-1373.69,15,3,2710.4,1336.71
14385,UFB8FD0,18,808.1300000000001,15,3,10814.38,11622.51
14386,U0942AA,18,-671.56,16,2,2671.5600000000004,2000.0
14387,UF7E2C3,18,-11709.16,13,5,41589.270000000004,29880.11
14388,UF969B1,18,-2286.3199999999997,14,4,10004.41,7718.09
14389,UF8DE1D,18,32362.200000000004,14,4,37962.62,70324.81999999999
14390,UF2C9AB,18,-25067.510000000002,18,0,25067.510000000002,0.0
14391,U5557A5,18,-4691.4,15,3,10291.4,5600.0
14392,UFA6B91,18,-2240.2999999999993,13,5,18865.88,16625.58
14393,UD361E6,18,370.0300000000005,15,3,3144.3999999999996,3514.4300000000003
14394,U2BADE0,18,31.010000000000446,13,5,8711.0,8742.01
14395,U5CB498,18,80.0,10,8,10120.0,10200.0
14396,U10DB99,18,3343.12,12,6,8258.0,11601.119999999999
14397,U01D3EB,18,0.3400000000019645,9,9,108453.68000000001,108454.01999999999
14398,UA57687,18,-20098.010000000006,13,5,85057.28000000001,64959.270000000004
14399,U86C313,18,-3204.33,17,1,3211.75,7.42
14400,UDAF284,18,-7.247535904753022e-13,16,2,8480.5,8480.5
14401,U55215C,18,-202.77000000000044,9,9,53987.0,53784.229999999996
14402,UFDBCDE,18,96.32000000000016,13,5,4109.14,4205.46
14403,U5CB657,18,-102.91999999999985,16,2,1000.8699999999999,897.95
14404,UD756D9,18,5223.9000000000015,14,4,31572.7,36796.6
14405,UFA472F,18,10.170000000000073,7,11,28473.0,28483.17
14406,U8EB81E,18,-1314.1799999999998,14,4,4223.98,2909.7999999999997
14407,UF15722,18,936.0999999999999,13,5,684.11,1620.21
14408,UC5D691,18,365.34000000000015,15,3,14488.91,14854.25
14409,UA71D21,18,-576.4,18,0,576.4,0.0
14410,U3D87CB,18,1966.3899999999999,11,7,4133.610000000001,6100.0
14411,UD35E03,18,2158.499999999999,13,5,39.03,2197.5299999999997
14412,UBA9D84,18,-1214.6800000000003,14,4,8229.68,7015.0
14413,U896B83,18,1901.96,10,8,15308.08,17210.04
14414,U991139,18,87678.39,13,5,23105.14,110783.53
14415,U87BB66,18,10883.149999999994,15,3,35911.25,46794.4
14416,UEC3920,18,1628.6399999999994,15,3,18620.36,20249.0
14417,U5AED40,18,163.79999999999984,15,3,2611.0700000000006,2774.87
14418,U86000F,18,745.5999999999999,14,4,4794.26,5539.860000000001
14419,UF8620D,18,-20003.8,14,4,23874.8,3871.0
14420,U04A3DB,18,2905.0,9,9,13365.0,16270.0
14421,UF54F2A,18,-55.12999999999954,13,5,12590.789999999999,12535.66
14422,U8A7F72,18,-1161.31,15,3,1939.2199999999998,777.91
14423,U76118B,18,27998.119999999995,12,6,27760.550000000003,55758.670000000006
14424,U13B86F,18,-3191.3,14,4,8515.46,5324.16
14425,U2F19D7,18,-460.14,15,3,1710.8400000000001,1250.7
14426,UAB47E1,18,-648.9699999999984,16,2,7168.5999999999985,6519.63
14427,U98DD12,18,-292.0,15,3,987.1500000000001,695.15
14428,U9F36B9,18,169.20999999999998,14,4,1040.8,1210.01
14429,U09E95A,18,622.0999999999998,15,3,3468.99,4091.09
14430,U4113D4,18,369.12,16,2,536.88,906.0
14431,U120F2B,18,447.0,15,3,37947.0,38394.0
14432,U7012D3,18,1962.8300000000002,15,3,5324.589999999998,7287.42
14433,UE18B09,18,-8613.44,15,3,10813.5,2200.06
14434,U3B6454,18,-11786.960000000001,18,0,11786.960000000001,0.0
14435,U94F91B,18,-600.1000000000008,16,2,6169.9,5569.799999999999
14436,UD99B30,18,536.8999999999996,13,5,24272.22,24809.120000000003
14437,UF8947A,18,28706.980000000003,13,5,71293.72999999998,100000.71
14438,UE507A8,18,686.7399999999998,14,4,9087.0,9773.74
14439,U6641B4,18,-19155.989999999998,11,7,24133.179999999997,4977.1900000000005
14440,U211F4B,18,-2.842170943040401e-14,4,14,392.4,392.4
14441,U371D40,18,178.02000000000032,16,2,2431.98,2610.0
14442,U59DC26,18,-367.0999999999999,14,4,427.19999999999993,60.1
14443,U9ACFEA,18,-885.0399999999998,14,4,2848.0400000000004,1963.0
14444,UFC493F,18,33.00000000000004,16,2,883.4599999999999,916.46
14445,U47604D,18,64769.35,5,13,109604.85,174374.2
14446,U72FF78,18,-2140.4200000000005,15,3,18950.230000000003,16809.809999999998
14447,U368393,18,-2482.18,13,5,3945.6799999999994,1463.5
14448,U482D43,18,10788.86,13,5,2377.07,13165.93
14449,UD39E1D,18,-3387.6800000000003,18,0,3387.6800000000003,0.0
14450,UDC7DA1,18,-367.3500000000031,13,5,286967.82000000007,286600.47000000003
14451,U788A8C,18,4946.87,15,3,5561.13,10508.0
14452,U8FC06A,18,297.6199999999999,10,8,3669.93,3967.55
14453,UF50B57,18,251.0699999999997,9,9,7888.02,8139.09
14454,UA526F6,18,470.9800000000005,11,7,26497.59,26968.57
14455,UFF93A8,18,7031.950000000001,13,5,1320.6,8352.55
14456,UDA03C9,18,-14193.829999999998,16,2,14279.669999999998,85.84
14457,UE99692,18,-5279.280000000001,16,2,5315.780000000001,36.5
14458,U286149,18,-30510.159999999996,15,3,63510.159999999996,33000.0
14459,U004E0E,18,5195.54,13,5,14859.86,20055.4
14460,U82C6E4,18,189.63999999999982,14,4,3620.9,3810.54
14461,U6AE475,18,-227.0,16,2,9190.0,8963.0
14462,U65473B,18,-47293.44,16,2,54661.53,7368.09
14463,UE20008,18,1697.8600000000038,13,5,90762.21999999999,92460.07999999999
14464,U1C71F0,18,-15563.619999999995,11,7,574315.6,558751.98
14465,UE59C74,18,-289.0,9,9,29857.9,29568.9
14466,U633452,18,-408.0300000000001,14,4,5636.94,5228.91
14467,U210B94,18,-21767.710000000003,15,3,54751.8,32984.09
14468,U03AF56,18,-10066.140000000001,15,3,25905.960000000003,15839.82
14469,U248A43,18,-812.3000000000008,11,7,23229.39,22417.09
14470,U35AE56,18,1554.9100000000008,14,4,4875.999999999999,6430.91
14471,U8F4CF0,18,1474.5599999999995,7,11,5134.290000000001,6608.85
14472,U253D5D,18,5349.46,14,4,683.06,6032.52
14473,U304C7A,18,-58.0999999999989,15,3,18565.959999999995,18507.86
14474,U5AAC57,18,-37157.64,14,4,39483.88,2326.24
14475,UDE19CE,18,-1992.8999999999996,8,10,28731.0,26738.1
14476,U265D0E,18,382.93,16,2,1269.48,1652.41
14477,UE579E7,18,8.520000000000437,9,9,23768.03,23776.550000000003
14478,UBC29C9,18,-251.07000000000002,14,4,1028.31,777.24
14479,UF6786F,18,-7369.579999999998,11,7,17945.86,10576.28
14480,U540C2A,18,-100.23,12,6,63897.23,63797.0
14481,UE88983,18,7270.850000000009,8,10,449076.57,456347.42000000004
14482,U6F8EDA,18,-54.8700000000008,9,9,32501.0,32446.13
14483,U7FCEAB,18,4306.22,15,3,8759.78,13066.0
14484,UC61CBD,18,16452.86,16,2,11460.14,27913.0
14485,U247259,18,37.799999999999955,9,9,808.8000000000001,846.5999999999999
14486,UBB2E54,18,472.0,9,9,7000.0,7472.0
14487,U2E52B3,18,-2770.7999999999997,12,6,11061.31,8290.51
14488,U4A0BC3,18,13655.42,11,7,14926.550000000001,28581.97
14489,UA50BB4,18,-1335.2200000000005,11,7,4479.41,3144.19
14490,UA94963,18,-57.699999999999974,10,8,935.1999999999999,877.5
14491,U5F98D6,18,-74080.71999999999,14,4,105470.9,31390.18
14492,U82370B,18,-2200.48,17,1,2200.4900000000002,0.01
14493,U56DEBF,18,-8.159999999999854,12,6,9783.16,9775.0
14494,U920925,18,2644.4700000000007,10,8,14251.72,16896.190000000002
14495,UA0B554,18,65.94999999999982,9,9,13603.07,13669.02
14496,U73BAEB,18,14506.029999999999,13,5,4593.97,19100.0
14497,UB8D300,18,-2.0,14,4,35716.0,35714.0
14498,U333B73,18,-966.1300000000002,13,5,1715.6499999999999,749.52
14499,UA2CF47,18,-3301.4799999999996,15,3,5686.09,2384.6099999999997
14500,U53A985,18,317.75,10,8,21308.47,21626.22
14501,U13F177,18,-206.5,14,4,908.79,702.29
14502,U5957F3,18,344.8199999999997,8,10,54859.32,55204.14
14503,UB131A5,18,-123.22999999999945,15,3,13664.63,13541.400000000001
14504,UC3DDE9,18,-3003.5,16,2,3023.5,20.0
14505,U1F7B41,18,4377.4,11,7,20585.95,24963.35
14506,UD5EA0B,18,-5817.74,12,6,21853.739999999998,16036.0
14507,U372486,18,10198.6,14,4,33973.28,44171.88
14508,U5535CA,18,2806.3500000000004,10,8,94203.7,97010.05
14509,U0E0179,18,-7684.68,18,0,7684.68,0.0
14510,UE64A13,18,5771.1,12,6,978.0999999999999,6749.2
14511,U6BA447,18,-1095.6699999999996,14,4,9098.11,8002.4400000000005
14512,UFE6C9A,18,-256.1999999999998,16,2,1556.1999999999998,1300.0
14513,UDA8E28,18,9089.509999999997,5,13,70416.04000000001,79505.55
14514,U772C40,18,-915.3699999999992,16,2,11301.37,10386.0
14515,U59BF5E,18,-2.842170943040401e-14,14,4,195.34,195.34
14516,U4A456D,18,982.3999999999999,12,6,417.5999999999999,1400.0
14517,U84370E,18,-814.9000000000001,16,2,4958.7,4143.8
14518,U833554,18,-4267.57,14,4,5094.84,827.27
14519,U992954,18,-29056.379999999997,11,7,88658.4,59602.020000000004
14520,UD5BA80,18,861.1999999999998,16,2,6416.799999999999,7278.0
14521,UFBC270,18,6493.68,13,5,7806.320000000001,14300.0
14522,UC42A14,18,11078.78,14,4,2549.22,13628.0
14523,UBDD727,18,-60.11000000000006,15,3,3027.98,2967.87
14524,UCA0E28,18,-1743.0299999999988,10,8,34378.04,32635.010000000002
14525,U4EB7DF,18,4246.0,16,2,53854.0,58100.0
14526,UD3AAC9,18,-291.0,14,4,9541.0,9250.0
14527,U595194,18,17727.66,10,8,11206.0,28933.66
14528,U705B1D,18,-35.94999999999999,14,4,291.72,255.77
14529,U98E6B5,18,1122.27,8,10,1295.5,2417.77
14530,UAABC01,18,-1464.6899999999987,11,7,26164.7,24700.010000000002
14531,U50F3A0,18,165.04000000000008,16,2,3806.9599999999996,3972.0
14532,U1CFB3B,18,28.649999999999636,10,8,15881.5,15910.15
14533,U138862,18,-0.6000000000000227,11,7,2767.6,2767.0
14534,U2B57F5,18,-1985.2799999999997,15,3,7521.01,5535.73
14535,U61B786,18,3.0,9,9,14997.0,15000.0
14536,U5D98CF,18,8470.940000000004,15,3,39100.469999999994,47571.41
14537,U0453CB,18,-1.8200000000001815,11,7,28993.52,28991.700000000004
14538,U204FA3,18,552.5399999999995,14,4,13447.460000000001,14000.0
14539,U5E90FB,18,2175.26,12,6,9556.77,11732.029999999999
14540,UFEC838,18,-2361.48,18,0,2361.48,0.0
14541,UFF6AD6,18,-146.23,12,6,678.0600000000001,531.8299999999999
14542,U9B60F3,18,20203.18,12,6,15539.73,35742.91
14543,U3DE26C,18,1038.039999999999,14,4,9171.96,10210.0
14544,U34CAD4,18,508.0799999999999,15,3,5327.7,5835.78
14545,U8F7BB2,18,3174.7399999999993,14,4,1606.8600000000001,4781.6
14546,U10BE18,18,-36.95999999999981,14,4,3314.0899999999997,3277.13
14547,UCEB72C,18,-5674.77,14,4,14939.380000000001,9264.61
14548,UCCEC9F,18,2241.75,10,8,3057.2500000000005,5299.0
14549,U817559,18,-6060.839999999998,18,0,6060.839999999998,0.0
14550,U4F276B,18,-952.0499999999993,8,10,60900.0,59947.950000000004
14551,U8DDEEE,18,4251.64,10,8,7020.86,11272.5
14552,UFD4A35,18,-112.77000000000002,14,4,665.95,553.18
14553,U9DB271,18,10586.0,13,5,7019.0,17605.0
14554,U097EEF,18,-439.2400000000001,14,4,13102.080000000002,12662.84
14555,UAA346F,18,-1605.62,16,2,6161.620000000001,4556.0
14556,U2F0953,18,-797.8199999999999,16,2,2791.8599999999997,1994.04
14557,UAC39A4,18,16280.249999999998,12,6,7572.0,23852.25
14558,UAB172A,18,3763.0099999999998,14,4,2436.9900000000007,6200.0
14559,UDC1694,18,-10683.43,15,3,87347.0,76663.57
14560,UF7E48F,18,101.36999999999986,12,6,1632.1,1733.4699999999998
14561,U554655,18,-449.75,16,2,1876.7599999999998,1427.01
14562,UC50186,18,9530.76,13,5,9869.260000000002,19400.02
14563,U43D744,18,-9812.52,15,3,10512.52,700.0
14564,U03CD0C,18,-41749.00999999998,10,8,183204.52000000002,141455.51
14565,U7F4E35,18,9410.37,2,16,5571.9,14982.27
14566,U1CAE06,18,212.47999999999956,16,2,18647.52,18860.0
14567,U6F92F1,18,3171.85,15,3,10763.5,13935.349999999999
14568,U89934E,18,-6597.07,6,12,31200.0,24602.93
14569,UAB49EE,18,-670.3099999999995,14,4,5205.03,4534.72
14570,U76C454,18,323.3,6,12,1961.83,2285.13
14571,U28F499,18,1745.9500000000044,7,11,107605.98,109351.93
14572,U970D6B,18,414.45000000000016,12,6,1556.1700000000003,1970.6200000000001
14573,UF692E1,18,-664.9700000000012,12,6,66599.0,65934.03
14574,U7B9028,18,17.73999999999978,16,2,5622.26,5640.0
14575,U59F74C,18,14204.59,13,5,9912.4,24116.99
14576,U468EAB,18,162.05000000000015,16,2,1453.9399999999998,1615.99
14577,U562E78,18,-267.82,17,1,367.82,100.0
14578,UFD07AB,18,-120.0,12,6,12120.0,12000.0
14579,U951949,18,-8.000000000000014,16,2,404.26,396.26
14580,U88DAC3,18,-1326.6000000000008,13,5,11339.329999999998,10012.73
14581,U402ED1,18,47.239999999999995,11,7,733.4,780.64
14582,U5013EB,18,-560.1700000000001,13,5,2395.9,1835.73
14583,UF6CF94,18,368.4200000000001,15,3,1696.5,2064.92
14584,U3F998E,18,-3617.24,18,0,3617.24,0.0
14585,U9508F6,18,-455.78000000000003,16,2,486.78000000000003,31.0
14586,UD7FE2E,18,-7741.6,16,2,11094.38,3352.78
14587,U2FC48A,18,2081.36,16,2,181.64,2263.0
14588,UF6DDAB,18,-382.31,18,0,382.31,0.0
14589,UD31D64,18,27605.160000000003,10,8,25301.0,52906.16
14590,UF520C0,18,1148.67,7,11,2546.33,3695.0
14591,U9C64FC,18,-1321.6999999999998,13,5,28461.36,27139.660000000003
14592,U328B68,18,-2071.9299999999994,14,4,16351.93,14280.0
14593,U7B6C92,18,-51128.35,13,5,92718.44,41590.09
14594,U04F71D,18,-4592.46,11,7,31500.800000000003,26908.339999999997
14595,UAE450B,18,330.35,12,6,14981.15,15311.5
14596,UDFB9D7,18,-305.5899999999999,13,5,1509.4299999999998,1203.84
14597,U19EB11,18,-1002.8800000000001,15,3,12936.6,11933.720000000001
14598,UC8F1F3,18,-1357.2,12,6,1861.92,504.72
14599,U85738C,18,-490.0699999999999,11,7,5331.34,4841.27
14600,UE0EBA3,18,-5035.28,10,8,16376.220000000001,11340.939999999999
14601,UFD1742,18,-673.8,14,4,1225.8,552.0
14602,UD37702,18,-3594.0499999999993,12,6,26862.57,23268.52
14603,UD7EFB3,18,-103.32999999999987,14,4,1125.8899999999999,1022.56
14604,UE5E2F6,18,-280.28999999999985,13,5,9890.8,9610.51
14605,UA16E19,18,-52.0,16,2,95.0,43.0
14606,UE8CD2A,18,491.5899999999983,7,11,32157.0,32648.590000000004
14607,UB59F48,18,-223.0,12,6,1974.0,1751.0
14608,UAE754C,18,0.0,12,6,16000.0,16000.0
14609,U9EBB51,18,-880.79,16,2,1079.81,199.02
14610,UB25784,18,0.0,12,6,10000.0,10000.0
14611,UF10505,18,9115.15,10,8,14144.02,23259.17
14612,U356D42,17,11080.7,13,4,735.48,11816.18
14613,U8EF080,17,310.7000000000001,11,6,703.89,1014.5900000000001
14614,UDF8D83,17,-270.48,15,2,352.51,82.03
14615,UFD1E29,17,4059.219999999999,11,6,4088.3600000000006,8147.58
14616,UCCD65C,17,60.0,7,10,47940.0,48000.0
14617,UBB9E7C,17,17042.42,6,11,23982.960000000003,41025.37999999999
14618,U28472F,17,189.14999999999986,14,3,1390.92,1580.07
14619,U8BC782,17,61.80000000000018,15,2,6728.36,6790.16
14620,U84374C,17,-24341.11,10,7,60381.01,36039.9
14621,U7525D2,17,-29850.259999999995,10,7,148355.0,118504.74
14622,U2210DC,17,4.0,13,4,14134.0,14138.0
14623,UA34BB9,17,-1437.4200000000003,15,2,4286.21,2848.79
14624,UE3D508,17,9602.68,12,5,8760.800000000001,18363.48
14625,UE0CBB2,17,-1133.9099999999999,13,4,5039.65,3905.74
14626,U7D9184,17,1636.52,14,3,1654.19,3290.71
14627,U5C529E,17,-410.1800000000001,14,3,1512.0400000000002,1101.86
14628,U1CCEA7,17,124.17999999999984,12,5,2705.02,2829.2
14629,U9FDEB8,17,-525.4200000000003,15,2,3756.1800000000007,3230.76
14630,U1F79F8,17,-1489.6499999999996,14,3,5368.140000000001,3878.4900000000002
14631,U7A3E5F,17,-603.8700000000003,14,3,6157.91,5554.04
14632,U2D545E,17,-61.53999999999999,14,3,1150.54,1089.0
14633,U617E4C,17,-12008.98,7,10,21532.8,9523.82
14634,UAA3A1D,17,2215.3199999999997,15,2,2784.6800000000003,5000.0
14635,U01F4F9,17,-159.5,11,6,317.0,157.5
14636,UD67155,17,127.85999999999967,12,5,15774.419999999998,15902.28
14637,UDEB155,17,8226.9,14,3,16986.14,25213.039999999997
14638,UD71925,17,-9489.25,10,7,24200.0,14710.75
14639,U3B2529,17,-3.8999999999999773,14,3,5504.9,5501.0
14640,UCA97A5,17,-1012.4300000000001,12,5,1374.5,362.07000000000005
14641,UA778D9,17,-125.33000000000013,14,3,2881.87,2756.54
14642,UE647B5,17,-13200.0,11,6,41805.56,28605.559999999998
14643,UE0F51D,17,158.2999999999999,15,2,2291.7000000000003,2450.0
14644,UF8C843,17,0.0,15,2,43421.88,43421.88
14645,UC84BB5,17,156.5699999999997,7,10,9004.0,9160.57
14646,U477711,17,-766.1200000000003,13,4,8714.0,7947.879999999999
14647,U41973E,17,-1160.29,11,6,12363.81,11203.52
14648,UA965FA,17,-551.2199999999999,15,2,5251.22,4700.0
14649,UD248AA,17,9986.460000000001,11,6,13686.14,23672.6
14650,UB4DE23,17,-15965.87,9,8,29870.28,13904.41
14651,U1398CB,17,26264.15000000001,6,11,89210.18000000001,115474.33000000002
14652,U34DA3C,17,-12228.62,12,5,14928.62,2700.0
14653,U195053,17,-1961.800000000001,14,3,13113.15,11151.349999999999
14654,UD9FFF2,17,-1276.9299999999998,15,2,2179.2799999999997,902.35
14655,U6F1AB7,17,12175.480000000001,10,7,2341.0800000000004,14516.56
14656,UA81BF7,17,-11917.900000000001,16,1,11937.900000000001,20.0
14657,U3A0751,17,-94.22000000000025,12,5,14168.0,14073.779999999999
14658,U0C5B17,17,27060.409999999996,15,2,30822.410000000003,57882.82
14659,U8F099E,17,641.0,10,7,28560.0,29201.0
14660,UF2E109,17,6648.97,10,7,10732.269999999999,17381.239999999998
14661,UB77E33,17,8668.080000000002,9,8,22025.0,30693.08
14662,U34BB89,17,-900.5300000000004,12,5,10186.0,9285.469999999998
14663,UD941B3,17,7921.009999999999,14,3,3450.22,11371.23
14664,UEEA14B,17,0.0,8,9,20000.0,20000.0
14665,UB91482,17,-4241.15,15,2,6261.15,2020.0
14666,UC44405,17,-1.900701818158268e-13,13,4,5578.0599999999995,5578.0599999999995
14667,UFF0F19,17,-318.7,14,3,925.7600000000001,607.06
14668,U5E9118,17,-12693.68,14,3,26321.5,13627.82
14669,U00DBDB,17,26942.34,11,6,8841.210000000001,35783.55
14670,U06F1A6,17,9524.51,12,5,4175.49,13700.0
14671,UDCE4A9,17,-13902.92,9,8,31682.98,17780.06
14672,U7C7707,17,0.0,9,8,16000.0,16000.0
14673,U6FD0A2,17,-205.94999999999982,15,2,6455.0,6249.05
14674,UF7A655,17,-1.8474111129762605e-13,15,2,893.6,893.5999999999999
14675,U1384B4,17,-227.52000000000024,11,6,10654.260000000002,10426.74
14676,UCD53CE,17,-5183.9,12,5,10764.44,5580.54
14677,UF9F28C,17,-812.9399999999998,14,3,2537.48,1724.54
14678,U21828C,17,-26238.300000000003,13,4,39695.53,13457.23
14679,UD678F7,17,-25.829999999999973,11,6,1022.6199999999999,996.79
14680,UFF0942,17,-31379.709999999992,10,7,316719.1,285339.39
14681,UB9DE2E,17,-1858.68,16,1,1858.69,0.01
14682,UABA1C7,17,264.03999999999985,8,9,7006.09,7270.130000000001
14683,UF90EEB,17,-549.0999999999997,10,7,3709.84,3160.7400000000002
14684,U846C44,17,-1.3677947663381929e-13,12,5,1496.4000000000003,1496.3999999999999
14685,U848DB0,17,3549.03,13,4,2061.5299999999997,5610.56
14686,U81107F,17,-10089.619999999999,13,4,13391.900000000001,3302.2799999999997
14687,U431201,17,3195.4800000000005,12,5,7602.860000000001,10798.34
14688,U7661C0,17,0.9799999999999891,10,7,190.98,191.96
14689,U3A645E,17,0.0,12,5,6000.0,6000.0
14690,U311039,17,-6765.429999999999,14,3,11754.22,4988.79
14691,U7B2544,17,-19803.67,11,6,83163.23999999999,63359.57
14692,U01BD4C,17,-0.9899999999979627,11,6,36001.0,36000.01
14693,U36716A,17,277.81999999999977,14,3,1932.08,2209.9
14694,U8F376D,17,-24988.68,13,4,57562.8,32574.12
14695,UA842D0,17,-2846.95,13,4,3756.97,910.02
14696,UE774D9,17,-9662.649999999998,11,6,43596.399999999994,33933.75
14697,U1E9240,17,-25439.96,6,11,131158.0,105718.04000000001
14698,U8569E9,17,-663.2800000000001,14,3,2650.4,1987.12
14699,U6E705F,17,2919.990000000001,9,8,20225.23,23145.22
14700,U453347,17,-3400.76,16,1,4616.290000000001,1215.53
14701,U65AF09,17,187.01,13,4,1133.49,1320.5
14702,U97346E,17,-281.39000000000306,13,4,62374.990000000005,62093.6
14703,UE76D97,17,50.0,8,9,32058.0,32108.0
14704,UACACEA,17,-3671.25,15,2,8773.34,5102.09
14705,U1F38D9,17,15.539999999999964,11,6,1737.98,1753.52
14706,U5FBF73,17,-6971.0,14,3,11589.8,4618.8
14707,UCE0A6E,17,-12.0,5,12,6909.0,6897.0
14708,U9CDB3E,17,-3213.47,10,7,15799.309999999998,12585.84
14709,U30AD4D,17,1721.0000000000005,12,5,4446.3,6167.3
14710,U0DEAEC,17,38990.67,12,5,8069.1,47059.77
14711,U310A82,17,13749.0,9,8,17854.0,31603.0
14712,UE9362D,17,-876.5300000000007,10,7,14052.24,13175.71
14713,UFF82D4,17,-340013.69,12,5,431194.20999999996,91180.52
14714,U2526BA,17,12964.18,13,4,10251.82,23216.0
14715,U7D5149,17,-3.2199999999995086,12,5,6359.0,6355.78
14716,UDA38D1,17,-12136.08,10,7,34601.78,22465.699999999997
14717,UB8B5A2,17,-3.552713678800501e-15,10,7,84.77,84.77
14718,UA349D4,17,-2273.47,12,5,4192.09,1918.62
14719,U5B83E0,17,14138.410000000002,14,3,1920.51,16058.92
14720,U3CED47,17,-1938.3900000000003,11,6,6012.97,4074.5799999999995
14721,UEFB6AD,17,-1356.1399999999999,15,2,7356.139999999999,6000.0
14722,U73ECB4,17,-2526.5600000000004,17,0,2526.5600000000004,0.0
14723,U61F381,17,5972.0,15,2,14845.0,20817.0
14724,U5CFE98,17,4988.190000000001,10,7,21216.710000000003,26204.9
14725,U79C40A,17,2643.1600000000008,13,4,6684.85,9328.01
14726,UBBCFBA,17,-7798.4,13,4,8652.52,854.12
14727,UAA3529,17,-7572.0,9,8,61416.0,53844.0
14728,U6CD176,17,-2412.7699999999995,12,5,10702.78,8290.01
14729,UAFB26E,17,-1855.7999999999997,14,3,2255.7999999999997,400.0
14730,U7E5699,17,-12642.17,16,1,12642.18,0.01
14731,U272607,17,-891.13,13,4,1714.58,823.45
14732,U3E6C17,17,-1156.62,16,1,1371.6200000000001,215.0
14733,UFC6AC2,17,3332.42,13,4,1059.46,4391.88
14734,U528FA4,17,9.760000000000218,6,11,6636.5,6646.26
14735,UDD02C3,17,-13.889999999999645,11,6,19750.37,19736.480000000003
14736,UA20658,17,3228.6800000000003,15,2,4171.529999999999,7400.21
14737,U278320,17,3357.5,14,3,298.21,3655.71
14738,U5620A1,17,2488.4100000000003,10,7,5924.639999999999,8413.050000000001
14739,UD61E9E,17,5676.070000000001,13,4,5767.919999999999,11443.99
14740,U93411F,17,-656.6,17,0,656.6,0.0
14741,U8E479A,17,2150.950000000001,14,3,8227.699999999999,10378.65
14742,UF0CCA3,17,-133601.08000000002,11,6,216117.46,82516.38
14743,UC07086,17,-7128.290000000006,8,9,502851.91000000003,495723.62
14744,U152717,17,-15198.459999999997,16,1,15415.459999999997,217.0
14745,U08840D,17,50.22999999999999,15,2,216.07000000000002,266.3
14746,U90D4CC,17,1039.63,9,8,3901.34,4940.97
14747,U1DEFC8,17,-1169.01,14,3,6476.36,5307.349999999999
14748,U01A5DC,17,3495.1799999999994,13,4,3230.6699999999996,6725.849999999999
14749,UB64265,17,459.8799999999992,13,4,13559.12,14019.0
14750,U8B71CC,17,2.1599999999998545,15,2,1798.0,1800.16
14751,UD6AD1C,17,1600.14,14,3,11400.0,13000.14
14752,U63536F,17,692.6499999999996,10,7,11410.0,12102.65
14753,UA8DA89,17,6878.18,13,4,31055.0,37933.18
14754,UC2A18D,17,-167332.69,9,8,242467.31,75134.62
14755,U62ABE7,17,765.3,12,5,80235.09,81000.39
14756,UB337CC,17,3738.000000000001,14,3,41310.869999999995,45048.87
14757,U351EAB,17,0.2999999999998977,11,6,3444.7000000000003,3445.0
14758,UE9DF96,17,-1513.49,17,0,1513.49,0.0
14759,UBC9356,17,-16528.31,11,6,77736.43000000001,61208.119999999995
14760,U4BF7F9,17,-577.95,8,9,6765.37,6187.42
14761,U51B376,17,-2966.159999999986,11,6,758214.0,755247.84
14762,UF4085B,17,62.88999999999942,12,5,5744.41,5807.3
14763,UFE48E3,17,-9645.98,16,1,10829.98,1184.0
14764,UDB9025,17,99.36000000000001,15,2,1366.64,1466.0
14765,U400D0C,17,113.17999999999999,13,4,1043.82,1157.0
14766,U5545CA,17,21190.599999999995,13,4,186050.0,207240.6
14767,U3EC313,17,-3684.77,8,9,5051.0,1366.23
14768,U7E1F8E,17,9047.06,8,9,38822.939999999995,47870.0
14769,UEF99CF,17,1800.0000000000005,6,11,34635.06,36435.06
14770,U0253CB,17,-337.22000000000025,12,5,7096.9,6759.68
14771,UC90297,17,-1266.0000000000002,15,2,2861.28,1595.28
14772,U7D215F,17,-405.0099999999994,15,2,2661.3499999999995,2256.34
14773,U95CBDD,17,-10.000000000000455,11,6,7537.380000000001,7527.38
14774,U05ACF1,17,-1470.8899999999999,8,9,1583.08,112.19
14775,U6BD2FD,17,5667.049999999999,14,3,1071.5,6738.549999999999
14776,UD544B8,17,-985.0400000000009,11,6,85861.04000000001,84876.0
14777,UB87B8D,17,-6894.55,14,3,15937.39,9042.84
14778,UCD4555,17,-9.094947017729282e-13,13,4,10206.5,10206.5
14779,UBA13F3,17,213.8300000000001,9,8,2303.54,2517.3700000000003
14780,UF57778,17,26686.439999999995,12,5,43470.0,70156.44
14781,U3EC5D4,17,-48.02999999999999,14,3,256.57,208.54000000000002
14782,U0A4ADE,17,-2791.7799999999997,14,3,7763.58,4971.8
14783,U9792ED,17,1342.74,6,11,1667.8999999999999,3010.64
14784,UA07727,17,-6155.67,14,3,6655.8099999999995,500.14
14785,UA618B3,17,-2144.75,8,9,9365.17,7220.42
14786,U436FEB,17,-554.01,15,2,1091.3600000000001,537.35
14787,UDC7AD2,17,-20250.59,11,6,29036.800000000003,8786.210000000001
14788,UDFCD11,17,-8864.98,14,3,32351.96,23486.98
14789,U1589F5,17,-15.219999999996844,9,8,38985.380000000005,38970.16000000001
14790,U7AAE23,17,12324.47,12,5,213.45,12537.920000000002
14791,U086787,17,-44513.06999999999,11,6,120412.12999999999,75899.06
14792,UDEB71A,17,-2376.67,8,9,9930.140000000001,7553.47
14793,U26602F,17,2120.0599999999977,8,9,32802.06,34922.119999999995
14794,U0DD039,17,18034.699999999997,13,4,525.1,18559.8
14795,U233FAC,17,-2468.11,16,1,2475.11,7.0
14796,U8307B7,17,-1011.9100000000012,11,6,54543.11,53531.2
14797,U738EBD,17,-648.4200000000001,15,2,8005.52,7357.1
14798,U31A794,17,102.99000000000001,14,3,1309.1,1412.09
14799,U386786,17,1004.9300000000001,14,3,172.86,1177.79
14800,U257080,17,270.9,11,6,2961.9,3232.8
14801,UD31ED3,17,-3164.62,15,2,7464.62,4300.0
14802,U1AB4A0,17,47.0,11,6,1866.26,1913.26
14803,UA351CF,17,934.0999999999999,15,2,7068.9,8003.0
14804,UE0A2BF,17,-892.7700000000004,11,6,10995.75,10102.98
14805,U3C2219,17,-1099.3999999999999,15,2,1178.5,79.1
14806,UC5F08F,17,1569.1999999999998,15,2,3154.8,4724.0
14807,U2382E1,17,678.5600000000001,10,7,1037.9,1716.4600000000003
14808,UD0145C,17,4.0,11,6,7996.0,8000.0
14809,U557A01,17,-6858.41,11,6,10375.41,3517.0
14810,U2B2885,17,346.59999999999974,13,4,2517.8,2864.4
14811,U4BE1C6,17,-4.8400000000001455,11,6,8310.0,8305.16
14812,U37EECA,17,6598.0,14,3,33002.0,39600.0
14813,UD6F691,17,0.0,12,5,9007.599999999999,9007.6
14814,U299F2D,17,-123793.04,11,6,202750.0,78956.96
14815,U8DED96,17,14816.1,5,12,1802.9,16619.0
14816,UD3A88F,17,-40755.5,14,3,66552.22,25796.72
14817,U737198,17,435.20000000000005,16,1,1164.7999999999997,1600.0
14818,U79AF07,17,11494.32,13,4,1773.92,13268.24
14819,UFEF991,17,-2541.7400000000052,15,2,22557.4,20015.659999999996
14820,UCBABBE,17,10826.01,13,4,20057.440000000002,30883.45
14821,U26126F,17,-361.89000000000016,14,3,5647.6,5285.71
14822,UB14336,17,-363.53999999999996,16,1,364.21,0.67
14823,U984BF4,17,-1722.1499999999996,15,2,9247.15,7525.0
14824,U8A5C37,17,-382.0,14,3,551.7899999999998,169.79
14825,U707BC2,17,-43.05000000000001,11,6,248.97,205.92
14826,U595BD1,17,-2797.66,16,1,3041.2000000000003,243.54
14827,UAA18CD,17,97.23000000000138,14,3,15082.91,15180.14
14828,U89A602,17,9906.910000000002,7,10,218.62,10125.53
14829,UA90D28,17,-1.5399999999999752,16,1,509.53999999999996,508.0
14830,U457C6A,17,612.5000000000018,15,2,6090.27,6702.77
14831,UF54CC6,17,66.35999999999991,11,6,11077.5,11143.859999999999
14832,UC12D24,17,-13234.05,14,3,24353.530000000002,11119.48
14833,U799EBC,17,-857.53,17,0,857.53,0.0
14834,U2BCFF7,17,-6258.720000000002,13,4,24907.449999999997,18648.729999999996
14835,U5AAEC2,17,-4200.67,12,5,21904.71,17704.04
14836,U188A45,17,181576.0,2,15,30000.0,211576.0
14837,UF955C6,17,-41.73999999999796,8,9,39930.0,39888.26
14838,UEA3744,17,541.31,15,2,1215.5900000000001,1756.8999999999999
14839,U4626EB,17,-480.3499999999986,13,4,12142.340000000002,11661.99
14840,U50A687,17,1529.8200000000004,14,3,3664.2,5194.02
14841,U7E1E51,17,-15775.86,17,0,15775.86,0.0
14842,U47CD94,17,-2278.8499999999995,13,4,15007.480000000001,12728.63
14843,U0FFBF9,17,-238.86000000000058,9,8,101343.45999999999,101104.6
14844,U73C55F,17,8213.640000000003,10,7,94322.8,102536.44
14845,UDCB3E5,17,367.99999999999966,13,4,4965.759999999999,5333.76
14846,U6AC6BE,17,-5844.5,14,3,6954.5,1110.0
14847,U4DA632,17,-7.0,10,7,16007.0,16000.0
14848,U0F9640,17,9023.51999999999,8,9,82887.05,91910.57
14849,UD30509,17,-7338.87,14,3,9153.3,1814.43
14850,U725630,17,-4485.3,15,2,5079.3,594.0
14851,U32E128,17,1327.000000000001,14,3,5833.500000000001,7160.500000000001
14852,UDB1BA4,17,-7167.9,9,8,18720.559999999998,11552.66
14853,U779C22,17,251.20000000000005,14,3,1721.92,1973.12
14854,U7CD228,17,-489.2900000000001,13,4,1688.4,1199.11
14855,U38CFE7,17,-10316.18,13,4,10738.2,422.02
14856,UEF9709,17,3251.4099999999994,14,3,8113.959999999998,11365.369999999999
14857,U33F205,17,-12000.0,8,9,40020.0,28020.0
14858,U641D3F,17,1038.23,12,5,9838.23,10876.46
14859,U228F64,17,-19108.39,13,4,20020.0,911.61
14860,U4CC0C0,17,-2258.2599999999998,7,10,7173.0,4914.74
14861,UB3DE1E,17,1974.1200000000008,9,8,15821.0,17795.12
14862,UC8497A,17,24572.059999999998,12,5,9685.7,34257.76
14863,UA1B916,17,194.76999999999995,11,6,217.31,412.08
14864,U8651D8,17,100.08000000000038,8,9,4091.31,4191.39
14865,U33158B,17,-1568.8600000000006,15,2,4853.78,3284.92
14866,U3C5136,17,-584.3099999999991,4,13,11471.03,10886.72
14867,U37C922,17,-1.4921397450962104e-13,14,3,1517.56,1517.56
14868,UEE95C5,17,-50320.0,11,6,66320.0,16000.0
14869,U8535AB,17,954.3299999999999,14,3,4995.0,5949.33
14870,U379A9E,17,1124.85,10,7,1088.33,2213.18
14871,U242D3B,17,-1.0,8,9,24011.0,24010.0
14872,U2D394B,17,-5658.21,15,2,7705.21,2047.0
14873,U164AB2,17,5495.88,10,7,5982.86,11478.74
14874,UBB2622,17,10430.16,11,6,14104.470000000001,24534.629999999997
14875,U6F69EC,17,550.68,15,2,1927.31,2477.99
14876,U08E632,17,-8232.51,15,2,27245.61,19013.1
14877,UD71E1A,17,113.38000000000011,13,4,2707.5,2820.88
14878,U779B22,17,52.00999999999999,12,5,159.85000000000002,211.86
14879,UF093EE,17,8638.31,9,8,5756.179999999999,14394.49
14880,UCEF370,17,25483.699999999997,8,9,25386.3,50870.0
14881,UE909EB,17,9270.23,9,8,12702.34,21972.57
14882,U3CA1D2,17,-36.35000000000022,8,9,16286.66,16250.310000000001
14883,U498686,17,-3052.3999999999996,13,4,4679.82,1627.42
14884,UFEBA4B,17,1829.8200000000002,14,3,8823.18,10653.0
14885,U2484DC,17,7.2999999999999545,9,8,6232.699999999999,6240.0
14886,U9633EA,17,-3455.8999999999996,12,5,25640.0,22184.1
14887,U58D54B,17,577.0,11,6,1192.0,1769.0
14888,UAEF44D,17,18.090000000000146,14,3,7870.910000000001,7889.0
14889,UB55141,17,87954.16999999998,9,8,210024.65,297978.82
14890,UB94D21,17,5663.549999999999,11,6,21620.34,27283.89
14891,UEA0523,17,-16990.77,9,8,29333.05,12342.28
14892,U24DBF0,17,-5138.369999999999,12,5,66066.5,60928.13
14893,UB2BCE8,17,10956.12,9,8,52290.88,63247.0
14894,U4E4A7E,17,70944.62,7,10,208932.4,279877.02
14895,U60B181,17,42794.72,12,5,34664.28,77459.0
14896,U53A299,17,9711.32,14,3,8522.58,18233.9
14897,UD409AD,17,3841.6100000000006,14,3,11235.84,15077.45
14898,UA7B92F,17,-7941.049999999999,14,3,17138.989999999998,9197.94
14899,U4A95A1,17,-16665.289999999997,13,4,20511.82,3846.53
14900,U9A594E,17,1783.11,12,5,1737.5,3520.61
14901,UA8BE4A,17,141.56999999999994,15,2,578.43,720.0
14902,UBD5E1A,17,-2583.24,8,9,13506.0,10922.76
14903,U0B8DDC,17,45875.009999999995,7,10,152234.59,198109.6
14904,U770FC0,17,-234.07000000000005,15,2,731.83,497.76
14905,U35E746,17,904.21,7,10,14706.0,15610.21
14906,UD2D9EB,17,79.69999999999982,11,6,18735.3,18815.0
14907,U7074FF,17,-1244.94,13,4,1377.8,132.85999999999999
14908,UDF87BF,17,545.52,14,3,609.72,1155.24
14909,U6321CE,17,-5339.17,14,3,36239.17,30900.0
14910,U3321A4,17,1080.6399999999999,11,6,1726.3600000000001,2807.0
14911,U27F970,17,39.70999999999991,14,3,1467.75,1507.46
14912,UB81F62,17,-3822.2799999999993,16,1,3822.9899999999993,0.71
14913,UBF3CF6,17,-8073.539999999998,15,2,11073.919999999998,3000.38
14914,UC1BF29,17,-96.0,9,8,15656.0,15560.0
14915,U9708B4,17,10770.22,6,11,13149.25,23919.469999999998
14916,UB1C486,17,-18.999999999999986,15,2,204.35999999999999,185.36
14917,U605FA9,17,-1031.74,11,6,6902.05,5870.31
14918,U9EB837,17,0.67999999999995,9,8,2527.9,2528.58
14919,UFF51EA,17,-5027.12,8,9,15255.189999999999,10228.069999999998
14920,U4E58F3,17,447.0,15,2,13553.0,14000.0
14921,UD93819,17,2026.1,9,8,10293.740000000002,12319.839999999998
14922,UB63E21,17,193.71000000000026,14,3,5508.86,5702.57
14923,UC6E1CA,17,60.88999999999987,10,7,4791.32,4852.21
14924,UCE1233,17,180.25,10,7,6969.9,7150.15
14925,U2195A1,17,-8753.36,13,4,21866.32,13112.96
14926,U61888A,17,-164.93000000000006,11,6,9984.0,9819.07
14927,UA41B45,17,13.450000000000273,13,4,3330.74,3344.19
14928,U271B47,17,-134.46,13,4,158.03,23.570000000000004
14929,U24033C,17,1485.8999999999999,15,2,9795.339999999998,11281.240000000002
14930,U25F28D,17,-3562.9799999999996,14,3,9462.980000000001,5900.0
14931,UCA4AF7,17,1823.79,8,9,161799.0,163622.79
14932,U3F2DF5,17,48052.33000000001,9,8,114707.67,162760.0
14933,U464386,17,15.29999999999999,14,3,2516.78,2532.0800000000004
14934,U4D400F,17,2.26929586233382e-13,11,6,2884.75,2884.75
14935,UEE929D,17,863.4699999999998,15,2,1035.48,1898.95
14936,UD9C884,17,6961.6,11,6,33650.0,40611.6
14937,UB96D9B,17,-2976.11,14,3,3679.76,703.65
14938,UA697C3,17,-203.5399999999895,9,8,136768.83,136565.28999999998
14939,U2C8300,17,839.0000000000018,15,2,74141.0,74980.0
14940,UD98ED5,17,-481.0,12,5,24797.0,24316.0
14941,UAF280E,17,112.6099999999999,13,4,1909.27,2021.8799999999999
14942,UDBF768,17,3841.989999999999,12,5,22652.119999999995,26494.11
14943,UF6F984,17,-401.1300000000001,8,9,8000.0,7598.87
14944,U185C9B,17,30743.369999999995,10,7,20342.370000000003,51085.74
14945,UF2AF41,17,-1092.58,15,2,6972.0,5879.42
14946,U0B2574,17,-317.4,15,2,889.4,572.0
14947,U93521E,17,-166000.0,12,5,205022.5,39022.5
14948,U330899,17,1045.3100000000002,14,3,664.7399999999999,1710.0500000000002
14949,U0DE15A,17,662.0,3,14,283.0,945.0
14950,UF7A588,17,-36551.97,15,2,56703.97,20152.0
14951,UE324DE,17,1394.3199999999983,8,9,76866.8,78261.12
14952,UCB6B5F,17,-3826.1499999999996,16,1,5126.15,1300.0
14953,U7BDBC3,17,-5284.72,15,2,7347.72,2063.0
14954,U452B64,17,1515.4499999999998,14,3,5334.91,6850.36
14955,U26201A,17,5191.98,10,7,1273.1200000000001,6465.1
14956,UC91FCE,17,996.5200000000002,11,6,3021.1400000000003,4017.66
14957,UE39545,17,-3519.890000000001,11,6,22267.300000000003,18747.41
14958,U6246A3,17,1314.5599999999997,14,3,1186.68,2501.24
14959,U52DCA7,17,-1885.9199999999998,16,1,1890.9199999999998,5.0
14960,U9DBD1C,17,368.51999999999987,15,2,892.62,1261.1399999999999
14961,UD11D5C,17,-4262.0,10,7,7861.5199999999995,3599.52
14962,U706025,17,273.37000000000006,11,6,1600.3,1873.67
14963,UCD8F87,17,-5340.0,11,6,7401.26,2061.26
14964,UB4668C,17,-147.37000000000012,15,2,1721.7800000000002,1574.4099999999999
14965,U7DCF76,17,-1908.9100000000005,12,5,14391.4,12482.49
14966,U885A51,17,-947.9100000000003,9,8,21930.469999999998,20982.559999999998
14967,UEA958F,17,67.01000000000022,8,9,8553.0,8620.01
14968,UED0C15,17,-7806.09,14,3,17551.13,9745.04
14969,U51FD83,17,5000.0,10,7,14858.14,19858.14
14970,U121CDB,17,14940.919999999998,14,3,53597.08,68538.0
14971,UD78EFE,17,-161.37000000000003,15,2,1761.3700000000001,1600.0
14972,UF6A618,17,-812.9699999999998,15,2,5212.97,4400.0
14973,U13CE22,17,4499.070000000001,9,8,9527.01,14026.080000000002
14974,U4D5019,17,26.09999999999991,14,3,2317.11,2343.21
14975,UEC12AC,17,-126835.26999999997,14,3,127592.69999999998,757.4300000000001
14976,U9744F1,17,333.9599999999999,12,5,1397.8200000000002,1731.78
14977,UF28BBA,17,-1009.8399999999999,12,5,3016.9800000000005,2007.1399999999999
14978,UFF6805,17,-1071.9000000000015,12,5,40037.9,38966.0
14979,UAB29E2,17,3322.44,14,3,3870.0,7192.4400000000005
14980,U0A98C1,17,-1740.81,16,1,1799.31,58.5
14981,U324B79,17,-714.3199999999997,15,2,3431.48,2717.16
14982,U02F5DD,17,1219.3900000000003,15,2,997.5,2216.8900000000003
14983,U19E792,17,-19049.43,13,4,28809.05,9759.62
14984,UD24ECE,17,6205.629999999999,7,10,17713.77,23919.4
14985,UF5A8C1,17,2877.41,13,4,1075.6799999999998,3953.09
14986,U8BDF8F,17,242.20999999999995,13,4,2582.04,2824.25
14987,U655E93,17,128.7700000000009,9,8,13355.26,13484.03
14988,U3DA65F,17,727.5400000000004,8,9,9324.54,10052.080000000002
14989,U0D40B0,17,680.0799999999997,15,2,1335.55,2015.63
14990,U658191,17,-71.81999999999971,14,3,62537.32,62465.5
14991,U97E4C6,17,4076.0299999999997,11,6,1810.27,5886.3
14992,U47DE55,17,314.4900000000016,9,8,62085.58,62400.07
14993,UB6C833,17,3635.71,12,5,3966.0,7601.71
14994,U32379A,17,-3303.0000000000027,12,5,25602.339999999997,22299.339999999997
14995,UCE7EF2,17,8872.04,10,7,9699.9,18571.940000000002
14996,U6A58CC,17,-1040.9299999999985,9,8,25290.0,24249.07
14997,UCA9D79,17,-1008.9199999999998,14,3,3132.85,2123.9300000000003
14998,UC00244,17,-2791.9500000000007,7,10,27775.0,24983.05
14999,UACCA4F,17,-2647.0,15,2,40081.0,37434.0
15000,U42FCF7,17,136.57999999999998,14,3,508.4899999999999,645.0699999999999
15001,U906103,17,8252.220000000001,15,2,4947.779999999999,13200.0
15002,U4AB3ED,17,3416.4799999999996,6,11,25994.91,29411.39
15003,UFAEA27,17,-9160.720000000001,4,13,98967.0,89806.28
15004,UB040AA,17,130.09999999999997,16,1,569.9,700.0
15005,U7495EF,17,11139.86,8,9,3123.4599999999996,14263.32
15006,U8F85CC,17,663.0,15,2,391.16,1054.16
15007,UFA3C1C,17,-31486.530000000002,10,7,43549.98,12063.45
15008,UC78028,17,3985.95,15,2,2175.38,6161.33
15009,UBE1B02,17,-52150.43000000001,12,5,90143.72,37993.29
15010,U46800B,17,-36.329999999999984,10,7,806.18,769.85
15011,UC080A7,17,316.3499999999997,14,3,11345.65,11662.0
15012,UE07197,17,11150.339999999991,10,7,90686.9,101837.24
15013,U04DEAE,17,-657.1300000000001,15,2,3257.7200000000003,2600.59
15014,U72A5A0,17,-218.15999999999894,12,5,15070.4,14852.240000000002
15015,UB0FFFD,17,-94.97999999999996,9,8,2435.0,2340.02
15016,U4964C4,17,-4597.27,15,2,8825.09,4227.820000000001
15017,U5AFD18,17,-994.45,9,8,2450.0,1455.55
15018,U787AEB,17,-7190.36,11,6,33337.95,26147.589999999997
15019,UB91D46,17,2566.33,13,4,3341.67,5908.0
15020,UD0DBAB,17,744.0,11,6,1260.95,2004.95
15021,U8EEAE9,17,-14950.730000000001,14,3,56950.729999999996,42000.0
15022,U544E20,17,-5120.050000000001,11,6,24420.06,19300.01
15023,UD5CBF4,17,0.8899999999998727,12,5,1008.6700000000001,1009.56
15024,U6CA52D,17,-1255.9,15,2,8555.9,7300.0
15025,UDBCF1F,17,-73.95000000000027,9,8,4454.0,4380.049999999999
15026,UDA41E7,17,130.77999999999975,14,3,6226.220000000001,6357.0
15027,UDCA242,17,-1247.51,12,5,3304.51,2057.0
15028,U20DD29,17,911.2000000000007,10,7,53270.0,54181.2
15029,U174C27,17,5245.110000000001,8,9,96337.34,101582.45
15030,UFB1A97,17,-14898.119999999999,11,6,58574.78,43676.659999999996
15031,U1E20C5,17,-295.43,13,4,1419.07,1123.64
15032,U1C884D,17,16.90000000000009,13,4,2316.84,2333.74
15033,U403A3A,17,-43.900000000000546,15,2,11250.570000000003,11206.67
15034,U293738,17,1472.92,11,6,18912.510000000002,20385.43
15035,U1A785D,17,10208.130000000003,9,8,8691.32,18899.45
15036,U7CBA54,17,286.11,15,2,792.05,1078.1599999999999
15037,UBDC1EB,17,-3165.12,15,2,4263.450000000001,1098.33
15038,UFF0E16,17,19057.07,8,9,6112.8,25169.870000000003
15039,UD537F5,17,-142.99999999999977,9,8,10547.34,10404.34
15040,U7B15C1,17,-2384.8,15,2,3384.8,1000.0
15041,U219334,17,-942.6499999999999,13,4,2518.21,1575.56
15042,UE89FF8,17,-60.77000000000015,12,5,3081.0499999999997,3020.28
15043,UD46049,17,51.0,14,3,10957.0,11008.0
15044,UC49B01,17,-952.3199999999999,17,0,952.3199999999999,0.0
15045,UF21A57,17,-115.70000000000005,12,5,2108.5,1992.8
15046,U2C658E,17,1414.0,9,8,26500.0,27914.0
15047,U9DE1DE,17,2433.24,14,3,1304.02,3737.26
15048,U7597AB,17,-8227.029999999997,12,5,26171.180000000004,17944.149999999998
15049,UEAD83C,17,-1905.13,14,3,10735.89,8830.76
15050,UCE32BB,17,7122.939999999995,9,8,225094.44,232217.38
15051,U91032B,17,-9505.0,13,4,46450.0,36945.0
15052,U01D76E,17,-16978.68,11,6,48908.68000000001,31930.0
15053,U6018BF,17,-1880.799999999994,14,3,37519.799999999996,35639.0
15054,U8D266E,17,-99838.48999999998,9,8,210277.52000000002,110439.03
15055,UB51BB2,17,-424.72000000000014,14,3,4676.8099999999995,4252.09
15056,U20974C,17,-299.9899999999999,10,7,3551.8,3251.8100000000004
15057,U9AD4C4,17,3096.0300000000007,11,6,17829.98,20926.010000000002
15058,U188A10,17,-74.01000000000003,13,4,987.7,913.69
15059,UEA2139,17,-1213.99,16,1,1313.99,100.0
15060,U555A09,17,-1221.4299999999998,16,1,2521.4300000000003,1300.0
15061,UBAF923,17,-256.44999999999993,10,7,2224.87,1968.4199999999998
15062,U525289,17,-2652.8200000000006,14,3,6675.710000000001,4022.89
15063,U8325F0,17,6642.5199999999995,14,3,2503.61,9146.13
15064,UF51B57,17,7811.829999999998,14,3,1937.26,9749.09
15065,U3B97CD,17,-5430.99,15,2,5431.01,0.02
15066,UF8C35B,17,-9989.419999999998,11,6,99988.0,89998.58
15067,UDD73FD,17,-562.8199999999988,9,8,44635.560000000005,44072.740000000005
15068,UA19BB5,16,85.10000000000002,13,3,5108.9,5194.0
15069,U046575,16,-3982.0499999999997,14,2,7087.11,3105.06
15070,UB3A492,16,527.9099999999999,7,9,10215.36,10743.27
15071,U996FFA,16,-1497.76,13,3,1596.78,99.02
15072,UDD0ED7,16,-322.22000000000116,9,7,42199.35,41877.130000000005
15073,UCA5C96,16,1668.7200000000003,11,5,3919.81,5588.530000000001
15074,UDCE63A,16,-69.17999999999999,14,2,697.1800000000001,628.0
15075,UF7F086,16,-2605.3999999999996,13,3,13318.72,10713.32
15076,U12784F,16,-2741.2699999999995,12,4,6570.27,3829.0
15077,U431C68,16,-588.5799999999999,14,2,1108.59,520.01
15078,UF26239,16,-476.5699999999997,11,5,25064.0,24587.43
15079,U95C78B,16,7184.15,8,8,14280.74,21464.89
15080,U3D007C,16,-0.35999999999999766,9,7,35.5,35.14
15081,U416A77,16,-227.5,11,5,5986.5,5759.0
15082,UF78DC8,16,117.46999999999946,14,2,4448.59,4566.0599999999995
15083,UB632FE,16,14.41000000000001,9,7,485.6,500.01
15084,U65B9F9,16,367.61999999999944,14,2,2276.35,2643.97
15085,U3C4E83,16,-5728.420000000001,16,0,5728.420000000001,0.0
15086,UDCEAE5,16,1003.1699999999998,12,4,6122.2699999999995,7125.4400000000005
15087,U9892DF,16,0.0,14,2,2097.13,2097.13
15088,U6CB0F9,16,-7985.0,13,3,20985.0,13000.0
15089,UB2F00E,16,-14.759999999999977,5,11,243.83999999999997,229.07999999999993
15090,UD548AE,16,7663.37,14,2,21.0,7684.37
15091,U96C067,16,1525.9999999999995,12,4,6242.18,7768.18
15092,UEE1D20,16,-418.8099999999995,13,3,43265.22,42846.41
15093,U9FC359,16,-3401.3599999999997,16,0,3401.3599999999997,0.0
15094,UF55D9B,16,-2601.3999999999996,12,4,14803.07,12201.67
15095,U8252E3,16,-19213.289999999997,7,9,51645.0,32431.71
15096,UB47E2F,16,-76977.4,11,5,176739.0,99761.59999999999
15097,U9242AF,16,-306.05,13,3,1293.6599999999999,987.6099999999999
15098,UF56AEA,16,-2877.66,11,5,19606.0,16728.34
15099,UE1F123,16,0.06000000000040018,12,4,14025.8,14025.86
15100,U19BF62,16,-1870.5599999999997,16,0,1870.5599999999997,0.0
15101,U32086B,16,806.0700000000003,13,3,2898.94,3705.01
15102,U29A913,16,-1434.92,12,4,2635.87,1200.95
15103,UFDF6E9,16,-1434.0,14,2,7341.0,5907.0
15104,U0E5AC8,16,-23161.309999999998,13,3,24056.149999999998,894.84
15105,U2695A7,16,-10.0,9,7,5965.0,5955.0
15106,U457AC5,16,-959.2699999999999,12,4,1129.28,170.01
15107,U9B1FED,16,-254.82000000000005,13,3,619.8699999999999,365.05
15108,U925664,16,1999.0599999999977,11,5,215721.0,217720.06
15109,UF6A725,16,-9759.59,10,6,22179.590000000004,12420.0
15110,U3200C6,16,-1014.8800000000006,11,5,5252.45,4237.57
15111,UC59916,16,37016.369999999995,11,5,17980.4,54996.77
15112,U689847,16,5971.12,13,3,5029.88,11001.0
15113,U8174BA,16,-12019.9,16,0,12019.9,0.0
15114,UBCFAE6,16,6534.87,8,8,1016.08,7550.95
15115,U836B7E,16,166.71999999999997,9,7,1543.52,1710.24
15116,UCF26BC,16,-9000.0,9,7,20989.0,11989.0
15117,UD41F64,16,-757.08,13,3,4403.78,3646.7
15118,U6837D7,16,-974.6999999999992,13,3,10288.9,9314.2
15119,UC5BE64,16,1641.77,14,2,458.23,2100.0
15120,U0776F4,16,-1573.3600000000001,14,2,6078.280000000001,4504.92
15121,UC9BC57,16,0.0,8,8,20000.0,20000.0
15122,U310DEE,16,-19855.58,16,0,19855.58,0.0
15123,U1AF932,16,28073.119999999995,4,12,1600010.0,1628083.12
15124,UA44054,16,506.30999999999995,12,4,4640.15,5146.46
15125,U697A2F,16,-197.54999999999978,10,6,2802.0,2604.4500000000003
15126,U79F045,16,-353.96,13,3,826.27,472.31
15127,U74C773,16,4.319999999999993,9,7,227.68,232.0
15128,UC373C3,16,1322.21,12,4,1222.71,2544.92
15129,U7F4BCD,16,0.0,6,10,54013.8,54013.8
15130,U307D07,16,-187.6600000000035,8,8,45663.21000000001,45475.55
15131,U7F27BC,16,-130653.10999999999,12,4,137170.32,6517.21
15132,U9143DF,16,133.2,14,2,466.9,600.0999999999999
15133,UA3D71D,16,-1711.2599999999998,12,4,2145.3599999999997,434.1
15134,UEE015D,16,-86.23000000000029,12,4,9138.83,9052.6
15135,U9C0938,16,-3644.58,14,2,4608.4800000000005,963.9
15136,UE8447E,16,-7622.070000000001,13,3,8022.079999999999,400.01
15137,U2BADF0,16,9.700000000000045,8,8,889.8,899.5
15138,U44B653,16,-110.78999999999996,13,3,830.79,720.0
15139,U7E56B1,16,-2510.910000000001,10,6,28881.6,26370.69
15140,U6F270F,16,-1749.9999999999998,13,3,4181.2,2431.2
15141,U50A945,16,-1872.01,12,4,2885.68,1013.67
15142,UFDF7D7,16,-994.66,12,4,6646.529999999999,5651.87
15143,U25F0C4,16,-2816.9,11,5,3157.6699999999996,340.77
15144,UC60B2E,16,1832.8300000000002,12,4,529.65,2362.48
15145,UA00DA6,16,11611.359999999997,10,6,13987.610000000002,25598.969999999998
15146,UBD1D72,16,11492.409999999998,11,5,17656.59,29149.0
15147,U4A7BAA,16,383.74,14,2,715.82,1099.56
15148,U1B4882,16,-30468.68,12,4,52009.26,21540.579999999998
15149,UD6CB83,16,-212.80000000000018,13,3,7300.78,7087.98
15150,U4A2655,16,10.0,8,8,38790.0,38800.0
15151,U8F43B9,16,476.1699999999999,10,6,1610.97,2087.1400000000003
15152,UEE89A6,16,-2536.7100000000028,10,6,43736.740000000005,41200.03
15153,U8EDE39,16,5846.190000000002,8,8,38119.3,43965.49
15154,UF38672,16,15212.0,10,6,61156.15,76368.15
15155,U2BEE37,16,321.66999999999985,13,3,2588.3300000000004,2910.0
15156,UCBB70D,16,6760.0,5,11,44400.0,51160.0
15157,U9695EB,16,8992.800000000001,12,4,1671.55,10664.35
15158,UD44488,16,0.11000000000012733,12,4,2000.0,2000.1100000000001
15159,U552269,16,-13273.95,16,0,13273.95,0.0
15160,U907525,16,-12932.390000000003,14,2,36725.72,23793.33
15161,U343CE3,16,-2352.5800000000004,16,0,2352.5800000000004,0.0
15162,U33A960,16,194.40999999999985,14,2,9906.0,10100.41
15163,UA7AD41,16,-1973.0100000000007,14,2,11586.119999999999,9613.11
15164,U64F3D5,16,-135756.13000000003,10,6,287361.4,151605.27
15165,U45D86D,16,-2605.74,12,4,4779.26,2173.52
15166,U0BC724,16,-1381.04,16,0,1381.04,0.0
15167,UDB5A31,16,1159.0500000000002,10,6,10006.04,11165.09
15168,UA429C7,16,-35.59999999999989,10,6,6011.9,5976.300000000001
15169,UD492F6,16,9933.69,8,8,13200.0,23133.69
15170,UEB0B78,16,2.2700000000004366,13,3,11966.5,11968.77
15171,UDEF617,16,15931.850000000002,11,5,11703.5,27635.35
15172,U4F6575,16,-12988.0,9,7,56060.0,43072.0
15173,U99D384,16,-29.570000000006985,10,6,435370.14,435340.57
15174,UEA224F,16,269.92999999999995,10,6,1552.59,1822.52
15175,U1B1EBB,16,-223.47999999999996,13,3,990.4100000000001,766.9300000000001
15176,U2096B2,16,-76.83000000000038,12,4,8809.350000000002,8732.52
15177,U78C469,16,-65.0,9,7,35985.0,35920.0
15178,UE80C10,16,-3911.2299999999996,13,3,7075.0,3163.77
15179,UF65713,16,31.969999999999885,12,4,1184.8200000000002,1216.79
15180,UF904D4,16,3543.5999999999985,12,4,59898.34,63441.939999999995
15181,U08E261,16,23.599999999999454,9,7,29946.6,29970.199999999997
15182,UCD71E1,16,36.00999999999982,12,4,5876.29,5912.3
15183,U21A07E,16,-523.1599999999999,11,5,20446.2,19923.04
15184,U975D87,16,-20812.860000000004,5,11,141066.7,120253.84
15185,U4DD116,16,55.33000000000018,13,3,2154.8,2210.1300000000006
15186,UFFE3F8,16,-79.47000000000116,9,7,219931.0,219851.53
15187,U764FBD,16,13144.0,9,7,14857.0,28001.0
15188,U02879E,16,-525.34,16,0,525.34,0.0
15189,UBF61AE,16,-993.9100000000002,14,2,7770.45,6776.54
15190,U85E4F4,16,-1719.7099999999994,12,4,13099.4,11379.69
15191,U6FA724,16,1622.69,8,8,4756.32,6379.01
15192,UB2C19B,16,-575.9100000000001,13,3,1091.0600000000002,515.15
15193,UEAE26E,16,-2436.1400000000003,9,7,17797.0,15360.86
15194,UE8C0D5,16,-113.13000000000011,11,5,7374.0,7260.87
15195,U12D512,16,329.1699999999995,11,5,13202.670000000002,13531.84
15196,U34B9FE,16,-7114.780000000001,15,1,10267.560000000001,3152.78
15197,UAF78B9,16,70.62000000000035,14,2,4374.749999999999,4445.37
15198,UF6DA8D,16,-826.9000000000001,13,3,4816.97,3990.07
15199,U65147E,16,9096.0,9,7,31569.33,40665.33
15200,U11A86C,16,-3430.7800000000034,13,3,30783.9,27353.12
15201,U265BF9,16,-7284.19,11,5,8184.1900000000005,900.0
15202,UFF7806,16,431.7900000000001,13,3,2086.48,2518.27
15203,U937D9D,16,2258.999999999998,13,3,57491.0,59750.0
15204,U5424CE,16,-788.6800000000003,9,7,39122.90000000001,38334.219999999994
15205,UC69440,16,1441.8900000000003,9,7,8850.88,10292.77
15206,U632472,16,0.7400000000002547,8,8,2920.0299999999997,2920.77
15207,U9B9C6E,16,-4099.08,16,0,4099.08,0.0
15208,U0B09B8,16,-779.380000000001,11,5,32468.34,31688.96
15209,UC4C962,16,-90.09000000000002,14,2,416.99000000000007,326.9
15210,UE20FB9,16,-2445.1000000000004,12,4,2583.76,138.66
15211,U5DAC39,16,12586.000000000004,8,8,42258.0,54844.0
15212,UE16BD6,16,1248.4999999999998,7,9,6856.46,8104.96
15213,UA4459F,16,-543.7600000000007,14,2,4125.89,3582.13
15214,UD0BFA3,16,-16170.509999999998,13,3,16211.509999999998,41.0
15215,UB3E625,16,-146.29000000000002,9,7,782.89,636.6
15216,UA6F2B8,16,1908.57,13,3,2484.3099999999995,4392.88
15217,U843278,16,-33450.68,9,7,59334.0,25883.32
15218,UAF0FCD,16,71.59999999999985,14,2,14728.400000000001,14800.0
15219,U046DA4,16,-2091.21,12,4,42215.119999999995,40123.909999999996
15220,U7795B6,16,-12417.800000000001,16,0,12417.800000000001,0.0
15221,UCBCB89,16,-151.6899999999996,10,6,14246.0,14094.310000000001
15222,U5D0937,16,39358.3,12,4,2477.5,41835.8
15223,UD11B12,16,-29.74000000000001,13,3,598.74,569.0
15224,UE56BB5,16,785.8900000000003,11,5,6696.910000000001,7482.8
15225,UF1603F,16,-1900.8399999999995,13,3,5800.84,3900.0
15226,U432D23,16,-346.8999999999999,15,1,883.84,536.94
15227,U0A5523,16,-18073.460000000006,11,5,33273.46000000001,15200.0
15228,UE814DC,16,-13826.63,12,4,16567.719999999998,2741.09
15229,UD8172E,16,658.47,11,5,3618.53,4277.0
15230,UCF731C,16,-182.36999999999986,14,2,1942.35,1759.98
15231,U830372,16,-232.27999999999997,8,8,3303.0,3070.7200000000003
15232,U9643CD,16,-6613.84,12,4,7452.29,838.4499999999999
15233,U43C35D,16,34807.0,3,13,39913.0,74720.0
15234,U857C93,16,2297.2799999999993,13,3,7990.5,10287.779999999999
15235,UBE4D86,16,72.1099999999999,10,6,2904.68,2976.79
15236,UE67DCE,16,-2669.09,10,6,5473.240000000001,2804.15
15237,UDBEAE3,16,954.6899999999996,13,3,11686.810000000001,12641.5
15238,UA87543,16,20.28,14,2,142.72,163.0
15239,UD92C3B,16,-15303.069999999994,12,4,44092.219999999994,28789.149999999994
15240,U9E61BD,16,3881.2699999999995,14,2,397.93,4279.2
15241,UE80B25,16,-50322.300000000054,7,9,1470224.0,1419901.7
15242,U2E7721,16,-4989.93,14,2,5099.93,110.0
15243,UE63029,16,-748.6400000000002,15,1,1358.64,610.0
15244,U4781D8,16,282.85000000000014,13,3,1863.3,2146.15
15245,UFAF18E,16,-298.7,11,5,740.4599999999999,441.76
15246,UD2AAC0,16,1311.1999999999998,12,4,2412.8,3724.0
15247,U583D26,16,-4649.999999999998,8,8,37676.43,33026.43
15248,U241351,16,3155.3499999999985,13,3,38475.28,41630.630000000005
15249,U756CBA,16,-16023.85,14,2,22622.7,6598.85
15250,U93C491,16,1561.7499999999998,12,4,1809.5,3371.25
15251,UE2A4D2,16,4393.59,10,6,4050.0,8443.59
15252,UB76959,16,-13255.049999999997,16,0,13255.049999999997,0.0
15253,U6E8336,16,-27873.130000000005,15,1,31003.130000000005,3130.0
15254,UF94C21,16,-11677.64,13,3,12613.630000000001,935.99
15255,U11284F,16,3556.24,9,7,4741.9,8298.14
15256,U70BD4A,16,-3533.8199999999997,13,3,5111.260000000001,1577.44
15257,UA70488,16,6845.76,7,9,6865.3,13711.060000000001
15258,U766EB4,16,15046.519999999995,10,6,49661.78,64708.299999999996
15259,U43D04E,16,1144.96,11,5,1064.52,2209.48
15260,U64FF7B,16,-22263.250000000004,6,10,126228.58,103965.33000000002
15261,U266B6B,16,2549.789999999999,12,4,27627.14,30176.93
15262,U99482E,16,3959.85,10,6,1760.3600000000004,5720.21
15263,U00CDA7,16,-187.99999999999994,15,1,618.8,430.8
15264,U2B6158,16,456997.05,9,7,963028.0,1420025.05
15265,U32F8FF,16,-2644.1,10,6,12620.25,9976.15
15266,U2D466D,16,935.0,10,6,49025.0,49960.0
15267,UCB9439,16,-1668.5600000000004,14,2,9468.56,7800.0
15268,UF20E7F,16,662.8000000000002,13,3,2119.2,2782.0
15269,UC4AC99,16,2483.9800000000005,14,2,3587.3199999999997,6071.3
15270,U1C7E23,16,137.0,9,7,71726.0,71863.0
15271,U616ED1,16,-2989.3100000000004,12,4,13948.6,10959.289999999999
15272,U83E21C,16,5261.0,9,7,26349.0,31610.0
15273,U704B8B,16,901.94,15,1,2447.5099999999998,3349.45
15274,U046773,16,26046.720000000005,12,4,40210.78,66257.5
15275,U9132F0,16,-7470.76,13,3,21211.15,13740.39
15276,UCF9D6D,16,-3047.7599999999998,15,1,4047.7599999999998,1000.0
15277,UAC35F0,16,-893.8299999999999,14,2,1799.1399999999999,905.31
15278,UF578CB,16,-612.0799999999999,14,2,6733.030000000001,6120.950000000001
15279,UE01646,16,73.99999999999996,14,2,1097.5199999999998,1171.52
15280,U14B75D,16,30405.070000000003,7,9,4491.0,34896.07000000001
15281,U49B78C,16,-200.00000000000045,10,6,49768.73999999999,49568.74
15282,UFAFECC,16,-1267.4299999999998,10,6,6705.78,5438.349999999999
15283,UCF3A9E,16,-3831.2000000000007,10,6,33648.2,29817.0
15284,U51DAA9,16,-24052.809999999998,16,0,24052.809999999998,0.0
15285,UE5ECE1,16,5003.110000000001,11,5,9996.9,15000.01
15286,U0D270C,16,192137.16999999998,6,10,46045.0,238182.16999999998
15287,UD0F144,16,74.41000000000014,11,5,7252.04,7326.45
15288,U45B36E,16,1100.1100000000006,10,6,118750.0,119850.11
15289,U98E2F0,16,-430.6,8,8,29030.6,28600.0
15290,UF42E75,16,46.16999999999962,8,8,8432.849999999999,8479.02
15291,U800741,16,-179.48000000000013,13,3,2003.68,1824.2
15292,U5AE571,16,-1633.4100000000003,12,4,7283.41,5650.0
15293,UB71C15,16,-235.70000000000007,12,4,772.84,537.14
15294,U2F846B,16,-173.18000000000006,13,3,2589.21,2416.0299999999997
15295,UB01237,16,6708.75,13,3,823.16,7531.91
15296,U9ECCA3,16,5506.619999999999,13,3,15808.66,21315.28
15297,U9BAA61,16,9597.599999999999,6,10,7203.4,16801.0
15298,U20B0C2,16,-1322.4900000000002,13,3,7322.49,6000.0
15299,UA4AAE4,16,-3218.3600000000006,14,2,4118.400000000001,900.04
15300,U3F7AAC,16,1088.0,11,5,53492.0,54580.0
15301,UF17AAB,16,10665.2,11,5,107861.46,118526.66
15302,U8FDA0F,16,288.39000000000124,11,5,20419.260000000002,20707.65
15303,UC9CD73,16,724.9000000000001,10,6,1973.79,2698.69
15304,U6A3A82,16,172.01000000000022,12,4,9278.0,9450.01
15305,UE70549,16,589.2199999999999,10,6,1036.0,1625.22
15306,U52E6DA,16,90.0,9,7,9207.0,9297.0
15307,UA04A53,16,-2.842170943040401e-14,14,2,857.0,857.0
15308,U35D51E,16,-2176.29,12,4,7529.29,5353.0
15309,UD7F374,16,-30.329999999999988,12,4,152.53,122.2
15310,UE9A11E,16,-11.269999999999998,15,1,12.029999999999998,0.76
15311,U076B3D,16,1619.5700000000002,6,10,7765.33,9384.9
15312,U0362E0,16,-15764.0,14,2,30200.0,14436.0
15313,U4E1157,16,419.0,10,6,933.88,1352.88
15314,UEBEB88,16,-773.8400000000004,13,3,12703.719999999998,11929.880000000001
15315,U607F0A,16,-776.13,14,2,2560.0,1783.87
15316,UCE1EC5,16,-875.6199999999999,13,3,1160.76,285.14
15317,U3A7C42,16,501.87,9,7,307.84000000000003,809.7099999999999
15318,U1D2E19,16,5819.93,12,4,16848.07,22668.0
15319,U47B049,16,188.5600000000003,14,2,5464.4400000000005,5653.0
15320,UA76413,16,27.94999999999186,11,5,715258.64,715286.59
15321,U0607BB,16,-11364.999999999998,12,4,35123.26,23758.260000000002
15322,U59D942,16,-4272.0199999999995,16,0,4272.0199999999995,0.0
15323,UF719EF,16,3892.7,8,8,12713.25,16605.95
15324,U4ACFDF,16,-5372.82,13,3,5774.53,401.71000000000004
15325,UFDD99C,16,-19741.27,10,6,20710.0,968.73
15326,UAF97D1,16,-551.5600000000001,16,0,551.5600000000001,0.0
15327,UD83C27,16,-17222.46,12,4,17397.46,175.0
15328,U493887,16,-4171.5,11,5,6471.759999999999,2300.26
15329,UDF547B,16,627.4300000000001,14,2,4872.570000000001,5500.0
15330,U78DBF4,16,466.90999999999894,7,9,16547.84,17014.75
15331,UFEED20,16,-843.2799999999999,15,1,1394.8899999999999,551.61
15332,U39EE04,16,237.55999999999992,12,4,918.62,1156.18
15333,UD77988,16,1974.5,9,7,24465.5,26440.0
15334,UD910A2,16,-6757.9,14,2,11860.99,5103.09
15335,UE523B4,16,-37212.490000000005,9,7,198455.95,161243.46
15336,U3BEECF,16,-1504.13,13,3,5708.5,4204.37
15337,UEA8103,16,14056.920000000004,8,8,49313.94,63370.86
15338,U460999,16,0.00999999999476131,8,8,103008.91999999998,103008.92999999998
15339,UFACDC4,16,67.60000000000001,15,1,342.8999999999999,410.5
15340,U9DF288,16,1010.1600000000004,14,2,3689.84,4700.0
15341,UBE529F,16,-956.0300000000002,14,2,6117.7,5161.67
15342,UFB00A7,16,-40228.240000000005,7,9,114995.94,74767.7
15343,U569362,16,2721.9800000000014,9,7,15176.0,17897.98
15344,UE21ADD,16,-17267.28,14,2,17347.28,80.0
15345,UB549FD,16,-3018.12,16,0,3018.12,0.0
15346,UEC3998,16,-486.69,15,1,675.57,188.88
15347,U7D23BB,16,52120.58,8,8,59624.51,111745.09
15348,UAD4111,16,-9627.32,15,1,14290.32,4663.0
15349,U146920,16,1091.2000000000044,10,6,108342.5,109433.70000000001
15350,U76F79A,16,556.1399999999999,10,6,4689.860000000001,5246.0
15351,UBD6CAE,16,-41735.36,16,0,41735.36,0.0
15352,UF00B73,16,-6199.0,14,2,26207.0,20008.0
15353,U9875EC,16,-10.0,8,8,41710.0,41700.0
15354,U71D52E,16,343.4,14,2,650.2,993.6
15355,U36514A,16,0.0,9,7,493.0,493.0
15356,UE864E0,16,1482.0299999999997,9,7,1636.05,3118.08
15357,U2EFBC2,16,371.16999999999996,9,7,1085.5,1456.67
15358,UF4174B,16,-2460.41,14,2,2760.41,300.0
15359,U1304B4,16,-1199.0,15,1,4699.0,3500.0
15360,U46708D,16,-480.31000000000023,10,6,13587.89,13107.58
15361,U31344B,16,9222.08,10,6,27516.6,36738.68
15362,UC81222,16,14509.61,10,6,28328.0,42837.61
15363,UEA59EC,16,1315.37,12,4,2139.24,3454.61
15364,U7C7B82,16,1825.1899999999996,12,4,6349.5,8174.69
15365,U45EFA3,16,-2183.0400000000013,14,2,7223.700000000001,5040.66
15366,UA56E28,16,12565.199999999999,10,6,24534.87,37100.07
15367,UB76881,16,-5968.780000000001,13,3,11135.449999999999,5166.67
15368,U9BE4DA,16,-2228.7,13,3,12786.0,10557.3
15369,U380AAD,16,-2058.25,13,3,2360.25,302.0
15370,UADA88F,16,0.0,10,6,18000.0,18000.0
15371,U5702B7,16,-5117.32,7,9,32062.29,26944.97
15372,UEE9331,16,-12606.289999999999,16,0,12606.289999999999,0.0
15373,U6C17DD,16,9885.15,13,3,3394.2099999999996,13279.359999999999
15374,UADC7C9,16,2528.0600000000004,12,4,2748.91,5276.97
15375,U49D713,16,13195.14,14,2,1614.8600000000004,14810.0
15376,U173376,16,-2453.16,12,4,2771.0,317.84000000000003
15377,U396B97,16,190.61000000000007,14,2,1762.3899999999999,1953.0
15378,U935F54,16,1413.21,11,5,11239.02,12652.230000000001
15379,U6B8ED9,16,-127.26000000000022,12,4,2519.26,2392.0
15380,U35B981,16,226.02000000000044,8,8,8250.02,8476.04
15381,U881EFB,16,3270.060000000001,11,5,15171.94,18442.0
15382,U200F52,16,-132.11000000000004,14,2,169.43000000000004,37.32
15383,U1EBD1F,16,69259.98999999999,9,7,2593.5600000000004,71853.55
15384,U5A89F8,16,-39084.94,13,3,89644.94,50560.0
15385,U131A54,16,129.05,12,4,964.9499999999999,1094.0
15386,UD97C5E,16,-6051.0,16,0,6051.0,0.0
15387,U348D69,16,54.100000000000435,14,2,10998.43,11052.53
15388,U88C934,16,-26449.989999999998,12,4,47245.0,20795.01
15389,UD6E207,16,1712.9700000000012,7,9,25752.379999999997,27465.35
15390,U30AE4D,16,143.80000000000018,8,8,14998.2,15142.0
15391,U70966C,16,0.0,8,8,102000.0,102000.0
15392,UCF0890,16,-89.59000000000003,12,4,389.63,300.04
15393,U4EEF0A,16,-104.7299999999999,10,6,4766.82,4662.09
15394,U625986,16,-412.8899999999999,13,3,3220.22,2807.33
15395,UBE6BFD,16,5973.429999999999,13,3,14103.529999999999,20076.96
15396,U1B1400,16,-1179.85,14,2,2360.16,1180.31
15397,UE34C37,16,-342.95,12,4,2076.13,1733.18
15398,U38515D,16,-1871.17,9,7,3226.5,1355.33
15399,U6E75CE,16,287.78999999999996,10,6,1495.0,1782.79
15400,U29B2C9,16,6431.360000000003,11,5,10071.039999999999,16502.4
15401,U1B0D2F,16,10115.65,10,6,2339.42,12455.07
15402,U16975F,16,-12529.84,13,3,21962.260000000002,9432.42
15403,UD2BDA0,16,30774.0,10,6,22633.94,53407.94
15404,U87768A,16,-1726.98,13,3,3399.98,1673.0
15405,U00A1C2,16,-19157.779999999995,11,5,52343.33,33185.55
15406,U46E8F8,16,-5400.32,10,6,56141.0,50740.68
15407,U45B0F4,16,-2.8999999999999773,8,8,5115.9,5113.0
15408,U1EB0E2,16,131.20999999999998,12,4,1207.8,1339.01
15409,U1643B9,16,-452.0499999999998,14,2,4335.709999999999,3883.66
15410,UE133D6,16,-33773.93000000001,16,0,33773.93000000001,0.0
15411,U568053,16,-121.99,12,4,928.5,806.51
15412,UF7B067,16,762.4,13,3,563.2999999999998,1325.7
15413,UB55601,16,567.52,11,5,776.4,1343.92
15414,UF5BDC0,16,34313.2,8,8,4692.799999999999,39006.0
15415,U82FE1D,16,-2997.8099999999977,9,7,64852.0,61854.19
15416,UA87748,16,-8453.0,15,1,10755.0,2302.0
15417,U8B4926,16,38999.40000000001,3,13,109995.79999999999,148995.2
15418,U84FB2F,16,-3263.6600000000035,11,5,37245.259999999995,33981.6
15419,U6B1C97,16,-6102.8,7,9,7653.3,1550.5
15420,U4C9420,16,12647.13,15,1,10904.359999999999,23551.49
15421,UA29653,16,412.38000000000005,13,3,1030.51,1442.8899999999999
15422,U562B48,16,723.4,7,9,704.42,1427.8200000000002
15423,U0D50E3,16,992.4999999999895,7,9,216656.9,217649.4
15424,UF1A3D5,16,20030.04,7,9,26951.16,46981.200000000004
15425,U966E81,16,19007.19,6,10,2570.61,21577.8
15426,UBA2A58,16,-14935.279999999999,13,3,42076.28,27141.0
15427,UFB15B3,16,-3082.9900000000002,13,3,5085.9,2002.9099999999999
15428,U0A2A38,16,-1635.1999999999994,13,3,5194.38,3559.18
15429,UD64091,16,665.33,14,2,427.6,1092.93
15430,UBE9339,16,-87.0,13,3,3062.28,2975.28
15431,UB106F2,16,-3137.0,14,2,8852.000000000002,5715.0
15432,U3AF41E,16,3554.0,11,5,5031.0,8585.0
15433,UDBAB6B,16,-7677.450000000001,14,2,10377.449999999999,2700.0
15434,U7CC911,16,-1353.3899999999999,16,0,1353.3899999999999,0.0
15435,UB1BCC7,16,-813.8499999999999,15,1,813.8599999999999,0.01
15436,U08E883,16,-6773.66,13,3,14968.72,8195.06
15437,U2598F4,16,4320.52,14,2,4240.0,8560.52
15438,UCAA528,16,17729.170000000002,10,6,24940.460000000006,42669.630000000005
15439,U87DAC2,16,-42767.170000000006,15,1,47057.170000000006,4290.0
15440,U8B443E,16,0.0,8,8,10000.0,10000.0
15441,UEA95BC,16,419.5000000000015,11,5,12303.25,12722.75
15442,U865A65,16,-9418.44,16,0,9418.44,0.0
15443,UDCC0A0,16,-1277.2700000000004,10,6,47777.270000000004,46500.0
15444,UC34578,16,9486.010000000091,4,12,2471085.46,2480571.47
15445,U8FC504,16,-23467.800000000003,10,6,89630.88,66163.08
15446,UFEA0A2,16,7196.63,14,2,2145.16,9341.79
15447,U6B9DE4,16,-12170.170000000002,12,4,34070.17,21900.0
15448,U436DC2,16,-2604.7400000000125,9,7,504010.0,501405.26
15449,U2CDE74,16,7499.999999999999,14,2,2576.85,10076.85
15450,U925AA8,16,-15990.149999999998,12,4,46490.81,30500.66
15451,U44017C,16,-17500.0,7,9,51000.0,33500.0
15452,UAFDDC7,16,3454.5999999999995,9,7,3285.12,6739.719999999999
15453,UC79485,16,293.34000000000015,9,7,21054.67,21348.01
15454,UAFEE17,16,-11676.18,16,0,11676.18,0.0
15455,U11DE40,16,-1781.0,10,6,14104.0,12323.0
15456,UD5392B,16,69.63000000000102,8,8,43966.68,44036.310000000005
15457,UD6CB46,16,-249.4100000000003,10,6,26349.6,26100.19
15458,U2D3306,16,-23791.9,12,4,23978.6,186.7
15459,UF07C0E,16,-17035.74,13,3,22488.8,5453.06
15460,U6B8AEF,16,8810.73,11,5,737.07,9547.8
15461,UE5CD3A,16,2216.5599999999995,4,12,1642.44,3859.0
15462,U26DD9E,16,-20511.160000000033,5,11,376534.48,356023.32
15463,U5B653A,16,1035.6799999999998,11,5,2608.16,3643.84
15464,U7C4904,16,-3023.5399999999995,14,2,6047.08,3023.54
15465,UBF513F,16,664.1,13,3,185.9,850.0
15466,U5C8531,16,-2485.0299999999997,14,2,4987.32,2502.29
15467,UBF3D7C,16,218.59999999999988,10,6,854.9399999999999,1073.54
15468,U5F74F8,16,-2886.7200000000003,14,2,3270.04,383.32
15469,U46450B,16,541.69,11,5,2276.0,2817.69
15470,U9E7A8F,16,1984.12,13,3,2615.88,4600.0
15471,UC1A187,16,-3510.0,14,2,15510.0,12000.0
15472,UD4C065,16,3030.69,13,3,4569.3099999999995,7600.0
15473,UC13FED,16,-5713.909999999999,12,4,6045.379999999999,331.46999999999997
15474,U7930B0,16,105.30000000000018,7,9,5869.0,5974.299999999999
15475,UBD2E78,16,-4.369999999998981,9,7,20804.0,20799.63
15476,U1033BD,16,-1351.4899999999998,8,8,26800.0,25448.510000000002
15477,U7F6D8B,16,-3426.7000000000007,10,6,41193.28,37766.58
15478,U0983F0,16,437.90000000000003,14,2,599.0,1036.9
15479,U8AF95C,16,-2575.75,10,6,13226.319999999998,10650.57
15480,U95C24B,16,-1619.239999999998,14,2,14969.24,13350.0
15481,U05D4CB,16,45.17999999999972,12,4,39603.45,39648.63
15482,U9C2661,16,6588.660000000002,10,6,18420.25,25008.91
15483,UD7D0EE,16,-5259.469999999999,14,2,15126.26,9866.79
15484,U53CC89,16,-919.27,15,1,1278.0699999999997,358.8
15485,U384C4A,16,-6116.169999999999,13,3,10236.79,4120.62
15486,UA1C8C5,16,1.3999999999996362,10,6,7850.0,7851.4
15487,UF62A26,16,3875.8,6,10,44307.780000000006,48183.58
15488,UA1E45F,16,516.6200000000001,11,5,857.1500000000001,1373.77
15489,U298CBE,16,-2001.0,15,1,14969.0,12968.0
15490,U07A84C,16,82679.59,9,7,19108.559999999998,101788.15
15491,U124FEF,16,2141.0,9,7,5720.0,7861.0
15492,U8A3022,16,-945.9,16,0,945.9,0.0
15493,UBCFC18,16,12449.92,6,10,9378.06,21827.98
15494,UD71F91,16,100000.0,11,5,19610.34,119610.34
15495,U88FD89,16,-400.82000000000005,10,6,1800.92,1400.1
15496,U78E662,16,271.99999999999983,10,6,9754.58,10026.58
15497,U4AA8CB,16,74070.0,8,8,20436.0,94506.0
15498,U8D7D65,16,-509.10000000000036,6,10,63682.0,63172.9
15499,UDF9776,16,464.9200000000001,12,4,10933.0,11397.92
15500,UBA4BA8,16,-536.8599999999997,12,4,7309.9800000000005,6773.120000000001
15501,U249FC0,16,52.19999999999999,7,9,5932.0,5984.200000000001
15502,UDFC1C1,16,2684.91,14,2,3336.48,6021.389999999999
15503,U50A965,16,322.76,14,2,2357.2400000000002,2680.0
15504,U234614,16,736.0799999999991,14,2,4370.46,5106.54
15505,U699585,16,1180.9599999999991,12,4,15141.68,16322.64
15506,UD4CF8E,16,32134.739999999998,7,9,29268.539999999997,61403.28
15507,U404FAC,16,-7860.3099999999995,14,2,12485.0,4624.69
15508,UC88CB6,16,5977.200000000002,12,4,10088.26,16065.460000000001
15509,U63542E,16,-1998.1900000000005,11,5,29798.289999999997,27800.1
15510,U718AFF,16,1349.6399999999999,8,8,11936.0,13285.64
15511,U6CB55A,16,-175.83000000000033,9,7,10185.66,10009.83
15512,U422426,16,-1268.0,8,8,29231.0,27963.0
15513,U679294,16,1.1300000000003454,11,5,11916.430000000002,11917.56
15514,U3BB200,16,-18810.14,13,3,28370.98,9560.84
15515,UA21298,16,131.5699999999997,7,9,65683.57,65815.14
15516,UA2FB61,16,-2087.58,16,0,2087.58,0.0
15517,UA4D487,16,80.39999999999995,13,3,990.5999999999999,1071.0
15518,UBCE24F,16,10390.4,12,4,63621.6,74012.0
15519,UF0CB9F,16,2678.6899999999996,12,4,10200.880000000001,12879.57
15520,UC7EFD2,16,-2485.3999999999996,16,0,2485.3999999999996,0.0
15521,UDF01AD,16,-21470.2,11,5,43710.2,22240.0
15522,U9EF8A1,16,-7822.7,12,4,8561.599999999999,738.9
15523,U0700BC,16,9300.690000000006,10,6,50734.0,60034.69
15524,UA48700,16,-321.42,11,5,800.9200000000001,479.5
15525,UE8E089,16,543.1999999999999,13,3,509.1,1052.3
15526,UE93BA2,16,-480.66,14,2,4097.0,3616.34
15527,U32E78A,16,7469.11,12,4,12346.209999999997,19815.32
15528,U65123D,16,-70243.54000000001,12,4,70323.55,80.01
15529,U3C146D,16,917.0,7,9,14283.0,15200.0
15530,U21B3E1,16,145.65999999999985,10,6,35558.34,35704.0
15531,U63D798,16,271151.33,5,11,3768.92,274920.25
15532,U05BD16,16,-2273.0599999999995,14,2,7568.2699999999995,5295.21
15533,U2DB03C,16,-14817.399999999998,12,4,18069.57,3252.17
15534,U074683,16,-709.3199999999997,13,3,7909.38,7200.0599999999995
15535,U38E94D,16,-4874.320000000001,16,0,4874.320000000001,0.0
15536,UE78DC7,16,-1074.11,16,0,1074.11,0.0
15537,U0A52CC,16,1971.6100000000001,11,5,3135.11,5106.72
15538,UB2A919,16,15.370000000000005,9,7,260.65999999999997,276.03
15539,U27227E,16,-1240.2699999999895,5,11,195000.0,193759.72999999998
15540,UFFA5AB,16,0.0,8,8,11800.0,11800.0
15541,U5E2BB9,16,-4759.3099999999995,9,7,4780.19,20.88
15542,U8AB04F,16,5269.86,6,10,3979.0,9248.86
15543,UE8F0B1,16,10476.32,10,6,6157.339999999999,16633.66
15544,UF80818,16,13547.250000000004,10,6,261668.91,275216.16000000003
15545,U5ED0D5,16,-1421.5700000000002,14,2,3563.44,2141.87
15546,UBB552E,16,-5466.43,13,3,8226.43,2760.0
15547,U2EFBB4,16,-10.389999999999418,11,5,8862.01,8851.62
15548,U2D28AB,16,14333.859999999997,8,8,44622.16,58956.02
15549,U8A25AA,16,619.5599999999995,14,2,4700.65,5320.21
15550,U27DFCC,16,-116.79000000000019,9,7,9503.21,9386.419999999998
15551,U4EC3FA,16,63.63000000000001,14,2,730.0000000000001,793.63
15552,U40525B,16,-3422.31,12,4,5686.41,2264.1
15553,UE228C3,16,121.92999999999998,10,6,881.6099999999999,1003.54
15554,U78ADE6,16,-13247.409999999998,13,3,25342.0,12094.59
15555,U85CB49,16,-412.6999999999998,12,4,9277.559999999998,8864.86
15556,UF2D630,16,8.590000000000146,8,8,9597.77,9606.36
15557,UB69256,16,-32537.949999999997,12,4,76190.58,43652.630000000005
15558,U2B52EB,16,1272.4999999999995,12,4,1293.5,2566.0
15559,U472EF4,16,8000.15,12,4,25860.64,33860.79
15560,UAA7FB3,16,17997.03,12,4,19915.03,37912.060000000005
15561,UD6188B,16,12.989999999999952,14,2,607.7900000000001,620.78
15562,U1DBDF3,16,-1868.5600000000002,16,0,1868.5600000000002,0.0
15563,U53EEAD,16,14636.270000000002,12,4,14750.75,29387.02
15564,UCD160C,16,4144.15,8,8,4374.96,8519.11
15565,U7642B4,16,-62.91999999999996,13,3,1412.6,1349.68
15566,UD96199,16,363.86,8,8,1833.6499999999999,2197.51
15567,U51EEA4,16,1730.42,5,11,512.48,2242.8999999999996
15568,UB4AF5D,16,142.0,14,2,13299.0,13441.0
15569,U68CFED,16,-860.5899999999999,16,0,860.5899999999999,0.0
15570,U21635D,16,0.0,8,8,24000.0,24000.0
15571,UE514BD,16,-3658.1000000000004,15,1,3861.0000000000005,202.9
15572,UE9BDD4,16,-15465.22,12,4,31287.850000000002,15822.630000000001
15573,UCE4FA1,16,23810.61,9,7,34091.26,57901.87
15574,UEE6360,16,838.1199999999999,10,6,11898.75,12736.869999999999
15575,U7A432C,16,-4405.78,16,0,4405.78,0.0
15576,U90F7F2,16,0.0,8,8,10000.0,10000.0
15577,U815835,16,-2439.100000000001,13,3,39549.54,37110.44
15578,U6B83D9,16,-7086.09,14,2,7090.9,4.81
15579,U839E3F,16,-5408.639999999999,9,7,22371.190000000002,16962.55
15580,U870244,16,1741.0,10,6,6245.0,7986.0
15581,U7CA677,16,-1442.8500000000008,10,6,22379.699999999997,20936.849999999995
15582,U881FC1,16,993.0099999999984,12,4,26460.43,27453.44
15583,UA6DC8D,16,299.25999999999897,9,7,13608.749999999998,13908.01
15584,UDF7B37,16,22449.899999999987,10,6,52538.5,74988.4
15585,UDF88A1,16,-354.47999999999996,16,0,354.47999999999996,0.0
15586,U8FFC0E,16,1137.7900000000009,11,5,6456.57,7594.360000000001
15587,U2DE1F8,15,-26.370000000000033,13,2,994.9399999999999,968.5699999999999
15588,U825385,15,-608.1700000000001,14,1,4912.77,4304.6
15589,UA7257C,15,-294.26000000000005,9,6,1177.94,883.6800000000001
15590,UB46DB1,15,189.3699999999999,10,5,12418.78,12608.15
15591,U04E968,15,-689.8599999999997,11,4,9840.0,9150.14
15592,U9B3DEA,15,3385.9900000000016,9,6,12897.0,16282.990000000002
15593,UE29035,15,-24558.64,13,2,24758.64,200.0
15594,U4671C4,15,-2096.0500000000006,15,0,2096.0500000000006,0.0
15595,U5519DE,15,-81886.75,6,9,626000.0,544113.25
15596,U336C90,15,12.909999999999982,10,5,384.19,397.09999999999997
15597,U4133E4,15,-1253.5,7,8,10152.5,8899.0
15598,UFF6028,15,13125.670000000002,12,3,2041.8,15167.470000000001
15599,U0B0E28,15,-865.3500000000003,13,2,2895.23,2029.88
15600,U9FE953,15,-2122.71,14,1,2663.66,540.95
15601,UBEB539,15,-747.3100000000559,5,10,1416500.0,1415752.69
15602,U131B9A,15,-233.4899999999998,12,3,5275.67,5042.18
15603,UDA9A57,15,1396.6100000000001,12,3,1838.4,3235.01
15604,U5E388D,15,-457.25,13,2,670.74,213.49
15605,UCFC31E,15,-3149.7500000000005,11,4,15979.24,12829.49
15606,UFB6C67,15,-12968.67,14,1,17344.5,4375.83
15607,UC071DC,15,3486.0,9,6,1012.0,4498.0
15608,U231E6D,15,-41053.53999999999,7,8,66156.68,25103.14
15609,UFF4CF8,15,300.0,8,7,1500.0,1800.0
15610,U907C51,15,-9.200000000000454,8,7,11011.8,11002.599999999999
15611,U282072,15,-1875.35,12,3,1965.04,89.69
15612,U882A80,15,47.3900000000001,7,8,1404.0,1451.3899999999999
15613,UA9A861,15,-1451.1999999999998,14,1,1951.1999999999998,500.0
15614,U7886E4,15,-3542.0,13,2,46442.0,42900.0
15615,U26C350,15,-505.0,9,6,8424.07,7919.07
15616,U69BB64,15,-8216.8,10,5,8532.8,316.0
15617,U2F8048,15,-177.46000000000262,11,4,32380.38,32202.92
15618,UC15C0F,15,96.07999999999984,13,2,626.0,722.0799999999999
15619,UD4147F,15,-5.684341886080802e-14,12,3,1717.8,1717.8
15620,U6C8A38,15,29765.5,11,4,32334.5,62100.0
15621,UA6B060,15,-19.9900000000016,10,5,63784.0,63764.009999999995
15622,U56C761,15,-26239.75,14,1,27391.96,1152.21
15623,UEDC9BC,15,40.169999999998254,7,8,37260.0,37300.17
15624,U255BAF,15,-47619.14,12,3,101226.14,53607.0
15625,U747CA0,15,926.27,11,4,4475.35,5401.62
15626,UB334B6,15,880.9499999999996,12,3,2962.05,3843.0
15627,UF2AC4B,15,-639.1700000000019,12,3,25084.34,24445.17
15628,UF117E6,15,1092.74,13,2,1088.12,2180.8599999999997
15629,UD6B86B,15,3398.8900000000012,11,4,4275.11,7674.0
15630,UAF8402,15,-11302.2,8,7,22128.6,10826.4
15631,UB479BF,15,2609.9999999999995,12,3,4455.7,7065.7
15632,UD8EE7C,15,-2806.63,13,2,2838.0,31.37
15633,UF49168,15,0.3599999999987631,7,8,23801.28,23801.64
15634,U181B05,15,-14347.310000000005,9,6,114539.25,100191.94
15635,UCD51FF,15,941.6999999999998,12,3,5704.16,6645.86
15636,U374B55,15,9919.060000000001,6,9,87803.97,97723.03
15637,U16984E,15,1312.5899999999995,7,8,7821.9,9134.49
15638,U6ECEB1,15,14831.1,6,9,4063.0,18894.1
15639,U7157A0,15,1670.58,13,2,14839.880000000001,16510.46
15640,U6B4354,15,-5542.150000000001,10,5,12050.94,6508.79
15641,U7D1714,15,-67.37999999999998,11,4,646.18,578.8
15642,UF30B72,15,-10328.4,8,7,40941.4,30613.0
15643,UE6E70D,15,589.45,7,8,584.9,1174.35
15644,U87E04F,15,5807.550000000001,8,7,6209.359999999999,12016.91
15645,UAB1B73,15,-3550.3199999999997,10,5,14350.32,10800.0
15646,UBC218F,15,1517.2299999999998,11,4,1283.16,2800.3900000000003
15647,UC9749C,15,-2194.5499999999997,14,1,2994.5499999999997,800.0
15648,U7F462D,15,-161.9300000000003,12,3,10392.93,10231.0
15649,U54C28E,15,278.04999999999995,4,11,508.0,786.05
15650,U7F0AD2,15,-2732.5999999999976,12,3,22415.25,19682.65
15651,U082D0E,15,3690.5,8,7,460.03000000000003,4150.53
15652,U762283,15,-35.63,9,6,3247.07,3211.44
15653,U460DC0,15,-20.670000000000073,9,6,17570.67,17550.0
15654,U2B0E99,15,-14.590000000000146,12,3,6554.59,6540.0
15655,U240FE1,15,-10970.169999999998,14,1,11013.169999999998,43.0
15656,UFC7B67,15,829.4200000000001,11,4,5418.58,6248.0
15657,UCEC228,15,-27704.28,7,8,161500.0,133795.72000000003
15658,UF83550,15,-490.59000000000003,9,6,1517.59,1027.0
15659,UBD759F,15,834.03,12,3,5165.970000000001,6000.0
15660,UB18E82,15,300.89,13,2,554.74,855.63
15661,UD120C0,15,-13907.8,12,3,31019.8,17112.0
15662,U0B80CF,15,4.547473508864641e-13,10,5,11222.789999999999,11222.79
15663,UCF84C9,15,-953.4199999999998,11,4,8437.880000000001,7484.46
15664,U4C01A1,15,308.21000000000174,8,7,38762.31,39070.52
15665,U7DA8C1,15,-31.279999999999973,13,2,365.59999999999997,334.32
15666,UA6A8A1,15,6721.5599999999995,10,5,7590.47,14312.03
15667,U41F389,15,702.8399999999999,11,4,810.31,1513.15
15668,UDBC077,15,34.910000000000025,10,5,955.13,990.04
15669,U2C87FA,15,164.75,11,4,6227.45,6392.2
15670,U60F5CF,15,124.78999999999951,10,5,12264.560000000001,12389.35
15671,U08A7AD,15,-415.28000000000134,13,2,12345.279999999999,11930.0
15672,U9358A4,15,-28.36999999999898,7,8,48872.96,48844.590000000004
15673,U263ACD,15,12116.76,9,6,11583.86,23700.62
15674,UAD4CA1,15,15477.85,9,6,220.08,15697.93
15675,U9D662C,15,132.83999999999992,9,6,5784.0,5916.84
15676,U312A25,15,-8525.460000000001,12,3,23090.460000000003,14565.0
15677,U125B6B,15,13479.25,11,4,967.0,14446.25
15678,UC37DCA,15,-1.1500000000005457,11,4,9741.26,9740.11
15679,UAFA6C6,15,115.07,8,7,2266.93,2382.0
15680,U9DFB73,15,-3725.2000000000007,13,2,36725.2,33000.0
15681,U28F903,15,844.0,10,5,25594.34,26438.34
15682,U699B31,15,415.30999999999995,8,7,1010.0,1425.3100000000002
15683,UBD98D0,15,2225.89,12,3,1579.12,3805.01
15684,U1B7FD6,15,1877.4500000000003,10,5,1921.72,3799.17
15685,U87B300,15,6801.0599999999995,11,4,1094.02,7895.08
15686,UA99CC8,15,1765.82,11,4,3884.18,5650.0
15687,U682EFD,15,526.4599999999999,12,3,1544.54,2071.0
15688,UA12A8A,15,-933.8299999999999,11,4,8444.0,7510.17
15689,UE5E21D,15,-8247.789999999999,14,1,8547.789999999999,300.0
15690,U7DBF88,15,-1160.37,11,4,1872.1699999999998,711.8
15691,UBD7D20,15,3841.3600000000006,9,6,5738.16,9579.52
15692,U7B8512,15,2371.0,12,3,9171.0,11542.0
15693,U5B492A,15,103493.27,6,9,53578.42,157071.69
15694,UFA3508,15,-8823.099999999999,11,4,27473.099999999995,18650.0
15695,U3A80C5,15,-145.4100000000006,10,5,6395.36,6249.95
15696,UB7232B,15,1.5899999999996908,13,2,2847.54,2849.1299999999997
15697,UAAB359,15,2999.1899999999996,7,8,22641.88,25641.07
15698,U57BD3D,15,-0.27000000000001023,11,4,5753.859999999999,5753.589999999999
15699,U11DE6D,15,-415.0499999999994,8,7,44877.53999999999,44462.48999999999
15700,U751504,15,21008.23,6,9,7970.5,28978.73
15701,U4F9ABB,15,-164.35999999999996,13,2,467.65,303.29
15702,U2DEEA4,15,381.6500000000001,11,4,4311.55,4693.2
15703,UEDE83F,15,473.53999999999996,9,6,9529.46,10003.0
15704,UEAAA16,15,348.12999999999994,13,2,411.87,760.0
15705,U947784,15,100.0,8,7,45097.0,45197.0
15706,U007C01,15,-104.28999999999998,12,3,417.59000000000003,313.3
15707,U891577,15,156.80999999999767,9,6,24560.91,24717.72
15708,U02047D,15,1196.0,7,8,2375.0,3571.0
15709,U0C8A0F,15,-330.98,14,1,680.98,350.0
15710,UC1F48B,15,30310.53,11,4,5731.68,36042.21
15711,UD5C990,15,-1.1199999999999761,11,4,590.12,589.0
15712,U4E2997,15,731.8800000000002,9,6,7537.36,8269.24
15713,U8E5354,15,-3930.0,12,3,18645.0,14715.0
15714,U460253,15,340.85000000000036,11,4,30700.0,31040.85
15715,U5C4D87,15,-4763.920000000004,13,2,35107.54,30343.62
15716,U86BB48,15,-54238.399999999994,4,11,195293.0,141054.6
15717,UDF9148,15,-4640.32,7,8,41202.32,36562.0
15718,U557686,15,-5868.0,12,3,12327.0,6459.0
15719,U33FFF7,15,1014.5499999999993,11,4,16933.45,17948.0
15720,U90D91F,15,-12460.13,10,5,64827.26000000001,52367.130000000005
15721,UF91A95,15,-9990.939999999999,12,3,14040.939999999999,4050.0
15722,U327421,15,-729.8699999999997,13,2,1845.2199999999998,1115.35
15723,U13EBE6,15,692.4000000000019,13,2,9980.289999999999,10672.69
15724,UED087D,15,164.39999999999964,8,7,21653.83,21818.23
15725,UD01E4A,15,-38.339999999999996,10,5,148.62,110.28
15726,U1749D0,15,-2130.51,10,5,37273.0,35142.49
15727,UF9AF24,15,-1322.0000000000023,11,4,26359.780000000002,25037.78
15728,U86C6B2,15,-2054.7000000000016,9,6,47607.85,45553.15
15729,UBBF8A0,15,-33.85999999999967,11,4,22910.4,22876.54
15730,UFCB391,15,-1020.02,12,3,1362.45,342.43
15731,UA81123,15,8714.5,8,7,15567.5,24282.0
15732,UFD3CBB,15,1056.6099999999992,12,3,10212.900000000001,11269.51
15733,U7CFDD0,15,8940.5,12,3,148.0,9088.5
15734,U0D4019,15,6785.089999999999,8,7,16567.23,23352.32
15735,U4A5F8A,15,331.91999999999825,8,7,21159.9,21491.82
15736,U125824,15,-2953.0,12,3,5867.0,2914.0
15737,UF2B465,15,-32160.909999999996,7,8,85251.0,53090.090000000004
15738,UA609B7,15,-5930.96,10,5,13793.4,7862.4400000000005
15739,UD8D48F,15,-9623.33,12,3,27569.760000000002,17946.43
15740,U804C63,15,12289.0,8,7,23887.84,36176.84
15741,UF57C0F,15,1553.22,12,3,4593.74,6146.960000000001
15742,U1C321B,15,-18849.94,11,4,20975.4,2125.46
15743,U4DA61E,15,-1043.92,13,2,4977.259999999999,3933.34
15744,UE35852,15,-817.0600000000001,9,6,2574.9300000000003,1757.8700000000001
15745,U92DDCB,15,-1643.0,12,3,2480.8,837.8000000000001
15746,UF6DC6E,15,-469.81999999999994,12,3,1429.8200000000002,960.0
15747,U47CE69,15,-874.2,11,4,1712.68,838.48
15748,U5C2A96,15,-4950.0,10,5,24658.0,19708.0
15749,UE78A81,15,-3829.7000000000003,11,4,7927.279999999999,4097.58
15750,U1609A0,15,-239.16999999999996,8,7,313.78,74.61
15751,UE3A4E1,15,-894.19,11,4,8580.880000000001,7686.6900000000005
15752,UC1607F,15,20449.989999999998,8,7,35400.0,55849.99
15753,U67D7F9,15,-475.09999999999854,9,6,27872.1,27397.0
15754,UD9950B,15,-240.63,10,5,627.2,386.57
15755,UCC5F0D,15,-337.62,15,0,337.62,0.0
15756,U849EBC,15,4796.310000000001,10,5,2510.46,7306.77
15757,UF38B76,15,-4943.0599999999995,10,5,23253.059999999998,18310.0
15758,U47A143,15,30210.409999999996,10,5,6272.58,36482.99
15759,U33F91A,15,468.3299999999999,9,6,11058.54,11526.869999999999
15760,U60EBCF,15,482.19999999999993,9,6,9612.25,10094.45
15761,U4F318B,15,-13239.33,13,2,14869.66,1630.33
15762,U1295B1,15,-216.05000000000004,13,2,216.25000000000003,0.2
15763,U1A3F15,15,-6956.84,13,2,8582.900000000003,1626.06
15764,UA4FA5E,15,-2755.69,12,3,5772.0,3016.3100000000004
15765,UDD9527,15,-490.93999999999994,13,2,740.9399999999999,250.0
15766,UDFF4E6,15,22678.0,6,9,23240.0,45918.0
15767,U92FE89,15,27106.210000000003,9,6,29409.019999999997,56515.229999999996
15768,UDF506A,15,-3875.4699999999993,14,1,14027.42,10151.95
15769,UB652AF,15,-3384.2300000000014,13,2,12551.78,9167.55
15770,U3752B8,15,-14999.8,14,1,15000.0,0.2
15771,U2BC8B7,15,1357.0,8,7,17967.8,19324.800000000003
15772,U27C4EA,15,-27834.5,10,5,52416.5,24582.0
15773,UA33E4A,15,-3272.0200000000004,10,5,4818.02,1546.0
15774,U94376F,15,632.1099999999997,13,2,7268.58,7900.6900000000005
15775,U0669CE,15,-4928.799999999999,11,4,16624.86,11696.060000000001
15776,UB58924,15,5750.26,12,3,21678.0,27428.260000000002
15777,UBA38F7,15,-1572.0,13,2,3584.9,2012.9
15778,U9B0122,15,1941.4099999999994,12,3,3662.9400000000005,5604.35
15779,UFE06CC,15,-6959.92,12,3,6974.92,15.0
15780,U98FCF1,15,1665.0200000000004,10,5,12120.0,13785.02
15781,UC93F29,15,-3152.8,13,2,4175.9800000000005,1023.1800000000001
15782,U049951,15,221.91999999999996,13,2,1360.08,1582.0
15783,U5E3C42,15,-1022265.5800000001,9,6,1347466.0,325200.42
15784,U6E6B9A,15,18693.04,9,6,8519.32,27212.36
15785,UF57D88,15,894.08,10,5,337.94,1232.02
15786,U7888FA,15,29.28,10,5,125.0,154.28
15787,U6DDD71,15,-179.6200000000007,13,2,3379.620000000001,3200.0
15788,U68560B,15,10693.58,12,3,5902.42,16596.0
15789,UF0CA70,15,179.20000000000002,12,3,1537.2000000000003,1716.4
15790,U487D57,15,3339.0300000000007,13,2,6004.379999999999,9343.41
15791,U950A5B,15,-8958.999999999998,12,3,16680.08,7721.08
15792,UB57B50,15,-1226.48,13,2,2821.7799999999997,1595.3
15793,UFCE720,15,-504.38999999999953,11,4,9905.189999999999,9400.8
15794,UB66FBD,15,246.18,12,3,558.07,804.25
15795,U57FB34,15,495.0,9,6,36005.0,36500.0
15796,U732E13,15,-486.7999999999993,3,12,26100.0,25613.199999999997
15797,U1DB8FA,15,-4.309999999999491,9,6,29671.81,29667.5
15798,UB09F68,15,-22.890000000000086,12,3,1488.85,1465.96
15799,U661FDC,15,-118532.30999999998,9,6,155563.0,37030.69
15800,U31D197,15,-11275.95,6,9,18226.17,6950.22
15801,U82E0AB,15,-2232.2400000000002,15,0,2232.2400000000002,0.0
15802,UA6C6C0,15,21.389999999999873,13,2,7457.0,7478.389999999999
15803,U455DD5,15,102.38,13,2,297.62,400.0
15804,U848509,15,-3047.0900000000006,8,7,12725.8,9678.71
15805,U31E6E0,15,-11639.960000000001,14,1,11639.990000000002,0.03
15806,U8EAB07,15,-0.32999999999992724,5,10,38056.0,38055.670000000006
15807,UE60E9C,15,1349.5999999999995,11,4,15368.5,16718.1
15808,U542716,15,18300.0,9,6,28229.96,46529.96
15809,U931D08,15,8718.2,8,7,4293.9,13012.1
15810,U6277C9,15,-204.19999999999982,13,2,2249.2,2045.0
15811,U76ED18,15,6614.370000000001,11,4,24040.629999999997,30655.0
15812,U809F99,15,320.2499999999999,12,3,2675.75,2996.0
15813,UDE26C4,15,-61004.719999999994,11,4,99262.44,38257.72
15814,U9DBCD4,15,776.8000000000002,9,6,1272.0900000000001,2048.8900000000003
15815,U6F9F5F,15,-9661.83,13,2,11661.83,2000.0
15816,U2C5CAD,15,5125.810000000001,12,3,8447.16,13572.970000000001
15817,UD9616D,15,2043.4700000000003,9,6,1345.5799999999997,3389.05
15818,UBBA322,15,940.2700000000017,7,8,77858.05,78798.32
15819,U34DEBD,15,-4.830000000000041,8,7,1070.8300000000002,1066.0
15820,U9AFC06,15,-19.0,8,7,44184.0,44165.0
15821,U9D5C20,15,0.0,8,7,2189.12,2189.12
15822,U2CB012,15,-4307.439999999999,9,6,40940.670000000006,36633.229999999996
15823,U2BF036,15,-38232.98999999999,13,2,50385.92999999999,12152.94
15824,UFB2A56,15,-16.0,13,2,19998.0,19982.0
15825,U03AFEF,15,-419.97000000000014,10,5,4469.969999999999,4050.0
15826,UCD3C0A,15,-395.03000000000026,13,2,2184.92,1789.8899999999999
15827,UD27D9E,15,-15019.739999999983,10,5,545820.4,530800.66
15828,U1F6CE0,15,-2265.0,10,5,5703.7,3438.7
15829,U46A59A,15,238.20000000000005,10,5,1155.8,1394.0
15830,U9BA7F3,15,-182.72000000000023,12,3,3644.32,3461.6
15831,U0F1E56,15,-75.11000000000003,11,4,286.78999999999996,211.67999999999998
15832,U5B58CA,15,-173.3,13,2,242.4,69.1
15833,U95F30B,15,-1241.58,15,0,1241.58,0.0
15834,U60A21B,15,513.39,10,5,360.56000000000006,873.95
15835,UC1929F,15,273.82000000000056,11,4,3910.25,4184.070000000001
15836,UF179D1,15,-1975.4,10,5,4800.4,2825.0
15837,U5C8866,15,1025.92,11,4,1400.0,2425.92
15838,UE57C73,15,761.68,11,4,555.32,1317.0
15839,UFA127A,15,-13888.74,12,3,28901.739999999998,15013.0
15840,UC03E21,15,108.02,7,8,13025.0,13133.02
15841,U9E3A70,15,0.4399999999999977,9,6,622.56,623.0
15842,UFBFFFC,15,-55285.94,11,4,111485.94,56200.0
15843,UAE14B9,15,-18428.34,9,6,35285.009999999995,16856.67
15844,UF42621,15,3375.2300000000005,8,7,11342.0,14717.23
15845,U940E95,15,11494.550000000003,8,7,10541.689999999999,22036.24
15846,UD8DD06,15,1484.17,7,8,7758.540000000001,9242.71
15847,UB939A9,15,-759.9200000000001,11,4,2689.6400000000003,1929.72
15848,U77E6D1,15,-25.940000000000005,12,3,301.17,275.23
15849,U51A067,15,-30158.619999999995,6,9,148959.3,118800.68000000001
15850,U9EE3EC,15,-11.219999999998436,7,8,50011.3,50000.08
15851,UD90B09,15,-2593.8999999999996,11,4,32655.61,30061.71
15852,UD68126,15,-13101.069999999996,8,7,312149.02999999997,299047.96
15853,UB27566,15,113.19999999999996,13,2,1430.7999999999997,1544.0
15854,UFF5971,15,-4989.08,14,1,7568.08,2579.0
15855,U425C10,15,-42.26999999999998,10,5,524.28,482.01
15856,U9B75D2,15,-110.45999999999992,12,3,872.6199999999999,762.16
15857,UC5D7C8,15,-274.2300000000001,10,5,1603.65,1329.42
15858,U1D5FF6,15,-9960.64,11,4,12354.05,2393.4100000000003
15859,U74A09A,15,85.69999999999996,13,2,810.9,896.6
15860,UFCDB6F,15,-3407.29,12,3,10909.0,7501.710000000001
15861,UABAB8E,15,4683.93,10,5,8017.980000000001,12701.910000000002
15862,U5BC09F,15,-2839.1900000000005,9,6,18991.879999999997,16152.69
15863,U542567,15,8286.750000000005,8,7,56434.76,64721.509999999995
15864,U30767B,15,-585.6700000000005,10,5,22924.239999999998,22338.57
15865,UDAC58F,15,55.190000000000566,8,7,15391.01,15446.2
15866,U337B85,15,-9310.220000000001,14,1,9710.220000000001,400.0
15867,U80E1B6,15,-301486.15999999986,6,9,854010.04,552523.88
15868,U32822F,15,224.3100000000001,12,3,1553.71,1778.0200000000002
15869,UA37D1C,15,1109.1499999999983,12,3,50390.850000000006,51500.0
15870,UAEDD30,15,5302.0,2,13,1.6500000000000001,5303.65
15871,U57BB55,15,153.30000000000038,10,5,5657.999999999999,5811.3
15872,UF6329F,15,-46.26999999999998,8,7,1597.21,1550.94
15873,U447D5D,15,9463.809999999998,11,4,30383.690000000002,39847.5
15874,UED1B3B,15,-29847.97,12,3,48056.60999999999,18208.64
15875,U73A110,15,33073.13,5,10,1187.03,34260.16
15876,U798C25,15,194.5400000000002,10,5,3603.13,3797.67
15877,UF96498,15,-3661.61,12,3,4451.61,790.0
15878,UD647C3,15,37023.77000000001,9,6,49583.85999999999,86607.63
15879,UE89421,15,116.11000000001513,9,6,403905.88,404021.99
15880,U6D2B2B,15,171.69999999999996,7,8,323.95,495.65000000000003
15881,UED4DBC,15,-325.78999999999996,12,3,7021.29,6695.5
15882,U8BAFC8,15,-466.6400000000001,11,4,4218.1,3751.46
15883,U28BABF,15,-135.19999999999982,11,4,6315.46,6180.26
15884,U6E046C,15,-27703.230000000003,9,6,148671.11,120967.88
15885,U28D422,15,-6741.259999999999,9,6,12150.419999999998,5409.16
15886,UD7E7EC,15,-8.980000000000132,10,5,4077.0,4068.0199999999995
15887,U1BB76A,15,22114.899999999998,11,4,19876.79,41991.69
15888,UF56A4D,15,-3014.3099999999995,13,2,7224.91,4210.6
15889,UFED8B0,15,4693.740000000002,12,3,5995.26,10689.0
15890,UA3402D,15,2579.83,8,7,7668.34,10248.17
15891,UAC17A3,15,0.15999999999985448,8,7,18935.37,18935.53
15892,UFB5160,15,57056.0,4,11,30588.17,87644.17
15893,U022F57,15,-9.730000000000254,11,4,4156.3,4146.57
15894,U0B9B7A,15,-2677.9900000000002,14,1,2678.0200000000004,0.03
15895,U5C30A1,15,387.89,13,2,1632.1100000000001,2020.0
15896,U6CC1F8,15,-13.109999999999985,13,2,269.90999999999997,256.8
15897,UB6CAC7,15,11434.58,9,6,16378.039999999999,27812.62
15898,UA4055B,15,1408.0500000000002,8,7,15681.05,17089.1
15899,UA52B30,15,2875.74,13,2,1559.8799999999999,4435.62
15900,UD40F85,15,164.41000000000003,13,2,1135.59,1300.0
15901,UF5FC8B,15,-1112.84,14,1,1119.84,7.0
15902,U7FAE28,15,-1640.0,13,2,3180.99,1540.99
15903,UAF15BF,15,-2276.8899999999994,11,4,2284.91,8.02
15904,U4A8906,15,-12475.519999999997,11,4,33002.94,20527.42
15905,U017AF1,15,8993.310000000001,10,5,9276.7,18270.010000000002
15906,U9A896E,15,0.7000000000002728,11,4,7993.3,7994.0
15907,UB809C0,15,35.71,13,2,370.42999999999995,406.14
15908,U2143DE,15,-70.61999999999989,10,5,1959.5,1888.88
15909,UA365F0,15,1872.9599999999998,12,3,1727.0400000000004,3600.0
15910,U99E00D,15,-448.56,12,3,6261.5599999999995,5813.0
15911,UE75900,15,249.2400000000001,13,2,714.4300000000001,963.6700000000001
15912,UDD6F3D,15,-350.03,10,5,2980.2799999999997,2630.25
15913,UEFD128,15,2081.620000000001,11,4,5471.74,7553.360000000001
15914,U58C463,15,367.7699999999985,9,6,26050.809999999998,26418.58
15915,U82E30D,15,3925.49,11,4,4060.7,7986.1900000000005
15916,U86AC0A,15,357.00000000000017,13,2,426.39,783.3900000000001
15917,UE5AD8E,15,1475.1100000000006,10,5,13525.9,15001.01
15918,UF0E0BC,15,6970.9400000000005,10,5,5025.07,11996.01
15919,U9B3D50,15,-2507.1699999999996,11,4,8823.5,6316.33
15920,U8F4FA2,15,-16352.990000000002,13,2,17892.98,1539.99
15921,U9142E1,15,-935.4000000000001,13,2,1909.7400000000002,974.3399999999999
15922,U73A09C,15,-365.59999999999997,12,3,1403.8999999999999,1038.3
15923,U53025C,15,1497.52,13,2,4932.4800000000005,6430.0
15924,U272976,15,174.85000000000036,10,5,17683.940000000002,17858.79
15925,U2E0CAF,15,4027.540000000001,12,3,6321.08,10348.619999999999
15926,UEDE7C0,15,20814.720000000005,12,3,8538.2,29352.920000000002
15927,U8B30E6,15,-8638.99,13,2,8801.9,162.91
15928,UF99E12,15,-20000.699999999997,11,4,285501.03,265500.33
15929,U13322C,15,-285.28,11,4,6350.0,6064.72
15930,U62B296,15,1241.9899999999998,13,2,945.24,2187.23
15931,U3F1C2B,15,-11.619999999999763,13,2,3390.270000000001,3378.65
15932,UD248C4,15,-1621.3000000000002,10,5,7359.79,5738.49
15933,UF8D92E,15,20409.059999999998,7,8,20826.0,41235.06
15934,UD45745,15,-242.8799999999999,12,3,970.4399999999999,727.56
15935,U188282,15,21244.729999999996,7,8,41496.0,62740.729999999996
15936,UEBA2A7,15,-1251.0,11,4,4187.3,2936.3
15937,U8A1892,15,5615.749999999996,6,9,40219.399999999994,45835.149999999994
15938,U8508F1,15,9294.949999999999,8,7,58662.0,67956.95
15939,U8C9C0F,15,-31933.39,11,4,75023.39,43090.0
15940,U5A4734,15,-2556.8,13,2,3046.8,490.0
15941,UD46937,15,-1513.6200000000003,13,2,12198.619999999999,10685.0
15942,U97028F,15,3773.0300000000007,11,4,11476.97,15250.0
15943,U099E68,15,12161.550000000001,12,3,6488.47,18650.02
15944,UEFE6AA,15,-3196.76,14,1,5329.11,2132.35
15945,UD3A447,15,-572.9000000000003,12,3,3950.1,3377.2
15946,UFDE62C,15,1415.8199999999997,9,6,21759.0,23174.82
15947,UC7F086,15,-1113.61,13,2,5197.38,4083.77
15948,U8CFF66,15,49.590000000000025,11,4,253.80999999999997,303.40000000000003
15949,UD2650B,15,-263.0999999999999,13,2,1363.3,1100.2
15950,U3C1328,15,-7404.16,11,4,13903.539999999999,6499.38
15951,U855259,15,-5388.240000000005,10,5,52517.0,47128.76
15952,U125495,15,-6699.97,12,3,11400.37,4700.4
15953,U5B0926,15,-973.96,11,4,1128.94,154.98000000000002
15954,UCC0E0C,15,-58.650000000000304,13,2,4615.790000000001,4557.14
15955,UFB152C,15,-1.4566126083082054e-13,12,3,3849.35,3849.35
15956,UCDD6AB,15,-11771.18,12,3,27568.409999999996,15797.23
15957,U8D90D7,15,-111.71999999999981,12,3,1620.23,1508.51
15958,U597EFC,15,75.67000000000189,9,6,9866.46,9942.130000000001
15959,U1E1C28,15,472.4899999999989,12,3,14690.0,15162.489999999998
15960,U390C16,15,-7734.15,10,5,7999.17,265.02
15961,U36C882,15,-402.75,8,7,1762.0,1359.25
15962,U4A3E84,15,-1515.9,8,7,7385.9,5870.0
15963,UCA58BA,15,-7767.12,15,0,7767.12,0.0
15964,UD507FD,15,-208.89999999999998,13,2,549.9,341.0
15965,U55BE68,15,3051.4000000000015,13,2,50690.6,53742.0
15966,UCE0E79,15,-4.849999999999909,11,4,1564.86,1560.01
15967,U82EB7F,15,-82.4300000000035,8,7,69559.77,69477.34
15968,U80AB6F,15,-10156.14,14,1,26035.14,15879.0
15969,UFDEC65,15,-857.0,12,3,1394.0000000000002,537.0
15970,UE9C3EC,15,1869.3200000000002,11,4,1770.68,3640.0
15971,UB45245,15,3383.54,8,7,8902.32,12285.86
15972,U27F70F,15,1040.67,11,4,698.89,1739.56
15973,UB0B066,15,-1503.0600000000004,11,4,4193.06,2690.0
15974,U0736B0,15,2568.199999999995,13,2,36461.5,39029.7
15975,U3E5CD3,15,-1910.2600000000002,14,1,3336.1000000000004,1425.84
15976,UA9830C,15,6.07999999999987,13,2,681.9200000000002,688.0
15977,UABA9E1,15,1649.75,10,5,7280.25,8930.0
15978,UA779DA,15,-4507.01,13,2,4507.13,0.12
15979,U529563,15,-3924.050000000003,14,1,31770.050000000003,27846.0
15980,U1A94A4,15,28210.0,4,11,35335.0,63545.0
15981,UD4FEB6,15,39778.81,10,5,3403.47,43182.28
15982,UB22DBC,15,-1571.3600000000004,13,2,7617.6900000000005,6046.33
15983,UDCBB9B,15,-1138.7500000000005,10,5,3659.8100000000004,2521.06
15984,UC1BB53,15,-4296.909999999999,12,3,8697.21,4400.3
15985,U84958D,15,-7989.48,10,5,16338.08,8348.6
15986,U5E87E2,15,75.81999999999995,12,3,422.89,498.71
15987,U7677E1,15,26.01,8,7,5974.0,6000.01
15988,UF08CBA,15,36427.68,9,6,30884.410000000003,67312.09
15989,U9A32FC,15,-16459.41,13,2,16459.510000000002,0.1
15990,U0AF056,15,986.65,10,5,7213.35,8200.0
15991,UB8629B,15,1641.32,9,6,1594.72,3236.04
15992,UFE0DEA,15,-19659.499999999993,15,0,19659.499999999993,0.0
15993,U814BA0,15,1839.04,12,3,702.29,2541.33
15994,U5BEC3B,15,1946.7600000000002,11,4,7053.24,9000.0
15995,UD6598F,15,1295.0,12,3,10305.0,11600.0
15996,UF9D5E8,15,-3.0,8,7,16003.0,16000.0
15997,U74FA3F,15,-35486.37,14,1,35636.37,150.0
15998,U45F7AA,15,-1399.39,14,1,1817.69,418.3
15999,UB5E1FE,15,-3327.8200000000006,11,4,41564.0,38236.18
16000,UD0FE39,15,1245.5200000000004,12,3,15858.619999999999,17104.14
16001,U0743B0,15,313.65000000000026,11,4,7103.079999999999,7416.7300000000005
16002,UE73A2F,15,931.8999999999996,11,4,4192.72,5124.62
16003,UD0D38C,15,-3099.3199999999997,12,3,7950.65,4851.330000000001
16004,UBBDC6B,15,-54.97999999999999,9,6,3056.49,3001.5099999999998
16005,U452537,15,257.98,12,3,645.05,903.03
16006,UB28FCE,15,59.48000000000002,12,3,8709.02,8768.5
16007,U65EB00,15,15424.99,8,7,17578.260000000002,33003.25
16008,U5A2989,15,8725.179999999998,10,5,5216.059999999999,13941.24
16009,UBB0EFB,15,59.23999999999967,10,5,11887.2,11946.44
16010,UC2228F,15,1429.5699999999997,10,5,12995.0,14424.57
16011,UD5CF3D,15,9832.619999999995,7,8,326137.0,335969.62
16012,U299380,15,-723.74,12,3,2574.52,1850.78
16013,UFBEFB5,15,-49.86,10,5,28269.859999999997,28220.0
16014,UBA5CBA,15,-16.05999999999949,8,7,19263.730000000003,19247.670000000006
16015,UF5E65A,15,5979.15,8,7,17084.190000000002,23063.34
16016,U65A492,15,-9.940000000000055,10,5,12005.9,11995.960000000001
16017,U7920DF,15,-4939.710000000002,10,5,29197.730000000003,24258.02
16018,UC4D438,15,3946.89,13,2,1163.3100000000002,5110.2
16019,UF6F460,15,-664.38,11,4,864.7299999999999,200.35
16020,U899F38,15,-288.5699999999997,13,2,3630.5699999999997,3342.0
16021,U0DA219,15,38.990000000007456,8,7,109761.28,109800.26999999999
16022,U85DB2B,15,130.0,11,4,42819.16,42949.16
16023,UE9E341,15,-1653.3500000000001,14,1,1683.3500000000001,30.0
16024,U2D5110,15,-563.3299999999995,8,7,21892.99,21329.66
16025,U28FC2F,15,14.409999999999997,7,8,341.58,355.99
16026,UE631E3,15,1381.5999999999985,12,3,27967.339999999997,29348.94
16027,UD1F826,15,402.53,12,3,2597.5,3000.0299999999997
16028,U2014F1,15,2115.0,11,4,23350.0,25465.0
16029,UAD88D4,15,3088.1000000000004,12,3,3641.3599999999997,6729.46
16030,UD14F89,15,-108782.63,12,3,517020.0,408237.37
16031,U6DD517,15,504.8499999999997,8,7,20888.309999999998,21393.16
16032,U1A0FD0,15,-3435.7400000000002,12,3,4448.529999999999,1012.79
16033,U9A43DE,15,10.720000000000255,12,3,6145.78,6156.5
16034,U45780C,15,-2158.97,10,5,10823.09,8664.12
16035,U830493,15,60770.46,8,7,91713.55,152484.00999999998
16036,UD790D9,15,-2588.9600000000005,13,2,4958.959999999999,2370.0
16037,UA180A4,15,-3195.210000000002,9,6,27132.05,23936.84
16038,UC6DD58,15,-2312.5899999999997,8,7,24312.59,22000.0
16039,U0C5A8F,15,-1134.1100000000006,13,2,7129.0,5994.889999999999
16040,U2102AB,15,-119.84999999999997,14,1,719.8499999999999,600.0
16041,U5BDCC9,15,-24273.380000000005,10,5,134306.0,110032.62
16042,UB1DFDC,15,5176.0700000000015,11,4,10202.299999999997,15378.37
16043,U8C9EA3,15,-460.5499999999999,13,2,5760.549999999999,5300.0
16044,UF7E4E7,15,-33099.850000000006,9,6,50879.880000000005,17780.03
16045,U827417,15,-155.86,9,6,4954.86,4799.0
16046,UB016AB,15,-269.96000000000004,15,0,269.96000000000004,0.0
16047,U644516,15,-3999.999999999999,11,4,22024.69,18024.690000000002
16048,UC94734,15,5297.2,8,7,8113.6,13410.8
16049,UACF9FA,15,120575.53,7,8,71422.0,191997.53
16050,U1B5E04,15,-561.84,13,2,2161.8399999999997,1600.0
16051,UA75C18,15,4512.58,9,6,2409.0,6921.58
16052,U83D957,15,98.09000000000015,7,8,20022.0,20120.09
16053,U28D652,15,7782.09,6,9,31503.3,39285.38999999999
16054,U71E3A3,15,23696.83,12,3,42095.770000000004,65792.6
16055,UFD9ACB,15,29622.769999999997,5,10,23011.0,52633.770000000004
16056,U9CEA3B,15,3837.3100000000004,11,4,12500.0,16337.31
16057,UDBB88B,15,-19.0,8,7,6019.0,6000.0
16058,UFD0E5C,15,67528.09,7,8,32563.559999999998,100091.65
16059,U1E99FA,15,2000.6299999999999,8,7,1116.8899999999999,3117.52
16060,U77BD82,15,755.14,13,2,760.4999999999999,1515.6399999999999
16061,UD6B791,15,89.61000000000001,13,2,1070.82,1160.4299999999998
16062,U422993,15,682.9199999999998,11,4,3137.08,3819.9999999999995
16063,U82A6F3,15,612.1100000000001,9,6,5776.12,6388.23
16064,UD66938,15,37092.0,8,7,10442.0,47534.0
16065,U8B43FD,15,-4862.41,7,8,21171.62,16309.21
16066,U8C6800,15,-10550.0,12,3,17037.079999999998,6487.08
16067,U4C993A,15,11909.129999999997,9,6,17178.72,29087.85
16068,UDA66C5,15,4197.999999999999,9,6,10956.060000000001,15154.060000000001
16069,UF0334C,15,-9.0,10,5,10009.0,10000.0
16070,UDDD011,15,-3853.3600000000006,12,3,11521.38,7668.02
16071,U5FD539,15,12.620000000000232,13,2,1856.4799999999998,1869.1000000000001
16072,U3F25AB,15,-7.105427357601002e-14,9,6,1073.01,1073.01
16073,U665F21,15,354.93,10,5,1456.67,1811.6000000000001
16074,UEF0A05,15,-15876.5,11,4,22093.66,6217.16
16075,U47E724,15,-351.9200000000001,10,5,4951.92,4600.0
16076,UD0F72A,15,67676.45,9,6,18330.0,86006.45
16077,U767972,15,305.0,12,3,1979.0,2284.0
16078,UF98729,15,328.40000000000015,12,3,2009.78,2338.18
16079,U30912D,15,-949.5,13,2,2481.3599999999997,1531.8600000000001
16080,U066934,15,-23.25,10,5,1376.5,1353.25
16081,U6E5050,15,4.547473508864641e-13,13,2,15722.72,15722.720000000001
16082,UA92206,15,-880.79,12,3,5425.77,4544.98
16083,U0EAEEC,15,82.10000000000036,8,7,19610.0,19692.1
16084,U043D99,15,30.570000000001343,12,3,18949.44,18980.010000000002
16085,U1B51E6,15,-9.36999999999989,12,3,2933.91,2924.54
16086,UF4F6FA,15,-2353.65,15,0,2353.65,0.0
16087,U8C5EF5,15,1164.51,11,4,3559.1899999999996,4723.700000000001
16088,UCFB6E5,15,-4840.59,13,2,13560.590000000002,8720.0
16089,UCA8352,15,98.40999999999997,12,3,1027.82,1126.23
16090,UB69329,15,-4465.950000000002,12,3,9729.95,5264.0
16091,U8870C9,14,3248.6000000000004,12,2,3751.4,7000.0
16092,UA7F0F6,14,-8097.6,14,0,8097.6,0.0
16093,U472FB2,14,-20.0,9,5,2659.0,2639.0
16094,UAC2B55,14,-1410.0000000000005,12,2,4774.199999999999,3364.2
16095,UCA973A,14,1621.57,1,13,100.0,1721.57
16096,U778B3C,14,-1463.6,12,2,1490.6,27.0
16097,U82C1A8,14,-642.8499999999988,7,7,12820.73,12177.880000000001
16098,U3A43FA,14,2648.0000000000005,5,9,145.14000000000001,2793.1400000000003
16099,U35459C,14,-933.94,11,3,38202.00000000001,37268.06
16100,UD6193B,14,705.1500000000003,11,3,4194.850000000001,4900.0
16101,U8FF1AB,14,-2557.5499999999993,7,7,10761.75,8204.2
16102,U35144C,14,-357.76,13,1,446.58,88.82
16103,UA7F445,14,869.53,11,3,7831.47,8701.0
16104,U6BCF92,14,230.77000000000027,7,7,6092.57,6323.34
16105,UDED958,14,-2725.05,11,3,8061.360000000001,5336.3099999999995
16106,U445C7B,14,-1068.0,9,5,38563.0,37495.0
16107,U5893A1,14,-3554.7099999999973,12,2,34954.94,31400.23
16108,U8FED3D,14,-228.0,12,2,7854.0,7626.0
16109,UE40E79,14,-465.1199999999999,12,2,7670.9400000000005,7205.82
16110,UEA1D3F,14,140.19999999999982,10,4,4242.8,4383.0
16111,U8552B5,14,-239733.47,7,7,295351.82999999996,55618.36
16112,U045C7E,14,-3365.2,11,3,3409.7,44.5
16113,U589C69,14,-585.7800000000005,8,6,17988.519999999997,17402.739999999998
16114,U0206FB,14,396.9300000000002,11,3,1410.0,1806.93
16115,U8BEF97,14,422.4100000000001,11,3,377.59000000000003,800.0
16116,U31C765,14,-5267.3099999999995,12,2,7263.0,1995.69
16117,U91C7C2,14,-845.9400000000005,11,3,8041.43,7195.49
16118,U1DBCE6,14,-259.4599999999994,9,5,7162.740000000001,6903.28
16119,U8A101B,14,35.109999999999985,12,2,519.89,555.0
16120,U901FD2,14,9237.480000000001,11,3,4723.84,13961.32
16121,UDD1C5C,14,-771.84,10,4,1786.3,1014.46
16122,U8EE571,14,-34.76000000000204,12,2,40931.39,40896.63
16123,U299F80,14,-400.3199999999998,8,6,4443.75,4043.4300000000003
16124,U6BF977,14,-15054.400000000001,12,2,65482.0,50427.6
16125,U1FE723,14,186.17000000000007,7,7,4943.9400000000005,5130.11
16126,U8A9865,14,-760.1799999999998,10,4,3427.8500000000004,2667.67
16127,UC6875D,14,-3302.000000000002,8,6,27797.78,24495.78
16128,U4320E3,14,-994.0,11,3,7894.0,6900.0
16129,U91AD74,14,10619.86,9,5,13080.69,23700.55
16130,U95CB73,14,675.1900000000002,8,6,18681.66,19356.85
16131,UD2FD32,14,0.0,10,4,46319.479999999996,46319.479999999996
16132,UD249AD,14,579.0,12,2,900.1199999999999,1479.12
16133,UC8A72D,14,-482.39,8,6,2181.08,1698.69
16134,U3CDC67,14,72.75999999999968,11,3,6207.34,6280.1
16135,U988DB3,14,-1035.4,12,2,1887.6999999999998,852.3
16136,U932177,14,336.8900000000002,11,3,2663.11,3000.0
16137,U986EE8,14,-5194.8,13,1,12794.8,7600.0
16138,U3F1118,14,-1787.67,8,6,4158.4,2370.73
16139,U44C8EA,14,2088.6000000000004,12,2,206.79999999999995,2295.4
16140,UEBA919,14,2635.4,8,6,4002.0,6637.4
16141,UD02992,14,-663.69,11,3,1002.97,339.28
16142,U145B6F,14,8788.03,11,3,2045.9699999999998,10834.0
16143,UDF837B,14,399.31999999999994,8,6,857.72,1257.04
16144,U8718FB,14,-15829.039999999997,13,1,18199.039999999997,2370.0
16145,U16EA22,14,5538.1,8,6,111.94999999999999,5650.05
16146,U2A6A10,14,5195.280000000001,12,2,1137.66,6332.9400000000005
16147,UC79F7B,14,41.99,7,7,7758.01,7800.0
16148,U55B840,14,72433.5,4,10,100133.5,172567.0
16149,UDCA348,14,-1338.8,13,1,1417.26,78.46
16150,U021499,14,-4141.9,11,3,12541.9,8400.0
16151,UF29D7D,14,-2672.5299999999997,11,3,4093.66,1421.13
16152,U526338,14,-5758.88,12,2,6648.88,890.0
16153,UA2DCA7,14,-3147.83,8,6,8258.14,5110.3099999999995
16154,U76D41C,14,-184.38,13,1,184.55999999999997,0.18
16155,U61C1E8,14,-1888.0,8,6,34168.0,32280.0
16156,UE3B381,14,3116.07,11,3,1750.23,4866.3
16157,U2C2338,14,-2387.51,10,4,8764.19,6376.68
16158,U47BF6D,14,867.3000000000002,11,3,4672.5199999999995,5539.82
16159,UB27F7A,14,4.799999999999661,10,4,4551.21,4556.01
16160,UE21384,14,11987.419999999998,10,4,25472.58,37460.0
16161,U287574,14,6973.810000000001,9,5,8422.0,15395.810000000001
16162,U3B21A9,14,-3507.9,13,1,3507.91,0.01
16163,UBCE7DB,14,-1027.3799999999999,14,0,1027.3799999999999,0.0
16164,U99137A,14,103.02000000000044,10,4,7950.0,8053.02
16165,U1F2B2E,14,802.2599999999999,12,2,4029.7400000000002,4832.0
16166,UD18D46,14,1097.81,9,5,1613.23,2711.04
16167,UF01048,14,6365.0,9,5,6978.0,13343.0
16168,UFDD4F0,14,10563.290000000003,10,4,7588.400000000001,18151.69
16169,U61D32C,14,561.6000000000001,10,4,5738.399999999999,6300.0
16170,UA077A9,14,-538.7399999999998,10,4,3976.76,3438.02
16171,U4B9DC6,14,-21.179999999999986,10,4,218.48,197.3
16172,U2437B6,14,5.471179065352771e-13,9,5,30976.59,30976.589999999997
16173,U51F5A9,14,-882.2700000000004,9,5,15246.04,14363.77
16174,UBCA027,14,-3692.719999999999,12,2,13902.72,10210.0
16175,U1C856C,14,798.01,10,4,1041.27,1839.28
16176,U055E9D,14,0.7999999999999545,6,8,3804.2,3805.0
16177,U21F9E4,14,-792.5799999999999,12,2,1012.5799999999999,220.0
16178,U33D349,14,2.3499999999999375,8,6,736.8800000000001,739.23
16179,UDD2A5A,14,-5975.259999999999,12,2,12750.73,6775.47
16180,U57DCFA,14,-14043.0,11,3,14170.01,127.01
16181,U842F0A,14,-14721.499999999998,10,4,34738.46,20016.96
16182,U8C3E6E,14,-3965.66,12,2,14079.66,10114.0
16183,UBA7B78,14,25207.29,8,6,34984.78,60192.07
16184,U756B2E,14,11394.239999999998,4,10,5410.41,16804.65
16185,U197CAF,14,-548.4,14,0,548.4,0.0
16186,UD73205,14,197.18000000000004,12,2,1224.1200000000001,1421.3
16187,U64FE23,14,-24980.94,8,6,105697.94,80717.0
16188,U5C56DC,14,-806.2800000000002,8,6,4206.7,3400.42
16189,U199603,14,4.160000000000082,7,7,4471.01,4475.17
16190,UD9CB77,14,17249.760000000002,10,4,11350.24,28600.0
16191,U7F9B32,14,0.0,7,7,8000.0,8000.0
16192,U8BCBCD,14,-4299.410000000001,7,7,24935.66,20636.25
16193,U0E3FFA,14,-51.760000000007494,6,8,162299.43000000002,162247.67
16194,U3AD72D,14,4.547473508864641e-13,12,2,8710.58,8710.58
16195,U543802,14,182.66999999999996,12,2,1110.33,1293.0
16196,U8AFB4C,14,-18.769999999999637,7,7,22274.629999999997,22255.86
16197,UC0076C,14,-2558.49,11,3,5667.0,3108.51
16198,UCE82CA,14,-37718.78,7,7,50011.0,12292.220000000001
16199,U0C9200,14,0.48000000000047294,8,6,11522.060000000001,11522.54
16200,UF562D8,14,-6558.200000000001,14,0,6558.200000000001,0.0
16201,U86C9E1,14,-2682.83,14,0,2682.83,0.0
16202,U53A2BF,14,2119.7799999999997,5,9,1735.63,3855.41
16203,UE09AD4,14,-6.449999999999818,6,8,17604.48,17598.03
16204,UA17728,14,-375.3900000000001,12,2,1349.39,974.0
16205,U274B5B,14,-120.16000000000001,11,3,522.81,402.65000000000003
16206,U4C4857,14,3221.649999999997,9,5,14889.48,18111.129999999997
16207,U553917,14,186.55,6,8,115.05,301.6
16208,U301A17,14,-3734.859999999999,12,2,3934.86,200.0
16209,UD733AD,14,-317.05000000000007,13,1,1318.22,1001.17
16210,U5A5F2B,14,-2010.1499999999999,12,2,2111.15,101.0
16211,UDC051C,14,-22415.17,12,2,22588.17,173.0
16212,UDF0B0A,14,-67.9900000000002,11,3,1728.0800000000002,1660.09
16213,UA49673,14,-19645.41,9,5,30294.75,10649.34
16214,U14D45F,14,-5599.219999999999,11,3,16658.4,11059.18
16215,U0AFD1F,14,-935.6000000000004,12,2,13337.0,12401.4
16216,U528A56,14,-1402.42,10,4,8782.02,7379.6
16217,UD0FB41,14,-3389.1,13,1,5727.46,2338.36
16218,UE4E13C,14,246.17000000000047,9,5,10203.859999999999,10450.03
16219,U34D117,14,-0.17000000000004434,9,5,552.85,552.6800000000001
16220,UE8533D,14,-5155.27,13,1,5181.120000000001,25.85
16221,UE11C07,14,1905.07,11,3,3824.88,5729.95
16222,U7356ED,14,379.72000000000116,9,5,10116.0,10495.720000000001
16223,UF26B5C,14,35.0,6,8,35050.0,35085.0
16224,U6D9785,14,1416.97,10,4,752.2400000000001,2169.21
16225,U1EB961,14,4467.49,12,2,6302.08,10769.57
16226,U592943,14,4010.0699999999997,6,8,1063.93,5074.0
16227,UEE6EE3,14,36.989999999998986,10,4,26554.12,26591.11
16228,UFF4897,14,293.08000000000004,12,2,882.86,1175.94
16229,UE90F34,14,-208.3,13,1,242.3,34.0
16230,UDD8C33,14,992.8799999999999,9,5,5547.96,6540.84
16231,U1E9743,14,376.22,12,2,563.78,940.0
16232,U920E1F,14,-8405.02,12,2,8803.22,398.2
16233,U1FAFF0,14,5554.340000000002,6,8,21476.6,27030.94
16234,U777ECF,14,-927.27,13,1,1627.27,700.0
16235,U7523DE,14,-1914.6499999999999,12,2,1947.0,32.35
16236,U79DB3D,14,-593.0,11,3,7420.0,6827.0
16237,U700BDC,14,-1227.0599999999997,10,4,13676.24,12449.18
16238,UB5A192,14,140379.17,9,5,38271.84,178651.01
16239,UFC525F,14,-6603.98,7,7,21419.0,14815.02
16240,U66DD5F,14,381.8600000000006,9,5,7918.15,8300.01
16241,U299E81,14,-936.9199999999998,12,2,8042.36,7105.4400000000005
16242,UF14945,14,-7505.399999999999,12,2,8570.56,1065.16
16243,UD985FF,14,-239.99,11,3,5354.0,5114.01
16244,UC19606,14,-3872.239999999998,7,7,23919.02,20046.78
16245,UDFF104,14,-1691.0,6,8,47570.0,45879.0
16246,UC37334,14,-8218.07,10,4,28135.94,19917.870000000003
16247,UDC718A,14,-1760.9700000000003,8,6,12642.759999999998,10881.79
16248,U70B50A,14,2156.79,12,2,8243.21,10400.0
16249,U0E2804,14,18.0,10,4,142.0,160.0
16250,UBAC4B0,14,-1932.7999999999997,14,0,1932.7999999999997,0.0
16251,U4464AF,14,-856.6600000000001,8,6,2805.66,1949.0
16252,U786235,14,-1642.17,12,2,3031.7500000000005,1389.58
16253,U0C7A63,14,-11598.51,9,5,24618.51,13020.0
16254,UD022D9,14,1909.7600000000002,6,8,20439.35,22349.11
16255,UE0EDC6,14,-3288.36,10,4,4261.46,973.0999999999999
16256,U859D52,14,0.0,6,8,30198.0,30198.0
16257,UB53609,14,-810.8200000000152,5,9,371178.76,370367.93999999994
16258,UFB03C2,14,3039.05,9,5,11609.880000000001,14648.93
16259,UD02A81,14,325.6099999999999,7,7,3310.09,3635.7
16260,U8F6E4D,14,-10524.120000000003,12,2,34301.12000000001,23777.0
16261,U38C00B,14,38375.64000000001,8,6,22115.739999999998,60491.38
16262,U6D6E23,14,4113.09,12,2,1186.91,5300.0
16263,U0C5644,14,289.6,10,4,604.9100000000001,894.51
16264,UFF4742,14,-8216.150000000001,10,4,66421.31999999999,58205.17
16265,UDB5814,14,-137572.0,9,5,909572.0,772000.0
16266,U5EAD2D,14,-1186.9199999999996,13,1,2846.919999999999,1660.0
16267,UC71EAA,14,-9.449999999999818,9,5,13061.279999999999,13051.830000000002
16268,U2F7D20,14,29380.15,12,2,10891.539999999997,40271.69
16269,U26C5A6,14,5636.0,9,5,19308.0,24944.0
16270,U8D3B58,14,-311.8400000000001,9,5,2258.2700000000004,1946.43
16271,UB3BC0A,14,-513.1600000000005,12,2,3973.16,3460.0
16272,U256A8D,14,-97.30000000000004,12,2,1093.36,996.06
16273,U64EE78,14,-2246.07,11,3,3336.86,1090.79
16274,UA98184,14,102.52,10,4,6698.5,6801.02
16275,U1D646D,14,-665.3599999999997,11,3,7185.36,6520.0
16276,UED34AE,14,-3000.0,3,11,47998.37,44998.37
16277,U3D61FC,14,5236.099999999999,11,3,2614.61,7850.71
16278,U858C32,14,600.99,9,5,208.08,809.07
16279,U634382,14,16335.840000000002,11,3,63909.6,80245.44
16280,U7F6419,14,-1605.4000000000003,11,3,2503.0800000000004,897.68
16281,UB3B9B5,14,-634.5900000000001,11,3,2851.98,2217.39
16282,U11D59D,14,-20000.0,10,4,39810.740000000005,19810.74
16283,U97DF59,14,-12015.059999999998,7,7,23767.9,11752.84
16284,U647E96,14,-401.53,11,3,2004.6599999999994,1603.1299999999999
16285,UDCE305,14,-1.5799999999999272,10,4,3971.6,3970.02
16286,UD512B2,14,-5131.199999999999,14,0,5131.199999999999,0.0
16287,UAA40FE,14,-11848.04,14,0,11848.04,0.0
16288,U699E47,14,-1832.8100000000002,13,1,1967.8100000000002,135.0
16289,U943DDE,14,37799.97,10,4,6443.49,44243.46
16290,U457C1C,14,-772.1999999999997,12,2,4147.86,3375.66
16291,U9B1F2F,14,3415.950000000166,3,11,1652000.0,1655415.95
16292,U30A8F6,14,-242.4000000000001,12,2,1896.8200000000002,1654.42
16293,U1EFD35,14,145.1700000000003,10,4,2990.04,3135.21
16294,U112B03,14,-2363.8100000000004,12,2,2985.9500000000003,622.14
16295,U9130B0,14,-3728.3199999999997,13,1,4028.3199999999997,300.0
16296,U8C8209,14,-6728.5999999999985,10,4,25250.0,18521.4
16297,U627ADD,14,-1603.0,9,5,19729.0,18126.0
16298,UDD3988,14,-8871.900000000001,12,2,23124.9,14253.0
16299,U472E54,14,-3000.0,7,7,121000.0,118000.0
16300,UCDC494,14,10633.960000000001,12,2,10192.539999999999,20826.5
16301,U8000C7,14,922.6199999999998,12,2,1077.38,2000.0
16302,U7C5C9F,14,-9577.029999999999,14,0,9577.029999999999,0.0
16303,U3E2999,14,-242.50000000000006,9,5,5552.48,5309.98
16304,U456B09,14,1692.99,12,2,3247.1699999999996,4940.16
16305,U1A96AB,14,-1463.9099999999999,10,4,6112.01,4648.1
16306,UE056D2,14,-2486.2500000000005,10,4,8289.86,5803.610000000001
16307,U6A9E89,14,1779.22,11,3,1246.6399999999999,3025.8599999999997
16308,UBF74B7,14,-1160.51,10,4,1881.97,721.46
16309,U94E06C,14,1605.6000000000001,7,7,5038.84,6644.44
16310,UA6C937,14,577.3800000000001,10,4,6565.62,7143.0
16311,U40041C,14,-5899.01,10,4,11829.01,5930.0
16312,U42492E,14,3035.0599999999995,9,5,5124.2,8159.26
16313,UB404E8,14,24931.12,7,7,8150.759999999999,33081.880000000005
16314,U0A8C87,14,496.14000000000004,12,2,1053.86,1550.0
16315,UDF6B49,14,100.8,7,7,564.83,665.6299999999999
16316,UF18020,14,16765.63,10,4,7497.5,24263.13
16317,U870B44,14,-1282.1399999999999,11,3,1378.7199999999998,96.58
16318,UF9FCB8,14,317.41999999999996,12,2,337.03000000000003,654.45
16319,UC6840E,14,24.959999999999923,10,4,3411.1600000000003,3436.12
16320,U3123EF,14,189.2400000000007,10,4,12310.759999999998,12500.0
16321,UDFDA38,14,1271.730000000001,12,2,14355.67,15627.4
16322,UEE770B,14,-8209.71,10,4,11110.0,2900.29
16323,U012F51,14,11215.86,8,6,1028.8,12244.66
16324,U63FE39,14,536.1900000000003,8,6,4800.0,5336.1900000000005
16325,UA966E1,14,1101.6299999999997,11,3,10778.34,11879.97
16326,UD7E2FD,14,-214.99,13,1,884.99,670.0
16327,U4471E5,14,155.78000000000003,10,4,267.32000000000005,423.1
16328,UB35492,14,-698.9999999999998,14,0,698.9999999999998,0.0
16329,U22EC8B,14,443.12999999999994,10,4,598.98,1042.11
16330,UF94766,14,209.0,10,4,15422.0,15631.0
16331,U3C1863,14,-721.6999999999999,13,1,2377.48,1655.78
16332,U9BDFAC,14,-22764.37,14,0,22764.37,0.0
16333,U4835A7,14,360.0,5,9,300.0,660.0
16334,U08C5BD,14,-1554.18,9,5,2541.7,987.52
16335,U3BA627,14,-2865.6800000000003,9,5,5597.150000000001,2731.47
16336,UD7D4EA,14,-4592.470000000001,8,6,23645.03,19052.559999999998
16337,U78D82D,14,-594.11,10,4,744.7000000000002,150.59
16338,UBEA148,14,-12116.35,13,1,12129.6,13.25
16339,U962940,14,1658.9599999999998,6,8,3380.87,5039.829999999999
16340,U2E7301,14,9916500.0,9,5,116503.6,10033003.6
16341,UF3D6EF,14,21169.55,12,2,47330.45,68500.0
16342,U1E5FF0,14,87.99000000000001,9,5,1793.39,1881.38
16343,U9325BA,14,-1817.7199999999987,8,6,31527.559999999998,29709.84
16344,UDBC671,14,-6.000000000000057,12,2,1771.3,1765.3
16345,UD3F062,14,1641.8400000000001,7,7,5058.17,6700.01
16346,UF3E3FC,14,1.25,12,2,293.72999999999996,294.97999999999996
16347,U272289,14,858.57,7,7,7360.87,8219.44
16348,U4E00BA,14,-553.6700000000001,9,5,30078.38,29524.71
16349,U2ABEF6,14,-385.0699999999997,8,6,14366.289999999999,13981.22
16350,U089C85,14,-373.29999999999995,11,3,870.1999999999999,496.90000000000003
16351,U440C6E,14,-33015.85999999999,14,0,33015.85999999999,0.0
16352,UDC93D7,14,8560.449999999999,10,4,35533.1,44093.55
16353,U7F7C75,14,-1.3199999999999985,10,4,261.42999999999995,260.11
16354,UFD808E,14,-257.41999999999996,12,2,1397.4199999999998,1140.0
16355,U8053B6,14,-514.9000000000001,9,5,3884.68,3369.78
16356,U0CFFF7,14,-11.949999999999855,10,4,5271.860000000001,5259.910000000001
16357,U31142D,14,323.93000000000006,11,3,342.46999999999997,666.4
16358,U7E4C94,14,-2734.44,9,5,7955.14,5220.7
16359,U8CEEDC,14,267.9000000000001,12,2,803.1,1071.0
16360,UE56116,14,-26.609999999999673,7,7,16346.66,16320.05
16361,UD697D6,14,-4949.099999999999,9,5,11100.0,6150.900000000001
16362,U0A7E34,14,7878.280000000001,9,5,7677.9,15556.18
16363,UCB79B9,14,984.25,8,6,8806.74,9790.99
16364,U0B9D84,14,635.4400000000005,7,7,11768.72,12404.16
16365,UD59B2D,14,-784.0,10,4,6845.84,6061.84
16366,UB73FA2,14,277.839999999999,9,5,34432.05,34709.89
16367,U5715EE,14,62.860000000000014,6,8,1154.67,1217.53
16368,U4759CA,14,-1264.5,12,2,2564.5,1300.0
16369,U7FC398,14,-4723.3,10,4,8431.44,3708.14
16370,U34FCED,14,93833.63,8,6,1317.71,95151.34
16371,UC0E1AA,14,-2382.25,12,2,5244.460000000001,2862.21
16372,UC5438E,14,-218.43000000000004,10,4,800.61,582.18
16373,U7C20DD,14,611.79,8,6,2357.67,2969.46
16374,UB2ADE5,14,-2011.539999999999,10,4,14254.64,12243.1
16375,U244AB0,14,36674.869999999995,8,6,37059.44,73734.31
16376,UD70890,14,-1502.59,12,2,1971.04,468.45000000000005
16377,UEFED2E,14,-109.92000000000007,7,7,5358.0,5248.08
16378,UD3C05B,14,-6417.660000000001,11,3,17917.66,11500.0
16379,U318A87,14,5721.77,8,6,7487.42,13209.189999999999
16380,U2D75C8,14,-4305.56,12,2,8144.9,3839.34
16381,U135E3B,14,352.2800000000001,12,2,2171.16,2523.44
16382,UFD9145,14,1023.1399999999998,8,6,901.11,1924.2499999999998
16383,U2EC91D,14,5059.2699999999995,4,10,984.4200000000001,6043.69
16384,U82420B,14,31.920000000000073,11,3,1815.08,1847.0
16385,UD97416,14,-299.63,10,4,393.63,94.0
16386,U048F0B,14,-2029.800000000003,11,3,33490.78,31460.98
16387,UD1AD2B,14,-7.105427357601002e-15,11,3,288.59000000000003,288.59000000000003
16388,UE4F6DB,14,0.0,6,8,57518.0,57518.0
16389,U482C9F,14,104792.0,7,7,14992.0,119784.0
16390,U3BF949,14,-2222.7,10,4,7673.7,5451.0
16391,UD38827,14,-3505.25,14,0,3505.25,0.0
16392,U21279F,14,21327.7,7,7,34028.0,55355.7
16393,U9F8C35,14,1391.1700000000012,9,5,10623.0,12014.170000000002
16394,U4DCDC6,14,-58.01999999999998,8,6,15404.3,15346.279999999999
16395,U04779B,14,-60306.19,9,5,70495.34,10189.15
16396,U67189E,14,-14.50000000000022,11,3,2498.89,2484.39
16397,UA14C7C,14,-657.1799999999998,11,3,3758.15,3100.97
16398,UD32E79,14,-2361.2599999999993,13,1,9619.57,7258.31
16399,U0E1A48,14,2271.0,7,7,12884.0,15155.0
16400,U238062,14,-12240.03,12,2,23449.03,11209.0
16401,U47AC4A,14,-5965.959999999998,12,2,8992.96,3027.0
16402,UC7C275,14,7298.75,9,5,5502.15,12800.9
16403,UDF770F,14,-13314.27,11,3,13923.2,608.93
16404,U7EB6C6,14,9204.0,7,7,29996.0,39200.0
16405,U67B50E,14,1660.61,8,6,10274.32,11934.93
16406,U8B20C8,14,-223.87000000000012,11,3,1170.6599999999999,946.79
16407,U905106,14,909.4000000000001,13,1,2090.6,3000.0
16408,U68B162,14,916.0399999999995,8,6,7383.38,8299.42
16409,U573EDB,14,-1605.69,11,3,3953.3,2347.61
16410,U18EDD9,14,-5886.219999999999,14,0,5886.219999999999,0.0
16411,U6C07AC,14,3887.8999999999996,8,6,9995.5,13883.4
16412,U32139B,14,81.57,11,3,8600.18,8681.75
16413,U7F9A21,14,-1312.0,11,3,3258.0000000000005,1946.0
16414,U76BCB2,14,-136.3099999999995,9,5,13293.08,13156.77
16415,UE2D843,14,-2188.96,12,2,4697.5,2508.54
16416,U43997D,14,-50536.04,10,4,65401.22,14865.18
16417,UA6FD24,14,-4534.05,9,5,6298.86,1764.81
16418,UACECAA,14,44642.21000000001,8,6,7328.79,51971.0
16419,UF03974,14,-52.70000000000002,13,1,154.58,101.88
16420,UF3C760,14,-856.5199999999995,12,2,4862.7,4006.1800000000003
16421,U4208BB,14,-51.18000000000011,8,6,2362.9300000000003,2311.75
16422,U61099C,14,8585.5,11,3,814.5,9400.0
16423,U959630,14,878.3,10,4,3281.7099999999996,4160.01
16424,U19EE54,14,7539.299999999999,10,4,9110.26,16649.559999999998
16425,U2E5BF9,14,895.0700000000004,11,3,2005.75,2900.82
16426,U6FAEDC,14,-24443.850000000006,10,4,153168.96,128725.11
16427,U2EBF63,14,411.8599999999998,10,4,716.73,1128.59
16428,U1329D6,14,22.480000000000118,7,7,2627.56,2650.04
16429,U6D3055,14,-81.69999999999982,9,5,6281.7,6200.0
16430,U91ECD0,14,223.89,10,4,1842.1100000000001,2066.0
16431,U0CCCAE,14,9821.73,8,6,15958.59,25780.32
16432,U0697EA,14,-2094.92,14,0,2094.92,0.0
16433,U546E8F,14,1004.5,11,3,958.5,1963.0
16434,U3B1260,14,-1990.6999999999998,10,4,10110.44,8119.74
16435,UC40583,14,508.20000000000005,12,2,27281.8,27790.0
16436,U782194,14,2029.1800000000007,9,5,2947.9,4977.08
16437,UAB798F,14,403.50999999999993,12,2,1.88,405.39
16438,U6557D2,14,-1381.04,12,2,2302.9799999999996,921.94
16439,UF2BBA4,14,289.06,7,7,1161.7,1450.76
16440,U8C6DD9,14,5.890000000000145,6,8,2933.0,2938.8900000000003
16441,UAEB94F,14,229.00999999999996,11,3,1800.46,2029.47
16442,U25B182,14,3108.0,12,2,23626.0,26734.0
16443,U7A94F4,14,-37.0,7,7,8140.0,8103.0
16444,U7943B8,14,4621.66,11,3,1229.2,5850.860000000001
16445,U881CF5,14,-391.0,10,4,102391.0,102000.0
16446,UAAE5C5,14,-1690.39,9,5,2496.2200000000003,805.83
16447,U99BB1F,14,-1755.6399999999999,11,3,4205.639999999999,2450.0
16448,UE18908,14,1070.8099999999997,10,4,1870.89,2941.7
16449,U2632FD,14,4365.85,6,8,6324.23,10690.08
16450,UC950FD,14,4089.3900000000003,10,4,2049.6099999999997,6139.0
16451,UF2CBFF,14,-117.27999999999955,11,3,5978.8,5861.52
16452,U28E3A9,14,-5.349999999999454,9,5,19329.0,19323.65
16453,UB77D4A,14,16071.66,5,9,6751.7,22823.36
16454,UCB693D,14,-15490.0,5,9,72002.0,56512.0
16455,UF32A60,14,-10267.000000000004,11,3,21198.78,10931.779999999999
16456,U33055D,14,-9840.41,14,0,9840.41,0.0
16457,U07A27D,14,-1787.3,12,2,2287.3,500.0
16458,U607C1F,14,-233.92000000000002,12,2,425.08,191.16
16459,UFCD425,14,-8261.36,14,0,8261.36,0.0
16460,UD31B86,14,-11821.970000000001,12,2,19285.940000000002,7463.969999999999
16461,UE94140,14,-50.0,10,4,9750.0,9700.0
16462,U106D49,14,-1309.2200000000003,11,3,3709.24,2400.02
16463,U9C284E,14,143.86999999999998,12,2,457.16,601.03
16464,UD8631D,14,-166.2900000000003,12,2,2351.6,2185.31
16465,U9AE6BA,14,6472.54,9,5,12429.46,18902.0
16466,U673743,14,-1745.5,14,0,1745.5,0.0
16467,U664FA4,14,4612.85,10,4,3866.86,8479.71
16468,U57D133,14,29118.08,7,7,18864.98,47983.06
16469,U190C80,14,199.44000000000003,12,2,238.32000000000002,437.76
16470,U832F67,14,-0.23000000000000398,7,7,10093.0,10092.77
16471,U163FF3,14,-304.78,9,5,6812.98,6508.200000000001
16472,U53B901,14,1.7053025658242404e-13,12,2,2162.12,2162.12
16473,UEF32E9,14,-10435.0,11,3,25741.5,15306.5
16474,UA74F99,14,5.129999999998254,5,9,12927.87,12933.0
16475,U1B0081,14,-4987.9000000000015,8,6,10780.76,5792.86
16476,UBABF07,14,-0.8599999999999852,12,2,1273.8600000000001,1273.0
16477,U9D74A0,14,5708.34,8,6,1727.6,7435.9400000000005
16478,UBDFDBF,14,25346.14999999999,8,6,31885.210000000003,57231.35999999999
16479,UC64D43,14,-4182.83,12,2,7449.700000000001,3266.87
16480,UFC4E95,14,-299.47999999999996,14,0,299.47999999999996,0.0
16481,U9BB08C,14,-1470.1000000000008,12,2,6742.26,5272.16
16482,UDD0457,14,-7060.0,8,6,20660.0,13600.0
16483,UA7A863,14,-2068.28,13,1,6168.28,4100.0
16484,U25C3A1,14,-2050.81,11,3,4001.81,1951.0
16485,U063D10,14,-764.3400000000026,12,2,30189.64,29425.3
16486,U3C74C8,14,7.105427357601002e-15,12,2,1758.5999999999997,1758.6
16487,U7E9E83,14,439.18,4,10,47.92,487.09999999999997
16488,UE732CC,14,947.1399999999999,11,3,5051.26,5998.4
16489,UA22F0F,14,218.81000000000057,10,4,10292.8,10511.61
16490,U1021B4,14,9086.3,9,5,65529.7,74616.0
16491,UC3F383,14,153.74,11,3,1487.26,1641.0
16492,UF85C98,14,-9602.699999999999,11,3,35862.700000000004,26260.0
16493,U012721,14,-1697.7499999999998,10,4,29796.75,28099.0
16494,UC31435,14,-17938.309999999998,12,2,26726.739999999998,8788.43
16495,U7DEB33,14,109.5,12,2,1010.5,1120.0
16496,U4A7A8E,14,-820.0,10,4,8723.0,7903.0
16497,UE26884,14,-3708.130000000001,12,2,12016.77,8308.64
16498,U060976,14,-9989.0,8,6,31929.239999999998,21940.239999999998
16499,UFB9922,14,55.72,9,5,844.31,900.03
16500,U516AC3,14,-146432.27,8,6,167200.59,20768.32
16501,UC5F097,14,1565.4300000000003,8,6,6151.4400000000005,7716.87
16502,U2C56F8,14,-588.51,12,2,745.51,157.0
16503,UFE4BC0,14,300.37999999999965,11,3,6816.76,7117.14
16504,U42D0B0,14,-5312.04,13,1,6152.040000000001,840.0
16505,U1D961C,14,-1435.3600000000001,12,2,6035.360000000001,4600.0
16506,UE4F840,14,469.8000000000002,8,6,17970.2,18440.0
16507,U5BD46B,14,-3520.120000000001,14,0,3520.120000000001,0.0
16508,UD0F533,14,-29.07000000000027,9,5,1645.1400000000003,1616.07
16509,U495FA2,14,-261.0,9,5,1052.85,791.85
16510,UC7E282,14,-1033.9799999999996,10,4,6001.8,4967.820000000001
16511,UD405A5,14,1100.9999999999998,10,4,1859.1000000000001,2960.1
16512,UEDE486,14,5932.390000000003,6,8,34017.6,39949.990000000005
16513,UD7F6C1,14,-8084.240000000001,14,0,8084.240000000001,0.0
16514,U3D07B7,14,-1055.82,14,0,1055.82,0.0
16515,UECCD98,14,400.6500000000001,8,6,7171.0,7571.65
16516,UFAE9B0,14,-513.6300000000001,6,8,2155.0,1641.37
16517,U87CBD8,14,-1838.2999999999993,11,3,17938.3,16100.0
16518,U769A96,14,0.0,8,6,20000.0,20000.0
16519,UEDA07E,14,38643.44,11,3,5740.32,44383.759999999995
16520,U77070C,14,91220.43000000001,6,8,7812.02,99032.45
16521,UDF4DC0,14,-11987.27,12,2,13321.41,1334.14
16522,UD76547,14,-10698.35,8,6,55400.0,44701.65
16523,UE91032,14,14904.380000000001,6,8,9775.08,24679.46
16524,UABE961,14,-3937.28,12,2,11307.5,7370.219999999999
16525,U36D70F,14,-4732.19,12,2,5732.19,1000.0
16526,UDA9117,14,-65.72,11,3,1266.0,1200.28
16527,UC55F2F,14,1358.0699999999997,9,5,10714.369999999999,12072.439999999999
16528,U8F9F2E,14,287.7999999999993,9,5,6202.200000000001,6490.0
16529,UC762D8,14,-1183.82,13,1,2183.8199999999997,1000.0
16530,U6652BB,14,16000.000000000002,10,4,29184.38,45184.380000000005
16531,UE890CA,14,173.12000000000043,11,3,10227.73,10400.85
16532,U7C6324,14,-10292.900000000001,9,5,12250.78,1957.8799999999999
16533,U8B7095,14,0.0,10,4,1358.56,1358.56
16534,U626391,14,-384.79999999999995,9,5,3284.8,2900.0
16535,U860ADD,14,-263.28,13,1,912.0799999999999,648.8
16536,U953588,14,-7575.93,10,4,20409.0,12833.07
16537,U93ACD4,14,-15933.0,11,3,37000.0,21067.0
16538,U9A33AB,14,7155.02,11,3,28890.0,36045.02
16539,UF9BEC3,14,-127.10000000000002,12,2,727.1,600.0
16540,U8D449E,14,-3021.3999999999996,11,3,27069.4,24048.0
16541,UB0174B,14,-45.26999999999998,8,6,1845.65,1800.38
16542,U1D4A1B,14,1560.4299999999998,12,2,439.65,2000.08
16543,UE64AEA,14,-1680.57,13,1,2268.79,588.22
16544,U113DB8,14,41.99999999999957,10,4,9940.67,9982.67
16545,UCEABA9,14,-41.06,11,3,691.52,650.46
16546,U1895A0,14,25.810000000000013,11,3,220.39999999999998,246.20999999999998
16547,U9F5001,14,-4967.1900000000005,9,5,15526.12,10558.93
16548,UE61C64,14,115616.22,8,6,14273.199999999999,129889.42
16549,UBDB716,14,-2317.22,11,3,7022.22,4705.0
16550,U4F09D4,14,-5431.75,9,5,13896.75,8465.0
16551,U77F02B,14,-36.63999999999942,11,3,12537.5,12500.86
16552,U39C28D,14,249.99999999999812,8,6,15439.45,15689.449999999999
16553,U799441,14,-781.0,12,2,9803.66,9022.66
16554,UB0F9FA,14,2146.8899999999994,8,6,10254.16,12401.05
16555,U3E49E3,14,16574.76,9,5,1106.8200000000002,17681.58
16556,UA8B3FC,14,-1877.8600000000001,8,6,16143.7,14265.84
16557,UA36847,14,-55.92000000000076,8,6,13368.27,13312.35
16558,UFA23C3,14,40.0,12,2,2770.42,2810.42
16559,U055873,14,2355.51,11,3,1385.49,3741.0
16560,U45FA4D,14,2491.6699999999996,11,3,3834.1,6325.77
16561,U546F55,14,7102.139999999999,10,4,14316.779999999999,21418.92
16562,U8050AB,14,-191.69999999999996,11,3,593.88,402.18
16563,U91A6E5,14,-8727.56,11,3,9388.769999999999,661.21
16564,U28A70A,14,9889.34,10,4,4212.660000000001,14102.0
16565,U696115,14,-981.12,11,3,1156.24,175.12
16566,U644499,14,-11817.779999999999,12,2,12019.779999999999,202.0
16567,UF368C8,14,-170.48000000000002,12,2,1437.7000000000003,1267.22
16568,U3074FB,14,27883.75,11,3,12264.279999999999,40148.03
16569,U2E0D28,14,77858.39000000001,8,6,38541.61,116400.0
16570,U2AA0F1,14,1079.9999999999998,4,10,5981.6,7061.6
16571,U19D6CD,14,-35832.79,8,6,42034.159999999996,6201.37
16572,U3D598C,14,-204.5,11,3,5703.6,5499.1
16573,UB33F3B,14,-121.38999999999942,6,8,80556.0,80434.61
16574,UE5D3C0,14,4738.84,10,4,10131.160000000002,14870.0
16575,U191520,14,57924.59,9,5,62075.41,120000.0
16576,UF3A363,14,6988.0,10,4,736.23,7724.23
16577,U43385A,14,-3488.6399999999994,10,4,7427.74,3939.1
16578,U3398FE,14,9943.119999999999,11,3,7774.629999999999,17717.75
16579,UDE53D7,14,-256.9200000000001,10,4,3176.92,2920.0
16580,UEDA36A,14,2116.0,9,5,3927.54,6043.54
16581,U7C4F00,14,680.0,9,5,16118.0,16798.0
16582,UAD89D2,14,-2016.6099999999997,8,6,4369.94,2353.33
16583,U16908E,14,-51498.01,8,6,103227.98999999999,51729.979999999996
16584,UBF28BA,14,12.200000000000045,13,1,7987.8,8000.0
16585,UFB3EAD,14,9251.379999999997,8,6,57608.0,66859.38
16586,U1F493C,14,-3258.620000000001,14,0,3258.620000000001,0.0
16587,U1D8EE4,14,-519.91,10,4,3110.92,2591.01
16588,UAB0CA7,14,816.25,9,5,1483.8,2300.05
16589,UAD3827,14,-2910.2699999999995,9,5,35910.77,33000.5
16590,U022CB4,14,6580.46,10,4,8978.539999999999,15559.0
16591,UE104FD,14,-29.819999999999993,12,2,1362.71,1332.8899999999999
16592,U1F6A77,14,-4408.57,13,1,6676.14,2267.57
16593,U88F8A5,14,4.05000000000291,6,8,79996.0,80000.05
16594,U89447D,14,2733.3499999999995,11,3,317.45000000000005,3050.8
16595,UA60C9E,14,7836.98,8,6,21065.300000000003,28902.28
16596,U4D6171,14,28181.129999999997,5,9,8000.15,36181.28
16597,UDA0CE8,14,-4317.0,10,4,7098.0,2781.0
16598,U01B45A,14,25.359999999999786,8,6,2478.48,2503.84
16599,UA9D910,14,-1638.0,10,4,2401.0,763.0
16600,UD339F1,14,-711.2399999999998,11,3,16090.41,15379.17
16601,U51CC1B,14,-43940.270000000004,12,2,55028.0,11087.73
16602,UD0307F,14,25707.92,13,1,6452.08,32160.0
16603,U8286B0,14,-1880.000000000001,12,2,8929.050000000001,7049.05
16604,UCF4B5B,14,-35813.19,3,11,57777.24,21964.05
16605,UE2B81E,14,2204.0499999999993,9,5,41402.9,43606.95
16606,U1BB3BA,14,5384.5,9,5,1815.7600000000002,7200.26
16607,U8EC7D3,14,-4849.28,11,3,12600.0,7750.719999999999
16608,UFED33E,14,1438062.1700000004,8,6,2100770.82,3538832.9899999998
16609,UE87D3E,14,17435.280000000002,11,3,39727.05999999999,57162.34
16610,U85E466,14,-4403.83,12,2,5388.549999999999,984.72
16611,U22061F,14,-2859.69,11,3,7759.530000000001,4899.84
16612,UFB5063,14,-4462.219999999999,12,2,9704.699999999999,5242.48
16613,U0490BA,14,2181.5299999999997,10,4,717.1299999999999,2898.6600000000003
16614,UDA8CAB,14,-1999.98,9,5,10039.380000000001,8039.4
16615,U1E4B53,14,380.16,0,14,0.0,380.16
16616,UE3D076,14,1436.44,9,5,348.3,1784.74
16617,U47DCBF,14,-1.1799999999999962,11,3,264.57,263.39
16618,U985FC9,14,0.38000000000101863,9,5,25901.23,25901.61
16619,U764DA0,14,6067.780000000001,8,6,17364.850000000002,23432.629999999997
16620,U26DC60,14,-375.28,12,2,512.28,137.0
16621,U1E6BCB,14,-7314.339999999997,10,4,18220.36,10906.02
16622,U6D794F,14,6004.0599999999995,10,4,5065.579999999999,11069.64
16623,UC1B488,14,-2143.92,14,0,2143.92,0.0
16624,U2AC449,14,860.0,12,2,1736.7,2596.7
16625,U6123CC,14,-4843.36,11,3,14820.199999999999,9976.84
16626,U4EE6E9,14,-59.999999999999886,9,5,12736.98,12676.98
16627,UB1FD40,14,10622.44,6,8,19377.559999999998,30000.0
16628,U00FC14,14,985.3000000000001,12,2,6243.49,7228.79
16629,U271DA5,14,49.0,2,12,10.0,59.0
16630,UF2546B,14,3684.7200000000003,7,7,1978.47,5663.1900000000005
16631,UCEE168,14,-1.410000000000048,9,5,572.64,571.23
16632,U22BAEA,14,-659.88,12,2,2409.88,1750.0
16633,U45CAAA,14,3806.4000000000033,7,7,123831.56,127637.96
16634,U889163,14,820.0,2,12,10.0,830.0
16635,U4E7789,14,-12147.609999999999,13,1,14238.609999999999,2091.0
16636,U59C9BB,14,76.13,6,8,2133.87,2210.0
16637,U8AC55D,14,-758.6799999999998,11,3,1588.2999999999997,829.62
16638,U7EF60B,14,77.05000000000001,12,2,3270.0,3347.05
16639,UC7263E,14,570.46,12,2,2005.02,2575.48
16640,U919682,14,-3.410605131648481e-13,13,1,1271.3600000000001,1271.36
16641,U5FD2DE,14,-13.930000000000291,6,8,13464.01,13450.08
16642,UF0A744,14,8497.450000000004,9,5,54488.549999999996,62986.0
16643,U2EB1ED,14,-1503.4999999999998,11,3,1884.23,380.73
16644,U8C3850,14,-13303.170000000002,11,3,18428.239999999994,5125.07
16645,UC9E70C,14,-1548.9399999999996,11,3,18523.940000000002,16975.0
16646,U4730F8,14,808.3000000000001,9,5,2001.7000000000003,2810.0
16647,UBAAF69,14,-410.0,9,5,35010.0,34600.0
16648,U41F3D6,14,-3582.72,13,1,3582.73,0.01
16649,U6FF462,14,156.38000000000002,9,5,172.61,328.99
16650,U47E282,14,-250.1900000000005,7,7,12979.5,12729.31
16651,U6C0F6E,14,-1486.0200000000004,9,5,26500.0,25013.98
16652,UCA859A,14,-547.7600000000002,12,2,12747.76,12200.0
16653,U95604E,14,-2365.06,11,3,3650.7,1285.6399999999999
16654,U8558CC,14,-89.54999999999995,12,2,1889.56,1800.01
16655,U58C86E,14,527.2299999999996,10,4,5687.42,6214.65
16656,U0F4F5F,14,-92.13,11,3,174.56,82.43
16657,U8846CA,14,141.68000000000006,8,6,2458.11,2599.79
16658,U6DC1D2,14,408.57,10,4,691.4300000000001,1100.0
16659,U0B2D69,14,-0.17000000000007276,8,6,47309.91,47309.74
16660,U5406E0,14,-514.4599999999999,12,2,1161.3999999999999,646.94
16661,U14FE2E,14,-0.7999999999996419,8,6,5249.699999999999,5248.9
16662,U9D1BF8,14,-3770.21,10,4,7763.1,3992.8900000000003
16663,UD909E7,14,-2211.41,12,2,2592.39,380.98
16664,U41F5AA,14,-4764.37,10,4,9214.470000000001,4450.1
16665,U497E80,14,46.179999999999886,10,4,6859.87,6906.05
16666,U6326C5,14,-99.70000000000005,10,4,2609.7,2510.0
16667,UE5B12A,14,9006.09,7,7,18298.0,27304.09
16668,U73E2B4,14,-10861.32,11,3,11074.32,213.0
16669,UD950B7,14,-2.2737367544323206e-13,10,4,6880.220000000001,6880.219999999999
16670,U383720,14,2263.220000000001,10,4,21776.78,24040.0
16671,U43F3BC,14,4587.52,9,5,9705.04,14292.56
16672,UC151DE,14,-1062.22,14,0,1062.22,0.0
16673,UE2F328,14,2870.3500000000004,10,4,3351.04,6221.39
16674,U9C834D,14,-2572.2999999999997,10,4,9228.540000000003,6656.24
16675,UF5BA5E,14,-953.2700000000002,11,3,7244.91,6291.639999999999
16676,UDFFD7E,14,105.9,9,5,420.7,526.6
16677,U34BAE1,13,-19300.0,9,4,61300.0,42000.0
16678,U65F470,13,462.81999999999977,9,4,1161.94,1624.7600000000002
16679,U1D8069,13,-222.17000000000002,9,4,417.20000000000005,195.03
16680,U29686B,13,-7369.83,8,5,16153.0,8783.17
16681,U80CC49,13,-2025.66,11,2,3966.7400000000002,1941.08
16682,U0D5831,13,268.8499999999999,7,6,372.18,641.03
16683,U1BAA3D,13,-1069.9100000000003,9,4,6243.34,5173.43
16684,U67BD6F,13,1618.58,11,2,221.42000000000002,1840.0
16685,UD4AC6C,13,-201.68999999999997,8,5,2291.6,2089.91
16686,UA3B762,13,15617.660000000002,9,4,1448.27,17065.93
16687,U83DA90,13,1471.6699999999998,8,5,3358.0,4829.67
16688,UC637D7,13,0.14000000000000412,12,1,141.86,142.0
16689,U520BAD,13,1110.6000000000008,11,2,3458.1,4568.700000000001
16690,U5C7452,13,654.9200000000003,10,3,2485.98,3140.9
16691,U08CB16,13,2021.3999999999999,8,5,4430.5,6451.9
16692,UE15D84,13,3811.3499999999995,10,3,9856.7,13668.05
16693,U0C47F8,13,31.730000000001382,7,6,15533.0,15564.730000000001
16694,U5ADA6F,13,-43.07999999999993,9,4,34009.740000000005,33966.66
16695,U54CECF,13,-2409.2,8,5,3000.3999999999996,591.2
16696,U839393,13,2279.08,5,8,3490.0,5769.080000000001
16697,U0236AC,13,-6626.389999999999,10,3,16544.4,9918.01
16698,U705578,13,-3334.0,12,1,5296.0,1962.0
16699,U7D08CC,13,68.22999999999996,10,3,939.26,1007.49
16700,U3476CE,13,-796.2300000000005,10,3,17134.6,16338.369999999999
16701,U655078,13,-5494.43,10,3,16059.67,10565.24
16702,U00B794,13,535.6300000000003,9,4,3995.98,4531.61
16703,UEC3643,13,-567.34,10,3,1825.24,1257.9
16704,UAFE9DE,13,-12428.07,8,5,30330.08,17902.010000000002
16705,U5C1202,13,10014.0,10,3,14298.4,24312.4
16706,U6E5903,13,-3398.36,11,2,3498.37,100.01
16707,U156EFB,13,-25.190000000000023,11,2,262.08000000000004,236.89
16708,U62DCA7,13,-1744.1699999999998,10,3,8953.0,7208.83
16709,UBDB5B2,13,0.0,12,1,7941.0,7941.0
16710,UA9AAA7,13,441.77,9,4,1500.1100000000001,1941.88
16711,UE4131D,13,1705.92,10,3,8794.08,10500.0
16712,UD879C0,13,90.19000000000051,10,3,31880.8,31970.989999999998
16713,UAF8480,13,95.17999999999893,8,5,28807.85,28903.03
16714,U7E320B,13,7130.029999999999,5,8,20000.0,27130.03
16715,UE130D3,13,-2565.84,10,3,8065.84,5500.0
16716,U5F9AE1,13,-475.8999999999999,11,2,524.02,48.120000000000005
16717,UCF8EA8,13,7539.450000000001,6,7,8308.73,15848.18
16718,U21A87D,13,-210.58,9,4,527.0899999999999,316.51
16719,UD79314,13,5847.450000000001,7,6,6236.11,12083.56
16720,U44A1B9,13,992.0499999999993,6,7,16152.48,17144.53
16721,U2EDB0E,13,-496.8900000000001,9,4,2109.71,1612.82
16722,UA36814,13,2037.56,10,3,9002.46,11040.02
16723,UFDC787,13,2671.78,8,5,2754.14,5425.920000000001
16724,UA4A265,13,7751.120000000001,8,5,8480.14,16231.259999999998
16725,U11251A,13,140.0,6,7,263416.0,263556.0
16726,UD09DDE,13,36029.89,10,3,5.0,36034.89
16727,U73390E,13,12274.09,4,9,13100.0,25374.09
16728,U72E75C,13,-6769.870000000001,8,5,23480.700000000004,16710.83
16729,UE21ED6,13,392.64999999999964,6,7,10227.0,10619.65
16730,UEFD6BA,13,273.24999999999983,11,2,962.6200000000001,1235.87
16731,UF3EA98,13,0.0,9,4,55209.6,55209.6
16732,UB024DD,13,-257.0,10,3,29057.0,28800.0
16733,UCDD434,13,18976.36,8,5,6446.719999999999,25423.08
16734,U449EE5,13,-3878.8999999999996,9,4,13106.08,9227.18
16735,U1629C6,13,-9778.3,12,1,9878.3,100.0
16736,U853233,13,-1966.0299999999997,10,3,5543.929999999999,3577.9
16737,U574FF8,13,41404.86,5,8,7701.67,49106.53
16738,U60476A,13,0.0,7,6,14548.17,14548.17
16739,UEC0678,13,3153.9199999999983,7,6,62195.84,65349.76
16740,U3BEF16,13,-149.91000000000048,10,3,6378.4800000000005,6228.57
16741,U5E56FE,13,25.0,11,2,11736.0,11761.0
16742,UC9839D,13,221.85999999999996,9,4,3978.2,4200.06
16743,UE91F8C,13,-2889.48,12,1,4089.48,1200.0
16744,UDF2713,13,-3583.789999999999,6,7,10883.88,7300.09
16745,U12E50F,13,6181.549999999999,5,8,31295.0,37476.55
16746,UA8A6B7,13,-100.07000000000002,10,3,1387.57,1287.5
16747,U67FC14,13,0.0,7,6,9998.0,9998.0
16748,U962032,13,-17997.4,11,2,18281.48,284.08
16749,U24B0D5,13,-23291.33,12,1,23292.03,0.7
16750,UE4AB5E,13,-0.38000000000010914,9,4,5913.620000000001,5913.24
16751,U97C340,13,6654.67,3,10,3010.0,9664.67
16752,U1F3704,13,-2852.8,11,2,3011.8,159.0
16753,UE5B106,13,3625.1099999999997,11,2,2342.16,5967.27
16754,UF3F087,13,1455.6499999999996,11,2,10544.35,12000.0
16755,UCAF410,13,-93.34000000000006,11,2,885.87,792.53
16756,U0E3359,13,-3.410605131648481e-13,6,7,15365.65,15365.65
16757,U5B6CB0,13,2316.0,7,6,17284.0,19600.0
16758,UF71EC1,13,13138.619999999999,5,8,122976.0,136114.62
16759,U7EB1D2,13,-139.89999999999992,10,3,10249.57,10109.67
16760,UFF9AE1,13,234.2999999999998,10,3,1164.8,1399.1
16761,UA17CF1,13,-4401.43,9,4,4500.0,98.57
16762,U01F051,13,4200.949999999999,7,6,7635.099999999999,11836.050000000001
16763,UA0789E,13,1378.4199999999998,2,11,697.5,2075.92
16764,U85BF64,13,-19207.51,11,2,26285.51,7078.0
16765,UFA1A6E,13,1002.2999999999993,6,7,39997.7,41000.0
16766,UF2E07B,13,-128.71,12,1,129.0,0.29
16767,UB56FBC,13,8250.0,9,4,10234.1,18484.1
16768,U98F16B,13,3373.6700000000014,7,6,54910.0,58283.67
16769,U150282,13,-180.0,8,5,4175.0,3995.0
16770,UF0C143,13,-24361.17,9,4,50561.22,26200.05
16771,UD8456D,13,3395.58,10,3,2512.42,5908.0
16772,UAF89F8,13,-4730.0,9,4,26050.0,21320.0
16773,U93790A,13,-1417.7300000000002,11,2,3132.7200000000003,1714.99
16774,U9F9B33,13,1742.8199999999977,10,3,12314.500000000002,14057.32
16775,U298701,13,4812.47,6,7,5806.8,10619.27
16776,UAB343F,13,-2067.88,7,6,10026.13,7958.249999999999
16777,U4B9050,13,-29603.11,7,6,50103.11,20500.0
16778,U37F586,13,-6900.0,9,4,37827.0,30927.0
16779,UD23A33,13,-5746.99,10,3,13635.0,7888.01
16780,U8EBC69,13,-1.6999999999999886,8,5,572.6999999999999,571.0
16781,U05DB40,13,-1750.1399999999999,11,2,2210.3200000000006,460.18
16782,UB688FC,13,3684.6499999999996,9,4,8097.1900000000005,11781.84
16783,UA132D4,13,4106.66,7,6,26516.0,30622.66
16784,UFB6C22,13,-575.54,10,3,9575.54,9000.0
16785,UCE16ED,13,-1193.0,11,2,8243.0,7050.0
16786,U5BCD61,13,-97.89999999999998,12,1,997.9,900.0
16787,U3154DC,13,-231.85000000000002,9,4,2455.85,2224.0
16788,UD9C2B4,13,376.0799999999999,8,5,839.1,1215.1799999999998
16789,U2D84D2,13,-25568.52,11,2,31084.52,5516.0
16790,UF8C7A9,13,-80.0,10,3,16046.0,15966.0
16791,UA0D022,13,1386.4100000000008,11,2,8112.5,9498.91
16792,UBB9731,13,7689.85,10,3,7583.7,15273.55
16793,UCF8178,13,-18.450000000000017,11,2,368.45000000000005,350.0
16794,U1BD9EB,13,-31579.4,11,2,42431.0,10851.6
16795,U7642A7,13,7470.0,8,5,389.37999999999994,7859.38
16796,UFC8A85,13,-633.1099999999999,11,2,4404.91,3771.7999999999997
16797,U2864D4,13,1433.57,8,5,1732.88,3166.45
16798,U204167,13,7331.4400000000005,6,7,6412.97,13744.41
16799,UFAF4B8,13,-3333.4400000000005,12,1,4333.44,1000.0
16800,U8B6D40,13,-6815.66,10,3,23103.08,16287.42
16801,U7EFE0F,13,-3492.4799999999996,12,1,8142.48,4650.0
16802,U138376,13,-244.76,11,2,445.76,201.0
16803,UF22402,13,163.9399999999965,7,6,100442.18,100606.12000000001
16804,U3DCB90,13,1260.02,10,3,2440.0,3700.02
16805,U6D8B42,13,315.7900000000004,9,4,10700.9,11016.69
16806,U8E9AF1,13,-90.00000000000001,11,2,220.8,130.8
16807,UEFFD1F,13,-10413.25,10,3,12946.0,2532.75
16808,U25EB6A,13,-7864.0,6,7,44240.0,36376.0
16809,U33D4C3,13,-3099.9699999999993,7,6,25700.0,22600.03
16810,UA5C918,13,27287.0,2,11,10.0,27297.0
16811,U893CC8,13,-1093.99,7,6,3451.3,2357.31
16812,U1DB4B2,13,-39.07999999999949,9,4,8851.25,8812.17
16813,UB28D6C,13,3468.1,11,2,431.7800000000001,3899.88
16814,U64A58C,13,-10748.6,12,1,11119.84,371.24
16815,U5B4993,13,5031.0,6,7,13598.0,18629.0
16816,U9E2D21,13,-223.19999999999993,11,2,2940.1,2716.9
16817,UEF7853,13,4892.0,6,7,4892.0,9784.0
16818,U732AA3,13,14033.17,9,4,424000.0,438033.17
16819,UD4A489,13,-3130.33,12,1,3297.24,166.91
16820,UCA2F86,13,-9708.47,10,3,20659.44,10950.97
16821,U7F694C,13,-8552.6,12,1,8553.24,0.64
16822,U9421DC,13,27442.719999999998,6,7,51400.020000000004,78842.74
16823,UE57F34,13,-535.9499999999999,8,5,2975.95,2440.0
16824,UD20C7C,13,659.2100000000064,6,7,100347.9,101007.11
16825,U5228E0,13,-1492.99,6,7,6770.28,5277.29
16826,UBA9195,13,0.2999999999999545,8,5,4131.66,4131.96
16827,UC85EA5,13,-176.60000000000036,7,6,14677.0,14500.4
16828,U9F3DF5,13,1129.7099999999998,8,5,3125.6,4255.3099999999995
16829,U0B9B37,13,-347.39999999999964,5,8,8020.4400000000005,7673.04
16830,U0A05C6,13,-1251.07,9,4,1873.96,622.8900000000001
16831,UFB9FD2,13,-4.93999999999869,8,5,21705.05,21700.11
16832,UAB96D1,13,-605.8199999999999,9,4,5574.29,4968.469999999999
16833,U18DD29,13,-1571.2999999999997,8,5,7024.299999999999,5453.0
16834,UD5BCDB,13,934.14,9,4,526.44,1460.58
16835,UDED54D,13,-93.0,9,4,1051.68,958.6800000000001
16836,U92B484,13,88.03999999999999,9,4,9271.8,9359.84
16837,U891D61,13,16.800000000000026,7,6,520.0899999999999,536.8900000000001
16838,UA3D6D3,13,-130.0,11,2,15004.0,14874.0
16839,U49479D,13,2143.0000000000005,8,5,13699.95,15842.95
16840,U5EDF87,13,-365.68,11,2,1397.28,1031.6
16841,UCA564C,13,556.1899999999996,10,3,3769.36,4325.55
16842,UCD8E26,13,-6719.139999999999,7,6,34978.74,28259.600000000002
16843,U311DC6,13,0.0,5,8,4970.25,4970.25
16844,UE59A6D,13,0.0,11,2,32.0,32.0
16845,U706797,13,-6131.560000000001,7,6,12849.880000000001,6718.320000000001
16846,U37285F,13,637.5300000000002,8,5,4192.5,4830.03
16847,U363718,13,1099.79,9,4,5242.71,6342.5
16848,UCE726B,13,-23.629999999999995,12,1,1301.6599999999999,1278.03
16849,UE50BF5,13,576.8399999999998,10,3,11434.16,12011.0
16850,UE946C9,13,0.18000000000211003,7,6,23384.819999999996,23385.0
16851,U469047,13,1208.7800000000007,11,2,12627.49,13836.27
16852,U47A64A,13,826.9200000000003,9,4,7223.08,8050.0
16853,U56C555,13,-3711.5,10,3,84701.34,80989.84
16854,UF04B43,13,242.3400000000001,8,5,1897.84,2140.1800000000003
16855,U8D75C7,13,6.220000000000027,6,7,2191.0,2197.2200000000003
16856,U4D0F1C,13,-166.08999999999992,9,4,6189.200000000001,6023.11
16857,UA535DB,13,-8468.740000000002,13,0,8468.740000000002,0.0
16858,U7342BB,13,1974.1399999999976,9,4,50193.369999999995,52167.51
16859,U3BF752,13,-1106.34,6,7,68514.64,67408.3
16860,U4A486F,13,-463.48999999999955,8,5,5014.13,4550.64
16861,U2AB8A4,13,-4848.210000000001,10,3,4968.4400000000005,120.23
16862,U604F1D,13,-0.06999999999997897,9,4,353.77,353.7
16863,U539114,13,2883.7200000000003,10,3,4941.860000000001,7825.58
16864,UDF93E5,13,-6681.3399999999965,11,2,26681.339999999997,20000.0
16865,UCDBDEF,13,0.7400000000000659,9,4,699.29,700.03
16866,U6AC247,13,-767.8399999999983,7,6,30667.839999999997,29900.0
16867,U818580,13,-1022.4599999999999,11,2,3562.46,2540.0
16868,U3ED1E4,13,11136.960000000003,10,3,11990.92,23127.88
16869,U23352E,13,487.01,9,4,3733.0,4220.01
16870,UE290E9,13,21.500000000000185,11,2,9278.5,9300.0
16871,UEC75BA,13,-1169.11,11,2,1715.11,546.0
16872,UCAF35D,13,-36717.82,6,7,39275.42,2557.6
16873,UC6AD8B,13,-3646.8100000000013,6,7,39798.0,36151.19
16874,U391B8A,13,1106.75,8,5,1816.02,2922.77
16875,U594B5D,13,3566.3100000000004,10,3,3412.68,6978.99
16876,UBA1621,13,0.0,8,5,20010.0,20010.0
16877,UB42571,13,-2848.8600000000006,12,1,3910.580000000001,1061.72
16878,UCBE0C5,13,437.1800000000003,7,6,4522.0,4959.18
16879,U3CCF52,13,360.3200000000001,11,2,1839.68,2200.0
16880,UD638E3,13,-1914.22,13,0,1914.22,0.0
16881,U104936,13,-1306.06,8,5,9026.0,7719.9400000000005
16882,U8E66E5,13,77.19000000000001,11,2,822.81,900.0
16883,U5A1CE1,13,-122.39999999999986,11,2,2295.13,2172.73
16884,U468855,13,-1924.14,7,6,7086.43,5162.289999999999
16885,U635984,13,750.0,9,4,3840.0,4590.0
16886,U7727C6,13,-8795.76,12,1,9795.760000000002,1000.0
16887,U378F2C,13,-3719.6099999999997,8,5,17008.0,13288.39
16888,UB448B6,13,81.28,9,4,771.2800000000001,852.5600000000001
16889,UA6E82C,13,3888.2199999999993,6,7,829.7599999999999,4717.98
16890,U88AF26,13,8888.96,5,8,9188.88,18077.84
16891,UEF2A37,13,-1121.5900000000001,7,6,24080.0,22958.410000000003
16892,U072CB1,13,-1.8500000000003638,10,3,11538.5,11536.65
16893,UC3E390,13,-10606.99,9,4,25509.22,14902.23
16894,U7B4911,13,2.4726887204451486e-12,6,7,31748.690000000002,31748.690000000002
16895,U032DA7,13,0.009999999999990905,6,7,3711.01,3711.02
16896,UF5DD9C,13,-7515.6,8,5,42780.6,35265.0
16897,U3F2209,13,1757.3000000000004,11,2,4107.1,5864.4
16898,U68897B,13,2583.5200000000004,8,5,14092.480000000001,16676.0
16899,UCD0478,13,-598.2499999999998,10,3,6692.2,6093.95
16900,U9ACDA2,13,-12600.0,10,3,30676.300000000003,18076.3
16901,U145A4B,13,-6874.69,9,4,30754.980000000003,23880.29
16902,UCBE7EC,13,4629.320000000001,9,4,72.0,4701.320000000001
16903,UD41E68,13,-24711.94,11,2,33411.94,8700.0
16904,U63E934,13,-6121.64,12,1,11321.640000000001,5200.0
16905,UE15961,13,-395.3499999999999,8,5,2405.35,2010.0
16906,UBAEC30,13,-13077.170000000002,11,2,24077.17,11000.0
16907,U3C38C4,13,-2512.0,11,2,27166.0,24654.0
16908,U1DD1F6,13,-2285.83,10,3,2651.23,365.4
16909,U324DD8,13,-5790.0,13,0,5790.0,0.0
16910,U9BE66B,13,-12274.24,11,2,12974.24,700.0
16911,U6E6106,13,-4981.519999999999,12,1,5425.519999999999,444.0
16912,UB38C76,13,5.019999999999982,7,6,12014.98,12020.0
16913,U43C09C,13,1574.2399999999998,9,4,2621.8599999999997,4196.1
16914,U3341EB,13,-1686.4899999999943,9,4,156686.49,155000.0
16915,U09D0D4,13,-4779.009999999999,9,4,16756.85,11977.84
16916,UDFF90B,13,-2332.5699999999993,7,6,19031.519999999997,16698.95
16917,U75D00A,13,-1427.7,13,0,1427.7,0.0
16918,UF59497,13,-87.04999999999978,12,1,2189.3799999999997,2102.33
16919,UF0500F,13,0.020000000000209184,9,4,10888.600000000002,10888.62
16920,UD0788E,13,-7944.0,11,2,7964.0,20.0
16921,UB6C47A,13,-1.0906830993917538e-12,10,3,10300.710000000001,10300.71
16922,U1D6DBB,13,62.45,12,1,1442.86,1505.31
16923,U24034B,13,-1484.449999999999,7,6,21325.450000000004,19841.0
16924,U026A62,13,1829.07,10,3,1216.4,3045.4700000000003
16925,U2C6728,13,-659.66,9,4,1101.23,441.57
16926,UD6144F,13,-103.06,13,0,103.06,0.0
16927,UB458A2,13,6101.8,9,4,188.47,6290.27
16928,U60E04E,13,494.4699999999999,10,3,8179.49,8673.96
16929,UCA2069,13,-16239.900000000003,10,3,56176.77999999999,39936.88
16930,UD32689,13,604.18,11,2,573.9,1178.08
16931,UD4ABD2,13,-4122.76,13,0,4122.76,0.0
16932,UF8B1F8,13,9158.689999999999,11,2,6441.310000000001,15600.0
16933,U1A247B,13,33.0,5,8,185.74,218.74
16934,UED38A9,13,-1418.3799999999997,9,4,3073.3799999999997,1655.0
16935,U45A04E,13,15174.679999999997,8,5,14795.41,29970.09
16936,UE98043,13,2981.3799999999997,8,5,3353.86,6335.24
16937,U1E2F6F,13,681.89,10,3,1088.1100000000001,1770.0
16938,UCB76DA,13,-6873.300000000001,10,3,17135.3,10262.0
16939,U60D96D,13,5.550000000000011,11,2,541.45,547.0
16940,UC28DC5,13,-45890.8,9,4,55612.7,9721.900000000001
16941,U2217D7,13,1002.89,10,3,1929.98,2932.87
16942,UBA6ADA,13,5684.31,10,3,4758.1,10442.409999999998
16943,U901486,13,587.12,7,6,652.13,1239.25
16944,UE06039,13,-615.98,12,1,1782.3,1166.32
16945,UAF91C5,13,-10150.0,11,2,29349.26,19199.260000000002
16946,UB372B9,13,-49.20999999999958,8,5,4268.719999999999,4219.51
16947,U0CBF4F,13,-77.35000000000002,12,1,248.64,171.29
16948,UA73E36,13,2989.0000000000005,10,3,2809.97,5798.97
16949,U559385,13,-965.02,10,3,971.03,6.01
16950,U57DC1B,13,28414.449999999993,10,3,32215.250000000004,60629.7
16951,UC4FADD,13,-4792.7,11,2,9785.86,4993.16
16952,U5DB994,13,-3213.36,8,5,6053.84,2840.48
16953,UA51A8E,13,3260.8199999999993,7,6,8424.23,11685.05
16954,UE15D2E,13,64706.48999999999,7,6,14893.310000000001,79599.79999999999
16955,UD89E4C,13,-728.9199999999998,12,1,1228.92,500.0
16956,U950AD1,13,9534.09,8,5,6478.16,16012.25
16957,UE6B971,13,2793.0,11,2,3271.0,6064.0
16958,U3B8B1D,13,-17628.97,9,4,37130.0,19501.03
16959,U9FA06D,13,-83.40000000000006,11,2,2247.3799999999997,2163.98
16960,U65BF49,13,51.22,6,7,343.8,395.02
16961,UB2EAC0,13,-11146.0,11,2,12906.0,1760.0
16962,U824304,13,8076.0,10,3,38617.0,46693.0
16963,UAD3D54,13,3326.3999999999987,8,5,3861.1800000000003,7187.579999999999
16964,UD9A324,13,-3130.2999999999997,8,5,3845.9399999999996,715.6400000000001
16965,UFBCC65,13,-5277.469999999999,11,2,11496.939999999999,6219.469999999999
16966,UABDF0E,13,1.7699999999999818,10,3,1233.0,1234.77
16967,U7A8051,13,-2276.3600000000006,8,5,9050.0,6773.64
16968,U8E6CD1,13,13512.41,9,4,20778.18,34290.590000000004
16969,U9AAECE,13,-117.66999999999997,9,4,2740.6900000000005,2623.0200000000004
16970,UBF342B,13,245.90999999999985,8,5,5283.87,5529.78
16971,U40ADED,13,-1290.45,10,3,6490.45,5200.0
16972,U7ED130,13,943.8199999999999,9,4,284.32,1228.1399999999999
16973,U6234B8,13,3580.2200000000003,8,5,9739.129999999997,13319.35
16974,UCB9A20,13,18920.809999999998,9,4,46016.0,64936.81
16975,UACE6CE,13,-1383.7000000000007,7,6,18385.0,17001.3
16976,U39F172,13,-4065.74,8,5,4306.54,240.8
16977,U1ED4F7,13,118.41999999999996,12,1,685.1,803.52
16978,UFF2932,13,-1.0658141036401503e-14,9,4,1127.03,1127.03
16979,UC32B36,13,-91.6,8,5,454.59000000000003,362.99
16980,UD37711,13,320.5500000000002,7,6,26847.0,27167.55
16981,UFEAE9B,13,-822.0699999999997,7,6,7194.86,6372.79
16982,UE786CF,13,-19014.579999999994,9,4,56020.1,37005.520000000004
16983,U0230CD,13,212.0,10,3,15103.0,15315.0
16984,U78F641,13,-9712.62,11,2,11174.66,1462.04
16985,UD1B80C,13,2989.66,10,3,2164.0699999999997,5153.7300000000005
16986,UBF9C5A,13,-9430.97,8,5,19437.010000000002,10006.04
16987,UCE8415,13,-1342.4899999999984,8,5,26694.879999999997,25352.390000000003
16988,U93C74A,13,-12240.0,8,5,33875.0,21635.0
16989,U2EC937,13,-45.500000000000114,12,1,1061.6000000000001,1016.1
16990,UEDE227,13,3890.7299999999996,10,3,5806.0,9696.73
16991,UF8AC16,13,-148.9,8,5,402.9,254.0
16992,U1AE077,13,-2841.4500000000007,10,3,3041.5500000000006,200.1
16993,UE9FA90,13,3196.65,10,3,5342.6,8539.25
16994,U60DD4A,13,0.25,7,6,35418.0,35418.25
16995,U26684A,13,931.3000000000001,3,10,31.700000000000003,963.0
16996,U8563B2,13,-73.44999999999982,9,4,2373.52,2300.07
16997,U546D5F,13,-24191.62,12,1,24241.62,50.0
16998,U15896D,13,-3732.83,6,7,17064.4,13331.57
16999,UE8EBD9,13,270.1300000000001,8,5,1952.3700000000001,2222.5
17000,UE8D9FE,13,58.189999999999834,9,4,7941.820000000001,8000.01
17001,U90EB37,13,-12989.81,11,2,14991.01,2001.2
17002,UE40AF2,13,840.0000000000001,11,2,662.01,1502.01
17003,UD9D38A,13,-1099.25,10,3,3447.0,2347.75
17004,UFBA2AF,13,2095.66,4,9,1573.34,3669.0
17005,UA2E139,13,-239.16000000000003,11,2,433.15999999999997,194.0
17006,U525DD7,13,6577.9800000000005,10,3,832.3200000000002,7410.3
17007,UA1D236,13,-39707.65,12,1,39707.69,0.04
17008,UBDCC44,13,43.0,8,5,1357.0000000000002,1400.0
17009,UE5168F,13,33357.99,7,6,1858.04,35216.03
17010,UFE5E8B,13,-1298.0000000000002,7,6,3279.0,1981.0
17011,UF77268,13,629.8000000000006,11,2,6800.639999999999,7430.4400000000005
17012,U841DB5,13,362.9599999999999,11,2,244.71999999999997,607.68
17013,UA03D24,13,-3961.1800000000003,9,4,11761.18,7800.0
17014,UD2CFCB,13,-5021.0,9,4,23189.0,18168.0
17015,U9723C4,13,-4.5,7,6,5965.5,5961.0
17016,U47EE1C,13,2907.9999999999995,10,3,5274.16,8182.16
17017,U11B8FC,13,-241.14,7,6,2796.0,2554.8599999999997
17018,U923782,13,167.7499999999999,10,3,1147.8200000000002,1315.57
17019,UBEB255,13,1154.9399999999996,11,2,10512.0,11666.939999999999
17020,U1EF2C2,13,575.2799999999997,9,4,10884.720000000001,11460.0
17021,U690395,13,3.5399999999997362,7,6,5490.18,5493.72
17022,U3B3498,13,-7626.619999999999,11,2,7895.639999999999,269.02
17023,U94663A,13,-5645.38,7,6,6613.910000000001,968.53
17024,UAA3BE7,13,1511.420000000001,9,4,15390.510000000002,16901.93
17025,U2CEAF0,13,-1112.42,12,1,1122.42,10.0
17026,UDAD572,13,-1018.0300000000001,12,1,1018.0600000000001,0.03
17027,U51D117,13,176.42999999999893,8,5,5723.37,5899.8
17028,U692604,13,-2403.41,11,2,4459.41,2056.0
17029,UB349C5,13,303.21,9,4,440.81,744.02
17030,U80DE2C,13,-1737.6100000000001,11,2,4557.610000000001,2820.0
17031,U44DB07,13,-75.19999999999891,9,4,38447.2,38372.0
17032,U07E066,13,-469.4599999999991,8,5,13778.4,13308.94
17033,UE234FD,13,9.699999999999818,11,2,7083.5,7093.2
17034,U39D01E,13,2935.4500000000007,10,3,4828.76,7764.21
17035,U850AE4,13,-2570.66,8,5,5930.400000000001,3359.74
17036,U99BBC9,13,-233.27000000000004,11,2,236.28000000000003,3.01
17037,U385F43,13,1211.06,9,4,5242.0,6453.0599999999995
17038,U266E72,13,2882.52,11,2,2122.53,5005.05
17039,U6D1F5B,13,2.680000000000291,6,7,41113.0,41115.68
17040,U8AF767,13,-4121.66,12,1,10521.66,6400.0
17041,U35C441,13,-7603.140000000001,12,1,11103.14,3500.0
17042,UFD1016,13,-948.0300000000007,7,6,22319.04,21371.010000000002
17043,U7454AA,13,-2448.39,9,4,9329.94,6881.549999999999
17044,UF56E48,13,0.8400000000001455,6,7,17837.54,17838.38
17045,UA6B072,13,-2887.3600000000006,10,3,35117.41,32230.05
17046,U7EE9FF,13,8784.869999999999,8,5,3355.5,12140.369999999999
17047,U097750,13,-130.26,10,3,1065.0,934.74
17048,UAE9DF0,13,-300.00000000000045,11,2,6305.000000000001,6005.0
17049,U1B0BFC,13,-2000.0,11,2,4918.0,2918.0
17050,U2E2CD8,13,1664.9,10,3,3560.54,5225.4400000000005
17051,UE1E155,13,-1501.3800000000024,10,3,18822.73,17321.35
17052,UC83206,13,-1474.1999999999998,11,2,1609.67,135.47
17053,U1A01BF,13,-21.690000000000055,6,7,16774.239999999998,16752.55
17054,U528E8B,13,-2965.6500000000005,10,3,5463.92,2498.27
17055,UDF01A7,13,-60.700000000000045,9,4,3129.7,3069.0
17056,U1CE2F1,13,1411.3200000000002,11,2,788.68,2200.0
17057,UE2F110,13,2081.0,9,4,3240.0,5321.0
17058,U1D2993,13,34.78000000000213,8,5,20925.589999999997,20960.37
17059,UAA8482,13,2267.389999999999,11,2,2181.2,4448.59
17060,UA04032,13,-1363.3500000000001,11,2,3763.39,2400.04
17061,UEA2436,13,35259.0,9,4,43742.44,79001.44
17062,U8A3878,13,-75.20000000000033,9,4,3758.9900000000002,3683.79
17063,UBEBC04,13,-11.520000000000003,8,5,42.5,30.98
17064,UA852F4,13,330.4699999999999,10,3,2381.4000000000005,2711.87
17065,U3604F1,13,-1388.8300000000006,11,2,9888.83,8500.0
17066,U008F15,13,8.881784197001252e-16,9,4,40.0,40.0
17067,U26B1AB,13,-12363.26,12,1,14663.26,2300.0
17068,UB10654,13,-517.6300000000001,9,4,1208.83,691.2
17069,U6A5D5D,13,1303.0000000000043,10,3,63664.259999999995,64967.26
17070,UF2A867,13,1694.4800000000005,5,8,13906.0,15600.48
17071,U9CA050,13,7934.51,6,7,3196.71,11131.220000000001
17072,U5F90D6,13,-11800.000000000002,9,4,39406.73999999999,27606.74
17073,U48379B,13,13713.33,6,7,22588.339999999997,36301.67
17074,U21F4CD,13,-1708.8999999999996,10,3,23243.9,21535.0
17075,UCC1723,13,-14639.18,6,7,45510.33,30871.15
17076,UA1EDE7,13,4291.0,5,8,58613.0,62904.0
17077,UAC6159,13,-81.8,11,2,15021.84,14940.04
17078,U536E1A,13,-173.90000000000146,11,2,11198.9,11025.0
17079,UEACEA3,13,-292985.21,4,9,440010.0,147024.78999999998
17080,UE76F55,13,40940.67999999999,7,6,15260.0,56200.67999999999
17081,UAA4BCB,13,135.26999999999998,11,2,1148.48,1283.75
17082,UCF973B,13,1746.0,11,2,10254.0,12000.0
17083,U33C43E,13,-18460.479999999996,9,4,19161.36,700.8800000000001
17084,U41486B,13,23.180000000000064,7,6,3198.9,3222.0800000000004
17085,UF3C18D,13,0.2100000000000648,7,6,2028.72,2028.93
17086,U0B7F61,13,2261.0300000000007,6,7,22333.339999999997,24594.37
17087,U5EA7C7,13,-5225.83,9,4,7855.96,2630.13
17088,U4356D4,13,-986.0,12,1,1486.0,500.0
17089,UD2FA2A,13,-13.120000000000008,10,3,214.07,200.95
17090,UA6D197,13,283.44,6,7,1246.47,1529.9099999999999
17091,UD7EB2C,13,1686.550000000003,10,3,48315.12,50001.67
17092,UF22C71,13,-8169.2,7,6,71261.66,63092.46000000001
17093,UC99CAA,13,1424.36,9,4,630.9999999999999,2055.36
17094,UBC5076,13,10773.49,11,2,1091.5,11864.99
17095,UF8B7B5,13,2795.3799999999997,11,2,28204.619999999995,31000.0
17096,U2CE74A,13,-3992.17,11,2,9224.42,5232.25
17097,U10B031,13,-1672.67,12,1,1735.99,63.32
17098,U012E18,13,6579.7699999999995,10,3,1172.36,7752.13
17099,UDC659D,13,-1243.8800000000003,7,6,12624.400000000001,11380.52
17100,U80F6B8,13,1862.4900000000052,7,6,131226.0,133088.49
17101,U49BEDF,13,-585.28,11,2,2835.48,2250.2
17102,U01CADC,13,17152.589999999997,7,6,58682.33,75834.92
17103,UC80172,13,-141.34,8,5,298.37,157.03
17104,UF0EEA3,13,-307.8000000000011,8,5,8332.1,8024.3
17105,UBFFC66,13,3726.529999999995,5,8,149061.83,152788.36000000002
17106,U389AE7,13,5230.74,5,8,3616.3999999999996,8847.14
17107,UCE4DD2,13,-1314.8899999999994,8,5,27441.660000000003,26126.770000000004
17108,U1F205D,13,-1392.7300000000002,9,4,19830.729999999996,18438.0
17109,U530112,13,-671.0,12,1,1391.0,720.0
17110,UF32A47,13,18436.51,6,7,12613.45,31049.96
17111,U8C9E9E,13,237.95999999999998,11,2,1838.0400000000002,2076.0
17112,U38DEC2,13,2103.91,10,3,20336.09,22440.0
17113,UDC660E,13,3800.8199999999993,5,8,6241.3099999999995,10042.13
17114,UC278DB,13,-5353.82,12,1,5549.82,196.0
17115,UA204CD,13,-825.0,7,6,12840.0,12015.0
17116,U4E80F6,13,-284.16,12,1,285.0,0.84
17117,U39420D,13,-738.3300000000002,11,2,1614.8700000000001,876.54
17118,U9F74D8,13,-285.74000000000024,10,3,10946.739999999998,10661.0
17119,UB1839E,13,12.039999999999992,7,6,786.3000000000001,798.3399999999999
17120,UEF95E9,13,13961.0,10,3,64335.0,78296.0
17121,UD78513,13,371.42000000000036,9,4,4091.67,4463.09
17122,UD67489,13,6084.57,11,2,8915.43,15000.0
17123,U84DCF8,13,-4381.95,11,2,8185.0,3803.05
17124,UFB26B2,13,-7944.98,12,1,8644.98,700.0
17125,UA36FF0,13,2635.0,11,2,6865.0,9500.0
17126,UE694A6,13,-7.590000000000003,9,4,218.60000000000002,211.01
17127,U4696E6,13,5187.500000000001,5,8,50513.72,55701.22
17128,UF165D5,13,-10519.52,11,2,10556.33,36.81
17129,U7A8AB6,13,0.029999999999886312,10,3,883.0799999999999,883.1099999999999
17130,U032F90,13,-2975.8,10,3,6327.8,3352.0
17131,U4C07C5,13,41454.18,3,10,16322.02,57776.2
17132,U1750DD,13,2332.26,6,7,6100.0,8432.26
17133,U1C1655,13,-10745.86,10,3,20749.0,10003.14
17134,U527913,13,-4787.860000000001,11,2,11679.02,6891.16
17135,U8BAC9A,13,219.7999999999989,11,2,10001.2,10221.0
17136,UACADE9,13,1.0,7,6,30999.0,31000.0
17137,U11A751,13,-94.0,8,5,8094.0,8000.0
17138,UC480FA,13,1248.33,8,5,3465.25,4713.58
17139,U6E3713,13,-1300.4100000000003,10,3,7900.410000000002,6600.0
17140,U616B52,13,-24533.959999999995,10,3,58284.659999999996,33750.7
17141,U36C3AC,13,5649.38,2,11,430.0,6079.38
17142,U133E17,13,-29.98999999999978,7,6,6070.99,6041.0
17143,U8243CF,13,160.04999999999995,8,5,2311.22,2471.27
17144,UEC00C6,13,-9208.96,11,2,35508.96,26300.0
17145,U35B550,13,1495.8800000000003,10,3,2.3,1498.18
17146,U03BAC7,13,-1417.3799999999999,11,2,1538.8999999999999,121.52
17147,U2737FD,13,-1.4210854715202004e-14,6,7,462.45000000000005,462.45
17148,U877491,13,-644.48,12,1,1063.77,419.29
17149,UE25B8D,13,0.0,11,2,16000.0,16000.0
17150,U4E397F,13,0.040000000000873115,6,7,28400.0,28400.04
17151,UD7BE01,13,-1833.58,10,3,2449.89,616.31
17152,U6A2437,13,0.01999999999999602,6,7,85.03999999999999,85.06
17153,U774EB8,13,6226.269999999999,8,5,18933.0,25159.270000000004
17154,U1EED5F,13,9908.23,7,6,26238.34,36146.57
17155,U14869D,13,444.0,9,4,6565.0,7009.0
17156,UB600DB,13,546.0599999999995,8,5,7813.6,8359.66
17157,UF9ECB9,13,-37518.69,12,1,38104.69,586.0
17158,U3BC29A,13,-110.0,11,2,9590.0,9480.0
17159,UC7CC94,13,-25.66000000000024,8,5,4940.2,4914.54
17160,UD301AA,13,1098.21,7,6,5071.960000000001,6170.169999999999
17161,UCA3F04,13,447.79999999999995,11,2,42.2,490.0
17162,U0052A2,13,120.09000000000043,5,8,4510.200000000001,4630.29
17163,U9F350C,13,4553.32,7,6,28714.75,33268.07
17164,U7FB949,13,436.89,5,8,1779.66,2216.55
17165,U2F44AF,13,-49.77000000000021,7,6,15023.839999999998,14974.07
17166,UB8095F,13,-4300.230000000003,7,6,53959.0,49658.77
17167,UBDA47C,13,-624.94,10,3,3968.9400000000005,3344.0
17168,U5390CD,13,-2529.71,9,4,7360.299999999999,4830.59
17169,U43F4C6,13,-35014.00000000001,10,3,36807.96000000001,1793.96
17170,U791675,13,-2470.4700000000003,7,6,7166.330000000001,4695.86
17171,UCBF284,13,16523.66,4,9,25255.0,41778.66
17172,U034230,13,805043.94,2,11,268800.0,1073843.94
17173,U9768EB,13,714.12,7,6,771.0,1485.12
17174,U0915D0,13,7.440000000002328,7,6,433000.0,433007.44
17175,U0FF926,13,-17288.57,7,6,31555.46,14266.89
17176,U7736DD,13,-2181.0,11,2,3981.0,1800.0
17177,U487F1F,13,1667.3699999999976,6,7,33432.0,35099.369999999995
17178,U7C5927,13,291.84000000000015,11,2,2308.1,2599.94
17179,U8C31C8,13,7003.26,4,9,7945.82,14949.08
17180,UF8FE24,13,193.78999999999996,10,3,512.3299999999999,706.1199999999999
17181,UCBBE25,13,-2816.2800000000025,9,4,21078.979999999996,18262.7
17182,U1AFB5F,13,337.81999999999994,10,3,2426.7799999999997,2764.6
17183,U1D6AA3,13,-436.6400000000003,11,2,2263.5,1826.86
17184,UFD5C74,13,2039.9,10,3,2484.86,4524.76
17185,U8A2A16,13,1026.0,6,7,5971.0,6997.0
17186,U76DDA3,13,-305.3199999999997,11,2,6905.32,6600.0
17187,UFB82DB,13,4633.030000000001,2,11,6.0,4639.030000000001
17188,U0826E6,13,-8635.34,7,6,13671.0,5035.66
17189,U50094C,13,-2811.39,8,5,6598.8,3787.4100000000003
17190,UF7DFB1,13,-1602.6599999999999,7,6,15527.9,13925.24
17191,U3E635B,13,-10881.0,12,1,20881.0,10000.0
17192,UA0BFB2,13,19.62999999999988,8,5,1580.1,1599.73
17193,U002C86,13,28.960000000000036,8,5,13939.32,13968.28
17194,UB0AD7C,13,1.3700000000001182,9,4,2426.3199999999997,2427.69
17195,UCFDEA2,13,-0.5400000000000205,11,2,1595.6,1595.06
17196,U3224DF,13,87.02,7,6,6288.0,6375.02
17197,U2E930A,13,9776.590000000002,11,2,6106.85,15883.44
17198,U93C014,13,-18988.359999999997,11,2,21187.88,2199.52
17199,UD9DFCD,13,849.0,8,5,10096.0,10945.0
17200,U4312A9,13,6690.97,6,7,845.9,7536.87
17201,UD698AC,13,832.5400000000002,8,5,1370.6799999999998,2203.2200000000003
17202,UB35153,13,20293.26,8,5,32206.74,52500.0
17203,U2CDA16,13,3537.7199999999993,10,3,7820.279999999999,11358.0
17204,U808ADF,13,-5901.619999999999,12,1,5951.619999999999,50.0
17205,U21031B,13,-1196.4899999999998,7,6,7685.0,6488.51
17206,UE2DBC2,13,482.27,8,5,4033.14,4515.41
17207,U46E708,13,-3792.74,9,4,10262.859999999999,6470.12
17208,UBE1911,13,336.5499999999993,7,6,35033.0,35369.55
17209,UB49649,13,-45.38000000000011,9,4,17903.659999999996,17858.28
17210,U68A132,13,1926.5,7,6,1765.77,3692.2699999999995
17211,UDA3892,13,14859.68,5,8,11348.57,26208.25
17212,UDEFDB0,13,-494.5300000000011,8,5,12431.32,11936.789999999999
17213,U092A01,13,1177.6800000000003,8,5,480.03000000000003,1657.71
17214,U982AC0,13,39.849999999998545,7,6,30171.5,30211.35
17215,UC56632,13,-190.5,11,2,5213.5,5023.0
17216,U4D0A07,13,49.18000000000029,10,3,5422.82,5472.0
17217,U3D93D4,13,-108.94,11,2,159.0,50.06
17218,UEE2B99,13,-7085.99,6,7,21456.0,14370.01
17219,UE71431,13,13399.529999999999,3,10,25092.260000000002,38491.79
17220,U9C78A5,13,-1668.3000000000002,10,3,5218.45,3550.15
17221,UAA863C,13,-11.300000000000068,11,2,940.2799999999999,928.98
17222,U6F7285,13,3004.85,3,10,3038.0,6042.85
17223,U87425A,13,2521.43,5,8,4851.67,7373.1
17224,UA1B997,13,-191.39999999999964,9,4,19559.870000000003,19368.47
17225,UC0F307,13,-3688.3800000000006,10,3,14988.380000000001,11300.0
17226,UF2C6E1,13,88.0,8,5,1232.0,1320.0
17227,U951142,13,-8918.73000000001,5,8,170036.0,161117.27
17228,UDCDCD8,13,2253.4,6,7,4557.300000000001,6810.7
17229,U76CEAB,13,-1525.0200000000002,8,5,13376.02,11851.0
17230,U6A3228,13,770.57,10,3,630.31,1400.88
17231,UD215FC,13,-1868.2099999999998,12,1,1868.2199999999998,0.01
17232,U86A929,13,-91.0,10,3,398.0,307.0
17233,UA8E71E,13,-275.69000000000005,11,2,735.6899999999999,460.0
17234,UD5BF00,13,2222.1499999999996,7,6,3183.0,5405.15
17235,UC82FB8,13,-6242.05,9,4,13842.2,7600.15
17236,UAFC77E,13,731.24,8,5,17967.76,18699.0
17237,U84292E,13,-2267.6000000000004,10,3,4467.6,2200.0
17238,U3FA17A,13,6284.94,5,8,253.26000000000002,6538.2
17239,UA07E2E,13,19.30000000000109,6,7,19764.02,19783.32
17240,U679C7E,13,-3852.0,9,4,17026.86,13174.86
17241,UF24781,13,-20056.7,11,2,32391.7,12335.0
17242,U079E61,13,-1649.1,12,1,1660.1,11.0
17243,U415B39,13,1234.4000000000015,8,5,27544.600000000002,28779.0
17244,UF4B097,13,27.00999999999999,11,2,1110.09,1137.1
17245,U232707,13,941.88,10,3,1724.7399999999998,2666.62
17246,UE2DB27,13,7680.0,5,8,520.0,8200.0
17247,UE95A7A,13,-152.88,10,3,366.72999999999996,213.85
17248,U47ACA0,13,-197.16000000000003,11,2,388.63000000000005,191.47000000000003
17249,U152AC0,13,-3627.98,10,3,4218.59,590.61
17250,U8A4698,13,-15260.3,8,5,17910.3,2650.0
17251,U14C1FE,13,710.4,11,2,1853.3300000000002,2563.73
17252,UC7F6B4,13,-2.1827852025868566e-13,8,5,2638.0400000000004,2638.040000000001
17253,U3C8516,13,-171.98,9,4,6452.34,6280.360000000001
17254,U996BDE,13,-5.0,7,6,20005.0,20000.0
17255,U241C24,13,9.549652735252323e-14,8,5,4255.860000000001,4255.860000000001
17256,U0088ED,13,91571.65999999999,7,6,331507.5,423079.16
17257,U08EE7E,13,165.0,11,2,3910.5,4075.5
17258,U06D4F2,13,25363.599999999944,5,8,485710.94,511074.5399999999
17259,U263998,13,-11708.0,7,6,36194.0,24486.0
17260,UFE409E,13,5051.4,10,3,2423.94,7475.34
17261,UC6A956,13,-5734.750000000002,10,3,12171.560000000001,6436.81
17262,UA704C4,13,-1653.2199999999996,6,7,25897.0,24243.78
17263,U7A873E,13,-837.3699999999997,7,6,53239.969999999994,52402.6
17264,UB7FDAE,13,-2858.0,10,3,5748.0,2890.0
17265,U9DE08F,13,0.0,11,2,29357.0,29357.0
17266,U57E7F8,13,-10000.0,8,5,63858.0,53858.0
17267,UE7220E,13,-3447.06,10,3,3764.9900000000002,317.93
17268,UD6ECC5,13,-613.75,7,6,2996.9399999999996,2383.19
17269,UB2EA92,13,6422.47,7,6,8097.55,14520.02
17270,U93F9D6,13,-137.73000000000008,10,3,3138.0,3000.27
17271,U9FF79F,13,6224.0,11,2,10561.0,16785.0
17272,U90357A,13,170.46999999999994,10,3,4240.1,4410.57
17273,U4836A5,13,-534.4100000000001,12,1,1085.21,550.8
17274,UF3DAA9,13,-3708.65,11,2,9760.0,6051.35
17275,UF6252A,13,-1684.5700000000002,12,1,1792.7399999999998,108.17
17276,UACE792,13,-1111.85,11,2,1609.2499999999998,497.4
17277,UD98920,13,12704.04,6,7,9910.0,22614.04
17278,UE164FB,13,-16589.02,11,2,45317.020000000004,28728.0
17279,UA3900B,13,-162.03999999999985,9,4,1451.04,1289.0
17280,U7D4D1F,13,7.999999999999981,11,2,174.10999999999999,182.11
17281,U9234A4,12,-278.1199999999999,9,3,4501.46,4223.34
17282,U2A16EC,12,-33649.0,7,5,68349.0,34700.0
17283,U2F098D,12,-222.63,8,4,2778.4399999999996,2555.8100000000004
17284,U7F98D8,12,530.0,7,5,5533.0,6063.0
17285,UD3C518,12,5963.0,5,7,43133.0,49096.0
17286,U9687D0,12,-132.39999999999998,10,2,215.25,82.85
17287,U0BBACC,12,1895.1399999999999,7,5,5338.879999999999,7234.0199999999995
17288,U194B12,12,-4886.21,12,0,4886.21,0.0
17289,UB9C771,12,-317.0000000000002,9,3,3736.2000000000003,3419.2
17290,U808AAA,12,787.8399999999992,8,4,45441.46000000001,46229.299999999996
17291,U734DCA,12,-88.73000000000002,9,3,918.92,830.19
17292,U6C372E,12,-9.094947017729282e-13,9,3,3931.9300000000007,3931.93
17293,U4966EB,12,-528.5,8,4,39028.5,38500.0
17294,UE75A54,12,-4132.119999999999,9,3,33132.14,29000.02
17295,U06D8B7,12,570.9700000000003,8,4,6501.110000000001,7072.08
17296,U2B4088,12,-1952.69,9,3,5476.68,3523.9900000000002
17297,UE4DE63,12,-239915.06,8,4,240840.0,924.9399999999999
17298,U130B5B,12,274917.24,10,2,9704.43,284621.67
17299,UEDD6B7,12,-2728.1600000000008,12,0,2728.1600000000008,0.0
17300,UFD5CDB,12,29098.590000000007,8,4,8201.41,37300.0
17301,UF7AECC,12,-4387.4,12,0,4387.4,0.0
17302,U933FD2,12,-2560.2999999999997,8,4,7530.099999999999,4969.8
17303,U796DC6,12,3983.0,10,2,16347.98,20330.98
17304,UF1FC59,12,-2222.2000000000003,10,2,30522.199999999997,28300.0
17305,UCD8323,12,-1207.4899999999998,7,5,17100.0,15892.51
17306,U5A1C62,12,199.52999999999997,8,4,4353.38,4552.91
17307,U4B9294,12,-209.53,11,1,210.3,0.77
17308,U7ACF72,12,-554.2499999999999,7,5,3149.09,2594.84
17309,U6C9D02,12,47.12000000000011,6,6,1396.71,1443.83
17310,UF6749A,12,-6818.759999999999,9,3,20390.96,13572.2
17311,U0583AD,12,-2009.0,8,4,7883.0,5874.0
17312,U99AF15,12,13693.84,6,6,25461.98,39155.82
17313,UEC40AB,12,1950.5600000000002,9,3,1084.69,3035.2500000000005
17314,UD28403,12,0.0,6,6,16000.0,16000.0
17315,UF820F0,12,-5428.06,8,4,12508.27,7080.21
17316,U00F176,12,-11855.0,9,3,34664.0,22809.0
17317,U6E50F0,12,-29.0,6,6,9029.0,9000.0
17318,UDE7D00,12,-6228.799999999999,10,2,20228.8,14000.0
17319,UC88AE2,12,-0.20000000000140972,7,5,25000.0,24999.8
17320,UC2B652,12,-300.01,10,2,1472.0100000000002,1172.0
17321,U223F97,12,9184.24,7,5,27228.29,36412.53
17322,U4E994B,12,8225.619999999999,5,7,16787.0,25012.62
17323,U7EF115,12,1558.8000000000002,5,7,566.1999999999999,2125.0
17324,U7F0216,12,36.75,9,3,7184.0,7220.75
17325,UFBF92F,12,-12832.320000000002,9,3,71204.62,58372.3
17326,UBA6099,12,-8402.0,12,0,8402.0,0.0
17327,U513EEE,12,-1151.8400000000001,7,5,14361.84,13210.0
17328,U4F4199,12,0.0,6,6,12000.0,12000.0
17329,UEB4D62,12,-85.21000000000006,8,4,3070.92,2985.71
17330,UF89418,12,-8547.140000000001,8,4,13645.02,5097.88
17331,U08EEEE,12,-52.039999999999964,7,5,2292.96,2240.92
17332,U9FD319,12,-1367.15,11,1,4268.8,2901.65
17333,U71BF4D,12,-2800.72,12,0,2800.72,0.0
17334,UC8843D,12,-678.9900000000007,9,3,34466.19,33787.2
17335,U4ABFF0,12,-551.99,11,1,561.99,10.0
17336,U91F2F3,12,-2119.1399999999994,8,4,8133.0,6013.86
17337,UD004F3,12,18028.34,6,6,26812.06,44840.4
17338,U249304,12,60.39,9,3,338.61,399.0
17339,U720BF7,12,-1073.0,8,4,31073.0,30000.0
17340,U003BBF,12,-4789.78,12,0,4789.78,0.0
17341,UD789E8,12,3520.5899999999997,8,4,139.57,3660.16
17342,U5D5B1E,12,-518.0,9,3,19874.0,19356.0
17343,U377087,12,9992.080000000002,9,3,46491.57,56483.65
17344,U2E4025,12,-4517.87,10,2,7080.0,2562.13
17345,U5AAF3B,12,-1.8189894035458565e-12,9,3,18023.5,18023.5
17346,UFC02FC,12,15118.080000000002,10,2,20325.95,35444.03
17347,U7C6481,12,-5.684341886080802e-14,10,2,916.4000000000001,916.4
17348,UDE703C,12,3492.76,6,6,4587.5,8080.26
17349,U1D521B,12,9234.0,9,3,6782.0,16016.0
17350,U8D1E62,12,-5321.720000000034,5,7,513758.13,508436.41
17351,UB958ED,12,637.7199999999998,7,5,2564.2799999999997,3202.0
17352,UEF4FD2,12,65.40999999999997,8,4,762.59,828.0
17353,UFE254F,12,77.0,9,3,10923.0,11000.0
17354,U25671A,12,6427.0,4,8,4047.0,10474.0
17355,UDF0B2A,12,-2329.8900000000003,8,4,5670.04,3340.15
17356,U6A7167,12,-1339.8700000000001,12,0,1339.8700000000001,0.0
17357,UCA6C1D,12,162.44999999999993,10,2,1240.45,1402.9
17358,U91DEFF,12,1041.0,6,6,5050.0,6091.0
17359,U5AE74B,12,380.0,7,5,16730.0,17110.0
17360,U99DBA4,12,-943.0,10,2,3725.0,2782.0
17361,U21F105,12,-6097.98,10,2,13300.98,7203.0
17362,UAAAF8E,12,79.60000000000036,9,3,6103.11,6182.71
17363,U2D65AA,12,-1193.9399999999996,9,3,8567.939999999999,7374.0
17364,U482E13,12,-809.3199999999997,8,4,9108.33,8299.01
17365,U031075,12,-27910.86,4,8,35527.94,7617.08
17366,U26DBDC,12,-7511.0,11,1,19011.0,11500.0
17367,U1A0B3B,12,0.0,6,6,13631.7,13631.7
17368,U9CD7A7,12,-2438.7,10,2,3820.6000000000004,1381.9
17369,UF69523,12,-2696.9399999999996,12,0,2696.9399999999996,0.0
17370,UB05278,12,79800.0,9,3,568.0,80368.0
17371,UDD927E,12,-4069.4800000000005,12,0,4069.4800000000005,0.0
17372,UEB656B,12,-148.38999999999987,8,4,1752.4,1604.01
17373,UF247DE,12,265.04999999999995,9,3,440.85,705.9
17374,UED3316,12,0.0,8,4,4760.339999999999,4760.34
17375,UA8D791,12,62.0,10,2,673.0,735.0
17376,U600A0E,12,7173.759999999999,5,7,3831.63,11005.390000000001
17377,U602F43,12,2760.8999999999996,7,5,3524.4,6285.3
17378,U5F500E,12,-4184.21,8,4,5599.67,1415.46
17379,U063C35,12,642.6399999999994,5,7,29206.13,29848.769999999997
17380,UFFA1D8,12,84632.47,8,4,13164.64,97797.11
17381,U968153,12,-1748.51,12,0,1748.51,0.0
17382,UDB3D89,12,-197.50000000000048,10,2,4664.299999999999,4466.8
17383,U335766,12,616.6599999999999,8,4,21159.34,21776.0
17384,U6F76A4,12,-8778.02,9,3,19262.22,10484.2
17385,U665736,12,-5911.67,8,4,8515.46,2603.79
17386,U290793,12,13881.8,7,5,7286.61,21168.41
17387,UC1B89B,12,-1942.8900000000003,9,3,11710.32,9767.43
17388,U4F4638,12,-4962.040000000001,8,4,30871.0,25908.96
17389,UC6A840,12,281.74000000000524,5,7,107500.0,107781.74
17390,UB5A054,12,-6000.0,10,2,17384.760000000002,11384.76
17391,UF941CD,12,5863.219999999999,8,4,1336.78,7200.0
17392,UB0C333,12,1129.98,11,1,1534.38,2664.36
17393,U6849F9,12,945.02,9,3,1427.3300000000002,2372.35
17394,U229E1E,12,-1991.5499999999997,6,6,6031.0,4039.4500000000003
17395,U5565C8,12,6457.259999999999,7,5,1717.34,8174.6
17396,U986319,12,-3424.99,9,3,9689.99,6265.0
17397,U07CE76,12,-2004.989999999998,5,7,88000.0,85995.01000000001
17398,U4AD2F1,12,10243.82,4,8,3214.6,13458.42
17399,UF767D1,12,9702.2,3,9,302.0,10004.2
17400,U4A57BC,12,1499.0,5,7,664.6899999999999,2163.69
17401,UC0665A,12,-75.44,8,4,130.55,55.11
17402,UADCD25,12,-275.14999999999947,11,1,8975.15,8700.0
17403,UDB9C29,12,307.0,6,6,18424.0,18731.0
17404,UFAFCB5,12,-3962.0,12,0,3962.0,0.0
17405,U1BB79A,12,-3681.17,10,2,12327.34,8646.17
17406,U8C8D38,12,-10.0,7,5,12010.0,12000.0
17407,UDA99AC,12,-2492.2200000000003,11,1,4785.360000000001,2293.14
17408,U571329,12,1230.02,9,3,553.87,1783.89
17409,U78CDE6,12,-1.0,9,3,17101.0,17100.0
17410,U91BE59,12,111222.29999999999,6,6,445.64000000000004,111667.93999999999
17411,U083707,12,1000.0000000000001,9,3,2468.9400000000005,3468.94
17412,UE02721,12,14815.81,7,5,3390.8,18206.61
17413,U30B27D,12,833.49,10,2,891.27,1724.76
17414,U0F85CF,12,-6762.12,6,6,13188.29,6426.17
17415,UE8D0A1,12,837.58,9,3,587.97,1425.55
17416,U570B19,12,-1564.2800000000007,7,5,53933.9,52369.62
17417,U003FA7,12,366.38000000000005,8,4,693.6600000000001,1060.04
17418,U8EFD1F,12,-1.09999999999809,6,6,20096.269999999997,20095.17
17419,U79EC02,12,1.3073986337985843e-12,8,4,47761.56,47761.56
17420,U2B29E0,12,-20.00000000000029,5,7,17110.23,17090.23
17421,UE0265E,12,3968.63,8,4,953.32,4921.95
17422,UF49BCC,12,5.0,8,4,22527.2,22532.2
17423,UFE2917,12,6918.27,6,6,6846.0,13764.27
17424,U369616,12,14708.32,10,2,700.58,15408.9
17425,U62A2E4,12,248.48999999999978,9,3,8951.51,9200.0
17426,UEFAD24,12,3040.7799999999993,8,4,12561.53,15602.31
17427,U9D91B4,12,-3105.2400000000007,10,2,6615.240000000001,3510.0
17428,UDD45A2,12,10046.939999999999,10,2,13280.279999999999,23327.219999999998
17429,U9430E8,12,-41.90000000000009,8,4,7040.9,6999.0
17430,UB939E3,12,-5285.16,10,2,15485.160000000002,10200.0
17431,U4CAD60,12,138.0,9,3,455.5,593.5
17432,UA29D19,12,-1133.04,12,0,1133.04,0.0
17433,UCEC6D5,12,41.8000000000001,10,2,1134.4,1176.2
17434,U1EFAD7,12,-0.900000000000091,6,6,5579.9,5579.0
17435,U51F2F1,12,-8213.940000000002,8,4,34459.0,26245.059999999998
17436,U8FDF21,12,-30003.0,9,3,30773.94,770.94
17437,U744DEA,12,-371.88,10,2,1246.8799999999999,875.0
17438,U3233F9,12,-201.25,8,4,5802.9,5601.65
17439,U9A3DAE,12,10486.92,1,11,9000.0,19486.920000000002
17440,UD64298,12,2651.0,8,4,47959.0,50610.0
17441,U733543,12,-1757.44,8,4,3809.4400000000005,2052.0
17442,U2394EC,12,154.72999999999993,9,3,2528.0799999999995,2682.81
17443,UF54723,12,-1591.0,9,3,5167.0,3576.0
17444,UE3ED7F,12,-4122.920000000001,11,1,6322.66,2199.74
17445,UB8867C,12,691.0099999999998,6,6,2602.71,3293.7200000000003
17446,U1A2111,12,3350.02,4,8,10960.0,14310.02
17447,UA15396,12,481.00999999999993,8,4,4126.4800000000005,4607.49
17448,UB170BF,12,1072.4900000000002,4,8,2675.2,3747.69
17449,U0B9D58,12,4113.709999999999,5,7,7312.52,11426.23
17450,U603823,12,-2951.1000000000004,12,0,2951.1000000000004,0.0
17451,U84BB94,12,-2872.7400000000007,11,1,4902.740000000001,2030.0
17452,UA08C3D,12,-185.19999999999993,8,4,1830.05,1644.85
17453,UA62BA1,12,-185.0,7,5,15185.0,15000.0
17454,UC177EB,12,6071.380000000001,9,3,12997.64,19069.02
17455,UE99535,12,-1564.0,10,2,3072.0,1508.0
17456,U068150,12,4408.59,8,4,10600.0,15008.59
17457,U7AE57C,12,20204.119999999995,6,6,383600.0,403804.12
17458,UDE3358,12,-230.0,6,6,9850.0,9620.0
17459,U521446,12,-5088.869999999999,11,1,14131.869999999999,9043.0
17460,UC4C87A,12,-6133.380000000001,12,0,6133.380000000001,0.0
17461,U163480,12,4951.680000000002,10,2,14809.02,19760.7
17462,UAC252E,12,-1846.9999999999998,9,3,5701.0,3854.0
17463,U142F51,12,-33000.0,9,3,64000.0,31000.0
17464,U226A09,12,1025.6,9,3,1540.0,2565.6
17465,U00DD4A,12,-6072.32,10,2,13328.779999999999,7256.46
17466,UF75358,12,0.0,8,4,24960.0,24960.0
17467,U853D6C,12,-7424.960000000001,9,3,14449.060000000001,7024.1
17468,U02F111,12,-1604.9699999999996,9,3,7828.700000000001,6223.7300000000005
17469,U28BFFE,12,13780.439999999999,7,5,52736.63,66517.07
17470,U2D1CBF,12,1977.0100000000002,8,4,20323.0,22300.010000000002
17471,UE83CB5,12,-27.879999999999907,9,3,2484.88,2457.0
17472,UE9AA64,12,8.810729923425242e-13,6,6,8937.010000000002,8937.01
17473,UCB6318,12,211.27,9,3,542.5400000000001,753.81
17474,U10BA0E,12,-26.93,6,6,610077.0,610050.07
17475,UEFEF76,12,2399.92,6,6,2220.08,4620.0
17476,UBB08F5,12,-27349.47,10,2,41888.5,14539.03
17477,U014C29,12,2990.0600000000004,5,7,10371.609999999999,13361.669999999998
17478,U08C0DD,12,-2870.03,10,2,5843.48,2973.45
17479,U35DA95,12,-1006.0900000000013,8,4,11848.42,10842.33
17480,U6AA2BF,12,-2014.7999999999993,10,2,8514.8,6500.0
17481,U62DEC8,12,-2058.76,12,0,2058.76,0.0
17482,UB9F95A,12,-5398.12,12,0,5398.12,0.0
17483,U4029BC,12,-4803.959999999999,8,4,19458.98,14655.02
17484,U2EB720,12,-20000.0,11,1,40000.0,20000.0
17485,U17CCF8,12,-7140.13,11,1,7140.16,0.03
17486,U740F14,12,-2680.98,8,4,10836.5,8155.52
17487,UE72DBC,12,-2.1900000000005093,6,6,16476.0,16473.809999999998
17488,UDE2E5C,12,-3000.0,8,4,6010.0,3010.0
17489,U8962DF,12,0.0,6,6,600.0,600.0
17490,UFA1914,12,0.0,6,6,205000.0,205000.0
17491,UC57346,12,-17515.58,9,3,29955.56,12439.98
17492,U216DA9,12,1.2789769243681803e-13,9,3,3871.22,3871.22
17493,UA7E2B8,12,165.0,4,8,15520.0,15685.0
17494,U0E8679,12,-5638.0,9,3,14085.099999999999,8447.1
17495,UE7ADAE,12,-1413.6000000000001,10,2,2357.7,944.1
17496,UFAC705,12,439.78999999999996,9,3,1049.06,1488.85
17497,UE76C4E,12,15750.470000000001,9,3,8586.68,24337.15
17498,UBB08E0,12,-1553.53,7,5,8073.97,6520.4400000000005
17499,U9EC002,12,467.4099999999999,10,2,501.69,969.0999999999999
17500,UAC1EC8,12,6.329999999999927,9,3,7197.0,7203.33
17501,U99D903,12,-8832.68,12,0,8832.68,0.0
17502,U94FE30,12,7449.86,6,6,21253.72,28703.58
17503,UEE2922,12,0.0,7,5,197.0,197.0
17504,UEDF46F,12,-22826.769999999997,7,5,42763.18,19936.41
17505,U2EDC5A,12,103967.0,7,5,41285.0,145252.0
17506,UF4EA4D,12,-1639.1599999999999,8,4,22716.86,21077.7
17507,UA6B348,12,82.98000000000002,9,3,190.17000000000002,273.15000000000003
17508,U33539B,12,0.0,6,6,1100.0,1100.0
17509,UDA2A9B,12,941.1000000000004,5,7,18587.0,19528.1
17510,U10B1DE,12,30050.379999999997,5,7,5555.62,35606.0
17511,UE9AD45,12,1215.0500000000004,9,3,8617.82,9832.87
17512,U9269E5,12,71894.0,5,7,109467.72,181361.72
17513,U038650,12,-77.00000000000088,9,3,6626.500000000001,6549.5
17514,U45AF49,12,18480.17,4,8,18458.32,36938.490000000005
17515,UDB9509,12,202.4000000000001,10,2,1901.6,2104.0
17516,U893F58,12,-91647.29000000027,2,10,2900000.0,2808352.71
17517,UCBCEE4,12,-1761.28,7,5,5521.0199999999995,3759.74
17518,U75B00A,12,-1019.8100000000001,9,3,1526.21,506.4
17519,UEE51CC,12,-124.12,7,5,904.39,780.27
17520,U25E9F6,12,0.989999999999938,10,2,1177.51,1178.5
17521,U02EB09,12,10.17,6,6,1860.17,1870.3400000000001
17522,UF4EE83,12,-15490.05,11,1,15500.0,9.95
17523,UD963A7,12,1581.279999999999,8,4,14018.720000000001,15600.0
17524,U5B87B5,12,1006.2699999999982,8,4,9648.900000000001,10655.169999999998
17525,U67081A,12,1333.38,8,4,1022.62,2356.0
17526,UC18075,12,-6905.860000000001,12,0,6905.860000000001,0.0
17527,U142493,12,-2591.5,9,3,5565.0,2973.5
17528,UC848CF,12,-1378.1200000000001,12,0,1378.1200000000001,0.0
17529,UCBFE4C,12,-23325.73,10,2,59850.0,36524.270000000004
17530,UC66F71,12,0.2300000000000182,9,3,627.29,627.52
17531,U63D2C8,12,5640.57,7,5,14472.04,20112.61
17532,UDFF0DE,12,5950.0,9,3,2323.7,8273.7
17533,UCF8B7C,12,1294.02,9,3,4091.749999999999,5385.77
17534,U952BF3,12,-1000.0,7,5,6358.5599999999995,5358.5599999999995
17535,U65C589,12,-13075.300000000001,10,2,13395.300000000001,320.0
17536,U521E72,12,6195.000000000001,10,2,4810.86,11005.86
17537,U1FD9BE,12,3764.0,7,5,12466.0,16230.0
17538,U625D06,12,0.0,8,4,17208.1,17208.1
17539,U95F903,12,-16757.280000000002,9,3,17057.3,300.02
17540,U136009,12,-1778.6000000000001,12,0,1778.6000000000001,0.0
17541,UEBD318,12,12295.0,7,5,105.0,12400.0
17542,UD09530,12,-45712.7,12,0,45712.7,0.0
17543,U0930A7,12,-2001.2199999999996,9,3,6201.219999999999,4200.0
17544,UA371C1,12,38.0,7,5,846.31,884.31
17545,UE03266,12,-135.08000000000013,8,4,2735.31,2600.23
17546,U14674C,12,-39.9499999999999,7,5,5469.719999999999,5429.7699999999995
17547,UAAEC28,12,-7322.26,10,2,8205.7,883.44
17548,U968A6C,12,-263.13999999999993,11,1,970.88,707.74
17549,U3DD248,12,1074.52,8,4,1516.22,2590.74
17550,U4D81B6,12,15492.340000000002,8,4,3775.7999999999997,19268.14
17551,U13DF3D,12,1095.85,7,5,10309.7,11405.55
17552,UFB7657,12,-5.684341886080802e-14,8,4,993.82,993.8199999999999
17553,UEB6159,12,11401.890000000001,4,8,18232.870000000003,29634.760000000002
17554,U5E406B,12,32542.66,6,6,11763.34,44306.0
17555,U72D38B,12,995.0699999999999,6,6,1904.9499999999996,2900.02
17556,UB995DA,12,-1023.06,9,3,1152.87,129.81
17557,U34EEE1,12,-9428.900000000001,11,1,13738.900000000001,4310.0
17558,U5CB729,12,-1018.3000000000002,6,6,11825.0,10806.7
17559,UF4E672,12,12560.0,11,1,9100.0,21660.0
17560,UAF7E13,12,0.0,9,3,165000.0,165000.0
17561,U38A95D,12,-948.8999999999996,8,4,5773.3,4824.400000000001
17562,U48C72F,12,-1222.71,10,2,2076.0,853.29
17563,U600F33,12,1017.0499999999998,8,4,1842.95,2860.0
17564,U9A7858,12,-1733.1499999999999,9,3,2241.1400000000003,507.99
17565,U205127,12,3150.4,5,7,538.6500000000001,3689.0499999999997
17566,U0F9E89,12,-196.0,10,2,222.01,26.01
17567,U1D6F3D,12,31408.479999999996,7,5,23953.440000000002,55361.92
17568,UDE9E14,12,517.0,10,2,33.0,550.0
17569,UD8CF83,12,-296.0,6,6,10296.0,10000.0
17570,U417C02,12,-1000.0000000000002,10,2,2684.7,1684.6999999999998
17571,UD63DAC,12,155271.0,0,12,0.0,155271.0
17572,U96056A,12,-20155.0,11,1,28250.0,8095.0
17573,UBBD456,12,-16664.200000000004,7,5,66400.01000000001,49735.81
17574,U4CEBE6,12,-82.13999999999986,6,6,32176.88,32094.74
17575,UFF2C3C,12,1362.9199999999998,7,5,21978.09,23341.01
17576,U8C746F,12,-9.094947017729282e-13,7,5,23681.29,23681.29
17577,U083B4D,12,-2583.830000000001,9,3,12870.16,10286.33
17578,U976445,12,-8789.0,10,2,25286.0,16497.0
17579,UF78142,12,85.0,10,2,185.0,270.0
17580,U737071,12,359.1100000000001,8,4,3508.7799999999997,3867.89
17581,U95373E,12,119.98000000000019,10,2,1398.1999999999998,1518.18
17582,U79CC17,12,-8543.540000000003,10,2,25586.280000000002,17042.74
17583,UC97FFE,12,-75455.82,10,2,76416.54,960.7199999999999
17584,UF73023,12,-382.24,10,2,1025.24,643.0
17585,U4BE559,12,1400.06,7,5,3582.09,4982.150000000001
17586,UB9975A,12,384.28000000000014,5,7,5692.85,6077.130000000001
17587,UF91676,12,-4057.7399999999993,8,4,21358.7,17300.96
17588,U3DE12E,12,-974.8200000000002,10,2,2774.82,1800.0
17589,UE04745,12,-10169.99,8,4,16374.26,6204.27
17590,U31D019,12,9445.890000000001,7,5,1875.4,11321.29
17591,U3D1598,12,-1352.7200000000003,9,3,2952.7200000000003,1600.0
17592,U87FC17,12,184.7,11,1,265.3,450.0
17593,U1BE312,12,-250.1899999999971,8,4,32230.43,31980.239999999998
17594,U8B0328,12,-7035.360000000002,9,3,33297.36,26262.0
17595,U664E94,12,1981.3700000000008,6,6,39601.0,41582.37
17596,UB4C1EA,12,-1739.6299999999992,9,3,13944.63,12205.0
17597,UF33344,12,0.0,9,3,43000.0,43000.0
17598,U9EF801,12,4966.66,8,4,17142.66,22109.32
17599,U5D93EF,12,32943.88,5,7,9542.119999999999,42486.0
17600,U50C218,12,1585.8999999999999,8,4,3092.02,4677.92
17601,U19E3FD,12,-334.5,11,1,345.0,10.5
17602,U5BF49A,12,5971.0,7,5,12200.0,18171.0
17603,U049949,12,-324.99999999998545,9,3,97459.02,97134.02
17604,UC5116F,12,4033.2599999999966,5,7,72583.34,76616.59999999999
17605,U305ED5,12,17257.02,7,5,11485.34,28742.36
17606,UAAD5BF,12,-2227.3399999999983,8,4,43729.06,41501.72
17607,U5C38B5,12,168.8800000000001,6,6,1380.1799999999998,1549.06
17608,UED630F,12,3284.3,8,4,6910.0,10194.3
17609,UE012A8,12,-1000.0299999999997,7,5,22800.03,21800.0
17610,UF21E97,12,-15.94999999999995,7,5,3743.88,3727.93
17611,UFC918D,12,96.65999999999985,7,5,9349.34,9446.0
17612,UCC1163,12,3371.7199999999993,8,4,3228.2799999999997,6600.0
17613,U498309,12,-2990.69,12,0,2990.69,0.0
17614,U9EB43C,12,-4964.66,10,2,6314.66,1350.0
17615,UE8C7CA,12,-80.94999999999987,5,7,15196.69,15115.74
17616,UD5E295,12,-7100.719999999999,10,2,8337.72,1237.0
17617,UD9A3AF,12,1073.5900000000006,10,2,19143.0,20216.59
17618,UA81885,12,-728.99,9,3,4876.0,4147.01
17619,U249C74,12,298.3699999999999,7,5,2031.63,2330.0
17620,UF3E220,12,-12.070000000000334,8,4,4108.0,4095.93
17621,U975628,12,-696.0,9,3,1226.01,530.01
17622,U3D2DA5,12,2666.1,10,2,1367.61,4033.71
17623,UE4CA87,12,-322.1600000000001,10,2,1155.16,833.0
17624,U1B8826,12,-33.61999999999995,10,2,993.62,960.0
17625,U2525D0,12,-2978.3399999999997,10,2,6941.95,3963.61
17626,U7A26CB,12,-116.19999999999993,10,2,2365.64,2249.44
17627,UFE968F,12,987.1699999999997,11,1,9012.83,10000.0
17628,U1F5C41,12,-469.8499999999999,8,4,1261.0299999999997,791.1800000000001
17629,U8672C2,12,-569.8899999999999,10,2,2129.0800000000004,1559.19
17630,UA284F3,12,68.35999999999967,8,4,5493.64,5562.0
17631,U1E382A,12,-1680.12,9,3,4238.12,2558.0
17632,UA8C36D,12,1.4210854715202004e-14,6,6,292.95,292.95
17633,U627967,12,112479.09000000001,4,8,388001.0,500480.09
17634,U802ED4,12,-181.53999999999996,10,2,6345.070000000001,6163.530000000001
17635,UBEC6BC,12,-5573.33,5,7,11146.84,5573.51
17636,U3B98D2,12,-292.15,9,3,2133.03,1840.88
17637,U9278B7,12,5815.5,11,1,4438.4,10253.9
17638,UFBC4FB,12,2403.34,7,5,2025.66,4429.0
17639,U612774,12,-13081.310000000001,5,7,26400.0,13318.689999999999
17640,U778DC0,12,0.00999999999985457,6,6,5022.0,5022.01
17641,U294D97,12,-4251.1,8,4,6213.14,1962.04
17642,UA9A451,12,7496.0,9,3,4754.0,12250.0
17643,UDACD1A,12,85.0,8,4,5277.7,5362.700000000001
17644,UD5F224,12,-4652.92,10,2,4754.63,101.71
17645,UAFC46E,12,543.3599999999999,8,4,5211.21,5754.57
17646,UEECE88,12,12.0,6,6,29988.0,30000.0
17647,U94E549,12,49.27000000000032,8,4,12597.62,12646.89
17648,UC3D722,12,10905.96,8,4,1983.04,12889.0
17649,U497623,12,-670.8000000000001,10,2,2071.08,1400.28
17650,UDC8159,12,-211.72999999999996,10,2,1279.75,1068.02
17651,U7EB18C,12,5561.67,3,9,14804.5,20366.17
17652,UD76BC2,12,1793763.18,6,6,1818073.0,3611836.1799999997
17653,U35A04C,12,-316.67999999999995,9,3,1093.6799999999998,777.0
17654,U48EF49,12,-488.64,8,4,1237.0900000000001,748.45
17655,UD66469,12,30.979999999999563,8,4,33800.0,33830.979999999996
17656,U5CAC08,12,-948.0,10,2,6178.0,5230.0
17657,UA3BF1A,12,-2262.2199999999993,8,4,23696.0,21433.78
17658,U5AE01D,12,-2514.62,12,0,2514.62,0.0
17659,U438DD0,12,25.400000000000006,10,2,262.78,288.18
17660,U2B4D57,12,-1179.6100000000001,9,3,4864.63,3685.02
17661,U43761C,12,-17.299999999999994,11,1,111.29999999999998,94.0
17662,U263D8F,12,2352.0799999999995,10,2,2740.2200000000003,5092.299999999999
17663,U5380DB,12,-175.96999999999997,9,3,1186.97,1011.0
17664,UAFE1BB,12,-807.42,11,1,1335.74,528.32
17665,U269244,12,14628.279999999999,2,10,3580.0,18208.28
17666,U3979AF,12,2.8421709430404007e-13,10,2,2518.5,2518.5
17667,UBC0FFD,12,1163.07,10,2,449.76000000000005,1612.83
17668,UC54E80,12,0.0,6,6,12000.0,12000.0
17669,UF24632,12,10098.09,3,9,3334.0,13432.09
17670,U93B231,12,-781.24,8,4,2341.2400000000002,1560.0
17671,UEB72A8,12,37757.869999999995,7,5,14378.82,52136.69
17672,UE55509,12,-3622.8199999999997,12,0,3622.8199999999997,0.0
17673,UC8D31A,12,-3404.4300000000003,8,4,4104.43,700.0
17674,UCBAD3A,12,59.199999999999996,8,4,8288.8,8348.0
17675,UF53E35,12,-4638.4,11,1,4638.41,0.01
17676,U8CAB7C,12,8452.88,5,7,8964.64,17417.519999999997
17677,U8945CC,12,-3804.6599999999994,10,2,7786.469999999999,3981.81
17678,U3A267B,12,0.0,10,2,36000.0,36000.0
17679,U8D45AF,12,4051.8000000000006,3,9,964.54,5016.34
17680,U27A650,12,0.0,6,6,30000.0,30000.0
17681,U6E2A5E,12,-12422.87,9,3,23931.5,11508.63
17682,U960B08,12,20750.0,6,6,37656.0,58406.0
17683,U8DB06F,12,-2546.120000000001,8,4,9198.23,6652.11
17684,U530A40,12,11831.099999999999,9,3,36404.9,48236.0
17685,U9D95ED,12,3712.26,9,3,7557.0,11269.26
17686,U82E9BB,12,1260.14,7,5,3659.5,4919.639999999999
17687,UCC6BED,12,-882.73,9,3,49853.0,48970.27
17688,U7C9E60,12,-4283.98,9,3,10494.0,6210.02
17689,UCFBE2E,12,49714.7,9,3,1293.3,51008.0
17690,U99F870,12,73.0,7,5,15810.0,15883.0
17691,UABA3F4,12,-5625.289999999999,10,2,6063.749999999999,438.46
17692,U97F8DB,12,40.23999999999978,3,9,24000.0,24040.239999999998
17693,U6F89B0,12,-188.85999999999993,8,4,1535.19,1346.3300000000002
17694,UDA0ED2,12,-5496.450000000001,6,6,23200.0,17703.55
17695,U04FCF8,12,586.5,6,6,7113.5,7700.0
17696,U74A6F6,12,-295.0,9,3,1505.43,1210.43
17697,UDD55F8,12,-2245.150000000001,6,6,7924.950000000001,5679.799999999999
17698,UA764F5,12,1085.56,10,2,2914.44,4000.0
17699,UD4773E,12,-7866.68,12,0,7866.68,0.0
17700,U88516F,12,5419.84,7,5,6945.92,12365.760000000002
17701,U0E70F9,12,-1699.94,11,1,1699.98,0.04
17702,U001DA6,12,590.0,8,4,3310.0,3900.0
17703,UFB903E,12,216.0,9,3,21854.0,22070.0
17704,U727A34,12,-1265.3300000000017,9,3,54265.33,53000.0
17705,U6A0B06,12,-865.0500000000009,8,4,9435.14,8570.09
17706,UA9B0CE,12,5182.15,7,5,23842.85,29025.0
17707,UE0136D,12,-1555.0000000000005,9,3,7257.0,5702.0
17708,U5BCAC0,12,-5272.9,7,5,8222.9,2950.0
17709,UC10C83,12,-1054.9300000000003,8,4,6255.0,5200.07
17710,UDE10B6,12,-323.25999999999976,9,3,6744.54,6421.280000000001
17711,U8CFB78,12,50.660000000000004,10,2,749.34,800.0
17712,U01E22F,12,-456.0,7,5,17792.5,17336.5
17713,UADC33E,12,149.22,10,2,1094.7800000000002,1244.0
17714,UEA2B5B,12,-11554.36,8,4,21000.0,9445.64
17715,U6BD625,12,3769.9399999999987,7,5,11815.5,15585.439999999999
17716,U44B372,12,3824.4000000000015,6,6,21504.880000000005,25329.280000000002
17717,U702485,12,-1336.7999999999993,9,3,19087.7,17750.9
17718,U733465,12,-153.89999999999964,9,3,7409.84,7255.94
17719,UE2092B,12,-1955.49,10,2,2955.4900000000002,1000.0
17720,UBBF8D0,12,0.0,9,3,4127.0,4127.0
17721,U51C7D5,12,11560.48,7,5,5093.339999999999,16653.82
17722,U8CAE6E,12,-34375.03999999999,10,2,53133.58,18758.54
17723,U51139A,12,6958.65,4,8,6560.04,13518.689999999999
17724,U9046F0,12,10222.070000000002,4,8,6550.34,16772.41
17725,U7F92DF,12,-4000.0,9,3,8058.17,4058.17
17726,U116E01,12,-208.61000000000004,9,3,376.62,168.01
17727,U348782,12,-2514.9399999999982,11,1,22645.84,20130.9
17728,UEE03ED,12,-1157.9799999999996,4,8,12321.47,11163.49
17729,U24A9FB,12,32303.92,8,4,66944.09,99248.01000000001
17730,U6BB1BC,12,-28622.18,8,4,166045.0,137422.82
17731,UD8B943,12,-177.79999999999998,10,2,774.9899999999999,597.19
17732,U2667EB,12,606.9399999999999,9,3,1393.22,2000.16
17733,UE9F8F8,12,-6.57000000000005,10,2,2543.83,2537.2599999999998
17734,U9E68DC,12,-2500.94,9,3,3714.29,1213.35
17735,U2701BF,12,-39729.32,8,4,39788.32,59.0
17736,UA9B1E4,12,33541.670000000006,4,8,31671.19,65212.86
17737,U2B9229,12,-101.22999999999995,10,2,962.23,861.0
17738,U4C15C6,12,-1478.5199999999986,4,8,26923.0,25444.480000000003
17739,U2F92A7,12,1493.699999999997,10,2,50999.3,52493.0
17740,U38EED1,12,-119.8599999999999,6,6,8112.650000000001,7992.79
17741,UEA004E,12,3069.040000000001,9,3,2934.16,6003.2
17742,U318D70,12,3492.0,10,2,1448.0,4940.0
17743,UFA6AF1,12,768.96,5,7,6021.04,6790.0
17744,U32C9F6,12,-11687.45,12,0,11687.45,0.0
17745,UD91246,12,380.34999999999997,9,3,2439.62,2819.9700000000003
17746,U35FF7B,12,692.0,6,6,24156.0,24848.0
17747,U7B3495,12,-270.0,9,3,3970.0,3700.0
17748,UAEA540,12,-7698.65,9,3,8068.38,369.73
17749,UE50B9F,12,-1879.9399999999987,10,2,29132.0,27252.06
17750,U79500E,12,-1893.56,11,1,2393.5599999999995,500.0
17751,UAD9D32,12,-1383.5,12,0,1383.5,0.0
17752,U60F349,12,-147.60000000000002,11,1,147.68,0.08
17753,UF686DA,12,-6657.049999999998,9,3,34871.1,28214.05
17754,U597AD5,12,-3104.3999999999996,12,0,3104.3999999999996,0.0
17755,UFC5694,12,-1688.78,6,6,11952.99,10264.21
17756,UE5C824,12,-192.03000000000003,11,1,692.03,500.0
17757,U7056D3,12,-774.5100000000002,9,3,10774.51,10000.0
17758,U68E5A8,12,-2310.9200000000005,7,5,4639.07,2328.15
17759,UBEB799,12,25.0,4,8,30.0,55.0
17760,U610F06,12,-692.8700000000001,11,1,1241.8,548.93
17761,U6E126F,12,-6061.4,10,2,13942.8,7881.4
17762,U5C6DA2,12,-2830.0000000000005,8,4,21247.640000000003,18417.64
17763,UC1E5DC,12,-3361.3,9,3,6968.310000000001,3607.01
17764,UEFDDC0,12,-5501.02,12,0,5501.02,0.0
17765,U5AA19D,12,-76.0,6,6,19796.0,19720.0
17766,UD48391,12,-5000.0,7,5,14999.83,9999.83
17767,U8B0148,12,-6.7999999999999545,8,4,7816.8,7810.0
17768,U95DF14,12,-4.547473508864641e-13,10,2,3000.7200000000003,3000.72
17769,UE1441E,12,1.44,6,6,2970.0,2971.44
17770,U4794F9,12,-718.1800000000001,12,0,718.1800000000001,0.0
17771,UBAD921,12,720.6699999999983,8,4,40578.33,41299.0
17772,UDF095D,12,959.5499999999993,10,2,6271.78,7231.33
17773,U22759E,12,-1761.84,11,1,2410.84,649.0
17774,U1B4F6F,12,-976.6700000000001,11,1,1457.6699999999998,481.0
17775,U6F7FD8,12,0.0,10,2,375.44,375.44
17776,UD1FD3A,12,-1609.5200000000004,8,4,12250.84,10641.32
17777,UB0BE4E,12,13.000000000000028,6,6,907.0,920.0
17778,UAF7BA7,12,-1499.9999999999982,8,4,24021.19,22521.190000000002
17779,U73C1C5,12,3419.9,8,4,1600.0,5019.9
17780,UDF31AD,12,50.0,10,2,9718.0,9768.0
17781,UB03781,12,-1994.06,12,0,1994.06,0.0
17782,UB2FB33,12,420.90000000000055,9,3,8742.8,9163.7
17783,UC17FDD,12,474.9699999999998,8,4,5626.7,6101.67
17784,U31267D,12,-3146.74,10,2,3428.74,282.0
17785,U191A7B,12,-429.22999999999996,9,3,1246.31,817.0799999999999
17786,UC674DC,12,6258.02,6,6,30227.61,36485.63
17787,U0A3DC3,12,-3464.16,6,6,5770.4,2306.24
17788,UF1778E,12,-8224.9,8,4,16449.5,8224.6
17789,U3BCFD4,12,-24.259999999999998,7,5,95.13999999999999,70.88
17790,U89FAB6,12,-48694.97,11,1,49063.97,369.0
17791,UE94F37,12,1563.5500000000002,9,3,5096.02,6659.57
17792,U2FCDEB,12,0.2600000000002183,3,9,11788.0,11788.26
17793,UB1D45B,12,0.8399999999999181,10,2,914.96,915.8
17794,U986DE8,12,285.7299999999999,7,5,1594.21,1879.94
17795,UA065BC,12,-1334.0300000000002,12,0,1334.0300000000002,0.0
17796,U6B5E78,12,-36.91999999999989,9,3,18051.359999999997,18014.440000000002
17797,UEFBCC4,12,8175.74,9,3,4540.62,12716.36
17798,UE8F51B,12,-11771.950000000003,12,0,11771.950000000003,0.0
17799,UA72652,12,-5123.949999999999,6,6,160148.67,155024.72
17800,U8A7927,12,-1664.7200000000003,11,1,1864.7200000000003,200.0
17801,U21A41E,12,0.0,6,6,2400.0,2400.0
17802,U18295C,12,0.0,6,6,6000.0,6000.0
17803,U3C41E3,12,-653.5000000000003,10,2,7488.799999999999,6835.299999999999
17804,UEA0DE5,12,2234.92,6,6,16402.0,18636.92
17805,UE95B14,12,237.0,8,4,5763.0,6000.0
17806,UA6D4C2,12,1004.5800000000002,7,5,4558.599999999999,5563.179999999999
17807,U83FA57,12,-15.609999999999786,8,4,6483.94,6468.33
17808,U157992,12,28451.809999999998,9,3,20167.48,48619.29
17809,U02E38D,12,-3686.49,12,0,3686.49,0.0
17810,U0DD0C3,12,-1848.86,6,6,2112.0,263.14
17811,U320591,12,-1425.5,8,4,3084.5,1659.0
17812,U77EB6F,12,498.63,7,5,1070.5900000000001,1569.22
17813,UB2AE50,12,613.4200000000001,6,6,1385.0800000000002,1998.5
17814,U24D256,12,54.57999999999974,5,7,4646.7,4701.28
17815,UD4C15D,12,-4826.5,12,0,4826.5,0.0
17816,U98D226,12,-4599.7,12,0,4599.7,0.0
17817,UD19653,12,-10021.1,12,0,10021.1,0.0
17818,U532318,12,2.0,6,6,7998.0,8000.0
17819,U262103,12,-322.3800000000002,9,3,2929.58,2607.2
17820,UA4434E,12,30.000000000000007,7,5,226.54,256.54
17821,U626A98,12,0.0,4,8,20002.0,20002.0
17822,U95D88B,12,1122.8500000000004,5,7,2020.0,3142.8500000000004
17823,UD40937,12,490.0,10,2,5010.0,5500.0
17824,UF5A436,12,-4057.9500000000007,7,5,12845.0,8787.05
17825,U27E4EE,12,17.000000000000114,7,5,1586.59,1603.5900000000001
17826,U0507C1,12,-1235.4099999999996,11,1,1416.0199999999998,180.61
17827,U82DEFD,12,-15503.2,12,0,15503.2,0.0
17828,U4C3F2C,12,4999.999999999999,10,2,1975.8600000000001,6975.86
17829,U16E81C,12,5157.2,7,5,11042.8,16200.0
17830,U1FB169,12,-73.03999999999985,10,2,875.8999999999999,802.86
17831,U63717B,12,-2474.24,8,4,16677.239999999998,14203.0
17832,U676C67,12,-5945.9299999999985,10,2,15928.25,9982.32
17833,UA626C0,12,0.0,10,2,1092.56,1092.56
17834,U6D705F,12,1168.4399999999998,10,2,454.97,1623.4099999999999
17835,UDDCF36,12,-6233.379999999999,12,0,6233.379999999999,0.0
17836,UE5388B,12,205.93999999999994,7,5,7528.08,7734.02
17837,U7DCA70,12,8822.650000000001,7,5,16207.0,25029.65
17838,U9C8A01,12,959.1099999999999,7,5,991.3600000000001,1950.47
17839,U422BCF,12,18668.84,9,3,5086.860000000001,23755.7
17840,UA1CD11,12,13385.55,7,5,3166.9800000000005,16552.53
17841,U14BC3D,12,2183.43,10,2,2972.36,5155.79
17842,U715289,12,-1694.75,11,1,1694.76,0.01
17843,U30D57F,12,-882.14,12,0,882.14,0.0
17844,U7BF422,12,2903.4100000000003,9,3,3181.4,6084.81
17845,UFF73D1,12,217.0000000000001,5,7,2170.93,2387.9300000000003
17846,UAA2223,12,-10.0,6,6,8010.0,8000.0
17847,UC4A10A,12,-490.0,6,6,7862.0,7372.0
17848,UA81F06,12,-189.8,7,5,6180.0,5990.2
17849,UC9F80D,12,-13170.319999999998,11,1,13370.319999999998,200.0
17850,UFBB422,12,29909.29,4,8,14000.0,43909.29
17851,UB1894D,12,407.59,5,7,1239.99,1647.58
17852,U9E2885,12,-1125.4600000000064,6,6,52319.46,51194.0
17853,U37BB2E,12,-3003.0,6,6,12957.0,9954.0
17854,UE30602,12,-1321.1999999999998,6,6,6579.2,5258.0
17855,U1235A2,12,-5683.860000000001,12,0,5683.860000000001,0.0
17856,UFE285C,12,-1938.3200000000002,11,1,3642.92,1704.6
17857,UC4DC32,12,-39.860000000000014,10,2,775.0,735.14
17858,UF99B43,12,-636.1999999999999,7,5,1936.2,1300.0
17859,U81E200,12,149.41999999999985,9,3,2125.2400000000002,2274.66
17860,U3DD88E,12,396672.83999999997,8,4,421422.28,818095.12
17861,U8642AE,12,1548.8200000000002,5,7,3721.7799999999997,5270.599999999999
17862,U38D1C2,12,-107.47,9,3,207.22,99.75
17863,UBA5DEC,12,720.0,5,7,3285.0,4005.0
17864,U4B72F9,12,-10562.4,12,0,10562.4,0.0
17865,U25F189,12,-51109.130000000005,8,4,102200.01000000001,51090.88
17866,U2ED770,12,0.04000000000132786,7,5,10604.4,10604.440000000002
17867,U8549FD,12,50003.87,3,9,3539.0,53542.87
17868,U0B0DD7,12,423.78999999999996,9,3,474.13,897.9199999999998
17869,U09394F,12,-800.0,10,2,2025.27,1225.27
17870,UFF5FF9,12,14541.02,9,3,1458.98,16000.0
17871,U5FEEB0,12,10330.04,4,8,10847.0,21177.039999999997
17872,UE52903,12,1376.96,10,2,273.85,1650.81
17873,U61BECA,12,7980.0,8,4,30166.66,38146.66
17874,U0F04B8,12,-5994.53,10,2,6044.54,50.01
17875,UDE14C2,12,47.61000000000013,10,2,5356.6,5404.21
17876,UE3ACCB,12,0.8599999999999,9,3,812.15,813.01
17877,U9C40CC,12,-167.89,7,5,1279.89,1112.0
17878,UEF6F4A,12,326.11,10,2,327.38,653.49
17879,U39A09A,12,1978.0,6,6,6108.0,8086.0
17880,U7DB54C,12,160.95,9,3,295.09,456.04
17881,U7B6EA7,12,2795.5,7,5,66884.5,69680.0
17882,U23E034,12,-823.1799999999998,9,3,3239.6800000000003,2416.5
17883,U6AE2B1,12,-17985.09,10,2,18275.48,290.39
17884,UF84A8A,12,-2203.77,8,4,10992.499999999998,8788.73
17885,U046D98,12,12639.89,7,5,640.03,13279.92
17886,U6E15C0,12,-659.4999999999992,10,2,6761.4,6101.900000000001
17887,UE17A1C,12,190.99999999999955,6,6,18210.0,18401.0
17888,U1B83F7,12,474.8000000000002,9,3,10125.2,10600.0
17889,U049848,12,-131.1199999999999,9,3,2531.16,2400.04
17890,UDAC929,12,1026.4,9,3,4263.6,5290.0
17891,U386E15,12,6283.000000000001,10,2,2496.09,8779.09
17892,U30FA7F,12,-2.1599999999980355,4,8,23063.0,23060.84
17893,U7C7F2F,12,1354.0,10,2,12751.0,14105.0
17894,UAF3369,12,1939.1,9,3,3184.9100000000003,5124.01
17895,UD912DA,12,-3500.3,10,2,5289.98,1789.68
17896,UA952FD,12,-60875.700000000004,8,4,76601.1,15725.4
17897,UD43D24,12,617.6299999999992,9,3,17500.0,18117.629999999997
17898,UFE6B6D,12,11902.82,11,1,1097.18,13000.0
17899,U37F8DF,12,-4744.0599999999995,12,0,4744.0599999999995,0.0
17900,U5894A1,12,-2179.0,9,3,3818.6,1639.6
17901,UA0C62D,12,1800.3400000000001,9,3,1764.66,3565.0
17902,U8AAE53,12,3390.659999999916,5,7,531820.0,535210.6599999999
17903,UA8823D,12,-3127.5,10,2,7017.2,3889.7
17904,UD1C98C,12,608.3900000000001,9,3,622.61,1231.0
17905,UFD124B,12,-82.24,9,3,239.84,157.6
17906,UE96161,12,-783.12,9,3,1856.13,1073.01
17907,U3AE24A,12,-1269.9799999999996,9,3,15489.98,14220.0
17908,UC6B172,12,81.21999999999753,7,5,33302.520000000004,33383.74
17909,U86243B,12,-1989.66,10,2,4793.93,2804.27
17910,U05F49D,12,5006.25,4,8,4860.66,9866.91
17911,UD365B8,12,-1067.44,12,0,1067.44,0.0
17912,UCA15A8,12,-2581.149999999999,9,3,50317.65,47736.5
17913,U59DF65,12,114.97999999999956,6,6,50928.16,51043.14
17914,U6E3EDF,12,-542.1199999999999,7,5,3511.0,2968.88
17915,U800630,12,22135.31,5,7,7258.65,29393.960000000003
17916,U5E2A9F,12,-10661.38,12,0,10661.38,0.0
17917,UE5AACC,12,-9788.550000000001,6,6,38584.16,28795.61
17918,UD3AE99,12,0.0,6,6,16000.0,16000.0
17919,U8307D6,12,-1208.2099999999996,8,4,4658.209999999999,3450.0
17920,U9D684F,12,17.58000000000061,10,2,2982.42,3000.0
17921,UF6E826,12,159.2,8,4,627.49,786.6899999999999
17922,U7E1C7A,12,-3319.3199999999997,8,4,50413.32,47094.0
17923,UF1D7A6,12,7.800000000000001,9,3,1049.0,1056.8
17924,U231994,12,378.0,9,3,4608.5,4986.5
17925,UDBF15A,12,25992.23,7,5,13441.619999999999,39433.85
17926,UC6534B,12,341.7099999999999,9,3,728.8199999999999,1070.53
17927,UBB5FE7,12,-5306.28,11,1,9306.279999999999,4000.0
17928,U6F62A6,12,2317.81,9,3,533.06,2850.87
17929,UF854D7,12,-58.25000000000023,10,2,1857.1599999999999,1798.9099999999999
17930,UF4CCA3,12,1514.4699999999998,9,3,2950.2799999999997,4464.75
17931,U77305F,12,-41.98000000000033,7,5,3476.36,3434.38
17932,UFD0202,12,-57.360000000000014,10,2,749.2499999999999,691.89
17933,U91B201,12,-286.0,5,7,17325.0,17039.0
17934,UE0247F,12,10011.0,9,3,9989.0,20000.0
17935,U0EDBA1,12,-5925.6,10,2,6955.6,1030.0
17936,UE8337E,12,-646.9999999999999,7,5,3137.96,2490.96
17937,UF6ED0D,12,-2516.9400000000005,9,3,5813.0,3296.06
17938,UD8A9C8,12,-1419.9900000000002,9,3,3323.2000000000003,1903.21
17939,UC16179,12,-2648.970000000002,7,5,24541.05,21892.079999999998
17940,UB7F100,12,-1662.46,12,0,1662.46,0.0
17941,U1BA301,12,-3677.3999999999996,11,1,4772.4,1095.0
17942,UF712B4,12,1290.8400000000001,8,4,8689.16,9980.0
17943,U06D51F,12,-12.0,10,2,8220.0,8208.0
17944,U01B19E,12,-6.600000000000023,9,3,1627.6,1621.0
17945,U1A0FEB,12,52.03000000000023,8,4,14537.98,14590.01
17946,UD55C46,12,-7279.919999999998,9,3,52155.92,44876.0
17947,UFB9335,12,500.2800000000001,7,5,1954.1499999999999,2454.43
17948,U01CB07,12,-375.28999999999996,10,2,12718.0,12342.71
17949,U86383B,12,1200.0,5,7,58800.0,60000.0
17950,UFAAEED,12,16520.17,6,6,44178.83,60699.0
17951,UDE172D,12,1615.14,10,2,15052.449999999999,16667.59
17952,UB33C0A,12,32120.0,6,6,956.8800000000001,33076.880000000005
17953,U7BF3AC,12,-77.41000000000011,8,4,2486.53,2409.1200000000003
17954,U5E1176,12,-3037.79,12,0,3037.79,0.0
17955,UC6FDCC,12,-664.0099999999999,9,3,3512.4,2848.3900000000003
17956,U618E79,12,7260.5,10,2,5939.5,13200.0
17957,U36830E,12,-1100.7700000000004,10,2,6200.77,5100.0
17958,U3EEB32,12,-443.85000000000014,7,5,10510.529999999999,10066.68
17959,U266C34,12,-38.609999999999985,8,4,2193.39,2154.78
17960,UDEACB2,12,382.9099999999996,6,6,12204.0,12586.91
17961,U8F7A71,12,-5802.0,5,7,54867.0,49065.0
17962,U68B836,11,-5706.99,8,3,16507.0,10800.01
17963,UE99F90,11,2584.1299999999974,6,5,30385.25,32969.38
17964,UA8AB00,11,14562.93,4,7,308.59999999999997,14871.53
17965,U164053,11,23670.880000000005,5,6,109587.0,133257.88
17966,UA8E589,11,-356.0,7,4,7727.0,7371.0
17967,U5587E7,11,1116.75,7,4,35591.78,36708.53
17968,UF2E074,11,10845.04,3,8,10314.5,21159.54
17969,U6855BF,11,1059.9999999999998,8,3,3093.13,4153.13
17970,U0CEA8C,11,123.08000000000001,7,4,184.2,307.28
17971,U9BD37F,11,10150.5,3,8,34797.0,44947.5
17972,UE9FF84,11,5141.16,5,6,6777.64,11918.800000000001
17973,U541FFE,11,-7386.2,8,3,8286.2,900.0
17974,U466D38,11,10310.380000000003,6,5,13833.74,24144.12
17975,UF917E4,11,-3029.0000000000036,8,3,35245.990000000005,32216.989999999998
17976,UF95F7F,11,2382.01,7,4,21161.0,23543.01
17977,U2D3975,11,8024.71,6,5,957.29,8982.0
17978,U9970C1,11,-39.850000000000364,7,4,3280.0,3240.15
17979,U08950A,11,999.9999999999991,5,6,14710.529999999999,15710.529999999999
17980,U5B05C1,11,2050.7999999999993,5,6,16689.0,18739.8
17981,UEEADA9,11,92.93000000000006,7,4,1525.0,1617.93
17982,U07E8E9,11,-2631.51,9,2,10052.51,7421.0
17983,U7CF9F2,11,73.28999999999814,8,3,14427.000000000002,14500.29
17984,UE3B433,11,-2437.75,9,2,4585.82,2148.07
17985,UFCDBDE,11,-9900.68,8,3,22823.68,12923.0
17986,U876A9F,11,10800.05,4,7,15221.04,26021.09
17987,U752017,11,-1060.8599999999997,9,2,6970.859999999999,5910.0
17988,UDE7A0B,11,3980.0499999999997,5,6,4958.0,8938.05
17989,U1D0292,11,132.0,8,3,1778.0,1910.0
17990,U729A2B,11,2187.549999999999,9,2,6126.32,8313.869999999999
17991,UEDBF57,11,50232.29000000001,7,4,4743.98,54976.270000000004
17992,U0075CC,11,27825.260000000002,4,7,5600.0,33425.26
17993,U69A387,11,599.0,7,4,4341.0,4940.0
17994,UB9B707,11,-1848.9100000000003,11,0,1848.9100000000003,0.0
17995,U90E2BA,11,-856.6100000000001,9,2,2087.74,1231.1299999999999
17996,U93BFA2,11,3224.3500000000004,8,3,3571.0,6795.35
17997,UD08951,11,-7893.3,9,2,15070.390000000001,7177.09
17998,UC627A9,11,536.3700000000008,7,4,7825.61,8361.98
17999,U890FF1,11,998.8400000000001,5,6,3092.83,4091.67
18000,UBD21F9,11,5357.98,4,7,6964.0,12321.98
18001,U21A50E,11,1216.2500000000005,7,4,20661.93,21878.18
18002,U12B560,11,-3119.000000000002,9,2,19727.48,16608.48
18003,U6D52D2,11,30358.86,8,3,6561.14,36920.0
18004,U9076DB,11,-29.9399999999996,8,3,5250.58,5220.64
18005,U9A0826,11,-2943.1000000000004,10,1,2944.1000000000004,1.0
18006,UDB6CD8,11,772.86,6,5,1416.36,2189.2200000000003
18007,U06C515,11,-927.8200000000002,8,3,4429.0,3501.18
18008,U06676E,11,-1.0,7,4,6001.0,6000.0
18009,U215488,11,3968.12,7,4,4075.38,8043.5
18010,U61AD24,11,3869.73,6,5,4393.35,8263.08
18011,UD2E033,11,-32.31,8,3,98.4,66.09
18012,U8065F4,11,13216.75,8,3,674.41,13891.16
18013,U766A81,11,206.0699999999989,9,2,8466.73,8672.8
18014,UAE34DA,11,-678.3000000000002,6,5,9455.02,8776.720000000001
18015,U30A801,11,278.66000000000054,8,3,11333.01,11611.67
18016,UB81AE1,11,-183.99999999999997,9,2,446.59999999999997,262.6
18017,U3D2FBF,11,-5838.76,10,1,5838.79,0.03
18018,UBBC018,11,-421.7900000000009,6,5,28672.32,28250.53
18019,U745498,11,-2771.1000000000004,4,7,9945.76,7174.66
18020,U8B70F2,11,5424.32,4,7,7163.68,12588.0
18021,U7876C7,11,-230.5,7,4,25886.3,25655.8
18022,U701759,11,7213.6,6,5,4745.66,11959.26
18023,U447B72,11,75.76000000000022,6,5,3035.13,3110.89
18024,U9B1D68,11,-1998.54,10,1,2198.54,200.0
18025,UBBDA40,11,-223.7200000000002,8,3,3797.0,3573.2799999999997
18026,UEB1BE0,11,-2296.87,9,2,2310.9,14.03
18027,UAF47E4,11,983.0,2,9,10.0,993.0
18028,U027613,11,-31.04,7,4,4866.04,4835.0
18029,UE0537E,11,1445.3400000000001,6,5,12173.71,13619.05
18030,U775C47,11,-26576.82,10,1,26576.829999999998,0.01
18031,U27D8C1,11,3827.270000000002,4,7,308377.01,312204.2799999999
18032,UECDD09,11,-3080.0,8,3,7080.0,4000.0
18033,U15ABCD,11,-2011.3799999999997,9,2,2911.3799999999997,900.0
18034,U81466E,11,-499.90000000000066,8,3,8694.900000000001,8195.0
18035,UC4AF99,11,-49605.84000000001,7,4,59262.030000000006,9656.19
18036,U5AB101,11,1.4199999999982538,5,6,33208.88,33210.3
18037,UBA0402,11,180.60999999999999,9,2,289.39,470.0
18038,UF38BFA,11,-836.5,9,2,1491.5,655.0
18039,UF50D94,11,6352.120000000001,4,7,6365.84,12717.960000000001
18040,U9C6074,11,2209.76,7,4,1532.34,3742.1
18041,U431496,11,0.0,6,5,6000.0,6000.0
18042,U527DFC,11,-216.79999999999995,8,3,1066.8,850.0
18043,U00015C,11,-29330.0,8,3,56630.0,27300.0
18044,U3406B1,11,-5621.55,11,0,5621.55,0.0
18045,U7B373F,11,-12465.0,6,5,48878.0,36413.0
18046,UA7FA35,11,-1380.5600000000004,5,6,12002.0,10621.44
18047,UD443BB,11,2380.98,8,3,1290.2199999999998,3671.2
18048,U10DC93,11,-2180.43,10,1,2180.46,0.03
18049,UC1A1BE,11,-36999.99,7,4,50140.049999999996,13140.060000000001
18050,UFA7A3D,11,-277.18,11,0,277.18,0.0
18051,U36E2F7,11,-5326.63,8,3,15628.369999999999,10301.74
18052,U641F5F,11,-262.0,11,0,262.0,0.0
18053,U2126B1,11,1437.3500000000001,7,4,2421.6800000000003,3859.0299999999997
18054,UC9E1FA,11,-1649.0900000000001,7,4,8297.0,6647.91
18055,U4BC703,11,0.0,8,3,835.6999999999999,835.7
18056,UF32317,11,220.0,9,2,4229.0,4449.0
18057,U57904A,11,362.03999999999996,7,4,38.0,400.03999999999996
18058,UEA2542,11,2711.46,6,5,898.5400000000001,3610.0
18059,U5CF46F,11,1.6199999999998909,7,4,1643.38,1645.0
18060,UC8F1D6,11,-7807.5,9,2,11311.55,3504.05
18061,U039F2D,11,3.2299999999995634,5,6,35500.0,35503.229999999996
18062,U5494BC,11,-1932.6999999999994,10,1,2032.6999999999994,100.0
18063,U578B7C,11,-2428.0,6,5,16781.0,14353.0
18064,UA2CB1F,11,3.019999999999982,5,6,2542.95,2545.9700000000003
18065,U8922D5,11,1160.6799999999962,3,8,63000.0,64160.68
18066,U1EE071,11,4500.0,4,7,74100.0,78600.0
18067,U5DF1AE,11,-1717.9999999999982,7,4,31759.16,30041.160000000003
18068,UFE7E9E,11,13.339999999999236,6,5,7286.9400000000005,7300.28
18069,UC8AA8D,11,10380.0,8,3,5529.339999999999,15909.34
18070,U88A3EA,11,-167.0,2,9,11905.2,11738.2
18071,UBD17FF,11,-1267.6999999999998,10,1,1317.6999999999998,50.0
18072,U0FCA89,11,18756.82,4,7,3971.18,22728.0
18073,U30D110,11,-12581.899999999998,7,4,45351.9,32770.0
18074,U47D19D,11,5.3290705182007514e-14,10,1,280.34999999999997,280.35
18075,UEA7B69,11,1214.1400000000006,9,2,9603.659999999998,10817.8
18076,UB82984,11,-1133.8599999999997,7,4,1589.8599999999997,456.0
18077,U77F5DF,11,3676.4500000000007,8,3,1029.55,4706.0
18078,U23D127,11,2006.88,8,3,2349.3100000000004,4356.1900000000005
18079,UDF1B2C,11,-1728.82,8,3,4351.039999999999,2622.22
18080,U90943B,11,-394.89,9,2,761.0999999999999,366.21
18081,U17546E,11,-944.8199999999999,7,4,5665.8099999999995,4720.99
18082,UC65F47,11,9195.86,6,5,8804.14,18000.0
18083,U04781C,11,-1242.0,7,4,12863.0,11621.0
18084,U4C18CC,11,101.4,9,2,147.4,248.8
18085,U41D1D3,11,-0.8499999999999659,6,5,1275.77,1274.92
18086,U801E05,11,405.79,8,3,683.5,1089.29
18087,UED466D,11,-6417.55,8,3,14308.0,7890.45
18088,U18E66F,11,-655.1000000000006,8,3,9255.38,8600.28
18089,U50CD7C,11,-898.16,9,2,1031.8,133.64
18090,U70AEDF,11,-35.48000000000002,9,2,7365.4800000000005,7330.0
18091,UBA0E8E,11,-2358.7999999999993,6,5,42728.8,40370.0
18092,UB4FBBC,11,4687.33,6,5,1773.57,6460.9
18093,UDE7996,11,-8851.92,11,0,8851.92,0.0
18094,U9E169E,11,-97.46000000000076,8,3,8987.699999999999,8890.24
18095,UDBAD07,11,-9734.880000000001,11,0,9734.880000000001,0.0
18096,UC65DE0,11,-2992.0,10,1,5843.0,2851.0
18097,UD77DB9,11,-79.00999999999999,10,1,321.81,242.8
18098,UB19DE1,11,182.0,7,4,1451.98,1633.98
18099,UF7D891,11,7674.01,6,5,6784.66,14458.67
18100,UDDF5EB,11,-343.20000000000044,9,2,6277.200000000001,5934.0
18101,U1A2E53,11,-218.95,8,3,4881.0,4662.05
18102,UF7BF13,11,58.19999999999993,6,5,2614.61,2672.81
18103,U8FB61E,11,-1516.8799999999994,6,5,25588.760000000002,24071.879999999997
18104,U167BC7,11,-1321.66,8,3,2449.6600000000003,1128.0
18105,U04000D,11,-5553.35,10,1,10308.9,4755.55
18106,U1F2E45,11,-215.0,8,3,69515.0,69300.0
18107,UD43F57,11,-3722.52,9,2,5478.58,1756.06
18108,U215A85,11,-313.5999999999999,10,1,691.5999999999999,378.0
18109,U10A6F0,11,-3750.61,10,1,4750.610000000001,1000.0
18110,U931ED8,11,4887.799999999999,10,1,2812.2000000000003,7700.0
18111,U9AA46E,11,-24412.3,9,2,38485.3,14073.0
18112,U62C838,11,0.060000000000005826,9,2,184.94,185.0
18113,UFD14A4,11,434.1699999999999,6,5,1803.3899999999999,2237.56
18114,UBFFB40,11,0.2500000000000051,6,5,412.74,412.99
18115,UB5AADC,11,-9.569999999999865,10,1,1722.71,1713.14
18116,UE2657C,11,-149.4599999999998,7,4,2621.4700000000003,2472.01
18117,UDFEF1C,11,80.7800000000001,7,4,851.0199999999999,931.8
18118,U0B405D,11,-9.103828801926284e-15,5,6,486.02,486.02
18119,U79D4A1,11,-2.0100000000002183,6,5,5997.99,5995.98
18120,UA01E61,11,-375.10000000000036,8,3,10715.1,10340.0
18121,U95DAF8,11,308.8400000000001,9,2,446.16,755.0
18122,UE731A6,11,3392.5399999999995,7,4,677.8499999999999,4070.3899999999994
18123,U329C24,11,-329.98,9,2,2050.0,1720.02
18124,UF5EB05,11,10931.269999999999,4,7,21430.27,32361.54
18125,U1CBE77,11,-24492.420000000002,6,5,37839.02,13346.6
18126,UBE7FBD,11,13830.0,0,11,0.0,13830.0
18127,U13418E,11,-2982.5000000000005,10,1,3128.5000000000005,146.0
18128,U774CA2,11,-1407.7399999999998,8,3,3740.74,2333.0
18129,U6B138D,11,-785.3399999999999,9,2,2981.34,2196.0
18130,U89AE61,11,-39.91999999999854,9,2,6025.089999999999,5985.17
18131,U827AA6,11,4284.259999999999,5,6,16009.64,20293.899999999998
18132,UA03097,11,-199.03999999999996,8,3,5080.04,4881.0
18133,UEBDBF7,11,2620.02,10,1,18379.98,21000.0
18134,U9CEB79,11,1068.8799999999974,8,3,68931.12,70000.0
18135,U0A952C,11,-5522.650000000001,9,2,13151.11,7628.46
18136,U2BFFE7,11,-6000.0,5,6,26200.0,20200.0
18137,U8FA6EF,11,-1015.6799999999998,9,2,3576.19,2560.51
18138,UAE5452,11,99.30000000000018,7,4,2851.12,2950.42
18139,U354D1C,11,-1211.9,9,2,3421.9,2210.0
18140,U64AFF8,11,-20.5,7,4,318.32000000000005,297.82
18141,U7CD2CE,11,-8752.0,5,6,23852.0,15100.0
18142,U188BE4,11,-25.0,7,4,19735.0,19710.0
18143,U00D5BF,11,1064.83,10,1,1035.16,2099.99
18144,UDD4E18,11,-1.5799999999999272,9,2,4991.58,4990.0
18145,U5D7DDD,11,-2986.8000000000006,9,2,5192.240000000001,2205.44
18146,UBB1ABB,11,-1344.4199999999998,7,4,5949.0,4604.58
18147,U025283,11,5.93,8,3,534.8,540.7299999999999
18148,U95ACAB,11,-799.44,9,2,2995.98,2196.54
18149,UF40A08,11,1.5631940186722204e-13,8,3,2338.2599999999998,2338.26
18150,UD6EF6D,11,-4874.799999999999,7,4,16865.0,11990.2
18151,U9C1FD0,11,-53356.1,9,2,57567.7,4211.6
18152,U72AA48,11,-37.12000000000262,5,6,70003.73000000001,69966.61
18153,UFA2E65,11,-786.7299999999997,8,3,12810.710000000001,12023.98
18154,UFCB046,11,-22748.24,9,2,22959.210000000003,210.97
18155,UC7029C,11,282.11,6,5,1828.01,2110.12
18156,U84882D,11,0.0,7,4,12768.2,12768.2
18157,UF34CA0,11,-9311.34,9,2,10521.34,1210.0
18158,U4A8E45,11,-371.1899999999998,5,6,17280.02,16908.829999999998
18159,U9ABDD6,11,-5173.209999999999,9,2,11773.210000000001,6600.0
18160,UB4BDDB,11,14.619999999999436,5,6,11545.15,11559.769999999999
18161,UE4735B,11,2195.0,6,5,15139.0,17334.0
18162,U3C6CE6,11,-429.33000000000004,9,2,2234.11,1804.78
18163,U5A9234,11,-7844.280000000001,10,1,7944.280000000001,100.0
18164,UE04B29,11,-1375.0600000000004,7,4,10796.21,9421.150000000001
18165,U319909,11,441.4399999999998,6,5,3970.09,4411.53
18166,U224E18,11,6374.5599999999995,9,2,13625.44,20000.0
18167,U50EC21,11,10000.0,5,6,36165.2,46165.2
18168,U65C105,11,-191.65999999999997,9,2,808.0699999999999,616.4100000000001
18169,U92A81B,11,-2.0,6,5,46.0,44.0
18170,U152FFA,11,466.66999999999945,3,8,11604.0,12070.67
18171,U01BE1C,11,-22698.53,9,2,42799.06,20100.53
18172,UD3CFBA,11,3903.5000000000014,3,8,250296.0,254199.5
18173,U7BE1FC,11,72709.5,5,6,20040.34,92749.84000000001
18174,UBED1D9,11,185.0,9,2,1515.0,1700.0
18175,U4CCED9,11,189.90999999999997,9,2,650.09,840.0
18176,UFEB3E5,11,30.0,7,4,427.14,457.14
18177,UA69131,11,519.7,8,3,909.2,1428.9
18178,UF2DB8A,11,-4507.86,5,6,6264.32,1756.46
18179,U07FD84,11,5071.8499999999985,5,6,16845.7,21917.55
18180,U17643D,11,7628.509999999998,6,5,47371.490000000005,55000.0
18181,UCC89F3,11,-790.09,11,0,790.09,0.0
18182,U4C64E5,11,409.49,8,3,513.5,922.99
18183,UB955AA,11,13.20999999999982,7,4,11986.8,12000.01
18184,U5FB242,11,-1202.41,11,0,1202.41,0.0
18185,U9B8DC2,11,-237.81,9,2,1503.5200000000002,1265.71
18186,UAB1BCF,11,-7080.0,6,5,19580.0,12500.0
18187,U7A1A1C,11,200.0,3,8,58693.0,58893.0
18188,U67B9E8,11,-712.5600000000001,9,2,1960.5,1247.94
18189,UDB1FC7,11,-6.920000000000094,6,5,1798.23,1791.31
18190,UE6A731,11,16.279999999999973,6,5,2406.33,2422.61
18191,UC1DEEF,11,-2832.0,6,5,70310.0,67478.0
18192,U0520CA,11,-10711.150000000001,7,4,15383.32,4672.17
18193,UCCE6B1,11,935.8399999999992,7,4,7550.200000000001,8486.04
18194,UE21920,11,-666.8400000000001,7,4,1768.63,1101.79
18195,U80FB6D,11,-2114.0,4,7,65784.0,63670.0
18196,U941B65,11,-926.9500000000007,5,6,12861.8,11934.85
18197,UCD6276,11,-114.0,9,2,1583.0,1469.0
18198,UF81518,11,215.0,8,3,16163.34,16378.34
18199,UEDD4C7,11,0.0,8,3,1445.0,1445.0
18200,UB1049C,11,-7994.24,10,1,8094.24,100.0
18201,U676C2B,11,7854.0,5,6,5706.0,13560.0
18202,U65407E,11,-136.28999999999996,7,4,409.68999999999994,273.4
18203,U009D4A,11,-16.699999999999918,9,2,1496.2299999999998,1479.53
18204,U829A20,11,4969.0,5,6,1766.84,6735.84
18205,U0E773E,11,48.07,5,6,157.13,205.2
18206,U435BC3,11,12038.97,4,7,27301.0,39339.97
18207,UD912D7,11,-2403.9,10,1,5953.9,3550.0
18208,U973C23,11,-3310.21,11,0,3310.21,0.0
18209,UC5B827,11,-1147.07,5,6,5742.08,4595.01
18210,UC3219F,11,-2128.99,7,4,4926.0,2797.01
18211,U3589E8,11,-3613.7799999999993,10,1,6633.78,3020.0
18212,U507619,11,-828.8,8,3,1110.8000000000002,282.0
18213,U085477,11,17038.500000000004,9,2,4155.549999999999,21194.050000000003
18214,U71EEE9,11,-21.429999999999996,6,5,24.0,2.57
18215,UF1F89B,11,221.07000000000005,9,2,1556.93,1778.0
18216,UA849A2,11,1.0,6,5,37999.0,38000.0
18217,UEB4C57,11,-13054.67,9,2,13590.37,535.7
18218,UA06987,11,556.04,7,4,395.96000000000004,952.0
18219,U03B4DE,11,-3732.8299999999995,9,2,5982.88,2250.05
18220,UE88462,11,-41620.92,8,3,47750.92,6130.0
18221,U864BAA,11,25373.84,5,6,60658.89,86032.73000000001
18222,UEF42A7,11,-824.5400000000005,8,3,16519.9,15695.359999999999
18223,U41DD54,11,5832.23,9,2,15227.73,21059.96
18224,UA0847D,11,-1630.56,9,2,2841.41,1210.85
18225,UF06826,11,10639.939999999984,5,6,140302.86,150942.8
18226,UD8B36A,11,8162.700000000001,9,2,649.0,8811.7
18227,U53C213,11,3924.17,9,2,16375.83,20300.0
18228,U39B1EC,11,-710.75,9,2,1628.2500000000002,917.5
18229,U94885F,11,6412.67,7,4,2172.26,8584.93
18230,U1B358E,11,-1093.3400000000001,7,4,5347.17,4253.83
18231,UE21E15,11,-109.04000000000005,10,1,109.11000000000004,0.07
18232,UF82E1F,11,1887.9499999999998,8,3,3712.05,5600.0
18233,UCCA678,11,995.0,8,3,12377.0,13372.0
18234,U1B7199,11,498.1999999999999,7,4,1006.5799999999999,1504.78
18235,U8DB936,11,7542.079999999999,8,3,8785.3,16327.38
18236,UE28C3A,11,0.0,7,4,9989.599999999999,9989.6
18237,U3B80F9,11,0.21000000000000796,8,3,400.78999999999996,401.0
18238,UD35435,11,0.010000000000218279,7,4,7500.0,7500.01
18239,UBB7B1C,11,13.0,7,4,83.78,96.78
18240,U44E3C8,11,-17810.260000000002,8,3,45308.26999999999,27498.010000000002
18241,UF88D65,11,38.0,8,3,6590.0,6628.0
18242,U0775D4,11,-18413.58,4,7,282500.0,264086.42000000004
18243,U0016B5,11,712.0,8,3,4988.0,5700.0
18244,UC3D21F,11,-407.8000000000002,9,2,7723.8,7316.0
18245,UDFFA02,11,4615.990000000001,6,5,6284.03,10900.02
18246,U076135,11,-1074.6,9,2,3076.4,2001.8
18247,U3381D6,11,-192.76,4,7,332.76,140.0
18248,UD27D60,11,2135.75,8,3,202.04000000000002,2337.79
18249,UC34FD2,11,6544.36,7,4,11051.810000000001,17596.17
18250,U408C72,11,322.2199999999998,7,4,3427.82,3750.04
18251,U764D4D,11,0.0,8,3,32000.0,32000.0
18252,UF7784C,11,1316.08,9,2,1941.1999999999998,3257.2799999999997
18253,U7908CB,11,-37758.25,7,4,137800.0,100041.75
18254,UE8C8DA,11,354.1199999999999,8,3,1325.88,1680.0
18255,UC35DCE,11,910.4100000000003,5,6,5658.9,6569.3099999999995
18256,U851327,11,12999.6,5,6,8.4,13008.0
18257,U7179D6,11,-78.39999999999999,10,1,78.41999999999999,0.02
18258,UF6283F,11,-440.90999999999997,10,1,610.91,170.0
18259,U255E9B,11,482.17999999999995,8,3,587.82,1070.0
18260,U93AE2B,11,-38.660000000000046,6,5,2077.55,2038.8899999999999
18261,UE5544C,11,-2972.08,7,4,12059.0,9086.92
18262,U79FD07,11,280.8999999999999,9,2,1919.1000000000001,2200.0
18263,U8D5DF0,11,0.11999999999943611,5,6,7036.66,7036.78
18264,U7B2557,11,6775.51,0,11,0.0,6775.51
18265,UABFC20,11,-3701.2100000000005,9,2,3706.3100000000004,5.1
18266,U89E892,11,-2972.0,10,1,3372.0,400.0
18267,U9954D9,11,688.99,7,4,939.97,1628.9599999999998
18268,U1ECFD9,11,21604.13,4,7,25000.0,46604.13
18269,UD55F72,11,-695.0,5,6,6905.38,6210.38
18270,UD46AC8,11,-578.5,7,4,6240.5,5662.0
18271,U7F8539,11,-458.30000000000007,8,3,590.26,131.96
18272,U584F45,11,78656.59,2,9,3487.0,82143.59
18273,UA1C610,11,-14487.73,8,3,20092.73,5605.0
18274,U279C1A,11,-45.8,9,2,179.72,133.92
18275,U4F182E,11,-9631.44,6,5,20025.68,10394.24
18276,U37969D,11,-1909.9799999999996,7,4,6010.0,4100.02
18277,U6EAA12,11,-1899.82,9,2,2823.0,923.1800000000001
18278,U6D90FE,11,-14365.14,4,7,32020.0,17654.86
18279,UAB0892,11,160.23999999999995,7,4,807.4,967.64
18280,UD394F3,11,5296.29,4,7,2263.9,7560.1900000000005
18281,U718D37,11,-398.59999999999997,10,1,453.9,55.3
18282,U1AD92F,11,-4721.669999999999,8,3,5470.669999999999,749.0
18283,UCCA3E4,11,18001.19,4,7,9496.27,27497.460000000003
18284,U3EDEB4,11,-1511.5100000000002,8,3,18377.56,16866.05
18285,U4BA4D7,11,-39340.94,8,3,80560.78,41219.84
18286,UF242B4,11,-15139.14,9,2,15458.55,319.40999999999997
18287,UF1D4EA,11,584.75,4,7,25483.78,26068.53
18288,U8CA158,11,4.0800000000008385,7,4,6334.55,6338.630000000001
18289,U96F73A,11,-19501.6,6,5,55741.6,36240.0
18290,UC04D8D,11,6801.070000000002,4,7,6823.9,13624.970000000001
18291,U3077B5,11,-3000.0,9,2,5724.96,2724.96
18292,U9802E3,11,1859.3200000000006,9,2,10606.380000000001,12465.7
18293,U49A8A2,11,-11280.36,9,2,11781.36,501.0
18294,U98AA6A,11,645.4999999999998,7,4,3885.51,4531.01
18295,UA5DB91,11,-178.85000000000002,6,5,1216.1,1037.25
18296,UF7B272,11,100.35000000000002,9,2,1373.1299999999999,1473.48
18297,UF0DCA9,11,-1625.8200000000002,10,1,1638.92,13.1
18298,UB620D7,11,-5592.06,8,3,14096.56,8504.5
18299,UCC0C7D,11,-240.68000000000006,9,2,1797.6799999999998,1557.0
18300,U4F5D4D,11,118.7,7,4,152.7,271.40000000000003
18301,U05FFB6,11,4595.610000000001,6,5,4346.84,8942.45
18302,UA8068B,11,3.197442310920451e-14,6,5,453.15999999999997,453.16
18303,U038FBE,11,-5097.91,7,4,9339.8,4241.89
18304,UDDF35E,11,4161.91,9,2,7515.1,11677.01
18305,U5A6829,11,-1326.4199999999998,9,2,2826.4199999999996,1500.0
18306,UF0E57B,11,-1238.0,8,3,5863.0,4625.0
18307,U5A3DA7,11,-100.71,7,4,84100.75,84000.04
18308,U853FAE,11,279.1,7,4,441.7,720.8
18309,U35D090,11,36.61999999999999,8,3,476.04,512.66
18310,U22FD2E,11,245.55999999999995,8,3,6754.439999999999,7000.0
18311,U587796,11,44816.0,2,9,182.0,44998.0
18312,UA2EB98,11,-28.389999999999997,9,2,41.800000000000004,13.41
18313,UA91F35,11,-2240.0699999999997,7,4,14219.0,11978.93
18314,U970B18,11,107.0,8,3,1030.0,1137.0
18315,UCB563D,11,-5018.5,9,2,15400.0,10381.5
18316,U928288,11,0.0,8,3,1666.01,1666.01
18317,U2B43B1,11,6822.36,4,7,2052.64,8875.0
18318,U3A01DE,11,6671.67,8,3,3626.6800000000003,10298.349999999999
18319,UCFCFA5,11,0.54,7,4,12009.5,12010.04
18320,UC86467,11,-1293.0,8,3,5508.0,4215.0
18321,UD6B8E8,11,-1489.5100000000002,4,7,24632.670000000002,23143.16
18322,UBEABB0,11,-4000.6900000000023,6,5,134006.0,130005.31
18323,U41B339,11,5905.74,6,5,18677.4,24583.14
18324,UB06FC1,11,6.089999999999984,8,3,238.72000000000003,244.81
18325,UA3D49D,11,28.10000000000008,9,2,754.5899999999999,782.69
18326,UE2E7D9,11,-7616.98,8,3,23433.329999999998,15816.35
18327,UF7BBB7,11,-3412.51,6,5,41998.0,38585.49
18328,U687F78,11,954.0799999999999,4,7,357.92,1312.0
18329,UD403C2,11,321.71000000000004,8,3,4608.09,4929.8
18330,U0E5F68,11,-2234.580000000001,9,2,4266.9800000000005,2032.4
18331,U368895,11,1862.44,4,7,1287.56,3150.0
18332,U8B7680,11,-248.44999999999993,9,2,2431.93,2183.48
18333,UB4D338,11,259.0200000000001,6,5,978.94,1237.96
18334,UE5C904,11,-17496.72,10,1,18496.72,1000.0
18335,UA6FFDA,11,-242.03,7,4,463.15,221.12
18336,U5280A8,11,-582.9999999999999,10,1,784.8999999999999,201.9
18337,U058C5D,11,3026.7999999999993,9,2,24823.2,27850.0
18338,U2683E9,11,527.3300000000002,7,4,2230.8,2758.13
18339,U624841,11,78.08000000000004,9,2,1001.9199999999998,1080.0
18340,U915910,11,-940.9100000000002,8,3,1508.66,567.7499999999999
18341,U7E8DD8,11,-5193.5599999999995,9,2,9743.560000000001,4550.0
18342,U1CCED4,11,36847.530000000006,10,1,21152.47,58000.0
18343,U42AA5C,11,-3999.8999999999996,5,6,14500.0,10500.1
18344,UA2007C,11,-112.82999999999947,7,4,5541.75,5428.92
18345,U629C67,11,3296.359999999986,6,5,333300.0,336596.36
18346,U234912,11,144.01999999999998,5,6,6045.98,6190.0
18347,U5839A8,11,-25.010000000000105,8,3,3096.8399999999997,3071.83
18348,U08C222,11,-1228.5500000000002,8,3,8251.61,7023.0599999999995
18349,UB65440,11,9.059419880941277e-14,8,3,1479.51,1479.51
18350,UB39C3A,11,-216.95,9,2,854.83,637.88
18351,UF6E8DC,11,1455.22,6,5,7325.0,8780.22
18352,U49133E,11,188.82000000000014,9,2,2322.52,2511.34
18353,U6F8359,11,3656.4,9,2,4552.1,8208.5
18354,UCD7D68,11,0.0,8,3,1515.94,1515.94
18355,UE641A2,11,50.00000000000182,5,6,31904.629999999997,31954.629999999997
18356,U3E7BE6,11,516.4799999999997,10,1,1283.52,1800.0
18357,U2E1519,11,10.139999999999954,9,2,313.49,323.63
18358,UD59FFE,11,-4302.79,8,3,10326.0,6023.21
18359,U6A7068,11,13.060000000000002,7,4,102.98,116.03999999999999
18360,U18B14F,11,4929.0,4,7,8301.0,13230.0
18361,UF5D4C1,11,1.3900000000000148,5,6,763.82,765.21
18362,U05183D,11,-71148.1,8,3,73703.8,2555.7
18363,UD2F303,11,-41.63000000000008,10,1,2041.63,2000.0
18364,U374E62,11,-9.85878045867139e-14,9,2,2204.6600000000008,2204.66
18365,UE03574,11,8434.25,5,6,16405.86,24840.11
18366,U1F2748,11,1778.4499999999998,9,2,2670.5499999999997,4449.0
18367,UA3E45A,11,1728.3099999999995,6,5,17661.69,19390.0
18368,U630E20,11,-1319.8100000000002,9,2,1419.8600000000001,100.05
18369,U371D21,11,236.51,5,6,8527.01,8763.52
18370,U2ECC88,11,20.0,6,5,20000.0,20020.0
18371,U54361C,11,-139.0,5,6,3931.3300000000004,3792.33
18372,UEB57D3,11,-1.5631940186722204e-13,9,2,4316.14,4316.139999999999
18373,UD42AEC,11,3669.2999999999993,8,3,15837.7,19507.0
18374,U3BA067,11,-13017.0,10,1,21917.0,8900.0
18375,U767AB1,11,0.9300000000001272,8,3,1320.33,1321.26
18376,U39FD8F,11,28.739999999999306,8,3,4778.16,4806.9
18377,U5C3669,11,-1067.01,9,2,1606.0099999999998,539.0
18378,U77C0A2,11,-164.35999999999999,9,2,395.96000000000004,231.6
18379,UE2BC0E,11,1.0800000000031957,6,5,49056.6,49057.68000000001
18380,UD4DA19,11,45.56,8,3,281.44000000000005,327.0
18381,UF661CC,11,0.6700000000008401,6,5,8698.1,8698.77
18382,UAA01B0,11,-3517.8199999999997,6,5,4980.29,1462.4700000000003
18383,UB64A6D,11,60.16,6,5,246.97000000000003,307.13
18384,UF63CFF,11,-137.94,9,2,153.60999999999999,15.67
18385,U61B6CA,11,246.61999999999898,7,4,20138.0,20384.62
18386,U600A00,11,-12165.82,6,5,62890.0,50724.17999999999
18387,UACB2D0,11,-7221.0,10,1,14788.0,7567.0
18388,U0F1847,11,179.3900000000001,7,4,1794.3,1973.69
18389,U1E5502,11,-43051.05,5,6,59600.0,16548.95
18390,UFE3D77,11,-3613.0,8,3,63673.0,60060.0
18391,U8F48B9,11,-2463.9,10,1,2558.9,95.0
18392,U65D38D,11,-936.6600000000001,10,1,1976.66,1040.0
18393,U1DB351,11,223.18999999999997,9,2,55.250000000000014,278.44
18394,U74B97D,11,5724.42,7,4,6541.700000000001,12266.119999999999
18395,U665D25,11,155.55000000000052,8,3,5567.7,5723.250000000001
18396,U1A1D7A,11,14722.900000000001,9,2,26819.100000000002,41542.0
18397,U50C352,11,-4223.0,7,4,7819.27,3596.27
18398,UD2E89E,11,493.61,9,2,683.98,1177.5900000000001
18399,UF67251,11,2422.25,5,6,6575.2699999999995,8997.52
18400,U061FA5,11,20.25,8,3,169.85,190.1
18401,U999D5B,11,1211.8200000000002,7,4,548.8199999999999,1760.6399999999999
18402,U9A18CB,11,-4843.400000000001,9,2,11337.2,6493.799999999999
18403,UD44C4F,11,-33803.0,7,4,47034.28,13231.279999999999
18404,U9F9155,11,-18.0,7,4,70018.0,70000.0
18405,U7CE431,11,0.8400000000000318,5,6,1106.0,1106.8400000000001
18406,U670550,11,-13411.2,6,5,25313.440000000002,11902.24
18407,UC90F67,11,1450.25,6,5,9150.0,10600.25
18408,UD9231C,11,-526.8299999999999,6,5,12600.0,12073.17
18409,UB580A0,11,-299.79999999999995,9,2,849.01,549.21
18410,UC01443,11,-20604.43,9,2,21604.43,1000.0
18411,UD006A8,11,34023.01,6,5,630.0,34653.01
18412,U1501A2,11,1390.0,8,3,6060.0,7450.0
18413,UA62713,11,4892.3499999999985,7,4,21507.1,26399.45
18414,U84E9E5,11,3159.2000000000007,8,3,22269.8,25429.0
18415,U004DB9,11,-187.75000000000006,9,2,700.82,513.07
18416,U860B63,11,-14.07000000000005,9,2,1044.43,1030.3600000000001
18417,U661B1E,11,704.3000000000002,9,2,4345.7,5050.0
18418,UF471D6,11,-361.59,9,2,361.71999999999997,0.13
18419,U27436B,11,7262.65,6,5,2579.5,9842.15
18420,UC8F5A0,11,-1393.67,2,9,4084.33,2690.6600000000003
18421,U5ECA64,11,13.099999999999909,5,6,4261.12,4274.219999999999
18422,U58F096,11,3090.2000000000007,9,2,2464.34,5554.540000000001
18423,UD42F61,11,855.0099999999984,9,2,29443.99,30299.0
18424,U584090,11,3565.0,6,5,55282.0,58847.0
18425,U3571D2,11,90.0,8,3,696.4200000000001,786.4200000000001
18426,U12B3A8,11,544.97,8,3,1088.4099999999999,1633.38
18427,U23EE02,11,665.0,7,4,7695.0,8360.0
18428,U31C431,11,-6555.709999999999,8,3,23013.4,16457.690000000002
18429,U2A1875,11,-5816.179999999998,9,2,25108.94,19292.760000000002
18430,UDF9B27,11,125.36999999999995,7,4,1374.84,1500.21
18431,U6286A9,11,0.0,9,2,6000.0,6000.0
18432,U21A327,11,-63.899999999999956,10,1,572.2,508.3
18433,UEF6F8B,11,81.25999999999999,9,2,722.74,804.0
18434,U41C173,11,1191.44,6,5,5377.29,6568.73
18435,UAB69AA,11,-7668.539999999999,8,3,20167.52,12498.98
18436,UD711FD,11,7025.240000000002,6,5,7568.1900000000005,14593.43
18437,UF086C7,11,4887.13,5,6,12340.67,17227.8
18438,UCCCBE6,11,-9330.27,6,5,16247.74,6917.469999999999
18439,U4FD472,11,177.34000000000015,8,3,5501.5,5678.84
18440,U668864,11,-179.89000000000004,5,6,1196.2,1016.31
18441,U57700C,11,-17066.7,10,1,19666.7,2600.0
18442,UCF3219,11,320.1,6,5,2455.0,2775.1
18443,UCC3F88,11,-1073.8600000000001,10,1,1723.8600000000001,650.0
18444,U99C078,11,140.0,7,4,1586.0,1726.0
18445,UD47AD6,11,-2020.7199999999993,4,7,20900.0,18879.28
18446,UE546E3,11,130.03999999999996,8,3,10605.0,10735.04
18447,UF044FE,11,-16573.47,11,0,16573.47,0.0
18448,U462280,11,-2766.92,7,4,4376.3,1609.3799999999999
18449,U6BA981,11,63.00999999999999,7,4,3628.99,3692.0
18450,U365930,11,74.13999999999987,6,5,6807.68,6881.82
18451,U127C9A,11,171.33000000000015,9,2,1440.33,1611.66
18452,U9A06D7,11,135.0,6,5,1145.0,1280.0
18453,U627BE8,11,15272.279999999999,6,5,7828.0,23100.28
18454,UE5EB14,11,163.69000000000005,8,3,1243.69,1407.38
18455,U823C0A,11,-11047.279999999999,9,2,11261.279999999999,214.0
18456,U5EC91C,11,-1139.0,8,3,13205.0,12066.0
18457,UB0A585,11,-355.9899999999907,7,4,117764.78,117408.79000000001
18458,U98D02A,11,1.1600000000000819,7,4,2085.85,2087.01
18459,U134268,11,-0.12000000000000158,6,5,23.209999999999997,23.090000000000003
18460,U646BB3,11,-6675.51,10,1,16075.51,9400.0
18461,U643E85,11,2488.51,8,3,3327.8599999999997,5816.37
18462,UBC2D64,11,44.100000000000136,8,3,4905.6,4949.7
18463,UFED928,11,342.0600000000002,8,3,8738.54,9080.600000000002
18464,U014ABE,11,13202.949999999997,2,9,12641.12,25844.07
18465,U62716A,11,0.0,9,2,1865.6599999999999,1865.6599999999999
18466,UCF227E,11,9859.919999999998,4,7,8683.2,18543.12
18467,U173FB3,11,-20.179999999999836,9,2,1112.1799999999998,1092.0
18468,UCBD34B,11,-3016.919999999999,8,3,12049.0,9032.08
18469,U468114,11,223534.37,1,10,5920.0,229454.37
18470,U245B6F,11,-1543.6400000000003,10,1,2547.4300000000003,1003.79
18471,U457411,11,485.67999999999995,8,3,114.32,600.0
18472,U42E11C,11,1.35,9,2,19.949999999999996,21.3
18473,U182A70,11,-350.69000000000034,8,3,21246.989999999998,20896.300000000003
18474,UE8363B,11,9761.62,5,6,4004.5,13766.12
18475,UF81EF3,11,-48.039999999999964,9,2,1199.0,1150.96
18476,U623DAD,11,-5379.13,9,2,8316.13,2937.0
18477,U0F5B47,11,-515.99,9,2,637.99,122.0
18478,U0190A7,11,585.2400000000001,9,2,1797.64,2382.88
18479,UF4D8BE,11,2705.2299999999996,7,4,38483.77,41189.0
18480,UF2CE4F,11,-2189.9,10,1,4194.9,2005.0
18481,U83C608,11,101.0,7,4,23731.0,23832.0
18482,UC0D166,11,-183.06,10,1,184.06,1.0
18483,U848BC2,11,-94.27,9,2,157.49,63.22
18484,U607561,11,-7201.4,10,1,7203.4,2.0
18485,U0A0FEA,11,3250.0,7,4,12370.66,15620.66
18486,U6BB9CA,11,-900.0,7,4,19900.0,19000.0
18487,U16D142,11,-1798.0299999999997,2,9,9508.029999999999,7710.0
18488,U94B49A,11,-2895.0200000000004,7,4,6396.02,3501.0
18489,UA8299E,11,-80.98999999999978,6,5,10808.13,10727.14
18490,UD209D2,11,-18.10000000000001,10,1,282.31,264.21
18491,UD47720,11,-157.2800000000002,10,1,2864.46,2707.18
18492,U390734,11,47512.31,6,5,8364.42,55876.729999999996
18493,UD15E88,11,1.3500311979441904e-12,9,2,10569.240000000002,10569.240000000002
18494,U7A4D07,11,6579.480000000001,8,3,4796.52,11376.0
18495,UCB0ECD,11,-2777.3299999999995,10,1,2777.3399999999997,0.01
18496,UD6B3E0,11,1517.47,4,7,4490.07,6007.54
18497,U78A2B0,11,-7616.76,8,3,13769.130000000001,6152.37
18498,U32970A,11,-8.0,6,5,564.0,556.0
18499,U67190E,11,136.05000000000035,9,2,5403.3,5539.35
18500,U1C8B61,11,120.00999999999999,6,5,1874.82,1994.83
18501,U5AF2ED,11,-10776.0,9,2,11713.0,937.0
18502,U57E63D,11,478.4399999999998,6,5,657.5400000000001,1135.98
18503,UC92F48,11,561.0,4,7,3739.0,4300.0
18504,U93FDF0,11,1.8099999999999454,7,4,3620.6099999999997,3622.42
18505,U27D11D,11,1395.3099999999997,8,3,304.88,1700.1899999999998
18506,UF87902,11,-317.63,8,3,3440.37,3122.74
18507,UFCA718,11,7879.139999999999,6,5,4383.84,12262.98
18508,U2BA014,11,-4539.02,9,2,5439.02,900.0
18509,UBF5938,11,-2.0900000000000407,6,5,280.46,278.37
18510,UC61EC2,11,400.02,5,6,3000.0,3400.02
18511,U3BA53E,11,2065.059999999995,8,3,19183.72,21248.779999999995
18512,U303D09,11,25.279999999999948,9,2,3000.2100000000005,3025.49
18513,UE1A42B,11,-2631.35,9,2,5092.68,2461.33
18514,UC06654,11,167.7400000000001,8,3,1122.2600000000002,1290.0
18515,UE896FA,11,-41.610000000000014,6,5,173.62,132.01
18516,U2404DC,11,63.110000000000014,6,5,7937.820000000001,8000.93
18517,U4002CB,11,11290.2,4,7,11315.0,22605.2
18518,U91FD1E,11,-2390.38,9,2,10690.380000000001,8300.0
18519,U0D4472,11,-1076.3200000000002,10,1,1843.32,767.0
18520,UB71038,11,-0.010000000000019327,8,3,538.96,538.95
18521,U8CDB14,11,17.0,6,5,39764.0,39781.0
18522,UF12E20,11,-14139.68,10,1,14139.689999999999,0.01
18523,U1EFEDE,11,2753.3500000000004,9,2,3720.75,6474.1
18524,U762693,11,807.6999999999998,8,3,7092.3,7900.0
18525,UD8B4C1,11,-768.0200000000002,8,3,4507.28,3739.2599999999998
18526,U622755,11,-683.9399999999996,6,5,10583.939999999999,9900.0
18527,UD96785,11,2365.03,5,6,7443.209999999999,9808.24
18528,UE9C816,11,-233.92999999999995,7,4,1887.86,1653.9299999999998
18529,U28FD55,11,661.0,5,6,2768.09,3429.09
18530,U88F57F,11,-5028.54,6,5,6700.02,1671.48
18531,UEC8594,11,244.55999999999997,8,3,2410.4100000000003,2654.97
18532,UF1E440,11,-220.37999999999988,7,4,7996.54,7776.16
18533,U57B68C,11,427.76,8,3,1636.0,2063.76
18534,U25230A,11,-6.71999999999997,6,5,529.8299999999999,523.11
18535,U57710C,11,104.80000000000001,9,2,314.1,418.9
18536,U560E3D,11,-50.67,9,2,51.87,1.2
18537,U4F6FF1,11,-6072.27,10,1,6072.280000000001,0.01
18538,UA267B3,11,45.03999999999995,6,5,1579.05,1624.09
18539,U1F3212,11,11383.08,9,2,58400.92,69784.0
18540,U11CCC1,11,36949.53,5,6,10566.0,47515.53
18541,U6FEA0C,11,2639.1499999999996,6,5,12533.740000000002,15172.89
18542,U7B4F4E,11,0.0,6,5,5901.3,5901.3
18543,U197EA2,11,-191.92,10,1,191.94000000000003,0.02
18544,U5BA5B2,11,-17.63000000000011,6,5,1405.2,1387.57
18545,U403625,11,1083.2600000000002,7,4,1556.74,2640.0
18546,U2FC238,11,2498.9800000000005,4,7,202.82999999999998,2701.8100000000004
18547,U08B929,11,29.830000000000155,9,2,1245.17,1275.0
18548,U1925B0,11,-1691.01,10,1,1701.01,10.0
18549,UE5B13A,11,2368.5099999999998,5,6,5932.52,8301.03
18550,UC3C8BC,11,-1975.56,6,5,2635.56,660.0
18551,U8B0C43,11,1912.21,9,2,937.7899999999998,2850.0
18552,U19913A,11,100.0,6,5,37.0,137.0
18553,U5FD49B,11,-4999.999999999998,7,4,46798.4,41798.4
18554,U3C1E8B,11,2350.0,6,5,23650.0,26000.0
18555,UB0EABA,11,-588.98,8,3,1545.52,956.54
18556,UDA3F47,11,91.04999999999995,7,4,7871.0,7962.05
18557,U778763,11,1182.1399999999996,6,5,8069.06,9251.2
18558,UD07BD9,11,-7593.209999999999,8,3,12605.65,5012.4400000000005
18559,UDA6BF9,11,-236.79000000000002,7,4,414.68,177.89000000000001
18560,U4628B8,11,-2496.95,6,5,4978.35,2481.4
18561,U6CA4DF,11,376.34999999999945,8,3,6473.650000000001,6850.0
18562,U684CEB,11,6345.32,5,6,29210.0,35555.32
18563,UFCF1D4,11,-10228.64,4,7,28300.0,18071.36
18564,U75407A,11,-3407.24,11,0,3407.24,0.0
18565,UA37035,11,20081.760000000002,4,7,58400.0,78481.76000000001
18566,UB61455,11,8089.6,5,6,1661.0,9750.599999999999
18567,U222CDB,11,458.5999999999999,8,3,5560.879999999999,6019.48
18568,U7131DB,11,-4501.0,5,6,25778.0,21277.0
18569,UD93B13,11,91916.12,1,10,5500.0,97416.12
18570,UE033EC,11,-116.98999999999995,8,3,548.11,431.12
18571,U8D37CF,11,18273.3,6,5,28080.0,46353.3
18572,UF74CCB,11,-25.959999999999127,7,4,22298.35,22272.39
18573,U051E84,11,-3.9099999999998545,8,3,932.1999999999999,928.29
18574,U34AA16,11,155.17999999999998,8,3,511.64,666.82
18575,UAADE96,11,5337.699999999999,8,3,5522.56,10860.259999999998
18576,U9C3077,11,-3375.2300000000005,8,3,4130.16,754.9300000000001
18577,U50F1A4,11,985.3500000000004,6,5,10615.46,11600.810000000001
18578,U354F60,11,-3618.75,6,5,7089.04,3470.29
18579,U1379EB,11,-456.04999999999995,9,2,1935.3700000000003,1479.3200000000002
18580,UF527A5,11,12767.19,7,4,13862.16,26629.35
18581,U9BB786,11,184.25000000000023,6,5,2614.18,2798.4300000000003
18582,U8A050F,11,3609.0,8,3,13902.0,17511.0
18583,U56BCDB,11,281.9,9,2,1204.12,1486.02
18584,UF25617,11,-1895.0,9,2,2097.0,202.0
18585,U943001,11,209.25,6,5,1079.6,1288.85
18586,U02A0A8,11,24.549999999999784,9,2,5051.45,5076.0
18587,U717CA5,11,2827.03,8,3,2417.3199999999997,5244.35
18588,U4E74AB,11,18.319999999999997,9,2,696.9799999999999,715.3
18589,U73977A,11,-3197.959999999999,10,1,7197.959999999999,4000.0
18590,UC73AB4,11,12217.189999999999,6,5,4302.11,16519.3
18591,U24E1BA,11,-25499.0,7,4,33866.0,8367.0
18592,U5A886C,11,156.1899999999996,7,4,13598.4,13754.59
18593,UF32158,11,9000.0,1,10,9000.0,18000.0
18594,U5E16B0,11,-103.58,9,2,275.58,172.0
18595,U3B362B,11,122.89999999999986,9,2,4429.1,4552.0
18596,U4ABA37,11,6.000000000000127,8,3,5641.999999999999,5648.0
18597,U501443,11,-6159.249999999999,6,5,15659.72,9500.470000000001
18598,UD6269C,11,45.20999999999998,6,5,1233.8,1279.01
18599,UFEA888,11,-350.96,9,2,2137.96,1787.0
18600,U5A928A,11,2792.3100000000004,7,4,492.9,3285.21
18601,UB1B323,11,693.6199999999999,9,2,7009.0,7702.62
18602,U70C250,11,29231.0,2,9,32400.0,61631.0
18603,UE663BA,11,0.0,8,3,668.7200000000001,668.72
18604,U8758D7,11,-19404.5,9,2,45395.5,25991.0
18605,U108BBE,11,-50.81999999999999,8,3,370.22,319.4
18606,U7E4A64,11,70.94,9,2,417.08000000000004,488.02
18607,UD4481B,11,-1303.9,8,3,4030.67,2726.77
18608,U2B2B21,11,52894.469999999994,7,4,17421.48,70315.95
18609,U3AAB98,11,-877.0,4,7,5811.0,4934.0
18610,UEF2A4D,11,6690.88,6,5,2066.8,8757.68
18611,U05843C,11,9.210000000000036,9,2,1858.79,1868.0
18612,UC4F041,11,-1663.0,10,1,3333.0,1670.0
18613,UE95205,11,6765.73,8,3,1597.84,8363.57
18614,U84714B,11,-167.61,7,4,416.68,249.07
18615,UB0971C,11,-6846.0,9,2,33265.66,26419.66
18616,U421AD2,11,74.40000000000009,6,5,1125.62,1200.02
18617,U50DCA7,11,-2068.5499999999997,10,1,4121.549999999999,2053.0
18618,UAFB276,11,396.09000000000026,8,3,2991.3199999999997,3387.41
18619,U840DEE,11,17355.960000000003,6,5,1319.62,18675.58
18620,U4970B0,11,-207.30000000000015,9,2,2244.08,2036.78
18621,UF8EB17,11,8.0,5,6,34002.0,34010.0
18622,UEAA2F3,11,137.45999999999998,7,4,163.13000000000002,300.59000000000003
18623,UD8C7AA,11,-123.90000000000009,8,3,2203.02,2079.12
18624,U1A6B39,11,-27102.7,9,2,59195.0,32092.3
18625,UC43C2B,11,839.8,9,2,2267.16,3106.96
18626,UA38DA4,11,-569.3000000000003,9,2,31908.68,31339.38
18627,UA87A29,11,-207.73999999999998,11,0,207.73999999999998,0.0
18628,U062415,11,-234.34000000000003,9,2,521.4,287.06
18629,UEE040E,11,1252.340000000002,6,5,63864.299999999996,65116.64
18630,UE7C9DD,11,174.35999999999967,6,5,7512.83,7687.1900000000005
18631,U391CB6,11,3814.6499999999996,7,4,7385.42,11200.07
18632,UB352D4,11,-8.710000000000003,8,3,460.9500000000001,452.24
18633,U68C351,11,1205.11,8,3,844.8900000000001,2050.0
18634,UBB43EC,11,7136.620000000001,7,4,17237.68,24374.3
18635,UFDA7FD,11,-817.0100000000002,7,4,3719.51,2902.5
18636,UFFEBE3,11,-500.0,6,5,3069.5,2569.5
18637,U56FC45,11,-6086.15,6,5,40226.75,34140.6
18638,UC0B465,11,-4050.21,10,1,5369.14,1318.93
18639,UFF5E78,11,-1.7499999999990905,8,3,9434.189999999999,9432.439999999999
18640,U184AA9,11,-1225.22,7,4,3453.74,2228.52
18641,U2E5396,11,-5850.71,8,3,8114.599999999999,2263.89
18642,U198A2A,11,4509.450000000001,4,7,74802.58,79312.03
18643,U4E54F2,11,100.36999999999999,6,5,1599.6799999999998,1700.05
18644,U8662FC,11,4091.6499999999996,5,6,4312.51,8404.16
18645,U10A194,11,4182.669999999998,5,6,43741.34,47924.01
18646,UD81182,11,-20000.0,2,9,40000.0,20000.0
18647,UBD701C,11,-13.100000000000009,6,5,7390.9,7377.8
18648,UF65BB0,11,-12400.100000000002,6,5,12627.0,226.9
18649,UA5A12E,11,-19.900000000000002,9,2,109.89999999999999,90.0
18650,U7E12BC,11,-4549.0,8,3,20742.8,16193.8
18651,U00CBC0,11,22.809999999999945,9,2,3454.92,3477.73
18652,U448ABD,11,-18254.3,10,1,36255.600000000006,18001.3
18653,U1D4951,11,25.849999999998545,5,6,43600.020000000004,43625.869999999995
18654,U6864D3,11,-2400.0,7,4,8500.0,6100.0
18655,U57066A,11,42.440000000000055,6,5,3970.56,4013.0
18656,U0458A3,11,-25.88000000000011,8,3,2534.88,2509.0
18657,U730E5F,11,1416.0,7,4,11384.0,12800.0
18658,U998BF2,11,1335.0,8,3,10120.0,11455.0
18659,UD4ACE3,11,7895.04,7,4,20670.0,28565.04
18660,U12493C,11,-1132.0800000000002,8,3,2264.16,1132.08
18661,U4B7538,11,-440.47999999999996,7,4,2285.22,1844.74
18662,UCEDE6C,11,-780.8000000000002,8,3,12584.800000000001,11804.0
18663,U4D4912,11,-4553.220000000001,7,4,8026.610000000001,3473.3900000000003
18664,U3FAF35,11,-19.109999999999673,5,6,8699.0,8679.89
18665,UF0D898,11,54.0,7,4,7918.89,7972.889999999999
18666,U5E9453,11,-309.55999999999995,7,4,1869.0,1559.44
18667,U530DB0,10,299.5,4,6,1036.0,1335.5
18668,U1B7023,10,-461.7300000000032,7,3,38188.93,37727.2
18669,UF50FF9,10,0.0,6,4,60000.0,60000.0
18670,UEBDF09,10,0.0,6,4,8600.0,8600.0
18671,U72F1F2,10,-56048.060000000056,4,6,727000.0,670951.94
18672,UA8FDF4,10,-970.0699999999999,6,4,1487.1599999999999,517.09
18673,U9B8642,10,378.78,7,3,2792.0600000000004,3170.84
18674,UC5F0CD,10,-4510.94,9,1,4610.94,100.0
18675,U6C3096,10,-224.89999999999998,8,2,1067.0,842.1
18676,U06C9F6,10,6170.17,6,4,2129.83,8300.0
18677,U08FAB9,10,-7.809999999999993,4,6,966.76,958.95
18678,UEDDA98,10,-2500.0,7,3,22000.0,19500.0
18679,U7717C6,10,155.83000000000084,9,1,3919.629999999999,4075.46
18680,U341F22,10,-10013.56,7,3,21997.28,11983.720000000001
18681,U3CAFD9,10,-872.94,8,2,1021.84,148.9
18682,U2BB3DE,10,-2452.8199999999997,8,2,9222.82,6770.0
18683,U5D2470,10,2.7799999999997453,4,6,8732.0,8734.779999999999
18684,UE6CAA3,10,-1171.6799999999998,9,1,3171.68,2000.0
18685,U757A1F,10,3170.0,4,6,51305.0,54475.0
18686,UE9C932,10,-1284.84,7,3,2685.0,1400.1599999999999
18687,UBFCC27,10,20004.0,5,5,135150.0,155154.0
18688,UC20E6A,10,-865.1800000000001,9,1,866.1600000000001,0.98
18689,U668F58,10,108.17000000000002,6,4,390.0,498.17
18690,U34CFED,10,-423.87,6,4,431.67,7.8
18691,UEFFC64,10,-8989.08,8,2,9489.08,500.0
18692,UCB16C6,10,1797.77,8,2,633.61,2431.38
18693,UAF0129,10,-2278.55,10,0,2278.55,0.0
18694,UCC59A0,10,-8230.0,7,3,37490.92,29260.92
18695,U80BC21,10,1220.25,7,3,3830.0,5050.25
18696,U79F243,10,-1930.6599999999999,8,2,2442.16,511.5
18697,UDB7540,10,-1432.79,7,3,1908.71,475.91999999999996
18698,UD63EC7,10,425.74,8,2,184.26,610.0
18699,UDD1D09,10,-788.98,8,2,1388.98,600.0
18700,U1F3E92,10,-818.0,8,2,6818.0,6000.0
18701,U408E5C,10,-1300.0,4,6,7999.0,6699.0
18702,U19F142,10,69.0200000000001,8,2,2103.98,2173.0
18703,U2C6DDA,10,-1383.14,9,1,1648.14,265.0
18704,U50B5DC,10,188.88999999999987,5,5,1158.22,1347.11
18705,UEFC4F5,10,-8333.0,5,5,15061.65,6728.65
18706,U7209D4,10,-302.7700000000002,6,4,1689.2,1386.43
18707,U160B5D,10,22.850000000000136,8,2,1327.6,1350.45
18708,U005D0E,10,-3733.0,8,2,10443.0,6710.0
18709,U5DF36E,10,165.56,8,2,1172.72,1338.28
18710,U8DF448,10,10.379999999999995,8,2,736.6600000000001,747.04
18711,UF8C185,10,-2820.7000000000003,6,4,12232.19,9411.49
18712,U5AF6E2,10,328.2,8,2,623.8,952.0
18713,U983ABE,10,1.0100000000002183,4,6,5994.0599999999995,5995.07
18714,U68B38D,10,5894.86,5,5,1800.0,7694.86
18715,U44EF6C,10,385.0,8,2,8215.0,8600.0
18716,UE1D870,10,-13.940000000000055,6,4,2200.06,2186.12
18717,UBD0F6A,10,-6052.82,9,1,7732.82,1680.0
18718,U169449,10,-10406.0,8,2,15353.6,4947.6
18719,U3C6F67,10,-4841.68,9,1,10841.68,6000.0
18720,U2171D0,10,6713.549999999999,3,7,42537.45,49251.0
18721,UE33917,10,-0.5999999999992696,8,2,10000.599999999999,10000.0
18722,U6C69EE,10,255.17000000000002,7,3,1027.83,1283.0
18723,U5CD6AE,10,3277.27,7,3,1020.7900000000001,4298.0599999999995
18724,U25A766,10,2013.7899999999995,7,3,162.4,2176.19
18725,UA11503,10,1.4210854715202004e-14,7,3,265.7,265.7
18726,U354081,10,-2896.0,8,2,12122.0,9226.0
18727,U4F87C0,10,30002.44,3,7,30958.0,60960.44
18728,U5661C4,10,-794.0099999999996,8,2,3308.58,2514.57
18729,U550C25,10,0.010000000000218279,6,4,4700.860000000001,4700.870000000001
18730,U83729E,10,118.0,4,6,8367.0,8485.0
18731,UEA7EE6,10,-3197.6099999999997,8,2,3397.62,200.01
18732,U8FE3DE,10,3376.21,6,4,4600.0,7976.21
18733,U0D9128,10,20.640000000000327,7,3,3829.4999999999995,3850.1400000000003
18734,U06D24F,10,-887.3499999999999,10,0,887.3499999999999,0.0
18735,UD083F3,10,-340.1700000000003,8,2,3517.4,3177.23
18736,U82446F,10,-230.9399999999996,7,3,11197.0,10966.060000000001
18737,U165DA8,10,-337.3699999999999,7,3,728.0,390.63
18738,U07F7D8,10,-327.7300000000014,6,4,10580.01,10252.279999999999
18739,U7469BF,10,-18425.08,4,6,18925.66,500.58000000000004
18740,U92E9EC,10,122.0,4,6,3128.0,3250.0
18741,UAF385A,10,-192.89999999999998,8,2,639.79,446.89
18742,UFAF8A5,10,-3558.0,8,2,7171.859999999999,3613.8599999999997
18743,UD5BC4E,10,-289.83,7,3,392.51,102.68
18744,UC66C54,10,-5219.34,8,2,10919.34,5700.0
18745,U62F575,10,31.93999999999869,6,4,31149.52,31181.46
18746,U8E8517,10,21.519999999999854,5,5,9078.59,9100.11
18747,UD391C3,10,4261.24,4,6,415.32,4676.5599999999995
18748,U190413,10,-32883.48,10,0,32883.48,0.0
18749,UE6EBD2,10,108.00999999999999,6,4,702.01,810.02
18750,U5DAF20,10,-964.3,8,2,2595.5800000000004,1631.28
18751,U55DF24,10,-13.99,7,3,3527.0,3513.01
18752,U7DA534,10,194.35999999999976,7,3,4350.16,4544.52
18753,U3BB443,10,213.2000000000001,7,3,2612.7400000000002,2825.94
18754,U37EBD2,10,-7949.280000000001,6,4,7976.01,26.729999999999997
18755,U697111,10,5.209999999999988,4,6,1249.32,1254.53
18756,U1E0744,10,-690.66,6,4,11861.66,11171.0
18757,UA00EF8,10,-2631.0,8,2,4987.12,2356.12
18758,UCF9C36,10,-172.0,7,3,14868.0,14696.0
18759,UE1E891,10,-2219.08,7,3,5118.24,2899.16
18760,U9FA74C,10,309.24000000000007,7,3,4233.94,4543.18
18761,UD5FFFB,10,33.19999999999982,6,4,16233.2,16266.4
18762,U083C1E,10,-1785.19,7,3,1825.25,40.06
18763,U41B148,10,-172.5,8,2,328.5,156.0
18764,U1DB8A0,10,19949.93,5,5,2150.42,22100.350000000002
18765,UBA0AA6,10,-971.7999999999998,10,0,971.7999999999998,0.0
18766,U64F84A,10,-141.98999999999998,8,2,160.04,18.05
18767,U690A3D,10,-286.6,8,2,334.1,47.5
18768,UC2C5C7,10,230.52999999999975,8,2,11969.470000000001,12200.0
18769,U0248E8,10,-683.0400000000001,10,0,683.0400000000001,0.0
18770,UFCB2BB,10,-262.47000000000025,7,3,15100.0,14837.529999999999
18771,U6A6330,10,-3140.86,8,2,4140.86,1000.0
18772,U056EAE,10,-247.7399999999968,8,2,21262.84,21015.1
18773,U089ADD,10,-1040.0,3,7,15080.0,14040.0
18774,U6320DA,10,-28.0,5,5,5976.0,5948.0
18775,UA869E2,10,2656.3600000000006,8,2,6143.639999999999,8800.0
18776,U22CC7D,10,432.91999999999996,6,4,1530.0,1962.92
18777,UD59AD1,10,-19353.13,6,4,41896.939999999995,22543.809999999998
18778,UE06123,10,-1.949999999999818,6,4,1677.9,1675.95
18779,U768332,10,1072.7999999999997,6,4,1056.9,2129.7
18780,U098843,10,4147.81,8,2,5672.83,9820.640000000001
18781,U363253,10,2045.9699999999998,4,6,5850.0,7895.969999999999
18782,UD33D88,10,-10013.700000000003,8,2,10368.210000000001,354.51
18783,UEB276B,10,-30.999999999999886,6,4,1389.3,1358.3
18784,U7089EA,10,-934.35,9,1,3712.7,2778.35
18785,UCA2234,10,-15181.589999999998,9,1,19316.31,4134.72
18786,U0F381E,10,1620.3,5,5,1450.15,3070.45
18787,UED1665,10,8542.0,0,10,0.0,8542.0
18788,U23CE6B,10,380.74,8,2,939.26,1320.0
18789,UFCACDC,10,-17760.0,6,4,19480.0,1720.0
18790,U597E6A,10,95.07,5,5,115.0,210.07
18791,UBDBEA7,10,47.26999999999998,6,4,2247.73,2295.0
18792,UAEF3B3,10,-9392.09,8,2,9393.0,0.91
18793,U2B454D,10,-3899.05,7,3,6520.0,2620.95
18794,U1782A9,10,-1982.0,8,2,10382.0,8400.0
18795,U21E8B2,10,1733.2399999999996,7,3,974.2,2707.4399999999996
18796,UD579A5,10,9396.099999999999,7,3,1362.54,10758.64
18797,U7DB0AB,10,-1942.15,6,4,3514.61,1572.46
18798,UE73AFB,10,4156.580000000002,7,3,12063.15,16219.73
18799,UE206EE,10,-15832.550000000003,10,0,15832.550000000003,0.0
18800,UFE2FDB,10,4879.71,5,5,1042.3,5922.01
18801,U00CFBB,10,1519.5700000000002,6,4,2067.8,3587.3700000000003
18802,U169027,10,51705.0,5,5,27446.36,79151.36
18803,UDE7E3E,10,-758.7900000000001,8,2,2358.79,1600.0
18804,U5C40E7,10,-1258.1499999999999,8,2,1673.6999999999998,415.55
18805,U371A3F,10,-12507.37,8,2,25004.0,12496.63
18806,U943469,10,3320.8699999999994,8,2,307.36,3628.23
18807,U46C239,10,73.76999999999998,8,2,1030.0,1103.77
18808,U67ABE6,10,-43.81000000000017,6,4,2028.61,1984.8
18809,U8246F0,10,2456.8500000000004,8,2,3061.23,5518.08
18810,U58B783,10,6.950000000000728,6,4,22605.0,22611.95
18811,U9A0852,10,213.56,2,8,64.03999999999999,277.6
18812,UC68E25,10,37.0,4,6,21940.0,21977.0
18813,U7ABD9A,10,-3532.3900000000012,10,0,3532.3900000000012,0.0
18814,U53D141,10,614.29,5,5,9175.44,9789.73
18815,U8FC29A,10,-1289.95,7,3,7989.0,6699.05
18816,U3F4347,10,-2576.5999999999995,8,2,2776.5999999999995,200.0
18817,UBFAD4E,10,825.0,8,2,165.05999999999997,990.06
18818,U481975,10,-185.1299999999992,8,2,5999.1,5813.97
18819,UB2FB71,10,-143.89999999999986,8,2,2205.83,2061.9300000000003
18820,U13A26D,10,112.84999999999991,8,2,2201.15,2314.0
18821,U991FE6,10,-5808.72,10,0,5808.72,0.0
18822,UF41CFE,10,-169.29999999999995,7,3,925.05,755.75
18823,U5618A9,10,19903.710000000003,3,7,30006.0,49909.71
18824,U8BF0B2,10,-199.40000000000003,8,2,3485.62,3286.2200000000003
18825,U9CC5F7,10,774.7199999999998,8,2,1922.7800000000002,2697.5
18826,U75CF01,10,-245.11999999999995,8,2,1610.78,1365.6599999999999
18827,U6A25B1,10,-2.810000000000005,4,6,225.11,222.29999999999998
18828,UE1681C,10,-27.5,7,3,7993.3,7965.8
18829,U453CC6,10,-4.32000000000005,5,5,1050.62,1046.3
18830,UDD5808,10,4350.01,7,3,43100.0,47450.01
18831,UF14D4E,10,192.72999999999996,5,5,1202.65,1395.3799999999999
18832,UD5C9F6,10,29890.74,6,4,57658.270000000004,87549.01
18833,U5632FF,10,-401.53000000000003,7,3,790.0600000000001,388.53
18834,U432B43,10,-293.1,6,4,14492.1,14199.0
18835,UBF2218,10,9885.03,7,3,1223.97,11109.0
18836,U1852D1,10,-2915.0,6,4,8437.779999999999,5522.780000000001
18837,U890303,10,62.0,8,2,5050.0,5112.0
18838,U606963,10,-25699.08,4,6,34189.1,8490.02
18839,U6BADF9,10,12276.61,6,4,6604.96,18881.57
18840,U3C63EE,10,0.020000000000095497,5,5,1186.6399999999999,1186.66
18841,UEC715B,10,-7744.699999999999,7,3,20694.699999999997,12950.0
18842,UB6A087,10,28240.0,6,4,72260.0,100500.0
18843,U5B614F,10,-2376.13,4,6,14584.0,12207.869999999999
18844,U1E2ED5,10,-7634.36,6,4,15371.0,7736.64
18845,U854867,10,1869.6200000000008,8,2,8662.92,10532.54
18846,UDBC54E,10,-1631.75,10,0,1631.75,0.0
18847,U4BA70A,10,77.29999999999984,8,2,4423.09,4500.39
18848,U810DCE,10,493.78999999999996,3,7,782.0,1275.79
18849,UAFBFD4,10,-72.80000000000018,6,4,10072.8,10000.0
18850,UFA988A,10,-4294.23,4,6,14636.52,10342.29
18851,U1C8251,10,-2688.67,5,5,17688.67,15000.0
18852,U7AD8A6,10,-1242.5299999999988,7,3,14543.609999999997,13301.079999999998
18853,UCDA4AE,10,-1929.7900000000002,8,2,1997.3000000000002,67.51
18854,U372C4B,10,5.684341886080802e-14,8,2,6507.159999999999,6507.16
18855,UB1A89B,10,0.0,6,4,18000.0,18000.0
18856,U7E370D,10,6100.0,5,5,18000.0,24100.0
18857,UA62FA7,10,-138.94,9,1,138.95,0.01
18858,UF4BF21,10,16022.49,7,3,2023.5,18045.989999999998
18859,UD92579,10,77.66000000000022,5,5,2484.8,2562.46
18860,U2B8578,10,-860.0,7,3,8880.0,8020.0
18861,U358151,10,3921.59,3,7,38800.0,42721.59
18862,UF23D1B,10,-416.0500000000002,8,2,1850.17,1434.12
18863,U2385F7,10,-3785.9400000000005,10,0,3785.9400000000005,0.0
18864,U11B590,10,764.7499999999999,8,2,500.35,1265.1
18865,U533D02,10,2.1316282072803006e-14,6,4,549.42,549.42
18866,U458BF7,10,5.0,6,4,26990.0,26995.0
18867,U6C15C8,10,-2877.24,8,2,6977.24,4100.0
18868,UA2579B,10,700.0,6,4,18010.0,18710.0
18869,UBFE6A4,10,8.0,5,5,19003.0,19011.0
18870,UA17D54,10,-28002.27,7,3,32300.92,4298.65
18871,UE9606E,10,-140.98000000000002,8,2,319.9800000000001,179.0
18872,U482418,10,-3599.96,7,3,10683.37,7083.41
18873,UBA3B8E,10,-1970.6899999999996,7,3,19786.8,17816.11
18874,U9D62C6,10,22344.82,4,6,14000.0,36344.82
18875,UCEFE4B,10,1075.02,6,4,1266.41,2341.4300000000003
18876,UDA6422,10,-576.82,10,0,576.82,0.0
18877,UB0784B,10,-567.37,8,2,1484.23,916.86
18878,UE6148C,10,180.00000000000006,4,6,983.34,1163.3400000000001
18879,UEDB2D2,10,228.97000000000003,8,2,659.7,888.67
18880,U8D8175,10,-56.719999999999345,7,3,10090.939999999999,10034.22
18881,UC045C8,10,680.71,6,4,352.31,1033.02
18882,U1C3F97,10,-350.00999999999925,7,3,7550.089999999999,7200.08
18883,UCB862F,10,-1629.87,5,5,9500.0,7870.13
18884,UA8D9A2,10,-174.46000000000004,8,2,3882.0,3707.54
18885,U0B07C6,10,261.7200000000009,8,2,15383.119999999999,15644.84
18886,UEC72C2,10,-2423.1000000000004,7,3,5296.1,2873.0
18887,U7AD0B7,10,5733.080000000001,5,5,15841.45,21574.53
18888,UCC04E2,10,9921.82,5,5,15444.18,25366.0
18889,U707484,10,23.9,8,2,141.1,165.0
18890,U1B136F,10,5120.66,5,5,16479.66,21600.32
18891,U39D262,10,0.8899999999994179,7,3,20193.0,20193.89
18892,U8A0A6F,10,805.6400000000003,6,4,10625.48,11431.119999999999
18893,UF48089,10,-749.4599999999999,9,1,750.1099999999999,0.65
18894,U2B8642,10,300.0,8,2,173.24,473.24
18895,U544D0D,10,-1099.99,4,6,9000.0,7900.01
18896,UE92F86,10,-495.3900000000001,8,2,2540.0,2044.61
18897,U35A070,10,-1715.7200000000003,7,3,10741.720000000001,9026.0
18898,UB7664D,10,-1509.0,9,1,2329.0,820.0
18899,UF46FDE,10,3876.0,8,2,7968.0,11844.0
18900,UDAE1E3,10,304.7200000000005,7,3,2635.25,2939.9700000000003
18901,U007BCC,10,-343.8,7,3,442.0,98.2
18902,U146001,10,-13355.119999999999,9,1,13355.13,0.01
18903,U17AC68,10,34750.0,7,3,6170.56,40920.56
18904,U17DF7D,10,3600.1800000000007,3,7,3229.18,6829.36
18905,U7EAEAE,10,-1461.8999999999996,8,2,10140.18,8678.28
18906,U11C30E,10,483.78,8,2,3916.2199999999993,4400.0
18907,U36AE84,10,-3326.3300000000017,6,4,11879.34,8553.01
18908,UCEA8F9,10,14797.2,7,3,3249.0,18046.2
18909,U4EED10,10,-14.950000000000227,6,4,2276.71,2261.76
18910,UC6578E,10,10000.580000000002,5,5,4778.43,14779.01
18911,U7436B3,10,-4540.07,8,2,9049.07,4509.0
18912,U199C13,10,-1722.2800000000004,6,4,10046.76,8324.48
18913,U9C2BC0,10,3799.0,6,4,7211.8,11010.8
18914,U963154,10,0.0,5,5,27800.0,27800.0
18915,U832A2A,10,-1590.0000000000018,7,3,19760.31,18170.309999999998
18916,UC64294,10,-524.0799999999999,7,3,6524.099999999999,6000.02
18917,UDD06B2,10,-200.0,5,5,30000.0,29800.0
18918,U798B74,10,22297.0,8,2,22709.0,45006.0
18919,UB5465A,10,34528.32,5,5,887.68,35416.0
18920,U74D15D,10,7970.3899999999985,5,5,18030.000000000004,26000.389999999996
18921,U55E98D,10,-1895.9500000000003,5,5,12605.949999999999,10710.0
18922,U025D1E,10,8969.73,4,6,7857.0,16826.73
18923,U0F82B1,10,-1275.67,10,0,1275.67,0.0
18924,U6F65E6,10,572.84,8,2,1354.6000000000001,1927.44
18925,UAFF1C7,10,10233.16,5,5,4166.6,14399.759999999998
18926,U42D423,10,52.849999999999994,8,2,94.0,146.85
18927,UE60266,10,0.009999999999891429,5,5,4522.3099999999995,4522.32
18928,UEB9D86,10,2631.63,4,6,2812.0,5443.63
18929,UFBE23F,10,-2206.7200000000003,7,3,3239.82,1033.1
18930,U583C6C,10,-1566.0,7,3,4844.5,3278.5
18931,U2E9FB6,10,1.6300000000001091,5,5,5642.0,5643.63
18932,UF85B10,10,-249.66000000000003,8,2,766.6600000000001,517.0
18933,UC970E3,10,291.7,8,2,358.2,649.9000000000001
18934,UE08CB9,10,373.0,7,3,104.50000000000001,477.5
18935,U809CF2,10,8894.66,5,5,2705.34,11600.0
18936,U8781FE,10,-1496.1399999999994,8,2,5696.139999999999,4200.0
18937,U508B0B,10,4919.39,5,5,11460.0,16379.39
18938,U99FED5,10,-4435.91,7,3,4624.4800000000005,188.57
18939,U5D81DD,10,-417.5299999999992,6,4,16425.4,16007.869999999999
18940,U8B3E0E,10,-2419.4700000000003,7,3,10425.0,8005.530000000001
18941,UA5BC45,10,-944.0,5,5,2533.4,1589.4
18942,U263783,10,1393.1999999999998,8,2,1476.8,2870.0
18943,U7E8A22,10,200.01,5,5,331.5,531.51
18944,U48E0AB,10,-15.0300000000002,9,1,3632.76,3617.73
18945,U319278,10,445.29999999999995,8,2,6314.7,6760.0
18946,U52FDBB,10,-45.20000000000073,7,3,30045.2,30000.0
18947,UCD57FE,10,-12.799999999999947,8,2,2549.61,2536.81
18948,U8D190A,10,30.34999999999991,8,2,1369.65,1400.0
18949,UF8F590,10,601.44,4,6,401.10999999999996,1002.5500000000001
18950,U6188F2,10,-5559.42,7,3,14404.0,8844.58
18951,U491DC7,10,468.57999999999976,7,3,4074.6,4543.18
18952,U256596,10,1899.5699999999997,6,4,7764.7,9664.27
18953,U304F27,10,27.46000000000001,7,3,222.54999999999998,250.01
18954,U7C0510,10,19296.95,3,7,24125.0,43421.95
18955,U4546E8,10,-2.8421709430404007e-13,7,3,3603.4,3603.3999999999996
18956,UA2E1D2,10,9.730000000000004,6,4,417.62,427.35
18957,U00733E,10,-1923.6599999999999,7,3,9299.0,7375.34
18958,U9777D9,10,12.0,6,4,3008.0,3020.0
18959,U78C7D6,10,-3087.67,6,4,4420.6,1332.9299999999998
18960,U3EF36B,10,12683.010000000002,5,5,12947.0,25630.010000000002
18961,U84ED1F,10,264.6,7,3,1181.4,1446.0
18962,U87531D,10,-16552.75,10,0,16552.75,0.0
18963,UCC5322,10,-31.399999999999977,8,2,932.04,900.6400000000001
18964,U8C5A96,10,-36434.799999999996,9,1,36549.67,114.87
18965,U4A338E,10,-31.79999999999982,7,3,5957.700000000001,5925.9
18966,U05BEB9,10,-3216.57,7,3,14128.0,10911.43
18967,U80A773,10,0.0,8,2,2985.0,2985.0
18968,UEC4A99,10,-5.989999999999782,6,4,40006.0,40000.01
18969,U1146A7,10,10138.38,6,4,2815.7,12954.08
18970,UCEAC37,10,-7629.67,8,2,14532.25,6902.58
18971,UF41114,10,6867.17,6,4,8300.86,15168.029999999999
18972,UCCAD26,10,150.0,6,4,17850.0,18000.0
18973,UEC99E3,10,-1984.0,6,4,4067.26,2083.26
18974,U243A29,10,-174.67000000000007,8,2,4842.0,4667.33
18975,U726D4F,10,-8273.52,10,0,8273.52,0.0
18976,U131889,10,468.59999999999854,4,6,32090.0,32558.6
18977,U3224A7,10,-267.39000000000004,9,1,285.44000000000005,18.05
18978,UC32EFB,10,-187.54000000000002,9,1,258.43,70.89
18979,U97255B,10,554.5900000000001,8,2,1257.8600000000001,1812.4499999999998
18980,U795B70,10,5800.420000000001,5,5,17633.7,23434.120000000003
18981,UF381A2,10,866.3199999999997,7,3,18723.07,19589.39
18982,UF6F340,10,15.999999999999972,8,2,162.26,178.26
18983,U354E9E,10,-706.0,8,2,957.0,251.0
18984,UC76BC4,10,-700.8599999999999,9,1,701.8599999999999,1.0
18985,UD69BD9,10,-3800.85,8,2,7338.85,3538.0
18986,UD29DFF,10,2.842170943040401e-14,8,2,427.18999999999994,427.19
18987,UB58B3A,10,675.3200000000002,5,5,4345.0,5020.32
18988,U777076,10,828.62,2,8,10012.2,10840.82
18989,U8E5F0A,10,958.0,5,5,42783.0,43741.0
18990,UF2C12A,10,1526.0,8,2,6882.0,8408.0
18991,UDDB2B9,10,-548.9,7,3,1954.92,1406.02
18992,UA2B222,10,-2811.3,8,2,8816.0,6004.7
18993,UAC779E,10,4599.9400000000005,7,3,4620.0599999999995,9220.0
18994,UA7A4A1,10,589.06,3,7,271.09000000000003,860.1500000000001
18995,U7EF281,10,-2681.67,5,5,28418.09,25736.42
18996,U7AAC25,10,6410.740000000001,4,6,4750.51,11161.250000000002
18997,UF8A543,10,1152.44,6,4,1124.0,2276.44
18998,U85BD03,10,2549.2800000000007,8,2,4063.14,6612.42
18999,U7413DC,10,-113.86999999999998,8,2,337.94,224.07
19000,U28FEAB,10,15294.0,4,6,42711.39,58005.39
19001,U8E5219,10,5.0,5,5,9971.0,9976.0
19002,U22E2E1,10,-593.0199999999988,7,3,5733.789999999999,5140.77
19003,U4C7A1A,10,7508.050000000001,7,3,17393.47,24901.52
19004,UC1F522,10,-475.7,9,1,515.7,40.0
19005,U9798E7,10,22960.260000000002,5,5,44040.0,67000.26000000001
19006,UDA0F04,10,-36.3,8,2,626.3,590.0
19007,UBAB8C6,10,301.12,6,4,1383.93,1685.05
19008,U993DB8,10,-10745.859999999999,9,1,10766.3,20.44
19009,U23581A,10,578.8800000000001,7,3,4521.12,5100.0
19010,UBF2074,10,-104.0,7,3,960.0,856.0
19011,UF3F1DB,10,-6998.0,6,4,25896.0,18898.0
19012,U52760F,10,-1211.059999999999,3,7,28430.26,27219.2
19013,UC5464E,10,-7.940000000000055,8,2,2008.0,2000.06
19014,U8BC590,10,0.1999999999998181,8,2,3487.8,3488.0
19015,U2C30CF,10,3992.9099999999994,4,6,1317.5800000000002,5310.49
19016,U72E58F,10,2482.3999999999996,8,2,5830.969999999999,8313.369999999999
19017,U479843,10,388.52,8,2,5659.83,6048.35
19018,UD3C16D,10,4701.370000000001,7,3,19023.0,23724.370000000003
19019,U57E9AB,10,144.51000000000022,8,2,6598.16,6742.67
19020,UDC3ACD,10,-513.85,8,2,1834.0,1320.15
19021,U8EBD0A,10,-87.48999999999862,6,4,10390.84,10303.35
19022,U4C61B2,10,1.1368683772161603e-13,7,3,1504.23,1504.23
19023,U275087,10,9997.12,3,7,9985.09,19982.21
19024,U0C1D60,10,105.59999999999991,8,2,1594.4,1700.0
19025,U346E25,10,157.73000000000025,8,2,1736.29,1894.02
19026,UD9790C,10,63.25,9,1,236.75,300.0
19027,U22CBF2,10,42.000000000000014,7,3,159.01999999999998,201.01999999999998
19028,UFD0258,10,50.67,5,5,39.9,90.57
19029,UE215FA,10,886.4600000000002,8,2,1451.68,2338.1400000000003
19030,UD8A333,10,-170.0,7,3,11150.0,10980.0
19031,U1DA29A,10,7906.0,7,3,6043.25,13949.25
19032,UA931A3,10,-5240.0,8,2,11821.66,6581.66
19033,UA10223,10,1500.2399999999998,8,2,1852.7600000000002,3353.0
19034,U888B46,10,8098.290000000001,3,7,2685.21,10783.5
19035,U0F6714,10,-4.160000000000021,6,4,412.9,408.74
19036,U9404CB,10,117.25000000000003,8,2,537.7499999999999,655.0
19037,U67DD99,10,-6373.15,8,2,15055.22,8682.07
19038,UE992DB,10,-1164.58,5,5,6868.179999999999,5703.599999999999
19039,U9DA5E8,10,0.0,6,4,24000.0,24000.0
19040,UCD72B7,10,9104.619999999999,6,4,1633.92,10738.54
19041,UDC64C7,10,-941.8600000000001,4,6,27671.0,26729.14
19042,U9F2E3E,10,120.0,5,5,12880.0,13000.0
19043,U20218C,10,400.8399999999999,8,2,1308.0,1708.84
19044,UB017F1,10,395.40999999999985,8,2,2031.56,2426.9700000000003
19045,UCA60A8,10,-18111.9,7,3,44099.9,25988.0
19046,U85347B,10,373.5,9,1,2706.5,3080.0
19047,U792DF3,10,-2714.4300000000003,8,2,3426.05,711.62
19048,U610A0C,10,1885.280000000001,8,2,3804.38,5689.66
19049,U378268,10,-17215.8,8,2,25849.6,8633.8
19050,U52DD62,10,2978.8099999999995,6,4,3271.1499999999996,6249.959999999999
19051,U65AA2F,10,49360.0,6,4,249.77999999999997,49609.78
19052,UDBDF54,10,-723.38,5,5,1929.38,1206.0
19053,UF66241,10,10872.41,5,5,4368.0,15240.41
19054,U63C3F8,10,219.99,7,3,1419.54,1639.53
19055,U95ADFE,10,-510.31999999999994,6,4,2226.3199999999997,1716.0
19056,U822282,10,21496.129999999997,5,5,48532.770000000004,70028.9
19057,U6C3B3A,10,829.0,4,6,6312.0,7141.0
19058,U73060F,10,-24199.0,6,4,45499.0,21300.0
19059,U94D57F,10,-129.06,10,0,129.06,0.0
19060,UE9D840,10,-109.84999999999945,5,5,9211.679999999998,9101.83
19061,UB40FFF,10,-971.7499999999999,8,2,2388.0,1416.25
19062,U5E4335,10,22375.910000000003,7,3,28195.98,50571.89
19063,UDF3F9B,10,2320.59,6,4,27931.509999999995,30252.1
19064,UE8DAB8,10,2.050000000000182,7,3,10050.0,10052.05
19065,U827C46,10,0.0,5,5,8000.0,8000.0
19066,U6E694E,10,-1057.4500000000003,9,1,2967.07,1909.62
19067,UB4C22D,10,27.0,8,2,1379.5,1406.5
19068,U4AA9D9,10,-107.02999999999975,6,4,7000.0,6892.97
19069,UB6C61D,10,-1808.68,10,0,1808.68,0.0
19070,U7EE2C8,10,-1266.8799999999974,8,2,24102.879999999997,22836.0
19071,UD8B4DE,10,4897.78,6,4,3102.26,8000.04
19072,U3B9269,10,102.14999999999992,8,2,740.19,842.3399999999999
19073,U399729,10,19070.0,4,6,2913.0,21983.0
19074,U6B4AFB,10,1648.0499999999993,5,5,9352.7,11000.75
19075,UF32E6E,10,3509.0,2,8,2860.0,6369.0
19076,UA9D3EF,10,-228.66,8,2,286.24,57.58
19077,U87E1A9,10,3844.8,5,5,690.1600000000001,4534.96
19078,UA2DB32,10,0.0,5,5,40543.0,40543.0
19079,U9E5EA6,10,-59.93,5,5,92.75,32.82
19080,U2FDA47,10,3230.74,4,6,4369.26,7600.0
19081,U223378,10,0.8399999999995771,8,2,3765.1600000000003,3766.0
19082,UEDC799,10,-3.63806207381856e-14,6,4,6600.04,6600.04
19083,U11A17D,10,1616.0,8,2,5215.71,6831.71
19084,U2536F5,10,-1107.0,7,3,13107.0,12000.0
19085,UB930D3,10,-202.87,7,3,213.94,11.070000000000002
19086,UC34EFE,10,195.0,8,2,5258.0,5453.0
19087,UAC65D0,10,38380.6,3,7,2644.9,41025.5
19088,UB17A4A,10,-17914.07,6,4,18339.54,425.47
19089,U72E3FE,10,-865.0,7,3,21065.0,20200.0
19090,UD6872F,10,-1831.5100000000002,6,4,23050.68,21219.17
19091,U88E4AD,10,-6.821210263296962e-13,5,5,6068.110000000001,6068.11
19092,U13E158,10,374.1999999999998,6,4,21935.8,22310.0
19093,U91FA45,10,-3747.0899999999997,10,0,3747.0899999999997,0.0
19094,U3C8582,10,-85.86000000000058,4,6,9894.3,9808.439999999999
19095,U287FA2,10,5644.3200000000015,8,2,8833.38,14477.7
19096,U179193,10,-577.47,10,0,577.47,0.0
19097,U7E0466,10,520.0,4,6,38767.0,39287.0
19098,UF5DE95,10,200.48000000000002,6,4,4799.52,5000.0
19099,UF61972,10,-13.850000000000364,5,5,13714.0,13700.15
19100,U4718D2,10,-129.8700000000008,8,2,23340.0,23210.129999999997
19101,U0F25D3,10,-141.79999999999998,9,1,477.40000000000003,335.6
19102,U466A5C,10,-1480.1500000000003,9,1,2348.5400000000004,868.39
19103,UB6D81F,10,-48.06,8,2,453.38000000000005,405.32
19104,U38BA63,10,534.6600000000001,5,5,685.34,1220.0
19105,UD1C003,10,388.20000000000005,6,4,494.0,882.2
19106,U006CF1,10,-951.2600000000002,7,3,6161.809999999999,5210.55
19107,UC2527C,10,-12048.6,8,2,19993.6,7945.0
19108,UE4F1FA,10,-3630.0099999999998,5,5,3688.58,58.57000000000001
19109,UE3A6A9,10,67.82999999999993,8,2,3604.25,3672.08
19110,UC6E3F2,10,-9.05,8,2,11.05,2.0
19111,UB5E7E2,10,6666.6900000000005,4,6,5903.34,12570.03
19112,UB484FC,10,441.65999999999997,7,3,974.11,1415.77
19113,U6B6E93,10,10751.0,4,6,38699.0,49450.0
19114,U4D4620,10,-519.1999999999998,8,2,6475.9,5956.7
19115,U53ED47,10,-2545.56,9,1,2548.1,2.54
19116,U695539,10,-171794.72999999998,4,6,286395.86,114601.13
19117,U05C0FA,10,448.21000000000004,5,5,850.0,1298.2099999999998
19118,U1051D3,10,43.05,6,4,1416.0,1459.05
19119,U6AC331,10,-1114.6999999999998,10,0,1114.6999999999998,0.0
19120,U198E65,10,839.6499999999996,4,6,11231.98,12071.63
19121,UED3362,10,-5921.0,7,3,13991.0,8070.0
19122,U319BA4,10,-2124.04,7,3,7091.71,4967.67
19123,UEAEA74,10,377.13000000000034,8,2,2113.09,2490.2200000000003
19124,U684B3E,10,0.12999999999995737,7,3,321.1,321.22999999999996
19125,U7B752D,10,-3065.7200000000003,8,2,3080.7200000000003,15.0
19126,UC66A39,10,24504.0,5,5,10496.0,35000.0
19127,U030F0D,10,5666.78,4,6,15993.36,21660.14
19128,U68FC79,10,-13321.56,4,6,16170.0,2848.44
19129,UA21E40,10,0.5700000000000003,7,3,105.12,105.69
19130,UFF211F,10,613.36,7,3,1325.33,1938.69
19131,U7E5791,10,-0.6000000000000005,6,4,10.0,9.4
19132,U47908B,10,0.0,6,4,38903.34,38903.34
19133,U69EA3D,10,5122.08,5,5,12765.92,17888.0
19134,U8B00E6,10,17.469999999999914,5,5,2161.6,2179.07
19135,U6431C3,10,0.6099999999999964,4,6,305.2,305.81
19136,UE12440,10,1960.56,5,5,2382.42,4342.98
19137,U231558,10,-17072.79,8,2,127087.5,110014.71
19138,U415035,10,0.0,6,4,85.66,85.66
19139,U9638D0,10,-2205.32,7,3,5206.0,3000.68
19140,U574443,10,7200.0,5,5,40500.0,47700.0
19141,U400791,10,-2986.57,5,5,9215.0,6228.43
19142,U2D3A83,10,-90.97000000000025,8,2,2262.76,2171.79
19143,U03295A,10,1663.9099999999999,7,3,21870.09,23534.0
19144,UC90D6C,10,-582.8900000000001,7,3,1430.8899999999999,848.0
19145,UAF5ECB,10,-12357.43,6,4,22534.86,10177.43
19146,UFDCF6F,10,-2391.64,9,1,2392.5,0.86
19147,U192358,10,-5118.280000000001,8,2,7028.280000000001,1910.0
19148,UC8FE58,10,6.069999999999993,8,2,391.93,398.0
19149,UE1815D,10,2960.64,5,5,2013.0,4973.639999999999
19150,UE111FA,10,-3868.25,8,2,4028.25,160.0
19151,U6E59B4,10,30011.0,7,3,1415.9,31426.9
19152,UDAAB06,10,-293.86999999999995,8,2,1432.6,1138.73
19153,UA1344C,10,939.7999999999993,7,3,6761.780000000001,7701.58
19154,UCFCE73,10,99.69999999999993,8,2,1832.3,1932.0
19155,UC15713,10,829.73,5,5,76.3,906.03
19156,UF7C915,10,-2088.0,6,4,16768.0,14680.0
19157,U0EC626,10,1211.9800000000002,8,2,1809.1299999999999,3021.11
19158,U6BD72C,10,79.32000000000004,7,3,319.68,399.0
19159,U7DD80F,10,-841.0,7,3,18068.0,17227.0
19160,UBC30B1,10,-17.04,7,3,76.94000000000001,59.9
19161,UF01A68,10,333.23000000000013,5,5,1662.4,1995.63
19162,UDAEE47,10,320.0,7,3,5940.0,6260.0
19163,UD96BA6,10,10.150000000000006,7,3,2191.28,2201.43
19164,U58272D,10,451.35,8,2,548.65,1000.0
19165,UAC728F,10,2413.0,8,2,2977.0,5390.0
19166,U1AABB7,10,43.379999999999654,6,4,2806.76,2850.14
19167,U34C067,10,-213.87999999999982,7,3,3937.76,3723.88
19168,UDE5E30,10,-1200.0,6,4,15800.0,14600.0
19169,UF5A240,10,-2538.48,9,1,2538.52,0.04
19170,U590452,10,0.0,6,4,207.01,207.01
19171,U45D74F,10,-203.2000000000008,9,1,5609.64,5406.44
19172,UE778E8,10,-13987.18,7,3,15744.18,1757.0
19173,U9802E8,10,-727.0699999999989,8,2,14472.21,13745.14
19174,U97E5C6,10,-3.552713678800501e-14,7,3,556.2,556.2
19175,UB4C0CF,10,620.3399999999999,7,3,806.2,1426.54
19176,U97D2C9,10,38295.0,6,4,10404.4,48699.4
19177,U3A4F7B,10,-7210.629999999999,8,2,7519.879999999999,309.25
19178,U992850,10,353.0,8,2,6347.0,6700.0
19179,U717D5D,10,2.0,5,5,5989.0,5991.0
19180,UCF4CDC,10,-109.09999999999991,5,5,15999.8,15890.699999999999
19181,U0B8EE4,10,-8266.32,10,0,8266.32,0.0
19182,U83892E,10,-1087.5399999999986,7,3,15507.109999999999,14419.570000000002
19183,U408681,10,-2137.86,7,3,6952.26,4814.4
19184,U44134C,10,3.3100000000002,5,5,4753.83,4757.14
19185,U82F079,10,1406.1300000000047,4,6,384000.0,385406.13
19186,UD396E1,10,38.92000000000189,5,5,21033.0,21071.920000000002
19187,U6ACBAC,10,409.69000000000005,4,6,628.3000000000001,1037.9900000000002
19188,U1CF1FB,10,3179.5400000000004,8,2,2520.46,5700.0
19189,U26B1DF,10,-1560.0,8,2,1599.0,39.0
19190,UFDB086,10,0.0,5,5,8000.0,8000.0
19191,UF1A321,10,-2146.0800000000004,7,3,7741.08,5595.0
19192,UE732C6,10,-754.96,7,3,2479.96,1725.0
19193,UC142DB,10,82.71000000000019,7,3,4117.38,4200.09
19194,UB377BC,10,1203.5900000000001,8,2,2214.8199999999997,3418.41
19195,U2217E0,10,-0.2300000000000182,8,2,1742.73,1742.5
19196,UF05475,10,82.0,7,3,1245.0,1327.0
19197,U296503,10,-2956.96,8,2,3438.46,481.5
19198,UB57F2C,10,141.46000000000004,8,2,7858.54,8000.0
19199,U14B3B7,10,569.7500000000002,7,3,2426.42,2996.17
19200,UA9D3ED,10,-4796.6,4,6,6096.6,1300.0
19201,UBAF940,10,172.89999999999992,7,3,306.18,479.08
19202,U791118,10,-1006.1000000000004,7,3,15182.4,14176.3
19203,UD4900E,10,-6622.44,10,0,6622.44,0.0
19204,U2A4A76,10,-349.72,8,2,1286.2,936.48
19205,U01926E,10,-189.99999999999997,9,1,239.05999999999997,49.06
19206,U4494D1,10,-7700.0,8,2,8605.0,905.0
19207,UA08620,10,22.98999999999978,7,3,10892.81,10915.8
19208,UDA761B,10,134.55999999999995,7,3,6083.05,6217.610000000001
19209,U0BA5BE,10,0.0,8,2,1250.07,1250.07
19210,UC2EDFD,10,414.4000000000001,8,2,1207.6,1622.0
19211,UF4C99B,10,837.0600000000001,8,2,644.79,1481.8500000000001
19212,UA0C749,10,-1179.88,6,4,3541.0,2361.12
19213,U53F41D,10,-61964.3,10,0,61964.3,0.0
19214,U60AD7B,10,217.0,7,3,9719.0,9936.0
19215,U2F69AB,10,1251.6000000000004,8,2,2235.0,3486.6000000000004
19216,UCEAE88,10,14.440000000000083,6,4,1947.12,1961.56
19217,U7190E7,10,13431.71,7,3,14816.529999999999,28248.239999999998
19218,U2D5D9E,10,-13038.0,5,5,39730.0,26692.0
19219,UC643F8,10,-2422.7599999999998,7,3,5585.759999999999,3163.0
19220,UA700A7,10,-441.0799999999999,6,4,4425.360000000001,3984.28
19221,UA40294,10,0.0,5,5,892.2,892.2
19222,U96E39B,10,0.0,4,6,32380.09,32380.09
19223,U1B5295,10,-7530.740000000001,8,2,7943.740000000001,413.0
19224,UFE352B,10,26.0,7,3,3922.0,3948.0
19225,U0E36B9,10,420.8000000000002,8,2,5372.0,5792.8
19226,UEE2A14,10,-389.8000000000002,8,2,7562.8,7173.0
19227,UB5E747,10,3.410605131648481e-13,8,2,3901.379999999999,3901.38
19228,U9E83A9,10,-5715.860000000001,6,4,14560.77,8844.91
19229,U61EA41,10,-7961.420000000001,10,0,7961.420000000001,0.0
19230,UA54EDC,10,246.25,8,2,10013.25,10259.5
19231,UFB53C0,10,41114.299999999996,2,8,23123.07,64237.369999999995
19232,U0EBB9E,10,-529.29,10,0,529.29,0.0
19233,U7E3078,10,-1848.3000000000002,9,1,4886.3,3038.0
19234,U8F7FDD,10,-3400.0,8,2,8000.0,4600.0
19235,U813BE8,10,258.0,7,3,1429.0,1687.0
19236,UF0F022,10,283.3599999999997,6,4,16266.64,16550.0
19237,U494BE5,10,1556.0,8,2,5050.0,6606.0
19238,UBBFAAD,10,1804.92,8,2,1963.0,3767.92
19239,UD339C8,10,243.99999999999818,5,5,28943.940000000002,29187.940000000002
19240,UAF03CC,10,-588.3200000000015,6,4,28830.0,28241.68
19241,UEA802F,10,-9000.0,6,4,23540.0,14540.0
19242,U172411,10,-3772.119999999999,8,2,17372.12,13600.0
19243,UF97DD1,10,-500.0,5,5,8201.21,7701.21
19244,UD2E393,10,669.2,6,4,4055.8,4725.0
19245,U1E6E71,10,-3866.13,8,2,6866.13,3000.0
19246,U309BEE,10,-4482.2,8,2,4909.62,427.42
19247,U2A1DC6,10,-22910.729999999996,6,4,46246.009999999995,23335.28
19248,U6017F9,10,-3776.86,7,3,4576.9,800.04
19249,U7E810D,10,3837.419999999999,3,7,21080.469999999998,24917.89
19250,U308BF6,10,983.3499999999999,5,5,1981.66,2965.01
19251,UF486A4,10,0.0,6,4,454.5,454.5
19252,U2ED2C2,10,-27681.149999999994,8,2,40884.24,13203.09
19253,UE18789,10,49.82999999999993,6,4,1684.75,1734.58
19254,U8EC690,10,497.06999999999977,8,2,2289.38,2786.45
19255,U056D51,10,559.7599999999998,7,3,2396.14,2955.8999999999996
19256,U83C2A5,10,5718.0,8,2,1282.0,7000.0
19257,UBB5C55,10,409.48,8,2,3246.0,3655.48
19258,UD1073C,10,4491.1,6,4,119.69,4610.79
19259,UE9232B,10,-4800.0,5,5,14100.0,9300.0
19260,UA1C6EB,10,-106.83,7,3,312.95,206.12
19261,U1948E4,10,541.5200000000002,7,3,2463.3799999999997,3004.9
19262,UAA27F0,10,-1637.2900000000009,8,2,4280.460000000001,2643.17
19263,U36EFDF,10,-177.96,7,3,514.12,336.16
19264,U52D4F3,10,-1164.52,7,3,2434.52,1270.0
19265,U6C8C4B,10,-7000.0,8,2,25998.0,18998.0
19266,UA10FAB,10,-9077.59,10,0,9077.59,0.0
19267,U6C01CB,10,-2451.6600000000003,7,3,8785.66,6334.0
19268,U2051C5,10,-2899.0000000000014,8,2,5899.06,3000.06
19269,UBE3313,10,-7118.0,6,4,22625.0,15507.0
19270,UB3A632,10,-37.0,8,2,3069.0,3032.0
19271,UE5253B,10,0.43000000000006366,8,2,4621.57,4622.0
19272,U72346D,10,-422.3,10,0,422.3,0.0
19273,UD97C26,10,7799.170000000002,6,4,10686.66,18485.83
19274,U328109,10,3953.5599999999995,5,5,33633.26,37586.82
19275,U20FD3A,10,1374.5,3,7,368.99,1743.49
19276,U5A98F7,10,3045.0,4,6,3045.0,6090.000000000001
19277,U86B269,10,-2581.96,8,2,5681.96,3100.0
19278,U005512,10,-1384.81,6,4,1585.26,200.45
19279,UC22CCF,10,-2219.66,7,3,8119.66,5900.0
19280,UDD895E,10,-2722.6699999999996,8,2,4025.14,1302.47
19281,UE77C04,10,781.88,7,3,817.22,1599.1
19282,UC4DAD3,10,3497.58,4,6,2950.0,6447.58
19283,U7C4471,10,-427.02000000000004,9,1,1427.02,1000.0
19284,U8C55E8,10,-9.0951551845464e-15,8,2,60.06,60.06
19285,UAF3961,10,-1591.0,8,2,3628.54,2037.54
19286,U9974F1,10,925.2900000000009,7,3,5656.709999999999,6582.0
19287,U4B5A93,10,-1453.35,8,2,1473.34,19.990000000000002
19288,UBFEDC9,10,-15.500000000000002,9,1,15.72,0.22
19289,UEF5D19,10,-1259.48,9,1,1269.48,10.0
19290,U72F7B7,10,-2344.4700000000003,8,2,6945.0,4600.53
19291,UFDC6C3,10,5.1999999999999975,7,3,194.81,200.01
19292,U956E72,10,-209.79000000000002,6,4,213.82,4.029999999999999
19293,U19DC2C,10,-3036.0,8,2,8931.5,5895.5
19294,U1C7895,10,-77202.03,6,4,104473.75,27271.72
19295,U6C5881,10,-2342.77,8,2,7257.76,4914.99
19296,U500586,10,-233.36999999999995,8,2,403.97999999999996,170.61
19297,U4DD3C4,10,6968.22,5,5,10197.769999999999,17165.989999999998
19298,U992F88,10,0.0,5,5,6000.0,6000.0
19299,U85984B,10,706.0,8,2,1794.0,2500.0
19300,U13786E,10,-10713.880000000001,6,4,25998.0,15284.119999999999
19301,UA85E02,10,67.0,8,2,1176.78,1243.78
19302,U69112F,10,258.38000000000005,7,3,2992.62,3251.0
19303,UCD49E4,10,30.739999999998872,5,5,11997.15,12027.89
19304,UA01487,10,-247.69000000000005,6,4,3748.58,3500.89
19305,UDE0ED2,10,490.0,7,3,1010.0,1500.0
19306,U70A022,10,-250.0,8,2,21058.0,20808.0
19307,UE91EE4,10,11542.16,3,7,9000.0,20542.16
19308,UBE385D,10,-23.870000000000005,7,3,2084.5,2060.63
19309,UED52EA,10,-888.3399999999999,8,2,1319.4,431.06
19310,UD560FA,10,-1538.8500000000004,6,4,6721.85,5183.0
19311,UEFFAC0,10,-220.34000000000015,7,3,3619.6800000000003,3399.34
19312,U33B012,10,145328.61,5,5,95794.76999999999,241123.38
19313,U5027F0,10,-106.0,5,5,65607.0,65501.0
19314,U378311,10,1942.2,6,4,232.73,2174.9300000000003
19315,U5BC013,10,280.78000000000065,4,6,19733.64,20014.42
19316,U3AE6E4,10,363.02,4,6,880.02,1243.04
19317,U5ED175,10,-4050.7,8,2,8290.7,4240.0
19318,UF0593B,10,-1804.7400000000018,5,5,20274.09,18469.350000000002
19319,UECAB19,10,-1060.0,5,5,36275.0,35215.0
19320,UDA0B88,10,871.0,5,5,15949.0,16820.0
19321,U408AF6,10,-3193.8399999999997,8,2,3753.8399999999997,560.0
19322,U4A3CD7,10,5852.149999999976,5,5,167731.0,173583.15
19323,UC22E6D,10,-3760.0,8,2,9220.0,5460.0
19324,UEF4F8B,10,-0.010000000000113687,6,4,2103.4900000000002,2103.48
19325,U44507E,10,5086.500000000002,6,4,14607.899999999998,19694.399999999998
19326,UD00955,10,-28552.940000000002,8,2,28902.940000000002,350.0
19327,U8FE361,10,-48.1400000000001,5,5,1298.69,1250.55
19328,U733B2B,10,-1192.1700000000005,6,4,7400.01,6207.84
19329,UB0968E,10,-0.7700000000004366,5,5,20000.0,19999.23
19330,UFC7EB7,10,339.42999999999984,6,4,1544.5700000000002,1884.0
19331,U6C0AFC,10,-5220.0,9,1,12920.0,7700.0
19332,U51EA78,10,-204.40999999999997,8,2,465.57,261.15999999999997
19333,U42C968,10,-24.50999999999999,6,4,429.6,405.09000000000003
19334,U595222,10,-34.900000000000006,8,2,166.9,132.0
19335,U31A24E,10,-1437.5500000000002,9,1,2808.3199999999997,1370.77
19336,U9A8196,10,-3227.8199999999993,8,2,3327.8199999999993,100.0
19337,UEDF047,10,-22736.0,8,2,22936.01,200.01
19338,U936378,10,9207.0,5,5,17386.0,26593.0
19339,UED9F2A,10,-2.1316282072803006e-13,5,5,1686.1400000000003,1686.1399999999999
19340,UBE6D92,10,10282.37,4,6,5475.28,15757.65
19341,U992E11,10,-40.0,5,5,9302.0,9262.0
19342,U8AC77B,10,-6196.23,8,2,10913.45,4717.22
19343,U893312,10,1.1368683772161603e-13,8,2,1458.15,1458.15
19344,UA26893,10,3256.79,4,6,9793.21,13050.0
19345,U63397F,10,-13.79,7,3,42.0,28.21
19346,UAEBC97,10,-1943.0,8,2,14943.0,13000.0
19347,UAB8D38,10,-306.31999999999994,8,2,6405.320000000001,6099.0
19348,UB0B397,10,-6530.5,10,0,6530.5,0.0
19349,U17A9A3,10,-5826.479999999999,8,2,6026.479999999999,200.0
19350,U52C54A,10,4217.070000000002,8,2,1677.4,5894.47
19351,U83C185,10,-1883.6200000000001,10,0,1883.6200000000001,0.0
19352,UC86A4D,10,330.0899999999999,6,4,478.43,808.52
19353,U037176,10,-211.90000000000003,7,3,1896.7,1684.8
19354,U09E279,10,1768.6600000000003,6,4,1212.74,2981.4
19355,UFBCF40,10,-7655.0,8,2,35399.0,27744.0
19356,UCB8B97,10,611.1599999999999,8,2,2592.54,3203.7
19357,UB9C8A5,10,554.45,7,3,655.24,1209.69
19358,U7650F8,10,-1779.5600000000024,7,3,51624.840000000004,49845.28
19359,UBE3B12,10,1065.9600000000005,6,4,6468.6,7534.56
19360,UF541CD,10,912.7100000000002,8,2,1641.98,2554.69
19361,U2ACA8A,10,1415.4099999999999,7,3,923.1199999999999,2338.5299999999997
19362,UB7E925,10,-3025.26,7,3,8082.66,5057.4
19363,UB9D0CC,10,350.9699999999998,7,3,9880.0,10230.97
19364,UA5A1C7,10,266.82,8,2,163.8,430.62
19365,UCB2BC1,10,-405.9499999999998,6,4,7818.85,7412.9
19366,U59A617,10,696.0,8,2,5805.0,6501.0
19367,UCA30D7,10,-2181.2199999999993,8,2,9000.0,6818.78
19368,UEEE83B,10,8400.43,3,7,15000.0,23400.43
19369,U2ECBB3,10,42305.88,1,9,50000.0,92305.88
19370,U70E11F,10,-8152.719999999999,5,5,55761.22,47608.5
19371,UF8EC0F,10,-4655.249999999999,9,1,6410.499999999999,1755.25
19372,U434D0A,10,7254.12,5,5,7321.0,14575.119999999999
19373,U262068,10,-10129.84,8,2,14228.84,4099.0
19374,U769C85,10,-4041.7799999999997,10,0,4041.7799999999997,0.0
19375,U7D07CA,10,857.75,8,2,536.25,1394.0
19376,U9B2BBD,10,1768.4799999999996,8,2,2618.52,4387.0
19377,U821B94,10,-6109.52,10,0,6109.52,0.0
19378,U9350EC,10,-209.39000000000001,6,4,620.08,410.68999999999994
19379,UA2DB02,10,-393.19000000000005,6,4,1337.07,943.88
19380,U5949B9,10,-530.0,6,4,19150.0,18620.0
19381,U96929E,10,153.11999999999998,4,6,860.8000000000001,1013.9200000000001
19382,UE7FEDF,10,-117.0,9,1,417.0,300.0
19383,UE471D6,10,-1951.44,8,2,3070.1800000000003,1118.74
19384,UF22F17,10,-4.6,9,1,24.60000000000001,20.0
19385,UEA5E37,10,-3014.52,6,4,5414.52,2400.0
19386,U0ACAAA,10,-464.02000000000004,7,3,524.6,60.58
19387,U64F3C9,10,355.35,8,2,704.65,1060.0
19388,UFADD6C,10,17820.0,0,10,0.0,17820.0
19389,U8A3D76,10,2739.0,5,5,1464.0,4203.0
19390,U27BB71,10,-657.4500000000003,7,3,6977.450000000001,6320.0
19391,U2F86E0,10,4174.62,6,4,3446.12,7620.74
19392,U884CEE,10,-6749.8200000000015,8,2,7549.8200000000015,800.0
19393,UD648DF,10,546.0999999999985,4,6,21058.0,21604.1
19394,UBEF0DC,10,551.9,9,1,1375.1000000000001,1927.0
19395,UB0F19D,10,0.57000000000005,9,1,756.43,757.0
19396,UCD95D3,10,-17.98999999999978,6,4,7999.21,7981.22
19397,U0C4F8A,10,16270.240000000003,9,1,1279.76,17550.0
19398,UD1280D,10,-1485.250000000001,5,5,15965.74,14480.49
19399,U14CD94,10,2563.5,8,2,3936.5,6500.0
19400,U0CE4D3,10,-16958.609999999997,9,1,26958.609999999997,10000.0
19401,UDE825C,10,223.3,8,2,526.4,749.7
19402,U18D018,10,-10.0,6,4,12010.0,12000.0
19403,U847A8A,10,115.59999999999991,7,3,3151.4,3267.0
19404,UB2624A,10,-62.16000000000008,8,2,1857.68,1795.52
19405,UA0F9D0,10,42172.14,6,4,90.86,42263.0
19406,UE88CDB,10,-4231.37,8,2,4560.099999999999,328.72999999999996
19407,UC2A588,10,-375.74,9,1,3082.74,2707.0
19408,U837329,10,-8015.0,7,3,21252.0,13237.0
19409,U25AAA2,10,-5455.889999999998,4,6,93438.0,87982.11
19410,UA3B2AA,10,518.0699999999999,7,3,2730.5400000000004,3248.61
19411,UDE0230,10,-6177.380000000001,8,2,6577.380000000001,400.0
19412,UF3B046,10,0.0,5,5,14000.0,14000.0
19413,U9FA8FA,10,-868.3000000000002,5,5,8268.3,7400.0
19414,UA528DB,10,3408.0400000000004,7,3,1171.69,4579.73
19415,U66EF66,10,-0.9900000000000091,5,5,5999.0,5998.01
19416,U2EA6E8,10,-6581.3,7,3,10005.0,3423.7
19417,U1B30D7,10,12667.45,7,3,17282.370000000003,29949.82
19418,U532277,10,15.060000000000002,5,5,2183.1,2198.16
19419,U8A577E,10,-923.0,6,4,10723.0,9800.0
19420,UDD4FA8,10,9505.74,3,7,4308.34,13814.08
19421,UBCDD32,10,300.0,7,3,70.0,370.0
19422,U6F59F1,10,-3478.35,10,0,3478.35,0.0
19423,U2A2D47,10,-8904.99,7,3,30789.99,21885.0
19424,U3E1C3C,10,4553.51,6,4,18200.0,22753.510000000002
19425,UD1B4F7,10,897.8899999999999,7,3,1393.2,2291.09
19426,UAFFFDC,10,21193.25,4,6,533.16,21726.410000000003
19427,UAE44E2,10,-10.0,7,3,29320.0,29310.0
19428,U182613,10,516.0999999999999,5,5,2226.3,2742.4
19429,U84444B,10,2878.5700000000006,7,3,6630.0,9508.57
19430,UE32596,10,1813.0,7,3,7187.0,9000.0
19431,U6752E0,10,-1852.5999999999985,5,5,15385.6,13533.000000000002
19432,UB2B186,10,2269.24,4,6,1059.76,3329.0
19433,UFF0416,10,1743.5999999999985,8,2,22972.9,24716.5
19434,U12A25F,10,-1243.0900000000001,6,4,3357.75,2114.66
19435,UBE6B99,10,-13588.66,8,2,13788.66,200.0
19436,UC5BE36,10,11832.170000000002,4,6,14124.83,25957.0
19437,UD2FAA2,10,474.8,9,1,525.1999999999999,1000.0
19438,U2C73D8,10,-150.0,5,5,34350.0,34200.0
19439,UCB3F88,10,-1039.83,8,2,2563.0,1523.17
19440,U72C33D,10,0.0,7,3,43.0,43.0
19441,U6DF1C1,10,-129.32999999999998,6,4,20229.5,20100.17
19442,U376F72,10,-2081.98,5,5,4782.030000000001,2700.05
19443,UCE7668,10,7992.180000000003,8,2,2784.36,10776.54
19444,U0635D6,10,4363.400000000001,5,5,2045.8100000000002,6409.21
19445,U682A53,10,-802.7599999999995,7,3,5602.759999999999,4800.0
19446,UF847D2,10,710.3299999999999,7,3,958.82,1669.1499999999999
19447,UA43000,9,-1579.9999999999998,6,3,6811.66,5231.66
19448,U13099C,9,3441.34,4,5,4398.26,7839.599999999999
19449,U903A33,9,973.21,7,2,668.0200000000001,1641.23
19450,UE04D8D,9,-270.05,6,3,3898.55,3628.5
19451,U98A576,9,-48.75,6,3,58.8,10.05
19452,UD88F92,9,1643.8599999999933,6,3,64357.659999999996,66001.51999999999
19453,U08591C,9,-55.91999999999999,7,2,303.02,247.1
19454,U14D564,9,306.31000000000023,6,3,2373.1,2679.4100000000003
19455,UDB487E,9,1367.4299999999998,6,3,2871.57,4239.0
19456,U9F7F53,9,-200.0,6,3,1998.0,1798.0
19457,UD47543,9,-229.62,7,2,1824.62,1595.0
19458,UC108FB,9,1367.6900000000003,7,2,2278.5,3646.19
19459,U75F0A9,9,0.0,5,4,51000.0,51000.0
19460,UD72FF9,9,2883.1899999999996,7,2,5121.0,8004.19
19461,U60CCB9,9,-208.48000000000002,7,2,533.0,324.52
19462,U8CB733,9,-106.47000000000007,8,1,737.48,631.01
19463,U6AB40C,9,20000.0,6,3,20000.0,40000.0
19464,U7D8732,9,860.0299999999997,4,5,528.8499999999999,1388.8799999999999
19465,UFBEAB5,9,440.0,5,4,1313.0,1753.0
19466,UF1E37B,9,-21050.0,6,3,44701.22,23651.22
19467,UFF8D2A,9,289.61000000000035,7,2,3710.39,4000.0
19468,U70E20D,9,-486.11999999999995,8,1,1236.12,750.0
19469,U2A8B5B,9,-3374.690000000001,4,5,15500.0,12125.31
19470,UA1FE93,9,2018.6599999999999,7,2,85.26,2103.92
19471,U1ACA62,9,3.0,4,5,2725.0,2728.0
19472,UA7E697,9,-45720.45,6,3,51500.0,5779.55
19473,U825234,9,4594.5,4,5,4458.76,9053.26
19474,U0C2B38,9,-458.8800000000001,7,2,1158.88,700.0
19475,U8ED645,9,0.0,7,2,1803.89,1803.8899999999999
19476,UACF312,9,-3645.5399999999995,8,1,3665.5399999999995,20.0
19477,U29EFFC,9,-17.379999999999995,8,1,262.93,245.55
19478,U4F8F9A,9,2309.92,6,3,3947.32,6257.24
19479,UFD5F8B,9,922.4499999999996,5,4,4689.0,5611.45
19480,U1323FD,9,224384.81,1,8,32550.0,256934.81
19481,UDFC827,9,960.5,7,2,3652.5,4613.0
19482,U0AA822,9,67.43,8,1,232.57,300.0
19483,U932DD0,9,5043.639999999999,5,4,1974.94,7018.58
19484,UA94A4A,9,-949.3499999999997,4,5,4918.01,3968.6600000000008
19485,U458359,9,676.48,7,2,4830.5199999999995,5507.0
19486,UA4436B,9,30524.000000000004,5,4,3007.1000000000004,33531.1
19487,U815545,9,5669.830000000001,5,4,6492.62,12162.45
19488,UB8C5EB,9,-1741.72,8,1,1751.72,10.0
19489,UD59A33,9,5612.75,6,3,4144.25,9757.0
19490,UF4689B,9,-14951.359999999999,7,2,16379.229999999998,1427.8700000000001
19491,UE84264,9,660.0,7,2,4790.0,5450.0
19492,U394702,9,-468.0,7,2,598.0,130.0
19493,UAB9A07,9,1100.0,4,5,5919.2,7019.2
19494,U04648D,9,11000.0,5,4,1498.8,12498.8
19495,UB5388E,9,-4996.5,9,0,4996.5,0.0
19496,U1866A9,9,-116.00000000000011,6,3,2916.38,2800.38
19497,UC901EF,9,102.58000000000004,7,2,762.5799999999999,865.1600000000001
19498,UA53009,9,0.0,6,3,31600.0,31600.0
19499,UF1DF9D,9,10404.23,2,7,11666.66,22070.89
19500,U755CE9,9,47.999999999999545,5,4,8788.1,8836.1
19501,UCD72E9,9,-462.75,6,3,16658.11,16195.36
19502,U733924,9,2745.61,6,3,229.39999999999998,2975.01
19503,U6E39FD,9,142.12999999999957,6,3,4612.0,4754.129999999999
19504,UC1CA4E,9,2100.0499999999997,4,5,3037.92,5137.969999999999
19505,UF689D0,9,-1296.9099999999999,8,1,2296.91,1000.0
19506,U4E5E09,9,-76103.45000000001,5,4,81327.26000000001,5223.81
19507,U35A7DF,9,-227.79,9,0,227.79,0.0
19508,U89D78F,9,75900.02,1,8,100.0,76000.02
19509,U51B547,9,-64.54000000000033,7,2,2568.07,2503.5299999999997
19510,U55EDD8,9,0.0,4,5,6874.5,6874.5
19511,UCFF6BF,9,-329.24000000000046,7,2,3278.2400000000002,2949.0
19512,UBDEF79,9,-1012.7600000000007,5,4,21325.510000000002,20312.749999999996
19513,UF337A3,9,-1921.7800000000002,6,3,1971.7800000000002,50.0
19514,UD98998,9,37.45000000001164,5,4,214925.86,214963.31
19515,U45267B,9,-1312.8399999999992,5,4,7840.9,6528.06
19516,U7B59F6,9,4234.97,3,6,50.0,4284.97
19517,UF757F4,9,-22.670000000000073,6,3,13023.05,13000.380000000001
19518,UED2661,9,0.0,7,2,10100.0,10100.0
19519,U863BBF,9,-3051.8199999999997,7,2,20162.82,17111.0
19520,U1706D0,9,-4267.57,8,1,5122.89,855.32
19521,UBA88FB,9,-944.8,7,2,1369.0,424.2
19522,U291A5F,9,-286.8,7,2,649.7,362.9
19523,U463F02,9,-45.87,5,4,275.66,229.79000000000002
19524,U4DEAE8,9,10000.219999999998,3,6,9541.68,19541.9
19525,U4BDECE,9,233.64999999999927,4,5,12338.0,12571.65
19526,U449F7B,9,-5219.85,7,2,29796.0,24576.15
19527,UFE8383,9,8298.26,0,9,0.0,8298.26
19528,UB43550,9,142.6500000000001,7,2,1170.0,1312.65
19529,U61CC78,9,-777.5500000000001,7,2,857.97,80.42
19530,U52E677,9,2917.3900000000003,6,3,1115.92,4033.3100000000004
19531,UFDD358,9,9497.44,5,4,2470.0,11967.44
19532,UF0D003,9,-1665.0500000000002,7,2,16457.760000000002,14792.71
19533,U4CFFB1,9,-680.0,4,5,187730.0,187050.0
19534,UDB5146,9,-6708.13,7,2,7763.13,1055.0
19535,U3490EB,9,-3201.62,7,2,5153.780000000001,1952.16
19536,UC3405F,9,-19155.85,8,1,19180.45,24.6
19537,UD6CAC8,9,-5.684341886080802e-14,6,3,522.5400000000001,522.54
19538,UDBE4E3,9,1483.5700000000006,4,5,7606.0,9089.57
19539,U472EF7,9,-534.0,6,3,15957.0,15423.0
19540,U22AD39,9,-46.11999999999989,2,7,8823.8,8777.68
19541,U9D1B6A,9,0.0,8,1,7318.0,7318.0
19542,U1B7A38,9,-650.7600000000002,7,2,18333.76,17683.0
19543,U824110,9,-224.95,6,3,224.98,0.03
19544,U31F32E,9,3470.0,4,5,26168.0,29638.0
19545,UEF4CE8,9,-1363.38,8,1,1417.3000000000002,53.92
19546,U2468FB,9,-2511.9799999999996,6,3,6522.98,4011.0
19547,U7C0A5D,9,-0.34999999999990905,6,3,1670.25,1669.9
19548,UFD3990,9,1511.17,7,2,3662.0,5173.17
19549,UF22F2D,9,-2194.24,7,2,4409.24,2215.0
19550,U5121F6,9,-555.8199999999997,6,3,10120.0,9564.18
19551,UE23803,9,-1.6299999999999955,7,2,158.63,157.0
19552,U70235D,9,-5611.760000000001,8,1,5621.760000000001,10.0
19553,U0587CF,9,-1496.37,5,4,3258.0,1761.63
19554,UE7ABD7,9,-2100.0,8,1,2106.0,6.0
19555,U398F76,9,-256.13,5,4,3574.74,3318.61
19556,U623F4A,9,806.49,6,3,248.56,1055.05
19557,UEFFFE0,9,1391.5,6,3,10640.5,12032.0
19558,UBDDF97,9,0.0,7,2,64.3,64.3
19559,U6B8DF7,9,8958.33,2,7,340.66999999999996,9299.0
19560,U33A298,9,-45.620000000000005,8,1,744.62,699.0
19561,U8E1A36,9,-4.49,6,3,6111.5,6107.01
19562,U415F16,9,-23240.0,6,3,73240.0,50000.0
19563,UF2C519,9,-1079.6599999999999,6,3,6579.66,5500.0
19564,U89336E,9,0.8999999999999204,7,2,599.1000000000001,600.0
19565,UA4117C,9,340.4,7,2,2799.6,3140.0
19566,U059A81,9,0.0,7,2,360.0,360.0
19567,U707D2F,9,1.3400000000001455,7,2,8398.66,8400.0
19568,UD17428,9,-951.0,7,2,2951.0,2000.0
19569,UB040C2,9,-2031.6999999999998,5,4,4535.17,2503.4700000000003
19570,UBB1384,9,-3229.36,8,1,3729.36,500.0
19571,U562911,9,-941.48,8,1,1241.4799999999998,300.0
19572,UAE8504,9,-290.74000000000007,4,5,7464.5,7173.759999999999
19573,U0F527B,9,0.0,5,4,6000.0,6000.0
19574,UB961D5,9,242.0,6,3,2890.0,3132.0
19575,U52403C,9,-162.1800000000035,5,4,77162.27,77000.09
19576,U2C3170,9,-8.800000000000011,6,3,945.8,937.0
19577,UD059F2,9,-1047.0,8,1,1130.0,83.0
19578,U193807,9,8166.670000000002,6,3,9821.349999999999,17988.02
19579,UFB8D26,9,6602.049999999999,4,5,8900.0,15502.05
19580,UD2FBC2,9,-1833.51,7,2,3718.51,1885.0
19581,U15E78B,9,-483.0,3,6,5794.0,5311.0
19582,UEC38BC,9,-120.0,7,2,4000.0,3880.0
19583,UD48B7D,9,13.820000000000618,6,3,14947.48,14961.3
19584,U6FB18C,9,5754.37,4,5,5731.0,11485.369999999999
19585,U6300EB,9,79999.72,6,3,22283.28,102283.0
19586,UE2F0A0,9,-743.5,7,2,1343.5,600.0
19587,U351467,9,29.899999999999977,6,3,490.6,520.5
19588,U707297,9,-196.0,6,3,912.06,716.06
19589,U71E0F9,9,1736.770000000002,6,3,20688.03,22424.8
19590,UDBA6FD,9,16.199999999999992,6,3,64.01,80.21
19591,U7D7F1D,9,107568.29000000001,3,6,4101.95,111670.24
19592,UF0E872,9,140.0600000000004,2,7,8862.32,9002.38
19593,U08A7BD,9,11482.71,6,3,4866.34,16349.05
19594,UB0EF4E,9,-348.93,6,3,403.93,55.0
19595,U25A5FD,9,-10350.920000000002,8,1,10388.920000000002,38.0
19596,U9148E6,9,-0.22999999999997556,8,1,494.23,494.0
19597,U5299F8,9,-5.87,6,3,6.0,0.13
19598,UAFA4EE,9,-119.00000000000045,6,3,7483.9,7364.9
19599,UD5C66F,9,-182.95999999999998,8,1,183.0,0.04
19600,UED09FC,9,588.4000000000001,7,2,341.6,930.0
19601,U36F2CB,9,-4882.48,9,0,4882.48,0.0
19602,UEC3019,9,-1.9984014443252818e-13,5,4,3280.22,3280.22
19603,U0041D1,9,-5090.13,7,2,8780.26,3690.13
19604,U0C79D2,9,1700.8899999999994,7,2,19696.0,21396.89
19605,UB25C23,9,264.69000000000005,7,2,2125.77,2390.46
19606,U85FC4B,9,0.0,6,3,513.79,513.79
19607,U16E34C,9,3.430000000000018,5,4,2191.5499999999997,2194.98
19608,UDCF7FA,9,-260.76000000000005,8,1,305.72,44.96
19609,UA967CF,9,7756.42,6,3,15170.789999999999,22927.21
19610,UB797FE,9,-2072.72,8,1,2222.72,150.0
19611,U29F5F0,9,-790.7,7,2,6790.7,6000.0
19612,UE634EC,9,200.00000000000034,5,4,6006.700000000001,6206.7
19613,UCFC2C2,9,756.8299999999999,8,1,1093.17,1850.0
19614,UD5E93F,9,-2392.99,7,2,2876.44,483.45
19615,U9C626E,9,-2600.96,2,7,4246.0,1645.04
19616,U5DE904,9,-397.71000000000004,4,5,5100.0,4702.29
19617,UF24870,9,-1300.6,7,2,1512.5,211.9
19618,U495E75,9,-3707.0,7,2,56517.0,52810.0
19619,U80AAE4,9,-1374.3199999999997,6,3,4262.48,2888.16
19620,UB88D36,9,0.0,8,1,8.0,8.0
19621,U64B393,9,1971.7899999999997,5,4,305.24000000000007,2277.0299999999997
19622,U95773C,9,-193.42000000000002,8,1,193.52,0.1
19623,U4DF761,9,-635.9300000000001,7,2,669.86,33.93
19624,UE36B74,9,237.52999999999997,6,3,529.47,767.0
19625,UE66444,9,6899.9400000000005,5,4,6996.17,13896.11
19626,U31CFF6,9,3132.3199999999997,6,3,7191.68,10324.0
19627,U8CA25A,9,-93.92,4,5,5730.0,5636.08
19628,UF6B60E,9,243.38,7,2,3000.0,3243.38
19629,UECF446,9,501.28,4,5,1501.03,2002.31
19630,UED95CE,9,426.29999999999995,8,1,423.7,850.0
19631,U742F7F,9,-10.0,6,3,6010.0,6000.0
19632,U280856,9,0.0,4,5,13785.29,13785.29
19633,UEFBC0D,9,2549.0,5,4,6640.0,9189.0
19634,U0205D7,9,-423.6600000000001,9,0,423.6600000000001,0.0
19635,U854F76,9,-2589.7,7,2,5764.700000000001,3175.0
19636,UAE9769,9,-719.4499999999999,6,3,2719.46,2000.01
19637,UDB3CBC,9,0.0,4,5,4200.0,4200.0
19638,U33A645,9,121.36000000000001,6,3,590.72,712.08
19639,U1896A0,9,248.80999999999995,6,3,432.70000000000005,681.51
19640,UB828AF,9,500.28,4,5,1105.6,1605.88
19641,UD0BDDE,9,0.0,6,3,4689.0,4689.0
19642,UECEFB2,9,-354.75,7,2,6183.0,5828.25
19643,U64BF61,9,-9818.060000000001,6,3,29123.0,19304.940000000002
19644,UE5154A,9,-1684.6899999999987,6,3,21784.69,20100.0
19645,UFDEEEF,9,1705.6000000000004,5,4,24168.88,25874.48
19646,U30F52F,9,-0.040000000000040926,6,3,2962.4,2962.36
19647,UBAE780,9,642.2,7,2,566.0,1208.2
19648,U75F92F,9,-3875.3599999999997,6,3,4326.2,450.84000000000003
19649,U493FCF,9,867.9000000000001,5,4,6684.219999999999,7552.12
19650,U488DF3,9,-461.71000000000004,8,1,547.71,86.0
19651,UBF508A,9,-589.98,6,3,1430.24,840.26
19652,U451849,9,-2151.12,9,0,2151.12,0.0
19653,U01FEE9,9,-3911.45,7,2,4422.61,511.16
19654,UFDEBA8,9,-3392.16,6,3,9089.14,5696.9800000000005
19655,U546035,9,10458.939999999999,4,5,7335.66,17794.6
19656,U8E2869,9,1256.11,3,6,40000.0,41256.11
19657,U6F6273,9,-50.0,6,3,5930.0,5880.0
19658,U164457,9,58290.0,2,7,10.0,58300.0
19659,UE8ACA1,9,6.0,6,3,10114.2,10120.2
19660,U7FBFCB,9,616.8,5,4,400.08,1016.88
19661,U2B9E9B,9,-2839.8999999999996,7,2,8439.9,5600.0
19662,UACEBE1,9,20810.699999999997,6,3,235.7,21046.4
19663,U3A15E3,9,0.0,6,3,347.18,347.18
19664,UDC965B,9,877.5,4,5,5100.5,5978.0
19665,U3D66BC,9,-19008.95,6,3,21039.0,2030.05
19666,UFED25C,9,-408.9,8,1,712.0,303.1
19667,U0DD659,9,-2790.0,8,1,6393.0,3603.0
19668,UA62650,9,17820.0,6,3,39494.0,57314.0
19669,UFB341A,9,5254.330000000002,5,4,15917.67,21172.0
19670,U239B8D,9,-3814.38,7,2,7590.570000000001,3776.1899999999996
19671,UFA2827,9,-20.98,4,5,5908.0,5887.02
19672,U704726,9,30000.0,6,3,527.3,30527.3
19673,U899647,9,465.08,3,6,35.0,500.08
19674,UBC4C21,9,-851.88,9,0,851.88,0.0
19675,U9B0B39,9,-69.74,7,2,389.64,319.9
19676,UC1AB65,9,-7466.459999999999,8,1,7688.48,222.02
19677,U9ECC8C,9,246.51999999999998,4,5,5634.98,5881.5
19678,U275F02,9,0.0,4,5,18115.07,18115.07
19679,U1CCE89,9,-14305.66,9,0,14305.66,0.0
19680,U395064,9,62174.979999999996,2,7,380000.0,442174.98
19681,U4D5081,9,2280.0,4,5,29984.0,32264.0
19682,U1D2574,9,-89.8,6,3,105.4,15.599999999999998
19683,UF4CF5B,9,4050.01,2,7,5299.99,9350.0
19684,U809409,9,22999.89,5,4,46943.34,69943.23
19685,UE0A727,9,21.430000000000064,4,5,7928.0,7949.43
19686,U693956,9,-14451.98,4,5,30349.91,15897.93
19687,U958B40,9,-114.7199999999998,6,3,4425.73,4311.01
19688,U6C7ED2,9,4024.5600000000004,6,3,1483.88,5508.44
19689,U310937,9,36.590000000000146,5,4,16910.0,16946.59
19690,U2C9747,9,184.74,6,3,588.37,773.11
19691,U437F55,9,-3497.76,6,3,6643.799999999999,3146.04
19692,U7AA342,9,5485.82,4,5,25425.0,30910.82
19693,U9F9785,9,18795.75,4,5,20520.0,39315.75
19694,UA9E483,9,-2566.6600000000003,6,3,8628.630000000001,6061.969999999999
19695,UC46BB5,9,7496.5599999999995,4,5,7429.56,14926.12
19696,U79D298,9,-6759.949999999999,8,1,10759.949999999999,4000.0
19697,UA57690,9,-877.0200000000008,5,4,19917.82,19040.8
19698,U2970A1,9,10.789999999999914,5,4,4145.34,4156.13
19699,U1F2F08,9,6.74807432154978e-16,7,2,5.059999999999999,5.06
19700,UBF4689,9,-222.6,7,2,353.0,130.4
19701,U39FF6A,9,0.1400000000000432,7,2,1075.72,1075.8600000000001
19702,UE4743C,9,-1985.5499999999997,7,2,4986.78,3001.23
19703,U5457D5,9,-164.33000000000015,7,2,2328.9,2164.5699999999997
19704,UE54F12,9,-377.0,5,4,8377.0,8000.0
19705,U1793B9,9,739.52,7,2,401.51,1141.03
19706,UEDD487,9,1365.33,7,2,1655.16,3020.49
19707,U2C4AD1,9,-11388.03,7,2,12118.04,730.01
19708,U029A69,9,13296.89,5,4,18654.22,31951.11
19709,U953B35,9,3235.8699999999994,7,2,8632.0,11867.869999999999
19710,U3F2F1B,9,439.78,4,5,275.5,715.28
19711,UEDA489,9,3858.0,7,2,16224.0,20082.0
19712,UFB60D9,9,243.78000000000011,7,2,1244.1499999999999,1487.93
19713,U4C11E4,9,-7358.830000000002,8,1,7358.840000000002,0.01
19714,UF0D64C,9,-2474.5,8,1,6127.67,3653.17
19715,UE6ADED,9,-4650.540000000001,7,2,17221.54,12571.0
19716,UDF08CF,9,63.52000000000044,5,4,20045.0,20108.52
19717,U11CE82,9,218.74000000000015,4,5,2158.65,2377.39
19718,U5AE20D,9,2778.2799999999997,4,5,1786.72,4565.0
19719,U0FE655,9,-3775.3100000000004,5,4,16562.65,12787.34
19720,UB0066E,9,2633.09,5,4,2191.36,4824.45
19721,UA42D38,9,54.309999999999945,5,4,5960.0,6014.31
19722,UFD16DD,9,-1947.7500000000002,8,1,1948.5400000000002,0.79
19723,U05151F,9,-600.0,5,4,2748.0,2148.0
19724,U139BB4,9,330.0,5,4,12750.0,13080.0
19725,U903372,9,-0.9899999999979627,4,5,40000.0,39999.01
19726,U7B686C,9,-20996.430000000004,5,4,32200.0,11203.57
19727,U5634F7,9,-7200.0,5,4,23200.0,16000.0
19728,U3A0D60,9,331.47999999999956,6,3,9500.0,9831.48
19729,U1843D0,9,-16748.0,8,1,16848.0,100.0
19730,U47A29C,9,-1014.1199999999985,4,5,40967.299999999996,39953.18
19731,U95C60E,9,1243.3100000000004,5,4,5789.98,7033.29
19732,U831111,9,-7064.860000000102,4,5,3316847.9,3309783.04
19733,U1C2AA2,9,735.9199999999889,5,4,100255.30000000002,100991.22
19734,UCCA2BF,9,-325.97,6,3,1847.94,1521.97
19735,UC57CD3,9,-514.0,7,2,3333.0,2819.0
19736,UAB7FED,9,217.1,3,6,78.0,295.1
19737,UAD6D67,9,-28278.36,7,2,29293.0,1014.64
19738,UAD15D2,9,275.87,6,3,267.68999999999994,543.56
19739,U5409F7,9,1003.9699999999998,7,2,2947.9,3951.87
19740,U934B14,9,-1191.2,9,0,1191.2,0.0
19741,U677C85,9,-39226.0,6,3,148326.0,109100.0
19742,U9A1C4C,9,-3050.0,5,4,21507.0,18457.0
19743,U46CEF7,9,-4.263256414560601e-14,7,2,1540.03,1540.03
19744,UC338B2,9,4092.0999999999995,6,3,1340.6399999999999,5432.74
19745,U28507C,9,-2699.06,5,4,3301.18,602.12
19746,U347A8D,9,87.96000000000008,6,3,974.3399999999999,1062.3
19747,U4AA6AE,9,-4540.789999999997,3,6,31548.35,27007.56
19748,U9BF1FD,9,607.01,4,5,549.59,1156.6
19749,U9FD4AC,9,260.2199999999998,4,5,6260.0,6520.219999999999
19750,UED0DDC,9,-580.0,4,5,48990.0,48410.0
19751,U34D2E3,9,-2494.32,5,4,4507.5,2013.1799999999998
19752,U2BD0BB,9,77.74999999999994,7,2,393.45000000000005,471.2
19753,UBEF628,9,14958.06,4,5,934.12,15892.179999999998
19754,UAC6AB7,9,-726.55,5,4,1026.6899999999998,300.14
19755,U4E62A0,9,15379.7,5,4,436.64,15816.34
19756,U9D871C,9,6.399999999999636,5,4,7803.6,7810.0
19757,UEC130A,9,100.0,4,5,14000.0,14100.0
19758,U89D667,9,-170.98000000000002,4,5,2119.17,1948.19
19759,UC0CEBF,9,-534.3999999999996,8,1,4034.3999999999996,3500.0
19760,U59DFB6,9,-1117.95,8,1,1117.98,0.03
19761,UF619B5,9,-243.11999999999898,6,3,11473.12,11230.0
19762,UDDB87B,9,15000.0,3,6,14516.54,29516.54
19763,U7413C9,9,-1451.8600000000001,6,3,6413.0,4961.139999999999
19764,U9796A6,9,-17.849999999998545,6,3,20018.11,20000.26
19765,UB012B5,9,-26270.850000000002,7,2,29280.120000000003,3009.27
19766,UAE9BCD,9,139.73,7,2,422.01,561.74
19767,UB7CEEB,9,229.1199999999999,7,2,2240.38,2469.5
19768,UE83080,9,2450.2599999999998,3,6,3030.8199999999997,5481.08
19769,U90BED1,9,-5955.0,6,3,7070.0,1115.0
19770,U9CDEEF,9,-4999.92,7,2,6500.0,1500.08
19771,UEF22C3,9,-9.094947017729282e-13,6,3,16244.559999999998,16244.559999999998
19772,U884B1F,9,45090.16,4,5,11534.78,56624.94
19773,UF94E28,9,300.26000000000045,5,4,6062.8,6363.06
19774,U4F3DF8,9,86.0,8,1,2114.0,2200.0
19775,U1490D5,9,280.67999999999995,6,3,290.72,571.4
19776,UD688C7,9,2471.2000000000007,6,3,16275.8,18747.0
19777,UBB00C4,9,750.0,4,5,16184.0,16934.0
19778,U057419,9,-334.86999999999995,6,3,917.68,582.81
19779,UD99A2F,9,-645.53,8,1,945.53,300.0
19780,UE76DA7,9,3340.88,5,4,540.0,3880.88
19781,U14B9F2,9,0.4099999999998545,3,6,35010.880000000005,35011.29
19782,U2E44E4,9,-23755.0,7,2,41059.0,17304.0
19783,U041166,9,-1850.3900000000003,8,1,4850.39,3000.0
19784,U268FA5,9,9471.26,2,7,1336.0,10807.26
19785,U474D16,9,-789.6599999999999,6,3,2411.0,1621.3400000000001
19786,UF42F67,9,-1592.58,6,3,5628.09,4035.51
19787,UDED882,9,53.319999999999915,5,4,3226.6800000000003,3280.0
19788,U776AF8,9,-24420.0,6,3,29852.0,5432.0
19789,UCCFA75,9,4239.68,5,4,1189.45,5429.13
19790,UE6114B,9,1067.8600000000001,8,1,1438.94,2506.8
19791,U74FB26,9,511.15,4,5,7681.15,8192.3
19792,UC1771A,9,7076.700000000001,2,7,2546.47,9623.17
19793,U678D75,9,2025.1199999999913,3,6,102093.98000000001,104119.09999999999
19794,UF66EFB,9,-28193.350000000002,5,4,103329.54000000001,75136.19
19795,U78D688,9,-1708.68,8,1,1710.26,1.58
19796,U8848AB,9,-1091.38,8,1,1111.38,20.0
19797,U5961CB,9,-5170.39,8,1,5170.920000000001,0.53
19798,U117AC1,9,-4.0,5,4,12004.0,12000.0
19799,UD8BC3E,9,1794.0599999999993,4,5,25932.470000000005,27726.53
19800,UE74671,9,455.87,5,4,9754.63,10210.5
19801,U74D8E9,9,689.52,6,3,642.5,1332.02
19802,U91DD12,9,-11863.82,8,1,14863.82,3000.0
19803,U492AF8,9,5.560000000000002,6,3,248.44,254.0
19804,U9C1AF2,9,-0.9099999999998545,6,3,1487.1799999999998,1486.27
19805,U11AD5C,9,-3014.5799999999995,7,2,6754.58,3740.0
19806,UE65981,9,-10.0,8,1,10.32,0.32
19807,U90B86B,9,192.3900000000001,8,1,907.6099999999999,1100.0
19808,U114731,9,-1138.4000000000003,6,3,9827.399999999998,8689.0
19809,U356033,9,-30.040000000000006,8,1,31.040000000000006,1.0
19810,UD49853,9,21955.449999999993,3,6,52028.51,73983.95999999999
19811,U50C0D1,9,-23746.91,6,3,35398.45,11651.54
19812,U16B90B,9,11394.320000000002,4,5,46401.01,57795.33
19813,U6F567F,9,-523.6,5,4,1068.6100000000001,545.01
19814,U1486F0,9,-350.41999999999996,7,2,678.0699999999999,327.65000000000003
19815,UF4B5A7,9,13.000000000000028,7,2,389.89,402.89
19816,U276C56,9,1456.1,7,2,339.90000000000003,1796.0
19817,U5CEBD6,9,1129.14,8,1,670.8599999999999,1800.0
19818,UC59A2B,9,0.010000000000218279,6,3,2863.34,2863.3500000000004
19819,U6B6FC8,9,606.6499999999996,7,2,3000.35,3607.0
19820,U9AF237,9,2.740000000000066,4,5,1593.0,1595.74
19821,UABAE37,9,-717.3299999999996,6,3,10616.460000000001,9899.130000000001
19822,U6EDB05,9,-2473.3199999999997,5,4,54942.0,52468.68
19823,U99F9A5,9,24.0,7,2,2196.54,2220.54
19824,UDF5CA0,9,1346.3500000000001,8,1,2492.2799999999997,3838.63
19825,U38B1A6,9,-18570.0,7,2,47558.0,28988.0
19826,U7B2173,9,8580.029999999999,6,3,12340.0,20920.03
19827,U403204,9,9.0,0,9,0.0,9.0
19828,UC2C52E,9,4445.25,7,2,1287.27,5732.5199999999995
19829,UD88DB7,9,-45.600000000000016,7,2,571.0899999999999,525.49
19830,U34DB28,9,878.130000000001,3,6,19408.16,20286.29
19831,UD5AAE0,9,-3500.39,6,3,6188.72,2688.33
19832,U6305B4,9,92.42999999999995,6,3,1048.5300000000002,1140.96
19833,U5ADCB3,9,-390.0,7,2,1129.0,739.0
19834,U3CBF5F,9,2879.1,8,1,870.8999999999999,3750.0
19835,U8B2F69,9,-1.1368683772161603e-13,7,2,2460.66,2460.66
19836,U64327A,9,148.0,4,5,45708.0,45856.0
19837,U46F6D2,9,670.4000000000001,4,5,1184.52,1854.9199999999998
19838,U087125,9,-23.159999999999997,7,2,323.2,300.04
19839,UF6B597,9,103.0,4,5,19788.0,19891.0
19840,U49B47A,9,-746.49,6,3,1909.68,1163.19
19841,U962A5D,9,13375.49,4,5,1380.0,14755.49
19842,UF6069E,9,-1.0,5,4,16001.0,16000.0
19843,UE25B9D,9,2476.470000000001,3,6,135500.0,137976.47
19844,U293906,9,7500.0,5,4,30000.0,37500.0
19845,U5EC51E,9,-8416.44,5,4,14360.0,5943.5599999999995
19846,UEE4173,9,-5791.299999999999,6,3,18282.0,12490.7
19847,U82E59E,9,-64.25,7,2,12014.0,11949.75
19848,U74491E,9,-596.8,8,1,597.6299999999999,0.83
19849,U8CD1C5,9,799.0,5,4,8796.0,9595.0
19850,U59006B,9,7061.96,7,2,4617.990000000001,11679.95
19851,UB6D976,9,-2043.9999999999998,6,3,7939.0,5895.0
19852,UD5D538,9,-586.98,5,4,2589.01,2002.03
19853,UFDADBD,9,9931.2,6,3,16013.8,25945.0
19854,U78D681,9,15327.92,4,5,7080.0,22407.92
19855,UAF1334,9,104.29000000000002,7,2,410.0,514.29
19856,UB926A7,9,1.6499999999999955,4,5,134.87,136.51999999999998
19857,U03CC81,9,12027.59,6,3,3776.12,15803.71
19858,UE4D95A,9,-1401.42,9,0,1401.42,0.0
19859,U5A58B2,9,-417.03999999999905,7,2,6176.6,5759.56
19860,U0A0FB7,9,-1634.2699999999968,5,4,43069.25,41434.979999999996
19861,U6679AC,9,335.7999999999996,7,2,2360.2000000000003,2696.0
19862,U60F020,9,-48.05999999999999,9,0,48.05999999999999,0.0
19863,UA81420,9,-2506.0,5,4,2956.0,450.0
19864,UD18848,9,-851.4800000000005,7,2,4314.97,3463.49
19865,U7B5E7F,9,-537.3199999999999,7,2,1967.3200000000002,1430.0
19866,UD8678A,9,-4911.77,7,2,9938.0,5026.23
19867,U7CABE0,9,-0.7000000000000455,6,3,381.09000000000003,380.39
19868,U34D0A6,9,-2011.8999999999996,8,1,12205.76,10193.86
19869,U14DCB3,9,-1624.0300000000002,8,1,1697.43,73.4
19870,U09612A,9,4528.0,5,4,3460.0,7988.0
19871,U871EE8,9,-2789.1400000000003,5,4,3289.1400000000003,500.0
19872,U4C864D,9,3330.0,0,9,0.0,3330.0
19873,U42A952,9,-1125.21,5,4,3938.0,2812.79
19874,UA0D291,9,-55.0,7,2,9508.0,9453.0
19875,UF06CE6,9,-1.9799999999995634,5,4,7030.01,7028.03
19876,U88C043,9,2158.9799999999996,6,3,8860.54,11019.52
19877,UB19053,9,-12152.560000000001,8,1,12157.05,4.49
19878,U378996,9,-866.0,6,3,4918.0,4052.0
19879,U7ADD40,9,-27020.879999999997,7,2,33081.88,6061.0
19880,UA1FEDE,9,8426.800000000001,4,5,17076.1,25502.9
19881,U18CF59,9,-264.39999999999986,5,4,1074.43,810.03
19882,U94C39E,9,998.35,4,5,5082.98,6081.33
19883,UED2988,9,2301.8999999999996,7,2,3794.0,6095.9
19884,U94B5B6,9,8400.0,0,9,0.0,8400.0
19885,UE7CD41,9,0.0,3,6,45000.0,45000.0
19886,U0FFFFE,9,-2259.9,8,1,5979.900000000001,3720.0
19887,UE78BE0,9,1110.3299999999997,6,3,3532.85,4643.18
19888,UE81E9F,9,74.40000000000009,8,1,3908.6,3983.0
19889,U19FCD1,9,-118.18000000000008,5,4,1492.18,1374.0
19890,U04C294,9,10547.0,4,5,42453.0,53000.0
19891,U263836,9,80.89999999999993,7,2,856.3900000000002,937.29
19892,UFF515A,9,-552.8900000000001,8,1,572.8900000000001,20.0
19893,UFE2BA2,9,-3389.2999999999993,6,3,9949.3,6560.0
19894,UE4E884,9,2703.47,7,2,1395.53,4099.0
19895,U6345E1,9,687.6199999999999,8,1,1012.3799999999999,1700.0
19896,U3AD066,9,-3582.0,6,3,10970.0,7388.0
19897,U64E93F,9,5277.010000000002,5,4,44433.0,49710.01
19898,U7FD694,9,55.0,4,5,2970.0,3025.0
19899,UF4660B,9,-1380.4099999999999,6,3,1602.5799999999997,222.17000000000002
19900,U69854B,9,-0.45999999999995567,7,2,673.06,672.6
19901,U60AAC2,9,4981.9,6,3,5118.1,10100.0
19902,UF9A0BE,9,-5982.029999999999,7,2,10882.029999999999,4900.0
19903,UEEC528,9,-452.4799999999999,8,1,692.4799999999999,240.0
19904,U191415,9,5978.12,5,4,1636.0,7614.12
19905,UCC4C6B,9,-2929.0,5,4,14908.0,11979.0
19906,U38569B,9,-11.0,6,3,14.0,3.0
19907,U6500E2,9,-1346.4899999999998,4,5,12500.0,11153.51
19908,U436B15,9,49.50000000000007,5,4,10556.5,10606.0
19909,U6E5CA2,9,-40.0,6,3,2406.7,2366.7000000000003
19910,U5C12E2,9,-520.92,6,3,889.64,368.71999999999997
19911,UEB603D,9,-2703.18,7,2,3026.99,323.81
19912,U61E955,9,5428.270000000004,5,4,73853.86,79282.13
19913,U0A4272,9,-295.0,7,2,16590.0,16295.0
19914,U3D0C86,9,980.7299999999996,6,3,8027.0,9007.73
19915,UAC1E8C,9,306.51000000000005,6,3,167.99,474.5
19916,UB0E6E9,9,7842.199999999999,6,3,4433.400000000001,12275.6
19917,UF6D103,9,-69.98,8,1,188.43,118.45
19918,U188E60,9,-583.68,8,1,584.68,1.0
19919,UC37FC2,9,-14.470000000000255,5,4,6019.0,6004.530000000001
19920,U759869,9,-7386.169999999998,6,3,53049.41,45663.24
19921,UFB0143,9,7038.969999999999,2,7,6000.0,13038.97
19922,U40DCFC,9,-7778.32,9,0,7778.32,0.0
19923,U09D14D,9,-2599.89,6,3,7800.0,5200.110000000001
19924,U7A12FF,9,0.030000000000009686,7,2,505.97,506.0
19925,UD9AA55,9,16973.250000000004,2,7,25600.0,42573.25000000001
19926,UA25861,9,414.35999999999996,7,2,965.6400000000001,1380.0
19927,U87A047,9,-13752.35,6,3,27502.940000000002,13750.59
19928,U7E27ED,9,-10.000000000000114,7,2,1010.4300000000001,1000.43
19929,U6A5937,9,-2.779999999948757,3,6,401874.56,401871.78
19930,U76B340,9,11323.6,7,2,13039.300000000001,24362.9
19931,U7AA673,9,-936.7999999999997,7,2,4225.389999999999,3288.59
19932,UDB114A,9,44959.58,5,4,10419.18,55378.76
19933,U7D9317,9,-2166.94,6,3,2726.94,560.0
19934,U43E467,9,11765.510000000004,3,6,15232.8,26998.309999999998
19935,U75DB05,9,-7979.59,7,2,35994.0,28014.41
19936,U70B275,9,6.8599999999999,6,3,1573.14,1580.0
19937,U4FE79E,9,1704.0,6,3,382.5,2086.5
19938,UA2BE30,9,-2010.0,6,3,5491.0,3481.0
19939,UD3EC65,9,-29.46,8,1,29.560000000000002,0.1
19940,U83E9BF,9,689.0,6,3,970.0,1659.0
19941,U878A3A,9,-58027.0,5,4,126567.0,68540.0
19942,U957F13,9,-3276.8500000000004,7,2,4478.69,1201.84
19943,U711F14,9,0.0,5,4,110950.0,110950.0
19944,U8A5551,9,300.04999999999995,6,3,491.53000000000003,791.5799999999999
19945,U213692,9,-3933.0,5,4,15523.0,11590.0
19946,U499937,9,40.69,6,3,657.08,697.77
19947,UCA2B27,9,175.0,7,2,735.0,910.0
19948,U1FA018,9,3419.4599999999996,5,4,2813.82,6233.28
19949,U574315,9,-1220.0,5,4,9419.0,8199.0
19950,U1CA5B9,9,3367.5599999999995,5,4,3740.84,7108.4
19951,UC34600,9,-679.28,8,1,680.59,1.31
19952,U8286AE,9,-4646.04,7,2,10043.5,5397.46
19953,U27DEF8,9,3470.1499999999996,6,3,1719.3,5189.45
19954,U3D301B,9,12177.43,4,5,9336.74,21514.17
19955,UFA3317,9,-1639.69,6,3,3211.29,1571.6
19956,U6A00F4,9,265.99,6,3,3592.35,3858.34
19957,U6800DD,9,-145.0,9,0,145.0,0.0
19958,U2A971F,9,-7568.999999999999,5,4,15276.0,7707.0
19959,U38D82E,9,3931.0,5,4,8369.0,12300.0
19960,U5BF16E,9,3650.650000000001,6,3,15898.869999999999,19549.52
19961,U9A45E4,9,-682.5200000000001,8,1,1182.52,500.0
19962,UE358AE,9,58541.67,4,5,4916.66,63458.33
19963,U1B5D47,9,8531.83,5,4,4270.17,12802.0
19964,UF00133,9,-1000.0,7,2,8000.0,7000.0
19965,UE38810,9,-2023.47,5,4,2173.4900000000002,150.01999999999998
19966,U984276,9,1723.5800000000004,6,3,2435.0699999999997,4158.650000000001
19967,U6462AE,9,-6906.99,6,3,8507.0,1600.01
19968,UCFDA3E,9,3109.5699999999997,7,2,6490.43,9600.0
19969,UB35696,9,445.59000000000015,5,4,4504.41,4950.0
19970,UC129E8,9,2994.76,6,3,10222.2,13216.96
19971,U50265D,9,-4996.38,5,4,19995.72,14999.34
19972,U71D6B8,9,2872.8399999999992,3,6,9621.59,12494.43
19973,U07CF2E,9,39.930000000000064,7,2,950.78,990.71
19974,UD3A32D,9,-19275.0,5,4,34830.0,15555.0
19975,U15D3F5,9,-1002.73,8,1,1003.66,0.93
19976,U413390,9,3127.2,7,2,3272.8,6400.0
19977,U318E73,9,640.0,7,2,9520.0,10160.0
19978,UF8443C,9,-1398.43,7,2,3250.8,1852.37
19979,U13E37F,9,-390.0,7,2,5190.0,4800.0
19980,UE2EF8D,9,3999.3199999999997,6,3,60000.0,63999.32
19981,U713566,9,-9163.56,8,1,11163.56,2000.0
19982,UC53D30,9,4196.41,1,8,5.0,4201.41
19983,UFA6011,9,-0.01999999999998181,4,5,1086.0,1085.98
19984,U0D40CC,9,75.37,7,2,725.91,801.28
19985,U53D6E4,9,-170.93000000000006,7,2,941.26,770.3299999999999
19986,UDFA3F2,9,200.0,7,2,715.3,915.3
19987,U961CDA,9,-11501.000000000002,6,3,32920.87,21419.87
19988,UDD2B0A,9,-903.4,9,0,903.4,0.0
19989,UC57E8D,9,-74.86000000000001,7,2,232.36,157.5
19990,UF75C1B,9,-4376.9400000000005,7,2,9381.04,5004.1
19991,U89A614,9,20855.66,7,2,7744.34,28600.0
19992,U86B391,9,-2405.79,8,1,2921.0999999999995,515.31
19993,U2720FD,9,-424.08000000000004,8,1,434.08000000000004,10.0
19994,U1DE449,9,5.0,7,2,19995.0,20000.0
19995,U079F52,9,-365.36999999999955,8,1,3415.04,3049.67
19996,U47EE36,9,-9388.0,7,2,15388.0,6000.0
19997,UE08F6A,9,-2661.2599999999998,8,1,2662.0299999999997,0.77
19998,UCEFC28,9,652.1100000000002,3,6,8750.0,9402.11
19999,U864BE0,9,2851.16,6,3,7748.84,10600.0
20000,U14D284,9,315.9699999999999,7,2,2174.03,2490.0
20001,UDC57C1,9,-2629.65,7,2,4949.650000000001,2320.0
20002,U1A8DB3,9,-234.3199999999997,5,4,11667.68,11433.36
20003,UD66BA6,9,-2102.82,8,1,2104.0,1.18
20004,U7680B0,9,-5726.37,6,3,10556.31,4829.9400000000005
20005,U46257D,9,0.5,5,4,3296.5,3297.0
20006,UE8C37B,9,-283.34999999999945,5,4,3338.8,3055.45
20007,U335328,9,17.690000000000012,6,3,277.18,294.87
20008,U8956A1,9,-351.91999999999996,8,1,653.92,302.0
20009,U8022B0,9,3335.9500000000003,6,3,2746.9100000000003,6082.860000000001
20010,U0AA16C,9,-4781.86,8,1,7381.86,2600.0
20011,U6E0557,9,15819.07,3,6,129.1,15948.169999999998
20012,UDB2EC2,9,1546.22,5,4,568.8,2115.02
20013,U3D10E4,9,904.83,6,3,921.77,1826.6000000000001
20014,UC8A874,9,934.06,6,3,756.0,1690.06
20015,U3E9229,9,169.0,8,1,331.0,500.0
20016,U6987BC,9,-248.0,4,5,959.0,711.0
20017,U8D8329,9,8638.0,4,5,6476.0,15114.0
20018,U4F49B2,9,-1903.36,8,1,2099.36,196.0
20019,U8E6AA9,9,84.13999999999989,8,1,4823.86,4908.0
20020,U5F5DC2,9,541.46,7,2,1159.78,1701.24
20021,UC53CF0,9,-263.8000000000002,5,4,13812.0,13548.2
20022,UA35415,9,2507.7,5,4,5741.3,8249.0
20023,U7A4752,9,148.1599999999999,7,2,1193.0100000000002,1341.17
20024,U065AC0,9,12978.660000000003,5,4,12710.34,25689.0
20025,U2F092B,9,271.71000000000004,6,3,1528.29,1800.0
20026,U8FAA7C,9,624.47,6,3,831.0,1455.47
20027,U6AB0D3,9,275.42,6,3,9741.66,10017.08
20028,UF65B46,9,282.76,5,4,668.0,950.76
20029,U5A4217,9,-22175.009999999995,7,2,48154.1,25979.09
20030,U4169A7,9,-39.019999999999996,5,4,517.0,477.98
20031,UB60F0B,9,18207.000000000004,6,3,21800.06,40007.060000000005
20032,UC60D20,9,19.809999999999974,6,3,583.6,603.4100000000001
20033,U7A8CE1,9,107.00000000000217,7,2,9827.879999999997,9934.88
20034,U58DEE6,9,428.05,3,6,2100.0,2528.0499999999997
20035,U665763,9,4.0,5,4,29996.0,30000.0
20036,U738083,9,-2680.769999999997,5,4,71374.0,68693.23000000001
20037,U77EBFF,9,-7315.249999999999,7,2,7315.2699999999995,0.02
20038,U87070D,9,828.9200000000001,7,2,336.58,1165.5
20039,U2474BB,9,1115.0,5,4,1469.1599999999999,2584.16
20040,U044DB9,9,-312.4599999999991,5,4,6785.0,6472.540000000001
20041,UA00581,9,143.70000000000002,8,1,176.3,320.0
20042,U6DBFA5,9,100.0,5,4,23910.0,24010.0
20043,U8FBC6B,9,5351.749999999999,4,5,1757.8000000000002,7109.549999999999
20044,U65A65B,9,315.0400000000009,4,5,23500.0,23815.04
20045,UBFAB37,9,-143.18,8,1,168.78,25.6
20046,U71F961,9,-9993.929999999997,6,3,20271.179999999997,10277.25
20047,UB421E1,9,-2791.0200000000004,5,4,16052.08,13261.060000000001
20048,U0795A2,9,-2652.69,9,0,2652.69,0.0
20049,U443754,9,-1101.0,6,3,3700.0,2599.0
20050,UDD887E,9,-11925.130000000001,6,3,27625.199999999997,15700.07
20051,UF44F7D,9,-3011.0,8,1,3911.0,900.0
20052,U9F1CD8,9,-22995.940000000002,8,1,22995.960000000003,0.02
20053,UE55F6A,9,-2737.08,5,4,8728.5,5991.42
20054,U14B56D,9,202.57999999999993,4,5,1901.0,2103.58
20055,UEEE1A5,9,-39947.21,6,3,40094.66,147.45
20056,U0907D4,9,408.8699999999999,3,6,1161.88,1570.75
20057,U7FA1B6,9,100016.87,4,5,110015.87,210032.74
20058,U77C077,9,2.273181642920008e-14,5,4,222.6,222.6
20059,U901AD8,9,281.5599999999995,6,3,14220.0,14501.56
20060,U36076B,9,-5108.98,9,0,5108.98,0.0
20061,U9AF105,9,-8900.0,5,4,21555.98,12655.98
20062,U163C9D,9,0.0,6,3,2413.46,2413.46
20063,U260762,9,-5500.49,5,4,8911.42,3410.9300000000003
20064,UB84270,9,-12297.380000000001,8,1,12347.380000000001,50.0
20065,U0B7F4E,9,-1556.48,8,1,1586.48,30.0
20066,U02FCAD,9,-1108.3100000000004,6,3,9495.320000000002,8387.01
20067,UFB2136,9,-4000.979999999999,5,4,10500.98,6500.0
20068,UC5DB80,9,-1753.47,9,0,1753.47,0.0
20069,U290AB7,9,579.5300000000001,7,2,633.13,1212.66
20070,UB0A1A8,9,184.10999999999956,7,2,2784.4,2968.51
20071,U1621D8,9,-422.3000000000002,5,4,6069.3,5647.0
20072,UD82332,9,-4.050093593832571e-13,6,3,5654.69,5654.69
20073,UAD0020,9,366.45000000000005,5,4,1634.67,2001.12
20074,UA870BD,9,20.810000000000173,5,4,3237.6,3258.41
20075,U38B58A,9,-673.4899999999998,4,5,2226.5800000000004,1553.0899999999997
20076,U7800C9,9,-2183.6000000000004,8,1,3183.6000000000004,1000.0
20077,U98ED88,9,91.74000000000021,5,4,4431.74,4523.48
20078,UD5B5AA,9,275.72999999999996,7,2,500.16,775.8900000000001
20079,UB751BA,9,-26.98999999999978,5,4,9623.99,9597.0
20080,U0C9D4C,9,-79.07000000000005,5,4,777.8,698.73
20081,U12D264,9,100.0,5,4,47.4,147.4
20082,U514E95,9,-12191.86,8,1,18101.86,5910.0
20083,UC37A34,9,16500.0,4,5,2306.0,18806.0
20084,UFD4506,9,353.29999999999995,6,3,989.9,1343.1999999999998
20085,U25C8BC,9,2000.1400000000003,4,5,22200.0,24200.14
20086,UB5306C,9,0.0,6,3,203.8,203.8
20087,U6A634A,9,445.13,6,3,1398.87,1844.0
20088,UC8EF17,9,6729.4,5,4,6306.95,13036.349999999999
20089,U3BA571,9,-19020.0,7,2,32720.0,13700.0
20090,UC537ED,9,-594.32,8,1,1477.5,883.18
20091,U87E5DA,9,-538.17,8,1,638.1700000000001,100.0
20092,U7771EA,9,-6800.0,7,2,12997.0,6197.0
20093,UC3AE7E,9,1903.79,6,3,1192.6,3096.39
20094,U7E0742,9,1672.5899999999997,7,2,3072.0,4744.59
20095,U9B9249,9,-254.15999999999997,6,3,266.0,11.84
20096,U92FC98,9,104.46999999999997,5,4,634.6,739.0699999999999
20097,U17C607,9,2771.87,6,3,3192.9,5964.77
20098,U73E4BE,9,299.66999999999996,6,3,1000.33,1300.0
20099,U7D41AD,9,1408.8000000000002,6,3,3915.2,5324.0
20100,UC073AD,9,-3391.540000000001,7,2,10084.54,6693.0
20101,U79A124,9,-538.6299999999999,7,2,1600.26,1061.63
20102,UE257CE,9,-2492.82,7,2,4857.15,2364.33
20103,U5CBDFF,9,-3175.3600000000006,7,2,22775.36,19600.0
20104,U977518,9,-16288.0,7,2,35288.0,19000.0
20105,U70FD31,9,2041.2199999999998,5,4,4200.2,6241.42
20106,UC3987F,9,1084.6499999999999,5,4,516.78,1601.4299999999998
20107,U4F7E63,9,-6432.04,9,0,6432.04,0.0
20108,U9DCA53,9,60623.770000000004,3,6,11300.0,71923.76999999999
20109,U04E490,9,-0.10999999999648935,5,4,40424.0,40423.89000000001
20110,U229A39,9,-559.4,9,0,559.4,0.0
20111,UAB234A,9,3732.16,6,3,2238.84,5971.0
20112,U47ADB1,9,-6600.820000000001,6,3,9400.82,2800.0
20113,U256BEA,9,-1559.1599999999999,7,2,10859.16,9300.0
20114,U5630FF,9,6113.67,8,1,4208.93,10322.6
20115,UB66447,9,762.0300000000007,5,4,12702.97,13465.0
20116,U6F2AF5,9,-1163.1999999999998,6,3,9263.2,8100.0
20117,U261856,9,-8238.0,6,3,33872.0,25634.0
20118,UA4B902,9,11289.82,3,6,12710.18,24000.0
20119,UFD5522,9,24000.0,6,3,29500.0,53500.0
20120,UBBE04E,9,-8981.41,6,3,9886.31,904.9
20121,U3A6243,9,104.62,4,5,1099.62,1204.24
20122,U659540,9,546.15,7,2,2202.13,2748.2799999999997
20123,UFE3751,9,19.619999999999948,8,1,530.8,550.42
20124,UC76B7F,9,551.07,6,3,689.93,1241.0
20125,U9C22C8,9,983.8099999999998,5,4,3050.0,4033.81
20126,UD7B19F,9,118.65000000000003,8,1,406.34999999999997,525.0
20127,UBC5958,9,-657.29,5,4,4992.01,4334.72
20128,U78D952,9,5200.17,3,6,5175.0,10375.17
20129,U718551,9,-7888.769999999999,6,3,18036.0,10147.230000000001
20130,UA97062,9,302.25,5,4,2601.44,2903.69
20131,UA97F15,9,15930.51,3,6,16695.93,32626.44
20132,U9E8B68,9,922.86,4,5,928.55,1851.4099999999999
20133,U9E0D2E,9,-226.09,6,3,13600.9,13374.81
20134,U78230F,9,0.0,7,2,5984.0,5984.0
20135,U5870D5,9,2700.09,3,6,2777.7799999999997,5477.87
20136,U893D98,9,13.199999999999818,5,4,27282.0,27295.2
20137,UA429A0,9,-1194.5200000000002,8,1,3029.62,1835.1
20138,U3DCDC9,9,-3670.8999999999996,7,2,8962.08,5291.18
20139,U647E70,9,-1510.2599999999998,7,2,3152.26,1642.0
20140,U12EB7D,9,-3553.1400000000003,8,1,3763.1400000000003,210.0
20141,U58D15D,9,1466.6499999999999,7,2,68.05000000000001,1534.6999999999998
20142,UE0614E,9,-49.45,5,4,48045.45,47996.0
20143,U8D78E0,9,-15639.369999999999,4,5,20430.0,4790.63
20144,U80E361,9,-1675.8000000000002,5,4,10839.8,9164.0
20145,UEF89B8,9,0.0,5,4,140.8,140.8
20146,U981521,9,-1017.9000000000001,8,1,1018.0600000000001,0.16
20147,UC0A647,9,252.0,4,5,105.0,357.0
20148,U1B3A14,9,-1880.17,7,2,4779.15,2898.98
20149,UE50E5D,9,-123.71000000000001,8,1,123.77000000000001,0.06
20150,U7BBB2E,9,8362.460000000001,3,6,5.0,8367.460000000001
20151,U592E89,9,1748.17,5,4,176.43,1924.6000000000004
20152,UE9A4E6,9,-5452.29,6,3,6011.29,559.0
20153,U6204BA,9,-274.0,2,7,7000.0,6726.0
20154,U8AF90A,9,-1.1368683772161603e-13,7,2,1354.35,1354.35
20155,UE97EB5,9,-6326.37,6,3,18444.74,12118.369999999999
20156,UD065F2,9,2300.0,0,9,0.0,2300.0
20157,U0D8FA0,9,-247.98000000000002,6,3,6583.1,6335.12
20158,U92E085,9,-417.34999999999997,7,2,425.59999999999997,8.25
20159,UEF9180,9,-174.34000000000003,8,1,348.68,174.34
20160,UF14B69,9,-539.9200000000008,4,5,26039.95,25500.03
20161,U3F35DB,9,-12.0,7,2,6012.0,6000.0
20162,U3EAC12,9,22494.05,6,3,7008.0,29502.05
20163,U917D43,9,-6344.99,5,4,16401.0,10056.01
20164,UD9BE70,9,12720.990000000003,6,3,2537.6,15258.590000000002
20165,UDFF8B9,9,5798.040000000001,6,3,2014.0,7812.040000000001
20166,UE3F38F,9,114.00000000000001,3,6,432.0,546.0
20167,UB9CF6E,9,4822.549999999999,4,5,7725.91,12548.46
20168,UA03E4B,9,-167.21,5,4,286.78999999999996,119.58000000000001
20169,U0F0829,9,-4.670000000000073,7,2,3972.78,3968.1099999999997
20170,U89B0FF,9,-145.9,8,1,472.59999999999997,326.7
20171,U3F02D2,9,667.3900000000001,6,3,1225.64,1893.03
20172,UAAB03D,9,751.3100000000007,6,3,21838.7,22590.01
20173,U4D4A0B,9,-1120.0,6,3,10620.0,9500.0
20174,U05D3CE,9,1320.8000000000002,6,3,1089.2,2410.0
20175,UDF4793,9,-33976.56,4,5,41500.0,7523.4400000000005
20176,U6ED7BB,9,373.71000000000004,6,3,226.51999999999998,600.23
20177,UC4EA90,9,162.15,6,3,220.9,383.05
20178,U80C1BE,9,-2.2737367544323206e-13,8,1,1766.2,1766.2
20179,UE99E26,9,-19.80000000000001,6,3,500.75,480.95
20180,U4E1AD4,9,-2723.7100000000005,3,6,56747.84,54024.13
20181,UB8E86B,9,58.99999999999997,7,2,587.16,646.16
20182,U04CC34,9,0.0,7,2,9000.0,9000.0
20183,U7414D7,9,1575.0599999999997,8,1,1693.24,3268.3
20184,U923BBD,9,-14378.41,6,3,30556.58,16178.170000000002
20185,U2BD267,9,-4630.219999999999,6,3,5047.219999999999,417.0
20186,U52F0B1,9,-579.0,7,2,5353.0,4774.0
20187,U0A4F19,9,3767.81,6,3,1872.9,5640.71
20188,U970573,9,-1851.92,5,4,2981.0,1129.08
20189,U776F8A,9,-7575.94,9,0,7575.94,0.0
20190,U8889D0,9,2202.99,7,2,302.01,2505.0
20191,U7AB063,9,637.03,7,2,878.81,1515.84
20192,U2AB1A7,9,-10.949999999999818,6,3,8001.0,7990.05
20193,U8A4AE5,9,-2699.21,8,1,4665.880000000001,1966.67
20194,U42F6AF,9,-3500.0,7,2,7690.0,4190.0
20195,U9C90A6,9,6481.63,4,5,12913.94,19395.57
20196,UC87AFB,9,-1.6400000000000001,7,2,1.86,0.22000000000000003
20197,U91AAEA,9,451.3999999999999,6,3,501.35,952.75
20198,UC82509,9,-62.0,8,1,3993.5,3931.5
20199,U5411A0,9,2.559999999999995,6,3,53.790000000000006,56.35
20200,U30421F,9,76389.84,3,6,19399.16,95789.0
20201,UD9B7D1,9,-242.35000000000005,7,2,865.18,622.8299999999999
20202,U3D04AB,9,4.339999999999918,5,4,875.6600000000001,880.0
20203,U89104C,9,23089.869999999995,4,5,74020.0,97109.87
20204,UA2DC11,9,810.4900000000052,7,2,35046.509999999995,35857.0
20205,U4311E0,9,742.5000000000001,7,2,1358.1499999999999,2100.65
20206,U96FBD6,9,-1001.66,6,3,1691.78,690.12
20207,U51B8E1,9,-15306.0,5,4,38150.0,22844.0
20208,UAF061A,9,-4576.0,6,3,8469.0,3893.0
20209,UF8C2BB,9,-9910.0,7,2,14110.0,4200.0
20210,UAFEB25,9,41.81999999999982,6,3,1584.0,1625.8199999999997
20211,U761B4E,9,-6713.570000000001,6,3,7582.0,868.43
20212,U149858,9,-26.63000000000102,6,3,9970.39,9943.76
20213,UCB053F,9,982.0,5,4,4915.77,5897.77
20214,U45278D,9,-2274.0,7,2,4775.0,2501.0
20215,U27ED9F,9,-8800.04,7,2,22764.04,13964.0
20216,U87EE81,9,-639.2100000000002,9,0,639.2100000000002,0.0
20217,U17260E,9,-10819.83,5,4,19420.0,8600.17
20218,UB0DA4F,9,81.38000000000005,5,4,1023.5,1104.88
20219,U217682,9,0.0,4,5,16000.0,16000.0
20220,UC7A4E2,9,2.6100000000000274,4,5,260.0,262.61
20221,U51EEAE,9,0.02,5,4,438.68,438.7
20222,U7384E3,9,-4650.899999999999,6,3,15900.05,11249.150000000001
20223,UA3564E,9,-352.82000000000005,5,4,568.4300000000001,215.61
20224,UB56453,9,1104.1,6,3,15405.9,16510.0
20225,U926D34,9,-1518.72,9,0,1518.72,0.0
20226,UC8D0CC,9,-1301.2199999999998,6,3,7126.0,5824.780000000001
20227,UDF1F55,9,-429.96000000000004,7,2,1379.96,950.0
20228,UA8ABE5,9,-1319.66,7,2,4019.6600000000003,2700.0
20229,UCB34E4,9,1720.2700000000007,7,2,5594.6900000000005,7314.96
20230,U266320,9,-648.8700000000006,6,3,6349.52,5700.65
20231,U3D5825,9,4200.0,4,5,51545.0,55745.0
20232,UBD6911,9,30123.46,3,6,14589.32,44712.78
20233,U0AE8DA,9,-4591.110000000001,8,1,4606.110000000001,15.0
20234,U4C9E7A,9,-93.82000000000016,6,3,2767.88,2674.06
20235,U28F98C,9,-5082.5199999999995,7,2,12148.52,7066.0
20236,U098677,9,-1212.2199999999998,8,1,1417.2199999999998,205.0
20237,UEF1086,9,1427.5000000000002,8,1,4772.5,6200.0
20238,U1E1499,9,4040.0,4,5,4260.0,8300.0
20239,U8EBED0,9,66.0,6,3,460.0,526.0
20240,U836033,9,-920.0,7,2,3281.34,2361.34
20241,UA8DC35,9,5503.239999999998,7,2,35935.2,41438.44
20242,U161CDA,9,1874.0,7,2,12226.0,14100.0
20243,U32F5FF,9,2731.9599999999996,7,2,445.30000000000007,3177.2599999999998
20244,U9F478B,9,-3274.319999999996,7,2,22611.409999999996,19337.09
20245,U0E66EC,9,-11556.25,5,4,48470.0,36913.75
20246,UD4D7D2,9,-2897.0000000000005,7,2,11194.48,8297.48
20247,U3FC868,9,426.85000000000036,7,2,10092.0,10518.85
20248,UC710B1,9,-22759.569999999992,3,6,157178.0,134418.43000000002
20249,U96C7A1,9,317.59999999999974,7,2,5090.3,5407.9
20250,UEAE8C1,9,-615.6900000000023,6,3,24617.07,24001.379999999997
20251,U4A6054,9,1694.04,4,5,1806.02,3500.06
20252,U8BBD62,9,5405.62,4,5,12770.0,18175.62
20253,U536249,9,601.1399999999999,7,2,305.32,906.4599999999999
20254,U907CFC,9,1912.83,6,3,2600.0,4512.83
20255,UA0C34B,9,-48.710000000000036,6,3,15963.71,15915.0
20256,U302046,9,-1365.639999999998,3,6,10623.3,9257.660000000002
20257,U5C817B,9,3399.6,6,3,3661.9,7061.5
20258,UA0ACF7,9,0.0,5,4,701.95,701.95
20259,U989677,9,-11360.25,8,1,14408.36,3048.11
20260,U195C3D,9,2400.0699999999997,2,7,2375.0,4775.07
20261,UA89442,9,247.58,5,4,115.0,362.58000000000004
20262,UFAD4F9,9,-576.54,8,1,1326.54,750.0
20263,U563D6B,9,3664.62,6,3,5735.38,9400.0
20264,UF8512A,9,5211.58,6,3,10943.16,16154.74
20265,U612F25,9,-3995.27,4,5,4135.27,140.0
20266,UB92945,9,2.0100000000002183,5,4,15982.0,15984.01
20267,UD88338,9,-713.3199999999999,7,2,713.3599999999999,0.04
20268,U5E5D24,9,98.39999999999964,5,4,5352.6,5451.0
20269,UE49E26,9,500.0,8,1,500.0,1000.0
20270,U7CA162,9,2541.7800000000025,3,6,38800.0,41341.78
20271,U75EA73,9,274.09000000000015,6,3,29995.3,30269.39
20272,UAC7AA8,9,-528.7,6,3,767.86,239.16
20273,UB9B7D4,9,-721.0,3,6,16966.0,16245.0
20274,UF6041C,9,-7451.7300000000005,8,1,9840.84,2389.11
20275,U718FE1,9,-10.070000000000022,7,2,721.61,711.54
20276,U2E4320,9,-1679.75,8,1,3720.0,2040.25
20277,U9FBCD1,9,-19867.0,6,3,47982.0,28115.0
20278,UA95DE8,9,1502.5299999999997,3,6,6902.8,8405.33
20279,U9890FE,9,184.83000000000038,7,2,2535.17,2720.0
20280,UE86F8E,9,-67.61,7,2,102.21000000000001,34.6
20281,UE36B0F,9,0.0,6,3,8000.0,8000.0
20282,U08832E,9,4189.0,5,4,22469.0,26658.0
20283,UBABC44,9,-2377.97,6,3,2388.0,10.03
20284,U9B8384,9,7020.88,7,2,2000.03,9020.91
20285,U507E4B,9,6547.54,3,6,5692.22,12239.760000000002
20286,UB18DC4,9,-3685.24,7,2,5985.239999999999,2300.0
20287,UB3C0E3,9,5314.400000000001,8,1,325.6,5640.0
20288,U0F9FEF,9,97.34999999999854,3,6,57503.0,57600.35
20289,UC0F680,9,-136.1699999999997,7,2,5214.45,5078.280000000001
20290,U824AFC,9,3050.0,3,6,6090.0,9140.0
20291,UC731F1,9,854.6600000000001,6,3,647.2299999999999,1501.8899999999999
20292,U21803B,9,0.0,6,3,1961.12,1961.12
20293,UD3F5FA,9,-355.8700000000008,5,4,6283.34,5927.469999999999
20294,U202343,9,3680.03,3,6,3716.0,7396.03
20295,UCADC87,9,671.3299999999999,6,3,500.00000000000006,1171.33
20296,UCB004A,9,-436.78,8,1,538.7800000000001,102.0
20297,UDCF02B,9,8078.52,2,7,8100.0,16178.52
20298,U558752,9,-69.86000000000001,8,1,369.86,300.0
20299,U606C67,9,-7188.72,8,1,7210.72,22.0
20300,U79C2BF,9,307.2999999999999,6,3,1398.5,1705.7999999999997
20301,U0EFE57,9,-478.2999999999991,5,4,15814.66,15336.36
20302,U89CE92,9,0.06,4,5,5000.0,5000.06
20303,U56A679,9,-4.547473508864641e-13,7,2,4250.570000000001,4250.57
20304,U555169,9,-318.1700000000003,7,2,3958.04,3639.87
20305,UE46A4C,9,-1667.3199999999997,8,1,3167.32,1500.0
20306,U6223C7,9,262.4499999999998,5,4,15997.0,16259.449999999999
20307,U6FA856,9,-10686.99,8,1,12948.66,2261.67
20308,UEA96B0,9,-193.63999999999965,8,1,5260.78,5067.14
20309,U2D2F06,9,5399.23,6,3,1053.8799999999999,6453.110000000001
20310,U0BDCFA,9,-6639.540000000001,6,3,12000.0,5360.46
20311,U30CA61,9,-2396.92,8,1,4396.92,2000.0
20312,U7F0395,9,88.14999999999964,7,2,13943.85,14032.0
20313,U6C1B31,9,-6.54,6,3,298.64000000000004,292.1
20314,U4067BE,9,200.0,4,5,5000.0,5200.0
20315,U45C2D0,9,21.699999999999818,3,6,13631.3,13653.0
20316,U38C0FF,9,10116.869999999999,3,6,15100.380000000001,25217.25
20317,U44A420,9,-1367.27,6,3,3346.9,1979.63
20318,UCE9676,9,1141.3199999999997,8,1,4858.68,6000.0
20319,U370940,9,4750.06,2,7,4000.0,8750.060000000001
20320,U124572,9,127.30000000000018,6,3,4354.0,4481.3
20321,UC54F8B,9,1768.0,0,9,0.0,1768.0
20322,U27355D,9,-979.64,9,0,979.64,0.0
20323,U062D41,9,32.1,4,5,31312.54,31344.64
20324,UD77AB1,9,-136.76,8,1,166.56,29.8
20325,U668F20,9,-21.77000000000021,6,3,4188.22,4166.450000000001
20326,UEC05A3,9,1855.6799999999998,3,6,1310.29,3165.97
20327,U9A08D2,9,-169.9,7,2,483.9,314.0
20328,UDF57C2,8,-2188.56,8,0,2188.56,0.0
20329,U93AFB7,8,-100.0,4,4,8918.21,8818.21
20330,UC29E01,8,8.400000000000546,5,3,5776.0,5784.4
20331,U77EDCD,8,-695.8,6,2,1111.0,415.2
20332,UF71658,8,-30.0,4,4,39990.0,39960.0
20333,U235F90,8,-25885.51,3,5,30033.36,4147.85
20334,U5708AB,8,8.660000000000082,4,4,1349.0,1357.6599999999999
20335,U35D20C,8,9.0,4,4,3114.0,3123.0
20336,UA873AB,8,5333.360000000001,3,5,8743.61,14076.970000000001
20337,U118F45,8,-1845.67,6,2,2556.51,710.84
20338,U287CEA,8,4833.570000000001,6,2,21066.43,25900.0
20339,UDD6AE0,8,241.89999999999964,5,3,1856.8000000000002,2098.7
20340,UBCD19B,8,364.26,6,2,1335.7400000000002,1700.0
20341,U2173DE,8,-316.00000000000074,6,2,5466.16,5150.16
20342,U14EEF2,8,1538.94,4,4,1131.0800000000002,2670.02
20343,U9A589D,8,-3105.1500000000005,6,2,7925.51,4820.36
20344,U1DDE04,8,208.62000000000023,5,3,2316.66,2525.28
20345,U53A14E,8,723.1799999999994,5,3,9481.0,10204.18
20346,U655B21,8,-355.77,7,1,355.9,0.13
20347,UE3DD6B,8,-2381.0,3,5,12298.0,9917.0
20348,UF860CD,8,-124.39999999999998,5,3,635.86,511.46000000000004
20349,U2C7F3C,8,-23.48999999999978,5,3,13236.56,13213.07
20350,U914930,8,15460.02,2,6,200300.0,215760.02000000002
20351,UD5BC38,8,37992.020000000004,2,6,8.0,38000.020000000004
20352,UC7A565,8,5996.49,4,4,5811.56,11808.050000000001
20353,U828414,8,326.87,6,2,753.13,1080.0
20354,UC852C5,8,30007.829999999998,3,5,32010.0,62017.83
20355,U64C70F,8,47.159999999999854,4,4,10097.76,10144.92
20356,UC241CC,8,-99.20999999999992,6,2,963.2099999999999,864.0
20357,U7CDE5C,8,-1378.0,7,1,1478.0,100.0
20358,UA8519C,8,180.29000000000002,4,4,29939.71,30120.0
20359,U2F3C3F,8,1900.0,3,5,19000.0,20900.0
20360,U9A7DA1,8,5958.58,4,4,881.3399999999999,6839.92
20361,U6936C5,8,-66070.0,8,0,66070.0,0.0
20362,U4F04CE,8,-147.69,6,2,257.69,110.0
20363,U873594,8,-2.2737367544323206e-13,6,2,1463.3200000000002,1463.32
20364,U1483EC,8,173520.0,4,4,21600.0,195120.0
20365,UBDB0BE,8,-208.29000000000008,6,2,863.37,655.0799999999999
20366,UDF4F4A,8,203.23000000000002,7,1,796.77,1000.0
20367,U64A399,8,-1951.8600000000004,6,2,1999.2,47.339999999999996
20368,UDCE91D,8,297.45000000000005,3,5,2058.55,2356.0
20369,U8E69E1,8,11701.829999999998,5,3,7417.32,19119.15
20370,UB6E8C1,8,3142.5,3,5,3291.4,6433.9
20371,UE63DC5,8,-0.02999999999904901,6,2,6541.469999999999,6541.4400000000005
20372,UDDDAB5,8,-33225.11,6,2,33625.11,400.0
20373,UED77D8,8,-1812.64,6,2,1892.64,80.0
20374,U91D36D,8,20000.0,0,8,0.0,20000.0
20375,U4BA13F,8,-13.05,6,2,13.280000000000001,0.22999999999999998
20376,UA6ABA3,8,-118.30999999999999,6,2,124.39999999999999,6.09
20377,U0F2091,8,140.0,7,1,1160.0,1300.0
20378,U05F4EC,8,1021.3199999999999,4,4,2020.0,3041.3199999999997
20379,U993573,8,-17655.09,4,4,17715.09,60.0
20380,UE961C3,8,11519.32,5,3,2255.68,13775.0
20381,U051B04,8,-577.42,8,0,577.42,0.0
20382,UED6D9E,8,-8524.59,4,4,18366.5,9841.91
20383,U4FA510,8,-1527.0,5,3,43665.0,42138.0
20384,UC14838,8,91.0,5,3,10009.0,10100.0
20385,UA82394,8,-760.0,5,3,32279.339999999997,31519.339999999997
20386,UFC1BFD,8,10.0,5,3,17998.0,18008.0
20387,U606910,8,-331.33,7,1,631.3299999999999,300.0
20388,U6C182C,8,0.0,4,4,6000.0,6000.0
20389,UB56308,8,0.0,4,4,6000.0,6000.0
20390,U2B5D4E,8,-948.0,5,3,14948.0,14000.0
20391,UB865D6,8,-1070.1899999999996,5,3,8614.0,7543.81
20392,U0B6C7E,8,-2990.0,6,2,7090.0,4100.0
20393,U2F163A,8,-1226.9,6,2,2330.0,1103.1
20394,U7CAA15,8,-1657.0600000000002,8,0,1657.0600000000002,0.0
20395,UF156A6,8,367.46,6,2,1199.41,1566.87
20396,UA42E8F,8,-8926.48,8,0,8926.48,0.0
20397,UCBCF59,8,-1519.2900000000004,7,1,7735.33,6216.04
20398,U4F37C7,8,0.009999999999990905,4,4,273.0,273.01
20399,UF61F36,8,19907.199999999997,2,6,4332.39,24239.59
20400,UFDE854,8,-188.34,8,0,188.34,0.0
20401,UE02F70,8,-142.0,6,2,40142.0,40000.0
20402,U9FDBD3,8,-25.0,4,4,7970.0,7945.0
20403,U9B32E1,8,-10899.39,6,2,13510.0,2610.61
20404,U421354,8,15131.0,3,5,7510.0,22641.0
20405,U82CAAB,8,0.0,6,2,5759.0,5759.0
20406,UD013A2,8,187.0,4,4,17713.0,17900.0
20407,U8ADB44,8,169.19999999999965,5,3,3365.7999999999997,3535.0
20408,UAD79A5,8,-12769.919999999998,4,4,14000.0,1230.08
20409,UBBDA2C,8,-4950.259999999999,8,0,4950.259999999999,0.0
20410,UD00A37,8,29.299999999999727,6,2,4470.7,4500.0
20411,U6F8F27,8,-4127.99,6,2,6127.99,2000.0
20412,U144BA8,8,60.01,3,5,15.01,75.02
20413,U642C24,8,6115.009999999998,4,4,24224.99,30340.0
20414,UA86C0A,8,-660.0,4,4,762.71,102.71
20415,U7665B1,8,211.01,4,4,379.23,590.24
20416,U3728FD,8,621.82,6,2,909.6,1531.42
20417,UE8448B,8,903.84,4,4,758.9,1662.74
20418,U8B22E0,8,-1231.09,6,2,4356.92,3125.83
20419,U86C4DE,8,1586.3999999999996,6,2,514.92,2101.3199999999997
20420,U79FFB5,8,-453.43000000000006,8,0,453.43000000000006,0.0
20421,U2DEDC3,8,-1828.3999999999996,5,3,9106.8,7278.4
20422,UDD88D0,8,7170.139999999999,4,4,829.86,8000.0
20423,U655DB4,8,106.0,5,3,598.0,704.0
20424,UF18CEC,8,-2975.02,7,1,2985.02,10.0
20425,U114BF5,8,-839.22,4,4,1399.22,560.0
20426,U7BB9D0,8,7500.25,3,5,7.0,7507.25
20427,U678F5B,8,-289.49,4,4,389.51,100.02000000000001
20428,U4E8527,8,1351.8600000000001,6,2,2292.14,3644.0
20429,U893233,8,-2368.5,6,2,2412.0,43.5
20430,UD23E96,8,762.12,4,4,3505.15,4267.2699999999995
20431,UDB7B46,8,-9.980000000000018,5,3,5757.94,5747.96
20432,UEE309F,8,-216.09000000000015,4,4,3933.34,3717.25
20433,U021D43,8,2550.1,0,8,0.0,2550.1
20434,U06751C,8,-2985.0,6,2,8185.0,5200.0
20435,U87C5C5,8,-12172.47,6,2,12597.47,425.0
20436,UE8C709,8,6.329999999999998,6,2,162.17000000000002,168.5
20437,U5B3456,8,-627.57,7,1,1447.8700000000001,820.3
20438,U37CDB1,8,-52.46,5,3,177.5,125.04
20439,UECD560,8,-2.649999999999636,5,3,7127.3099999999995,7124.66
20440,UF392DF,8,386.0,5,3,29880.0,30266.0
20441,UD192FD,8,-621.98,8,0,621.98,0.0
20442,U2D9E67,8,-55.92,7,1,117.84,61.92
20443,UBDF9AC,8,-28.83000000000004,5,3,650.12,621.29
20444,U1D2CBB,8,5001.15,2,6,5000.0,10001.15
20445,UFA5806,8,2047.3400000000004,4,4,6242.73,8290.07
20446,UC28FC1,8,-3842.0,7,1,4042.0,200.0
20447,UFA288A,8,-809.4,8,0,809.4,0.0
20448,U356B03,8,-3703.62,6,2,3906.62,203.0
20449,U1CDD10,8,-1977.0,7,1,2327.0,350.0
20450,UD74498,8,4605.910000000001,5,3,2035.41,6641.320000000001
20451,UAF5FBF,8,-2153.0,6,2,5447.0,3294.0
20452,U47B9C1,8,543.8999999999996,4,4,4000.0,4543.9
20453,UB7CE15,8,375.0,4,4,29925.0,30300.0
20454,UDF1E83,8,-422.97,5,3,1380.22,957.25
20455,UBBCB79,8,-7912.599999999999,8,0,7912.599999999999,0.0
20456,U241CFE,8,-2199.4499999999994,6,2,11450.92,9251.470000000001
20457,UC714C7,8,2974.9,5,3,1350.1,4325.0
20458,U7AAD37,8,10.01,5,3,187.0,197.01
20459,UB5881E,8,-2678.0400000000004,8,0,2678.0400000000004,0.0
20460,U97621F,8,-1576.5499999999997,7,1,3277.98,1701.43
20461,U987BD5,8,-2650.58,5,3,3998.78,1348.2
20462,U529CDC,8,-23975.7,7,1,24975.7,1000.0
20463,U4FF4D1,8,-1363.4799999999998,4,4,7010.0,5646.52
20464,U2DEAA9,8,391.01000000000005,6,2,967.6299999999999,1358.64
20465,UB2C4D8,8,12071.36,6,2,4798.8,16870.16
20466,U4710C4,8,3.0000000000000195,5,3,642.6999999999999,645.7
20467,U58EA1F,8,-7.2700000000002,3,5,6007.28,6000.009999999999
20468,U1E7F5F,8,7.020000000000437,5,3,6140.82,6147.84
20469,UF09C08,8,585.0,6,2,8462.0,9047.0
20470,U42A785,8,-5.0,5,3,3326.6,3321.6
20471,U0171E3,8,-176.31999999999994,6,2,1886.3199999999997,1710.0
20472,U19FB3E,8,-255.93,6,2,424.19,168.26
20473,UC8F69D,8,221.0,7,1,1679.0,1900.0
20474,UE2A0EF,8,-2885.62,8,0,2885.62,0.0
20475,UFA373B,8,-319.0,7,1,594.61,275.61
20476,UF9ACBD,8,4279.42,5,3,8300.0,12579.42
20477,UDFFB20,8,546.5399999999998,5,3,482.52000000000004,1029.06
20478,U2D16C4,8,0.0,4,4,11200.0,11200.0
20479,U14C821,8,1223.9000000000005,6,2,6780.0,8003.900000000001
20480,UAE2B15,8,-8870.0,5,3,17685.0,8815.0
20481,U29F20F,8,-0.5,4,4,41110.0,41109.5
20482,UE0BBBD,8,1337.0700000000002,6,2,2650.2799999999997,3987.35
20483,U3A13E7,8,-3467.5,3,5,9469.66,6002.16
20484,U3ED9BA,8,25.00999999999999,3,5,401.12,426.13
20485,UDFAFF5,8,-3200.0,6,2,9210.0,6010.0
20486,U1A781A,8,1.7053025658242404e-13,4,4,2049.64,2049.6400000000003
20487,U2083CB,8,8773.16,5,3,28400.699999999997,37173.86
20488,UA8BF92,8,4552.65,6,2,151.39000000000001,4704.04
20489,U49F675,8,-4460.79,4,4,13221.2,8760.41
20490,UEA12A4,8,1.0,5,3,7999.0,8000.0
20491,U253465,8,240.53,6,2,389.47,630.0
20492,U1CEE7A,8,610.1799999999998,4,4,4640.0,5250.18
20493,U7FC886,8,2592.1,5,3,2067.5,4659.6
20494,UD35BE2,8,1720.6599999999999,3,5,9682.0,11402.66
20495,U3A4B40,8,-27318.59,6,2,29449.7,2131.11
20496,UEFF3BF,8,0.009999999999990905,4,4,3043.0,3043.01
20497,UC02A75,8,12996.0,4,4,18.0,13014.0
20498,U035943,8,475.9,6,2,1287.9,1763.8
20499,U50A919,8,-564.97,7,1,764.97,200.0
20500,UEE83AC,8,761.7399999999998,2,6,5453.3,6215.04
20501,UD51B15,8,-1154.3300000000002,7,1,1154.8300000000002,0.5
20502,UE83BCC,8,-267.32,8,0,267.32,0.0
20503,UA9F330,8,0.03,7,1,0.07,0.1
20504,U54EA55,8,103.79000000000002,6,2,106.75,210.54000000000002
20505,UC6922C,8,-5937.98,5,3,14701.0,8763.02
20506,U32F9E1,8,1.0199999999999978,4,4,46.94,47.96
20507,U04BD9F,8,694.02,6,2,737.6400000000001,1431.66
20508,U5C8A1C,8,-1267.08,8,0,1267.08,0.0
20509,UA5B01A,8,1190.01,4,4,436.22,1626.2299999999998
20510,U886E1F,8,-0.009999999999999787,4,4,16.0,15.99
20511,UDD0BB6,8,-16830.78,8,0,16830.78,0.0
20512,UB9BD0D,8,5004.41,3,5,10088.880000000001,15093.29
20513,UEC57AD,8,-1891.42,8,0,1891.42,0.0
20514,UCBCECA,8,0.0,5,3,12541.66,12541.66
20515,U76386D,8,358.0,4,4,9148.0,9506.0
20516,UC5CB35,8,909.4799999999999,3,5,857.71,1767.19
20517,UB50292,8,1002.6499999999996,3,5,14167.37,15170.02
20518,U085015,8,0.1300000000005639,6,2,3364.8699999999994,3365.0
20519,UFDB978,8,50.0,5,3,23950.0,24000.0
20520,UBD48CF,8,-1979.5000000000002,8,0,1979.5000000000002,0.0
20521,U9B011E,8,1.4210854715202004e-13,6,2,1354.3799999999999,1354.38
20522,UF7B639,8,800.0,5,3,11150.0,11950.0
20523,UD9D23D,8,4708.1,4,4,1165.9099999999999,5874.01
20524,UE4B9D6,8,11190.0,4,4,20840.0,32030.0
20525,U284DEE,8,139.0,5,3,1216.0,1355.0
20526,UE98ACF,8,-1831.14,6,2,2231.15,400.01
20527,U35E9F5,8,8720.560000000001,2,6,29000.0,37720.56
20528,U98A824,8,475.0,5,3,4725.0,5200.0
20529,U17869E,8,56.5,7,1,243.5,300.0
20530,UF801E0,8,6063.879999999999,3,5,20927.47,26991.350000000002
20531,UBB96D4,8,-223.57000000000016,6,2,1223.71,1000.14
20532,U6AB966,8,-650.0,6,2,4775.48,4125.48
20533,U58B91E,8,-7307.4800000000005,6,2,7677.17,369.69
20534,U7F4114,8,1730.08,5,3,16270.0,18000.08
20535,U9F163A,8,-322.32,8,0,322.32,0.0
20536,U514107,8,346.49,4,4,2993.0,3339.49
20537,U6E0C43,8,0.8800000000010186,4,4,33915.0,33915.88
20538,U4C9005,8,3700.000000000002,6,2,21311.58,25011.58
20539,U72E583,8,0.0,6,2,1212.0,1212.0
20540,UE8EC45,8,-4156.709999999999,8,0,4156.709999999999,0.0
20541,UEB4117,8,607.8899999999998,5,3,3215.7799999999997,3823.6699999999996
20542,U60F13E,8,-3.907985046680551e-14,7,1,270.90000000000003,270.9
20543,U333DBC,8,12713.53,4,4,10336.67,23050.2
20544,U9C2671,8,-1153.38,6,2,1387.38,234.0
20545,UBC0901,8,23.11999999999999,7,1,199.88000000000002,223.0
20546,U91AA45,8,1.8189894035458565e-12,5,3,20401.15,20401.15
20547,U2259BD,8,245.28000000002794,2,6,576853.0,577098.28
20548,U61798B,8,-265.22,6,2,3123.0,2857.7799999999997
20549,U270B39,8,14353.200000000012,5,3,152600.0,166953.2
20550,UC203C6,8,-4247.999999999999,4,4,12207.289999999999,7959.290000000001
20551,U98E6EB,8,-150.0,6,2,700.0,550.0
20552,U6F119A,8,-66.19,6,2,170.29,104.1
20553,UDB9243,8,0.0,7,1,69.86000000000001,69.86
20554,U3F701C,8,-9999.970000000001,6,2,10762.5,762.53
20555,UF047DB,8,14368.119999999999,4,4,60588.0,74956.12
20556,U65C3CF,8,-7.105427357601002e-15,5,3,575.5,575.5
20557,UC5A1E1,8,-237.06000000000017,4,4,2132.31,1895.25
20558,U8C3481,8,-2557.25,5,3,5016.66,2459.41
20559,UA9E08F,8,-8.881784197001252e-15,6,2,413.83000000000004,413.83000000000004
20560,UA8B395,8,-234.51999999999998,4,4,7696.0,7461.48
20561,U688BBA,8,1.1368683772161603e-13,6,2,1143.52,1143.52
20562,U85BCAC,8,8885.659999999998,5,3,4273.14,13158.8
20563,U424B55,8,482.5999999999999,7,1,178.40000000000003,661.0
20564,UF916D5,8,3.0,4,4,7994.0,7997.0
20565,U91F32D,8,-5777.0,5,3,11231.3,5454.3
20566,U0128C1,8,-676.0000000000002,6,2,2826.5,2150.5
20567,UAEB3CF,8,21.479999999999976,4,4,1076.07,1097.55
20568,U96144B,8,-274.31,4,4,309.7,35.39
20569,U6BF613,8,-2740.9,8,0,2740.9,0.0
20570,U6EB63C,8,8000.0,2,6,8258.0,16258.0
20571,U7D0CBA,8,-3237.2799999999997,8,0,3237.2799999999997,0.0
20572,U7D9554,8,-7000.139999999999,6,2,24026.14,17026.0
20573,U0270E0,8,700.77,4,4,5656.32,6357.09
20574,U15F8F2,8,-1512.1400000000003,8,0,1512.1400000000003,0.0
20575,U02D27F,8,0.0,7,1,36.0,36.0
20576,UD152CA,8,772.0,5,3,4693.0,5465.0
20577,U105B57,8,-1741.4299999999998,6,2,9552.0,7810.57
20578,UF36A94,8,200.72000000000003,5,3,1442.81,1643.53
20579,U762BA8,8,-6099.880000000001,8,0,6099.880000000001,0.0
20580,U290D66,8,-34065.42999999999,5,3,38665.439999999995,4600.01
20581,U0ACBDA,8,3730.7200000000003,3,5,4062.34,7793.06
20582,UD5F814,8,999.9999999999998,5,3,1608.59,2608.59
20583,UF599ED,8,-11344.050000000001,4,4,33145.88,21801.83
20584,UD2E603,8,-2110.17,8,0,2110.17,0.0
20585,U06CE76,8,4.0,5,3,7993.0,7997.0
20586,U04F877,8,94.98000000000002,6,2,632.0199999999999,727.0
20587,UF3B008,8,-1261.32,8,0,1261.32,0.0
20588,U184422,8,-1339.1,5,3,1662.0,322.9
20589,UD8C255,8,-180.0,4,4,9940.0,9760.0
20590,U0EB709,8,1.6930901125533637e-15,4,4,150.17,150.17000000000002
20591,UDCCFAF,8,-165.1399999999999,4,4,1332.3400000000001,1167.2
20592,UF88898,8,-1149.9800000000005,6,2,5547.18,4397.2
20593,U0C3560,8,761.34,7,1,1938.6599999999999,2700.0
20594,U413333,8,521.98,4,4,558.8199999999999,1080.8000000000002
20595,U9EA494,8,310.0,7,1,890.0,1200.0
20596,U6087BB,8,5556.5,3,5,11510.0,17066.5
20597,U6A1AF1,8,3264.42,2,6,2012.5,5276.92
20598,U545ED4,8,0.0,5,3,5629.34,5629.34
20599,U8DB185,8,-6.3976601794024646e-15,7,1,111.99,111.99
20600,U875398,8,15006.0,2,6,17499.0,32505.0
20601,U18B801,8,-566.0,6,2,1330.0,764.0
20602,U875B0D,8,-7333.94,8,0,7333.94,0.0
20603,U666295,8,6226.68,5,3,11880.0,18106.68
20604,U36B1CC,8,-2866.0,8,0,2866.0,0.0
20605,UA1CC37,8,765.01,4,4,8285.2,9050.210000000001
20606,UD36DB9,8,500.6,5,3,1528.8000000000002,2029.4
20607,UE17DFB,8,1019.0,6,2,431.0,1450.0
20608,U20E678,8,241.48999999999995,5,3,1639.8,1881.29
20609,U2349C0,8,-18867.4,6,2,23319.4,4452.0
20610,UF12791,8,110.66999999999993,6,2,786.06,896.73
20611,UCB1F9E,8,-112.0,6,2,5952.0,5840.0
20612,U24F4B5,8,9864.000000000004,5,3,34134.72,43998.72
20613,U019DFE,8,593.8000000000002,6,2,4100.0,4693.8
20614,UC3534B,8,-3354.9900000000002,7,1,5593.93,2238.94
20615,U7DB192,8,5680.33,6,2,6496.64,12176.97
20616,UE964F3,8,-4000.0,6,2,4610.0,610.0
20617,UA31238,8,2681.01,5,3,7030.0,9711.01
20618,U48E0C9,8,30.5,6,2,251.5,282.0
20619,U66CE6E,8,-688.9999999999998,7,1,2982.8,2293.8
20620,U3C1AF2,8,886.6700000000001,6,2,1413.33,2300.0
20621,U853756,8,-46.900000000000034,7,1,358.99,312.09
20622,U97315C,8,0.0,4,4,10000.0,10000.0
20623,U15273D,8,904.39,5,3,2008.56,2912.95
20624,UDEFDDD,8,202.0,4,4,1932.0,2134.0
20625,U7ED3E9,8,9039.61,2,6,5869.2,14908.810000000001
20626,U1239E9,8,-2294.7,6,2,7678.8,5384.1
20627,UFA277C,8,-6824.12,8,0,6824.12,0.0
20628,UA9AC40,8,-2627.3000000000006,5,3,3403.4500000000003,776.1500000000001
20629,UC1FCFC,8,31301.569999999996,4,4,1148.62,32450.19
20630,U9DAF50,8,-19.970000000000027,4,4,1201.97,1182.0
20631,U34C701,8,0.0,6,2,2637.38,2637.38
20632,UACCB6A,8,1991.67,4,4,983.34,2975.01
20633,UF352AE,8,-0.33999999999999986,4,4,18.5,18.16
20634,UD9AE63,8,-762.3499999999999,4,4,6948.66,6186.3099999999995
20635,U04FCF1,8,2602.08,3,5,6742.67,9344.75
20636,U3FA169,8,-9636.220000000001,8,0,9636.220000000001,0.0
20637,U801010,8,39963.0,3,5,3037.0,43000.0
20638,UAA9EC0,8,-7574.619999999999,6,2,7576.719999999999,2.1
20639,U4244E3,8,-4998.179999999999,4,4,19996.98,14998.8
20640,U614501,8,-123.0,4,4,8438.0,8315.0
20641,U32A88F,8,-3186.56,6,2,11786.560000000001,8600.0
20642,U2862C1,8,737.8,6,2,1112.85,1850.6499999999999
20643,UF04929,8,9717.439999999999,6,2,8282.56,18000.0
20644,UF41E6A,8,113.36999999999989,6,2,3349.63,3463.0
20645,U43871B,8,300.0,6,2,199.85,499.85
20646,U54DBB2,8,-3167.92,8,0,3167.92,0.0
20647,UC8C73D,8,196.96000000000004,6,2,1622.68,1819.64
20648,U6BEB68,8,100.0,4,4,983.34,1083.3400000000001
20649,UEEA19F,8,-350.01,6,2,3500.01,3150.0
20650,U58A6B0,8,-10.0,4,4,10010.0,10000.0
20651,U073E35,8,-130.89999999999964,5,3,8665.9,8535.0
20652,UC20F58,8,3251.68,4,4,748.3199999999999,4000.0
20653,UBE8EDE,8,2745.39,5,3,1056.8200000000002,3802.21
20654,U5BAF8F,8,-71.51999999999998,7,1,690.1,618.58
20655,U504717,8,-228.49999999999994,6,2,1027.98,799.48
20656,UB7B3B9,8,1163.0,5,3,4337.0,5500.0
20657,U06DC1A,8,1077.1,4,4,2959.0,4036.1
20658,U1546CA,8,6.3400000000001455,3,5,10920.0,10926.34
20659,UE80F81,8,924.52,5,3,541.61,1466.13
20660,U3A4DCC,8,-5130.82,4,4,8800.0,3669.1800000000003
20661,UD55E1A,8,6600.43,3,5,28806.0,35406.43
20662,U9049F7,8,2.84,4,4,399.0,401.84000000000003
20663,UC69CA8,8,-574.7199999999999,8,0,574.7199999999999,0.0
20664,U6DE3EA,8,0.0,6,2,1094.94,1094.94
20665,U54EB34,8,-305.8000000000029,6,2,70305.97,70000.17
20666,U0347E0,8,0.7700000000004366,4,4,7724.0,7724.77
20667,U6E3B58,8,209.40999999999974,6,2,1581.7600000000002,1791.17
20668,U0CC844,8,-4126.860000000001,8,0,4126.860000000001,0.0
20669,UE73AC3,8,410.2299999999998,6,2,2523.0200000000004,2933.25
20670,U55BE1F,8,-6061.720000000001,8,0,6061.720000000001,0.0
20671,U7F1F72,8,-454.13,7,1,454.14,0.01
20672,U389A61,8,-625.6199999999999,8,0,625.6199999999999,0.0
20673,U3DC32E,8,9766.0,3,5,11678.0,21444.0
20674,U8B0191,8,13124.529999999992,1,7,500000.0,513124.52999999997
20675,U60C587,8,-4389.15,8,0,4389.15,0.0
20676,UAA8286,8,-65594.95,4,4,113322.0,47727.05
20677,UA1D02D,8,-1534.5200000000004,5,3,10503.95,8969.43
20678,UF96F12,8,-130.18,6,2,702.6,572.4200000000001
20679,U0D4897,8,113.96,3,5,107.51,221.46999999999997
20680,U3E7C95,8,0.0,4,4,4450.0,4450.0
20681,U8F177C,8,11394.8,4,4,1035.2,12430.0
20682,U528D53,8,-2101.82,4,4,2751.82,650.0
20683,U408E40,8,-503.62,8,0,503.62,0.0
20684,U22AE7D,8,284.0,6,2,530.0,814.0
20685,U5B99B6,8,-16585.0,6,2,22145.0,5560.0
20686,U01A432,8,-945.5699999999999,7,1,986.0899999999999,40.52
20687,UC3A205,8,10252.07,4,4,5489.46,15741.529999999999
20688,UC228BB,8,-8722.84,8,0,8722.84,0.0
20689,U61E83A,8,0.5399999999999068,6,2,886.64,887.18
20690,UFFF6A4,8,-4765.0,4,4,19979.0,15214.0
20691,UD8C046,8,6117.030000000001,2,6,3983.6,10100.630000000001
20692,U1D4E96,8,-12.799999999999862,6,2,1242.2,1229.4
20693,U0DCC7A,8,-14933.239999999998,6,2,63500.0,48566.76
20694,UD6D57C,8,9300.0,3,5,10100.0,19400.0
20695,U1F77A4,8,29302.15,1,7,2000.0,31302.15
20696,U879F19,8,-4.110000000000582,2,6,26309.3,26305.19
20697,UE66015,8,-2922.84,8,0,2922.84,0.0
20698,UB70372,8,286.97999999999996,7,1,644.02,931.0
20699,U98CCB7,8,290.80999999999995,5,3,693.6,984.41
20700,UDD7F70,8,115.61000000000003,6,2,372.79999999999995,488.41
20701,U9FDECE,8,2400.0,3,5,14400.0,16800.0
20702,U08BEC7,8,-15888.04,4,4,33245.93,17357.89
20703,U4AAA5A,8,7824.0,4,4,16843.0,24667.0
20704,U5C670C,8,-51.17000000000553,5,3,45288.93,45237.76
20705,UF5757E,8,-34.0,7,1,334.0,300.0
20706,U73E2BF,8,1220.0199999999998,5,3,2088.36,3308.38
20707,U0C65B3,8,947.3399999999992,5,3,10600.0,11547.34
20708,U1CBB2C,8,100.0,4,4,30900.0,31000.0
20709,UF59D21,8,-133.09999999999968,6,2,2335.24,2202.1400000000003
20710,U6ABE64,8,-10200.0,6,2,12077.86,1877.8600000000001
20711,U1EF52D,8,-567.5900000000026,4,4,29519.62,28952.03
20712,U7D4093,8,-798.5500000000001,7,1,798.5600000000001,0.01
20713,UB3506D,8,235.1,5,3,18.0,253.1
20714,UC372CE,8,-4811.16,8,0,4811.16,0.0
20715,U799908,8,-0.9899999999997817,3,5,15942.2,15941.21
20716,UDBF28E,8,-46.720000000000006,6,2,151.3,104.58
20717,UC111DB,8,-513.78,6,2,1030.0,516.22
20718,UD8E3B2,8,1708.2399999999998,6,2,3245.0,4953.24
20719,UA7B05A,8,89821.53,1,7,89820.0,179641.53
20720,U81F117,8,4.0300000000002,5,3,1762.9699999999998,1767.0
20721,UBE8F4C,8,-2964.029999999999,4,4,20972.2,18008.17
20722,UE5A974,8,88.07999999999998,6,2,911.9200000000001,1000.0
20723,U3AA426,8,341.65999999999997,5,3,263.34000000000003,605.0
20724,UA6B471,8,6894.88,5,3,3527.3399999999997,10422.22
20725,UC68EA4,8,-2480.75,7,1,4830.9800000000005,2350.23
20726,U6328A1,8,-3015.8999999999996,5,3,31705.0,28689.1
20727,UFEC912,8,403.53,6,2,2523.0,2926.5299999999997
20728,U4E3E66,8,2.000000000000007,6,2,168.89999999999998,170.9
20729,U383E97,8,1302.4699999999993,4,4,5101.01,6403.48
20730,U4278C1,8,-2868.94,8,0,2868.94,0.0
20731,U3D3427,8,-367.1,5,3,2388.1,2021.0
20732,U8623D9,8,-4779.92,3,5,16916.0,12136.08
20733,U6A9362,8,3022.5,3,5,3010.0,6032.5
20734,U8E4F78,8,-5248.540000000001,8,0,5248.540000000001,0.0
20735,U5FA399,8,6593.800000000001,4,4,5549.0,12142.800000000001
20736,UF6FCEA,8,-18745.77,6,2,22939.090000000004,4193.32
20737,U6CF7C7,8,1126.0,6,2,3024.0,4150.0
20738,U8F6BAC,8,492.4299999999985,6,2,9588.28,10080.71
20739,U76399C,8,-2431.16,8,0,2431.16,0.0
20740,U362B9D,8,-99.75999999999978,5,3,3081.97,2982.21
20741,U72549D,8,142.37,5,3,350.0,492.37
20742,UFD2128,8,-4293.889999999999,5,3,7118.849999999999,2824.96
20743,U59F73E,8,-550.0,6,2,964.0,414.0
20744,UA434B6,8,10478.8,3,5,20274.0,30752.8
20745,U646CAA,8,3771.4300000000003,5,3,9505.470000000001,13276.9
20746,U3745F8,8,-358.25,6,2,1587.42,1229.17
20747,U3F363B,8,223.0,6,2,127.0,350.0
20748,UDE995A,8,0.0,6,2,6000.0,6000.0
20749,UB8009D,8,4058.0,5,3,9777.0,13835.0
20750,U909AFF,8,1389.33,4,4,15010.0,16399.33
20751,UE96117,8,-2007.0,6,2,15869.0,13862.0
20752,U097904,8,-8154.9,6,2,24193.0,16038.1
20753,U4F3C5B,8,-185.0,6,2,4685.0,4500.0
20754,U732D30,8,73.31000000000002,7,1,388.69,462.0
20755,U3D69CD,8,0.0,4,4,22000.010000000002,22000.010000000002
20756,U962015,8,-426.5,5,3,447.78,21.28
20757,U37732C,8,-371.85999999999996,8,0,371.85999999999996,0.0
20758,UEAAA01,8,52.0,4,4,6948.0,7000.0
20759,U84E054,8,-12484.250000000002,8,0,12484.250000000002,0.0
20760,U97882B,8,10.0,4,4,8990.0,9000.0
20761,UAFDD77,8,5470.01,0,8,0.0,5470.01
20762,U0C7005,8,-10000.0,6,2,35010.0,25010.0
20763,U348E3A,8,-2785.0,6,2,17380.0,14595.0
20764,U8558D9,8,0.0,4,4,12000.0,12000.0
20765,U02D933,8,-2461.5699999999997,6,2,6325.0,3863.4300000000003
20766,U7A5FA1,8,163.95,6,2,273.5,437.45
20767,U65BAD2,8,-45272.0,7,1,55272.0,10000.0
20768,UA5D9C9,8,-2051.0,6,2,2950.0,899.0
20769,U008DAF,8,720.36,3,5,64.89999999999999,785.26
20770,U2ABE15,8,0.0,4,4,15400.0,15400.0
20771,U8FE35E,8,0.0,5,3,62.5,62.5
20772,U5D0570,8,4959.01,4,4,2936.0,7895.01
20773,U15B82B,8,-1327.19,7,1,1627.19,300.0
20774,U45BC40,8,5355.860000000001,4,4,7544.139999999999,12900.0
20775,UB83ACA,8,-449.90000000000146,5,3,24001.97,23552.07
20776,UF67671,8,574.3,6,2,9157.2,9731.5
20777,UADCAC6,8,-1556.6000000000004,4,4,7586.0,6029.4
20778,UE832BE,8,30895.17,5,3,1236.6799999999998,32131.850000000002
20779,U0C768A,8,-1325.0,6,2,15548.98,14223.98
20780,U782D64,8,-1034.35,6,2,1548.0,513.65
20781,U4FE22B,8,-2258.54,8,0,2258.54,0.0
20782,U966637,8,-253.61,6,2,1153.9,900.29
20783,U30ECB1,8,24.48,4,4,0.52,25.0
20784,U6E5131,8,-2458.32,8,0,2458.32,0.0
20785,UD9D45B,8,4069.720000000001,5,3,13000.0,17069.72
20786,U931F56,8,3260.95,4,4,2150.41,5411.36
20787,UD8C0D3,8,580.3200000000002,6,2,941.0,1521.3200000000002
20788,U27F0B3,8,371.61,2,6,6.970000000000001,378.58
20789,U24F357,8,-3643.06,8,0,3643.06,0.0
20790,UFCF6F3,8,257.5799999999999,4,4,12200.0,12457.58
20791,U9EB860,8,0.0,6,2,1782.0,1782.0
20792,UF3A94F,8,-1986.0,6,2,4179.0,2193.0
20793,UCB95EB,8,122.30999999999995,5,3,5410.0,5532.3099999999995
20794,U83DCC4,8,1274.07,5,3,2758.93,4033.0
20795,UCE6B51,8,2682.3599999999997,6,2,2403.64,5086.0
20796,UC64886,8,10.0,2,6,34990.0,35000.0
20797,U595D7F,8,0.0,4,4,15780.0,15780.0
20798,U291EBD,8,818.66,6,2,891.34,1710.0
20799,U164D9E,8,-5648.59,8,0,5648.59,0.0
20800,U34E341,8,3955.0,6,2,14380.0,18335.0
20801,UCAA0AD,8,17642.38,4,4,710.89,18353.27
20802,UDDF6BB,8,-84.9900000000003,4,4,5591.06,5506.07
20803,UEAA9A3,8,-11.0,2,6,31931.0,31920.0
20804,U054D5E,8,-4995.99,6,2,10995.99,6000.0
20805,U60E6B0,8,-1010.9899999999998,4,4,7153.01,6142.02
20806,U33B3CD,8,-488.99,6,2,647.0,158.01
20807,U3A4558,8,-206.45999999999913,5,3,9606.0,9399.54
20808,U185367,8,6712.47,4,4,4815.0,11527.470000000001
20809,UC3BF96,8,12.24,5,3,620.0,632.24
20810,U07D2B7,8,-5.0,6,2,435.0,430.0
20811,U766B45,8,-2996.7200000000003,5,3,3921.67,924.95
20812,UFBA391,8,-7223.910000000001,8,0,7223.910000000001,0.0
20813,U13CEDF,8,-2544.06,8,0,2544.06,0.0
20814,U9308B3,8,-10.90000000000002,5,3,314.90999999999997,304.01
20815,UE4BC47,8,-104.99,5,3,107.46,2.47
20816,U1F3EB3,8,-6666.32,8,0,6666.32,0.0
20817,U2DE16C,8,176.2299999999999,5,3,1417.19,1593.42
20818,U2BCAB7,8,-227.0,7,1,277.0,50.0
20819,UEAF79E,8,-1233.83,7,1,1733.83,500.0
20820,U2FDAFA,8,3723.61,4,4,2276.44,6000.05
20821,U8C1EF3,8,6.0,5,3,64.0,70.0
20822,U0E03B5,8,-380.0,6,2,1610.0,1230.0
20823,U9A6A84,8,-73.6600000000015,4,4,16374.12,16300.46
20824,UD1DF9A,8,239.80999999999995,6,2,1862.35,2102.16
20825,U64E49C,8,-1496.33,5,3,6099.0,4602.67
20826,UED2B39,8,7.105427357601002e-15,6,2,1847.48,1847.48
20827,U979C71,8,1615.06,2,6,153.56,1768.62
20828,U926286,8,-9144.609999999999,5,3,26195.0,17050.39
20829,U8FF286,8,-11915.55,7,1,11922.0,6.45
20830,UCAAD6F,8,701.6799999999998,4,4,6358.34,7060.02
20831,UC98089,8,-3139.17,3,5,45175.18,42036.01
20832,UFB84EA,8,151.0,6,2,38649.0,38800.0
20833,UF95247,8,-3858.88,5,3,21861.72,18002.84
20834,U866898,8,734.0,5,3,94446.0,95180.0
20835,U12F61F,8,597.6800000000001,6,2,1065.6599999999999,1663.3400000000001
20836,U56AD9E,8,-1658.2200000000003,6,2,3634.56,1976.34
20837,U67406D,8,-962.9100000000003,5,3,6609.4,5646.49
20838,U019E07,8,14945.5,4,4,15061.5,30007.0
20839,U9DCDC3,8,241.44,2,6,77.3,318.74
20840,UD4F256,8,18.1099999999999,6,2,3070.89,3089.0
20841,U5546E6,8,-301.72999999999956,5,3,10193.759999999998,9892.029999999999
20842,UDC9B45,8,158.23999999999998,6,2,961.76,1120.0
20843,U134C59,8,-3413.0,6,2,4481.0,1068.0
20844,U6B1131,8,7606.689999999999,4,4,15659.710000000001,23266.4
20845,U817C08,8,333.2,6,2,132.89,466.09
20846,UAA92F7,8,-2967.12,8,0,2967.12,0.0
20847,UD54840,8,435.2,6,2,594.8,1030.0
20848,U4DEC31,8,2760.0,3,5,260.0,3020.0
20849,U949AF8,8,24.299999999999955,5,3,2315.84,2340.14
20850,UBDC041,8,1739.86,6,2,960.1399999999999,2700.0
20851,U6E77DF,8,-6836.1,6,2,18677.9,11841.8
20852,U4D890D,8,-208.0,6,2,1608.0,1400.0
20853,U36BD52,8,-7145.650000000001,6,2,7936.710000000001,791.0600000000001
20854,UBB7277,8,0.0,4,4,4305.5,4305.5
20855,U21DC43,8,169.85000000000002,5,3,130.18,300.03
20856,U8516A1,8,16389.08,5,3,8184.839999999999,24573.920000000002
20857,UA313F2,8,120.49000000000001,3,5,350.01,470.5
20858,U810E11,8,0.0,7,1,204.0,204.0
20859,U6E14B9,8,0.0,6,2,15267.0,15267.0
20860,UD9DC7D,8,-1422.9900000000007,6,2,6672.65,5249.66
20861,U81896C,8,-31.200000000000273,6,2,5995.8,5964.6
20862,U6F8B18,8,-3241.59,8,0,3241.59,0.0
20863,UE752A3,8,-11001.85,5,3,23002.0,12000.15
20864,UEA3200,8,-900.0,5,3,6422.0,5522.0
20865,UABBA07,8,-941.0,3,5,13482.0,12541.0
20866,U8A7CD1,8,-1796.2999999999993,6,2,13916.3,12120.0
20867,U0EA76F,8,3083.6000000000004,7,1,11322.4,14406.0
20868,UA4452E,8,-3094.0199999999995,8,0,3094.0199999999995,0.0
20869,U5CEEF3,8,8.0,4,4,5903.0,5911.0
20870,U00AE00,8,1424.5,5,3,3578.1,5002.599999999999
20871,UF7BA28,8,885.0,5,3,5415.0,6300.0
20872,U55D746,8,225.59,6,2,1855.9,2081.49
20873,UEE5D7D,8,0.04999999999972715,6,2,3867.95,3868.0
20874,U13E129,8,-715.0,6,2,3632.8,2917.8
20875,UBA9616,8,279.0,6,2,274.0,553.0
20876,U75C385,8,718.52,6,2,7281.639999999999,8000.16
20877,U6645E9,8,-26500.330000000005,6,2,29817.700000000004,3317.37
20878,U5B4970,8,-3095.7200000000003,6,2,6512.4400000000005,3416.72
20879,U9F2600,8,1.3399999999999999,5,3,3.84,5.18
20880,UF4A811,8,-866.7599999999999,8,0,866.7599999999999,0.0
20881,U3D4E51,8,-6043.790000000001,5,3,30102.579999999998,24058.79
20882,U5E5913,8,-1177.1,6,2,3115.6800000000003,1938.58
20883,U829C49,8,2187.42,4,4,4459.44,6646.859999999999
20884,UC3100F,8,-1190.12,8,0,1190.12,0.0
20885,U394D6E,8,-633.4300000000001,7,1,647.4300000000001,14.0
20886,U156728,8,-2.842170943040401e-14,7,1,164.91000000000003,164.91
20887,UF2A216,8,-2931.55,6,2,5861.549999999999,2930.0
20888,UBF269F,8,6098.57,4,4,6308.5,12407.07
20889,U1B2803,8,0.5799999999999272,3,5,39600.0,39600.58
20890,UF8B6CF,8,-28.09,6,2,78.1,50.01
20891,UD8A774,8,220.0,5,3,860.0,1080.0
20892,U8B9CEB,8,-440.66999999999996,5,3,5881.34,5440.67
20893,U496A19,8,-2.2737367544323206e-13,6,2,1354.5600000000002,1354.56
20894,UF07E08,8,-58.1299999999992,6,2,6864.070000000001,6805.9400000000005
20895,U2E843A,8,24.029999999999973,6,2,965.08,989.11
20896,UCE6421,8,-84.80000000000018,5,3,5377.8,5293.0
20897,U2CEE1A,8,-89123.77,7,1,89338.82,215.05
20898,U5D71EE,8,-2.842170943040401e-14,5,3,951.8,951.8
20899,UD8D575,8,-4800.0,6,2,9600.0,4800.0
20900,UC3380B,8,-647.65,5,3,740.88,93.23
20901,UF98D49,8,-1259.0599999999995,6,2,9406.060000000001,8147.0
20902,U68DB90,8,-11186.619999999999,8,0,11186.619999999999,0.0
20903,U2CDCF1,8,30000.0,6,2,593.0,30593.0
20904,UD601C0,8,254.0,5,3,54.0,308.0
20905,U89CF4E,8,-1186.4999999999995,5,3,3573.22,2386.7200000000003
20906,UA6CDA4,8,-550.4599999999999,7,1,850.4599999999999,300.0
20907,U082745,8,-1293.28,5,3,1800.0,506.72
20908,U257C55,8,-7.0900000000001455,5,3,7920.0,7912.91
20909,U64900F,8,-1412.7300000000005,5,3,4425.89,3013.16
20910,UA800A3,8,346.0000000000001,4,4,881.34,1227.3400000000001
20911,UD28B18,8,12637.330000000002,5,3,28936.11,41573.44
20912,U8DC868,8,-29.98999999999978,3,5,7692.0,7662.01
20913,U81A8AF,8,-4368.0,5,3,13369.0,9001.0
20914,U7944AF,8,-6490.79,4,4,7788.79,1298.0
20915,UBD7B17,8,-2.0,5,3,801.0,799.0
20916,U10E185,8,4968.41,3,5,5032.0,10000.41
20917,U75BC35,8,-49.94,6,2,192.28,142.34
20918,UFB23B0,8,42429.0,0,8,0.0,42429.0
20919,U470EC8,8,22.10000000000001,6,2,626.9599999999999,649.06
20920,U3C35C1,8,-5333.0,6,2,11483.0,6150.0
20921,U4340DB,8,-10087.14,8,0,10087.14,0.0
20922,UB06027,8,-5.684341886080802e-14,5,3,800.0699999999999,800.07
20923,U0C5B0B,8,2163.129999999999,4,4,12739.7,14902.83
20924,UC4DC0E,8,404.5,4,4,4010.0,4414.5
20925,UCDFCE4,8,-79.0,3,5,21079.0,21000.0
20926,UE0FAC8,8,490.3600000000006,4,4,39610.0,40100.36
20927,U8D3A5C,8,-1949.2,5,3,3038.0,1088.8
20928,U17638B,8,-22.0,6,2,9122.0,9100.0
20929,U53C149,8,7.5,4,4,4010.0,4017.5
20930,U3D534F,8,226.71999999999994,6,2,588.1999999999999,814.92
20931,U480623,8,-2880.54,6,2,8180.540000000001,5300.0
20932,UF9C4C0,8,57.0,4,4,583.0,640.0
20933,U944377,8,-616.5799999999997,6,2,14916.76,14300.18
20934,U79D15F,8,-1628.0,6,2,9016.0,7388.0
20935,UDB1E18,8,39.75,5,3,10.34,50.089999999999996
20936,UD73C29,8,-6071.759999999998,6,2,17059.76,10988.0
20937,UD772A9,8,-1021.12,7,1,2558.62,1537.5
20938,UA768C9,8,15770.92,3,5,345.64,16116.560000000001
20939,U0D8762,8,-9302.85,7,1,10430.0,1127.15
20940,UE6805D,8,1571.7600000000002,5,3,6140.0,7711.76
20941,UF6844B,8,-2259.4799999999996,4,4,12084.0,9824.52
20942,U0E7F28,8,-184.07999999999998,6,2,234.90000000000003,50.82
20943,U30A588,8,-127.06,6,2,330.38,203.32
20944,U336DBC,8,-0.8099999999999454,5,3,3435.0,3434.19
20945,UC80C87,8,-49924.409999999996,3,5,250010.0,200085.59
20946,UEA35C4,8,4302.05,4,4,3513.3,7815.349999999999
20947,UEE8915,8,-6591.98,8,0,6591.98,0.0
20948,U49004F,8,-2999.9999999999995,5,3,9417.720000000001,6417.72
20949,U01569B,8,2675.579999999999,7,1,6324.42,9000.0
20950,U81A0D7,8,-3452.079999999998,4,4,26604.329999999998,23152.25
20951,UFB55C5,8,3867.2,5,3,1666.6,5533.8
20952,UEC8F83,8,19000.0,3,5,161.9,19161.9
20953,UA62AAC,8,-2789.49,3,5,20800.0,18010.510000000002
20954,UC513FC,8,-70.97000000000025,5,3,2141.0,2070.03
20955,UF67333,8,-5900.999999999999,6,2,8866.899999999998,2965.8999999999996
20956,U76360A,8,-6698.740000000001,7,1,6698.75,0.01
20957,U280BAC,8,-4.920000000000073,4,4,2704.92,2700.0
20958,UD643CF,8,-603.78,4,4,3447.0699999999997,2843.29
20959,U7089D1,8,4120.0,4,4,15700.0,19820.0
20960,U1D04CF,8,0.0,3,5,18000.0,18000.0
20961,UCA6E58,8,1.4210854715202004e-14,7,1,151.3,151.3
20962,U2F24D7,8,830.0,4,4,1533.5,2363.5
20963,U72486E,8,12.0,4,4,19988.0,20000.0
20964,U68670C,8,463.0799999999999,5,3,2921.92,3385.0
20965,U321E31,8,651.0200000000001,6,2,502.94,1153.96
20966,U932A7D,8,0.0,5,3,3205.86,3205.86
20967,U2815E1,8,10935.52,4,4,10512.0,21447.52
20968,U804873,8,-385.27999999999986,7,1,4385.280000000001,4000.0
20969,U18D595,8,132.04,3,5,179.73999999999998,311.78000000000003
20970,U604C6C,8,337.92,7,1,162.08,500.0
20971,U26C954,8,714.03,7,1,5055.01,5769.04
20972,U9B0470,8,1695.0,3,5,7575.0,9270.0
20973,U8821AE,8,-610.1999999999998,5,3,6010.2,5400.0
20974,UA329AD,8,2742.89,4,4,11085.71,13828.6
20975,U0AAD52,8,-20.0,5,3,15620.0,15600.0
20976,U5F989D,8,-5573.89,8,0,5573.89,0.0
20977,UD14D3C,8,-4254.38,8,0,4254.38,0.0
20978,UD73CF0,8,-2994.01,5,3,6000.01,3006.0
20979,UBA0B62,8,-2477.96,5,3,5178.0,2700.04
20980,UDF38D0,8,0.8000000000001819,6,2,5570.2,5571.0
20981,UCE1BFE,8,-620.52,6,2,3532.52,2912.0
20982,U80DCC5,8,287.25,3,5,31013.0,31300.25
20983,U811D8F,8,-674.7199999999998,5,3,5287.719999999999,4613.0
20984,U76D4F7,8,-518.0,7,1,519.0,1.0
20985,U333214,8,-3893.459999999999,3,5,36018.0,32124.54
20986,U92FA1C,8,704.3100000000001,5,3,2402.62,3106.93
20987,U710738,8,10000.01,4,4,3996.66,13996.67
20988,U1F919F,8,456.0,4,4,2010.0,2466.0
20989,U08C0F8,8,-73.59000000000015,5,3,11612.36,11538.77
20990,UC70E2F,8,1470.0,6,2,530.0,2000.0
20991,U9D7DD8,8,-796.2099999999999,5,3,1335.21,539.0
20992,U6E1FB4,8,-8.529999999999854,5,3,5794.66,5786.13
20993,UF89532,8,638.14,6,2,2033.6799999999998,2671.82
20994,U9ADBA9,8,3000.0,4,4,2998.0,5998.0
20995,U27747C,8,-20874.24,3,5,30000.0,9125.76
20996,U5D03A2,8,78.0,4,4,720.0,798.0
20997,U074D21,8,-48.850000000000364,4,4,12974.4,12925.55
20998,U970B4C,8,1200.6299999999999,6,2,4263.0,5463.63
20999,U413CCE,8,15291.0,4,4,6010.0,21301.0
21000,U612CB8,8,-11530.64,5,3,15926.09,4395.450000000001
21001,UFD9BDA,8,-1755.1000000000001,8,0,1755.1000000000001,0.0
21002,U4C4218,8,-1608.9499999999998,7,1,1609.07,0.12
21003,U6C8977,8,-5412.99,5,3,17283.0,11870.01
21004,U529F6C,8,4720.0,5,3,16620.0,21340.0
21005,U8F6F60,8,-958.8299999999999,6,2,18095.93,17137.1
21006,U901F46,8,3748.31,6,2,875.4,4623.71
21007,U6BC238,8,0.0,4,4,9000.0,9000.0
21008,U5BAF47,8,-3699.8100000000004,6,2,9490.26,5790.45
21009,UFD33F8,8,329.0,6,2,406.7,735.7
21010,U42B87E,8,2.463307335887066e-16,7,1,3.059999999999999,3.06
21011,U8E7050,8,310.0,3,5,207.65,517.65
21012,UF0EAB3,8,1850.8600000000006,2,6,10100.0,11950.86
21013,UB82BD2,8,-100.0,4,4,7900.0,7800.0
21014,UD17248,8,-126.19,7,1,226.19,100.0
21015,U77BCF6,8,25.8599999999999,5,3,3562.1400000000003,3588.0
21016,U2DC7AC,8,0.9600000000000231,5,3,1715.43,1716.39
21017,U956D93,8,-624.75,7,1,659.75,35.0
21018,UFACBC4,8,-78.36000000000003,5,3,1400.0,1321.64
21019,U15F60C,8,5311.860000000001,1,7,3610.0,8921.86
21020,U3290AD,8,259.9200000000001,6,2,1704.0,1963.92
21021,U5A0206,8,-1251.2399999999998,5,3,10511.240000000002,9260.0
21022,U3040CC,8,-3877.56,8,0,3877.56,0.0
21023,UDC55C9,8,-2939.73,4,4,5900.0,2960.27
21024,UFE9C39,8,-1410.0,6,2,3706.5,2296.5
21025,UA9613E,8,-2420.92,4,4,3508.7200000000003,1087.8
21026,U4750C5,8,-76.69,6,2,116.69,40.0
21027,UEA20EF,8,37.07999999999993,5,3,7963.0,8000.08
21028,U35B7A7,8,-15606.0,8,0,15606.0,0.0
21029,UDAB6C6,8,-410.0,5,3,1660.0,1250.0
21030,UB29275,8,6.74807432154978e-16,7,1,3.059999999999999,3.06
21031,UF23EDC,8,6429.0,3,5,29996.0,36425.0
21032,UE36C19,8,0.0,5,3,30050.0,30050.0
21033,UBE05D2,8,-8.989999999999782,4,4,10009.01,10000.02
21034,U3C8905,8,1501.05,4,4,59527.0,61028.05
21035,U5D89D9,8,-3324.6,6,2,5462.700000000001,2138.1
21036,U4D0598,8,-2581.3999999999996,6,2,9920.0,7338.6
21037,U83AA06,8,5849.540000000001,6,2,3328.46,9178.0
21038,U9BD454,8,-16325.67,8,0,16325.67,0.0
21039,UAB08CF,8,613.08,4,4,851.75,1464.83
21040,U18AC82,8,139.04000000000002,6,2,652.96,792.0
21041,U9548E1,8,-10496.32,5,3,11999.56,1503.24
21042,U3A5104,8,2796.7000000000003,5,3,14203.3,17000.0
21043,U69305A,8,-2098.8999999999996,8,0,2098.8999999999996,0.0
21044,U778E1D,8,-1068.9400000000005,7,1,5446.140000000001,4377.2
21045,UA26BAC,8,-231.20000000000002,4,4,851.2,620.0
21046,U56E442,8,-9231.34,6,2,13889.34,4658.0
21047,U7AE7D5,8,-189.86,6,2,408.0,218.14
21048,U322042,8,5072.85,5,3,3255.0,8327.85
21049,UC3DDDB,8,909.5,5,3,14624.5,15534.0
21050,U105608,8,-39111.659999999996,8,0,39111.659999999996,0.0
21051,U739312,8,-11490.15,4,4,23000.34,11510.19
21052,UF87984,8,0.3000000000020382,4,4,60009.26,60009.560000000005
21053,U1FAB28,8,184.64,4,4,1407.3600000000001,1592.0
21054,U4513CB,8,1.8099999999999454,4,4,5475.0,5476.8099999999995
21055,U04C54A,8,-110.0,5,3,5990.0,5880.0
21056,U21E9A1,8,-300.5200000000002,6,2,1565.98,1265.46
21057,U5FDF37,8,1891.0,3,5,4649.0,6540.0
21058,U8E04BA,8,-6901.5599999999995,8,0,6901.5599999999995,0.0
21059,U4FD04F,8,-3771.1999999999994,3,5,20137.1,16365.9
21060,U9ECDE3,8,3459.6,6,2,1624.8,5084.4
21061,U75A2BC,8,0.04,5,3,36521.66,36521.700000000004
21062,U4B4CE3,8,208.99,5,3,1100.0600000000002,1309.05
21063,UE97606,8,28574.21,3,5,389.33,28963.539999999997
21064,UA1B0BB,8,-174.69,8,0,174.69,0.0
21065,UF01A0A,8,97587.15,2,6,8147.23,105734.38
21066,UD53E38,8,-2881.24,6,2,5706.0,2824.76
21067,U119E44,8,-652.1999999999999,8,0,652.1999999999999,0.0
21068,U726D7E,8,-3638.34,8,0,3638.34,0.0
21069,UEDC035,8,-2133.59,2,6,5000.0,2866.41
21070,UD6EDC3,8,-363.77000000000044,5,3,31827.5,31463.73
21071,U196628,8,20610.3,4,4,3210.0,23820.3
21072,U1122A6,8,19425.22,3,5,6100.0,25525.22
21073,U9D56CF,8,450.0,4,4,20050.0,20500.0
21074,U260868,8,-1792.7799999999997,4,4,10132.8,8340.02
21075,UDB8CA9,8,0.0,6,2,548.81,548.81
21076,UE57059,8,-3062.2799999999997,8,0,3062.2799999999997,0.0
21077,U33FA5F,8,39998.09999999999,5,3,5255.900000000001,45254.0
21078,U08DC06,8,4051.3199999999997,5,3,1389.34,5440.66
21079,UEA8FCF,8,-2635.0,6,2,5083.5,2448.5
21080,UD37F7F,8,-91.57000000000001,6,2,460.34,368.77
21081,U323B6C,8,15.239999999999782,4,4,2310.91,2326.15
21082,U2110F3,8,1.1368683772161603e-13,6,2,3731.76,3731.76
21083,UAD21AC,8,-8408.9,6,2,8414.17,5.27
21084,U8ADC2A,8,-13555.669999999998,7,1,43555.67,30000.0
21085,U702E24,8,61.0,5,3,15939.689999999999,16000.689999999999
21086,U3AA438,8,-26170.760000000002,6,2,30498.760000000002,4328.0
21087,U634AA5,8,4.420000000000073,5,3,14075.58,14080.0
21088,U3757EB,8,7789.040000000001,1,7,20450.0,28239.04
21089,UCF16AC,8,-17.91,5,3,319.66,301.75
21090,UD30D1A,8,11764.73,0,8,0.0,11764.73
21091,U8A20E5,8,4521.849999999999,4,4,76.9,4598.75
21092,U6562BB,8,-244.01000000000002,6,2,394.62,150.61
21093,U88B33D,8,281.51,5,3,18.5,300.01
21094,UCBD014,8,322.0,6,2,2190.0,2512.0
21095,U655879,8,-2256.2599999999998,8,0,2256.2599999999998,0.0
21096,U5A7F16,8,-4009.0,5,3,23980.0,19971.0
21097,UFC2766,8,-5006.6,6,2,8682.7,3676.1
21098,UE85597,8,2417.11,4,4,19278.739999999998,21695.850000000002
21099,UB321C0,8,669.0,4,4,14028.0,14697.0
21100,U4455A0,8,-2215.6800000000003,4,4,3010.0,794.3199999999999
21101,UD0427F,8,2127.52,6,2,4539.9,6667.42
21102,UD9EFF6,8,1066.54,3,5,1011.54,2078.08
21103,U28D2E1,8,-7.010000000000218,5,3,8489.0,8481.99
21104,U625D9F,8,-6362.75,7,1,13945.919999999998,7583.17
21105,U685CB2,8,12.430000000000291,4,4,17208.0,17220.43
21106,UBF1DDF,8,1504.33,4,4,1453.34,2957.67
21107,U9E17DE,8,2628.11,5,3,1090.78,3718.89
21108,UC57EF0,8,-2069.88,8,0,2069.88,0.0
21109,U41B139,8,8017.73,2,6,10640.0,18657.73
21110,U44A409,8,127.10000000000002,7,1,372.9,500.0
21111,UE61D3E,8,110000.0,1,7,100000.0,210000.0
21112,U9626DA,8,-937.2,6,2,1117.2,180.0
21113,UE5562C,8,41.90999999999985,6,2,1304.0900000000001,1346.0
21114,UDE5487,8,2717.9999999999995,4,4,1134.8600000000001,3852.8599999999997
21115,U7D0B6B,8,0.0,5,3,1189.3400000000001,1189.3400000000001
21116,U4CF2A1,8,-4850.0,3,5,9500.0,4650.0
21117,U08F55C,8,-8708.900000000001,4,4,61142.9,52434.0
21118,U69CA2D,8,-98.57000000000002,6,2,293.22,194.64999999999998
21119,U73D32F,8,-136.75,5,3,1005.3,868.55
21120,UE00B5F,8,-0.08000000000000007,3,5,5005.0,5004.92
21121,U5C4CBF,8,-2802.3800000000006,6,2,8073.38,5271.0
21122,U38BC31,8,-712.5999999999999,5,3,1673.0,960.4
21123,U824827,8,-1461.7,6,2,2294.9,833.1999999999999
21124,U76C06B,8,-3839.99,5,3,4459.42,619.43
21125,U7D78F4,8,399.0,6,2,1001.0,1400.0
21126,UAF2998,8,-9125.719999999998,8,0,9125.719999999998,0.0
21127,UAA152E,8,17985.3,5,3,3307.2,21292.5
21128,U0E5D83,8,185.3699999999999,4,4,20966.0,21151.37
21129,UC1B1C3,8,-272.39999999999964,4,4,14221.0,13948.6
21130,UDA8431,8,-106.19000000000003,4,4,379.5,273.30999999999995
21131,U185C27,8,50408.5,3,5,2109.56,52518.06
21132,U89EC13,8,2.0,4,4,5498.0,5500.0
21133,UACE4B1,8,42.00999999999999,4,4,1159.84,1201.85
21134,U7A839F,8,-20.0,5,3,8080.0,8060.0
21135,UC67612,8,-2325.8199999999997,4,4,2825.8199999999997,500.0
21136,U27AD5A,8,2068.89,4,4,908.34,2977.23
21137,UA32155,8,-9.0,7,1,33.0,24.0
21138,U70473C,8,351.0,3,5,9890.0,10241.0
21139,U636233,8,165232.47999999998,4,4,6624.7,171857.18
21140,U39C012,8,-4715.9,6,2,12271.1,7555.2
21141,U26BC52,8,-756.06,8,0,756.06,0.0
21142,U671B36,8,-2152.0,5,3,2573.0,421.0
21143,U631CEC,8,25064.02,4,4,169.5,25233.52
21144,U30F8D4,8,-20010.99,4,4,65211.16,45200.170000000006
21145,U2571AB,8,-6226.0,6,2,11236.0,5010.0
21146,U105F9E,8,20.0,3,5,5000.0,5020.0
21147,UDE1E70,8,-66.0,7,1,107.0,41.0
21148,UF43744,8,2972.7000000000007,3,5,3291.38,6264.080000000001
21149,UE44477,8,414.7,7,1,585.3,1000.0
21150,UF39294,8,11140.57,3,5,11220.64,22361.21
21151,UE491B4,8,-178.22000000000003,5,3,5178.51,5000.29
21152,U249300,8,-6140.380000000001,6,2,12214.61,6074.23
21153,U143DDC,8,0.0,4,4,4925.58,4925.58
21154,U64A0EE,8,-10.599999999999909,7,1,3010.6,3000.0
21155,U59B407,8,-4291.32,8,0,4291.32,0.0
21156,U9CED49,8,-2949.98,4,4,5900.0,2950.02
21157,U27B63C,8,-716.93,5,3,14017.0,13300.07
21158,U890B3A,8,-4710.0,4,4,5310.0,600.0
21159,UF7B9EB,8,-107.91999999999999,8,0,107.91999999999999,0.0
21160,UA5447B,8,-859.23,5,3,1262.0,402.77
21161,UE7E307,8,3622.9700000000003,3,5,6493.2,10116.17
21162,UFA2015,8,142.61000000000035,5,3,11892.699999999999,12035.31
21163,U84CC17,8,0.0,4,4,510.28,510.28
21164,U9BD9EA,8,-389.62000000000006,6,2,921.6200000000001,532.0
21165,U19802C,8,-17043.07,8,0,17043.07,0.0
21166,U083835,8,-70.69000000000001,6,2,470.7,400.01
21167,UB87C17,8,2.469999999999999,4,4,546.46,548.9300000000001
21168,UA55AE3,8,8500.0,6,2,4103.2,12603.2
21169,UE10628,8,-236.0199999999999,7,1,5236.0199999999995,5000.0
21170,UD4D9DC,8,-383.07,6,2,1885.1399999999999,1502.07
21171,UF32AB2,8,-5866.740000000002,8,0,5866.740000000002,0.0
21172,U672C0D,8,1.909999999999975,5,3,519.48,521.3900000000001
21173,U259779,8,0.19999999999998863,4,4,279.8,280.0
21174,U5E0864,8,-27.39999999999999,5,3,246.89999999999998,219.5
21175,U04F87B,8,181.94,6,2,4272.0599999999995,4454.0
21176,UA563B3,8,888.4899999999998,5,3,6328.5,7216.99
21177,U6F9DFC,8,-7362.579999999999,4,4,14800.0,7437.419999999999
21178,U0096B7,8,22062.630000000005,3,5,103000.0,125062.63
21179,U9A0769,8,-6860.7,5,3,19200.0,12339.3
21180,UED75DA,8,8199.989999999998,4,4,1035000.02,1043200.01
21181,UA3582C,8,1047.0,6,2,3100.0,4147.0
21182,U8DDCD7,8,-652.5999999999999,8,0,652.5999999999999,0.0
21183,U33D423,8,-1031.5,5,3,2883.5,1852.0
21184,U056DFD,8,-204.32,7,1,204.5,0.18
21185,U43AAB0,8,-7194.3200000000015,8,0,7194.3200000000015,0.0
21186,UD8DD07,8,-30188.91,4,4,54438.74,24249.83
21187,UE3DC93,8,-1105.0,4,4,18210.0,17105.0
21188,UA0074E,8,596.8700000000044,5,3,32898.0,33494.87
21189,UC75794,8,74.77999999999975,4,4,5362.67,5437.449999999999
21190,U1A3BE3,8,284.3,5,3,183.7,468.0
21191,U0A5464,8,1432.0,5,3,6668.0,8100.0
21192,U49F097,8,147.0,6,2,3892.0,4039.0
21193,U8C7E1E,8,436.81999999999994,6,2,1631.0,2067.8199999999997
21194,U148AA9,8,9611.67,3,5,11000.0,20611.67
21195,U246FE2,8,0.0,4,4,80000.0,80000.0
21196,U3783A3,8,-88.06999999999971,4,4,7788.219999999999,7700.15
21197,UC89838,8,-196.58999999999992,6,2,782.0,585.4100000000001
21198,U85C2A6,8,901.1100000000006,6,2,5560.0,6461.110000000001
21199,U4B5B81,8,21.889999999999418,5,3,48159.98,48181.869999999995
21200,UD6D172,8,43.57,6,2,6536.0,6579.57
21201,U995806,8,-169.23999999999995,6,2,472.13999999999993,302.9
21202,U522B1B,8,-83.08999999999997,6,2,424.03999999999996,340.95
21203,U84B2BD,8,-1550.0,3,5,6078.0,4528.0
21204,U600554,8,-988.26,8,0,988.26,0.0
21205,U930DF5,8,191.0,6,2,19724.6,19915.6
21206,UCA2E0F,8,0.0,4,4,12000.0,12000.0
21207,UC7CB0F,8,-668.0,4,4,3238.0,2570.0
21208,UC1EB29,8,-3125.0199999999995,5,3,10337.91,7212.89
21209,UD8313E,8,1334.77,4,4,2085.25,3420.02
21210,U5D6AD9,8,-5777.46,8,0,5777.46,0.0
21211,U49FD00,8,-2058.49,6,2,5595.5,3537.01
21212,U9A550F,8,3.2399999999997817,4,4,14796.76,14800.0
21213,UC324F2,8,-4862.0,4,4,14570.0,9708.0
21214,UFE976E,8,-4575.23,6,2,7075.23,2500.0
21215,U34AF0D,8,62554.8,5,3,37506.0,100060.8
21216,UBD9FA7,8,-4607.42,7,1,4607.43,0.01
21217,U9CE70C,8,-1148.62,6,2,3362.47,2213.85
21218,UB9FC1A,8,-7752.62,6,2,14094.6,6341.98
21219,UA24260,8,3586.53,2,6,148.94,3735.4700000000003
21220,U5ACD24,8,-172.24,5,3,338.82,166.57999999999998
21221,UBDFBFC,8,1985.0,6,2,5861.0,7846.0
21222,U0B7697,8,314.0,7,1,986.0,1300.0
21223,UF23089,8,-653.4499999999999,6,2,2429.5699999999997,1776.12
21224,UD9FABD,8,-19.64,5,3,253.1,233.45999999999998
21225,UDA00EA,8,-338.70000000000016,5,3,10343.7,10005.0
21226,UF8EF27,8,-548.22,6,2,786.1699999999998,237.95
21227,U5AC02A,8,-8028.530000000086,4,4,1540880.0,1532851.47
21228,UBDBFC9,8,1819.31,4,4,728.46,2547.77
21229,U40D105,8,-51.99999999999997,6,2,1281.51,1229.51
21230,U2F3072,8,-300.0,4,4,30300.0,30000.0
21231,UE16DDC,8,42.94,7,1,348.08,391.02
21232,U5D2790,8,10178.04,3,5,11826.060000000001,22004.1
21233,UD9AFC4,8,-430.07000000000005,6,2,1068.54,638.47
21234,UFE518E,8,-528.0399999999998,7,1,3178.04,2650.0
21235,U60C0DD,8,-2811.0,7,1,5581.0,2770.0
21236,U99522A,8,1814.99,6,2,947.6700000000001,2762.66
21237,UB41C44,8,10579.060000000001,4,4,4320.94,14900.0
21238,U567698,8,-3471.0,5,3,7865.0,4394.0
21239,UD7C34A,8,383.20000000000005,6,2,2120.0,2503.2
21240,U9E18B2,8,-6320.280000000001,8,0,6320.280000000001,0.0
21241,U057DBA,8,-2551.04,8,0,2551.04,0.0
21242,UC15587,8,3894.5699999999997,3,5,923.0,4817.57
21243,UE38D40,8,1000.1000000000004,6,2,5568.9,6569.0
21244,UB06A26,8,-4054.0,3,5,50885.0,46831.0
21245,UD6009D,8,-1900.0,4,4,9610.0,7710.0
21246,U75005D,8,-130.39999999999998,4,4,531.8,401.4
21247,U27DC0D,8,1635.3200000000002,5,3,6315.68,7951.0
21248,UF85F9D,8,1854.76,4,4,3774.34,5629.1
21249,UEB36BA,8,0.17000000000004434,6,2,450.67999999999995,450.85
21250,UF4F6FB,8,60.0,4,4,6000.0,6060.0
21251,UD0D08E,8,-2951.25,6,2,3000.0,48.75
21252,U68743C,8,-3267.45,6,2,4334.45,1067.0
21253,U077F89,8,16016.240000000002,5,3,3988.5000000000005,20004.74
21254,UE9E0F3,8,-2852.4700000000003,6,2,3174.47,322.0
21255,UC73EF8,8,-2582.0,7,1,4052.0,1470.0
21256,UE72680,8,142.0,5,3,1168.0,1310.0
21257,UF1C70F,8,-1037.0,7,1,1337.0,300.0
21258,UA272FB,8,-2760.02,8,0,2760.02,0.0
21259,U1FDDD7,8,5503.08,2,6,5848.92,11352.0
21260,UA53094,8,-1522.4,6,2,3565.4,2043.0
21261,U77FA43,8,968.73,4,4,110.8,1079.53
21262,U990462,8,-8.190000000002328,4,4,111460.0,111451.81
21263,UA4C96C,8,-3950.0,4,4,13500.0,9550.0
21264,U564F94,8,-596.0800000000008,2,6,10712.92,10116.84
21265,UDA76D5,8,2548.67,4,4,141.39999999999998,2690.0699999999997
21266,U62E068,8,4558.26,3,5,5054.86,9613.12
21267,U153553,8,2661.0200000000004,6,2,2090.9799999999996,4752.0
21268,UC6CAC3,8,576.7699999999995,5,3,11424.74,12001.51
21269,UBBA5C0,8,1506.4899999999998,4,4,10000.0,11506.49
21270,U14FB6E,8,0.730000000000004,6,2,55.269999999999996,56.0
21271,U9CF3AF,8,-1515.6899999999996,5,3,14194.0,12678.310000000001
21272,U040BAE,8,-10871.97,6,2,13074.22,2202.25
21273,U12B347,8,-1041.29,4,4,2763.52,1722.23
21274,U14D21B,8,367.88999999999993,4,4,687.1200000000001,1055.01
21275,U26299F,8,0.0,4,4,200.0,200.0
21276,U4BE3D1,8,-541.86,7,1,541.9300000000001,0.07
21277,UBC7E44,8,-1791.4,8,0,1791.4,0.0
21278,U036735,8,3642.0600000000004,5,3,6994.450000000001,10636.51
21279,UE5332B,8,-2632.8399999999997,6,2,12569.269999999999,9936.43
21280,U7447D4,8,-6051.02,6,2,24588.02,18537.0
21281,U8D7E61,8,-643.7099999999955,3,5,28563.9,27920.190000000002
21282,U2A9DFD,8,-169.91,8,0,169.91,0.0
21283,UE8136C,8,-197.81,6,2,622.8,424.99
21284,U614527,8,-14.599999999999977,4,4,1834.7,1820.1
21285,U207B85,8,-2004.0,5,3,4170.0,2166.0
21286,UD811A1,8,-16.200000000000003,8,0,16.200000000000003,0.0
21287,U17B25E,8,420.0,5,3,1006.0,1426.0
21288,U32D891,8,16594.03,2,6,10000.0,26594.03
21289,U698FB2,8,16518.1,5,3,5360.0,21878.1
21290,UC9F4E4,8,0.0,4,4,10000.0,10000.0
21291,U6EB9BA,8,-1512.0,2,6,14062.0,12550.0
21292,UA20D2E,8,6.020000000000437,3,5,23839.0,23845.02
21293,U3CB149,8,-429.0,6,2,589.0,160.0
21294,U9565B5,8,6093.0,4,4,13955.0,20048.0
21295,UBE4990,8,1301.0,6,2,17396.0,18697.0
21296,UB56F27,8,5898.62,5,3,9944.38,15843.0
21297,UAEB775,8,-12409.0,6,2,14010.0,1601.0
21298,UD961C8,8,-209.47000000000003,7,1,309.8,100.33
21299,U07F67E,8,0.5,4,4,341.0,341.5
21300,UF5766A,8,-1000.0000000000007,6,2,50269.89,49269.89
21301,UA29A3C,8,2.5000000000000853,6,2,3344.8,3347.3
21302,U633830,8,-338.0799999999981,4,4,31700.42,31362.34
21303,UEEBF97,8,472.47,4,4,927.64,1400.1100000000001
21304,UD2AF20,8,245.1899999999999,6,2,633.51,878.7
21305,U7E6D78,8,0.0,4,4,17930.0,17930.0
21306,U414636,8,-306.9899999999998,5,3,4655.0,4348.01
21307,U47CF7E,8,3.0,6,2,3122.0,3125.0
21308,UBC7DB4,8,1153.45,6,2,2240.0,3393.45
21309,U72C7B1,8,34002.34,2,6,10000.0,44002.34
21310,UAFE9B0,8,4729.17,5,3,561.6600000000001,5290.83
21311,UC0A292,8,-10163.34,6,2,10438.24,274.9
21312,U6752EF,8,79.39999999999964,7,1,7187.0,7266.4
21313,U65F6DF,8,3790.0,4,4,11734.5,15524.5
21314,U657234,8,-744.2,6,2,1573.2,829.0
21315,U7B8036,8,110.58999999999999,6,2,124.89999999999999,235.49
21316,U1FFCCB,8,3132.5,4,4,2130.0,5262.5
21317,UEBCBB0,8,724.0900000000001,6,2,5780.0,6504.09
21318,UBE5AE5,8,-564.0,4,4,3564.0,3000.0
21319,U1FE35B,8,-914.68,8,0,914.68,0.0
21320,UF08ED8,8,15.949999999999818,4,4,2533.01,2548.96
21321,U85F907,8,7633.34,4,4,846.0999999999999,8479.44
21322,U54D6E8,8,2987.5,4,4,14993.0,17980.5
21323,U838608,8,1001.09,2,6,98.91,1100.0
21324,U8A947D,8,9014.470000000001,1,7,3990.0,13004.47
21325,U2852A8,8,75.40000000000009,6,2,1708.1999999999998,1783.6
21326,U6A9CBB,8,5140.6900000000005,5,3,10827.95,15968.64
21327,U1C3F02,8,-149.04000000000008,4,4,719.0400000000001,570.0
21328,UBC4738,8,0.7100000000000728,5,3,1392.47,1393.18
21329,U55373E,8,-5.0,5,3,5553.0,5548.0
21330,UA5A433,8,-267.8499999999999,6,2,3917.85,3650.0
21331,U08F083,8,-919.5999999999999,8,0,919.5999999999999,0.0
21332,UCA456C,8,-676.5100000000002,4,4,10522.51,9846.0
21333,UDCBB14,8,62.04,3,5,23002.0,23064.04
21334,U0F8CED,8,2169.6600000000003,6,2,346.34000000000003,2516.0
21335,U5ECBCA,8,82.57999999999998,6,2,617.0,699.5799999999999
21336,UD67892,8,-3524.22,6,2,8548.779999999999,5024.5599999999995
21337,UBAD5D6,8,-948.2400000000002,6,2,1514.44,566.2
21338,UBFFDF9,8,-972.68,4,4,1022.68,50.0
21339,UC31B20,8,2100.1000000000004,1,7,200.2,2300.3
21340,U3728C7,8,-1509.0,5,3,21489.0,19980.0
21341,U1F409D,8,-387.06,6,2,2387.06,2000.0
21342,U895FC1,8,-14863.280000000002,4,4,29108.24,14244.96
21343,U945954,8,-1003.0,7,1,1426.0,423.0
21344,UC9D4CE,8,-15179.679999999997,8,0,15179.679999999997,0.0
21345,UC2F6BD,8,0.0,4,4,592.0,592.0
21346,UE291C8,8,0.0,5,3,4920.76,4920.76
21347,U29ECFB,8,-405.7700000000001,5,3,11598.6,11192.83
21348,U31A50D,8,32.39999999999989,6,2,3311.1,3343.5
21349,UB4FA2B,7,0.009999999999308784,3,4,14998.27,14998.279999999999
21350,U76501F,7,-5261.200000000001,6,1,5761.200000000001,500.0
21351,U15ADDE,7,-5320.359999999995,2,5,709000.0,703679.64
21352,UB91066,7,-609.0799999999999,3,4,2800.11,2191.03
21353,U9BF273,7,780.0699999999999,4,3,458.34000000000003,1238.4099999999999
21354,U86FFB7,7,3.2899999999999636,4,3,1343.42,1346.71
21355,U9ADBD3,7,-2235.0599999999995,6,1,2235.0699999999997,0.01
21356,UC846B4,7,-49.0,5,2,40875.0,40826.0
21357,UD5AB43,7,333.3000000000002,4,3,9294.7,9628.0
21358,UCC318A,7,1360.2599999999998,5,2,1684.7400000000002,3045.0
21359,U45BB28,7,2405.11,4,3,5015.62,7420.73
21360,UC9F24C,7,878.22,5,2,1481.78,2360.0
21361,UD5E437,7,-151.0,4,3,15706.1,15555.1
21362,UA183E9,7,654.1499999999996,5,2,4348.16,5002.3099999999995
21363,UFCBC7C,7,-1110.46,7,0,1110.46,0.0
21364,UE6483B,7,374.28,5,2,5725.72,6100.0
21365,UDB0FDC,7,4201.29,3,4,4966.66,9167.95
21366,UE9EDB8,7,42.85999999999967,5,2,3547.1200000000003,3589.98
21367,U50AF28,7,-367.61,4,3,707.5,339.89
21368,UF58319,7,-3.9299999999999997,5,2,1056.0,1052.07
21369,U2C698E,7,45.82999999999996,3,4,343.31,389.14
21370,U1CC854,7,-4959.0,3,4,9962.0,5003.0
21371,U2F8E38,7,6892.24,5,2,3335.76,10228.0
21372,U9DB21C,7,-599.78,5,2,1100.0,500.22
21373,U4F87A3,7,-318.71,6,1,318.81,0.1
21374,UB694CB,7,2000.0,2,5,1500.0,3500.0
21375,UF375D7,7,44.33999999999998,4,3,182.9,227.24
21376,UF658DF,7,6656.0,0,7,0.0,6656.0
21377,UAB0AEE,7,-1539.2399999999998,7,0,1539.2399999999998,0.0
21378,UBF543E,7,21395.46,2,5,2306.5,23701.96
21379,UA98323,7,-42.850000000000364,5,2,4390.85,4348.0
21380,UF79DF5,7,643.09,4,3,12.0,655.09
21381,U371B20,7,17475.21,4,3,2977.4,20452.61
21382,UEB0DAA,7,783.6099999999999,4,3,4096.4,4880.01
21383,UE0894A,7,-359.5,4,3,956.1,596.6
21384,U64EE32,7,-19.9,4,3,551.4,531.5
21385,U0FF1FA,7,1188.6000000000004,5,2,5609.02,6797.62
21386,UA49545,7,-18750.84,2,5,35000.0,16249.16
21387,UC10A61,7,-8.38000000000011,3,4,11263.58,11255.2
21388,UFE3E1C,7,19.0,5,2,1232.0,1251.0
21389,U441C87,7,-34.7,5,2,75.0,40.3
21390,UDBC742,7,17056.4,4,3,3278.7,20335.1
21391,U164B17,7,2014.3000000000002,3,4,26226.199999999997,28240.5
21392,UE858BA,7,-0.19999999999936335,4,3,10633.599999999999,10633.4
21393,UDF8771,7,8075.21,4,3,4207.6,12282.810000000001
21394,U45D44A,7,-1074.67,5,2,2914.17,1839.5
21395,U82B489,7,0.3999999999996362,4,3,19999.6,20000.0
21396,U263C53,7,219.38999999999996,2,5,40.73,260.12
21397,U50A381,7,-6956.04,5,2,13218.0,6261.96
21398,U40C615,7,-999.5,5,2,1144.0,144.5
21399,UFC0916,7,57500.04,2,5,57309.0,114809.04000000001
21400,U316D16,7,172.07,4,3,665.0,837.0699999999999
21401,U78E192,7,-999.9499999999999,3,4,2808.14,1808.19
21402,UAA8CE1,7,-2499.8599999999997,5,2,3766.0,1266.14
21403,U538932,7,-843.22,5,2,1195.0,351.78
21404,UC8E98B,7,-509.22,5,2,716.22,207.0
21405,U45F07E,7,-1600.0,4,3,16390.0,14790.0
21406,U0B7A55,7,141.96999999999997,5,2,374.41,516.38
21407,U6CC098,7,-2434.0,7,0,2434.0,0.0
21408,UCD7D93,7,222.60000000000002,5,2,321.5,544.1
21409,UA3CB23,7,-0.0500000000001819,3,4,9217.46,9217.41
21410,U5E11CC,7,-273.4,4,3,430.4,157.0
21411,U65D554,7,26230.8,4,3,6421.5,32652.3
21412,UF23C51,7,-3652.69,6,1,3690.69,38.0
21413,UDFEEF5,7,-509.74,6,1,510.42,0.68
21414,U7DF5EA,7,-703.7399999999998,5,2,3110.0,2406.26
21415,U3C7946,7,-1739.3200000000002,5,2,2940.4700000000003,1201.15
21416,U73851F,7,-20713.7,4,3,21113.74,400.04
21417,UEA3147,7,-4990.99,4,3,12991.0,8000.01
21418,UADAD6A,7,49356.0,1,6,8560.0,57916.0
21419,U52EEF7,7,-37256.5,5,2,49356.5,12100.0
21420,UEA4DE6,7,-400.0,6,1,480.0,80.0
21421,U29A12A,7,6828.890000000001,4,3,4771.13,11600.02
21422,U0F631B,7,1.0,3,4,40999.0,41000.0
21423,U99AD84,7,-1348.4,3,4,1361.93,13.53
21424,U7CF10D,7,-1.0408340855860843e-17,6,1,0.060000000000000005,0.06
21425,U2554B7,7,-2667.0,5,2,6007.0,3340.0
21426,UBDEE96,7,3083.31,2,5,3083.34,6166.65
21427,U83D97A,7,1348.0,4,3,7552.0,8900.0
21428,UD871D0,7,1753.6199999999997,4,3,5000.0,6753.62
21429,UCA3675,7,-12.48999999999998,5,2,212.48999999999998,200.0
21430,U3E7EC0,7,-208.0,6,1,413.52000000000004,205.52
21431,UB403A2,7,3000.0,5,2,7465.5,10465.5
21432,U5AFD6D,7,-94.0,5,2,3874.0,3780.0
21433,UF4E54B,7,-32892.59,4,3,56700.0,23807.41
21434,U688093,7,2587.0000000000005,4,3,1671.02,4258.02
21435,UB28452,7,15613.0,6,1,30.0,15643.0
21436,U06AE8B,7,-1698.42,6,1,1700.42,2.0
21437,UF66861,7,5972.5599999999995,4,3,1727.4400000000003,7700.0
21438,UB5AEFD,7,925.0,4,3,11075.0,12000.0
21439,U41919B,7,-38872.0,5,2,69746.0,30874.0
21440,UBA9364,7,2199.11,5,2,3830.0,6029.110000000001
21441,U6691B2,7,2694.47,4,3,4963.0,7657.47
21442,U82D8EB,7,-1179.39,5,2,2196.13,1016.74
21443,UEA3F17,7,1329.0299999999997,4,3,1341.94,2670.9700000000003
21444,U8B94F0,7,-25.829999999999927,4,3,8816.0,8790.17
21445,UF31745,7,-1350.4000000000005,3,4,10132.09,8781.689999999999
21446,U0878AC,7,0.0,5,2,360.0,360.0
21447,U3567D3,7,-9431.74,5,2,12231.739999999998,2800.0
21448,UBA039D,7,10193.08,3,4,2510.0,12703.08
21449,U0ED3EE,7,4066.66,4,3,3933.34,8000.0
21450,U34085F,7,0.1399999999999727,4,3,501.55,501.69
21451,UBDA01E,7,0.0,5,2,2063.2,2063.2
21452,U3BDEF3,7,471.12,4,3,63.88,535.0
21453,U09096C,7,-7967.110000000001,4,3,17000.0,9032.89
21454,U71AE3E,7,44.0,4,3,19944.0,19988.0
21455,U011F6D,7,-3176.86,6,1,3176.9,0.04
21456,UB61F2D,7,34.51,4,3,82.69999999999999,117.21
21457,U04775A,7,12143.050000000003,4,3,7432.32,19575.370000000003
21458,U4649C0,7,-5623.0,5,2,6160.0,537.0
21459,U2E7C26,7,4600.27,2,5,4600.0,9200.27
21460,UC66A9D,7,3739.0,5,2,10006.0,13745.0
21461,UFC9305,7,216.32999999999998,4,3,160.8,377.13
21462,UFB4603,7,3.0,4,3,17997.0,18000.0
21463,U0E2062,7,-1298.8400000000001,5,2,2468.84,1170.0
21464,U120E80,7,97.90999999999997,5,2,237.29000000000002,335.2
21465,UFABA83,7,-40.0,5,2,4062.0,4022.0
21466,UF13134,7,5600.459999999999,2,5,5555.56,11156.02
21467,UB2D9E4,7,-0.8599999999997578,4,3,2166.43,2165.57
21468,U2C012D,7,4398.299999999999,5,2,5719.0,10117.3
21469,UBB669E,7,-120.39000000000014,4,3,2249.71,2129.3199999999997
21470,U29086E,7,-3.4500000000000455,4,3,579.0600000000001,575.61
21471,UE28AB6,7,-118.39,5,2,297.59000000000003,179.20000000000002
21472,UFB4A11,7,-887.4000000000001,5,2,3494.0,2606.6
21473,UD448D1,7,4548.98,5,2,9425.86,13974.84
21474,U8BA708,7,0.0,3,4,12000.0,12000.0
21475,UA0E958,7,3000.4300000000003,2,5,3000.0,6000.43
21476,U68F154,7,-2699.0,5,2,6900.0,4201.0
21477,U54A49A,7,4251.54,4,3,673.4599999999999,4925.0
21478,U669FBF,7,1195.02,5,2,2564.48,3759.5
21479,U9B51B2,7,148.0,6,1,1852.0,2000.0
21480,U51DE9D,7,23.749999999999773,4,3,6009.26,6033.01
21481,UF9F56B,7,292.67999999999995,4,3,2132.9,2425.58
21482,UF26608,7,5507.0,2,5,2693.0,8200.0
21483,U20674F,7,170.0,6,1,2410.0,2580.0
21484,U158850,7,1000.0000000000001,5,2,3949.0,4949.0
21485,U372139,7,0.0,4,3,325.0,325.0
21486,U2EDC09,7,14.999999999999993,3,4,166.9,181.9
21487,U909A6B,7,706.3100000000002,5,2,7912.69,8619.0
21488,UE70B89,7,6000.51,2,5,6093.74,12094.25
21489,UF960BF,7,3.5799999999999272,3,4,255000.0,255003.58
21490,U49014C,7,-4163.47,5,2,4188.4800000000005,25.01
21491,U3EA430,7,-1.02,6,1,1.05,0.03
21492,UF98CE5,7,-8060.59,5,2,8091.22,30.63
21493,UBA4CC6,7,-879.62,4,3,4006.46,3126.84
21494,U52A41B,7,3140.13,2,5,3160.28,6300.410000000001
21495,UF753C6,7,-419.41999999999996,7,0,419.41999999999996,0.0
21496,U0C561D,7,98.0,5,2,15750.0,15848.0
21497,UB0FE2E,7,-5769.37,5,2,13588.0,7818.63
21498,U68E6C9,7,0.6599999999999824,4,3,336.42,337.08
21499,U0E6972,7,-6.938893903907228e-18,6,1,0.060000000000000005,0.06
21500,U75C157,7,-2896.0,5,2,4284.0,1388.0
21501,UC01294,7,-2499.7599999999998,7,0,2499.7599999999998,0.0
21502,U294251,7,100.46000000000001,5,2,604.64,705.1
21503,U86D92F,7,0.010000000000218279,3,4,4000.01,4000.02
21504,UDEB510,7,550.0,6,1,2050.0,2600.0
21505,U09F20A,7,-6287.93,6,1,6290.400000000001,2.47
21506,U68A351,7,0.9099999999998545,3,4,26000.0,26000.91
21507,U634A2B,7,12598.01,3,4,3570.0,16168.01
21508,U386697,7,421.0,6,1,279.0,700.0
21509,UF1B593,7,7934.9,2,5,123.1,8058.0
21510,UD6FB4D,7,4600.0,3,4,238.0,4838.0
21511,U98D161,7,6383.05,4,3,1233.9,7616.95
21512,U714279,7,416.18,4,3,692.02,1108.2
21513,U1BF85B,7,19.52000000000021,4,3,2480.64,2500.16
21514,U7B4706,7,-2275.0300000000007,3,4,10175.03,7900.0
21515,UEAF7AB,7,1722.1000000000058,1,6,230000.0,231722.1
21516,U919730,7,-626.9399999999999,4,3,3317.1,2690.16
21517,U974A61,7,-46500.0,6,1,46620.0,120.0
21518,U9546C8,7,1520.0,4,3,2222.0,3742.0
21519,U0AFA56,7,782.28,3,4,5784.0,6566.28
21520,U28D115,7,67.59999999999985,6,1,1232.4,1300.0
21521,U626F19,7,2747.619999999999,5,2,14802.0,17549.62
21522,UDA013F,7,0.08999999999999964,4,3,14.250000000000002,14.34
21523,U440578,7,80738.05000000005,2,5,1400000.0,1480738.05
21524,UA42440,7,-0.020000000000209184,5,2,2144.6600000000003,2144.64
21525,U8E3E99,7,1065.0,3,4,8635.0,9700.0
21526,U4D0C2C,7,687.46,4,3,5314.54,6002.0
21527,U13F399,7,255.69000000000028,4,3,2004.01,2259.7000000000003
21528,UB486B1,7,-1132.2199999999998,6,1,2532.22,1400.0
21529,UE25699,7,80.32999999999998,5,2,720.0,800.3299999999999
21530,UCA9488,7,-1285.45,4,3,4486.400000000001,3200.95
21531,U27EDA0,7,188.54000000000002,4,3,361.46,550.0
21532,UB8AB85,7,1719.23,4,3,5435.799999999999,7155.030000000001
21533,U86638D,7,-130.99,5,2,616.79,485.8
21534,U6FAEFA,7,115.75,5,2,847.06,962.81
21535,U90BD5F,7,-2390.31,6,1,2655.9,265.59
21536,UE24C20,7,-181.94999999999982,5,2,4183.66,4001.71
21537,U979EB1,7,0.2600000000001046,4,3,2141.74,2142.0
21538,UFAF00E,7,-2489.0,4,3,15613.0,13124.0
21539,U2B976A,7,-172.99,4,3,293.0,120.01
21540,U6E22DF,7,-123.00000000000014,5,2,2467.6400000000003,2344.64
21541,UA45CE6,7,-1899.2200000000003,5,2,3399.2200000000003,1500.0
21542,U08EE66,7,102.55999999999949,2,5,4269.06,4371.62
21543,UB036DB,7,-2313.83,5,2,5145.4,2831.5699999999997
21544,UED7477,7,0.1599999999999966,4,3,890.16,890.3199999999999
21545,U92BE0F,7,154.43000000000006,6,1,1126.07,1280.5
21546,U4F6B1B,7,-1461.5,5,2,11530.0,10068.5
21547,UFBDC9B,7,1813.5299999999988,3,4,37287.9,39101.43
21548,U5196A2,7,0.0,3,4,1120.2,1120.2
21549,U1075D4,7,59.0,4,3,126.0,185.0
21550,UC5C288,7,205.81999999999996,3,4,152.3,358.12
21551,UCE99D2,7,8391.349999999999,2,5,12715.16,21106.510000000002
21552,UB4CB40,7,-9066.61,5,2,14066.61,5000.0
21553,U5220BE,7,387.3800000000001,4,3,9200.0,9587.380000000001
21554,U5FA94A,7,-3672.67,5,2,4242.4,569.73
21555,U88A96A,7,-297.2899999999999,7,0,297.2899999999999,0.0
21556,U48AE0D,7,45.690000000000055,4,3,1824.32,1870.01
21557,U5D857A,7,2650.0,5,2,2250.0,4900.0
21558,UF5A70C,7,53.200000000000045,5,2,1182.8,1236.0
21559,UEE3F1D,7,-1965.0,5,2,2095.0,130.0
21560,UF7B915,7,2434.9300000000003,3,4,8705.07,11140.0
21561,U472D08,7,136.98000000000002,4,3,102.75999999999999,239.74
21562,UF2ED35,7,13686.31,4,3,2627.38,16313.69
21563,UCD7991,7,1808.3400000000001,4,3,5211.66,7020.0
21564,UCDBBF1,7,882.77,3,4,879.0,1761.77
21565,U420661,7,0.0,5,2,6000.0,6000.0
21566,U234FF9,7,-24.000000000000014,6,1,330.39,306.39
21567,U9F5892,7,4840.0,2,5,7352.0,12192.0
21568,U43318F,7,71.0,4,3,5919.0,5990.0
21569,UB36BD5,7,830.0,5,2,3361.16,4191.16
21570,UFCFA53,7,-14902.23,6,1,14906.9,4.67
21571,U66C05F,7,-1613.3,4,3,1723.3,110.0
21572,U3E49F5,7,4568.0,3,4,70770.0,75338.0
21573,U15004D,7,129.0,5,2,871.0,1000.0
21574,UD8B57F,7,-2962.96,4,3,7020.0,4057.04
21575,U08F834,7,-690.1000000000004,5,2,7872.5,7182.4
21576,U0AED49,7,0.0,5,2,102.52,102.52000000000001
21577,U7D8082,7,-1386.32,5,2,2300.32,914.0
21578,U0D8A52,7,-865.76,5,2,3109.4799999999996,2243.7200000000003
21579,U299A3F,7,-1089.15,7,0,1089.15,0.0
21580,U32096B,7,-403.22,6,1,803.22,400.0
21581,U9C5A77,7,-110.57,6,1,111.0,0.43
21582,U5C0C72,7,3128.0,3,4,10772.0,13900.0
21583,U737637,7,-854.8299999999999,5,2,904.92,50.09
21584,UA15970,7,-1609.0,3,4,17751.0,16142.0
21585,U3B6DA5,7,358.0,5,2,2633.0,2991.0
21586,U84F2EB,7,-570.7600000000001,5,2,997.0999999999999,426.34
21587,U8B607F,7,1897.0,5,2,2603.0,4500.0
21588,U23B1E3,7,744.0,6,1,284.85999999999996,1028.86
21589,U2C538F,7,-2.83,4,3,4.0,1.17
21590,U32B2E4,7,2854.1800000000003,4,3,2725.8199999999997,5580.0
21591,UC65C61,7,1653.9,4,3,870.6,2524.5
21592,U0DACC8,7,7.490000000000009,4,3,2292.5099999999998,2300.0
21593,U49F24D,7,-25.260000000000176,4,3,2356.26,2331.0
21594,U6E02D3,7,67.71999999999997,4,3,430.70000000000005,498.42
21595,U5CCBB2,7,-6.0,4,3,8005.0,7999.0
21596,UAB110F,7,3980.0,4,3,4390.0,8370.0
21597,U408C57,7,-33.39999999999999,4,3,613.41,580.01
21598,UBC5680,7,26900.0,0,7,0.0,26900.0
21599,U791113,7,-3451.38,5,2,6579.42,3128.04
21600,U24FB2C,7,3957.7999999999993,0,7,0.0,3957.7999999999993
21601,U099B33,7,103.51999999999998,6,1,796.48,900.0
21602,U82CA6B,7,7701.77,2,5,5166.68,12868.45
21603,U67D6F8,7,-465.2999999999993,5,2,15920.0,15454.7
21604,UF44673,7,-1.0408340855860843e-17,6,1,0.060000000000000005,0.06
21605,UB24C76,7,0.0,4,3,3079.0,3079.0
21606,U6DAA15,7,0.0,2,5,40800.0,40800.0
21607,U590702,7,-745.8899999999999,4,3,2346.5,1600.6100000000001
21608,U7F76EF,7,-241.0,5,2,10171.0,9930.0
21609,U640109,7,195.27999999999997,4,3,389.72,585.0
21610,UEDBD70,7,6789.01,2,5,1220.0,8009.01
21611,UC273CC,7,-101.0,3,4,29550.0,29449.0
21612,U40D13D,7,-1100.0,5,2,8760.0,7660.0
21613,U5878EE,7,-59.47999999999999,4,3,283.02,223.54
21614,UA6EB21,7,8700.0,2,5,2300.0,11000.0
21615,U425E7C,7,4117.41,4,3,422.59000000000003,4540.0
21616,U11DA2E,7,-9.999999999999927,5,2,10013.42,10003.42
21617,UB9365E,7,6281.16,5,2,28.84,6310.0
21618,UF20297,7,-414.03999999999996,5,2,573.96,159.92
21619,U84ED07,7,271.49999999999983,4,3,3564.0,3835.5
21620,UDD18DB,7,1072.55,5,2,387.5,1460.05
21621,U006ADD,7,3.552713678800501e-15,5,2,507.12,507.12
21622,U670B60,7,24966.260000000002,1,6,21988.0,46954.26
21623,UE6DFDA,7,-3162.4300000000003,1,6,5729.0,2566.5699999999997
21624,UFD9F84,7,4100.15,2,5,4166.74,8266.89
21625,UF3CC78,7,-50.059999999999995,7,0,50.059999999999995,0.0
21626,UF56D13,7,0.0,4,3,24600.36,24600.36
21627,UAB6C6E,7,7953.93,3,4,4213.29,12167.220000000001
21628,U8B5806,7,380.0100000000002,4,3,3620.0,4000.01
21629,U9065ED,7,-5.204170427930421e-18,6,1,0.060000000000000005,0.06
21630,UAEAFE7,7,-7.099999999998545,4,3,100006.0,99998.9
21631,U43ADAD,7,-12002.11,5,2,42525.0,30522.89
21632,UC98E70,7,90.0,6,1,3910.0,4000.0
21633,U0F2ACD,7,13698.08,4,3,2647.92,16346.0
21634,UD640EF,7,-1341.7,6,1,1741.7,400.0
21635,U34A8F5,7,-1808.1200000000003,2,5,3244.1200000000003,1436.0
21636,U79A4F6,7,0.3300000000004366,5,2,19999.999999999996,20000.33
21637,UF45094,7,-3383.68,6,1,3385.0,1.32
21638,UD6D0F6,7,3985.9100000000003,4,3,4024.7799999999997,8010.6900000000005
21639,U78CAB2,7,10.460000000000036,3,4,9500.0,9510.46
21640,UE414B5,7,-10.0,6,1,20010.0,20000.0
21641,UB4E6E6,7,20175.96,4,3,15548.0,35723.96
21642,U6B907E,7,-1037.0,5,2,1047.0,10.0
21643,U10D97E,7,2734.68,4,3,528.64,3263.32
21644,U370544,7,-23.69999999999927,6,1,16023.699999999999,16000.0
21645,UAEA730,7,123.97000000000116,4,3,15812.01,15935.980000000001
21646,U43ABC0,7,-1224.3799999999997,5,2,2453.38,1229.0
21647,U84C4FB,7,-94.0,4,3,3679.0,3585.0
21648,UF53512,7,-19122.5,5,2,19622.5,500.0
21649,UDE0C74,7,-2241.67,5,2,2521.62,279.95
21650,UDE26E6,7,-19.97,6,1,20.0,0.03
21651,U3EBBB0,7,0.03999999999996362,3,4,10200.0,10200.04
21652,U0A3728,7,-54.98999999999978,5,2,7783.889999999999,7728.9
21653,UCA6419,7,-229.0,4,3,8718.0,8489.0
21654,U1AEABB,7,-375.33,4,3,756.66,381.33
21655,UFB03C3,7,984.05,4,3,615.95,1600.0
21656,U21FED0,7,-4999.88,5,2,11010.0,6010.12
21657,U67C87F,7,19006.160000000003,2,5,34986.12,53992.280000000006
21658,U53B180,7,25.0,4,3,9975.0,10000.0
21659,U5B5DD0,7,-142.24,6,1,171.17000000000002,28.93
21660,U1566DA,7,928.8100000000002,4,3,7800.0,8728.81
21661,UB17CF6,7,-741.3800000000002,4,3,13443.82,12702.439999999999
21662,U8EB2DD,7,6028.200000000001,4,3,559.8000000000001,6588.0
21663,U3B7A49,7,-576.7999999999993,2,5,11179.98,10603.18
21664,UFED528,7,-10.0,4,3,6870.0,6860.0
21665,U01C5F5,7,7490.25,2,5,7488.88,14979.130000000001
21666,U7ED5DA,7,-7938.08,6,1,7938.11,0.03
21667,U1D0DEE,7,-0.6500000000026205,5,2,17374.54,17373.89
21668,UE8F7B7,7,0.0,5,2,2740.0,2740.0
21669,U0990EA,7,0.0,6,1,60.0,60.0
21670,UE3FE41,7,4.529999999999973,3,4,2180.96,2185.49
21671,U828A2D,7,-3.110000000000582,2,5,15890.0,15886.89
21672,UEF699F,7,2725.57,4,3,526.86,3252.43
21673,U111291,7,-1440.4,5,2,2660.4,1220.0
21674,U4E4FEE,7,3660.04,4,3,5439.96,9100.0
21675,U9361CE,7,8814.52,1,6,9820.0,18634.52
21676,U223A6A,7,182.0,3,4,1118.0,1300.0
21677,U341A0B,7,132.88,4,3,577.12,710.0
21678,U2C6B9E,7,-2039.08,7,0,2039.08,0.0
21679,U316577,7,-26504.0,6,1,26528.0,24.0
21680,UAA0DA2,7,-719.9499999999998,4,3,3030.0,2310.05
21681,U1F4665,7,14.119999999999997,3,4,57.9,72.02000000000001
21682,U237184,7,3634.0,4,3,7266.66,10900.66
21683,U6ADF14,7,650.22,6,1,154.78,805.0
21684,U803E4D,7,-645.0,5,2,3305.0,2660.0
21685,UEDDA6C,7,3987.5200000000004,3,4,3577.87,7565.389999999999
21686,U681E49,7,1362.0,5,2,15298.0,16660.0
21687,U12F78A,7,-4630.0,5,2,17720.0,13090.0
21688,U30FA3F,7,6000.0,5,2,25572.0,31572.0
21689,U64228F,7,-674.8199999999999,6,1,675.8199999999999,1.0
21690,UF106CA,7,90.76999999999998,4,3,709.04,799.81
21691,UC8813F,7,3000.0,4,3,7000.0,10000.0
21692,U94AD80,7,1374.77,2,5,1297.0,2671.77
21693,U3D02FC,7,3000.1100000000006,2,5,2916.66,5916.77
21694,U6452E3,7,852.5100000000004,5,2,6047.91,6900.42
21695,UFBFD6C,7,9129.24,1,6,5000.0,14129.24
21696,U75DCE4,7,1611.15,2,5,189.0,1800.15
21697,U3B5B8F,7,26.580000000000013,5,2,182.04000000000002,208.62
21698,U5F2BEF,7,-1881.73,4,3,4031.74,2150.01
21699,UC534BD,7,678.79,2,5,169.34,848.13
21700,U96E8BC,7,-6053.33,5,2,6053.35,0.02
21701,U51C35C,7,-59.5,4,3,1353.0,1293.5
21702,UF9C7B2,7,1.9899999999999984,3,4,29.03,31.02
21703,UF82C41,7,691.0,4,3,3040.0,3731.0
21704,U017964,7,121.0,4,3,929.0,1050.0
21705,U4BE053,7,6721.0,3,4,19888.0,26609.0
21706,U2A7C84,7,-14.990000000000009,3,4,2185.0,2170.01
21707,U67687F,7,9125.07,1,6,3395.0,12520.07
21708,U92A1FC,7,-5.499999999999453,5,2,7355.599999999999,7350.1
21709,UD88886,7,16762.4,4,3,3237.6000000000004,20000.0
21710,UF81358,7,221.0,4,3,9979.0,10200.0
21711,UA4FB0F,7,2319.95,4,3,2207.65,4527.599999999999
21712,UF4CC0C,7,269.03,3,4,9810.0,10079.03
21713,U52BA0F,7,356.61999999999995,4,3,511.5,868.1199999999999
21714,UD491DA,7,-746.7399999999999,6,1,1003.7399999999999,257.0
21715,U451985,7,-997.5200000000001,7,0,997.5200000000001,0.0
21716,U169B21,7,490.0,4,3,3710.0,4200.0
21717,U732376,7,62.0,2,5,23949.0,24011.0
21718,U8A4699,7,-187.53,6,1,670.77,483.24
21719,UB10C6D,7,-3776.61,4,3,3933.34,156.73
21720,UE54A1D,7,15505.899999999998,4,3,15065.359999999999,30571.260000000002
21721,U275C9F,7,453.82000000000005,4,3,336.57,790.39
21722,U956BB4,7,-2028.82,5,2,6570.17,4541.35
21723,UF27F96,7,0.0,3,4,12460.0,12460.0
21724,UE001B7,7,100000.05,2,5,32.0,100032.05
21725,U738386,7,-156.06,4,3,317.61,161.55
21726,UD2780F,7,238.64,6,1,61.36,300.0
21727,U6EDAD7,7,-9817.0,5,2,16717.0,6900.0
21728,U0035E2,7,56.58000000000001,6,1,73.42,130.0
21729,U8B8FBB,7,-1449.0,5,2,4412.34,2963.34
21730,U90A07C,7,-3228.4399999999996,6,1,3228.45,0.01
21731,UB85719,7,-3.552713678800501e-15,6,1,59.900000000000006,59.9
21732,U865427,7,-468.9599999999991,5,2,12528.96,12060.0
21733,U339075,7,249.83999999999997,4,3,155.67000000000002,405.51
21734,UD45E68,7,597.0,4,3,5343.0,5940.0
21735,UF6EA1E,7,0.0,6,1,6.0,6.0
21736,UBBDBCB,7,65.97999999999996,5,2,757.62,823.5999999999999
21737,U62A6DC,7,46.22,5,2,488.43,534.65
21738,U278B12,7,4435.0,0,7,0.0,4435.0
21739,U95C1D1,7,-1446.98,6,1,1509.25,62.27
21740,UA05472,7,-11.3900000000001,5,2,1510.0,1498.61
21741,U66FFB0,7,-3279.999999999999,5,2,5907.379999999999,2627.38
21742,U55DAD8,7,234.7899999999998,5,2,1923.2,2157.99
21743,U45828E,7,-2643.98,5,2,2644.1,0.12
21744,UFD9F9E,7,277.3299999999999,5,2,2119.79,2397.12
21745,U9C3161,7,153.8800000000001,3,4,5918.12,6072.0
21746,U5AD17A,7,-14894.6,5,2,29697.6,14803.0
21747,U8AE422,7,-9.639999999999986,5,2,649.65,640.01
21748,UB3998D,7,-695.1600000000001,5,2,2262.42,1567.26
21749,UA057B6,7,-1.110000000000241,4,3,5753.0,5751.889999999999
21750,UCC5837,7,-1.0000000000005822,3,4,65302.61,65301.61
21751,U31AF3D,7,169.41,3,4,2611.7400000000002,2781.15
21752,U7E6230,7,16.220000000000027,3,4,51930.0,51946.22
21753,U52AEF0,7,5642.33,2,5,5634.66,11276.99
21754,UCD8345,7,1976.0700000000002,3,4,4994.57,6970.64
21755,U00ED13,7,0.0,4,3,265.0,265.0
21756,UF6537B,7,-2.950000000000003,4,3,189.66,186.70999999999998
21757,U0CC05F,7,708.82,2,5,1402.01,2110.83
21758,UE4664E,7,-4680.5,4,3,10000.0,5319.5
21759,UD8E2CA,7,17366.699999999997,1,6,2200.0,19566.699999999997
21760,U000CDC,7,-3036.9600000000005,4,3,3328.96,292.0
21761,U7537A1,7,653.0600000000001,3,4,4952.68,5605.74
21762,U4EC17B,7,-73452.20999999999,6,1,74936.20999999999,1484.0
21763,U3B56FC,7,-229.9399999999999,4,3,2029.9399999999998,1800.0
21764,UD6E56F,7,-40.619999999999976,5,2,501.52,460.90000000000003
21765,UBFA81F,7,-1783.0,5,2,2602.0,819.0
21766,UBFEBA1,7,218.97000000000003,1,6,2000.0,2218.9700000000003
21767,UD1A10A,7,15.3100000000004,4,3,2634.0,2649.3100000000004
21768,U40B7B2,7,149.89999999999964,3,4,4010.0,4159.9
21769,U69B845,7,-78.9,6,1,192.78,113.88
21770,UEF2CF3,7,-9.299999999999997,5,2,4009.3,4000.0
21771,UA1C928,7,-5881.36,6,1,8763.7,2882.34
21772,U525CA9,7,230.73999999999995,6,1,380.00000000000006,610.74
21773,UFA73F1,7,-1258.6000000000013,5,2,24589.9,23331.3
21774,UC75E1F,7,-202.0,5,2,953.37,751.37
21775,U55A409,7,-1727.44,6,1,4997.4400000000005,3270.0
21776,U007045,7,3328.0200000000004,2,5,3333.34,6661.360000000001
21777,U4249E2,7,-0.5499999999999545,5,2,2001.01,2000.46
21778,U93AD0A,7,5.0,6,1,1423.0,1428.0
21779,UE27EDF,7,830.94,4,3,1096.94,1927.88
21780,UE37DDE,7,-805.9200000000001,6,1,1810.7,1004.78
21781,UE97B3E,7,-9651.34,5,2,29219.0,19567.66
21782,U1608EE,7,-6496.0,5,2,37946.0,31450.0
21783,UFFE822,7,557.4499999999998,4,3,8736.0,9293.45
21784,U9AC1CD,7,-5.07,5,2,15.09,10.02
21785,U019B42,7,-742.5700000000002,6,1,742.6300000000001,0.06
21786,U809F0D,7,-414.08000000000004,5,2,1278.52,864.4399999999999
21787,UFA9869,7,-722.25,6,1,1522.25,800.0
21788,U6DD02C,7,68220.0,2,5,4260.0,72480.0
21789,UE9E1BD,7,-2799.99,5,2,8100.0,5300.01
21790,UFDB346,7,68.59999999999995,5,2,576.0200000000001,644.62
21791,U85C9B4,7,17.929999999999836,4,3,12985.0,13002.93
21792,U8FD095,7,463.01,3,4,1163.99,1627.0
21793,U767BA7,7,1377.0,3,4,4387.0,5764.0
21794,UD676D9,7,25.04000000000003,4,3,363.34,388.38
21795,U65DD15,7,10001.23,2,5,8788.9,18790.129999999997
21796,UAC15C4,7,-515.51,5,2,1070.52,555.01
21797,U7F48B1,7,607.5500000000002,3,4,12393.119999999999,13000.67
21798,UBD3C46,7,8566.0,4,3,89.0,8655.0
21799,UC8E172,7,-1955.0,5,2,4435.0,2480.0
21800,U8F556A,7,0.0,3,4,16000.0,16000.0
21801,U9253DD,7,93.08,4,3,539.5999999999999,632.6800000000001
21802,U252368,7,-2149.74,5,2,3583.74,1434.0
21803,UE4DF94,7,12.799999999999983,4,3,153.12,165.92
21804,U8558E4,7,-4949.67,3,4,9950.0,5000.33
21805,U2FADC1,7,3547.86,2,5,3412.83,6960.6900000000005
21806,U4FE567,7,37.52,4,3,10508.39,10545.91
21807,U6F16D2,7,1.9,3,4,92.6,94.5
21808,UFD71BF,7,164.46000000000004,4,3,11967.54,12132.0
21809,U8B4862,7,-235.8,6,1,705.8,470.0
21810,UACE06D,7,5600.280000000001,2,5,5555.56,11155.840000000002
21811,UEBA87D,7,-42.90000000000022,6,1,8925.369999999999,8882.47
21812,U2D4F58,7,-4233.0,6,1,4954.0,721.0
21813,UE08804,7,4777.02,4,3,1092.98,5870.0
21814,UFC30CE,7,731.0600000000003,4,3,2048.69,2779.75
21815,UC2DF4D,7,-12450.32,4,3,12506.0,55.68
21816,U0F98BA,7,64.08999999999992,4,3,3285.0,3349.09
21817,U563953,7,-92.06,6,1,984.65,892.59
21818,UF2EEB1,7,1389.22,3,4,2.01,1391.23
21819,UD248E7,7,-3945.7799999999997,4,3,12128.17,8182.39
21820,U0C2839,7,3026.3500000000004,4,3,9063.070000000002,12089.42
21821,U68BDA2,7,0.039999999999054126,3,4,17489.56,17489.6
21822,U7BCF8D,7,-356.53999999999996,6,1,711.54,355.0
21823,U56F55B,7,21691.739999999998,2,5,508.26,22200.0
21824,U637CBB,7,4746.0,0,7,0.0,4746.0
21825,U980260,7,-1029.27,6,1,1233.27,204.0
21826,U04A172,7,-374.52,4,3,3278.96,2904.44
21827,UBBDC49,7,-1129.0,7,0,1129.0,0.0
21828,UEDC6DC,7,-218.5699999999997,5,2,5219.0,5000.43
21829,UB2FE1F,7,1248.2200000000003,5,2,1556.78,2805.0
21830,UF28BBE,7,0.0,6,1,60.0,60.0
21831,UD4461D,7,640.0,4,3,1620.0,2260.0
21832,U8533E9,7,-1080.0,5,2,2063.02,983.02
21833,U59B024,7,1081.3,5,2,1478.59,2559.8900000000003
21834,U66333E,7,-768.9899999999998,2,5,9754.9,8985.91
21835,U2F7235,7,4516.27,2,5,1010.84,5527.110000000001
21836,UA67056,7,2631.0,2,5,5266.0,7897.0
21837,U2B2E19,7,-13.81,5,2,2013.8100000000002,2000.0
21838,UBE0CD4,7,2270.83,4,3,4541.66,6812.49
21839,UB1F602,7,-269.17,5,2,492.0,222.82999999999998
21840,UFF25DD,7,-295.78,6,1,1044.73,748.95
21841,U00239F,7,-6475.150000000001,5,2,6475.860000000001,0.7100000000000001
21842,UDAC6F7,7,21839.17,4,3,11070.0,32909.17
21843,U943F6A,7,124.0,5,2,3376.0,3500.0
21844,UEC185A,7,1423.6599999999999,4,3,899.34,2323.0
21845,U97266E,7,-0.020000000000010232,4,3,234.11,234.09000000000003
21846,UBECABD,7,-2290.13,5,2,5489.56,3199.4300000000003
21847,U00EBD3,7,27443.25,3,4,2980.63,30423.88
21848,U848410,7,-291.1899999999996,3,4,8760.0,8468.810000000001
21849,U507FB9,7,143.73000000000002,6,1,456.27,600.0
21850,UF432DB,7,-1960.0,4,3,8720.0,6760.0
21851,UFEE45D,7,-9804.0,5,2,15798.0,5994.0
21852,UA13C6C,7,6.0,5,2,7783.0,7789.0
21853,U1DB9B9,7,2416.67,4,3,688.34,3105.01
21854,UBE05E2,7,-23919.37,4,3,48930.0,25010.629999999997
21855,U5DF3B8,7,-6609.8,5,2,13968.8,7359.0
21856,U4597D5,7,-19.5,5,2,182.5,163.0
21857,U5C422A,7,1105.4300000000003,5,2,1707.5699999999997,2813.0
21858,UBB69D4,7,5060.01,2,5,5056.44,10116.45
21859,U0BD2FA,7,4288.24,2,5,4333.3,8621.54
21860,UBE4550,7,-661.6800000000003,4,3,3392.6800000000003,2731.0
21861,U19E769,7,128.64,4,3,1063.36,1192.0
21862,U4B45FB,7,9.0,4,3,19411.0,19420.0
21863,UE15EBD,7,-1500.0,4,3,5538.2,4038.2
21864,U935C9D,7,-221.47999999999993,7,0,221.47999999999993,0.0
21865,UB07EA5,7,14724.52,5,2,921.48,15646.0
21866,UF331EE,7,-1720.0,3,4,30440.0,28720.0
21867,UAD5772,7,20000.67,2,5,20000.0,40000.67
21868,U7BC843,7,120.0,4,3,826.0,946.0
21869,U3AB5BB,7,7.009999999998399,3,4,45003.0,45010.009999999995
21870,UE0D174,7,-1407.1699999999998,5,2,1516.35,109.17999999999999
21871,U132490,7,-322.7,6,1,476.2,153.5
21872,U5C94D8,7,4840.48,2,5,4833.34,9673.82
21873,U65711F,7,588.0,4,3,257.9,845.9
21874,U364493,7,-17565.9,5,2,53464.9,35899.0
21875,U01339D,7,6392.11,4,3,1215.78,7607.89
21876,U8CD040,7,-0.05999999999999872,4,3,295.18,295.12
21877,U0C4F2F,7,150.0,4,3,1170.0,1320.0
21878,UB35D61,7,619.3999999999996,3,4,9945.220000000001,10564.619999999999
21879,UE0698A,7,-2226.48,6,1,2726.48,500.0
21880,U91568F,7,-114.56999999999994,5,2,1001.97,887.4
21881,U2C90CF,7,12897.7,4,3,2489.8,15387.5
21882,U55E79B,7,264.12000000000035,4,3,11500.0,11764.119999999999
21883,UDA6537,7,-57.43000000000001,6,1,57.580000000000005,0.15
21884,U5CED4F,7,-42217.4,1,6,50000.0,7782.6
21885,U3F02F8,7,-8358.900000000001,4,3,40710.9,32352.0
21886,UFAC2FC,7,-93011.79,3,4,96054.0,3042.21
21887,UDA2F52,7,3324.2000000000003,4,3,6577.12,9901.32
21888,UDF6498,7,125.87,4,3,0.13,126.0
21889,U0A074F,7,80.88999999999999,6,1,416.12,497.01
21890,U502454,7,-3587.0,3,4,5836.0,2249.0
21891,UB3B9E8,7,-523.5100000000001,4,3,2619.43,2095.92
21892,U3A8B33,7,309.5,4,3,2390.5,2700.0
21893,UC97C25,7,-125.80000000000001,6,1,219.8,94.0
21894,U4938FE,7,-14199.689999999999,4,3,19864.21,5664.5199999999995
21895,U69F377,7,-1670.9299999999998,5,2,5670.929999999999,4000.0
21896,U26E601,7,5.684341886080802e-14,5,2,1357.0,1357.0
21897,U116ABB,7,-5050.640000000001,6,1,9727.970000000001,4677.33
21898,U50BD7D,7,0.930000000000291,2,5,100000.0,100000.93
21899,U08A20F,7,54500.0,0,7,0.0,54500.0
21900,UF1F646,7,986.0,4,3,1096.8600000000001,2082.8599999999997
21901,UCC78E9,7,-1250.74,5,2,20250.739999999998,19000.0
21902,U4A50E0,7,125.0,4,3,15005.0,15130.0
21903,U1238AC,7,1565.93,2,5,2383.59,3949.5199999999995
21904,U0B574E,7,1204.65,5,2,1520.0,2724.65
21905,U423C92,7,-999.0,4,3,5999.0,5000.0
21906,U682FE0,7,-2681.4900000000007,5,2,2731.5,50.01
21907,U155F1B,7,6409.219999999999,4,3,1239.18,7648.4
21908,U881FAF,7,-63.08000000000001,5,2,250.05,186.97
21909,U6BD410,7,19511.60999999997,3,4,460000.0,479511.61
21910,U6EA52C,7,-105.0,6,1,293.66,188.66
21911,UFB3A11,7,-2590.0,5,2,4590.0,2000.0
21912,U0C8686,7,3146.5700000000006,4,3,780.91,3927.48
21913,UCA4E5C,7,94.43,3,4,33.6,128.03
21914,UC4329D,7,339.0499999999993,4,3,11903.0,12242.05
21915,U080FDF,7,-80.75999999999999,6,1,540.76,460.0
21916,U289098,7,969.48,5,2,678.86,1648.34
21917,U74D00C,7,336.0,3,4,78310.0,78646.0
21918,U61B76B,7,270.52,2,5,7676.76,7947.280000000001
21919,U876A6D,7,-45.19,3,4,816.0,770.81
21920,U98E363,7,1.1368683772161603e-12,4,3,36473.84,36473.84
21921,U731576,7,0.6599999999998545,4,3,1201.2,1201.86
21922,U678017,7,940.7,4,3,122.22,1062.92
21923,U8E954B,7,-56.41000000000001,5,2,209.91,153.5
21924,U841B98,7,4669.030000000001,2,5,4666.66,9335.69
21925,U9B7F29,7,-84.37000000000002,5,2,169.00000000000003,84.63
21926,U21005D,7,5442.08,4,3,3001.59,8443.67
21927,UF023B2,7,41.890000000000015,6,1,345.12,387.01
21928,UDD44DD,7,-4671.0,7,0,4671.0,0.0
21929,UC1686D,7,684.3399999999999,6,1,5471.66,6156.0
21930,U201E83,7,2245.9000000000005,5,2,1817.8799999999999,4063.78
21931,UA2755A,7,-2790.8499999999976,2,5,20420.0,17629.15
21932,U69425C,7,-165.03999999999996,5,2,1705.04,1540.0
21933,UB3308D,7,-500.05999999999995,7,0,500.05999999999995,0.0
21934,UD0DFD9,7,4742.16,4,3,1200.0,5942.16
21935,U6F5089,7,0.2100000000001785,5,2,1690.4299999999998,1690.6399999999999
21936,U8779C0,7,23328.36,2,5,70048.98,93377.34
21937,UA47A6C,7,2.9999999999995453,5,2,7598.9,7601.9
21938,U3C7A94,7,-1818.0,5,2,2671.42,853.42
21939,UEEB1A2,7,-8720.650000000001,3,4,45910.0,37189.35
21940,U9D5B93,7,12553.809999999998,5,2,9446.190000000002,22000.0
21941,U168FE6,7,3000.0,4,3,18000.0,21000.0
21942,UE8B553,7,2.0399999999999636,5,2,3647.96,3650.0
21943,U2ED5C2,7,21.54999999999995,4,3,994.88,1016.43
21944,U5A1BDB,7,0.0,6,1,3872.0,3872.0
21945,U9CBA1A,7,396.0899999999996,4,3,5758.41,6154.5
21946,UB9CE87,7,-7.105427357601002e-15,5,2,1112.62,1112.62
21947,U9B7C1F,7,126.80000000000001,6,1,145.2,272.0
21948,UAA6659,7,2182.7,4,3,16670.379999999997,18853.08
21949,U670393,7,453.3199999999998,4,3,3523.0699999999997,3976.39
21950,U58CA1F,7,-1016.3299999999999,5,2,1016.8299999999999,0.5
21951,UBB00CF,7,0.0,5,2,30000.0,30000.0
21952,UD779D7,7,-6527.0,2,5,13427.0,6900.0
21953,UF4FC7C,7,-1119.79,4,3,50480.0,49360.21
21954,UCDFC91,7,-472.419999999991,1,6,90000.0,89527.58
21955,UD2B279,7,648.0,5,2,352.0,1000.0
21956,U6B0D2C,7,415.69999999999897,3,4,9565.0,9980.699999999999
21957,U70B4EA,7,9847.45,3,4,5330.0,15177.45
21958,UA6AAD2,7,8702.46,2,5,8702.0,17404.46
21959,UE0EBF9,7,-168.60999999999999,6,1,168.78,0.17
21960,U54A3AE,7,89.42999999999999,2,5,280.57,370.0
21961,U91322D,7,-3.552713678800501e-14,5,2,608.9200000000001,608.92
21962,U62BB49,7,0.0,3,4,29000.0,29000.0
21963,UD20B86,7,-1019.55,5,2,22141.0,21121.45
21964,UE22F80,7,9410.380000000001,4,3,10770.0,20180.38
21965,U3F299E,7,-1.1368683772161603e-13,4,3,1057.62,1057.62
21966,UFEBAB2,7,8402.91,2,5,8333.34,16736.25
21967,UECF665,7,-257.2,6,1,683.9,426.7
21968,U6EAB10,7,6050.0,4,3,23130.0,29180.0
21969,UD42138,7,-2762.0,4,3,7035.0,4273.0
21970,U99581A,7,320.079999999999,3,4,11790.189999999999,12110.27
21971,UDCC15D,7,150.10000000000002,5,2,49.900000000000006,200.0
21972,U0162CF,7,40830.89,4,3,4782.16,45613.05
21973,U3F5F8A,7,-10030.0,5,2,10149.9,119.9
21974,U189339,7,5628.139999999999,4,3,1285.59,6913.73
21975,U10A811,7,-1.0,3,4,6000.0,5999.0
21976,U82F22D,7,829.6700000000001,3,4,8524.0,9353.67
21977,U1C721D,7,3022.21,5,2,2669.6,5691.8099999999995
21978,U3C454B,7,8.020000000000437,3,4,4973.0,4981.02
21979,U2037CD,7,3274.2899999999995,4,3,20726.6,24000.89
21980,UD2566B,7,278.0,5,2,922.0,1200.0
21981,UF850AC,7,1000.0,5,2,13787.0,14787.0
21982,U9A051A,7,-11922.3,6,1,11922.33,0.03
21983,UDBED5F,7,0.8300000000017462,3,4,100125.1,100125.93000000001
21984,U8AE8D3,7,-235.72000000000003,4,3,2407.73,2172.01
21985,UC37110,7,991.0,4,3,1809.0,2800.0
21986,U377471,7,-11.0,3,4,8943.0,8932.0
21987,U260A8B,7,-123.24,6,1,125.24,2.0
21988,UFE1EFD,7,78.6099999999999,3,4,8821.4,8900.01
21989,U3939C9,7,-4.44,7,0,4.44,0.0
21990,U8BF818,7,1114.4,4,3,1785.6,2900.0
21991,U2505AB,7,899.4099999999999,5,2,1348.06,2247.4700000000003
21992,U8BEC29,7,106.19,5,2,207.0,313.19
21993,U23ADB8,7,2.0,4,3,268.0,270.0
21994,UD94DF3,7,42.55999999999949,3,4,29377.440000000002,29420.0
21995,U905457,7,-3473.72,6,1,3475.1299999999997,1.41
21996,U871B37,7,0.06999999999970896,4,3,29150.0,29150.07
21997,UADB5E6,7,134.3199999999997,5,2,13006.0,13140.32
21998,UFE6471,7,103.82000000000005,5,2,690.9,794.72
21999,UB6DCBA,7,-3247.0,5,2,14436.0,11189.0
22000,UE8C9A1,7,5783.9,5,2,1429.1,7213.0
22001,UE4D675,7,2190.36,5,2,44813.0,47003.36
22002,U3BAEC9,7,-11.86,5,2,132.0,120.14
22003,U0662E7,7,-4453.41,5,2,16048.58,11595.17
22004,UD972A8,7,4850.16,2,5,4833.34,9683.5
22005,UC49883,7,2991.3199999999997,4,3,960.99,3952.31
22006,U55899B,7,-4907.5,3,4,31138.5,26231.0
22007,UEC16F6,7,-614.3,6,1,637.53,23.23
22008,U8DC44D,7,259.4899999999998,1,6,12909.0,13168.49
22009,UB18B80,7,-6.650000000000006,5,2,209.0,202.35
22010,U25F4F3,7,2.0,4,3,9598.0,9600.0
22011,U658A84,7,919.6699999999998,5,2,859.6999999999999,1779.37
22012,U1289EC,7,428.48,5,2,71.52,500.0
22013,U4E7560,7,2475.96,3,4,5326.75,7802.71
22014,U6C90AC,7,2738.5600000000004,4,3,526.78,3265.34
22015,UFB96E7,7,-280.0,5,2,21200.0,20920.0
22016,U768EE0,7,95.67999999999995,5,2,2355.33,2451.01
22017,UF0F00C,7,1052.0,4,3,19097.0,20149.0
22018,UE269A1,7,187.42000000000007,5,2,10808.95,10996.37
22019,U369C8C,7,667.5799999999989,4,3,8832.42,9500.0
22020,U95A4B4,7,3979.9999999999995,4,3,1359.04,5339.04
22021,UBA44F6,7,25.0,4,3,391.0,416.0
22022,UAB498F,7,-3310.8,6,1,4823.599999999999,1512.8
22023,U39D0B4,7,-268.9599999999999,5,2,271.13,2.17
22024,U21A725,7,-2945.6800000000003,6,1,3045.6800000000003,100.0
22025,UD7D518,7,8003.49,2,5,7666.66,15670.15
22026,U2167EC,7,8981.22,3,4,19618.78,28600.0
22027,U48588D,7,-64.99999999999989,5,2,2101.18,2036.18
22028,U3AE273,7,-1438.0,3,4,4064.1,2626.1
22029,U2E5A52,7,3503.0699999999997,2,5,2500.0,6003.07
22030,U443114,7,7743.8,4,3,6866.67,14610.470000000001
22031,U747486,7,2549.0,5,2,7449.0,9998.0
22032,U22C379,7,-10.0,4,3,11560.0,11550.0
22033,UB9B015,7,-2112.9,6,1,3633.6,1520.7
22034,UEABDDB,7,-2450.0,5,2,5450.16,3000.16
22035,U677F4C,7,-1812.2899999999988,3,4,17012.399999999998,15200.11
22036,U72452F,7,-22406.0,4,3,45606.0,23200.0
22037,UB6CD39,7,10997.98,5,2,4956.3,15954.28
22038,UE17AD1,7,2700.15,2,5,2777.78,5477.93
22039,UE551F0,7,5000.67,2,5,5000.0,10000.67
22040,U6FDB60,7,92.97000000000025,3,4,11107.66,11200.630000000001
22041,U8D6D74,7,0.7600000000002183,3,4,13476.74,13477.5
22042,U715132,7,-10.0,4,3,10015.0,10005.0
22043,U3E1E56,7,-1110.9400000000003,4,3,2511.3,1400.36
22044,U00FC80,7,-4559.59,6,1,4560.0,0.41
22045,U133992,7,2762.66,3,4,1092.0,3854.66
22046,UDB8B16,7,-5.0,5,2,130.0,125.0
22047,U3F0F36,7,389.0,2,5,756.0,1145.0
22048,UEE8901,7,1627.2,4,3,314.0,1941.2
22049,UF3B855,7,106.0,3,4,1300.0,1406.0
22050,U237CBF,7,-3399.88,5,2,14597.0,11197.119999999999
22051,UAE1C8F,7,4700.16,2,5,4677.22,9377.380000000001
22052,UA8AE48,7,-92.0,6,1,3433.0,3341.0
22053,U436E5D,7,3133.0,4,3,324.0,3457.0
22054,UA66AAB,7,-1777.74,4,3,5427.74,3650.0
22055,U082660,7,-50.059999999999995,7,0,50.059999999999995,0.0
22056,U06A0C2,7,-2000.0,4,3,42000.0,40000.0
22057,UD976B2,7,0.27000000000043656,3,4,9522.26,9522.53
22058,UC6AF38,7,-2.0,6,1,3000.0,2998.0
22059,U718E13,7,-5343.91,6,1,8141.0,2797.09
22060,U177FBB,7,-268.80999999999995,4,3,3318.81,3050.0
22061,U7E9FF5,7,0.039999999999984936,4,3,368.02,368.05999999999995
22062,U52C400,7,795.7700000000004,4,3,8205.17,9000.939999999999
22063,U152FE7,7,-1233.8299999999997,5,2,1267.22,33.39
22064,UFBF241,7,279.91,4,3,18.1,298.01
22065,UD6CD14,7,-419.64,6,1,446.48,26.84
22066,UD23059,7,0.07000000000017792,4,3,1393.2199999999998,1393.29
22067,U5D4E84,7,402.7899999999999,5,2,2270.71,2673.5
22068,U464CD7,7,7442.84,4,3,1090.6200000000001,8533.46
22069,UC79843,7,907.08,4,3,432.91999999999996,1340.0
22070,U655CD8,7,0.49999999999995737,4,3,687.0200000000001,687.52
22071,UD9CEA5,7,10.0,5,2,12010.0,12020.0
22072,U6282B8,7,-559.0,5,2,5803.0,5244.0
22073,U2E1040,7,401.0,2,5,5999.0,6400.0
22074,U9357D9,7,343.1100000000006,4,3,24000.0,24343.11
22075,UECF7B9,7,256.83000000000004,4,3,446.16999999999996,703.0
22076,U30F2D1,7,-8468.0,4,3,21484.0,13016.0
22077,UD7A64C,7,2633.66,3,4,1866.47,4500.13
22078,UE89140,7,-3.4500000000007276,4,3,14700.0,14696.55
22079,U971CC4,7,-102.65000000000006,6,1,447.35,344.7
22080,U339D5F,7,-4853.419999999999,3,4,23001.420000000002,18148.0
22081,UC00329,7,-4939.799999999999,7,0,4939.799999999999,0.0
22082,U15C475,7,-282.19000000000005,4,3,1032.22,750.03
22083,UC29F88,7,-265.89,7,0,265.89,0.0
22084,UDAE364,7,4984.0,3,4,349.45,5333.45
22085,U6E2C9E,7,-13245.47,3,4,20672.0,7426.530000000001
22086,U2D897A,7,107.05,4,3,97.0,204.05
22087,UA65190,7,0.0,4,3,7810.0,7810.0
22088,U4170E2,7,6547.0,3,4,17453.0,24000.0
22089,UFC0938,7,-201.15,5,2,352.0,150.85
22090,UF634F9,7,-2439.34,5,2,4034.34,1595.0
22091,U432350,7,-10000.0,5,2,20000.0,10000.0
22092,UDF5710,7,349.81999999999994,6,1,928.7,1278.52
22093,UF806D3,7,317.3499999999999,4,3,1982.35,2299.7
22094,U971976,7,11208.0,3,4,6001.0,17209.0
22095,UD8C8DD,7,-5604.4,6,1,5704.4,100.0
22096,UD97464,7,-429.96000000000004,5,2,1436.96,1007.0
22097,U7B0D08,7,-28.029999999999973,5,2,748.0,719.97
22098,UE195BC,7,325.0,4,3,1130.0,1455.0
22099,UD20D06,7,-502.0,6,1,4383.0,3881.0
22100,U0EC96D,7,3800.0,3,4,83600.0,87400.0
22101,U2BCB4D,7,-655.26,4,3,705.26,50.0
22102,UA282D9,7,90.34999999999992,4,3,2009.66,2100.01
22103,UA22569,7,0.0,4,3,2924.4100000000003,2924.4100000000003
22104,U2AAD1B,7,3547.3,4,3,10285.0,13832.300000000001
22105,U06BEDE,7,21.009999999999994,5,2,0.05,21.060000000000002
22106,UC656DF,7,5001.5599999999995,2,5,5000.0,10001.56
22107,U85A97B,7,-353.5999999999999,4,3,3048.0,2694.4
22108,UA1FFF7,7,-9830.42,5,2,10179.81,349.39
22109,UE1177E,7,-33.539999999999964,5,2,1942.54,1909.0
22110,U21A58B,7,56.749999999999886,6,1,551.1800000000001,607.93
22111,U98BA38,7,-2336.44,6,1,2336.46,0.02
22112,UEADB0C,7,7160.43,2,5,7166.66,14327.09
22113,UCDBC32,7,-0.6599999999998545,5,2,1699.6599999999999,1699.0
22114,U5D37F0,7,776.0,4,3,5614.0,6390.0
22115,UBAA9BE,7,56.029999999999745,4,3,5010.0,5066.03
22116,UFA7655,7,-748.0999999999999,5,2,894.1999999999999,146.1
22117,U08E335,7,-811.91,4,3,2721.91,1910.0
22118,U7EA61D,7,8333.18,2,5,8333.34,16666.52
22119,U0E1490,7,-430.19000000000005,4,3,5826.58,5396.39
22120,UF1DD98,7,86.35999999999996,5,2,704.81,791.17
22121,UF390CE,7,22.699999999999875,6,1,2377.2999999999997,2400.0
22122,UFA4EFF,7,-104.30000000000001,5,2,489.0,384.7
22123,UA7942D,7,-0.8799999999999955,5,2,6001.0,6000.12
22124,UF37D0E,7,666.0,4,3,2708.0,3374.0
22125,U5DBAF3,7,-14.950000000000045,4,3,337.96000000000004,323.01
22126,U6D4E83,7,-23868.2,7,0,23868.2,0.0
22127,U2AEA36,7,-391.94000000000005,4,3,1084.8899999999999,692.95
22128,UAF5407,7,43060.0,0,7,0.0,43060.0
22129,U3EBF50,7,-428.0,5,2,829.0,401.0
22130,UD605E9,7,-6328.49,6,1,8857.15,2528.66
22131,U63EBA9,7,-69084.0,4,3,73072.0,3988.0
22132,UB498E6,7,1130.6800000000003,3,4,12066.32,13197.0
22133,U3C32ED,7,-29764.85,4,3,40675.0,10910.15
22134,UE9F01C,7,606.01,2,5,300.01,906.02
22135,UA90654,7,-54.5,6,1,2814.5,2760.0
22136,U02E193,7,-732.98,6,1,733.0,0.02
22137,U1DB27A,7,-1609.9899999999998,6,1,1709.9899999999998,100.0
22138,UD7E7A4,7,2824.02,4,3,26.0,2850.02
22139,UB41F7D,7,91.0,3,4,5713.0,5804.0
22140,UF22D9D,7,-14410.0,3,4,40000.0,25590.0
22141,UC12915,7,2000.65,4,3,463.7,2464.35
22142,UD02A0F,7,-1440.21,4,3,5800.0,4359.79
22143,U557ECD,7,131.6,5,2,22.4,154.0
22144,UA36E23,7,-466.0,6,1,928.5,462.5
22145,U4A6DD4,7,0.22000000000002728,6,1,1078.78,1079.0
22146,U7D27F9,7,30294.57,3,4,59964.0,90258.57
22147,U223A91,7,7304.969999999999,5,2,821.99,8126.959999999999
22148,U12B3CD,7,-7255.01,5,2,12640.46,5385.45
22149,UE98F68,7,1.4210854715202004e-14,4,3,568.8,568.8
22150,U04DD01,7,-546.1999999999998,4,3,14468.0,13921.8
22151,UE734B1,7,300.0,3,4,12000.0,12300.0
22152,U575D2D,7,107.46000000000001,5,2,2.54,110.0
22153,U2C72A3,7,3601.19,2,5,3591.66,7192.849999999999
22154,U64DC70,7,5665.0,5,2,4335.0,10000.0
22155,UBE0281,7,3900.0,2,5,3270.0,7170.0
22156,U63A0CC,7,-740.3199999999999,7,0,740.3199999999999,0.0
22157,U1FC76D,7,236787.83000000002,0,7,0.0,236787.83000000002
22158,U6F0144,7,-6641.0,5,2,15968.0,9327.0
22159,U837399,7,2988.3,4,3,3021.7,6010.0
22160,U29367D,7,-1999.9999999999998,5,2,3899.9,1899.9
22161,UA67FEC,7,962.0999999999999,4,3,7768.9,8731.0
22162,UE57288,7,8002.4,2,5,8025.0,16027.4
22163,U3DF892,7,2971.2,4,3,9028.8,12000.0
22164,UDA9950,7,-188.59999999999997,5,2,651.66,463.06
22165,UA74AEA,7,0.0,5,2,6000.0,6000.0
22166,UE4F817,7,2675.1,4,3,4390.9,7066.0
22167,U76CAEF,7,-1608.3400000000001,5,2,3558.34,1950.0
22168,U83C7A6,7,-310.94000000000005,5,2,1175.0,864.06
22169,UEF9C56,7,1070.0,6,1,1130.0,2200.0
22170,U875936,7,-1755.0,4,3,12855.0,11100.0
22171,U5E672B,7,-8.5600000000004,4,3,13346.0,13337.439999999999
22172,U4D8CD0,7,-992.8,6,1,1012.8,20.0
22173,UD613F6,7,96.00000000000003,5,2,728.85,824.85
22174,UFD6855,7,2494.6400000000003,2,5,10.0,2504.6400000000003
22175,UEC6D6F,7,7420.32,2,5,7416.66,14836.98
22176,UAE736E,7,10.0,5,2,223.5,233.5
22177,U46D6F9,7,-544.98,5,2,546.51,1.53
22178,U32B30B,7,14865.48,5,2,1317.78,16183.26
22179,U3FCEE2,7,20.43,2,5,13.0,33.43
22180,U14F38C,7,-1200.0,3,4,10000.0,8800.0
22181,UB9D80C,7,54.329999999999984,6,1,386.51,440.84
22182,UA5346E,7,-569.6999999999998,5,2,19631.7,19062.0
22183,UFBB8A8,7,-93.9699999999998,3,4,7036.0,6942.030000000001
22184,U3092C5,7,2475.31,5,2,800.9200000000001,3276.23
22185,U477938,7,0.19000000000002273,4,3,1055.1599999999999,1055.35
22186,UC9B09C,7,-2211.58,4,3,24870.9,22659.32
22187,U9C0460,7,-30.19,4,3,47.13,16.939999999999998
22188,UC0D68E,7,813.2599999999995,3,4,11202.52,12015.78
22189,UFA0823,7,999.8499999999999,5,2,1749.8,2749.65
22190,U4CCE67,7,-2.6500000000001456,4,3,6004.34,6001.69
22191,UF5404E,7,-440.0,7,0,440.0,0.0
22192,UC9B0DA,7,12059.0,2,5,10524.0,22583.0
22193,UC92A63,7,-10002.560000000001,5,2,14405.560000000001,4403.0
22194,UFF26BD,7,-30.0,5,2,70.0,40.0
22195,UC06D68,7,1044.38,5,2,1559.46,2603.84
22196,UC14775,7,-259.1400000000001,2,5,6107.0,5847.86
22197,U14E500,7,2601.0,2,5,2550.0,5151.0
22198,U1D83D0,7,-2266.67,5,2,8733.34,6466.67
22199,U5FF063,7,-48999.85,4,3,98000.0,49000.15
22200,U55C98B,7,2.0,5,2,1281.0,1283.0
22201,U238ACF,7,-384.0,5,2,2484.0,2100.0
22202,U51BC9A,7,1009.0,4,3,2091.0,3100.0
22203,UF551F0,7,-714.63,6,1,715.2,0.57
22204,UCE217F,7,-0.02999999999974534,4,3,6529.0,6528.97
22205,U19CB86,7,-1607.65,6,1,1607.6799999999998,0.03
22206,U87F9B1,7,642.31,3,4,195.0,837.31
22207,U76C73A,7,-2683.7599999999984,6,1,13996.289999999999,11312.53
22208,U08777F,7,3036.08,3,4,3698.92,6735.0
22209,U5237FC,7,-5268.97,3,4,14803.0,9534.029999999999
22210,UBA5552,7,-699.9999999999999,5,2,3263.7200000000003,2563.7200000000003
22211,U4388A1,7,96.94000000000011,5,2,878.97,975.9100000000001
22212,U1D9CF5,7,-4725.349999999999,6,1,4726.349999999999,1.0
22213,U69A997,7,0.01,3,4,10000.01,10000.02
22214,U1EE48D,7,8099.17,5,2,3762.34,11861.51
22215,U920B2A,7,-6.989999999999782,4,3,5269.99,5263.0
22216,UDA0A40,7,-27541.45,2,5,48000.0,20458.55
22217,U896A62,7,-9301.0,6,1,53786.0,44485.0
22218,UDD5811,7,-3510.13,5,2,6450.32,2940.19
22219,U2D54A9,7,7.58,3,4,6001.0,6008.58
22220,U303E93,7,81.09999999999991,5,2,1431.9,1513.0
22221,UFF87BF,7,50.0,3,4,10450.0,10500.0
22222,U16D8B8,7,1196.6000000000004,5,2,3163.4,4360.0
22223,U94541A,7,32.87,6,1,305.13,338.0
22224,UE67EE5,7,1834.8400000000001,4,3,9621.16,11456.0
22225,UC658A3,7,19848.0,1,6,3652.0,23500.0
22226,U07D428,7,-1.1368683772161603e-13,5,2,1119.27,1119.27
22227,UCBF766,7,2065.4399999999987,3,4,24801.1,26866.54
22228,U5933A8,7,62.78999999999999,4,3,163.18,225.97
22229,U72FE57,7,-4813.06,5,2,4943.06,130.0
22230,UA2FBA0,7,-315.05,7,0,315.05,0.0
22231,UB361A9,7,-39380.869999999995,6,1,42480.869999999995,3100.0
22232,UF3FFD7,7,3270.9700000000003,2,5,3540.0,6810.97
22233,UE818AA,7,21776.879999999997,4,3,3885.12,25662.0
22234,U6F9CE9,7,550.46,2,5,534.44,1084.9
22235,UD9BB43,7,-3.4400000000009094,4,3,10003.44,10000.0
22236,UC72098,7,-68.60000000000002,5,2,1466.6,1398.0
22237,U34981A,7,-25304.2,6,1,35104.2,9800.0
22238,UDD7412,7,11.87,4,3,165.0,176.87
22239,UB3F9FC,7,4695.639999999999,4,3,423.96,5119.6
22240,U8C3299,7,7866.950000000001,4,3,7004.0,14870.95
22241,U89AD14,7,5451.5,3,4,1068.6,6520.1
22242,U594117,7,1670.0600000000013,3,4,26228.0,27898.06
22243,UECCBC2,7,7.030000000000001,6,1,25.5,32.53
22244,U64F052,7,103.82,4,3,207.41,311.23
22245,U37683A,7,375.5,3,4,15000000.0,15000375.5
22246,UA12507,7,-1212.0,6,1,3931.8,2719.8
22247,U60D80F,7,1178.0,4,3,2152.0,3330.0
22248,U9410CA,7,0.0,6,1,237.31999999999996,237.32
22249,U066C7C,7,2787.0,3,4,413.0,3200.0
22250,UDAD090,7,-63.629999999999995,3,4,327.4,263.77
22251,U9E0A5D,7,61.0,6,1,5395.5,5456.5
22252,UBF5A09,7,167.5899999999998,6,1,2861.4100000000003,3029.0
22253,UC948BA,7,-396.96000000000004,4,3,1071.64,674.6800000000001
22254,UF8703D,7,10735.990000000002,3,4,40000.0,50735.990000000005
22255,UABD5D9,7,-11088.0,4,3,31863.0,20775.0
22256,U1BB567,7,-1903.7299999999996,4,3,4385.36,2481.63
22257,UFBA180,7,-98943.88999999997,2,5,300000.0,201056.11
22258,U9667AF,7,-2309.0,3,4,42000.0,39691.0
22259,U9F02B5,7,-2442.77,4,3,5099.82,2657.05
22260,U06FFE7,7,129.1300000000001,5,2,2690.87,2820.0
22261,U7F6EF8,7,9218.619999999999,3,4,10218.619999999999,19437.239999999998
22262,U528E19,7,-442.5,4,3,1337.5,895.0
22263,UDD1FD6,7,2180.0,4,3,4354.16,6534.16
22264,U1C6352,7,-1330.56,5,2,1572.1599999999999,241.6
22265,U2910AB,7,101.01999999999998,5,2,194.4,295.41999999999996
22266,UBEA118,7,-2433.26,4,3,3933.26,1500.0
22267,U7620E6,7,-2100.0,5,2,9362.0,7262.0
22268,UCBDBB4,7,99.79999999999995,4,3,701.8,801.5999999999999
22269,U9CCB1C,7,-1002.1599999999999,5,2,3057.24,2055.08
22270,UF2C95A,7,-458.56999999999994,6,1,658.5699999999999,200.0
22271,UB76579,7,-1685.4,6,1,2485.4,800.0
22272,U50AC1E,7,1933.01,5,2,1787.99,3721.0
22273,U717E54,7,-2183.0,4,3,13059.0,10876.0
22274,U8F1A81,7,8110.0,4,3,1204.0400000000002,9314.04
22275,UA743CB,7,6666.780000000001,2,5,6664.0,13330.78
22276,UE4F00C,7,-166433.77000000002,7,0,166433.77000000002,0.0
22277,U1346EA,7,3.0,6,1,6.0,9.0
22278,U1212C1,7,292.5899999999999,4,3,603.08,895.67
22279,UCC5CFA,7,-5333.73,4,3,11000.0,5666.27
22280,U01757B,7,6342.95,2,5,0.02,6342.97
22281,U658E3A,7,-1987.0,5,2,10614.0,8627.0
22282,U4F2DA1,7,0.1500000000005457,4,3,6305.56,6305.710000000001
22283,UDFBC9F,7,10100.0,3,4,1130.0,11230.0
22284,UF101C1,7,2002.2,2,5,434.85,2437.05
22285,UF6FFFC,7,964.0,5,2,7772.0,8736.0
22286,UF1B077,7,-271.01,7,0,271.01,0.0
22287,UF69316,7,-4769.88,5,2,7666.0,2896.12
22288,U5FFC05,7,-18.20000000000001,5,2,143.3,125.1
22289,U69B419,7,-440.54999999999995,6,1,2032.98,1592.43
22290,U47C4EF,7,0.0,3,4,18700.0,18700.0
22291,UE7FAD5,7,-4961.58,6,1,9963.720000000001,5002.14
22292,UF6D3C2,7,-1995.0,5,2,6000.0,4005.0
22293,U4E266A,7,480.0,0,7,0.0,480.0
22294,UDF76CE,7,12941.249999999998,5,2,157.95,13099.199999999999
22295,U9D0328,7,6379.950000000001,4,3,3323.9,9703.85
22296,U59A0B5,7,-0.4299999999999875,4,3,451.74,451.31000000000006
22297,U9C4E88,7,-802.4200000000001,5,2,2386.42,1584.0
22298,U792871,7,-1056.1799999999998,6,1,1057.32,1.14
22299,U9D02D5,7,-9.440000000000055,5,2,3067.5,3058.06
22300,UED7503,7,-1948.28,3,4,2510.0,561.72
22301,U31CD2B,7,5508.0,4,3,12.0,5520.0
22302,U3B7D8B,7,1544.1000000000001,3,4,2035.5,3579.6
22303,U1069C8,7,431.33000000000004,5,2,1197.0,1628.33
22304,U5DF898,7,10291.449999999999,4,3,1971.66,12263.11
22305,UAEC044,7,417.0,4,3,13439.0,13856.0
22306,UAC780C,7,-305.5,4,3,22895.0,22589.5
22307,UC19194,7,-1135.6100000000001,5,2,3604.0,2468.39
22308,U25214E,7,-269.79999999999984,5,2,3408.6000000000004,3138.8
22309,U124ACD,7,-1057.9700000000003,4,3,3300.0,2242.0299999999997
22310,U89271E,7,-229.01,4,3,1159.01,930.0
22311,UB67016,7,-513.7,5,2,895.7,382.0
22312,U8965B9,7,2927.3900000000003,4,3,2877.7999999999997,5805.1900000000005
22313,U706014,7,-54.409999999999854,4,3,7425.0,7370.59
22314,U346022,7,160.0,4,3,11790.0,11950.0
22315,UBD0DFB,7,-3425.56,4,3,6026.56,2601.0
22316,UE2792C,7,-5889.99,4,3,18080.0,12190.01
22317,U2396D0,7,-1300.0,5,2,6300.0,5000.0
22318,U6DD956,7,0.0,6,1,6000.0,6000.0
22319,U095C9D,7,4602.11,2,5,4452.76,9054.869999999999
22320,UE5F898,7,-12.11,5,2,18.0,5.89
22321,UC9A392,7,42.32999999999993,4,3,3158.0,3200.33
22322,U7CEAE2,7,-3909.3500000000004,5,2,11852.85,7943.5
22323,U32FE21,7,-5999.1,6,1,6599.0,599.9
22324,U9FA909,7,1224.52,6,1,1375.48,2600.0
22325,U475564,7,11978.599999999999,5,2,27509.98,39488.58
22326,U5E8F3C,7,0.4,4,3,130.0,130.4
22327,UE9BA58,7,1487.88,5,2,2550.0,4037.88
22328,UA0A91F,7,595.1900000000002,5,2,4230.61,4825.8
22329,U634AA4,7,5.380000000001019,3,4,29380.0,29385.38
22330,UE37C67,7,1462.3,6,1,237.7,1700.0
22331,UE3CA4D,7,-2810.0,4,3,14035.0,11225.0
22332,UC28B3E,7,-259.0,5,2,1347.46,1088.46
22333,U0A3D15,7,3405.96,3,4,1942.3400000000001,5348.3
22334,U0FD3B4,7,-1006.46,5,2,4006.46,3000.0
22335,U91C5BB,7,-2959.27,6,1,3459.27,500.0
22336,U2D9661,7,-348.5399999999999,4,3,13598.880000000001,13250.34
22337,U063674,7,232.41999999999996,4,3,3116.0699999999997,3348.49
22338,UCD40C1,7,2673.1100000000006,4,3,3742.3900000000003,6415.5
22339,U33390C,7,360.71999999999935,5,2,6032.9400000000005,6393.66
22340,U1BCB4B,7,5012.08,3,4,5389.0,10401.08
22341,U4CD847,7,-44.27000000000021,5,2,3758.8,3714.5299999999997
22342,UB115C3,7,58.36000000000058,5,2,5941.64,6000.0
22343,UD36536,7,2.190000000000083,5,2,716.7,718.8900000000001
22344,UFA9582,7,5353.76,5,2,4147.5,9501.26
22345,U0F86B4,7,111.98999999999978,5,2,4000.0,4111.99
22346,U0B1535,7,0.0,4,3,325.0,325.0
22347,U06E014,7,86.07999999999993,4,3,20005.0,20091.08
22348,UF03187,7,-473.9,5,2,560.7,86.8
22349,UBC7A00,7,-9260.0,5,2,12050.0,2790.0
22350,U533F0F,7,-0.16000000000008185,4,3,565.1600000000001,565.0
22351,U7AAD44,7,13702.0,4,3,98.0,13800.0
22352,U83D4E5,7,-13.26,6,1,13.280000000000001,0.02
22353,U81EB1A,7,-153.0,6,1,553.0,400.0
22354,UD43713,7,-34.0,3,4,15034.0,15000.0
22355,U7669F6,7,-1299.33,6,1,1299.85,0.52
22356,U20F99B,7,1459.38,5,2,260.62,1720.0
22357,U3CD623,7,516.2200000000003,5,2,4000.0,4516.22
22358,U86C24A,7,-18.97,4,3,198.0,179.03
22359,U315DD1,7,-7030.39,4,3,7430.51,400.12
22360,U9B9CDC,7,-7815.0,5,2,14612.0,6797.0
22361,U3DD442,7,110.03,5,2,550.84,660.87
22362,U93DC41,7,1846.0,4,3,2299.9,4145.9
22363,UCB0000,7,8754.949999999999,2,5,7200.0,15954.949999999999
22364,UE44121,7,5642.71,6,1,68.29,5711.0
22365,UD3857C,7,3441.46,2,5,3433.34,6874.8
22366,U768C48,7,33.84000000000145,3,4,20081.63,20115.47
22367,U75A971,7,-1836.13,5,2,3546.13,1710.0
22368,U043686,7,4651.0,2,5,24919.0,29570.0
22369,UB42F27,7,6189.01,2,5,39714.59,45903.6
22370,UDBFC27,7,1.4210854715202004e-13,4,3,6698.22,6698.22
22371,U7EDB27,7,-26822.25,2,5,34767.63,7945.38
22372,U9CDAB6,7,-105.11000000000001,5,2,406.0,300.89
22373,U23471F,7,375.08000000000004,4,3,784.92,1160.0
22374,U81F048,7,22.52,2,5,22.52,45.04
22375,U18ACD3,7,2920.5,5,2,3045.5,5966.0
22376,U1B4B68,7,-928.1400000000003,3,4,3266.32,2338.18
22377,UDA878A,7,82.0,4,3,1273.07,1355.0700000000002
22378,U6B843F,7,-4721.44,4,3,4949.12,227.68
22379,U888615,7,50.289999999999964,3,4,543.0,593.29
22380,U70E6E3,7,11983.609999999999,5,2,1061.95,13045.56
22381,U798BA2,7,2890.379999999999,5,2,6816.79,9707.17
22382,UF886CA,7,-2049.0,5,2,2816.33,767.33
22383,UF2A5F5,7,1190.789999999999,4,3,14081.0,15271.789999999999
22384,UC4BB04,7,-88.89000000000001,4,3,161.31,72.42
22385,UFF645B,7,2459.5,2,5,250000.0,252459.5
22386,U03218D,7,424.62,5,2,736.3399999999999,1160.96
22387,U0308AA,7,-741.25,5,2,2883.0,2141.75
22388,UCBC633,7,44000.0,3,4,45000.0,89000.0
22389,U5393F1,7,-492.0,6,1,5888.0,5396.0
22390,U05FC02,7,10500.0,4,3,3933.34,14433.34
22391,UD13DA1,7,14.01,2,5,12.79,26.799999999999997
22392,UE282B9,7,-2451.66,6,1,2456.66,5.0
22393,UE665AA,7,-39.550000000000004,4,3,72.25,32.7
22394,UE57990,7,-50.97,4,3,121.0,70.03
22395,UB14D2F,7,4400.0,2,5,6800.0,11200.0
22396,U735686,7,6090.0,3,4,4010.0,10100.0
22397,UE6F5F0,7,1186.46,4,3,713.5399999999998,1900.0
22398,U79C09D,7,4400.42,2,5,4267.64,8668.060000000001
22399,U2D9965,7,-596.28,6,1,796.28,200.0
22400,UA01267,7,1142.0,3,4,10058.0,11200.0
22401,U0FF9AD,7,231.89999999999998,4,3,2219.1,2451.0
22402,U3E334F,6,4610.0,3,3,9200.0,13810.0
22403,U85B864,6,1577.7,3,3,22.3,1600.0
22404,U48838D,6,-13207.83,4,2,13217.83,10.0
22405,U8942F3,6,0.0,4,2,5050.96,5050.96
22406,UDB5AFB,6,-5.989999999999995,4,2,96.0,90.01
22407,UDB8DDB,6,3483.1799999999994,4,2,6020.0,9503.18
22408,UBEC10B,6,0.009999999999990905,3,3,2300.0,2300.01
22409,UE5D70F,6,-162.5,3,3,2112.5,1950.0
22410,U3EBDB3,6,46.21999999999996,4,2,852.78,899.0
22411,U85227C,6,-2190.0,4,2,7382.82,5192.82
22412,UF144C3,6,0.06999999999993634,3,3,4020.0,4020.0699999999997
22413,U341E5F,6,-1005.04,6,0,1005.04,0.0
22414,UCE0111,6,66.28000000000065,2,4,13035.14,13101.42
22415,U5E9C48,6,-827.0999999999999,5,1,1937.1,1110.0
22416,UB843BA,6,-9211.199999999999,5,1,9274.8,63.6
22417,U6C5CDD,6,-2604.36,4,2,2643.36,39.0
22418,UF5EAFD,6,355.91,5,1,364.09,720.0
22419,U45D337,6,63.0,4,2,537.0,600.0
22420,UFCBE13,6,38.0,4,2,1417.0,1455.0
22421,UE8E794,6,990.33,3,3,11.0,1001.33
22422,U188B51,6,-1003.6000000000004,3,3,38916.24,37912.64
22423,UA78C40,6,1159.61,3,3,872.8,2032.4099999999999
22424,UC1230A,6,-236.0,4,2,9859.0,9623.0
22425,UDD317D,6,-7288.119999999999,6,0,7288.119999999999,0.0
22426,UDE31DB,6,0.0,5,1,5694.0,5694.0
22427,UC719DE,6,-422.9,4,2,2022.9,1600.0
22428,U52A994,6,6243.17,4,2,7025.0,13268.17
22429,U9BE5CC,6,-1743.0000000000002,4,2,1991.41,248.41
22430,U8E9A8D,6,2100.7,4,2,899.3,3000.0
22431,U415139,6,17312.18,0,6,0.0,17312.18
22432,U1B6E30,6,-368.0,5,1,4968.0,4600.0
22433,U2A2CE1,6,1.7053025658242404e-13,4,2,1762.7,1762.7
22434,U397A1D,6,0.0,3,3,6000.0,6000.0
22435,UDBE72F,6,-3199.7799999999997,6,0,3199.7799999999997,0.0
22436,UDFD2D5,6,-834.2600000000002,5,1,5204.26,4370.0
22437,U6DCE76,6,0.0,5,1,83.5,83.5
22438,UE934A1,6,-26.21,4,2,41.21,15.0
22439,U3675EB,6,-607.86,6,0,607.86,0.0
22440,UC6A71F,6,0.019999999999939178,4,2,853.02,853.04
22441,U669FF9,6,-8.526512829121202e-14,4,2,887.5600000000001,887.56
22442,U175B9F,6,-139.40999999999997,4,2,529.41,390.0
22443,UC71EF6,6,-4829.75,5,1,4830.0,0.25
22444,UE0961E,6,158.00000000000023,4,2,3985.3,4143.3
22445,UAFE06F,6,503.09000000000015,2,4,5000.0,5503.09
22446,UE8F22A,6,-1034.1200000000001,6,0,1034.1200000000001,0.0
22447,UCAE3E0,6,-4114.91,6,0,4114.91,0.0
22448,UFD313E,6,75.00999999999999,3,3,350.0,425.01
22449,UDCAA0E,6,3000.0,2,4,2978.0,5978.0
22450,UF274FD,6,0.0,4,2,183.66,183.66
22451,U55FEF7,6,-2912.0,4,2,8712.0,5800.0
22452,U1217F1,6,29.230000000000473,4,2,4986.0,5015.2300000000005
22453,U4D97FD,6,43.01000000000022,4,2,29959.989999999998,30003.0
22454,U7C3E3B,6,-0.51,4,2,1.02,0.51
22455,U08B42E,6,10.0,4,2,299.15,309.15
22456,U7A7489,6,0.0,4,2,275.5,275.5
22457,U28961A,6,-529.99,2,4,670.0,140.01
22458,U0245D3,6,-4513.0,4,2,25013.0,20500.0
22459,U3F9E55,6,417.0,4,2,715.36,1132.3600000000001
22460,U116167,6,-10123.0,3,3,40476.0,30353.0
22461,UD997A2,6,-427.37,4,2,897.37,470.0
22462,U38B0EB,6,0.12999999999919964,2,4,20000.0,20000.129999999997
22463,UEFDA29,6,-652.0,6,0,652.0,0.0
22464,U683DB9,6,-2851.0,5,1,5851.0,3000.0
22465,UA0D55B,6,-0.640000000000182,5,1,2721.34,2720.7
22466,U7C787F,6,-3591.6,4,2,9681.0,6089.4
22467,U04DDDA,6,-1.4210854715202004e-14,4,2,339.25,339.25
22468,UDA2202,6,-137.75,3,3,147.76,10.01
22469,U14430E,6,-636.3000000000001,6,0,636.3000000000001,0.0
22470,U3A9013,6,6102.42,2,4,0.02,6102.4400000000005
22471,U1F4AF7,6,115.5,4,2,3784.5,3900.0
22472,U0D83C4,6,-510.0,4,2,937.5,427.5
22473,U958F8F,6,-988.1699999999998,3,3,9282.2,8294.03
22474,U5D1BFA,6,-1987.98,3,3,5958.429999999999,3970.45
22475,U4F4377,6,2918.0,3,3,2895.0,5813.0
22476,U8E269C,6,1714.0800000000002,3,3,1035.0,2749.0800000000004
22477,U32B84C,6,0.0,3,3,12.0,12.0
22478,U5E2D4E,6,0.0,4,2,1966.66,1966.66
22479,UB7C760,6,-9980.0,4,2,19990.0,10010.0
22480,U4AF850,6,-453.0,4,2,34996.0,34543.0
22481,U5201A3,6,2939.0,3,3,501.0,3440.0
22482,U8BAB13,6,107.57999999999993,4,2,1586.42,1694.0
22483,U5DCBC5,6,0.0,3,3,158.0,158.0
22484,U83F41D,6,-3000.0,5,1,7949.0,4949.0
22485,U3A57BF,6,553.3600000000006,4,2,4237.28,4790.64
22486,U43F001,6,-258.96999999999935,5,1,10458.97,10200.0
22487,UCE0D44,6,120.2,4,2,639.8,760.0
22488,U77E721,6,-290.0,2,4,4000.0,3710.0
22489,U55E0A6,6,-558.9799999999996,3,3,7856.99,7298.01
22490,U54429B,6,2.0499999999992724,2,4,18191.0,18193.05
22491,UC76E95,6,-6750.0,3,3,16965.0,10215.0
22492,U721BAF,6,6259.14,0,6,0.0,6259.14
22493,U0AF24A,6,-2708.0,6,0,2708.0,0.0
22494,U61D472,6,2.399999999999636,3,3,2405.63,2408.0299999999997
22495,U2AA97C,6,0.0,5,1,50.0,50.0
22496,UE62BDB,6,-260.58,6,0,260.58,0.0
22497,UEB8AF4,6,2300.0,4,2,9700.0,12000.0
22498,U12C774,6,9230.16,3,3,32936.84,42167.0
22499,U74C6B5,6,-5.684341886080802e-14,4,2,511.18000000000006,511.18
22500,U4F3ABD,6,-705.8700000000001,6,0,705.8700000000001,0.0
22501,U6F4489,6,-16050.63,2,4,27472.0,11421.37
22502,UFE71F4,6,4161.110000000001,0,6,0.0,4161.110000000001
22503,U065698,6,-10157.79,6,0,10157.79,0.0
22504,U2F7525,6,5.0,4,2,14003.0,14008.0
22505,U84AC32,6,200.0,4,2,10.0,210.0
22506,U71C3A0,6,-1806.31,6,0,1806.31,0.0
22507,U898B94,6,-65.59000000000015,4,2,2075.59,2010.0
22508,U3D6459,6,-8.69,4,2,279.71,271.02
22509,U6FA0FF,6,49.80000000000001,5,1,1655.41,1705.21
22510,U7743A3,6,1.02,2,4,1.01,2.03
22511,UE2F1E6,6,19011.039999999997,3,3,262.65999999999997,19273.7
22512,UD9D21C,6,-2.2737367544323206e-13,4,2,2141.74,2141.74
22513,U3D85C8,6,2172.0,4,2,1310.0,3482.0
22514,UCB4C3E,6,190.0,4,2,1170.0,1360.0
22515,U983506,6,-1948.46,6,0,1948.46,0.0
22516,U1DF46B,6,0.0,4,2,7790.0,7790.0
22517,U4441D6,6,-2.5,5,1,40.11,37.61
22518,UFE64A9,6,8480.0,3,3,20.0,8500.0
22519,U2D858F,6,180.0,4,2,1020.0,1200.0
22520,U7BB459,6,505.81,3,3,181.88,687.6899999999999
22521,UD602FC,6,-5.047628981458274e-13,2,4,9251.8,9251.800000000001
22522,UBED802,6,-1.2300000000003646,3,3,7909.82,7908.59
22523,UFC2F15,6,-43.8,5,1,43.809999999999995,0.01
22524,U23609C,6,0.009999999999990905,4,2,3862.21,3862.22
22525,UC0EA7A,6,106.0,3,3,1694.0,1800.0
22526,UEEA006,6,-310.21,5,1,311.21,1.0
22527,UA20C10,6,256.3000000000002,3,3,4805.0,5061.3
22528,U52531E,6,0.0,4,2,6000.0,6000.0
22529,U248389,6,-16.45999999999998,4,2,827.3599999999999,810.9
22530,UDE2D30,6,-699.67,5,1,709.67,10.0
22531,UF26B83,6,-1081.29,3,3,4821.360000000001,3740.07
22532,U67EAAE,6,1070.0,2,4,1070.0,2140.0
22533,U706F7B,6,-98.0,3,3,65938.0,65840.0
22534,U24BC06,6,52.03,2,4,234.76,286.78999999999996
22535,UF2EB1A,6,-10019.94,4,2,10436.58,416.64
22536,U4EA894,6,35.90000000000009,4,2,7864.1,7900.0
22537,UF749C8,6,342.25,3,3,459.97,802.22
22538,U0D3801,6,-3.980000000000018,3,3,1404.0,1400.02
22539,UBA707F,6,1532.0,2,4,10.0,1542.0
22540,U51223A,6,-4.0,5,1,1804.0,1800.0
22541,UF3B30E,6,-6480.16,5,1,6963.76,483.6
22542,UABADAD,6,-146.68,6,0,146.68,0.0
22543,U428BDF,6,-20.0,3,3,6980.0,6960.0
22544,U89C867,6,278.35,4,2,543.0,821.35
22545,U1DF875,6,-600.4999999999999,6,0,600.4999999999999,0.0
22546,UAEAE54,6,64.07000000000005,3,3,1272.0,1336.0700000000002
22547,UA63FC3,6,14093.0,3,3,22688.0,36781.0
22548,U620D7D,6,-5.684341886080802e-14,4,2,877.8,877.8
22549,UE74985,6,10008.08,2,4,2095.0,12103.08
22550,UEB2450,6,8544.359999999999,2,4,567.18,9111.539999999999
22551,U2CBF8A,6,-39.0,4,2,7579.0,7540.0
22552,U774E32,6,-503.55999999999995,6,0,503.55999999999995,0.0
22553,U93003B,6,0.02000000000000668,4,2,284.98,285.0
22554,U508D52,6,2004.1999999999998,5,1,575.8,2580.0
22555,U1067AA,6,6459.870000000001,3,3,11900.0,18359.87
22556,UC48B84,6,0.0,4,2,1924.0,1924.0
22557,U6D45D2,6,1839.0,4,2,14361.0,16200.0
22558,U079163,6,18.63999999999999,4,2,555.08,573.72
22559,U387541,6,10.0,4,2,230.08,240.08
22560,UFE3EEB,6,10902.410000000002,0,6,0.0,10902.410000000002
22561,U3439D4,6,-1650.0,4,2,1770.0,120.0
22562,U00C898,6,-18.3,4,2,41.9,23.6
22563,UBAF115,6,1957.2100000000003,4,2,847.46,2804.67
22564,U72DEA0,6,-5275.639999999999,1,5,15000.0,9724.36
22565,UF90BBF,6,7.0,3,3,9993.0,10000.0
22566,UE0D2C4,6,-3.2399999999997817,2,4,26731.5,26728.26
22567,U208479,6,0.0,4,2,2560.26,2560.26
22568,U2FD98E,6,0.07000000000000739,4,2,1392.4699999999998,1392.54
22569,UA843B2,6,-290.07000000000016,4,2,2230.0,1939.9299999999998
22570,UC42506,6,2468.57,0,6,0.0,2468.57
22571,U510AF9,6,1483.72,4,2,477.54999999999995,1961.27
22572,U8C0CB2,6,-3568.66,4,2,8204.5,4635.84
22573,UD21911,6,-5.480000000000018,3,3,7900.0,7894.52
22574,U0A481F,6,16.0,3,3,110.0,126.0
22575,UB50D33,6,1567.6799999999994,4,2,11312.78,12880.46
22576,UE8D101,6,100525.39,1,5,271.39,100796.77999999998
22577,U24AB31,6,0.2899999999999636,3,3,655.7,655.99
22578,U0DFEA6,6,-79.60000000000002,4,2,539.6,460.0
22579,U64A388,6,-1819.6399999999996,4,2,4624.9,2805.26
22580,UE466EF,6,77.88000000000058,3,3,17099.98,17177.86
22581,UEB491E,6,-2911.02,3,3,8633.8,5722.780000000001
22582,UA8BAD3,6,0.0,4,2,6000.0,6000.0
22583,U3DFE6B,6,11922.0,4,2,12075.82,23997.82
22584,U994C5B,6,607.5,4,2,2128.0,2735.5
22585,U919EE7,6,12.759999999999968,3,3,627.01,639.77
22586,UCEB807,6,34.809999999999995,4,2,65.2,100.01
22587,U03DB13,6,149.68999999999997,3,3,565.1,714.79
22588,UA5C40F,6,-12567.199999999999,6,0,12567.199999999999,0.0
22589,U915868,6,4487.6,2,4,4487.6,8975.2
22590,UD08DE8,6,1.4210854715202004e-14,4,2,583.84,583.84
22591,U134A26,6,5000.0,0,6,0.0,5000.0
22592,UB641BF,6,-249.0,6,0,249.0,0.0
22593,U1B7433,6,5.684341886080802e-14,4,2,741.46,741.46
22594,UB3296E,6,18.00999999999999,4,2,1763.24,1781.25
22595,U38EB6B,6,-729.5,6,0,729.5,0.0
22596,U529853,6,5.83,3,3,50100.01,50105.84
22597,UA8A47E,6,0.0,2,4,10082.68,10082.68
22598,U68ACC6,6,5800.0,3,3,12200.0,18000.0
22599,U7BD510,6,0.0,3,3,4100.0,4100.0
22600,U2A8D88,6,284.76,4,2,271.0,555.76
22601,UF1392A,6,0.0,4,2,7010.0,7010.0
22602,U8E8600,6,-5000.0,4,2,13798.95,8798.95
22603,U441F36,6,4326.799999999999,4,2,311.20000000000005,4638.0
22604,UE59065,6,5.684341886080802e-14,4,2,519.4599999999999,519.46
22605,UE990E2,6,-16.75,4,2,7068.75,7052.0
22606,U7F69D9,6,-83.15000000000008,4,2,6548.74,6465.59
22607,U2297DB,6,-729.1700000000001,4,2,2458.34,1729.17
22608,U19C2CE,6,-5.68,5,1,6.0,0.32
22609,U2E9E41,6,-77.9,4,2,122.21000000000001,44.31
22610,U174F60,6,0.0,3,3,1850.0,1850.0
22611,UF9445F,6,-1.1000000000000014,3,3,56.2,55.1
22612,U6215AD,6,6.07,3,3,14.0,20.07
22613,U28F505,6,1080.0,4,2,5830.0,6910.0
22614,UEABFDD,6,518.0,4,2,4040.0,4558.0
22615,UD0A249,6,860.7800000000025,3,3,33071.0,33931.780000000006
22616,U5FA1AC,6,1185.0,4,2,8585.0,9770.0
22617,UEB8599,6,1627.81,4,2,406.62,2034.4299999999998
22618,UCE417B,6,-15179.68,5,1,38828.8,23649.12
22619,U248CF7,6,-21334.43,3,3,25733.43,4399.0
22620,U0436C4,6,-161.34,4,2,176.34,15.0
22621,UECF3DD,6,860.0,4,2,3737.0,4597.0
22622,UBD8B26,6,8495.650000000001,2,4,1781.41,10277.060000000001
22623,UDB6945,6,-472.89000000000027,3,3,4486.22,4013.33
22624,U91B70B,6,0.0,3,3,15.0,15.0
22625,U393530,6,-18072.73,4,2,27116.3,9043.57
22626,U86DD51,6,5927.02,2,4,3255.88,9182.9
22627,U2F5E99,6,3593.0,4,2,1707.0,5300.0
22628,U8C0F07,6,-1622.1599999999999,4,2,5553.16,3931.0
22629,UE6C7F0,6,-3820.9400000000005,5,1,4920.9400000000005,1100.0
22630,U6CF559,6,-26667.5,5,1,26712.5,45.0
22631,U6B38B1,6,0.0,4,2,1762.7,1762.7
22632,U43AA07,6,1905.9399999999987,4,2,27194.06,29100.0
22633,U1EB8B6,6,-983.4899999999997,5,1,5483.49,4500.0
22634,U3AFA06,6,12200.0,2,4,12200.0,24400.0
22635,U3718B8,6,202.1,3,3,147.9,350.0
22636,U56D4D3,6,-514.16,4,2,1064.1599999999999,550.0
22637,UBAE8A9,6,-505.0,2,4,8500.0,7995.0
22638,U014EAE,6,2447.999999999999,4,2,19205.92,21653.92
22639,UAAB4CE,6,-171.0,4,2,271.0,100.0
22640,U8F5FD5,6,-2100.0,6,0,2100.0,0.0
22641,U6F1190,6,-320.0,3,3,19758.0,19438.0
22642,U6E19AA,6,-1.0,3,3,18501.0,18500.0
22643,U071B62,6,0.0,4,2,251.4,251.4
22644,U5CC2A8,6,-88.88000000000011,2,4,7000.0,6911.12
22645,UBDF727,6,82.58,4,2,17.43,100.01
22646,UB5B03A,6,-348.74,4,2,548.74,200.0
22647,U33FC2C,6,878.2199999999998,4,2,5143.0,6021.219999999999
22648,UE2B147,6,-9.769999999999982,4,2,1478.77,1469.0
22649,UAC9526,6,0.7200000000000131,4,2,719.28,720.0
22650,U41A7D5,6,211.24,2,4,12296.0,12507.24
22651,U06156F,6,26796.03,1,5,10000.0,36796.03
22652,UEAF345,6,2743.5299999999997,2,4,4000.0,6743.530000000001
22653,UE129FA,6,118073.18000000001,1,5,150.0,118223.18000000001
22654,UA9CC66,6,-5.25,4,2,3376.0,3370.75
22655,UE9383D,6,-224.60000000000002,4,2,1024.6,800.0
22656,U711F70,6,-1355.9400000000003,6,0,1355.9400000000003,0.0
22657,U92867F,6,-2.842170943040401e-14,3,3,417.58000000000004,417.58
22658,UD7C105,6,10.0,3,3,20140.0,20150.0
22659,UF818F5,6,-0.07000000000000056,3,3,10.07,10.0
22660,U34FEF4,6,-11503.0,3,3,27497.0,15994.0
22661,U532673,6,0.0,3,3,16999.66,16999.66
22662,UD524E7,6,660.11,4,2,69.89,730.0
22663,U9BF36C,6,-29.670000000000073,4,2,4829.67,4800.0
22664,UFC64C3,6,-1002.0,5,1,1940.7,938.7
22665,UB83FB6,6,-154.59,3,3,3377.0,3222.41
22666,U14B97D,6,2350.3,3,3,3650.0,6000.3
22667,U61E9AF,6,75.80999999999997,4,2,366.58,442.39
22668,UA43809,6,-160.0,4,2,6760.0,6600.0
22669,UD85919,6,-793.84,3,3,1282.72,488.88
22670,UD50E3A,6,-1628.22,6,0,1628.22,0.0
22671,U692F6E,6,-50.70000000000004,5,1,383.9,333.2
22672,UD04666,6,150000.66,3,3,50002.0,200002.66
22673,UC44C4E,6,-100.70000000000003,5,1,500.70000000000005,400.0
22674,U81811B,6,152.99,5,1,547.01,700.0
22675,UD41D0A,6,40.93000000000001,4,2,564.0699999999999,605.0
22676,U6370BE,6,199.0,2,4,5000.0,5199.0
22677,UDBB78B,6,-2.990000000000009,4,2,303.0,300.01
22678,UD92998,6,-7.210000000000036,2,4,807.48,800.27
22679,U46E2EC,6,5080.37,4,2,3482.63,8563.0
22680,UFF78A0,6,9924.08,4,2,84.5,10008.58
22681,UF37C2B,6,-80.0,4,2,19480.0,19400.0
22682,UF0C3F7,6,11673.55,3,3,1089.57,12763.119999999999
22683,UFFEF3E,6,0.0,4,2,346.0,346.0
22684,UE1BC38,6,0.0,4,2,15450.0,15450.0
22685,U40A9C8,6,-3576.02,6,0,3576.02,0.0
22686,U449DF3,6,4516.02,2,4,19966.66,24482.68
22687,U1576E2,6,-3902.7999999999997,4,2,3917.7999999999997,15.0
22688,U358A76,6,-1005.0,4,2,1700.0,695.0
22689,U2D4CA8,6,0.0,4,2,21800.0,21800.0
22690,U660F08,6,-380.18999999999994,4,2,1080.8,700.61
22691,UBF7106,6,-150900.0,4,2,169650.0,18750.0
22692,UA79F66,6,-7176.719999999999,3,3,13000.0,5823.280000000001
22693,U82E5A1,6,69.0,4,2,2931.0,3000.0
22694,UD2661B,6,-12237.289999999999,4,2,12487.3,250.01
22695,U981791,6,-259.86,4,2,280.0,20.14
22696,U25696E,6,-0.2899999999999636,3,3,6956.76,6956.47
22697,UA67B81,6,-2400.0,3,3,10000.0,7600.0
22698,UD69517,6,-0.7300000000004729,3,3,7612.0,7611.2699999999995
22699,U3C8A91,6,96.79000000000042,3,3,5875.9,5972.6900000000005
22700,U6F994B,6,2080.7100000000064,2,4,100268.0,102348.71
22701,U6ABD87,6,-11141.2,5,1,11511.2,370.0
22702,U693507,6,-881.76,6,0,881.76,0.0
22703,UD67993,6,20011.07,2,4,14134.39,34145.46
22704,U296889,6,212.29000000000008,4,2,1420.0,1632.29
22705,UB1C6D2,6,-19525.75,3,3,114773.0,95247.25
22706,U55BAF7,6,20838.96,2,4,2522.26,23361.22
22707,UA32926,6,0.0,3,3,1625.3,1625.3000000000002
22708,UEEB92A,6,15000.0,2,4,15000.0,30000.0
22709,UAD1859,6,-955.0800000000003,5,1,10843.08,9888.0
22710,UEC2900,6,4979.6,2,4,7990.0,12969.6
22711,U2A1F3F,6,3.0,2,4,4997.0,5000.0
22712,UF7C240,6,805.36,4,2,759.0,1564.3600000000001
22713,UA14C76,6,-23384.0,5,1,28706.0,5322.0
22714,UE6E72B,6,-4355.860000000001,4,2,4555.860000000001,200.0
22715,U4F3A52,6,0.0,5,1,506.0,506.0
22716,UA30897,6,-10.0,4,2,10010.0,10000.0
22717,UCA2D06,6,-5832.8,5,1,5842.8,10.0
22718,U282F7B,6,-3501.4999999999995,4,2,13995.6,10494.1
22719,UEF1FA9,6,30424.1,3,3,575.9,31000.0
22720,UE71644,6,100.0,3,3,48.86,148.86
22721,U9B63BB,6,84.27000000000001,2,4,105.0,189.27
22722,UC73106,6,12.0,4,2,835.0,847.0
22723,U66B94E,6,0.0,3,3,31000.0,31000.0
22724,UA39B94,6,3549.1399999999994,4,2,5582.540000000001,9131.68
22725,U2992B3,6,-113.97000000000017,3,3,1262.2,1148.23
22726,UCBD6D9,6,151.17000000000007,4,2,2791.0,2942.17
22727,U7A3568,6,-3618.7799999999997,4,2,3799.7799999999997,181.0
22728,UFD1487,6,-4914.02,3,3,18856.0,13941.98
22729,U29C8C5,6,-3232.58,5,1,3332.58,100.0
22730,U0723F2,6,1659.0500000000002,2,4,3316.66,4975.71
22731,U13A191,6,3670.0,2,4,3666.66,7336.66
22732,UFF0454,6,-29.700000000000003,5,1,43.49,13.79
22733,U3B3BDA,6,0.0,4,2,1222.16,1222.16
22734,U20FBE7,6,0.0,3,3,54.22,54.22
22735,U8B14C6,6,-0.5,3,3,918.0,917.5
22736,UE692D3,6,3500.0,2,4,3500.0,7000.0
22737,UA1AEBD,6,8650.0,1,5,4850.0,13500.0
22738,U33D1FB,6,105.0,2,4,100.0,205.0
22739,U3619F5,6,1499.9899999999993,4,2,3354.8699999999994,4854.86
22740,UB95C8C,6,-221.25000000000006,4,2,919.7,698.45
22741,UF91D4E,6,-0.03999999999984993,4,2,719.4999999999999,719.46
22742,U18F489,6,-485.80999999999995,4,2,5415.0599999999995,4929.25
22743,UD1119B,6,-732.1199999999999,6,0,732.1199999999999,0.0
22744,U1F08EF,6,50473.83,1,5,50000.0,100473.83
22745,U20CD48,6,-149.99,3,3,153.23999999999998,3.25
22746,U1DE439,6,-5.0,4,2,5960.0,5955.0
22747,UF8EAD0,6,-3716.44,4,2,3724.59,8.149999999999999
22748,UD02B6C,6,49944.0,3,3,4002.0,53946.0
22749,U86685A,6,910.0,4,2,39830.0,40740.0
22750,UE6CADB,6,0.0,5,1,2197.32,2197.32
22751,U505579,6,-0.7400000000016007,3,3,60092.020000000004,60091.28
22752,UDCBD58,6,110.0,5,1,190.0,300.0
22753,UFBD5AF,6,0.0,4,2,888.2,888.2
22754,UEB13AC,6,0.0,4,2,1206.0,1206.0
22755,U95C72C,6,0.0,3,3,24000.0,24000.0
22756,UD21E77,6,-3791.0,4,2,15857.0,12066.0
22757,U237014,6,-201.78000000000003,5,1,221.78000000000003,20.0
22758,U925D34,6,-2492.48,4,2,3192.48,700.0
22759,U0C0742,6,509.06999999999994,2,4,2001.0,2510.07
22760,UE7971B,6,-1442.7400000000002,6,0,1442.7400000000002,0.0
22761,U6AB21B,6,-1371.9399999999998,5,1,3276.66,1904.72
22762,UB50019,6,5695.570000000001,4,2,1204.4299999999998,6900.0
22763,U3E0901,6,362.0100000000002,2,4,19299.989999999998,19662.0
22764,U55EC0D,6,-976.4500000000002,3,3,3377.32,2400.87
22765,U28EEE8,6,3624.0,2,4,5700.0,9324.0
22766,U9C755C,6,2.0,2,4,6.0,8.0
22767,U0C204E,6,212.0,3,3,194.0,406.0
22768,U1A9BE3,6,0.0,4,2,915.44,915.44
22769,UB73E07,6,0.0,3,3,19000.01,19000.01
22770,UE82D74,6,396.0,4,2,3517.0,3913.0
22771,UA135E9,6,274.39000000000004,4,2,39.77,314.16
22772,UE59E7E,6,490.06999999999994,2,4,980.06,1470.1299999999999
22773,U0ECDBF,6,-878.67,4,2,1618.34,739.67
22774,UCC2E86,6,22970.0,2,4,3030.0,26000.0
22775,U96DBC5,6,-22.0,4,2,2722.0,2700.0
22776,UEB5F2A,6,-6000.0,2,4,11300.0,5300.0
22777,U5FDBC8,6,7368.43,2,4,5000.0,12368.43
22778,U7EA7A2,6,-528.8,5,1,530.68,1.88
22779,UD0BA18,6,0.09999999999990905,4,2,3300.0,3300.1
22780,U1D1CBB,6,1.0,4,2,5.0,6.0
22781,U9F8DB9,6,-31976.24,3,3,66977.04000000001,35000.8
22782,UE715A0,6,85.57,2,4,85.57,171.14000000000001
22783,UA0E152,6,10345.25,3,3,10500.5,20845.75
22784,UDBB07E,6,1122.38,2,4,330.0,1452.38
22785,UFED8D0,6,17004.91,4,2,34990.09,51995.0
22786,U79B530,6,0.0,4,2,659.0,659.0
22787,UD9CDE2,6,2803.02,4,2,500.0,3303.02
22788,UD61677,6,-780.0,6,0,780.0,0.0
22789,UF59656,6,20.880000000000223,4,2,3558.84,3579.7200000000003
22790,U51FC7C,6,245.14999999999986,4,2,1865.15,2110.3
22791,U442F47,6,1.7053025658242404e-13,4,2,9479.939999999999,9479.94
22792,U6EE9DA,6,124.76000000000003,4,2,809.4000000000001,934.1600000000001
22793,U21EE3D,6,-0.36000000000001364,4,2,211.36,211.0
22794,U92800E,6,1113.8600000000001,4,2,336.14,1450.0
22795,UAC400C,6,0.0,4,2,3405.0,3405.0
22796,U0EB5EA,6,800.0,1,5,300.02,1100.02
22797,UF4E879,6,0.009999999999990905,3,3,617.5,617.51
22798,U624D7D,6,-40.0,5,1,340.0,300.0
22799,U188180,6,-55.340000000000146,3,3,4994.54,4939.2
22800,U3B41F1,6,-130.12,5,1,130.2,0.08
22801,U7F5021,6,0.0,4,2,12000.0,12000.0
22802,U283163,6,-9228.21,4,2,12182.1,2953.89
22803,UBDC34C,6,167.16000000000008,4,2,1166.0,1333.16
22804,UC572A5,6,0.0,4,2,708.9,708.9
22805,U307DAE,6,-668.43,5,1,2414.8599999999997,1746.43
22806,UE668B9,6,0.0,3,3,570.0,570.0
22807,UA824D3,6,-8.55,5,1,8.56,0.01
22808,U203DCE,6,68.10000000000036,3,3,18677.86,18745.96
22809,UABD48A,6,-3866.0,3,3,10866.0,7000.0
22810,U163321,6,-14251.5,6,0,14251.5,0.0
22811,U138D75,6,68.5,4,2,19731.5,19800.0
22812,U290F3F,6,3130.08,3,3,6990.0,10120.08
22813,U151040,6,34838.76,0,6,0.0,34838.76
22814,UA49C68,6,-2.7000000000000455,4,2,1562.7,1560.0
22815,U1806F1,6,-2451.0,4,2,3703.0,1252.0
22816,U815B81,6,1463.33,4,2,167.5,1630.83
22817,U87CAFF,6,204.25,1,5,204.25,408.5
22818,U1D34C8,6,-1318.71,3,3,5862.2,4543.49
22819,UE2AF92,6,-1032.0599999999995,4,2,5955.92,4923.860000000001
22820,UFF3413,6,45.53,4,2,69.47,115.0
22821,UA506D0,6,1.4600000000000364,3,3,880.21,881.67
22822,U0686B3,6,80.0,4,2,57.8,137.8
22823,UDF919A,6,-6000.0,6,0,6000.0,0.0
22824,UB3D338,6,249.88,3,3,833.12,1083.0
22825,U8C621C,6,121.68000000000018,4,2,961.6800000000001,1083.3600000000001
22826,U5C02D5,6,4440.0,4,2,4728.0,9168.0
22827,U5FF6B0,6,-906.5399999999995,3,3,2674.6899999999996,1768.15
22828,U639277,6,612.1,4,2,5287.9,5900.0
22829,U798891,6,-1442.0,4,2,2591.0,1149.0
22830,UDE3E2F,6,176092.67,3,3,30190.0,206282.67
22831,U44450B,6,-1281.67,3,3,6182.72,4901.05
22832,UDF7E36,6,-349.8,5,1,350.01,0.21
22833,UA42E0A,6,-14.92,5,1,15.0,0.08
22834,U44948B,6,-3821.17,6,0,3821.17,0.0
22835,UE2FB58,6,-9979.41,3,3,15992.0,6012.59
22836,U7B767D,6,0.0,4,2,2725.0,2725.0
22837,U4B6E08,6,0.0,4,2,14056.0,14056.0
22838,U19CC20,6,1.0600000000001302,4,2,1438.9399999999998,1440.0
22839,UC280C6,6,0.0,4,2,26010.0,26010.0
22840,U90A19D,6,2560.4,4,2,539.6,3100.0
22841,UE2615E,6,-39.71999999999999,4,2,39.8,0.08
22842,U2CF09C,6,-746.22,5,1,961.75,215.53
22843,UE6834F,6,4720.0,4,2,4950.0,9670.0
22844,UF0BEC6,6,1090.0,2,4,253.82,1343.82
22845,UBE9025,6,866.79,4,2,6486.79,7353.58
22846,U3C969D,6,0.0,4,2,109.9,109.9
22847,U1FBF7C,6,12085.0,3,3,110.0,12195.0
22848,UA6F448,6,-426.72,4,2,1752.72,1326.0
22849,U8177FE,6,-1121.3,5,1,1714.3,593.0
22850,U4ADE8C,6,1765.76,4,2,434.24,2200.0
22851,U32D77B,6,-84.8,6,0,84.8,0.0
22852,U201224,6,102.04000000000002,4,2,722.04,824.0799999999999
22853,U5F2A08,6,420.0,4,2,3230.0,3650.0
22854,U6079C4,6,21197.4,1,5,12.6,21210.0
22855,UFFBD9D,6,-43133.34,4,2,53818.34,10685.0
22856,U5CA09A,6,-70.0,4,2,16000.0,15930.0
22857,UE40841,6,-419.4,4,2,564.4,145.0
22858,U0F0A7D,6,-651.4000000000001,4,2,4631.94,3980.54
22859,UEEC0A3,6,-1.4210854715202004e-13,3,3,10713.66,10713.66
22860,UE5387C,6,-9241.400000000001,3,3,31541.4,22300.0
22861,UA5021B,6,-279.12,6,0,279.12,0.0
22862,U3C1CE1,6,6.01,4,2,2892.0,2898.01
22863,U4A9E5C,6,-121.27000000000001,4,2,166.77,45.5
22864,U386969,6,-195.0,6,0,195.0,0.0
22865,UC7607C,6,8.75,3,3,2991.84,3000.59
22866,UCD0494,6,0.0,3,3,12176.0,12176.0
22867,U94C06F,6,13964.93,2,4,4587.3,18552.23
22868,U01BAA0,6,-20.40000000000009,4,2,2592.3999999999996,2572.0
22869,UB6A319,6,158.79999999999998,1,5,12.0,170.79999999999998
22870,UEC0C41,6,0.0,4,2,25054.0,25054.0
22871,U9AC9AE,6,-2220.0,4,2,3720.0,1500.0
22872,UDF5EBC,6,-5520.0,4,2,9520.0,4000.0
22873,U61C33D,6,970.0,4,2,1051.0,2021.0
22874,UE4E47D,6,0.0,4,2,1867.2,1867.2
22875,UE7B0E9,6,-1289.5,4,2,2189.5,900.0
22876,U421A99,6,-131.92000000000002,4,2,310.05,178.13
22877,UEA173F,6,-2567.0,3,3,7829.0,5262.0
22878,U6516E3,6,-2309.3599999999997,6,0,2309.3599999999997,0.0
22879,U5014D4,6,104.0,4,2,520.0,624.0
22880,U2BB110,6,49.850000000000016,3,3,119.69999999999999,169.55
22881,UED83C8,6,-200.0,4,2,10130.0,9930.0
22882,UF0B415,6,14.400000000001,2,4,12159.7,12174.1
22883,UD921CA,6,15000.0,2,4,45000.0,60000.0
22884,UEA4998,6,-5344.96,4,2,5548.96,204.0
22885,U76DB1B,6,152.49,4,2,1172.1100000000001,1324.6
22886,U494323,6,8.000000000000004,4,2,54.269999999999996,62.269999999999996
22887,UD7256F,6,84.0,3,3,1116.0,1200.0
22888,U3EDC2B,6,29.0,3,3,87.0,116.0
22889,U40B10C,6,2001.17,2,4,2001.0,4002.1699999999996
22890,U7CA4AB,6,-5497.0,5,1,5994.040000000001,497.04
22891,UE50E32,6,2264.5,3,3,8093.0,10357.5
22892,UFDD5BC,6,-100.0,5,1,2828.0,2728.0
22893,UE766A1,6,-3117.49,4,2,4486.5599999999995,1369.07
22894,U2D19E5,6,310.0,4,2,2297.0,2607.0
22895,U2A1B50,6,3.552713678800501e-15,4,2,880.8199999999999,880.82
22896,UE26796,6,-2.7899999999999636,4,2,891.7,888.91
22897,U62C49E,6,990.27,2,4,224.48,1214.75
22898,UCE039A,6,0.0,4,2,6000.0,6000.0
22899,U7DE46A,6,9.419999999999959,3,3,1390.0,1399.42
22900,UF79A2A,6,2.842170943040401e-14,5,1,510.90999999999997,510.91
22901,UE6BAA9,6,-476.28999999999996,4,2,527.53,51.24
22902,UD3C729,6,3000.0,3,3,3600.0,6600.0
22903,U003D87,6,-103.17999999999999,6,0,103.17999999999999,0.0
22904,UC7D69C,6,0.0,3,3,16997.0,16997.0
22905,U724EAD,6,-574.85,4,2,1223.85,649.0
22906,U3524A8,6,400.0,4,2,1200.0,1600.0
22907,UD4BD46,6,-116.27000000000001,5,1,116.71000000000001,0.44
22908,UF86FAC,6,-14.720000000000027,4,2,391.72,377.0
22909,U7004C8,6,1054.0,3,3,409.0,1463.0
22910,UBC1BF4,6,-0.6299999999999955,4,2,1727.44,1726.81
22911,UBCC10B,6,0.0,4,2,2522.22,2522.22
22912,UE576D0,6,4002.2999999999997,2,4,4729.9,8732.199999999999
22913,UE491AF,6,-5.5,4,2,75.5,70.0
22914,UC846D7,6,18.0,4,2,3926.0,3944.0
22915,UC48E1A,6,4994.02,2,4,6.0,5000.02
22916,U54D98E,6,-291.0,3,3,8498.0,8207.0
22917,U9C29C0,6,-7388.0,3,3,37358.0,29970.0
22918,U0EE8A0,6,-1071.78,6,0,1071.78,0.0
22919,U9485CA,6,-150.84,6,0,150.84,0.0
22920,UB4B74E,6,-4.547473508864641e-13,4,2,2303.24,2303.24
22921,UBA2041,6,276.0,3,3,20000.0,20276.0
22922,UDCE3DC,6,-11.03,4,2,6011.03,6000.0
22923,UE0E7E6,6,52.02,3,3,75.0,127.02
22924,U6E2E18,6,0.0,4,2,4354.16,4354.16
22925,U84756F,6,120.0,3,3,110.0,230.0
22926,UBB64B8,6,1694.03,2,4,6.0,1700.03
22927,U010CF4,6,0.03999999999990678,4,2,602.52,602.56
22928,UD4C94D,6,-10100.0,4,2,20100.08,10000.08
22929,U43B6D3,6,1198.66,4,2,42.34,1241.0
22930,UE53715,6,908.3699999999999,4,2,9083.34,9991.71
22931,UDD7D98,6,269.99,3,3,140.3,410.29
22932,UEBC8BC,6,85.44,4,2,730.76,816.2
22933,UE33761,6,0.0,3,3,10000.0,10000.0
22934,U756050,6,-541.4,6,0,541.4,0.0
22935,U32AC99,6,0.0,3,3,20856.39,20856.39
22936,U1D3239,6,-825.08,6,0,825.08,0.0
22937,U1906BC,6,400.0,4,2,5900.0,6300.0
22938,UBC3891,6,0.0,4,2,1380.66,1380.66
22939,U2BAFEE,6,0.0,2,4,20000.0,20000.0
22940,UEA103B,6,-0.10000000000001208,4,2,207.10000000000002,207.0
22941,U10FFCF,6,8209.8,3,3,11589.77,19799.57
22942,U52F036,6,-4553.49,4,2,11868.0,7314.51
22943,UB7620B,6,-10695.61,6,0,10695.61,0.0
22944,U3E63F7,6,2.2737367544323206e-13,4,2,4348.02,4348.02
22945,U359FD4,6,2212.49,2,4,13883.1,16095.59
22946,U91A7D9,6,-470.94,6,0,470.94,0.0
22947,U93F87D,6,-179.20000000000002,4,2,1079.1999999999998,900.0
22948,U795AB2,6,514.63,3,3,129.78,644.41
22949,UE6924B,6,789.0,3,3,5960.0,6749.0
22950,UDF37F8,6,320.0,2,4,15480.0,15800.0
22951,U77DFF0,6,-533.119999999999,5,1,5409.22,4876.1
22952,U190D33,6,7.27612414763712e-14,3,3,15060.08,15060.08
22953,U3CAD66,6,-1782.77,6,0,1782.77,0.0
22954,U7F2CF9,6,-2816.2700000000004,3,3,4314.3,1498.03
22955,UEA40C3,6,6205.74,2,4,2010.0,8215.74
22956,U2CB359,6,-153.0,4,2,29188.0,29035.0
22957,U75C038,6,175.51000000000022,4,2,2208.0,2383.51
22958,UBB2A66,6,92.47000000000003,4,2,710.0,802.47
22959,UC39378,6,-170.0,4,2,59600.0,59430.0
22960,U4BCED0,6,1822.17,3,3,432.9,2255.07
22961,U32BA40,6,2517.9500000000003,4,2,2982.05,5500.0
22962,UEE5A64,6,-102697.34,6,0,102697.34,0.0
22963,UD05651,6,-4395.320000000001,6,0,4395.320000000001,0.0
22964,U5EDC45,6,-84.59000000000003,3,3,1799.6399999999999,1715.05
22965,U4A179D,6,340.1,4,2,110.30999999999999,450.41
22966,U562755,6,200.01,2,4,200.01,400.02
22967,UEFA8AB,6,-9.939999999999998,3,3,549.94,540.0
22968,UDD370C,6,-0.04000000000000625,4,2,183.7,183.66
22969,UF5DF0B,6,641.9300000000005,2,4,10460.0,11101.93
22970,UFD747B,6,8247.04,1,5,857.4,9104.439999999999
22971,U52119E,6,1648.2299999999996,4,2,11126.0,12774.23
22972,U8AEF91,6,-1089.2,6,0,1089.2,0.0
22973,U79AC91,6,1744.6,3,3,7840.4,9585.0
22974,U8AB882,6,-1913.7800000000002,3,3,4813.96,2900.1800000000003
22975,UC56748,6,3238.0,4,2,262.0,3500.0
22976,UF3BE3A,6,-0.5,4,2,15805.5,15805.0
22977,U39C9C3,6,3226.9300000000003,4,2,5993.16,9220.09
22978,U6A80C1,6,1030.0,4,2,6216.0,7246.0
22979,UB651E5,6,13.800000000000026,4,2,1166.8,1180.6000000000001
22980,UE98655,6,398.3600000000006,2,4,15561.35,15959.710000000001
22981,U5A2C67,6,4943.0,4,2,5145.0,10088.0
22982,U298099,6,0.0,5,1,2770.0,2770.0
22983,U8A0787,6,5.0,4,2,11610.0,11615.0
22984,U58A7F7,6,-0.0200000000000089,4,2,268.31999999999994,268.29999999999995
22985,U8B32F2,6,-4970.0,4,2,10000.0,5030.0
22986,U097FB1,6,11138.0,3,3,6362.0,17500.0
22987,U7E7F8C,6,28600.6,1,5,1000.0,29600.6
22988,UD13DAA,6,-8.881784197001252e-15,5,1,820.0,820.0
22989,U9A9BE6,6,1273.08,1,5,3.0,1276.08
22990,U3C0395,6,0.57000000000005,4,2,526.86,527.4300000000001
22991,U063775,6,-52.01000000000005,5,1,3996.3,3944.29
22992,U2EF384,6,2200.19,0,6,0.0,2200.19
22993,UC4297F,6,1000.0,3,3,2000.02,3000.02
22994,U87D346,6,17.549999999999955,4,2,4010.0,4027.55
22995,UE71911,6,-512.66,6,0,512.66,0.0
22996,UD557E6,6,-4849.95,3,3,14480.0,9630.05
22997,UE89E7D,6,0.42,3,3,4005.55,4005.9700000000003
22998,UCE16B9,6,4998.0,1,5,25000.0,29998.0
22999,UEC1685,6,5667.1,1,5,0.01,5667.110000000001
23000,U4C46C0,6,1.4210854715202004e-13,4,2,3119.54,3119.54
23001,UCA7346,6,-3.0,4,2,15003.0,15000.0
23002,U575985,6,1924.6399999999994,2,4,17300.0,19224.64
23003,UB7D64D,6,-21688.55,5,1,23900.0,2211.45
23004,U64E5F7,6,-2200.0,5,1,4600.0,2400.0
23005,UF8DE8D,6,211.45999999999987,4,2,4288.54,4500.0
23006,U101CE5,6,-47.700000000000045,4,2,1390.0,1342.3
23007,U9FB609,6,1174.5,4,2,5825.5,7000.0
23008,U3E5B18,6,20990.0,1,5,20999.0,41989.0
23009,U17E92A,6,1999.9999999999998,4,2,4094.48,6094.48
23010,U6FF927,6,0.0,4,2,2154.32,2154.32
23011,UFF7D05,6,-0.30000000000000426,4,2,39.42,39.12
23012,U82369B,6,-310.0,4,2,5410.0,5100.0
23013,UD023EE,6,-3893.0,4,2,11461.0,7568.0
23014,U7054A1,6,-4214.91,6,0,4214.91,0.0
23015,UF52461,6,0.0,4,2,12000.0,12000.0
23016,U70BABF,6,162.0,4,2,23038.0,23200.0
23017,U63ABAB,6,0.0,2,4,6000.0,6000.0
23018,UE43D6C,6,2970.8599999999997,3,3,1033.0,4003.8599999999997
23019,U35431E,6,1205.0,1,5,10.0,1215.0
23020,U4A7CBF,6,-60.0,6,0,60.0,0.0
23021,U069F63,6,-2827.15,6,0,2827.15,0.0
23022,UE6EE79,6,29935.559999999998,2,4,241.0,30176.559999999998
23023,U46F9FD,6,18914.0,2,4,1700.0,20614.0
23024,UF7E4D8,6,-1063.64,5,1,2887.6400000000003,1824.0
23025,UF2B201,6,1.1368683772161603e-13,4,2,1762.6999999999998,1762.7
23026,U3D2D81,6,-2883.73,2,4,6000.0,3116.2700000000004
23027,U9A4D94,6,5046.040000000001,3,3,5010.0,10056.04
23028,U0C2729,6,-178.0,3,3,238.0,60.0
23029,U27A50C,6,-4985.5,4,2,16488.28,11502.78
23030,UCBA93A,6,-3683.5499999999993,6,0,3683.5499999999993,0.0
23031,UA4FD6B,6,-16.410000000000025,5,1,476.6,460.19
23032,UABF08A,6,5942.05,3,3,500.0,6442.05
23033,U7E749B,6,936.0,4,2,1614.0,2550.0
23034,UE376D6,6,26.720000000000006,5,1,973.28,1000.0
23035,U9F0EF2,6,386.0,4,2,2018.58,2404.58
23036,U3745B3,6,9240.94,5,1,759.0600000000001,10000.0
23037,U631B11,6,252.05999999999995,3,3,14000.0,14252.06
23038,UC3A374,6,-21369.95,3,3,26250.0,4880.05
23039,UA47788,6,0.01,2,4,14000.0,14000.01
23040,U231F51,6,-36.86,5,1,37.0,0.14
23041,UD47A90,6,66.27999999999997,5,1,1933.72,2000.0
23042,UB69615,6,0.0,4,2,294.0,294.0
23043,UC8FEA8,6,0.0,3,3,122.7,122.7
23044,UCC9B83,6,-112.34000000000015,4,2,1762.3400000000001,1650.0
23045,UCD68C0,6,5588.0,2,4,10.0,5598.0
23046,UEEA423,6,-200.0,4,2,7010.0,6810.0
23047,UA87466,6,729.85,3,3,111.41,841.26
23048,U55C1D8,6,-19797.0,3,3,20010.0,213.0
23049,U02C6BE,6,-77.13,5,1,207.57000000000002,130.44
23050,U364CF6,6,-352.8,5,1,490.79,137.99
23051,UD99E27,6,2474.74,4,2,1586.42,4061.16
23052,U3C46C2,6,-28.90000000000009,2,4,4529.34,4500.4400000000005
23053,U37CF2A,6,7000.0,3,3,20000.0,27000.0
23054,UFEFD4B,6,-483.3299999999999,4,2,7566.66,7083.33
23055,UA9196C,6,-10788.54,3,3,15800.01,5011.469999999999
23056,U93ADDF,6,-675.46,6,0,675.46,0.0
23057,U776111,6,792.98,4,2,885.0,1677.98
23058,U3B72C8,6,-36.51000000000022,4,2,8010.0,7973.49
23059,U4F1AB2,6,5919.01,3,3,24059.0,29978.01
23060,UD0EFC7,6,-9116.0,4,2,10819.0,1703.0
23061,U08BD69,6,19641.57,4,2,15373.43,35015.0
23062,U879A6F,6,0.010000000000218279,4,2,8691.99,8692.0
23063,U86A199,6,8062.46,3,3,1339.92,9402.38
23064,UACC0D9,6,0.0,4,2,24000.0,24000.0
23065,UC2A867,6,4460.4,4,2,539.6,5000.0
23066,U3A2AAD,6,10.0,3,3,16000.0,16010.0
23067,UDDD19E,6,18.0,3,3,23982.0,24000.0
23068,UD9EAA6,6,-9500.0,5,1,17000.0,7500.0
23069,U90367E,6,80.02,3,3,1010.01,1090.03
23070,U38BE32,6,91.77999999999997,5,1,1286.0,1377.78
23071,U1CD9F3,6,0.0,4,2,1088.16,1088.16
23072,U59714B,6,-23304.93,6,0,23304.93,0.0
23073,U29EC0D,6,-3000.0,4,2,5647.0,2647.0
23074,U12562C,6,1499.3799999999999,4,2,8263.0,9762.380000000001
23075,U8A64BE,6,-1600.0,4,2,7600.0,6000.0
23076,U7FC532,6,-2090.75,4,2,2107.5600000000004,16.81
23077,UCC1AD5,6,-9.15,4,2,9.5,0.35
23078,U5F3A30,6,-1100.7000000000025,3,3,35500.0,34399.299999999996
23079,U3B5ABC,6,-441.68,6,0,441.68,0.0
23080,U6192D0,6,977.4699999999998,3,3,3330.0,4307.469999999999
23081,U2198AA,6,-848.19,6,0,848.19,0.0
23082,U55549E,6,75.0,2,4,19935.0,20010.0
23083,U43009E,6,2016.1299999999999,3,3,301.5,2317.63
23084,U6EFD3F,6,180.01,3,3,20.0,200.01
23085,U5F6A13,6,-21.0,6,0,21.0,0.0
23086,UF24A30,6,598.02,4,2,30.0,628.02
23087,UFEEBE9,6,3383.73,3,3,858.27,4242.0
23088,U484380,6,761.8000000000002,3,3,9215.2,9977.0
23089,UA4CEAA,6,-246.68000000000006,4,2,1287.68,1041.0
23090,U630872,6,39040.3,0,6,0.0,39040.3
23091,U401A86,6,4500.66,4,2,164.82999999999998,4665.49
23092,U3508CD,6,-2191.4900000000002,5,1,2350.09,158.6
23093,U66E3C5,6,7554.84,4,2,5525.16,13080.0
23094,U110CBC,6,305.4200000000001,4,2,220.16,525.58
23095,UECFE28,6,1010.8500000000004,3,3,9540.0,10550.85
23096,UDD2FFF,6,86.65000000000009,4,2,620.0,706.6500000000001
23097,U43EA88,6,7752.8,2,4,7756.0,15508.8
23098,U8E6FC2,6,-7205.439999999999,4,2,9804.199999999999,2598.76
23099,U7261E1,6,-866.14,4,2,881.16,15.02
23100,U64EE0F,6,-23887.420000000002,1,5,30000.0,6112.58
23101,U22766B,6,-3688.34,5,1,3788.34,100.0
23102,UA73E4C,6,-9.60000000000003,4,2,916.6,907.0
23103,UB68FF9,6,1293.0,3,3,8873.0,10166.0
23104,U9F853E,6,-91.0,5,1,139.0,48.0
23105,U5DA957,6,-75.0,4,2,10810.0,10735.0
23106,U81ABFF,6,83.39999999999998,4,2,705.0,788.4
23107,U8AB9A7,6,1028.02,1,5,435.82,1463.84
23108,U5B3479,6,690.0,4,2,5250.0,5940.0
23109,UAE42B2,6,-1.0799999999999272,3,3,5011.08,5010.0
23110,U468D00,6,-2589.6400000000003,5,1,2689.6400000000003,100.0
23111,U10456C,6,4175.25,1,5,224.75,4400.0
23112,UD75816,6,489.21,3,3,14.170000000000002,503.38
23113,UF5EDD8,6,-1502.13,4,2,1655.27,153.14000000000001
23114,UD3F0AE,6,-1820.0,3,3,19420.0,17600.0
23115,U123EEC,6,2168.07,3,3,2058.0,4226.07
23116,UE26D0B,6,4958.120000000001,1,5,10000.0,14958.12
23117,UC32A41,6,120.0,5,1,680.0,800.0
23118,UC38FB7,6,-0.05000000000001137,4,2,419.27,419.22
23119,U6644B6,6,-100.0,3,3,11950.0,11850.0
23120,UE24836,6,9.689999999999818,3,3,4570.31,4580.0
23121,UA840AE,6,-19004.0,6,0,19004.0,0.0
23122,U3A632B,6,-180.94,6,0,180.94,0.0
23123,U1C17A5,6,-1188.0,2,4,39298.0,38110.0
23124,UFBE53F,6,4159.2300000000005,3,3,318.4,4477.63
23125,UEFEEEF,6,1452.0,4,2,4848.0,6300.0
23126,U7A06C0,6,-18.929999999999993,4,2,140.03000000000003,121.10000000000001
23127,U1AD40A,6,-181.82999999999987,4,2,11057.34,10875.51
23128,U1D0463,6,-1.0658141036401503e-14,4,2,428.58000000000004,428.58
23129,U854CAC,6,1873.4,4,2,376.6,2250.0
23130,U3B4402,6,56.879999999999995,3,3,589.01,645.89
23131,U835B79,6,-2.2737367544323206e-13,4,2,2241.2000000000003,2241.2
23132,UFED9E4,6,-65.63999999999942,2,4,12904.0,12838.36
23133,U9CD8FC,6,2200.040000000001,2,4,22000.0,24200.04
23134,UAA9719,6,9862.14,3,3,7574.0,17436.14
23135,U066BBA,6,113.97999999999999,3,3,630.0,743.98
23136,U7B859B,6,125.34999999999991,4,2,2309.0,2434.35
23137,U9E152A,6,3517.92,4,2,491.08,4009.0
23138,UD95EFB,6,0.5300000000000011,4,2,228.94,229.47
23139,U5B9592,6,705.37,2,4,2326.0,3031.37
23140,UD9DE97,6,-7538.0,4,2,10434.98,2896.98
23141,U111A4D,6,-99.0,4,2,10149.0,10050.0
23142,UF7597A,6,0.18000000000000682,4,2,3395.6400000000003,3395.82
23143,U39A9F9,6,-49914.66,6,0,49914.66,0.0
23144,UBECA64,6,-8559.060000000001,6,0,8559.060000000001,0.0
23145,U5C0DEC,6,-1749.21,4,2,3504.66,1755.4499999999998
23146,U5C0000,6,0.7299999999999898,2,4,325.29,326.02
23147,U9BD407,6,-4477.67,6,0,4477.67,0.0
23148,U65B5D0,6,-1179.35,6,0,1179.35,0.0
23149,UF5C776,6,88.58999999999949,2,4,6000.0,6088.589999999999
23150,U7318EE,6,524.6400000000003,4,2,4475.36,5000.0
23151,U8D2678,6,2976.8100000000004,4,2,756.02,3732.83
23152,U97E9D3,6,59000.0,1,5,80.0,59080.0
23153,U6C06C6,6,-15700.0,3,3,40200.0,24500.0
23154,U8A87A1,6,0.22000000000025466,4,2,4719.78,4720.0
23155,U044D80,6,4709.91,3,3,129.0,4838.91
23156,U15CB8C,6,-239.34,6,0,239.34,0.0
23157,U3B27CD,6,2.0,3,3,5798.0,5800.0
23158,UF57090,6,35042.26,4,2,49957.74,85000.0
23159,UF71583,6,-1799.98,3,3,2144.0,344.02
23160,U22DA55,6,-4820.86,6,0,4820.86,0.0
23161,U37A9F1,6,3775.830000000001,4,2,5703.8,9479.630000000001
23162,UBEC118,6,-2500.0,3,3,80500.0,78000.0
23163,U4B8350,6,0.0,3,3,1753.37,1753.37
23164,U24F2AD,6,22230.0,1,5,23950.0,46180.0
23165,U9B4955,6,-313.84000000000003,3,3,771.98,458.14
23166,U4A5254,6,0.0,3,3,6000.0,6000.0
23167,U1E8347,6,100.0,3,3,4.0,104.0
23168,U927F58,6,515.87,4,2,496.34000000000003,1012.21
23169,UBE40D6,6,-7.18,4,2,941.19,934.01
23170,UE5FA2E,6,22258.77,2,4,8733.35,30992.120000000003
23171,UCB287F,6,891.0,3,3,991.0,1882.0
23172,U44C73A,6,0.0,3,3,9000.0,9000.0
23173,UE2CEC6,6,-47.1,4,2,137.72,90.62
23174,U0A1C43,6,199.0,2,4,627.59,826.59
23175,U6AAE95,6,-0.060000000000000005,6,0,0.060000000000000005,0.0
23176,UBC362C,6,-74.08,5,1,74.09,0.01
23177,UA178DE,6,-18989.24,4,2,19989.24,1000.0
23178,U414FB7,6,20000.0,3,3,9959.82,29959.82
23179,U3D5EAE,6,-209.39999999999998,4,2,593.07,383.66999999999996
23180,U3F45E8,6,-648.5,4,2,1548.5,900.0
23181,UDE8B4A,6,9403.1,4,2,1536.9,10940.0
23182,UDC9740,6,-3.6799999999999997,3,3,15.0,11.32
23183,UE6CE39,6,4138.71,4,2,1975.0,6113.71
23184,U6DA6CA,6,39.2000000000005,4,2,3377.4999999999995,3416.7
23185,U6D44B5,6,5289.44,2,4,800000.0,805289.44
23186,UEC9086,6,-5510.679999999999,4,2,5910.679999999999,400.0
23187,U52012A,6,-11845.490000000002,4,2,22778.8,10933.31
23188,UF88CC9,6,-0.12000000000000455,4,2,717.1199999999999,717.0
23189,U225599,6,3.552713678800501e-15,4,2,253.46,253.46
23190,U98B696,6,-5575.529999999999,3,3,35656.979999999996,30081.45
23191,U10FC14,6,-7699.1,5,1,10979.1,3280.0
23192,UE729E3,6,2704.800000000001,4,2,11747.9,14452.7
23193,UE1A9C7,6,-8440.69,1,5,23000.0,14559.31
23194,UCCBFFD,6,0.9899999999997817,2,4,5800.0,5800.99
23195,UCA4345,6,-363.41999999999996,5,1,402.41999999999996,39.0
23196,UDEA616,6,7740.0,1,5,7960.0,15700.0
23197,U191581,6,-253.60000000000002,4,2,539.6,286.0
23198,UDB4CDD,6,7188.26,3,3,61.959999999999994,7250.22
23199,UD63348,6,5202.59,2,4,10459.72,15662.310000000001
23200,UC0DE52,6,-6988.8,3,3,8000.0,1011.2
23201,U3785F9,6,-100.0,5,1,2193.59,2093.59
23202,U825AF2,6,-6400.0,3,3,8000.0,1600.0
23203,U5C0844,6,-2.2737367544323206e-13,4,2,1272.48,1272.48
23204,U3BFA78,6,-6060.0,6,0,6060.0,0.0
23205,U55EE27,6,17673.59,1,5,500000.0,517673.59
23206,UFDF063,6,-271.0,3,3,9800.0,9529.0
23207,U361F81,6,1701.1699999999998,4,2,1798.66,3499.83
23208,U0E9F2B,6,887.82,3,3,2745.4300000000003,3633.25
23209,U423C2A,6,-484.42,6,0,484.42,0.0
23210,U8FE9F7,6,2141.87,2,4,1998.9,4140.77
23211,U85A822,6,-2860.0,2,4,14860.0,12000.0
23212,U8A5D00,6,3790.0,2,4,5210.0,9000.0
23213,U8D217C,6,1100.0,4,2,399.99999999999994,1500.0
23214,UF840EF,6,-3366.1000000000004,5,1,3786.1000000000004,420.0
23215,UE70998,6,706.1700000000001,3,3,5823.83,6530.0
23216,U2027CE,6,-6504.200000000001,5,1,8428.2,1924.0
23217,U6C2235,6,25.459999999999127,2,4,24225.0,24250.46
23218,U5165FF,6,31.9,3,3,20.6,52.5
23219,U4AC597,6,1469.0,4,2,20156.0,21625.0
23220,UC2BA42,6,-1399.5,5,1,1531.5,132.0
23221,UC20C8D,6,-4010.6299999999997,4,2,8021.639999999999,4011.01
23222,UE84560,6,16759.21,0,6,0.0,16759.21
23223,UEA9020,6,23791.0,1,5,7400.0,31191.0
23224,U6E9777,6,-574.4200000000001,6,0,574.4200000000001,0.0
23225,U4FDAEC,6,4395.0,2,4,248.11,4643.11
23226,U0DAEC4,6,787.4999999999997,3,3,4316.5,5104.0
23227,UF0A76A,6,1402.0,2,4,5098.0,6500.0
23228,UB7BCDE,6,219.87,2,4,91.87,311.74
23229,U278193,6,-2048.0,4,2,3198.0,1150.0
23230,U1F1932,6,-29544.15,3,3,89320.0,59775.85
23231,UEA0439,6,5617.78,3,3,554.0,6171.78
23232,U7B862C,6,-830.0,6,0,830.0,0.0
23233,U71149C,6,12.0,2,4,10000.0,10012.0
23234,U5D965D,6,66.51,2,4,86.5,153.01
23235,UED51C0,6,-183.28,5,1,217.78,34.5
23236,U1DAF55,6,-138.0,3,3,1985.0,1847.0
23237,U6BEDA9,6,5345.95,4,2,3072.0,8417.95
23238,U41000E,6,579.0400000000001,5,1,835.13,1414.17
23239,U99D206,6,-15146.56,6,0,15146.56,0.0
23240,U7A7280,6,-699.3599999999999,6,0,699.3599999999999,0.0
23241,UE759D1,6,-6113.0,3,3,9400.99,3287.99
23242,UE8C2E0,6,-562.1100000000001,4,2,1609.98,1047.87
23243,U4D3535,6,-371.51,4,2,712.14,340.63
23244,UC11738,6,-0.6200000000000045,3,3,503.55,502.93
23245,U2AC675,6,-1.0,4,2,1012.0,1011.0
23246,U426179,6,-284.1,6,0,284.1,0.0
23247,U8E1051,6,128.0,5,1,282.0,410.0
23248,U5BB6DD,6,-1500.0,3,3,30010.0,28510.0
23249,UFE0C43,6,249.26000000000008,2,4,461.34,710.6
23250,U50B70A,6,1791.38,4,2,108.62,1900.0
23251,U2021F2,6,0.0,4,2,24010.0,24010.0
23252,U3ED36F,6,-9702.0,4,2,20602.0,10900.0
23253,UA1BCDB,6,278.0999999999999,3,3,2076.9,2355.0
23254,U2E04F3,6,389.02,4,2,287.98,677.0
23255,UC7C743,6,13728.880000000001,4,2,3088.12,16817.0
23256,UA177C6,6,369.9000000000001,4,2,2810.1,3180.0
23257,U6D0048,6,500.0,4,2,2210.0,2710.0
23258,UB2450E,6,1430.0,4,2,620.0,2050.0
23259,U14EE87,6,0.0,4,2,29.0,29.0
23260,UF5E043,6,2775.13,3,3,2405.0,5180.13
23261,UBB547F,6,-499.6,4,2,539.5999999999999,40.0
23262,U85E7A8,6,-107.96000000000001,4,2,326.98,219.01999999999998
23263,UF414C3,6,-2849.72,4,2,3250.0,400.28
23264,U816D57,6,-200.0,4,2,1400.0,1200.0
23265,U636410,6,0.33999999999650754,2,4,33700.0,33700.34
23266,U2A6FC8,6,474.0,2,4,10.0,484.0
23267,U592B7B,6,-219.83999999999997,4,2,853.6700000000001,633.83
23268,UE28EE7,6,0.0,4,2,1891.6599999999999,1891.66
23269,U4AF0CC,6,-10.0,4,2,20520.0,20510.0
23270,U33A27C,6,5584.9,4,2,5.0,5589.9
23271,U52C487,6,0.0,4,2,110.6,110.6
23272,UF71FFC,6,-34.98999999999978,3,3,5624.0,5589.01
23273,UE8D406,6,-10006.15,5,1,10286.15,280.0
23274,U199610,6,0.0,5,1,8192.0,8192.0
23275,UC6B0EC,6,820.0,3,3,21930.0,22750.0
23276,U4C7AA0,6,46324.11,2,4,499.0,46823.11
23277,U9B0170,6,0.1100000000000864,2,4,1399.08,1399.19
23278,UDDB513,6,190.01,2,4,1669.0,1859.01
23279,UFAEDA6,6,30.050000000000182,4,2,2535.0,2565.05
23280,U3C58DD,6,10135.0,2,4,10.0,10145.0
23281,U354864,6,-9144.709999999997,4,2,9544.709999999997,400.0
23282,U3521DF,6,-3607.0200000000004,4,2,12607.02,9000.0
23283,UDB30D1,6,-109.94999999999999,3,3,610.0,500.05
23284,UA7A7A8,6,-34.85,3,3,89.71000000000001,54.86
23285,U0E3D19,6,-1019.69,5,1,1019.71,0.02
23286,UEA6FD9,6,-19.0,3,3,5835.0,5816.0
23287,U0973D6,6,10.480000000000004,2,4,66.0,76.48
23288,U4557F2,6,-2798.5,3,3,6025.24,3226.74
23289,UD8775A,6,178.45,4,2,366.0,544.45
23290,U20221C,6,-935.0799999999999,4,2,1457.08,522.0
23291,U51CDB2,6,0.0,3,3,6000.0,6000.0
23292,U96A36E,6,80.0,3,3,9920.0,10000.0
23293,U49209E,6,22043.0,0,6,0.0,22043.0
23294,UA325E0,6,1168.73,4,2,189.34,1358.07
23295,U0ED2F1,6,-441.50000000000006,5,1,868.2099999999999,426.71
23296,U4FC771,6,0.2699999999999818,2,4,3326.5299999999997,3326.8
23297,UDA291F,6,-5437.5,4,2,6275.4,837.9
23298,UEB3D03,6,-2.1000000000000014,5,1,35.120000000000005,33.02
23299,U57C3A8,6,-230.0,3,3,2390.0,2160.0
23300,UCD1E1E,6,-18997.14,4,2,23000.0,4002.86
23301,UF95B01,6,-347.92,6,0,347.92,0.0
23302,UC55CED,6,1658.5,1,5,1499.5,3158.0
23303,U5D8A88,6,8365.0,0,6,0.0,8365.0
23304,UC2D14D,6,-3230.6399999999994,2,4,13736.48,10505.84
23305,UFC5D9C,6,-1163.34,3,3,1737.0,573.6600000000001
23306,UA9D1C4,6,308.45,3,3,388.81,697.26
23307,UC14B6A,6,-20.019999999999996,4,2,217.6,197.57999999999998
23308,U9FC29C,6,50000.0,1,5,26000.0,76000.0
23309,U3CF27C,6,4.973799150320701e-14,4,2,612.84,612.84
23310,UB2CACA,6,1617.3000000000002,3,3,4000.0,5617.3
23311,UDABBDF,6,-34066.09,4,2,34816.09,750.0
23312,U1F8274,6,-18129.54,4,2,18279.54,150.0
23313,UF1CD58,6,775.01,3,3,619.8,1394.81
23314,U849825,6,-620.48,4,2,1721.48,1101.0
23315,UA95188,6,-678.86,5,1,1102.8600000000001,424.0
23316,U0BDE0C,6,2456.9500000000003,1,5,3770.3,6227.25
23317,U157D77,6,613.9599999999999,2,4,2799.0,3412.9600000000005
23318,U868440,6,502.71,3,3,319.29,822.0
23319,U5D55FB,6,-1.1368683772161603e-13,4,2,851.0400000000001,851.04
23320,U2CDA24,6,-44.44,6,0,44.44,0.0
23321,U3C9B79,6,-664.9200000000001,3,3,738.08,73.16
23322,UB5D899,6,-204.48000000000002,5,1,520.0,315.52
23323,U29144B,6,33157.53,0,6,0.0,33157.53
23324,UC867BE,6,11598.130000000001,2,4,2.0,11600.130000000001
23325,U1C779D,6,-862.3699999999999,2,4,2257.37,1395.0
23326,UAB4FDD,6,-1680.9,6,0,1680.9,0.0
23327,U3E368F,6,-2379.25,4,2,2680.0200000000004,300.77
23328,U72614F,6,82.12,4,2,343.0,425.12
23329,U2178FB,6,7743.79,4,2,5190.21,12934.0
23330,U8B4BF1,6,-1198.0,3,3,4947.33,3749.33
23331,UF7B5D5,6,0.0,5,1,30.0,30.0
23332,UAF3F44,6,-7741.09,6,0,7741.09,0.0
23333,U4A1E15,6,2925.58,2,4,374.42,3300.0
23334,U1A90A8,6,-1089.2,6,0,1089.2,0.0
23335,U63FBEB,6,4771.8,4,2,1222.0,5993.8
23336,UA5F075,6,-19735.2,6,0,19735.2,0.0
23337,U83FCBA,6,-11949.37,6,0,11949.37,0.0
23338,U93D006,6,490.03,2,4,10.0,500.03
23339,UFF08AE,6,-937.88,4,2,1282.0,344.12
23340,U22B847,6,-590.0000000000009,3,3,17631.8,17041.8
23341,U33B9EA,6,-1770.92,4,2,2710.0,939.08
23342,UB66A02,6,-860.2900000000002,4,2,1719.3999999999999,859.11
23343,U31617E,6,212.87,4,2,532.0,744.87
23344,UF8817A,6,-3097.99,5,1,6097.99,3000.0
23345,U37D720,6,3.699999999999993,3,3,928.4300000000001,932.13
23346,UE98B70,6,0.0,4,2,830.4999999999999,830.5
23347,U4E1516,6,24.890000000000327,2,4,10000.0,10024.89
23348,U1DB3E7,6,-1.9600000000000364,4,2,4255.0,4253.04
23349,U8A7A98,6,7737.820000000001,2,4,1548.21,9286.03
23350,UBDD467,6,-10.0,4,2,10010.0,10000.0
23351,UAD9D52,6,0.2799999999999727,4,2,2044.72,2045.0
23352,UDF6882,6,-4049.29,4,2,7523.84,3474.55
23353,U37AC4A,6,-5808.53,2,4,9518.53,3710.0
23354,UA7F7C4,6,-23.25,4,2,88.57,65.32000000000001
23355,U777CA2,6,-49730.17,5,1,49775.04,44.87
23356,U9959F9,6,-10000.0,4,2,30000.0,20000.0
23357,UA293CF,6,4555.14,4,2,261.25,4816.39
23358,U8084BB,6,860.0,4,2,3240.0,4100.0
23359,U95FA24,6,-0.5399999999999636,4,2,7063.37,7062.83
23360,U9051D5,6,287.0,4,2,2000.0,2287.0
23361,UD5B5B6,6,-2.2737367544323206e-13,4,2,1782.2400000000002,1782.24
23362,U79EA6E,6,1101.6599999999999,4,2,98.34,1200.0
23363,U6AD435,6,-170.0,3,3,6200.0,6030.0
23364,UD4D853,6,8148.120000000001,3,3,12076.3,20224.42
23365,U488778,6,-837.8699999999999,4,2,6121.87,5284.0
23366,U1B2B9A,6,2998.34,4,2,958.0,3956.34
23367,UDA3385,6,-2200.0,6,0,2200.0,0.0
23368,UAFE693,6,13.000000000000028,4,2,249.62,262.62
23369,UCE0950,6,-6539.74,6,0,6539.74,0.0
23370,U2BB0EC,6,500.15,2,4,1000.15,1500.3
23371,U1118D0,6,3868.8599999999997,4,2,634.0,4502.86
23372,U624B5C,6,442.9299999999994,4,2,16240.96,16683.89
23373,U18BA82,6,1511.5099999999995,4,2,11504.8,13016.31
23374,UF693FD,6,-830.8599999999998,5,1,1461.7199999999998,630.86
23375,U259BB8,6,-1280.78,3,3,20281.0,19000.22
23376,U631CA0,6,846.0,3,3,610.0,1456.0
23377,UC1BF9D,6,-1211.5199999999998,6,0,1211.5199999999998,0.0
23378,U6E7074,6,-99.98000000000002,4,2,547.6400000000001,447.66
23379,UA6005C,6,570.0,3,3,4170.0,4740.0
23380,UF0A044,6,866.0499999999998,3,3,846.72,1712.77
23381,U848CD7,6,-277.15000000000003,4,2,476.65000000000003,199.5
23382,U25BD9E,6,-9997.630000000001,3,3,10002.0,4.369999999999999
23383,U6E32ED,6,-4583.0,4,2,12383.0,7800.0
23384,UDC6E53,6,100.0,3,3,46100.0,46200.0
23385,UFF06E3,6,800.6599999999964,2,4,60927.09,61727.75
23386,U0C3B46,6,2771.0,0,6,0.0,2771.0
23387,UF46C6E,6,15.0,3,3,11985.0,12000.0
23388,U28337D,6,-59.280000000000015,5,1,99.28000000000002,40.0
23389,U1C279F,6,-2299.42,6,0,2299.42,0.0
23390,U5B1624,6,3800.0,0,6,0.0,3800.0
23391,U4AFAAB,6,230.1199999999999,3,3,11272.880000000001,11503.0
23392,U338749,6,271.0,4,2,8729.0,9000.0
23393,U63D2BD,6,7.105427357601002e-15,5,1,51.919999999999995,51.92
23394,UE6A856,6,610.6199999999999,3,3,16.0,626.6199999999999
23395,U465B52,6,31.110000000000014,4,2,722.6999999999999,753.81
23396,U90AF90,6,-12491.559999999998,3,3,392500.0,380008.44
23397,U624357,6,-1002.9700000000003,4,2,15801.0,14798.029999999999
23398,U933EFA,6,-4.249999999999991,3,3,214.32,210.07
23399,U5C1591,6,1716.0,4,2,6084.0,7800.0
23400,UFF2790,6,4761.33,5,1,638.67,5400.0
23401,U6895C8,6,3659.0,5,1,2941.0,6600.0
23402,UD14C2D,6,0.0,4,2,642.0,642.0
23403,U2BF90C,6,-32718.16,3,3,34431.979999999996,1713.82
23404,UD4C7A1,6,-2.6400000000000006,3,3,113.00999999999999,110.37
23405,UA969AF,6,-9.899999999999977,4,2,1029.7,1019.8
23406,U4130FA,6,12245.48,4,2,3954.5200000000004,16200.0
23407,U6DE396,6,5.684341886080802e-14,4,2,296.09999999999997,296.1
23408,UC508EF,6,-3165.0,3,3,9495.18,6330.18
23409,U45836F,6,-551.12,6,0,551.12,0.0
23410,U28D2D8,6,361.4200000000001,4,2,4531.58,4893.0
23411,UFDEB99,6,0.0,4,2,2344.9,2344.9
23412,UA43D7F,6,-3052.78,4,2,6305.56,3252.78
23413,UE762BB,6,11.920000000000044,4,2,5288.08,5300.0
23414,U971312,6,-3721.0,3,3,8973.0,5252.0
23415,U4D85B9,6,5043.32,4,2,456.68,5500.0
23416,U9C4D43,6,-10012.599999999999,3,3,14912.919999999998,4900.32
23417,U8179D7,6,-900.9200000000002,4,2,3031.13,2130.21
23418,UC67BEA,6,595.0,3,3,19155.0,19750.0
23419,U5E0EDD,6,0.0,3,3,5943.0,5943.0
23420,U7E1233,6,263.99999999999994,4,2,3469.61,3733.6099999999997
23421,U120D3D,6,42080.0,2,4,5720.0,47800.0
23422,UFC06F1,6,-653.6,6,0,653.6,0.0
23423,U422BCB,6,-28.1899999999996,2,4,9579.310000000001,9551.12
23424,U5DE1C4,6,-495.9200000000001,3,3,6990.0,6494.08
23425,U93AE78,6,6483.03,1,5,6218.0,12701.03
23426,UF70578,6,355.0899999999998,4,2,1995.1100000000001,2350.2
23427,U8141BC,6,9792.0,2,4,9792.0,19584.0
23428,U73C312,6,-19.0,3,3,8720.0,8701.0
23429,UC39C44,6,-1097.1100000000004,4,2,3542.7000000000003,2445.59
23430,U6DC356,6,367.98,2,4,61.22,429.20000000000005
23431,U03F9D2,6,-601.4000000000015,4,2,20103.5,19502.1
23432,U9CAEF2,6,146.0,4,2,9586.0,9732.0
23433,U2D62DC,6,900.26,4,2,699.74,1600.0
23434,UF233B1,6,336.4600000000013,3,3,30700.0,31036.460000000003
23435,UE2D97A,6,157.3999999999998,5,1,1139.1900000000003,1296.59
23436,UAB8AF7,6,1465.81,3,3,2245.0,3710.81
23437,UEE1806,6,1218.0,4,2,6576.0,7794.0
23438,UC65229,6,-1.2199999999994589,4,2,4921.22,4920.0
23439,U7CE524,6,23.0,4,2,2030.0,2053.0
23440,UBA368B,6,-28.13000000000011,3,3,7040.0,7011.87
23441,U9EF384,6,86.01000000000002,4,2,475.86,561.87
23442,UDACDA0,6,1822.0,3,3,4078.0,5900.0
23443,UFF54C7,6,10222.0,4,2,12.0,10234.0
23444,UE0246B,6,212.60000000000002,4,2,98.7,311.3
23445,UBE9FBE,6,-2258.67,6,0,2258.67,0.0
23446,U57153A,6,840.1999999999998,3,3,2202.0,3042.2
23447,U95047B,6,2.842170943040401e-14,4,2,353.9,353.9
23448,U770B04,6,-13616.05,6,0,13616.05,0.0
23449,U066093,6,-1047.3400000000001,6,0,1047.3400000000001,0.0
23450,UDFA276,6,-6.100000000000023,4,2,746.1,740.0
23451,U5C2EE2,6,-869.8,5,1,870.3299999999999,0.53
23452,U4F6467,6,-159.88000000000005,5,1,2959.88,2800.0
23453,UD09490,6,9007.04,4,2,6692.96,15700.0
23454,U2D8167,6,-341.06999999999994,4,2,415.79999999999995,74.73
23455,U257533,6,-374.0,4,2,5774.0,5400.0
23456,U26CEA7,6,200.73,2,4,376.0,576.73
23457,U87E1C8,6,-1894.8,4,2,4006.8,2112.0
23458,UFF7044,6,20976.460000000003,2,4,1144.0,22120.460000000003
23459,UE7C98F,6,-10.96,4,2,12.0,1.04
23460,UA8D4B5,6,71.0,3,3,5929.0,6000.0
23461,UF33A04,6,-6.0,4,2,8006.0,8000.0
23462,U64A2F5,6,-0.9800000000000022,3,3,22.97,21.990000000000002
23463,UCD28D1,6,-1164.6599999999999,4,2,16154.66,14990.0
23464,U90E9EC,6,-4867.24,6,0,4867.24,0.0
23465,UC112E5,6,-4799.58,3,3,21000.0,16200.42
23466,UA6A9D9,6,0.0,3,3,10000.0,10000.0
23467,UBE2200,6,-9889.28,5,1,10998.56,1109.28
23468,U3FEE7C,6,19183.0,1,5,1000.0,20183.0
23469,U7E6120,6,-16650.200000000004,4,2,19289.200000000004,2639.0
23470,UC9050D,6,17.399999999999977,3,3,1982.7,2000.1
23471,UA7CFEF,6,-1.4210854715202004e-14,5,1,172.72,172.72
23472,U535588,6,-533.0,3,3,40109.0,39576.0
23473,UEF1322,6,-17601.409999999996,6,0,17601.409999999996,0.0
23474,U31FC58,6,-326.96000000000004,6,0,326.96000000000004,0.0
23475,UBD0032,6,202.19999999999982,4,2,3395.6000000000004,3597.8
23476,UDA7F66,6,0.1599999999999966,4,2,97.84,98.0
23477,UE8041A,6,-324.74,5,1,2324.74,2000.0
23478,UB406E4,6,8514.27,2,4,1010.0,9524.27
23479,U3EB222,6,271.6999999999998,3,3,6000.0,6271.7
23480,U917BC5,6,127.79999999999998,4,2,248.7,376.5
23481,U84B973,6,0.0,4,2,70000.0,70000.0
23482,U1F6472,6,-4.0,4,2,9789.0,9785.0
23483,UE8E709,6,1.136590821460004e-14,3,3,336.05,336.05
23484,U4CFB7A,6,57.71999999999981,3,3,2730.2799999999997,2788.0
23485,U651D69,6,3207.5600000000013,4,2,13719.439999999999,16927.0
23486,UCE35FF,6,1992.47,2,4,2007.54,4000.01
23487,UFE9CF8,6,418.0,3,3,40008.0,40426.0
23488,U2EC142,6,-800.3,6,0,800.3,0.0
23489,UDB5064,6,768.0999999999999,3,3,1349.9,2118.0
23490,UC87E75,6,-9.059419880941277e-14,4,2,958.5300000000001,958.53
23491,U4C4ECB,6,7470.0,3,3,5970.55,13440.55
23492,U1CA621,6,13338.2,2,4,8000.0,21338.2
23493,U691D93,6,751.4300000000003,3,3,7000.0,7751.43
23494,U7A9C6F,6,284.3699999999999,4,2,2520.0,2804.37
23495,U9FE5BB,6,18.02,4,2,11.99,30.01
23496,U94DDED,6,-308.31000000000006,5,1,511.62,203.31
23497,UE526D9,6,376.0,2,4,10.0,386.0
23498,U14B9FD,6,322.46,4,2,288.0,610.46
23499,UF5EC08,6,366.74000000000007,4,2,428.18,794.9200000000001
23500,UE1E8D5,6,0.0,4,2,8000.0,8000.0
23501,UF40190,6,-1330.0,4,2,7030.0,5700.0
23502,UD42FD1,6,-2020.0,5,1,4520.0,2500.0
23503,UB4164A,6,22.080000000001746,1,5,34888.0,34910.08
23504,U5D5F4B,6,-994.1999999999999,5,1,1096.1999999999998,102.0
23505,UF54531,6,223.21999999999997,3,3,287.97,511.19
23506,UFF1543,6,10058.03,1,5,5281.77,15339.800000000001
23507,UD66143,6,13119.0,4,2,69459.0,82578.0
23508,UC27ECC,6,-640.5500000000002,4,2,4118.0,3477.45
23509,UE91A10,6,-33.360000000000035,5,1,208.56000000000003,175.2
23510,UD317CF,6,1021.9100000000001,2,4,406.0,1427.9099999999999
23511,U7BA7D6,6,-501.62000000000006,6,0,501.62000000000006,0.0
23512,U49F6FE,6,-499.9,6,0,499.9,0.0
23513,UAF7053,6,-1228.0,3,3,8016.0,6788.0
23514,U93C39A,6,-2923.05,5,1,3325.57,402.52
23515,U5B4159,6,-189.86,6,0,189.86,0.0
23516,U3CA01A,6,1000.0,3,3,5000.0,6000.0
23517,U6DAFAF,6,-1.4210854715202004e-14,4,2,218.67000000000002,218.67000000000002
23518,U12E060,6,305.7,3,3,22.3,328.0
23519,U587958,6,-1248.5599999999997,5,1,3430.5599999999995,2182.0
23520,U3465DC,6,1991.02,3,3,2009.0,4000.02
23521,U0432E8,6,-433.8000000000002,4,2,5913.8,5480.0
23522,UD23CDF,6,1322.4500000000003,3,3,5000.01,6322.460000000001
23523,U0B3CE8,6,0.0,2,4,21000.0,21000.0
23524,U3B1737,6,-148.0,4,2,8148.0,8000.0
23525,U66EA83,6,51.60000000000002,4,2,578.4,630.0
23526,UC70BCC,6,-1237.9400000000003,4,2,12513.94,11276.0
23527,U59AF2C,6,-35847.08,6,0,35847.08,0.0
23528,UEA8653,6,-4069.4,6,0,4069.4,0.0
23529,UF92269,6,-60.840000000000146,3,3,3086.84,3026.0
23530,U150ACF,6,0.020000000000095497,4,2,587.1999999999999,587.22
23531,U9BC41C,6,1547.0,3,3,12153.0,13700.0
23532,U637B40,6,-676.5999999999999,6,0,676.5999999999999,0.0
23533,UF464E4,6,1.3999999999999986,3,3,134.6,136.0
23534,U292B23,6,-3121.01,3,3,11000.0,7878.99
23535,U9BF948,6,-1367.44,6,0,1367.44,0.0
23536,U88EDE0,6,499.96000000000004,4,2,242.94,742.9
23537,UCF8D47,6,9334.57,3,3,2885.01,12219.58
23538,U77BA43,6,-402.66999999999996,3,3,8705.07,8302.4
23539,UBEA0AD,6,-0.3400000000001455,3,3,15000.0,14999.66
23540,U7AF0E5,6,92.0,3,3,5122.0,5214.0
23541,U2480FE,6,-1454.5800000000002,5,1,1454.7,0.12
23542,U1714F1,6,-149.70000000000002,6,0,149.70000000000002,0.0
23543,U33137F,6,11.0,4,2,9908.0,9919.0
23544,U59B6E2,6,21.16,3,3,55.39,76.55
23545,UBF5ADC,6,-1776.0,4,2,9588.0,7812.0
23546,U6F7D11,6,-90542.7,4,2,91823.08,1280.38
23547,UEEABF5,6,-2.2500000000000053,4,2,267.88,265.63
23548,UB5E34F,6,-1335.6,5,1,1801.6,466.0
23549,U58A70F,6,-71.48,6,0,71.48,0.0
23550,U0F4792,6,124.38,4,2,910.0,1034.38
23551,U9FB49B,6,398.01,3,3,33586.0,33984.01
23552,U050D50,6,-9624.27,2,4,16109.27,6485.0
23553,UD2C25E,6,17192.25,2,4,4.0,17196.25
23554,UD089EA,6,1957.5100000000002,3,3,4574.0,6531.51
23555,UD4016E,6,-12420.46,3,3,27610.1,15189.64
23556,UA369B0,6,-469.65,6,0,469.65,0.0
23557,U0E4208,6,-420.0,4,2,5010.0,4590.0
23558,UBA7748,6,1420.24,1,5,9.98,1430.22
23559,UB62C55,6,902.26,4,2,1252.74,2155.0
23560,U1F64F1,6,-51223.350000000006,4,2,51244.06,20.71
23561,U14E1C8,6,-522.7599999999993,4,2,10430.5,9907.740000000002
23562,UE754AB,6,212.85000000000014,4,2,1613.7,1826.5500000000002
23563,UCEB032,6,-12799.949999999999,2,4,24000.01,11200.060000000001
23564,U7DB09B,6,2101.39,2,4,632.0,2733.39
23565,UD96C4B,6,-679.82,6,0,679.82,0.0
23566,U66755C,6,-42.98999999999978,3,3,19387.44,19344.449999999997
23567,U62BF4A,6,100.0,4,2,36810.0,36910.0
23568,UE84204,6,0.4000000000000057,4,2,136.6,137.0
23569,U2F64E6,6,275.10999999999996,3,3,372.32000000000005,647.43
23570,U9C61A9,6,-71.24000000000001,6,0,71.24000000000001,0.0
23571,U8E5D17,6,-96.54,4,2,209.8,113.26
23572,U007489,6,1.9,3,3,4.78,6.68
23573,UF0A157,6,351.8999999999942,2,4,43624.0,43975.899999999994
23574,UA7B0B0,6,-95.2,4,2,217.0,121.8
23575,UC96AA6,6,1026.6099999999997,3,3,6100.0,7126.61
23576,UE777A3,6,0.0,4,2,13400.0,13400.0
23577,U7A9EEE,6,0.04999999999994742,3,3,1603.74,1603.79
23578,UB251E0,6,1380.47,3,3,20.0,1400.47
23579,U06DFD3,6,80083.06,2,4,39545.86,119628.92
23580,U67A4FD,6,20.000000000000007,3,3,35.02,55.02
23581,UCDAE01,6,-1050.98,4,2,1139.0,88.02
23582,UCEA010,6,1391.78,0,6,0.0,1391.78
23583,U569910,6,5.31,2,4,10.0,15.309999999999999
23584,U753DFB,6,20.0,3,3,19106.0,19126.0
23585,UF4C7D5,6,4069.45,4,2,5665.8,9735.25
23586,UCB8CC6,6,-13510.26,6,0,13510.26,0.0
23587,U6A3EA2,6,0.0,4,2,15.0,15.0
23588,U921C58,6,-3098.96,5,1,4472.959999999999,1374.0
23589,UDF6042,6,0.0,4,2,2950.0,2950.0
23590,UAF1632,6,-32.41000000000001,6,0,32.41000000000001,0.0
23591,UD860AD,6,-430.0,3,3,2330.0,1900.0
23592,U0B86AD,6,-708.22,5,1,2623.22,1915.0
23593,U290D47,6,2.5900000000001455,3,3,15997.0,15999.59
23594,UD0DFC4,6,-5.179999999999609,3,3,4800.0,4794.820000000001
23595,U33CA68,6,-84.0,4,2,5780.0,5696.0
23596,UB618ED,6,-7.76,3,3,25.9,18.14
23597,U5AF7E7,6,337.0,4,2,49.4,386.4
23598,U1729B2,6,-2005.41,5,1,2233.88,228.47
23599,U495EAF,6,1900.0,3,3,9500.0,11400.0
23600,U4144EF,6,-1697.9199999999998,4,2,1717.9199999999998,20.0
23601,U4D3785,6,0.0,3,3,1250.0,1250.0
23602,U26AA56,6,2995.0,3,3,50000.0,52995.0
23603,UBA78FD,6,0.0,3,3,11630.0,11630.0
23604,UC872E4,6,25.200000000000003,4,2,135.8,161.0
23605,U4054AD,6,-2427.1099999999997,4,2,3470.05,1042.94
23606,UF1D253,6,-3384.83,5,1,3488.83,104.0
23607,U105E36,6,-361.33,4,2,362.68,1.35
23608,U24C293,6,1254.0,4,2,1025.32,2279.3199999999997
23609,U536EE8,6,15.06,4,2,9983.0,9998.06
23610,UBA2110,6,-1709.4199999999998,6,0,1709.4199999999998,0.0
23611,UE7D816,6,1546.0,4,2,1693.0,3239.0
23612,UEC8BB3,6,231.97999999999956,3,3,19997.0,20228.98
23613,U539C00,6,0.0,4,2,1108.0,1108.0
23614,UEBBCBB,6,-10.0,4,2,20010.0,20000.0
23615,UEBAF23,6,440.7099999999997,4,2,1922.3000000000002,2363.0099999999998
23616,UEB13D8,6,1078.76,4,2,361.24,1440.0
23617,UD0472A,6,4437.329999999998,2,4,23799.0,28236.33
23618,U545C07,6,2200.0,2,4,0.34,2200.34
23619,U1329EA,6,-342.3399999999999,4,2,1573.34,1231.0
23620,U2FBA48,6,100.01,2,4,8000.0,8100.01
23621,U0AAA0D,6,4210.6900000000005,4,2,7797.62,12008.31
23622,U175ADD,6,-906.5100000000002,5,1,3943.0,3036.49
23623,U01F595,6,0.0,3,3,9998.0,9998.0
23624,U1BCF6C,6,0.0,4,2,7910.0,7910.0
23625,U85F46D,6,6038.0,4,2,7073.0,13111.0
23626,U105780,6,-11030.0,4,2,31000.0,19970.0
23627,U2806EE,6,-1120.0,4,2,10370.0,9250.0
23628,UEB67D3,6,0.0,3,3,1074.0,1074.0
23629,U02A588,6,-799.38,5,1,999.3800000000001,200.0
23630,UADDB3C,6,933.0,2,4,1930.0,2863.0
23631,U0F9CF6,6,0.0,4,2,32831.0,32831.0
23632,U8D9435,6,0.0,4,2,862.6,862.6
23633,U8E66DC,6,7936.0,2,4,135.0,8071.0
23634,UFD37F9,6,-787.54,6,0,787.54,0.0
23635,UA61F6D,6,1328.9300000000003,3,3,8784.0,10112.93
23636,U784ADF,6,-42.0,3,3,16042.0,16000.0
23637,UD8CE23,6,945.43,4,2,360.97,1306.4
23638,U3AF1DB,6,-643.3399999999999,4,2,1823.0,1179.6599999999999
23639,U30BEB3,6,-6409.640000000001,5,1,9819.28,3409.64
23640,U7A7529,6,10.88000000000011,4,2,1752.12,1763.0
23641,U3EE47F,6,150.9,4,2,536.1,687.0
23642,U2F8AE9,6,1.1368683772161603e-13,3,3,1446.7399999999998,1446.74
23643,U147AA2,6,-10.379999999999999,5,1,10.44,0.06
23644,U4EED9D,6,-2100.0,4,2,2239.0,139.0
23645,U375B79,6,0.0,3,3,16000.0,16000.0
23646,UEFA186,6,0.0,4,2,588.2600000000001,588.26
23647,U6D9F8D,6,-968.77,6,0,968.77,0.0
23648,UAA27F1,6,-9700.0,3,3,31785.0,22085.0
23649,U2ADEBC,6,650.0,4,2,6773.0,7423.0
23650,UA35899,6,-4494.95,4,2,8510.0,4015.05
23651,U956706,6,-6920.320000000001,5,1,6921.26,0.94
23652,U7ECEA9,6,2.389999999999418,3,3,9458.26,9460.65
23653,UAA4A07,6,0.0,3,3,6000.0,6000.0
23654,U90BE55,6,0.0,4,2,5318.0,5318.0
23655,U9A0E9C,6,36490.0,3,3,34770.0,71260.0
23656,UD570C5,6,180.0,4,2,1420.0,1600.0
23657,U3EF384,6,183.95000000000016,4,2,1423.96,1607.91
23658,U74621E,6,1001.5,4,2,8398.5,9400.0
23659,UDAED49,6,-2999.24,6,0,2999.24,0.0
23660,UDE3F60,6,185.0,3,3,1382.0,1567.0
23661,UF6D1F0,6,93.6,4,2,260.4,354.0
23662,U400B94,6,-5217.0,6,0,5217.0,0.0
23663,UBEA05E,6,-5000.0,3,3,10800.0,5800.0
23664,U8D8F6D,6,6175.52,4,2,24.5,6200.02
23665,U38F3FD,6,-6097.0,4,2,8002.0,1905.0
23666,U9F5FE3,6,-501.4000000000001,4,2,2501.4,2000.0
23667,UEA45CC,6,132.0,3,3,4018.0,4150.0
23668,U04F205,6,-873.36,6,0,873.36,0.0
23669,UD9E3E4,6,132.05999999999995,3,3,980.0,1112.06
23670,U93502A,6,0.0,3,3,319.5,319.5
23671,U4B56AC,6,-3532.8199999999997,6,0,3532.8199999999997,0.0
23672,UCA0208,6,-1.5631940186722204e-13,4,2,1176.6,1176.6
23673,U56EC34,6,-349.9000000000001,5,1,3350.9,3001.0
23674,U03E4D8,6,5000.0,3,3,25000.0,30000.0
23675,UB5A196,6,-855.1800000000001,6,0,855.1800000000001,0.0
23676,UB4D388,6,0.0,3,3,933.66,933.66
23677,U793E41,6,11555.68,4,2,13510.0,25065.68
23678,UE92804,6,0.0,4,2,1586.42,1586.42
23679,UD89CA8,6,-898.4899999999998,3,3,8794.49,7896.0
23680,UF2523A,6,1.7763568394002505e-14,4,2,464.58,464.58
23681,UC4E359,6,0.0,3,3,16890.0,16890.0
23682,UFD0F31,6,0.030000000000001137,3,3,141.0,141.03
23683,UCE57C9,6,0.0,4,2,14000.0,14000.0
23684,U88BDF6,6,-3006.02,4,2,5286.0,2279.98
23685,UDE09EC,6,-14.0,3,3,43.0,29.0
23686,UB57B71,6,-4016.9400000000005,4,2,8025.9400000000005,4009.0
23687,U039905,6,-49.260000000000005,6,0,49.260000000000005,0.0
23688,U9AD215,6,2003.5699999999997,3,3,22710.0,24713.57
23689,U04098B,6,150.0999999999999,3,3,2909.9,3060.0
23690,U8AC951,6,-25.900000000000002,3,3,26.0,0.1
23691,UF83E6B,6,-903.0,4,2,8203.0,7300.0
23692,UA4B9EB,6,8780.77,1,5,94.0,8874.77
23693,UF40B8A,6,67100.0,3,3,3000.0,70100.0
23694,UED47C6,6,320.19000000000005,3,3,224.07999999999998,544.27
23695,U040ED0,6,-118.58,4,2,220.0,101.42
23696,UA70E4A,6,217.01,1,5,28.0,245.01
23697,U383B79,6,63.0,3,3,352.0,415.0
23698,UAF1F5A,6,-4044.3,4,2,4762.3,718.0
23699,UE03D6A,6,71.00000000000003,4,2,263.48,334.48
23700,U6A0498,6,-4085.0,4,2,15790.0,11705.0
23701,UBA5FFA,6,3100.28,3,3,25.0,3125.28
23702,U31DA09,6,4017.3199999999997,4,2,14267.32,18284.64
23703,UABC6F5,6,0.5300000000000409,3,3,3364.9300000000003,3365.46
23704,U2FA01A,6,276.0,4,2,3642.0,3918.0
23705,U31AC97,6,1947.7099999999998,3,3,267.29,2215.0
23706,U4F8C33,6,-729.4599999999999,6,0,729.4599999999999,0.0
23707,U61AC3A,6,103.09999999999997,4,2,863.36,966.46
23708,UF289AE,6,-784.0,4,2,2994.0,2210.0
23709,UD65045,6,0.0,4,2,1798.66,1798.66
23710,U2648B3,6,-2468.14,6,0,2468.14,0.0
23711,U4A08E4,6,5.684341886080802e-14,4,2,881.3399999999999,881.34
23712,UE38F45,6,-4701.99,4,2,5882.0,1180.01
23713,U2100C9,6,121.60000000000002,4,2,620.95,742.55
23714,UC654F7,6,-495.65,5,1,559.4499999999999,63.8
23715,UC5395B,6,1737.9800000000005,3,3,3366.65,5104.63
23716,UA767F7,6,-884.1800000000001,4,2,954.1800000000001,70.0
23717,UC74062,6,-7499.0,4,2,23124.0,15625.0
23718,UF9D78D,6,-45.9,4,2,102.9,57.0
23719,U280C37,6,-6335.64,3,3,13303.210000000001,6967.570000000001
23720,U615D3F,6,18.23000000000017,3,3,5282.55,5300.78
23721,UD59593,6,-6196.18,1,5,20500.0,14303.82
23722,U6F4FC1,5,5.0,3,2,5995.0,6000.0
23723,UB4202D,5,-7.5600000000000005,3,2,8.0,0.44
23724,U62067C,5,100.01000000024214,2,3,4000000.01,4000100.02
23725,UB793AE,5,36.27000000000044,2,3,5463.75,5500.02
23726,U9A6688,5,4547.41,3,2,1491.6,6039.01
23727,UF22F13,5,83.40999999999985,4,1,2543.34,2626.75
23728,U93C0D8,5,465.7,3,2,94.14,559.84
23729,U33E9B0,5,0.0,4,1,70.5,70.5
23730,U263146,5,1042.0999999999995,3,2,8120.0,9162.099999999999
23731,U2C24A5,5,-2.8500000000000005,2,3,6.0,3.1499999999999995
23732,U5694F2,5,-30.899999999999977,4,1,330.9,300.0
23733,U7252C3,5,-276.86,5,0,276.86,0.0
23734,UB3A97B,5,-90.0,3,2,1020.0,930.0
23735,UAA4D3F,5,-18500.0,3,2,48018.0,29518.0
23736,UA2D67D,5,-10054.0,4,1,10447.3,393.3
23737,U2A46EA,5,7797.860000000001,3,2,8177.0,15974.86
23738,UAC3EE7,5,0.13000000000000256,3,2,5393.87,5394.0
23739,U07AEC8,5,0.03999999999996362,2,3,7000.0,7000.04
23740,U7104AD,5,-704.8000000000002,4,1,1244.8000000000002,540.0
23741,UFC35E0,5,0.009999999999990905,2,3,188.79,188.79999999999998
23742,UD5D307,5,474.1,2,3,6.0,480.1
23743,U109E70,5,13100.0,0,5,0.0,13100.0
23744,U4DD3BE,5,-335.98,3,2,336.02,0.04
23745,U76ECF0,5,0.0,2,3,38000.0,38000.0
23746,UD3FA71,5,5.0,0,5,0.0,5.0
23747,UF12BB4,5,0.30999999999994543,2,3,4645.42,4645.73
23748,UD70D5D,5,11003.03,2,3,6.0,11009.03
23749,UCB68B0,5,-17.629999999999995,4,1,17.639999999999997,0.01
23750,U69B38B,5,145.25,2,3,10.0,155.25
23751,U236A05,5,492.0,3,2,3418.0,3910.0
23752,UF9EB79,5,3.0,1,4,0.08,3.08
23753,U6061F9,5,-6795.8,3,2,11719.0,4923.2
23754,UB4AF77,5,-19.0,3,2,9707.0,9688.0
23755,UB7EF0E,5,-89.46999999999998,5,0,89.46999999999998,0.0
23756,U37D6DD,5,-1997.0,3,2,11964.0,9967.0
23757,UC8D0D6,5,0.0,3,2,7000.0,7000.0
23758,UB77408,5,-2900.0,3,2,8000.0,5100.0
23759,U13DFB4,5,139.0,3,2,170.0,309.0
23760,U9B6EAD,5,4.0,3,2,13979.0,13983.0
23761,U67BCC3,5,-681.0799999999999,4,1,781.0799999999999,100.0
23762,U3D1706,5,-2500.0,3,2,9000.0,6500.0
23763,U8BD98B,5,-1286.42,4,1,1586.42,300.0
23764,U8B4C89,5,57.25999999999999,4,1,442.74,500.0
23765,UD50EB5,5,0.0500000000001819,2,3,6928.0,6928.05
23766,U96D817,5,348.0,2,3,3515.0,3863.0
23767,U4D1EB4,5,6325.879999999999,3,2,2067.0,8392.88
23768,U7F53CD,5,12100.35,1,4,11990.0,24090.35
23769,UA57259,5,-45500.0,3,2,71000.0,25500.0
23770,U590B0D,5,5312.5599999999995,4,1,187.44,5500.0
23771,U2171FA,5,-1.4210854715202004e-14,2,3,207.66,207.65999999999997
23772,UD66306,5,-3464.49,4,1,3508.0899999999997,43.6
23773,U9CB8F0,5,-113.9,5,0,113.9,0.0
23774,U71E246,5,280.0,4,1,620.0,900.0
23775,UFC549A,5,64.0,3,2,36.0,100.0
23776,U13C3B0,5,10.0,4,1,2990.0,3000.0
23777,U8DACB7,5,260.18,2,3,44.150000000000006,304.33000000000004
23778,UEA39A5,5,62.950000000000045,3,2,1510.0,1572.95
23779,U4450A9,5,32.2,3,2,47.8,80.0
23780,UD6BBE2,5,478.0000000000001,3,2,1207.9,1685.9
23781,U4D32A8,5,-63.24999999999999,4,1,70.6,7.35
23782,U4A0B8F,5,0.13000000000010914,2,3,7642.46,7642.59
23783,U2FB491,5,127.46000000000004,3,2,6010.0,6137.46
23784,U8C88EB,5,336.74,2,3,22.0,358.74
23785,U582209,5,-1323.42,4,1,1333.42,10.0
23786,U7B70CE,5,-148.0,4,1,6318.0,6170.0
23787,U749D95,5,-4736.469999999999,3,2,7728.0,2991.53
23788,U65ACAF,5,5572.0,2,3,19028.0,24600.0
23789,U250FBF,5,-1646.96,4,1,1647.3,0.34
23790,UF92D35,5,-2351.9300000000003,2,3,4390.0,2038.0700000000002
23791,UEDC173,5,632.27,3,2,97.6,729.87
23792,UB2C37E,5,360.2,2,3,360.35999999999996,720.56
23793,U2F8787,5,30.949999999999818,2,3,4491.66,4522.61
23794,U331A41,5,3354.26,4,1,1145.74,4500.0
23795,UF50ADD,5,565.6899999999982,1,4,18200.0,18765.689999999995
23796,U7C35EE,5,2.0,3,2,13998.0,14000.0
23797,UE53E3B,5,-85.4,3,2,295.4,210.0
23798,U89E0FC,5,94.0,2,3,5586.0,5680.0
23799,U6C99CE,5,360.0,3,2,510.0,870.0
23800,UD5AAC3,5,-19162.0,3,2,19762.0,600.0
23801,U02D1F5,5,-3952.81,4,1,3954.04,1.23
23802,U33EF7E,5,108.0,2,3,5980.0,6088.0
23803,UC6577D,5,201.0,2,3,11.4,212.4
23804,U7C525C,5,-79.44,5,0,79.44,0.0
23805,UEA0C8C,5,0.0,4,1,9000.0,9000.0
23806,UEB2DFB,5,2438.0,0,5,0.0,2438.0
23807,UBFA3A3,5,-99.55,2,3,3100.0,3000.45
23808,U83F703,5,-2323.0,4,1,5383.0,3060.0
23809,U6D50A1,5,-187.69999999999996,3,2,269.4,81.7
23810,UCBA269,5,0.0,3,2,158.0,158.0
23811,U9A6659,5,311.02,2,3,583.26,894.28
23812,UA76E2A,5,-187.35999999999999,5,0,187.35999999999999,0.0
23813,UD664E4,5,2023.0500000000002,2,3,2520.0,4543.05
23814,U6817F6,5,-5.689893001203927e-15,3,2,98.6,98.6
23815,U4846B2,5,4.0,4,1,16.0,20.0
23816,U420166,5,3600.04,0,5,0.0,3600.04
23817,UADFA88,5,-273.90000000000003,5,0,273.90000000000003,0.0
23818,U555F22,5,-4000.6000000000004,3,2,8959.0,4958.4
23819,U5000EC,5,-1366.39,4,1,1474.38,107.99
23820,U970B16,5,-1406.9499999999998,3,2,6227.0,4820.05
23821,U1DE028,5,8203.11,3,2,4946.889999999999,13150.0
23822,U17C2BF,5,-3348.6200000000003,5,0,3348.6200000000003,0.0
23823,UD93CEC,5,0.0,4,1,5557.0,5557.0
23824,U8B3B67,5,139.0,3,2,681.0,820.0
23825,U590123,5,-4107.0,5,0,4107.0,0.0
23826,UAE052D,5,2890.0,3,2,510.0,3400.0
23827,UCF6142,5,41805.979999999996,2,3,9200.0,51005.98
23828,UB2CD74,5,-943.52,4,1,1887.04,943.52
23829,U2BEC71,5,-366.34,5,0,366.34,0.0
23830,UF00F0B,5,1467.0,2,3,2145.0,3612.0
23831,U0E0778,5,-3104.6,3,2,5454.6,2350.0
23832,UBCC011,5,94.5,4,1,128.5,223.0
23833,U99F3B5,5,-21.0,4,1,312.58,291.58
23834,U3DE5CD,5,26.0,0,5,0.0,26.0
23835,UD59579,5,933.68,3,2,9323.5,10257.18
23836,UC8F3E6,5,699.1000000000013,3,2,12839.009999999998,13538.11
23837,U048B9B,5,4500.0,3,2,3810.0,8310.0
23838,UD8D8E7,5,1600.0,4,1,900.0,2500.0
23839,U43365A,5,368.47,2,3,2550.0,2918.4700000000003
23840,UB0B45F,5,4937.67,2,3,1963.0,6900.67
23841,U56D99C,5,363.76000000000005,2,3,711.24,1075.0
23842,U097715,5,-332.02,5,0,332.02,0.0
23843,U734533,5,-7389.0,4,1,12903.0,5514.0
23844,UC921E4,5,0.0,2,3,470.2,470.2
23845,U5733AC,5,-3158.0,3,2,8775.0,5617.0
23846,UBAFD5B,5,359.23,3,2,610.0,969.23
23847,UAD7709,5,834.0,3,2,3366.0,4200.0
23848,U8B85D2,5,-2533.04,4,1,4933.04,2400.0
23849,UA40C09,5,-6201.0,3,2,14203.0,8002.0
23850,UEE5D9B,5,100.0,3,2,4175.0,4275.0
23851,U59397F,5,-110.99999999999997,4,1,303.4,192.4
23852,UE453E4,5,-10010.1,4,1,10015.0,4.9
23853,UB69E13,5,5258.1,3,2,1038.9,6297.0
23854,U181829,5,-2000.0,3,2,9995.0,7995.0
23855,UA96915,5,-8.280000000000001,3,2,120.0,111.72
23856,U4761FF,5,0.0,3,2,356.0,356.0
23857,U6628DE,5,104.35000000000014,3,2,3363.4700000000003,3467.82
23858,UF8B73F,5,0.5,3,2,59726.5,59727.0
23859,UA31B80,5,1300.51,3,2,781.49,2082.0
23860,U2D991D,5,1.0,3,2,4203.0,4204.0
23861,U8CA8A3,5,569.5499999999998,3,2,386.07,955.6199999999999
23862,U1A1FC6,5,-740.71,2,3,4160.03,3419.32
23863,U7F0409,5,-1732.0700000000002,4,1,1732.2,0.13
23864,UF08F75,5,363.55,4,1,936.45,1300.0
23865,U833E6B,5,-4100.509999999998,4,1,16000.51,11900.0
23866,U5564F9,5,1500.07,3,2,4710.0,6210.07
23867,U58866C,5,-8108.03,3,2,10010.0,1901.97
23868,UCD4BA4,5,83.5400000000003,3,2,6232.87,6316.41
23869,U36607E,5,-305.08000000000004,4,1,705.08,400.0
23870,UB6C928,5,2571.0,0,5,0.0,2571.0
23871,U3A2838,5,473.71000000000004,3,2,44.79,518.5
23872,U3EB782,5,-1.1199999999998909,3,2,1046.12,1045.0
23873,U7CDB2F,5,-34.97,4,1,35.0,0.03
23874,UC918EE,5,-35800.0,3,2,35810.0,10.0
23875,UE2A67F,5,-3496.08,4,1,3596.08,100.0
23876,UF37B25,5,-1.3000000000000003,4,1,16.3,15.0
23877,UDE09A3,5,-0.5100000000000002,4,1,2.97,2.46
23878,U2E7B7C,5,230.0,2,3,2000.0,2230.0
23879,U61832A,5,-12388.0,3,2,22888.0,10500.0
23880,UEA97B3,5,9690.0,2,3,18870.0,28560.0
23881,U06D476,5,-10.919999999999845,3,2,1915.6,1904.68
23882,UEC9011,5,5860.0,1,4,5688.0,11548.0
23883,U0E5988,5,-667.63,4,1,668.0,0.37
23884,UFC1286,5,-1256.5,2,3,56630.0,55373.5
23885,UFFBE4C,5,-3180.46,3,2,4462.0,1281.54
23886,U216497,5,-6500.0,3,2,13500.0,7000.0
23887,UE44837,5,291.0,3,2,283.0,574.0
23888,UC7BE0C,5,1622.76,1,4,373.0,1995.76
23889,U73EE5D,5,18.219999999999914,3,2,1764.88,1783.1
23890,UF38EB2,5,-2553.34,4,1,2753.34,200.0
23891,U0ED103,5,-75.4,5,0,75.4,0.0
23892,U15AF9E,5,-5.5,5,0,5.5,0.0
23893,U9D286B,5,-558.59,3,2,635.94,77.35
23894,U35CC43,5,-11.8,4,1,12.0,0.2
23895,U8B4CFB,5,297.0,3,2,3.01,300.01
23896,UBC20C4,5,-1798.0,5,0,1798.0,0.0
23897,UB7D635,5,-9.460000000000008,3,2,220.84000000000003,211.38000000000002
23898,UE04BFF,5,0.0,2,3,24000.0,24000.0
23899,U5CC326,5,-1021.1899999999999,3,2,2520.3,1499.11
23900,U1D39BE,5,33.60000000000002,3,2,376.8,410.40000000000003
23901,U93FB4E,5,0.0,3,2,197.8,197.8
23902,UDE3FE1,5,-10.0,2,3,7660.0,7650.0
23903,U864AF0,5,65.75,3,2,6699.6,6765.35
23904,UE2F31C,5,-8.881784197001252e-15,4,1,151.67,151.67
23905,U6DFB19,5,6880.1,0,5,0.0,6880.1
23906,UDF949A,5,207.02999999999975,2,3,9530.0,9737.029999999999
23907,U865BB3,5,35.0,3,2,35.0,70.0
23908,U89C770,5,-59831.24,3,2,59849.53999999999,18.3
23909,U39E5FD,5,2177.2,3,2,4188.0,6365.2
23910,U5C04DC,5,-21249.6,5,0,21249.6,0.0
23911,U9CB6DA,5,160.0,3,2,1590.0,1750.0
23912,U8E6AAF,5,-5892.13,5,0,5892.13,0.0
23913,UEED072,5,165.0,3,2,1858.0,2023.0
23914,UFE634A,5,2060.39,3,2,5006.0,7066.389999999999
23915,U3AABBB,5,-642.77,5,0,642.77,0.0
23916,U550468,5,-4017.95,4,1,4020.0,2.05
23917,UD9F376,5,389.38,2,3,789.62,1179.0
23918,UFC5DE8,5,-1869.0,5,0,1869.0,0.0
23919,U9775BD,5,1063.0,3,2,2000.0,3063.0
23920,UF1C510,5,-668.2900000000001,3,2,670.0,1.71
23921,U0429F9,5,-1499.4899999999998,3,2,5569.47,4069.98
23922,U572145,5,1850.0,0,5,0.0,1850.0
23923,UE51FF5,5,70.19000000000001,4,1,111.80999999999999,182.0
23924,U8B2F16,5,174.0,2,3,686.0,860.0
23925,U57CEEC,5,-10480.0,3,2,23280.0,12800.0
23926,U6F888C,5,-184.54999999999995,4,1,369.1,184.55
23927,U652759,5,-9950.0,4,1,20000.0,10050.0
23928,UFFE6CF,5,3150.0,3,2,19154.0,22304.0
23929,U70BE0A,5,720.66,2,3,502.98,1223.64
23930,UD485C9,5,-1041.82,5,0,1041.82,0.0
23931,U51368C,5,0.9800000000004729,2,3,13610.0,13610.98
23932,U2649C8,5,1310.0,3,2,9810.0,11120.0
23933,U71F717,5,2119.26,4,1,380.74,2500.0
23934,U6DF4DE,5,-800.0,3,2,8420.0,7620.0
23935,UAE0923,5,-9598.0,3,2,9608.0,10.0
23936,UD96DB3,5,-202.0,3,2,217.0,15.0
23937,U206A30,5,-338.44,5,0,338.44,0.0
23938,U830CEF,5,-11.7,5,0,11.7,0.0
23939,U95A44B,5,33.61999999999989,2,3,1467.0,1500.62
23940,U6B489F,5,-1061.58,4,1,1161.58,100.0
23941,UE2D81E,5,-110.19999999999997,4,1,220.39999999999998,110.2
23942,U347D3E,5,-100.0,2,3,17654.0,17554.0
23943,U0822A5,5,6085.299999999999,4,1,653.18,6738.48
23944,U2A68D8,5,-61867.6,2,3,62014.38,146.78
23945,UB11FFE,5,-209.87,2,3,232.0,22.13
23946,U1BCCB5,5,25.67,3,2,1676.0,1701.67
23947,UEFAB0C,5,-3.0,3,2,2846.0,2843.0
23948,U7B506E,5,910.0,3,2,6690.0,7600.0
23949,UFD2495,5,6.0,3,2,4866.84,4872.84
23950,U37778E,5,70.0,3,2,4910.0,4980.0
23951,U0FFE7B,5,-16248.3,3,2,48100.0,31851.7
23952,U095459,5,-1212.68,4,1,2425.36,1212.68
23953,U70E7BF,5,1863.52,0,5,0.0,1863.52
23954,UC18BAD,5,433.0,3,2,5206.0,5639.0
23955,U296F64,5,1300.0900000000001,3,2,310.0,1610.0900000000001
23956,UF3D64C,5,-90096.33,3,2,90200.0,103.67
23957,U8C5ED9,5,162.0,3,2,538.0,700.0
23958,U2AC1DF,5,14105.45,2,3,6.0,14111.45
23959,UD8C6D5,5,-456.53,3,2,1000.0,543.47
23960,UE91827,5,40.0,3,2,270.0,310.0
23961,UAA4B73,5,-110.64999999999998,2,3,415.52,304.87
23962,U758CA5,5,5992.0,2,3,7260.0,13252.0
23963,UB28E89,5,-41.339999999999996,4,1,41.4,0.06
23964,U722716,5,-5000.0,3,2,24104.0,19104.0
23965,U28A0C6,5,792.0,3,2,4043.0,4835.0
23966,U91F414,5,-1500.0,4,1,4500.0,3000.0
23967,UBA5EA1,5,1.3400000000001455,2,3,32213.0,32214.34
23968,UD6C6EE,5,1.5600000000000023,2,3,51.67,53.230000000000004
23969,U252331,5,-10.420000000012806,2,3,171860.2,171849.78
23970,UD9E622,5,100.0,3,2,22600.0,22700.0
23971,U46BF68,5,2173.52,3,2,4996.0,7169.52
23972,UB43262,5,-367.46999999999997,4,1,734.94,367.47
23973,U842A8F,5,4080.0600000000004,2,3,1219.0,5299.06
23974,UC6593A,5,5.099999999999994,3,2,138.9,144.0
23975,U93E91B,5,-106.0,3,2,13670.0,13564.0
23976,UD90048,5,-0.019999999999999574,4,1,12.62,12.6
23977,UA052F1,5,1303.62,3,2,6560.8099999999995,7864.43
23978,UED9D78,5,7500.01,0,5,0.0,7500.01
23979,U681D58,5,-11967.98,3,2,15124.0,3156.02
23980,UEB623C,5,2994.9,2,3,6.5,3001.4
23981,UA7657A,5,-13833.58,2,3,15654.0,1820.42
23982,U8E00EA,5,640.0,0,5,0.0,640.0
23983,U833F3B,5,911.0,2,3,67.9,978.9
23984,UFE167A,5,-77093.29,4,1,77093.3,0.01
23985,UCCF53F,5,100036.12,1,4,1999.0,102035.12
23986,U4287D8,5,-0.36999999999999744,4,1,50.9,50.53
23987,UD448FC,5,1.0,3,2,10509.0,10510.0
23988,UEABFE7,5,-186.0,3,2,13401.0,13215.0
23989,U7D21E4,5,2261.75,2,3,1566.5,3828.25
23990,UF7ED23,5,615.02,1,4,5.0,620.02
23991,U1778E9,5,-848.1999999999998,4,1,2048.2,1200.0
23992,UBF7324,5,305.87,2,3,6.0,311.87
23993,U80A691,5,2980.0,1,4,2963.0,5943.0
23994,U569F83,5,-73.98999999999978,2,3,9898.0,9824.01
23995,UED73F9,5,505.02,4,1,29.98,535.0
23996,U400A2A,5,-18259.120000000003,3,2,28208.5,9949.38
23997,U641558,5,-3957.8,3,2,7600.0,3642.2
23998,U0E743A,5,0.0,3,2,6549.7,6549.7
23999,UC76CA1,5,0.0,2,3,20000.0,20000.0
24000,U55E30C,5,5848.8,4,1,2311.2,8160.0
24001,UBF6B57,5,-1092.5,3,2,2992.5,1900.0
24002,U39A6B1,5,49.9,3,2,3000.0,3049.9
24003,UC9DE51,5,4169.08,2,3,10.0,4179.08
24004,U86EFE9,5,-179.98000000000002,4,1,379.9800000000001,200.0
24005,U8B7E13,5,71.2,3,2,1528.8,1600.0
24006,U18A61C,5,-82.51999999999998,3,2,6082.52,6000.0
24007,U5ACFDE,5,-119.66,4,1,169.66,50.0
24008,U28B03B,5,40.0,0,5,0.0,40.0
24009,U8079AD,5,1.0,2,3,29332.0,29333.0
24010,UD833C3,5,0.03,2,3,18000.0,18000.03
24011,UF0EED7,5,31.820000000000164,1,4,1000.0,1031.8200000000002
24012,U4C2A38,5,0.0,3,2,126.0,126.0
24013,UEBFF7F,5,2900.09,1,4,1800.0,4700.09
24014,UEF7665,5,-2011.3600000000006,4,1,5159.5599999999995,3148.2
24015,U5469B1,5,25006.0,1,4,24000.0,49006.0
24016,U086883,5,-101.89999999999964,3,2,9711.9,9610.0
24017,UD89A1D,5,1990.04,1,4,9.98,2000.02
24018,UD5CA70,5,3403.350000000006,1,4,80000.0,83403.35
24019,U979B75,5,17.0,2,3,2488.01,2505.01
24020,U5B82DB,5,-282.9500000000005,3,2,15671.95,15389.0
24021,U6048E0,5,0.759999999999996,2,3,53.0,53.76
24022,UF42616,5,664.0,3,2,1486.0,2150.0
24023,U9579FE,5,-18081.28,4,1,18107.45,26.17
24024,UD221B1,5,1822.0,3,2,178.0,2000.0
24025,U9DF36D,5,-3586.0,3,2,16737.0,13151.0
24026,U6E2542,5,140.0,3,2,25860.0,26000.0
24027,UC8101F,5,-414.78,4,1,414.93999999999994,0.16
24028,UD32634,5,0.0,3,2,1258.0,1258.0
24029,U8B8F02,5,0.0,3,2,2.0,2.0
24030,UA2F838,5,-22.58,3,2,45.2,22.62
24031,U30DBA1,5,-0.8999999999999773,3,2,383.9,383.0
24032,U7E96D0,5,-2611.7,2,3,7775.0,5163.3
24033,U0B332C,5,4500.0,0,5,0.0,4500.0
24034,U138D0E,5,780.0,2,3,4286.0,5066.0
24035,UE733BA,5,-1534.98,5,0,1534.98,0.0
24036,U4056F1,5,4086.02,3,2,3010.0,7096.02
24037,UB93C61,5,-494.22,4,1,583.2199999999999,89.0
24038,U950241,5,-102.22000000000116,2,3,19300.0,19197.78
24039,UFF6040,5,0.0,2,3,40403.54,40403.54
24040,UF56019,5,1022.0,2,3,4578.0,5600.0
24041,U18CBFB,5,-930.19,4,1,1342.8,412.61
24042,U920AF2,5,0.77,2,3,300.01,300.78
24043,UE6DE8E,5,148.16000000000003,3,2,460.0,608.1600000000001
24044,UBD2F8E,5,171.73000000000002,4,1,1120.27,1292.0
24045,U63FE76,5,-74.10000000000036,4,1,10055.5,9981.4
24046,U5F6BBD,5,-385.1,5,0,385.1,0.0
24047,UD4F833,5,789.9899999999998,3,2,5150.0,5939.99
24048,U84A486,5,0.19,2,3,10000.0,10000.19
24049,U726314,5,50.85,2,3,152.0,202.85
24050,UF5E770,5,80.28000000000003,4,1,319.71999999999997,400.0
24051,UF95FE2,5,-88.89999999999998,4,1,177.89999999999998,89.0
24052,U94A800,5,392.83000000000004,3,2,501.12,893.95
24053,U15A8C4,5,-1262.7,4,1,1762.7,500.0
24054,U47B49A,5,440.40999999999985,3,2,2608.1,3048.5099999999998
24055,UCA179E,5,63.11000000000013,2,3,5637.25,5700.360000000001
24056,UE8629C,5,39374.0,2,3,5656.0,45030.0
24057,U4B64C2,5,-188.19,2,3,300.0,111.81
24058,U1FA62F,5,0.0,3,2,3422.0,3422.0
24059,U796D32,5,-278.03999999999996,4,1,1368.04,1090.0
24060,U7458F9,5,-8.526512829121202e-14,3,2,1589.1,1589.1
24061,U8CDBA6,5,2.660000000000025,2,3,277.35,280.01
24062,U2F6198,5,0.0,4,1,621.0,621.0
24063,U43F86E,5,-561.9000000000001,3,2,2177.0,1615.1
24064,U4C6981,5,48.99,3,2,1.07,50.06
24065,U43A940,5,0.1999999999998181,4,1,7999.8,8000.0
24066,U154D29,5,4645.23,2,3,8700.0,13345.23
24067,U8DD69C,5,-543998.13,2,3,650000.0,106001.87
24068,UB4C928,5,-55759.48,4,1,108185.0,52425.52
24069,UF31EFF,5,13.0,2,3,15982.0,15995.0
24070,U49A864,5,-1767.66,5,0,1767.66,0.0
24071,UC9F70E,5,-45.93,3,2,122.97,77.04
24072,U7EEAD9,5,0.830000000000382,2,3,7990.0,7990.83
24073,U993746,5,5.0,2,3,10.0,15.0
24074,UB998E8,5,-391.66,4,1,491.66,100.0
24075,U00D3F6,5,-761.08,5,0,761.08,0.0
24076,UD3E515,5,-820.0,3,2,5808.0,4988.0
24077,UCF3C0A,5,486.74000000000024,3,2,3414.58,3901.32
24078,U52B309,5,135.0,3,2,3010.0,3145.0
24079,U71553B,5,617.6700000000001,4,1,4237.16,4854.83
24080,UC4C896,5,5765.59,2,3,1919.0,7684.59
24081,U0CB6D9,5,-10000.0,4,1,10968.74,968.74
24082,UDD6828,5,-832.0,4,1,1782.0,950.0
24083,U548DF0,5,102.15,3,2,2.8499999999999996,105.0
24084,U12DB46,5,-10636.08,4,1,10641.08,5.0
24085,UFACAD0,5,6374.2300000000005,1,4,3.0,6377.2300000000005
24086,UBE7B1F,5,0.0,3,2,20.0,20.0
24087,U136F90,5,736.48,4,1,263.52,1000.0
24088,U901050,5,1820.4799999999996,4,1,379.52,2200.0
24089,U93E75F,5,-1098.5,4,1,1102.5,4.0
24090,U697A60,5,-821.34,4,1,881.34,60.0
24091,UF46BB5,5,2084.63,3,2,2675.0,4759.63
24092,U7A1C62,5,51058.240000000005,0,5,0.0,51058.240000000005
24093,U0BAEB9,5,3.0,2,3,9307.0,9310.0
24094,U593331,5,0.09000000000014552,2,3,15387.78,15387.87
24095,UE52E26,5,-6.350000000000364,2,3,19000.0,18993.65
24096,UE6E331,5,-810.3800000000001,3,2,2821.0,2010.62
24097,UE4DE8E,5,-238.0,3,2,248.0,10.0
24098,U46BFF5,5,6869.0,2,3,1076.0,7945.0
24099,U07361E,5,-2895.11,4,1,2900.11,5.0
24100,UF1C008,5,7639.929999999999,2,3,4166.0,11805.93
24101,U8701F5,5,476.12,2,3,458.98999999999995,935.11
24102,UE18B49,5,-7525.76,2,3,25015.0,17489.239999999998
24103,UF8538B,5,-1652.0,3,2,3394.0,1742.0
24104,UEA9E63,5,-13.289999999999992,2,3,1113.38,1100.09
24105,U515645,5,630.1700000000001,4,1,369.83,1000.0
24106,UE11477,5,-4.420000000000073,4,1,7968.26,7963.84
24107,UCD96CC,5,-7840.68,4,1,8840.68,1000.0
24108,UD78D97,5,-2224.16,5,0,2224.16,0.0
24109,UB5A150,5,74.88999999999942,2,3,13927.52,14002.41
24110,U7D410D,5,5032.29,2,3,6.0,5038.29
24111,U7AAB32,5,-2965.28,4,1,5930.56,2965.28
24112,U716D60,5,-558.0,3,2,578.0,20.0
24113,U32945A,5,-10000.0,2,3,20000.0,10000.0
24114,U49AF47,5,-2379.94,4,1,2609.94,230.0
24115,U22815D,5,0.8599999999996726,3,2,5940.14,5941.0
24116,UDE5680,5,2070.14,2,3,583.26,2653.4
24117,UD9C369,5,-265.0,3,2,1055.0,790.0
24118,U8A987C,5,-9277.220000000001,5,0,9277.220000000001,0.0
24119,UE77867,5,1083.7,3,2,1200.0,2283.7
24120,UC828F3,5,1546.06,3,2,3954.4,5500.46
24121,U6636F5,5,9270.0,2,3,97850.0,107120.0
24122,UBD3E5D,5,7731.17,0,5,0.0,7731.17
24123,UE13E51,5,845.0,2,3,22570.0,23415.0
24124,UF6006A,5,-1051.73,3,2,4200.0,3148.27
24125,UC7CED6,5,-14891.0,4,1,29420.0,14529.0
24126,U438C20,5,741.14,2,3,141.85,882.99
24127,U59545F,5,18600.0,3,2,18600.0,37200.0
24128,U996F11,5,-3779.9,4,1,3781.9,2.0
24129,UBB008F,5,0.3899999999994179,1,4,7000.0,7000.389999999999
24130,UABBA0A,5,3079.7999999999993,2,3,14435.2,17515.0
24131,U06F223,5,10.0,4,1,190.0,200.0
24132,U2BB287,5,-785.0,3,2,3200.0,2415.0
24133,UF8C3AE,5,-1300.0,3,2,8700.0,7400.0
24134,UBEF941,5,651.8,3,2,617.2,1269.0
24135,UF35ABE,5,23.840000000000032,4,1,176.15999999999997,200.0
24136,UFAA6B8,5,0.029999999999972715,2,3,1200.0,1200.03
24137,U178F89,5,-69.44,4,1,73.64,4.2
24138,UEC0DB4,5,-334.28,4,1,344.28,10.0
24139,U359627,5,-46403.69,2,3,46464.0,60.31
24140,U60BCCA,5,-3963.1,2,3,4095.0,131.9
24141,U0F6D77,5,233.0,2,3,817.0,1050.0
24142,UE5AC47,5,0.0,3,2,216.0,216.0
24143,U18196A,5,189.04999999999995,3,2,7660.0,7849.05
24144,U52A415,5,1205.91,2,3,13657.0,14862.91
24145,UC50A6F,5,-1124.3700000000001,4,1,1124.4,0.03
24146,UD98E22,5,-280.5900000000002,3,2,3464.28,3183.69
24147,UD9EBE5,5,-3251.5,4,1,3271.5,20.0
24148,U8E1FDD,5,2117.9800000000105,1,4,210000.0,212117.98
24149,UFDEC79,5,156.98,4,1,43.02000000000001,200.0
24150,U125DFF,5,125.30000000000001,4,1,270.5,395.8
24151,UC3A45D,5,17.800000000046566,2,3,2000358.92,2000376.72
24152,UE812C4,5,10000.0,1,4,19000.0,29000.0
24153,UA4A43E,5,-15.99,2,3,5816.0,5800.01
24154,U5C06A5,5,1021.0,3,2,2646.34,3667.34
24155,U201299,5,3808.1400000000003,3,2,191.86,4000.0
24156,U98F62A,5,-544.510000000002,3,2,35653.86,35109.35
24157,U3886E4,5,4769.0,2,3,4946.0,9715.0
24158,U5A43D3,5,601.4,3,2,1471.6,2073.0
24159,UDD2BAD,5,-1209.6799999999998,4,1,1309.6799999999998,100.0
24160,UB21B86,5,-59.96,4,1,79.96000000000001,20.0
24161,UE17603,5,-4980.0,3,2,14980.0,10000.0
24162,UAC9599,5,-66.0,2,3,3966.0,3900.0
24163,UDFB2C8,5,2129.5,3,2,1504.3,3633.8
24164,UD20581,5,15700.0,3,2,12010.0,27710.0
24165,U4F2D44,5,50000.0,1,4,100.0,50100.0
24166,UE22CBB,5,0.0,4,1,10.0,10.0
24167,U217A40,5,-580.44,3,2,606.0,25.560000000000002
24168,U6F2A12,5,-345.06,4,1,345.07,0.01
24169,U419A94,5,0.0,3,2,3526.0,3526.0
24170,U23F285,5,550.0,3,2,6140.5,6690.5
24171,U2E5887,5,1469.3999999999999,3,2,130.67,1600.07
24172,UBFC4FE,5,-1355.6300000000003,1,4,8000.0,6644.37
24173,UD067C5,5,0.2199999999997999,2,3,7965.0,7965.219999999999
24174,U6EEE6F,5,-3050.41,3,2,6767.0,3716.59
24175,UE763A0,5,366.78999999999996,3,2,9633.21,10000.0
24176,UE9F44F,5,-542.44,2,3,1020.0,477.56
24177,U2BCB1A,5,0.0,3,2,4200.0,4200.0
24178,U1C38BB,5,-5956.0,4,1,6036.0,80.0
24179,UC9BD37,5,2180.0,3,2,2833.8599999999997,5013.86
24180,U1755EA,5,-866.0,3,2,77524.0,76658.0
24181,U18B87D,5,194.0,2,3,8006.0,8200.0
24182,UCFBC76,5,-49992.48,3,2,50016.5,24.02
24183,U3143C8,5,100.0,2,3,3202.0,3302.0
24184,U3C8A20,5,149959.52,2,3,1700.1,151659.62
24185,UDBF279,5,149.94,0,5,0.0,149.94
24186,U5028F3,5,995.0,3,2,826.0,1821.0
24187,U18987E,5,42.0,3,2,508.0,550.0
24188,U451274,5,-1111.4,4,1,1389.0,277.6
24189,UDC483E,5,0.03999999999976353,2,3,6373.8,6373.839999999999
24190,U2CD47B,5,-1162.5,3,2,3000.0,1837.5
24191,UC12F71,5,302.65,3,2,1584.7,1887.35
24192,UDAB9A0,5,73.20999999999998,2,3,454.0,527.21
24193,U998EA3,5,-25233.0,3,2,62000.0,36767.0
24194,UCB88BE,5,0.5099999999999977,3,2,277.18,277.69
24195,U5CCE42,5,4914.75,4,1,285.25,5200.0
24196,UCEB377,5,250.0,2,3,450.0,700.0
24197,UA23D3C,5,7000.0,3,2,4910.0,11910.0
24198,UABCBB1,5,-6000.0,3,2,22008.0,16008.0
24199,UF5EF5F,5,-51.879999999999995,2,3,1504.0,1452.12
24200,U522DB3,5,-5062.72,3,2,5101.0,38.28
24201,UD9B252,5,11.360000000000014,3,2,263.44,274.8
24202,UB19DD6,5,0.0,3,2,8400.0,8400.0
24203,U109DC5,5,-113.0,3,2,39103.7,38990.7
24204,UCDD45A,5,-499.7,4,1,999.4,499.7
24205,UE2874F,5,-371.96999999999997,4,1,949.94,577.97
24206,U111AA4,5,-2.279999999998836,3,2,34063.18,34060.9
24207,UF274DA,5,15000.0,3,2,253.5,15253.5
24208,U990A30,5,3999.99,1,4,0.01,4000.0
24209,UE69954,5,-7.105427357601002e-15,3,2,342.49,342.49
24210,U20123D,5,-56.5,5,0,56.5,0.0
24211,UA15A57,5,0.0,2,3,107.0,107.0
24212,UD8FF13,5,-4119.9400000000005,3,2,8120.0,4000.06
24213,UFFBF88,5,14.650000000000006,3,2,145.45,160.1
24214,UC984CD,5,-89.20999999999998,4,1,388.21,299.0
24215,U9F1D62,5,-240.0,3,2,24240.0,24000.0
24216,U2F00F9,5,1611.23,2,3,10.0,1621.23
24217,U8323C5,5,3619.9900000000007,2,3,4010.0,7629.990000000001
24218,U7288B8,5,534.3699999999999,3,2,945.1500000000001,1479.52
24219,UD8621F,5,14.040000000008149,2,3,260000.0,260014.04
24220,U84CF07,5,92.0,3,2,3010.0,3102.0
24221,UC1E58D,5,-112.98000000000002,4,1,2112.98,2000.0
24222,UEF09AF,5,-8.7199999999998,2,3,5158.0,5149.280000000001
24223,UDADDE7,5,7608.040000000001,2,3,1010.0,8618.04
24224,U8A0706,5,-15994.22,4,1,16044.22,50.0
24225,U0BA53B,5,890.0,3,2,810.0,1700.0
24226,U8421EA,5,-3760.0,4,1,26648.0,22888.0
24227,U509C01,5,-113.91,2,3,114.31,0.4
24228,UD1CD26,5,3167.56,2,3,10.0,3177.56
24229,U868B95,5,15.0,2,3,515.0,530.0
24230,U326EE3,5,489.0,3,2,388.0,877.0
24231,U75AB81,5,3261.4400000000005,4,1,5566.32,8827.76
24232,U612444,5,-38.45000000000073,2,3,25265.12,25226.67
24233,UD840B8,5,-0.17000000000007276,3,2,21811.0,21810.83
24234,UCF6BB8,5,-4950.0,3,2,14850.0,9900.0
24235,U5F4DCB,5,0.04,2,3,3.71,3.75
24236,UDCA704,5,1810.6999999999998,4,1,1289.3000000000002,3100.0
24237,U35C84F,5,-29366.46,4,1,29907.03,540.57
24238,U9B6412,5,4.9099999999998545,2,3,5007.1,5012.01
24239,UBA117A,5,-6277.309999999999,2,3,22725.0,16447.69
24240,U21B3BE,5,4415.55,2,3,3314.0299999999997,7729.58
24241,UA8AC03,5,485.8900000000001,2,3,1114.11,1600.0
24242,UCFA1B0,5,-861.19,4,1,861.48,0.29
24243,U1C8B94,5,1321.2299999999996,4,1,7823.82,9145.05
24244,U2B3DE5,5,-25.579999999999927,2,3,3500.0,3474.42
24245,UC6048F,5,360.0,2,3,10.0,370.0
24246,UAAB462,5,100.0,2,3,248.0,348.0
24247,UC2AAC1,5,-27948.660000000003,5,0,27948.660000000003,0.0
24248,U78B8ED,5,-2.3999999999999773,2,3,958.4,956.0
24249,U26AB82,5,939.87,3,2,9060.13,10000.0
24250,UDA7E8F,5,4.44,2,3,5996.0,6000.44
24251,UA70209,5,2.831068712794149e-15,3,2,43.5,43.5
24252,U8E978B,5,-748.0,3,2,1308.0,560.0
24253,U639B16,5,-932.0,4,1,1520.0,588.0
24254,U8AD376,5,-2809.05,3,2,4684.0,1874.95
24255,U998A2C,5,21.779999999999973,2,3,2701.7,2723.48
24256,U3BAC74,5,-123.3799999999992,3,2,10130.0,10006.62
24257,U54E90E,5,2931.4,2,3,5905.0,8836.4
24258,UFEAE99,5,-7524.150000000001,3,2,7862.97,338.82
24259,UC91540,5,-88.79999999999998,4,1,292.2,203.4
24260,U33B502,5,1958.1699999999998,2,3,2782.37,4740.54
24261,U463D65,5,-4939.820000000001,4,1,4941.820000000001,2.0
24262,U2B22BC,5,35.88,4,1,101.02000000000001,136.9
24263,U176AC6,5,285.10999999999996,3,2,155.89000000000001,441.0
24264,UBBBBA3,5,0.0,4,1,105.0,105.0
24265,U49C1A0,5,-2351.0,5,0,2351.0,0.0
24266,U9E147F,5,-508.01,4,1,609.01,101.0
24267,U1A8598,5,0.0,3,2,63.07,63.07
24268,U6D96D8,5,-91.83,4,1,183.66,91.83
24269,U58E803,5,5436.47,1,4,4120.0,9556.470000000001
24270,UB33072,5,460.0,3,2,158.51,618.51
24271,U9CC93C,5,0.0,3,2,3173.0,3173.0
24272,U5BEC29,5,-435.53999999999996,4,1,485.53999999999996,50.0
24273,U899BFB,5,0.47,2,3,1.18,1.65
24274,U85BCD4,5,0.010000000000005116,2,3,150.0,150.01
24275,U0DB496,5,0.0,3,2,1784.0,1784.0
24276,U07A99B,5,8555.0,3,2,445.0,9000.0
24277,U8BBCBB,5,-3000.0,3,2,13000.0,10000.0
24278,UB31A5D,5,60.0,3,2,5940.0,6000.0
24279,U2398C1,5,405.03999999999996,0,5,0.0,405.03999999999996
24280,UA05B44,5,-2200.0,3,2,9000.0,6800.0
24281,U67149A,5,1550.11,1,4,1479.17,3029.28
24282,U3783D3,5,353.6199999999999,4,1,646.3800000000001,1000.0
24283,U95575B,5,7600.0,2,3,21500.0,29100.0
24284,U54E67C,5,50.799999999999955,4,1,1049.2,1100.0
24285,UD3B167,5,-1430.0,2,3,5829.0,4399.0
24286,UEA059F,5,139.51999999999998,3,2,1470.94,1610.46
24287,UF1185E,5,-996.0,3,2,7000.0,6004.0
24288,U9F1EB3,5,1356.0,1,4,27542.0,28898.0
24289,U835418,5,-8205.82,2,3,17528.95,9323.13
24290,U740D6A,5,-15.0,3,2,10000.0,9985.0
24291,UDB1C0C,5,-8038.9800000000005,2,3,13000.0,4961.0199999999995
24292,UFE891E,5,1500.44,0,5,0.0,1500.44
24293,U894BCB,5,10326.19,3,2,2212.0,12538.19
24294,UEB36B5,5,-324.71000000000004,5,0,324.71000000000004,0.0
24295,UF75592,5,-2228.2,4,1,2428.2,200.0
24296,U59C62A,5,29290.0,2,3,10.0,29300.0
24297,U81ADBE,5,3069.8600000000006,3,2,3010.0,6079.860000000001
24298,UAEB2D5,5,234.32000000000002,2,3,97.6,331.9200000000001
24299,U1545C4,5,1465.0,3,2,11420.0,12885.0
24300,U5785AB,5,-103.41,4,1,103.97,0.56
24301,UDC3EEA,5,-2989.97,2,3,6000.0,3010.03
24302,U2255A2,5,-1762.75,3,2,6817.0,5054.25
24303,UA5D294,5,0.010000000000218279,2,3,16000.0,16000.01
24304,U1D8298,5,135.61000000000013,2,3,2464.6,2600.21
24305,UEF16EA,5,20.0,2,3,29980.0,30000.0
24306,U0C8ACB,5,90.0,2,3,3010.0,3100.0
24307,UBE9505,5,69.0,1,4,3004.0,3073.0
24308,UB05069,5,0.0,3,2,510.0,510.0
24309,U912BD6,5,9198.3,3,2,10101.7,19300.0
24310,UDA7CDE,5,101945.67,2,3,6.0,101951.67
24311,U2A66AA,5,845.0,3,2,142.0,987.0
24312,U88BD31,5,-9697.0,3,2,28635.0,18938.0
24313,UA3BB44,5,-27.960000000000036,3,2,5980.0,5952.04
24314,UFD055E,5,-5365.47,3,2,5845.0,479.53
24315,UD46BE2,5,-11842.0,5,0,11842.0,0.0
24316,UCD0085,5,-87.55,3,2,356.57,269.02
24317,U695B1B,5,-148.39999999999995,3,2,570.8,422.40000000000003
24318,U7826AE,5,-7804.4,4,1,10328.0,2523.6
24319,UB4404D,5,-4997.97,3,2,9998.0,5000.03
24320,U3D6DFE,5,-6479.0,2,3,9901.0,3422.0
24321,U6DA0F2,5,-697.1800000000001,2,3,3500.0,2802.8199999999997
24322,UC3F864,5,80.0,4,1,320.0,400.0
24323,U38440C,5,-407.24,5,0,407.24,0.0
24324,U4B45A8,5,2259.0,3,2,3884.0,6143.0
24325,U7B9BC9,5,-7.48,4,1,8.0,0.52
24326,UB4EE17,5,43.75,4,1,512.5,556.25
24327,U1397CB,5,0.0,3,2,38000.0,38000.0
24328,U139B9B,5,35002.0,2,3,19998.0,55000.0
24329,U024A3A,5,-181.01000000000022,3,2,2905.0,2723.99
24330,UF162B5,5,-53.93,4,1,67.83,13.9
24331,U36CCDA,5,-9989.0,5,0,9989.0,0.0
24332,UAE3551,5,0.07,2,3,258.32,258.39
24333,U716A67,5,-140.58000000000004,4,1,305.58000000000004,165.0
24334,UB63E4D,5,-9.98,3,2,10.02,0.04
24335,UEE2ADC,5,12634.2,2,3,10165.8,22800.0
24336,UF54061,5,-2067.0,5,0,2067.0,0.0
24337,U6174BF,5,106.90000000000055,2,3,5894.36,6001.26
24338,U4601E2,5,1238.0,3,2,14752.0,15990.0
24339,U3D08A2,5,4.01,3,2,6.0,10.01
24340,U9D17A0,5,-589.99,4,1,590.0,0.01
24341,U669780,5,-1802.04,4,1,1812.04,10.0
24342,U19EADF,5,612.8000000000001,2,3,1487.23,2100.0299999999997
24343,U290F5D,5,102.47999999999999,2,3,162.15,264.62999999999994
24344,UDDE168,5,177.67,2,3,222.35999999999999,400.03
24345,U832BB6,5,-297.47,5,0,297.47,0.0
24346,U522A3E,5,8285.04,3,2,2466.0,10751.04
24347,U5AD97C,5,-3.0,3,2,34.120000000000005,31.12
24348,U39E93B,5,-0.47999999999997556,3,2,180.78,180.3
24349,UF7B407,5,1115.27,2,3,10.0,1125.27
24350,UF9C181,5,232.0,4,1,2068.0,2300.0
24351,UCDF88E,5,40.0,3,2,19.380000000000003,59.38
24352,UD6122F,5,-286.0,3,2,1024.97,738.97
24353,UB8C900,5,-1257.87,3,2,1597.87,340.0
24354,U48C88A,5,-537.9699999999999,4,1,1075.94,537.97
24355,UE17BD6,5,380.69000000000005,2,3,3000.0,3380.69
24356,U4325C8,5,27.150000000001455,3,2,10506.0,10533.150000000001
24357,U92797D,5,-76.72000000000025,4,1,2158.4,2081.68
24358,UAD6F55,5,-1406.74,3,2,1519.8,113.06
24359,U096650,5,-1480.5,4,1,1630.5,150.0
24360,U78B07F,5,2.0999999999999943,2,3,183.9,186.0
24361,UC1DBF7,5,-26768.0,4,1,59200.0,32432.0
24362,UE647AD,5,0.0,3,2,6000.0,6000.0
24363,U828324,5,-8508.21,3,2,14607.25,6099.04
24364,UDD7101,5,-1000.44,4,1,1050.44,50.0
24365,UE4A8B0,5,-26.790000000000006,2,3,127.21000000000001,100.42
24366,UC02243,5,-2928.0,4,1,4028.0,1100.0
24367,U73BF37,5,-304.44,4,1,504.44,200.0
24368,U43F5D4,5,-0.08000000000000007,3,2,8.09,8.01
24369,UB07852,5,4.690000000000055,2,3,4105.58,4110.27
24370,U663C0A,5,-5537.0,4,1,10543.0,5006.0
24371,U356E2E,5,3520.0,2,3,4980.01,8500.01
24372,U8EB389,5,-1150.0,3,2,10050.0,8900.0
24373,UF2C038,5,0.0,4,1,541.67,541.67
24374,U15D5E4,5,-7018.0,3,2,16742.0,9724.0
24375,UCE8384,5,-1693.0800000000004,4,1,2293.0800000000004,600.0
24376,U533285,5,-770.8499999999999,4,1,3237.6,2466.75
24377,U143737,5,-19416.0,3,2,19990.0,574.0
24378,U955E31,5,0.22999999999956344,2,3,5800.0,5800.23
24379,U9C0015,5,16500.02,1,4,16340.87,32840.89
24380,UDC3EC8,5,1.0900000000001455,3,2,3325.91,3327.0
24381,UB6AC37,5,-60.23999999999796,2,3,43800.0,43739.76
24382,U2D55D8,5,-19100.0,2,3,39099.990000000005,19999.99
24383,U1AAEAA,5,6647.32,2,3,1153.0,7800.32
24384,U026894,5,-1154.9299999999998,4,1,1261.12,106.19
24385,U3A980A,5,-588.0,2,3,26600.0,26012.0
24386,UC65C7C,5,447.67999999999984,4,1,3429.9,3877.58
24387,U0F9423,5,2.842170943040401e-14,3,2,223.70999999999998,223.71
24388,U58A6EB,5,81.16999999999962,3,2,5005.0,5086.17
24389,U58653B,5,1528.6899999999996,3,2,4470.8,5999.49
24390,UE27334,5,2306.07,2,3,35.0,2341.07
24391,UC02F97,5,-16862.82,3,2,24376.0,7513.18
24392,UC6F012,5,-2946.66,4,1,3146.66,200.0
24393,U499F72,5,5.259999999999991,1,4,1020.0,1025.26
24394,U115571,5,907.0,1,4,530.0,1437.0
24395,U7D7FFE,5,-3070.38,4,1,3071.3,0.92
24396,UD1DBF9,5,-4096.0,5,0,4096.0,0.0
24397,U79DF5F,5,5740.94,4,1,1259.0600000000002,7000.0
24398,U3EFE71,5,2475.01,2,3,2525.0,5000.01
24399,U6609C6,5,0.09999999999990905,3,2,2505.9,2506.0
24400,U9EA6B6,5,17460.73,3,2,400.0,17860.73
24401,U0B9A83,5,153.90000000000003,3,2,355.95,509.85
24402,U5BB470,5,0.06000000000000355,3,2,74.4,74.46000000000001
24403,UEE9CA1,5,2271.87,3,2,310.0,2581.87
24404,U00DCAA,5,3400.0,0,5,0.0,3400.0
24405,U9D351B,5,-3.360000000000582,3,2,19795.18,19791.82
24406,UCEBFF3,5,30.0,1,4,50.0,80.0
24407,U0B7E2E,5,7000.0,1,4,3500.0,10500.0
24408,UAE8618,5,-825.0,4,1,1960.0,1135.0
24409,UE96016,5,439.5799999999999,2,3,800.0,1239.58
24410,U85E659,5,8530.1,0,5,0.0,8530.1
24411,U61032D,5,4649.1,2,3,87.7,4736.8
24412,U0DFEEA,5,14915.0,3,2,13410.0,28325.0
24413,U1A896B,5,-0.7100000000000364,3,2,6200.71,6200.0
24414,U8565B2,5,-1175.5,4,1,2694.0,1518.5
24415,UDA4EB5,5,-3470.0,3,2,5700.0,2230.0
24416,U1768CD,5,838.77,3,2,710.0,1548.77
24417,UB182F6,5,-3924.6,4,1,3925.6,1.0
24418,U3285C8,5,5.0,2,3,10.0,15.0
24419,UE98034,5,0.0,3,2,3825.0,3825.0
24420,U0E3770,5,500.0,3,2,37500.0,38000.0
24421,U20D413,5,999.22,3,2,1.02,1000.24
24422,U18EAB8,5,-661.8499999999999,4,1,2161.85,1500.0
24423,U5EF254,5,19.0,2,3,25.0,44.0
24424,UBC665F,5,-517.6600000000001,3,2,2917.66,2400.0
24425,U630CAA,5,-0.7999999999997454,2,3,9960.0,9959.2
24426,U8305F6,5,-245.80000000000018,3,2,8500.0,8254.2
24427,U8664A3,5,232.3800000000001,2,3,2568.56,2800.94
24428,UA3AC8D,5,2067.8,2,3,210.0,2277.8
24429,U0A0FD7,5,2599.65,3,2,3.35,2603.0
24430,U9CF538,5,-233.90999999999997,3,2,1234.0,1000.09
24431,UF5A163,5,6072.02,3,2,460.0,6532.02
24432,U1550CB,5,-1192.66,3,2,6195.24,5002.58
24433,U4B7D33,5,13984.0,2,3,228.0,14212.0
24434,U7D2216,5,4116.18,1,4,10000.0,14116.18
24435,U72F6D5,5,2444.21,2,3,1509.0,3953.21
24436,U373B14,5,-8199.0,3,2,8999.0,800.0
24437,U2D28B4,5,-4345.98,5,0,4345.98,0.0
24438,UF77C33,5,3300.0,0,5,0.0,3300.0
24439,U99FAD8,5,871.5999999999999,3,2,3000.0,3871.6
24440,UC79110,5,-901.88,4,1,902.0,0.12
24441,UE50885,5,-10.0,5,0,10.0,0.0
24442,U8A0AA5,5,2350.0,3,2,7050.0,9400.0
24443,UBBCE83,5,552.8499999999995,3,2,9049.28,9602.130000000001
24444,U7DD6AA,5,28586.0,0,5,0.0,28586.0
24445,UAE95A8,5,-700.5,5,0,700.5,0.0
24446,U0EF603,5,-32.48999999999978,3,2,4815.5,4783.01
24447,UA2B646,5,16978.6,3,2,533.0,17511.6
24448,U0F0DCA,5,-868.9300000000003,3,2,15000.0,14131.07
24449,UB620EF,5,-58.0,4,1,358.0,300.0
24450,U5D94F8,5,52284.0,0,5,0.0,52284.0
24451,U0AADE5,5,-9000.0,3,2,28980.0,19980.0
24452,UA290BE,5,-58.44,3,2,366.01,307.57
24453,UBAA13F,5,45000.0,2,3,6000.0,51000.0
24454,U1EDAA2,5,3474.0,0,5,0.0,3474.0
24455,UCE5CF8,5,-2844.0,3,2,5717.01,2873.01
24456,U5E7E81,5,546.7900000000009,2,3,22642.0,23188.79
24457,U043AB3,5,-5.74,2,3,6.0,0.26
24458,U73BBBC,5,0.19000000000050932,2,3,16896.0,16896.190000000002
24459,UDD6912,5,-1309.0,3,2,2320.0,1011.0
24460,U45AC6B,5,-15363.0,4,1,16561.0,1198.0
24461,U097316,5,95000.0,1,4,16.0,95016.0
24462,U5D1AD7,5,-1489.9999999999998,4,1,2965.14,1475.14
24463,U6CFBA1,5,0.0,3,2,679.6,679.6
24464,U40403C,5,5.070000000000164,2,3,5310.0,5315.07
24465,U8B010E,5,980.0,2,3,3970.0,4950.0
24466,U4672F6,5,57.30000000000001,3,2,418.7,476.0
24467,U02919C,5,-1276.0,3,2,6372.0,5096.0
24468,UDD335D,5,3721.06,2,3,238.94,3960.0
24469,U6AC159,5,2000.06,0,5,0.0,2000.06
24470,U59167D,5,-1598.7400000000002,4,1,4308.74,2710.0
24471,U07F215,5,1679.0,2,3,98185.0,99864.0
24472,U665433,5,-402.9699999999998,3,2,2403.54,2000.57
24473,UE4F070,5,-189.97,4,1,489.97,300.0
24474,U44434A,5,-610.96,4,1,930.96,320.0
24475,UA6AD5A,5,1736.3800000000006,4,1,5263.62,7000.0
24476,U9F5910,5,88.56,3,2,11.5,100.06
24477,U6B7019,5,1524.3,2,3,690.95,2215.25
24478,U1777FD,5,-27.0,3,2,18127.0,18100.0
24479,U4CA4C0,5,-762.0,3,2,2480.0,1718.0
24480,U67C9BF,5,-11.889999999999873,4,1,2211.89,2200.0
24481,UFD53ED,5,699.0,2,3,2782.0,3481.0
24482,UD5E8A7,5,-297.6300000000001,2,3,10298.32,10000.689999999999
24483,UB2A666,5,0.0,3,2,265.0,265.0
24484,UCB1610,5,6000.8,0,5,0.0,6000.8
24485,U8BE95E,5,3905.0,0,5,0.0,3905.0
24486,U5794B9,5,700.0,2,3,2625.0,3325.0
24487,U1960B1,5,0.0,2,3,329.5,329.5
24488,U26E022,5,-995.06,4,1,995.54,0.48
24489,U4AFE5D,5,8972.0,3,2,3000.0,11972.0
24490,UCF4384,5,320.0,3,2,980.0,1300.0
24491,U74870F,5,-9000.0,3,2,18000.0,9000.0
24492,U4E0D01,5,301.1700000000001,2,3,1650.0,1951.17
24493,U5B99E3,5,79.02999999999997,1,4,178.0,257.03
24494,UAD51E7,5,11.609999999999673,2,3,11300.0,11311.61
24495,U68C914,5,49.89999999999981,3,2,6178.1,6228.0
24496,U83BABD,5,4991.31,3,2,528.75,5520.06
24497,UCE1BA2,5,-78.36999999999944,2,3,14050.0,13971.630000000001
24498,U0A54DC,5,0.009999999999990905,3,2,449.99,450.0
24499,UA919C3,5,-6426.82,3,2,6696.5,269.68
24500,UD8AD79,5,-96.0,4,1,195.0,99.0
24501,U5E790D,5,-2385.0,3,2,2570.0,185.0
24502,UB90DF7,5,-182.0,3,2,286.0,104.0
24503,UCA1F91,5,-130.07,1,4,225.0,94.93
24504,U6128BF,5,-70.0,3,2,5815.0,5745.0
24505,UB263AF,5,-273.63,4,1,273.68,0.05
24506,UDCCF4D,5,-3126.0,5,0,3126.0,0.0
24507,U2B03AE,5,-376.5,3,2,7815.5,7439.0
24508,UD87455,5,7300.04,2,3,5975.87,13275.91
24509,U0E627D,5,-3835.9799999999996,3,2,7822.0,3986.02
24510,UEB2179,5,-4.989999999999998,3,2,28.0,23.01
24511,U9E4FC2,5,301.49,3,2,0.51,302.0
24512,U0B43D4,5,375.0,4,1,2725.0,3100.0
24513,U1FAAC2,5,-37799.0,4,1,59799.0,22000.0
24514,U693727,5,33.00999999999999,3,2,1039.99,1073.0
24515,U0D6D4D,5,5491.0,3,2,5009.0,10500.0
24516,U930DCD,5,1619.0,2,3,950.0,2569.0
24517,U22D761,5,-121.48000000000002,3,2,433.0,311.52
24518,UD6BCB0,5,2326.44,2,3,204.0,2530.44
24519,U90FBBA,5,80.75,2,3,5300.0,5380.75
24520,U2DC42E,5,244.99,0,5,0.0,244.99
24521,U81979B,5,50800.0,1,4,19000.0,69800.0
24522,U8AD888,5,-5422.0,4,1,5482.0,60.0
24523,UD42A1A,5,4684.0,3,2,6316.0,11000.0
24524,UE9C978,5,0.0,3,2,1660.0,1660.0
24525,UE4A46B,5,-130.0,4,1,146.0,16.0
24526,UD24F0C,5,296.98,2,3,2017.0,2313.98
24527,U2561A6,5,-295.29,2,3,301.45,6.16
24528,UAC9AD0,5,78.0,4,1,2360.0,2438.0
24529,U88604F,5,2016.12,2,3,15146.0,17162.12
24530,UC19A56,5,-6992.0,4,1,13986.0,6994.0
24531,U20EFA4,5,5895.0,2,3,10105.0,16000.0
24532,U015C2E,5,350.0,3,2,700.0,1050.0
24533,U5B9969,5,-65.80000000000001,4,1,111.04,45.24
24534,U983714,5,13419.88,1,4,1000.0,14419.88
24535,UAB97C9,5,120.01,2,3,120.01,240.01999999999998
24536,U538051,5,5216.95,0,5,0.0,5216.95
24537,U309EC8,5,-16131.0,3,2,37246.0,21115.0
24538,UA2A10F,5,-13470.560000000001,4,1,13470.580000000002,0.02
24539,U7F762F,5,-13371.810000000001,2,3,25000.0,11628.189999999999
24540,U5198A3,5,0.0,4,1,19500.0,19500.0
24541,UD5B246,5,-1082.4499999999998,4,1,2163.34,1080.89
24542,UFC1B7E,5,-1337.6299999999999,2,3,8700.0,7362.37
24543,U25EC26,5,940.14,4,1,1810.1799999999998,2750.32
24544,U66390C,5,-558.39,5,0,558.39,0.0
24545,UD417E2,5,18.57,2,3,24.240000000000002,42.81
24546,UE41049,5,1231.2199999999998,1,4,168.0,1399.2199999999998
24547,U324A03,5,-7986.5599999999995,4,1,7986.57,0.01
24548,U6EC0B8,5,1398.01,2,3,2.0,1400.01
24549,U93E42E,5,23198.119999999995,2,3,22998.0,46196.119999999995
24550,U911D63,5,877.0,0,5,0.0,877.0
24551,UF23C9B,5,-462.25,5,0,462.25,0.0
24552,UEC279F,5,0.0,3,2,4996.0,4996.0
24553,U868FF8,5,83.0,3,2,5832.0,5915.0
24554,U82D529,5,140.51,2,3,236.0,376.51
24555,UDDE624,5,-1659.4300000000003,3,2,15510.0,13850.57
24556,U1F5098,5,3000.0,2,3,5999.88,8999.880000000001
24557,UE52D7C,5,-1860.0,4,1,2360.0,500.0
24558,U5EF19B,5,-21713.14,3,2,21714.2,1.06
24559,UE8AA97,5,8470.94,2,3,56.129999999999995,8527.07
24560,U90947C,5,-209.97999999999593,3,2,41122.0,40912.02
24561,UEAA426,5,-109.5,3,2,3609.6,3500.1
24562,U3A04D2,5,9.019999999999982,2,3,1100.0,1109.02
24563,UBDBEBD,5,-170.0,4,1,747.0,577.0
24564,U821E2C,5,-6.0,3,2,342.0,336.0
24565,U26824D,5,0.0,3,2,2810.0,2810.0
24566,U744D43,5,999.47,2,3,2.0,1001.47
24567,UBAB9EE,5,-1469.7599999999998,4,1,1569.7599999999998,100.0
24568,U3B0BEE,5,-699.0,3,2,26720.0,26021.0
24569,UEA0191,5,-219.85000000000005,2,3,1869.8500000000001,1650.0
24570,U86C09E,5,-148.68,3,2,300.0,151.32
24571,U76566A,5,34.2,3,2,65.0,99.2
24572,UCA266B,5,0.0,3,2,3010.0,3010.0
24573,UEB8673,5,-10145.470000000001,4,1,10145.54,0.07
24574,U3A2D22,5,4.960000000000036,2,3,1754.96,1759.92
24575,U63A807,5,-2023.0,3,2,7941.0,5918.0
24576,U0D4BB5,5,9000.0,2,3,18000.0,27000.0
24577,U8577F9,5,3176.17,2,3,10.0,3186.17
24578,UEA49A9,5,1208.5,3,2,2191.5,3400.0
24579,UE83922,5,0.0,3,2,9610.0,9610.0
24580,UB3DDAB,5,-49.97,2,3,151.63,101.66
24581,UCA147C,5,-263295.0,4,1,263300.0,5.0
24582,UC12A4F,5,-981.0,3,2,16981.0,16000.0
24583,U651490,5,-802.2,5,0,802.2,0.0
24584,U27C4D3,5,2063.05,2,3,3737.0,5800.05
24585,UB1001B,5,182.0,3,2,228.0,410.0
24586,U221324,5,-464.77,4,1,466.01,1.24
24587,U6E5629,5,2768.0,1,4,2200.0,4968.0
24588,UD6ED4D,5,-110.2,4,1,220.4,110.2
24589,U865371,5,269.84000000000003,1,4,836.16,1106.0
24590,UDA05D1,5,-7.879999999999999,3,2,98.35,90.47
24591,U192751,5,-22521.55,4,1,38521.55,16000.0
24592,U9F8DB3,5,493.7799999999999,3,2,282.8,776.5799999999999
24593,UAA82BE,5,403.79999999999995,3,2,1096.2,1500.0
24594,UA53F30,5,6.779999999999987,4,1,793.22,800.0
24595,UF60961,5,-3180.46,4,1,3180.5,0.04
24596,U1B68AE,5,-508.26,4,1,708.26,200.0
24597,U523839,5,0.0,4,1,3000.0,3000.0
24598,U0662B2,5,-10000.0,3,2,20500.0,10500.0
24599,UE1E726,5,-1153.67,4,1,1153.68,0.01
24600,U3B9796,5,405.13,1,4,11605.0,12010.13
24601,U48DECD,5,-1306.6899999999998,3,2,2502.7,1196.01
24602,UFDBAC2,5,-23.0,3,2,5223.0,5200.0
24603,U71D6BF,5,0.0,3,2,507.0,507.0
24604,U51D74B,5,6195.660000000001,1,4,6194.45,12390.11
24605,UDCD063,5,-3115.12,4,1,3155.12,40.0
24606,U61F0E0,5,358.0,3,2,5060.0,5418.0
24607,UDE4745,5,-5704.88,3,2,11852.6,6147.72
24608,UFBF376,5,440.2000000000003,3,2,3650.0,4090.2000000000003
24609,UCAC013,5,26730.049999999996,1,4,29038.0,55768.049999999996
24610,U9CC470,5,-264.08000000000004,4,1,364.08000000000004,100.0
24611,U1F21EE,5,727.02,2,3,67.9,794.92
24612,U7A7B63,5,256.3299999999999,3,2,661.97,918.3
24613,U714854,5,-44860.0,2,3,88710.0,43850.0
24614,U195666,5,2240.02,2,3,260.0,2500.02
24615,U0DC87B,5,595.0,2,3,4600.0,5195.0
24616,U087365,5,1177.0,1,4,823.0,2000.0
24617,UC528C9,5,0.5,4,1,310.5,311.0
24618,U17C66C,5,234.39999999999964,3,2,14030.599999999999,14265.0
24619,U633DAE,5,4018.66,4,1,881.3399999999999,4900.0
24620,U5C4584,5,155.0,4,1,645.0,800.0
24621,UBDAE36,5,-1964.98,3,2,2947.0,982.02
24622,UE28CA7,5,-17698.7,2,3,25105.7,7407.0
24623,UF8B3ED,5,19.0,4,1,1209.0,1228.0
24624,UD2BF39,5,0.0,3,2,9413.0,9413.0
24625,U505721,5,18969.690000000002,0,5,0.0,18969.690000000002
24626,UD3C6A9,5,0.23000000000047294,2,3,8520.130000000001,8520.36
24627,U911FAF,5,300.0,4,1,23000.0,23300.0
24628,U55DE56,5,30000.0,2,3,60000.0,90000.0
24629,UFD5A46,5,-2556.0,3,2,6067.0,3511.0
24630,U6B5A8F,5,6046.0,3,2,2000.0,8046.0
24631,U20E6BB,5,-92.0,3,2,6161.0,6069.0
24632,UF6AC5D,5,-84.0,4,1,201.0,117.0
24633,U1EE893,5,4169.73,3,2,41018.0,45187.729999999996
24634,U98E4EA,5,0.020000000000436557,1,4,18000.0,18000.02
24635,U933691,5,-132.79999999999995,3,2,1106.0,973.2
24636,U51E05B,5,2000.0,3,2,18.0,2018.0
24637,U3B4A97,5,5964.07,3,2,221.22,6185.289999999999
24638,U0B489B,5,7163.05,0,5,0.0,7163.05
24639,U3C7DD7,5,1901.1599999999999,1,4,248.2,2149.36
24640,UB94486,5,-199.99,2,3,9400.0,9200.01
24641,U054A16,5,-31.21,3,2,32.0,0.79
24642,U04DCF9,5,0.0,4,1,60.0,60.0
24643,U0E3619,5,20.0,4,1,210.0,230.0
24644,UCF6F7B,5,60813.76,2,3,10255.0,71068.76
24645,U0D1B7C,5,119.25999999999993,4,1,880.74,1000.0
24646,UDC8351,5,7443.969999999999,0,5,0.0,7443.969999999999
24647,U66BEBD,5,-5.653463808208414e-15,3,2,97.36,97.36
24648,U3B98E4,5,0.0,3,2,24980.0,24980.0
24649,U5BCC89,5,85.07999999999993,3,2,1915.0,2000.08
24650,U55B3E0,5,6982.0,2,3,2018.0,9000.0
24651,U8F0676,5,-379.70000000000005,2,3,3250.0,2870.3
24652,U57F102,5,5000.0,3,2,30020.0,35020.0
24653,U95853D,5,2.089999999999975,2,3,796.0,798.0899999999999
24654,UC26D98,5,2.0,2,3,7998.0,8000.0
24655,U04EC2C,5,400.0,4,1,1600.0,2000.0
24656,U098B7F,5,0.0,3,2,149.39,149.39
24657,U357532,5,0.01,2,3,0.46,0.47000000000000003
24658,UCC120F,5,-2990.0,4,1,4515.0,1525.0
24659,U1787F6,5,-268.44,5,0,268.44,0.0
24660,U5B2AEE,5,1600.14,2,3,10.0,1610.14
24661,UF0D126,5,5152.290000000001,2,3,27237.71,32390.0
24662,U03BDFA,5,20732.3,2,3,7380.7,28113.0
24663,U0F706D,5,-2899.7799999999997,4,1,3799.7799999999997,900.0
24664,U758D20,5,454.31999999999994,2,3,147.96,602.28
24665,U2E125F,5,-12897.01,4,1,12898.01,1.0
24666,UA60CB1,5,167.45,3,2,164.48000000000002,331.93
24667,U00B9F9,5,-1525.0,4,1,3010.0,1485.0
24668,U4089DE,5,-531.02,4,1,1061.02,530.0
24669,U909765,5,0.02,2,3,0.42000000000000004,0.44000000000000006
24670,UE3AF15,5,-18240.0,4,1,28240.0,10000.0
24671,UB88D8E,5,8.01,2,3,5892.0,5900.01
24672,U9E0F16,5,-11096.949999999999,5,0,11096.949999999999,0.0
24673,UA4A541,5,0.0,2,3,51043.229999999996,51043.229999999996
24674,UE081D3,5,834.0,3,2,2166.0,3000.0
24675,UC22364,5,324.0,2,3,648.0,972.0
24676,UD95C25,5,7954.93,2,3,7146.88,15101.810000000001
24677,U3B82EE,5,1333.24,2,3,162.0,1495.24
24678,U007594,5,2.079999999999984,3,2,425.92,428.0
24679,U53632D,5,-15.0,2,3,1164.0,1149.0
24680,U1B84A0,5,-5.320000000000164,2,3,2816.26,2810.94
24681,U821E03,5,0.1000000000003638,2,3,10994.9,10995.0
24682,UB468A4,5,10433.24,0,5,0.0,10433.24
24683,UEFFA83,5,-100001.99,4,1,100002.0,0.01
24684,U87F167,5,119.79999999999995,3,2,860.0,979.8
24685,U6ED24E,5,3000.0,2,3,2960.0,5960.0
24686,UCAD947,5,38013.25,1,4,30275.0,68288.25
24687,U5B834F,5,68.55999999999949,2,3,8300.0,8368.56
24688,U0F1166,5,15127.0,2,3,25000.0,40127.0
24689,UA1C2D7,5,-3700.0,2,3,8000.0,4300.0
24690,UD135AF,5,4195.0,2,3,1005.0,5200.0
24691,U31E0C8,5,10400.0,2,3,4500.0,14900.0
24692,UBA6D25,5,-316.56,2,3,1218.0,901.44
24693,U334F60,5,-407.0,4,1,1788.0,1381.0
24694,UE4D4FE,5,-5.960000000000036,3,2,2906.0,2900.04
24695,U16AA62,5,2190.0,2,3,10.0,2200.0
24696,UE74174,5,4830.0,2,3,12521.0,17351.0
24697,U266190,5,-800.0,3,2,3000.0,2200.0
24698,U4C331F,5,2040.07,1,4,2000.0,4040.0699999999997
24699,U267CE3,5,0.0,3,2,640.0,640.0
24700,U6AE233,5,2901.91,2,3,12000.0,14901.91
24701,UE86000,5,1.8299999999999272,2,3,3200.0,3201.83
24702,UC023A5,5,40000.0,3,2,241.0,40241.0
24703,UED112C,5,-550.0,2,3,29150.0,28600.0
24704,UA11EC4,5,-8550.01,4,1,9356.01,806.0
24705,U76E43B,5,887.52,2,3,710.0,1597.52
24706,UEEF470,5,15564.0,2,3,3836.0,19400.0
24707,U62872D,5,-81.01999999999998,3,2,5020.0,4938.98
24708,UFEBB01,5,-2656.12,3,2,4515.0,1858.8799999999999
24709,UE2C4C6,5,0.0,3,2,10560.0,10560.0
24710,UE5903C,5,106.0,4,1,594.0,700.0
24711,U6800A8,5,12.699999999999818,1,4,3140.0,3152.7
24712,U7995BC,5,-0.36000000000001364,2,3,1033.16,1032.8
24713,UE39167,5,4236.7,2,3,5000.0,9236.7
24714,UAE73A4,5,-12831.65,4,1,12839.35,7.7
24715,U8CB674,5,-723.87,3,2,768.92,45.05
24716,U4B6689,5,144.39999999999998,3,2,312.6,457.0
24717,UBE5BDD,5,-134.0,3,2,4034.0,3900.0
24718,UF566AB,5,3527.0499999999984,2,3,5179.39,8706.439999999999
24719,UAE1D82,5,0.0,3,2,5010.0,5010.0
24720,U08B135,5,-28.6899999999996,2,3,12838.0,12809.310000000001
24721,U0C7509,5,209.39999999999998,3,2,530.6,740.0
24722,UE776F2,5,-9.0951551845464e-15,4,1,1952.01,1952.01
24723,U1D9559,5,211.82999999999993,3,2,21057.0,21268.83
24724,UE53BD4,5,2228.0,3,2,2285.0,4513.0
24725,U99E769,5,822.0,2,3,10.0,832.0
24726,U8E8417,5,403.25,3,2,20.0,423.25
24727,UF79008,5,2824.19,3,2,25.0,2849.19
24728,UE4A461,5,16.0,2,3,40114.0,40130.0
24729,UB111F1,5,-2700.0,4,1,5400.0,2700.0
24730,UFFE0FD,5,2737.7,3,2,2985.0,5722.7
24731,U9EF019,5,-5823.879999999999,4,1,5943.9,120.02
24732,U8E1D86,5,675.0,1,4,224.0,899.0
24733,U0A2DB3,5,-89.98999999999978,2,3,10500.0,10410.009999999998
24734,U18C902,5,1.0,3,2,11307.0,11308.0
24735,UE1EA44,5,13562.0,1,4,75.0,13637.0
24736,U115CCB,5,935.9799999999999,4,1,1064.02,2000.0
24737,U98114D,5,5287.0,2,3,5789.0,11076.0
24738,UC00470,5,-5600.0,3,2,6064.0,464.0
24739,UDCB70C,5,-344.17,4,1,688.34,344.17
24740,U6F114B,5,5614.0,3,2,550.0,6164.0
24741,UD7EC2B,5,-84.91,2,3,100.01,15.1
24742,U30E5AD,5,-3962.54,5,0,3962.54,0.0
24743,UEA5D4F,5,-281.89999999999964,4,1,10072.9,9791.0
24744,U5BC79F,5,-13961.0,3,2,40895.0,26934.0
24745,UD11574,5,-142.54000000000005,4,1,333.45000000000005,190.91
24746,U84E5A4,5,175.0,4,1,1125.0,1300.0
24747,UDE0F00,5,-8563.5,3,2,18914.7,10351.2
24748,U754612,5,49868.0,2,3,59986.0,109854.0
24749,U0B96CD,5,0.5499999999999545,3,2,1947.0,1947.55
24750,U331F9E,5,-250.0,3,2,5750.0,5500.0
24751,U341DD7,5,89.20000000000073,2,3,5730.799999999999,5820.0
24752,U7099F3,5,730.0,2,3,1580.0,2310.0
24753,UCE1008,5,-59.61,2,3,60.0,0.39
24754,U5C2687,5,17916.859999999997,3,2,18879.2,36796.06
24755,UCB15B8,5,1500.0,1,4,8124.0,9624.0
24756,U7FFC21,5,976.6399999999994,1,4,5000.0,5976.639999999999
24757,UE42EB6,5,41.71999999999977,3,2,11255.54,11297.26
24758,U4B83E3,5,10450.0,2,3,4550.0,15000.0
24759,U101B12,5,-25.0,3,2,40.0,15.0
24760,U369BA9,5,-3000.0,2,3,7000.0,4000.0
24761,UE7F6CB,5,-9699.29,2,3,9777.27,77.97999999999999
24762,U5452DA,5,598.98,4,1,1.02,600.0
24763,U024BF0,5,-3480.2,4,1,3490.2,10.0
24764,U37BC14,5,-171.0,3,2,2020.0,1849.0
24765,UCE5019,5,1195.0,3,2,1056.85,2251.85
24766,U782B44,5,1212.0,2,3,10000.0,11212.0
24767,U38D6E5,5,-5998.0,3,2,11998.0,6000.0
24768,U67004A,5,-2748.99,4,1,5328.99,2580.0
24769,U0AB825,5,603.88,3,2,416.3,1020.1800000000001
24770,UB1933D,5,-24306.070000000003,3,2,29331.760000000002,5025.69
24771,UE74378,5,0.6900000000000546,2,3,4426.0,4426.6900000000005
24772,U5D5A5D,5,-3999.88,3,2,6000.01,2000.1299999999999
24773,UFC888D,5,285.97999999999956,3,2,40056.78,40342.759999999995
24774,U2370B6,5,1571.6,3,2,228.4,1800.0
24775,U810E15,5,-0.6000000000000227,3,2,479.0,478.4
24776,U488438,5,206.17999999999984,2,3,5000.0,5206.18
24777,UE3666C,5,-28700.0,4,1,38700.0,10000.0
24778,U551EA4,5,13.399999999999999,3,2,2892.0,2905.4
24779,U49AFB1,5,-50000.0,4,1,65300.0,15300.0
24780,UDE8B60,5,228.0,2,3,1432.0,1660.0
24781,U8A0A40,5,334.23,4,1,1665.77,2000.0
24782,U6AA117,5,-1.8800000000001091,2,3,5111.0,5109.12
24783,U785D68,5,-1473.17,4,1,1473.25,0.08
24784,UFC729D,5,80.0,4,1,1020.0,1100.0
24785,U3025AF,5,-43.86999999999989,2,3,2143.87,2100.0
24786,U3A821E,5,117.53000000000002,4,1,183.7,301.23
24787,U37D035,5,291.53,4,1,1632.0,1923.53
24788,UFE4427,5,-606.4200000000001,4,1,638.6600000000001,32.24
24789,UD7218F,5,-15.99,4,1,16.0,0.01
24790,U164787,5,-3500.0,4,1,7769.0,4269.0
24791,U6A9B9C,5,0.0,3,2,4768.17,4768.17
24792,UE5AC2C,5,175.0,0,5,0.0,175.0
24793,UA62064,5,-220.55999999999995,4,1,1025.56,805.0
24794,U391FCA,5,13.089999999999947,4,1,526.91,540.0
24795,UA1C545,5,10000.0,1,4,10000.0,20000.0
24796,U9B5E36,5,-1.0658141036401503e-14,4,1,229.04,229.04
24797,U7A84D5,5,739.39,2,3,10.0,749.39
24798,UB1686B,5,0.4800000000000182,3,2,1810.0,1810.48
24799,UCE1A1A,5,0.0,3,2,4020.0,4020.0
24800,UC1C21D,5,46.02000000000044,2,3,5804.0,5850.02
24801,U28F474,5,4987.01,2,3,377.0,5364.01
24802,UC7D8C0,5,13.0,0,5,0.0,13.0
24803,U7090E4,5,6076.0,2,3,828.0,6904.0
24804,UDE5AFE,5,-2058.83,4,1,2165.83,107.0
24805,UD48F16,5,-16685.9,4,1,22655.9,5970.0
24806,U0B2CEF,5,-16160.0,4,1,16170.0,10.0
24807,U072F10,5,-1028.4,4,1,1028.44,0.04
24808,UE09C8B,5,5.0,2,3,10.0,15.0
24809,U45F674,5,22668.0,4,1,33182.0,55850.0
24810,U0F32F3,5,58232.41,0,5,0.0,58232.41
24811,U1C8F8E,5,-1.5800000000000125,3,2,79.0,77.42
24812,U1CBFDF,5,3308.75,1,4,3000.0,6308.75
24813,UB79887,5,-4870.0,3,2,8000.0,3130.0
24814,UB32250,5,-1034.8,4,1,1131.1,96.3
24815,UFDF59F,5,200000.24,0,5,0.0,200000.24
24816,UC869DE,5,-290.09000000000003,4,1,1290.09,1000.0
24817,UFD5ED8,5,84.31,2,3,1838.0,1922.31
24818,UE426AC,5,-7734.9800000000005,4,1,8685.29,950.31
24819,UDF5945,5,-1737.0,3,2,2552.0,815.0
24820,UE060E0,5,255.0,4,1,1745.0,2000.0
24821,U4701F2,5,1.6700000000000728,2,3,7278.04,7279.71
24822,U82E3A4,5,703.0,3,2,210.0,913.0
24823,UAFD326,5,-151.83999999999997,2,3,362.74,210.89999999999998
24824,UAE5AA8,5,-44.8,2,3,2520.0,2475.2
24825,U1E626F,5,28.0,2,3,20272.0,20300.0
24826,U0EA855,5,119.0,3,2,432.0,551.0
24827,U3ADA8B,5,-202.31,4,1,404.62,202.31
24828,U3D0C4F,5,16.299999999999997,4,1,183.7,200.0
24829,U18E762,5,140.37,3,2,508.44,648.81
24830,U06516D,5,-1362.5,4,1,1372.5,10.0
24831,UB17960,5,12782.96,2,3,2921.8500000000004,15704.81
24832,U40C82E,5,559.2600000000002,1,4,3040.0,3599.26
24833,UE5997D,5,-1208.94,5,0,1208.94,0.0
24834,UA505B9,5,-1207.4900000000002,2,3,2707.4900000000002,1500.0
24835,U5B49B1,5,-42136.64,2,3,44122.32,1985.6799999999998
24836,U48B6DE,5,0.0,2,3,10.0,10.0
24837,U00574F,5,1980.0,1,4,0.02,1980.02
24838,U487A59,5,-50.0,3,2,9550.0,9500.0
24839,UDD51D0,5,-1.8189894035458565e-12,3,2,16161.3,16161.3
24840,U21EE60,5,3526.51,3,2,6535.0,10061.51
24841,UD86726,5,5307.06,2,3,5208.19,10515.25
24842,U77A782,5,1286.3799999999999,4,1,993.6200000000001,2280.0
24843,U5BC6AB,5,4000.0,3,2,3000.0,7000.0
24844,U9D91F4,5,1693.5600000000002,3,2,1428.4399999999998,3122.0
24845,UD89A0E,5,770.0,3,2,4080.0,4850.0
24846,UDA2A39,5,9861.8,1,4,6000.0,15861.8
24847,U0DB654,5,-561.1100000000001,3,2,5920.0,5358.89
24848,UA1C478,5,8906.65,2,3,230.0,9136.65
24849,U75F821,5,0.07,2,3,110.07,110.13999999999999
24850,UFBFBB3,5,10.0,2,3,6000.0,6010.0
24851,U604F15,5,-8752.960000000001,4,1,8753.0,0.04
24852,UF6E77B,5,-324.62,4,1,524.62,200.0
24853,UA7EBD8,5,-1654.99,3,2,4005.0,2350.01
24854,U08E202,5,0.0,3,2,18.0,18.0
24855,U4064D4,5,-20.680000000000007,3,2,501.68000000000006,481.0
24856,U6A4D0E,5,5725.84,2,3,6148.03,11873.87
24857,U27AC43,5,1157.6400000000003,4,1,1842.3600000000001,3000.0
24858,U882AA9,5,-998.9200000000001,4,1,1000.0,1.08
24859,U333425,5,790.5999999999999,1,4,3042.02,3832.62
24860,U25A187,5,-157.81999999999886,2,3,101108.04,100950.22
24861,U6B4DE9,5,1.0199999999999818,2,3,722.0,723.02
24862,U2DEF22,5,1000.01,2,3,524.86,1524.8700000000001
24863,U5A3E5D,5,-117.0,3,2,3717.0,3600.0
24864,U495839,5,-2519.54,4,1,2619.54,100.0
24865,UA1304C,5,0.0,4,1,30.0,30.0
24866,U706B25,5,100.0,2,3,29700.0,29800.0
24867,U12F472,5,5234.0,0,5,0.0,5234.0
24868,UB66913,5,292.6300000000001,2,3,6000.0,6292.63
24869,U7565D6,5,1200.17,0,5,0.0,1200.17
24870,U2A6683,5,10383.08,2,3,449.92,10833.0
24871,UED1A58,5,-420.0,4,1,1580.0,1160.0
24872,UEA52D9,5,-49904.65,2,3,63284.2,13379.55
24873,U8CDA24,5,26766.14,2,3,201.0,26967.14
24874,U03E312,5,-792.6199999999999,5,0,792.6199999999999,0.0
24875,U8CD297,5,41.5,4,1,320.5,362.0
24876,UE00E2D,5,-2335.8,5,0,2335.8,0.0
24877,UF377CE,5,-2815.4799999999996,2,3,3460.31,644.8299999999999
24878,UE65DB5,5,15407.6,0,5,0.0,15407.6
24879,U24A45C,5,-5450.0,3,2,21135.0,15685.0
24880,UFEEAE6,5,-108.5,4,1,217.0,108.5
24881,UD61CF9,5,-195.4000000000032,2,3,43200.0,43004.6
24882,UD57869,5,-13157.6,4,1,15110.0,1952.4
24883,UBA0538,5,195.56,3,2,218.44,414.0
24884,U64B34A,5,300.01,1,4,0.01,300.02
24885,UE7F793,5,-28.89,4,1,29.009999999999998,0.12
24886,U0CCECF,5,-52.0,4,1,362.0,310.0
24887,UEC1D6D,5,93.66,1,4,165.48,259.14
24888,U10E9C0,5,2673.0,3,2,4776.0,7449.0
24889,UF14820,5,-11700.69,2,3,12207.08,506.39
24890,U64F0C9,5,-1.3999999999996362,3,2,6778.2,6776.799999999999
24891,UC4486F,5,500.0,3,2,1229.0,1729.0
24892,UED226B,5,-14.379999999999882,3,2,1665.6399999999999,1651.26
24893,UB955C9,5,926.5799999999999,4,1,73.42000000000002,1000.0
24894,U49FA76,5,-49.21,4,1,10106.21,10057.0
24895,U8E602A,5,-122.25,4,1,3119.41,2997.16
24896,U47FF38,5,-19.0,4,1,276.0,257.0
24897,U755951,5,7.105427357601002e-15,4,1,81.9,81.9
24898,UD26023,5,-1626.5,3,2,3826.5,2200.0
24899,U761143,5,0.0,2,3,20000.0,20000.0
24900,U547C65,5,2000.0599999999995,2,3,5002.0,7002.0599999999995
24901,U0A4482,5,-64.56,3,2,219.56,155.0
24902,UECF624,5,-23970.9,4,1,36371.229999999996,12400.33
24903,UFB5B22,5,946.23,3,2,218.0,1164.23
24904,U927F0C,5,-1447.94,5,0,1447.94,0.0
24905,UCD60AA,5,-355.8499999999999,4,1,2248.29,1892.44
24906,UAF1EA9,5,-457.0,3,2,6814.0,6357.0
24907,UCCF1D7,5,126.03999999999985,4,1,1966.66,2092.7
24908,U86A9D3,5,136.51999999999998,4,1,119.47999999999999,256.0
24909,UFAB961,5,-957.62,4,1,1057.62,100.0
24910,UC1D037,5,8.199999999999989,2,3,301.8,310.0
24911,U4CF59F,5,988.0,3,2,10485.58,11473.58
24912,U28E717,5,4482.0,3,2,6218.0,10700.0
24913,UD2B463,5,-2010.01,3,2,2053.2,43.19
24914,UE9D792,5,-319.4599999999999,4,1,719.46,400.0
24915,UBF4C89,5,5012.47,1,4,2000.0,7012.469999999999
24916,U2F6C09,5,20.970000000000255,2,3,7788.02,7808.990000000001
24917,UD7DD49,5,502.77,3,2,3893.31,4396.08
24918,UC25268,5,94.04,2,3,6.0,100.04
24919,U0813F8,5,18.07,3,2,132.0,150.07
24920,UD8E8F9,5,210.0,3,2,4150.0,4360.0
24921,UDCE534,5,-45.0,3,2,55.0,10.0
24922,UDD2285,5,-627.72,4,1,677.72,50.0
24923,UAEF8D0,5,-564188.07,2,3,581667.86,17479.79
24924,U16E47B,4,500.0,2,2,4500.0,5000.0
24925,UDA5558,4,0.0,2,2,18563.0,18563.0
24926,U2B6883,4,-3427.209999999999,1,3,17000.0,13572.79
24927,U694002,4,2101.2700000000004,2,2,3956.0,6057.27
24928,UE97A65,4,-4820.0,2,2,14820.0,10000.0
24929,UB2CBFA,4,-135.96,3,1,136.09,0.13
24930,U5AD1C5,4,4800.06,1,3,640000.0,644800.06
24931,UD156B3,4,6000.0,1,3,6000.0,12000.0
24932,U6025AB,4,-871.0,2,2,25752.0,24881.0
24933,UCBE431,4,33.55,2,2,10.0,43.55
24934,U577754,4,-21042.4,4,0,21042.4,0.0
24935,U13DE69,4,-3439.26,4,0,3439.26,0.0
24936,U1D505C,4,-11948.0,2,2,19728.0,7780.0
24937,UA24DE4,4,22000.02,0,4,0.0,22000.02
24938,U967902,4,3842.0,2,2,4058.0,7900.0
24939,UA262F2,4,-5019.73,4,0,5019.73,0.0
24940,U0A86A5,4,5661.24,0,4,0.0,5661.24
24941,U0B948B,4,2997.08,1,3,2997.0,5994.08
24942,U50C0EC,4,-161.81,2,2,337.0,175.19
24943,U25F4C5,4,-132.14,4,0,132.14,0.0
24944,UFD7058,4,74.0,2,2,6.0,80.0
24945,U209DDE,4,9.999999999999993,3,1,190.0,200.0
24946,UC29B87,4,-1170.0,2,2,3320.0,2150.0
24947,UFB130B,4,-100.86,4,0,100.86,0.0
24948,U745E0F,4,95.7,2,2,102.0,197.7
24949,U143086,4,0.0,2,2,19000.0,19000.0
24950,U139FCE,4,7179.959999999999,2,2,3000.0,10179.96
24951,U18295F,4,997.8000000000002,1,3,3000.0,3997.8
24952,UF0B8B3,4,-6.0,2,2,48.95,42.95
24953,U5DF193,4,-1831.9700000000128,1,3,163588.0,161756.03
24954,U9CC208,4,-22045.010000000002,3,1,22060.93,15.92
24955,U234E20,4,-9083.34,4,0,9083.34,0.0
24956,U03A9F9,4,203.41999999999996,1,3,556.58,760.0
24957,UF7ADFF,4,-86.74,4,0,86.74,0.0
24958,U0401BA,4,-6846.0,3,1,13846.0,7000.0
24959,U561894,4,-3667.1400000000003,4,0,3667.1400000000003,0.0
24960,U390BE9,4,-178000.0,2,2,180000.0,2000.0
24961,UFBEFE9,4,930.0,2,2,2370.0,3300.0
24962,UF83EBD,4,-1.0,2,2,5900.0,5899.0
24963,U704585,4,2000.08,1,3,2000.08,4000.16
24964,UF4A9AB,4,5000.0,1,3,0.1,5000.1
24965,UD5C13C,4,26731.0,1,3,169.0,26900.0
24966,U32FBE4,4,9613.77,2,2,361.62,9975.39
24967,U7CBFB1,4,0.0,2,2,8000.0,8000.0
24968,U646FA6,4,0.0,3,1,87.0,87.0
24969,UD9C039,4,-2508.0,4,0,2508.0,0.0
24970,UD53505,4,1680.01,0,4,0.0,1680.01
24971,U765CB0,4,-1249.22,3,1,1250.0,0.78
24972,U8AEC90,4,10.099999999999994,1,3,207.61,217.71
24973,U467049,4,75.0,3,1,2925.0,3000.0
24974,U9E44A2,4,-59.0,2,2,1859.0,1800.0
24975,UAA7EA5,4,0.0,2,2,4739.0,4739.0
24976,UC41819,4,-1.0,3,1,109.5,108.5
24977,UEC8AC5,4,355.07,2,2,314.9,669.97
24978,UC0CDE6,4,19800.059999999998,1,3,19783.75,39583.81
24979,U815D91,4,-296.53999999999996,2,2,4800.0,4503.46
24980,U316E5D,4,-900.0,2,2,1200.0,300.0
24981,UE66D1B,4,-86.34,4,0,86.34,0.0
24982,U513B24,4,5943.6,3,1,56.400000000000006,6000.0
24983,U485AC4,4,995.8699999999999,1,3,2550.0,3545.87
24984,U0592A9,4,3042.0,2,2,5899.0,8941.0
24985,U93D813,4,11467.0,2,2,11927.0,23394.0
24986,U332B77,4,-200.0,2,2,7960.0,7760.0
24987,UE38E61,4,-224.0,2,2,329.0,105.0
24988,U38D473,4,202.89000000000001,2,2,173.42,376.31
24989,U39684F,4,-3822.7999999999997,4,0,3822.7999999999997,0.0
24990,UFDE647,4,5880.0,1,3,620.0,6500.0
24991,UA1CF73,4,0.0,2,2,9800.0,9800.0
24992,UAB153C,4,-747.0,3,1,1017.0,270.0
24993,UF8CB59,4,-72.54,4,0,72.54,0.0
24994,UFC22CE,4,181.8,3,1,18.2,200.0
24995,U6A630A,4,2510.02,0,4,0.0,2510.02
24996,U5A5BBB,4,-508.0,2,2,6000.0,5492.0
24997,UF1154A,4,2715.0,2,2,28.0,2743.0
24998,U471ABC,4,654.7600000000002,2,2,10800.0,11454.76
24999,UA3795F,4,0.0,2,2,6500.0,6500.0
25000,UBA61D4,4,90.32000000000005,2,2,859.68,950.0
25001,U5C8A22,4,-799.1799999999998,4,0,799.1799999999998,0.0
25002,UDFC434,4,10.960000000000008,2,2,89.0,99.96000000000001
25003,U73C84E,4,-281.39999999999964,2,2,6000.0,5718.6
25004,UF091A0,4,504.9899999999998,2,2,1644.0,2148.99
25005,U939C97,4,-318.96,4,0,318.96,0.0
25006,UA1983D,4,766.72,1,3,265.97,1032.69
25007,UD08ED3,4,-1283.64,4,0,1283.64,0.0
25008,UC463AE,4,-10.0,3,1,11.0,1.0
25009,U91DFAB,4,235.40999999999985,2,2,5980.0,6215.41
25010,U0A4B80,4,5088.2,1,3,4000.0,9088.2
25011,U3EED8A,4,-983.3400000000001,4,0,983.3400000000001,0.0
25012,U556E11,4,-3.0,2,2,3000.0,2997.0
25013,UE1BD47,4,-818.54,3,1,1318.54,500.0
25014,U6B3273,4,-1383.7,4,0,1383.7,0.0
25015,U3649C6,4,6662.779999999999,1,3,2500.0,9162.779999999999
25016,U295299,4,-2323.7599999999998,4,0,2323.7599999999998,0.0
25017,UD5B806,4,-415.04,2,2,1025.04,610.0
25018,U26FA38,4,540.95,2,2,451.0,991.95
25019,U6232C7,4,-1496.9899999999998,2,2,10000.0,8503.01
25020,U57C2D3,4,-174.0899999999997,3,1,3074.0899999999997,2900.0
25021,U462C14,4,-739.62,4,0,739.62,0.0
25022,U1D0AF8,4,612.0,2,2,50888.0,51500.0
25023,UFAC82E,4,-188562.1,2,2,200000.0,11437.9
25024,U0C2332,4,17.130000000000003,2,2,10.0,27.130000000000003
25025,UE14157,4,12003.3,2,2,534.7,12538.0
25026,UEB3F8A,4,-2950.0,4,0,2950.0,0.0
25027,UE18726,4,30.0,3,1,460.0,490.0
25028,UA15B4F,4,148.70000000000073,2,2,4301.299999999999,4450.0
25029,U249767,4,100.0,2,2,7900.0,8000.0
25030,UCAD88A,4,3769.0,2,2,15928.0,19697.0
25031,U186369,4,290.0,2,2,5486.6,5776.6
25032,UA94F7C,4,-1397.35,3,1,1397.36,0.01
25033,U798E29,4,-371.06,4,0,371.06,0.0
25034,UEE694F,4,-2940.0,2,2,5900.0,2960.0
25035,U8BDA81,4,-250.0,2,2,12000.0,11750.0
25036,U98D7C7,4,91700.0,0,4,0.0,91700.0
25037,U1E3572,4,80.0,0,4,0.0,80.0
25038,UF24EC5,4,30.0,2,2,10.0,40.0
25039,U423406,4,998.0,2,2,5002.0,6000.0
25040,U20D1F6,4,-3.200000000000003,3,1,139.7,136.5
25041,U4B3FB1,4,-962.28,4,0,962.28,0.0
25042,U7FDE53,4,78.45000000000005,2,2,6700.0,6778.45
25043,U8FE8E2,4,-2.9200000000000004,2,2,6.0,3.0799999999999996
25044,UB84EE4,4,608.5999999999999,3,1,1591.4,2200.0
25045,UA107F8,4,-77.96,2,2,2578.0,2500.04
25046,UFE63FB,4,-598.96,4,0,598.96,0.0
25047,U643F36,4,5.0,2,2,10.0,15.0
25048,U4D5499,4,8.0,2,2,7792.0,7800.0
25049,U463620,4,-829.34,2,2,1680.0,850.66
25050,UD12B64,4,72.93000000000006,2,2,686.72,759.6500000000001
25051,UA5C81E,4,-357.48,4,0,357.48,0.0
25052,U373292,4,-595.1600000000001,4,0,595.1600000000001,0.0
25053,UF62154,4,5.77,1,3,0.77,6.539999999999999
25054,U591EB5,4,0.0,2,2,6000.0,6000.0
25055,U6D73CF,4,-9741.78,2,2,19700.0,9958.22
25056,U829656,4,10.080000000000013,2,2,314.91999999999996,325.0
25057,UDD8060,4,-1638.9099999999999,4,0,1638.9099999999999,0.0
25058,U3D1261,4,1625.11,0,4,0.0,1625.11
25059,U5CEE13,4,453.0,2,2,141.0,594.0
25060,U1DC622,4,6024.0,1,3,1310.0,7334.0
25061,U2282E1,4,-288.8,4,0,288.8,0.0
25062,UF8F38B,4,-200.0,3,1,600.0,400.0
25063,UAFBE37,4,7000.0,1,3,0.04,7000.04
25064,U299AB4,4,12.410000000000004,1,3,30.0,42.410000000000004
25065,UB690B4,4,-2450.1600000000003,4,0,2450.1600000000003,0.0
25066,U68B65D,4,-357.34,2,2,1618.8,1261.46
25067,UE233A5,4,7991.52,1,3,3995.76,11987.28
25068,UC0D9FD,4,0.0,2,2,10.0,10.0
25069,U25F9D4,4,-501.5,3,1,781.5,280.0
25070,UC97A56,4,3361.0699999999997,0,4,0.0,3361.0699999999997
25071,U9263FF,4,0.16000000000008185,2,2,1599.84,1600.0
25072,U95FC1D,4,209.0,1,3,506.75,715.75
25073,U20D65C,4,-4.08,2,2,6.0,1.92
25074,U6BA401,4,99.02999999999997,2,2,1522.0,1621.03
25075,UEE2F7F,4,-503.51,2,2,1008.0,504.49
25076,U7AAF05,4,2.1316282072803006e-14,3,1,762.65,762.65
25077,UABD3D0,4,-58.78,4,0,58.78,0.0
25078,U81E3C4,4,8306.0,1,3,2020.0,10326.0
25079,UD51C31,4,1550.0,2,2,2700.0,4250.0
25080,UF11A3B,4,-550.28,2,2,1539.0,988.72
25081,UDFCD51,4,85.0,3,1,25.0,110.0
25082,U5052B0,4,-413.0,2,2,1809.0,1396.0
25083,UF6B43A,4,-9629.32,4,0,9629.32,0.0
25084,U248E5E,4,18.0,2,2,3030.0,3048.0
25085,U87B185,4,-108.01,2,2,217.0,108.99
25086,UA78850,4,213.04000000000002,1,3,0.5,213.54000000000002
25087,UBC00FF,4,3.552713678800501e-15,2,2,49.94,49.94
25088,U801DF3,4,-700.8599999999999,4,0,700.8599999999999,0.0
25089,U299D15,4,100.0,2,2,11000.0,11100.0
25090,UF3648D,4,-1895.34,2,2,31896.0,30000.66
25091,U4348A4,4,7566.659999999999,2,2,7566.72,15133.38
25092,U7E351B,4,1180.54,2,2,3367.9,4548.4400000000005
25093,U9364B6,4,-16.89,1,3,100.0,83.11
25094,U7529EF,4,-2115.22,4,0,2115.22,0.0
25095,UBEFC79,4,-1831.66,4,0,1831.66,0.0
25096,U7FCBE8,4,201.0,2,2,7800.0,8001.0
25097,U26583F,4,-11.0,2,2,7923.0,7912.0
25098,U6221D5,4,1.2300000000007276,1,3,10030.0,10031.230000000001
25099,U88D93F,4,50.07,1,3,50.0,100.07
25100,U182055,4,0.0,2,2,10.0,10.0
25101,U335F4B,4,4.06,2,2,2.0,6.06
25102,U3EF379,4,29730.0,1,3,10000.0,39730.0
25103,U964059,4,-406.5,4,0,406.5,0.0
25104,U4FCB48,4,460.0,3,1,4040.0,4500.0
25105,UC01477,4,-99.51000000000002,3,1,217.51000000000002,118.0
25106,UDD9980,4,-1.82,2,2,2.0,0.18
25107,U6E4E5A,4,-4319.719999999999,4,0,4319.719999999999,0.0
25108,U2259BB,4,281.56999999999994,2,2,500.0,781.5699999999999
25109,U9529EE,4,-1140.88,4,0,1140.88,0.0
25110,U8011D6,4,5052.63,2,2,10.0,5062.63
25111,UFE2A09,4,0.0,2,2,8000.0,8000.0
25112,UC77761,4,-1036.0,4,0,1036.0,0.0
25113,U39F9A1,4,290.54,2,2,176.0,466.54
25114,UC71C4E,4,-13186.86,4,0,13186.86,0.0
25115,U8A61B8,4,6.5,2,2,9370.0,9376.5
25116,U3694B9,4,6311.2300000000005,2,2,1148.46,7459.6900000000005
25117,U079875,4,0.0,2,2,135.5,135.5
25118,U1D53A1,4,923.0,1,3,621.0,1544.0
25119,UDE527C,4,-4000.0,3,1,8000.0,4000.0
25120,UA040CF,4,-67.75999999999999,4,0,67.75999999999999,0.0
25121,U5C08DF,4,-5.82,2,2,7.57,1.75
25122,UBF0F5B,4,-10198.0,3,1,19205.0,9007.0
25123,U289ABC,4,4.03,2,2,6.0,10.03
25124,U5C483B,4,0.0,2,2,25800.0,25800.0
25125,UC300B0,4,220.0,2,2,1080.0,1300.0
25126,UD81ED6,4,167.60999999999967,3,1,4920.0,5087.61
25127,U6C6DE3,4,-199.13,3,1,299.13,100.0
25128,U007361,4,-1773.28,4,0,1773.28,0.0
25129,UD6F87E,4,-280.0,2,2,301.57,21.57
25130,UFAB616,4,-79.83,3,1,164.66,84.83
25131,U550B14,4,1870.6100000000001,2,2,1870.6499999999999,3741.26
25132,U59ACF6,4,-1518.12,4,0,1518.12,0.0
25133,UC394DB,4,-3149.26,3,1,3698.0,548.74
25134,U670F31,4,-7134.0,1,3,12000.0,4866.0
25135,UD2252A,4,340.11000000000007,2,2,788.71,1128.8200000000002
25136,U994625,4,-288.0,4,0,288.0,0.0
25137,UE84F73,4,-2622.08,4,0,2622.08,0.0
25138,UC5F4D1,4,-2799.24,4,0,2799.24,0.0
25139,UDF9B59,4,-2.0,2,2,3468.0,3466.0
25140,UD44FF0,4,144.73000000000008,2,2,2856.58,3001.31
25141,U4C3DF5,4,-2671.1,4,0,2671.1,0.0
25142,UEED5E5,4,5.01,2,2,6.0,11.01
25143,UF42B0F,4,-176.34,4,0,176.34,0.0
25144,UF4E1D0,4,0.0,2,2,1466.66,1466.66
25145,U8583FE,4,2.0,1,3,2.0,4.0
25146,U3113EB,4,-1651.6599999999999,4,0,1651.6599999999999,0.0
25147,U954A83,4,-9136.349999999999,4,0,9136.349999999999,0.0
25148,U440A76,4,-5000.0,2,2,47800.0,42800.0
25149,UBEBFF2,4,0.0,2,2,7888.0,7888.0
25150,UF464E9,4,-358.93,4,0,358.93,0.0
25151,UD592C9,4,-2855.5600000000004,4,0,2855.5600000000004,0.0
25152,U54E202,4,5385.0,1,3,9735.0,15120.0
25153,UFF82F5,4,62.0,2,2,3898.0,3960.0
25154,U452013,4,-133.96999999999997,1,3,345.4,211.43
25155,UD426D3,4,2178.76,2,2,404.24,2583.0
25156,UB2D9AD,4,-4151.430000000001,1,3,20000.0,15848.570000000002
25157,UF5DB61,4,9999.99,1,3,26000.0,35999.99
25158,UA4B420,4,0.0,2,2,400.0,400.0
25159,U6734CC,4,-3920.95,3,1,4066.95,146.0
25160,U21E83E,4,-5514.19,3,1,5514.2,0.01
25161,U6D2746,4,17206.0,2,2,60582.0,77788.0
25162,U5740F9,4,1618.0,1,3,5300.0,6918.0
25163,U952282,4,0.2599999999999998,2,2,10.0,10.26
25164,UDCBADA,4,2000.0,2,2,18300.0,20300.0
25165,U5A7421,4,1903.0,1,3,1892.0,3795.0
25166,UE14B29,4,296.36,2,2,1289.0,1585.3600000000001
25167,U59EF56,4,-20000.0,3,1,20035.33,35.33
25168,U616AA8,4,-5.684341886080802e-14,3,1,883.3,883.3
25169,UFD2C5B,4,18.6,2,2,10.0,28.6
25170,U4C47E0,4,-470.64,4,0,470.64,0.0
25171,U9D30AE,4,5079.34,1,3,6120.0,11199.34
25172,UEC7960,4,-571.39,4,0,571.39,0.0
25173,U2AEC65,4,243.97000000000003,2,2,1888.97,2132.94
25174,U76DC3E,4,-15.0,3,1,239.0,224.0
25175,UAA5B07,4,903.0,3,1,1797.0,2700.0
25176,UB4BAF5,4,29000.0,0,4,0.0,29000.0
25177,U004963,4,-1217.86,2,2,1290.0,72.14
25178,U589BFB,4,-605.0,4,0,605.0,0.0
25179,U6F1C96,4,2681.0,2,2,6574.0,9255.0
25180,U019036,4,-75.13999999999987,2,2,4075.16,4000.02
25181,UBD720A,4,-4000.0,3,1,8000.0,4000.0
25182,U66F674,4,320.0,2,2,4680.0,5000.0
25183,UD436CC,4,2937.58,2,2,8849.0,11786.58
25184,UE01B11,4,0.0,2,2,101.0,101.0
25185,U18350B,4,0.0,2,2,25000.0,25000.0
25186,U2AA995,4,-739.0,2,2,79958.0,79219.0
25187,UE2256A,4,-2326.76,4,0,2326.76,0.0
25188,UE9DC44,4,100.0000000000002,2,2,2648.28,2748.28
25189,U9A50D6,4,10.0,2,2,10.0,20.0
25190,U28CCBF,4,1262.01,2,2,87.99000000000001,1350.0
25191,U5B0518,4,1947.1299999999999,1,3,1970.0,3917.13
25192,U52A38B,4,5.0,2,2,10.0,15.0
25193,U8C8236,4,-338.12,4,0,338.12,0.0
25194,U5D7C7D,4,1000.0,2,2,3100.0,4100.0
25195,U9289B8,4,695.0,3,1,386.0,1081.0
25196,U7C8504,4,2021.29,0,4,0.0,2021.29
25197,U884A34,4,1700.0,1,3,300.0,2000.0
25198,U9227B3,4,975.7,2,2,1010.0,1985.7
25199,U414A4B,4,35.00999999999999,2,2,585.5,620.51
25200,UB2EAC6,4,7.105427357601002e-15,3,1,250.46,250.46
25201,UB22168,4,5.0,2,2,10.0,15.0
25202,U75437E,4,-888.880000000001,2,2,10888.880000000001,10000.0
25203,U1ADC89,4,0.07000000000005002,2,2,544.93,545.0
25204,UEE429C,4,4.029999999999999,2,2,6.0,10.03
25205,UF5BAD8,4,-511.18,4,0,511.18,0.0
25206,U3B469F,4,-899.34,4,0,899.34,0.0
25207,U035076,4,2301.0200000000004,0,4,0.0,2301.0200000000004
25208,U987F85,4,13800.04,1,3,49.85,13849.890000000001
25209,U8CCD60,4,-288.0,4,0,288.0,0.0
25210,U58B1CE,4,9300.11,0,4,0.0,9300.11
25211,U54B249,4,750.0100000000002,1,3,6250.0,7000.01
25212,U19B587,4,-119.98,2,2,120.02,0.04
25213,U5C9622,4,0.010000000000218279,1,3,13500.0,13500.01
25214,UF6C2E4,4,-74.0,3,1,393.0,319.0
25215,U37E1D1,4,303.0,2,2,2347.0,2650.0
25216,U60AF66,4,-998.04,4,0,998.04,0.0
25217,U9C7D25,4,503.0,3,1,1347.0,1850.0
25218,U897801,4,-7.105427357601002e-15,3,1,81.99000000000001,81.99
25219,UA39E03,4,-2628.6099999999997,4,0,2628.6099999999997,0.0
25220,U3D130D,4,-836.64,3,1,1436.64,600.0
25221,U16401A,4,-315.0,2,2,4900.0,4585.0
25222,UF01472,4,0.0,2,2,151.5,151.5
25223,U42BAE0,4,5693.99,2,2,10.0,5703.99
25224,UA8F169,4,0.0,2,2,0.2,0.2
25225,U72BDBE,4,0.24999999999999545,1,3,104.76,105.01
25226,UC3F2B5,4,-854.0,3,1,41261.0,40407.0
25227,U7A35FA,4,-3441.66,4,0,3441.66,0.0
25228,U02D482,4,0.0,2,2,10.0,10.0
25229,UA052C9,4,-129.31,2,2,657.0,527.69
25230,UE5D32C,4,1120.0100000000002,1,3,2900.0,4020.01
25231,U7F3052,4,-196.54,4,0,196.54,0.0
25232,U3624A6,4,-5014.93,4,0,5014.93,0.0
25233,U639E42,4,8884.0,2,2,3416.0,12300.0
25234,UDCB2F3,4,0.0,2,2,13960.0,13960.0
25235,UC9DE41,4,-491.74,4,0,491.74,0.0
25236,U7EF1B0,4,-3.552713678800501e-14,3,1,444.44000000000005,444.44
25237,UCA8C1A,4,694.04,2,2,6.0,700.04
25238,U0EBC94,4,1260.1299999999999,2,2,6363.0,7623.13
25239,UED306D,4,600.0,2,2,4200.0,4800.0
25240,U4113C0,4,-4720.0,4,0,4720.0,0.0
25241,U52D83C,4,3815.06,0,4,0.0,3815.06
25242,U0AD7BE,4,-175.0,4,0,175.0,0.0
25243,UB21986,4,0.0,2,2,10.0,10.0
25244,U164953,4,2917.1,1,3,12.9,2930.0
25245,U765F73,4,-1.97,2,2,2.0,0.03
25246,UCD886A,4,-91.84,4,0,91.84,0.0
25247,UB9AFA1,4,105.0,1,3,200.0,305.0
25248,UDE4840,4,-4196.84,4,0,4196.84,0.0
25249,UA43684,4,140.0,3,1,1020.0,1160.0
25250,U6253AA,4,236.0,2,2,10.0,246.0
25251,U729863,4,11.030000000001746,2,2,23089.17,23100.2
25252,UA094B3,4,220.0,2,2,1080.0,1300.0
25253,U5D4D7D,4,-264.42,4,0,264.42,0.0
25254,U80505D,4,0.0,2,2,20000.0,20000.0
25255,UDDD933,4,819.1199999999999,1,3,6960.0,7779.12
25256,U4537A9,4,-558.4200000000001,4,0,558.4200000000001,0.0
25257,U7F2F90,4,275.0,1,3,1600.0,1875.0
25258,U5AA799,4,0.0,2,2,12100.0,12100.0
25259,UD0F93E,4,14606.62,0,4,0.0,14606.62
25260,UA024AA,4,7243.5,2,2,21453.8,28697.3
25261,U439AC9,4,0.0,3,1,2360.0,2360.0
25262,U5DFCED,4,-119.94,4,0,119.94,0.0
25263,UCF8A0F,4,-183.7,4,0,183.7,0.0
25264,U589F18,4,-9083.34,4,0,9083.34,0.0
25265,U357BF6,4,-4108.0,4,0,4108.0,0.0
25266,U0CF5FB,4,-11229.0,3,1,12999.0,1770.0
25267,UE28956,4,590.9,2,2,67.0,657.9
25268,UDE6EAA,4,300.1300000000001,1,3,2000.0,2300.13
25269,UECCEBA,4,16.48,1,3,100000.0,100016.48
25270,UC3C04B,4,-369.0,2,2,582.0,213.0
25271,UDEB3B5,4,-512.94,4,0,512.94,0.0
25272,U599169,4,500.03,1,3,0.03,500.05999999999995
25273,U38EA39,4,-71.22,4,0,71.22,0.0
25274,U82A058,4,180.87,0,4,0.0,180.87
25275,UFF20F1,4,-862.14,4,0,862.14,0.0
25276,U2B801F,4,0.0,1,3,19950.0,19950.0
25277,UD52253,4,-639.0,4,0,639.0,0.0
25278,U54872D,4,-2698.03,4,0,2698.03,0.0
25279,UDA262B,4,-168.29,3,1,168.37,0.08
25280,U20EA30,4,-2317.0,2,2,2622.0,305.0
25281,U63436A,4,3091.75,2,2,358.25,3450.0
25282,UEC31FE,4,-497.78,2,2,1407.78,910.0
25283,UD74C81,4,298.37,0,4,0.0,298.37
25284,UB7901B,4,253.0,2,2,536.3,789.3
25285,UE09313,4,-1.96,3,1,110.28999999999999,108.33
25286,U6C820A,4,1.0,3,1,11997.0,11998.0
25287,UD8D247,4,30.0,2,2,15587.0,15617.0
25288,U709079,4,-899.34,4,0,899.34,0.0
25289,UD199CE,4,468.5,2,2,1531.5,2000.0
25290,U40E3A1,4,13532.7,2,2,19854.38,33387.08
25291,U8A4188,4,-878.36,4,0,878.36,0.0
25292,U8C4ED5,4,-21000.0,4,0,21000.0,0.0
25293,UBF62A7,4,227.0,2,2,1439.0,1666.0
25294,U2B0830,4,23.0,3,1,6.0,29.0
25295,UDFAC0F,4,2900.0,2,2,2000.0,4900.0
25296,UD3DFF8,4,-1406.86,4,0,1406.86,0.0
25297,U3A6AE1,4,-535.8,4,0,535.8,0.0
25298,U151442,4,-33.03,3,1,133.03,100.0
25299,U6D4494,4,-798.8399999999999,4,0,798.8399999999999,0.0
25300,U351C8D,4,-182.01,4,0,182.01,0.0
25301,U776BBF,4,232.0,2,2,168.0,400.0
25302,U16849D,4,-625.06,4,0,625.06,0.0
25303,U6AB8F6,4,-2573.52,4,0,2573.52,0.0
25304,U6AADA3,4,16.5,2,2,10.0,26.5
25305,UA927C2,4,4.01,2,2,6.0,10.01
25306,U9A4A2D,4,-95.0,3,1,110.0,15.0
25307,UE33B58,4,2.0,2,2,1647.0,1649.0
25308,U187ACF,4,-809.4000000000001,4,0,809.4000000000001,0.0
25309,UB2213E,4,-962.11,4,0,962.11,0.0
25310,UAE7CC2,4,0.0,2,2,290.0,290.0
25311,U032312,4,169.0,3,1,881.0,1050.0
25312,U282537,4,-3048.3,4,0,3048.3,0.0
25313,U218333,4,0.0,2,2,30000.0,30000.0
25314,UF94EA8,4,929.3699999999999,2,2,720.0,1649.37
25315,UD35832,4,-2141.74,4,0,2141.74,0.0
25316,UA2531F,4,-1745.6,4,0,1745.6,0.0
25317,U365022,4,10872.0,0,4,0.0,10872.0
25318,U54B0C3,4,0.0,2,2,50032.51,50032.51
25319,U6DEC86,4,1063.69,2,2,510.0,1573.69
25320,U5454CB,4,4800.0,0,4,0.0,4800.0
25321,U530E69,4,39.0,0,4,0.0,39.0
25322,U2C5C84,4,-2418.1699999999996,2,2,2428.2,10.03
25323,UFA8964,4,1818.0,1,3,591.0,2409.0
25324,U92F32C,4,-11.829999999999998,3,1,34.83,23.0
25325,U38C299,4,0.0,2,2,2418.23,2418.23
25326,UB56904,4,1644.29,2,2,1313.0,2957.29
25327,U9510C8,4,999.9100000000001,1,3,499.91,1499.8200000000002
25328,U1E6ACA,4,-160.17000000000002,3,1,537.0,376.83
25329,UA13FC4,4,-1573.15,3,1,1608.15,35.0
25330,U5F93C0,4,26.389999999999986,2,2,450.03,476.41999999999996
25331,UD6FE24,4,61.5,2,2,287.0,348.5
25332,U57F04A,4,0.0,2,2,11200.0,11200.0
25333,U67263E,4,-1693.1599999999999,4,0,1693.1599999999999,0.0
25334,U93D53F,4,-1146.04,4,0,1146.04,0.0
25335,U0504F3,4,3245.87,0,4,0.0,3245.87
25336,U054E1C,4,0.0,2,2,287.96,287.96
25337,U568D60,4,0.0,2,2,38.62,38.62
25338,U22DB59,4,-529.01,4,0,529.01,0.0
25339,U83C21F,4,0.0,3,1,7946.0,7946.0
25340,UA5A10E,4,-91.84,4,0,91.84,0.0
25341,U72CAD6,4,-1775.9699999999998,2,2,3775.97,2000.0
25342,U3918E0,4,800.0,2,2,13200.0,14000.0
25343,U0F20EE,4,0.05000000000000028,3,1,9.95,10.0
25344,U9153E5,4,0.0,2,2,1071.0,1071.0
25345,UB996C0,4,-41.58,3,1,42.1,0.52
25346,U705317,4,133.91999999999996,2,2,554.0,687.92
25347,U45A8DD,4,-3724.74,3,1,3788.9,64.16
25348,UF0C991,4,102.0,2,2,2398.0,2500.0
25349,U27BDA5,4,232.0,2,2,2068.0,2300.0
25350,U9CC3DC,4,876.0,0,4,0.0,876.0
25351,UF87A31,4,933.0,2,2,2497.0,3430.0
25352,UA45090,4,-16866.64,2,2,29866.73,13000.09
25353,U208592,4,5053.0,1,3,688.0,5741.0
25354,U439F9F,4,-526.18,4,0,526.18,0.0
25355,U3DEC54,4,1233.0,3,1,2200.0,3433.0
25356,UE4AEF3,4,232.0,2,2,210.0,442.0
25357,U92E682,4,-1.0,1,3,8500.0,8499.0
25358,UD8ECEF,4,1231.0500000000002,2,2,9200.0,10431.05
25359,U9582BC,4,-351.42,4,0,351.42,0.0
25360,U26BEFC,4,3229.94,1,3,111.06,3341.0
25361,U2E36FA,4,-1168.9499999999998,2,2,8800.0,7631.05
25362,U4E08EC,4,5371.51,1,3,1000.0,6371.51
25363,U33630E,4,4.589999999999918,2,2,2040.0,2044.59
25364,U8A5C32,4,-4016.67,4,0,4016.67,0.0
25365,UFECCE9,4,0.0,2,2,15998.0,15998.0
25366,U1F9020,4,28.75,0,4,0.0,28.75
25367,U15898D,4,-581.68,4,0,581.68,0.0
25368,U5F4F0F,4,-5927.22,4,0,5927.22,0.0
25369,UBF5C6C,4,2286.7,0,4,0.0,2286.7
25370,U9C9AA8,4,2300.0,2,2,8100.0,10400.0
25371,U1A145C,4,63.0,2,2,3180.97,3243.97
25372,U112539,4,0.0,2,2,427.5,427.5
25373,U2C5227,4,0.0,2,2,10.0,10.0
25374,UBEE4E8,4,-30.0,4,0,30.0,0.0
25375,UD0CC07,4,62.0,2,2,3198.0,3260.0
25376,U4C3B4F,4,-1349.0,4,0,1349.0,0.0
25377,U6708F3,4,35.0,0,4,0.0,35.0
25378,U91F4F3,4,1500.0,0,4,0.0,1500.0
25379,U951F97,4,30.729999999999983,2,2,206.39000000000001,237.12
25380,U878E6E,4,219.0,2,2,781.0,1000.0
25381,U1EF89D,4,-181.7,4,0,181.7,0.0
25382,UEFCC4E,4,-1500.0,2,2,7200.0,5700.0
25383,U39AF8F,4,2078.0,2,2,1900.0,3978.0
25384,U3AEAD3,4,3.05,1,3,3.19,6.24
25385,UFDA804,4,445.99,0,4,0.0,445.99
25386,U383403,4,-8100.0,3,1,28100.0,20000.0
25387,UB0A3DD,4,-57.94,2,2,60.0,2.06
25388,UCD457C,4,-318.9699999999998,2,2,2524.0,2205.03
25389,UE5B3D2,4,5403.05,0,4,0.0,5403.05
25390,U4965CE,4,-550.07,2,2,956.6700000000001,406.6
25391,UC3A653,4,151.61,2,2,1151.0,1302.6100000000001
25392,U396809,4,0.0,1,3,30000.0,30000.0
25393,UA85CEF,4,-410.0,3,1,2510.0,2100.0
25394,U54A10E,4,-409.16,4,0,409.16,0.0
25395,UE29E8D,4,6549.9,2,2,11500.0,18049.9
25396,UF9C7ED,4,-2906.66,4,0,2906.66,0.0
25397,UF1932D,4,0.0,2,2,10.0,10.0
25398,UBFC8A2,4,1086.12,2,2,964.0,2050.12
25399,U67DF43,4,0.0,2,2,112.34,112.34
25400,U969C3C,4,1643.8,0,4,0.0,1643.8
25401,U86B3B7,4,106.0,2,2,3990.0,4096.0
25402,UB2E9A7,4,-249.15,3,1,305.0,55.85
25403,U34DDCB,4,-1560.64,4,0,1560.64,0.0
25404,UACB136,4,-211.51999999999998,4,0,211.51999999999998,0.0
25405,U3CAC36,4,294.0,2,2,10.0,304.0
25406,UDBB284,4,-208.0,3,1,2900.0,2692.0
25407,UCE8A7B,4,3290.0,2,2,10.0,3300.0
25408,U1B0E26,4,-3450.0,2,2,9950.0,6500.0
25409,UA77387,4,-376.8700000000001,3,1,2213.87,1837.0
25410,U0C842A,4,0.0,2,2,6200.0,6200.0
25411,UBDE970,4,450.83000000000004,2,2,10.0,460.83000000000004
25412,UB142F3,4,11503.96,0,4,0.0,11503.96
25413,UFD1827,4,-116.80000000000001,3,1,378.84000000000003,262.04
25414,U5D2124,4,1990.0,2,2,10.0,2000.0
25415,UC6F5BE,4,-6914.070000000001,4,0,6914.070000000001,0.0
25416,UF5E246,4,1420.0,2,2,11400.0,12820.0
25417,UC852D4,4,-481.74,4,0,481.74,0.0
25418,UF9632E,4,-545.0,4,0,545.0,0.0
25419,UCC0FF5,4,-478.35,4,0,478.35,0.0
25420,U05F914,4,1565.0,1,3,5.0,1570.0
25421,U283D1D,4,-2451.1,4,0,2451.1,0.0
25422,U23ABFC,4,-1586.42,4,0,1586.42,0.0
25423,U9AB331,4,1.0,2,2,9999.0,10000.0
25424,U2723FA,4,43500.0,0,4,0.0,43500.0
25425,U5DB101,4,0.0,2,2,212.66,212.66
25426,UE87372,4,5908.12,2,2,258.6,6166.72
25427,UF5636D,4,192.0,2,2,4900.0,5092.0
25428,U77776C,4,-2840.21,3,1,2850.11,9.9
25429,UD81CAB,4,-19642.039999999997,4,0,19642.039999999997,0.0
25430,U1B34FA,4,-19.98,3,1,20.0,0.02
25431,U29C19B,4,-2.220446049250313e-15,2,2,300.94,300.94
25432,U0FDE29,4,-3596.7,1,3,4900.0,1303.3000000000002
25433,U4448C7,4,-2279.0,4,0,2279.0,0.0
25434,U9BF6C9,4,-173.07999999999998,4,0,173.07999999999998,0.0
25435,UBD1C21,4,0.0,2,2,628.0,628.0
25436,U954A20,4,-108.5,4,0,108.5,0.0
25437,UFC45FA,4,-1376.66,4,0,1376.66,0.0
25438,U06FB59,4,-3955.48,2,2,3989.0,33.519999999999996
25439,U8D1C3A,4,0.0,2,2,8000.0,8000.0
25440,UE84FCE,4,1160.0,1,3,2240.0,3400.0
25441,U229189,4,-938.9000000000001,4,0,938.9000000000001,0.0
25442,U763A58,4,524.9499999999999,2,2,158.79000000000002,683.74
25443,U63AB61,4,0.6200000000000045,2,2,299.38,300.0
25444,U18F9E7,4,1.4210854715202004e-14,1,3,363.77,363.77
25445,U0B37AF,4,-806.0799999999999,3,1,7521.8,6715.72
25446,U915A76,4,74.72,2,2,10.0,84.72
25447,U6C3853,4,24200.0,0,4,0.0,24200.0
25448,UCCEC6D,4,5437.64,2,2,442.0,5879.64
25449,U40CE1A,4,0.0,2,2,36000.0,36000.0
25450,UD757DF,4,-4.98,2,2,10.0,5.02
25451,UF0267B,4,-1999.0,1,3,59999.0,58000.0
25452,U9D8713,4,2174.72,0,4,0.0,2174.72
25453,UA6D66A,4,-5.0,2,2,12005.0,12000.0
25454,UAE05E3,4,431.0,2,2,7551.0,7982.0
25455,U56632C,4,20840.0,0,4,0.0,20840.0
25456,UF65750,4,-1267.77,4,0,1267.77,0.0
25457,U58442F,4,658.0,0,4,0.0,658.0
25458,UF22D9B,4,5.0,2,2,10.0,15.0
25459,U635DA6,4,1290.0,2,2,10.0,1300.0
25460,UD531ED,4,-0.2600000000002183,3,1,7920.0,7919.74
25461,U3F2699,4,205.0,1,3,5.0,210.0
25462,UE310BB,4,-162.16,4,0,162.16,0.0
25463,U9CD55C,4,0.3100000000000023,1,3,62.32,62.63
25464,UF8D2FB,4,-2608.7200000000003,4,0,2608.7200000000003,0.0
25465,UC7A10B,4,679.0,2,2,3914.0,4593.0
25466,UDEC5EE,4,498.01,2,2,2.0,500.01
25467,U956C6A,4,-1847.119999999999,3,1,8847.119999999999,7000.0
25468,UEA63E5,4,0.0,2,2,12000.0,12000.0
25469,U7107EA,4,-40676.64,4,0,40676.64,0.0
25470,UBF261C,4,101.99999999999989,3,1,769.1700000000001,871.17
25471,UE3D379,4,-2649.32,4,0,2649.32,0.0
25472,UFD85E1,4,-1365.14,4,0,1365.14,0.0
25473,U1FBE31,4,-23.0,3,1,3023.0,3000.0
25474,UAA11BC,4,-20.0,3,1,25.0,5.0
25475,U952F16,4,-701.54,4,0,701.54,0.0
25476,U255DA5,4,-201.0,2,2,5761.0,5560.0
25477,U752C95,4,0.0,3,1,1398.0,1398.0
25478,U7ADCD3,4,-312.0,3,1,1292.0,980.0
25479,UC70374,4,-151.0,3,1,5601.0,5450.0
25480,UE4670B,4,328.28999999999974,2,2,2328.29,2656.58
25481,U82E0A7,4,-5900.0,4,0,5900.0,0.0
25482,U26EF96,4,0.0,2,2,265.85,265.85
25483,U045ABC,4,-5.99,2,2,6.01,0.02
25484,UFE3EAD,4,450.0,2,2,3100.0,3550.0
25485,UFD5767,4,3987.0,2,2,4013.0,8000.0
25486,UB5419D,4,17.310000000000002,0,4,0.0,17.310000000000002
25487,UD6613A,4,-1930.1899999999998,3,1,1930.1999999999998,0.01
25488,U8F5E30,4,-119.23000000000002,2,2,16251.23,16132.0
25489,UE184A1,4,-11630.0,3,1,11730.0,100.0
25490,U4C74ED,4,-13.489999999999998,4,0,13.489999999999998,0.0
25491,U7CAFE3,4,-11.1,4,0,11.1,0.0
25492,U075BA7,4,154.30000000000018,2,2,14028.0,14182.3
25493,U707CD2,4,-3.25,2,2,1030010.0,1030006.75
25494,U2E0A75,4,-501.66,4,0,501.66,0.0
25495,UF3184D,4,-3.920000000000016,2,2,854.0,850.08
25496,U15457B,4,700.0,2,2,36550.0,37250.0
25497,U7F29F8,4,261.6500000000001,2,2,4040.0,4301.65
25498,U3EB89B,4,-2.96,3,1,3.0,0.04
25499,UD683A5,4,-129.77999999999997,2,2,329.90999999999997,200.13
25500,U41E60B,4,-247.19,2,2,436.0,188.81
25501,UED2BD6,4,-512.44,4,0,512.44,0.0
25502,UF93B24,4,-17655.0,1,3,21275.0,3620.0
25503,UB2FFB5,4,423.72000000000025,2,2,3557.0,3980.7200000000003
25504,U3A9668,4,-461.5,4,0,461.5,0.0
25505,U2D416F,4,1574.0,2,2,11773.0,13347.0
25506,UC1522E,4,-4052.4500000000007,2,2,21126.0,17073.55
25507,UC3B476,4,79.84,2,2,166.34,246.18
25508,U0E734F,4,-9978.0,2,2,19978.0,10000.0
25509,U42B761,4,13840.0,1,3,3499.0,17339.0
25510,U554A35,4,-5.0,3,1,762.1,757.1
25511,U20D0F0,4,-356.9,3,1,656.9,300.0
25512,UBAF18F,4,393.8399999999999,2,2,3050.0,3443.84
25513,UF8BA26,4,-68.28,3,1,78.42,10.14
25514,UDDD29E,4,-4670.860000000001,1,3,5180.0,509.14
25515,UFB5091,4,-820.0,3,1,50519.0,49699.0
25516,U5FA0D4,4,2114.62,2,2,42.9,2157.52
25517,UEF56E5,4,-99.72,2,2,298.0,198.28
25518,UDC522F,4,1085.67,2,2,1001.0,2086.67
25519,U06D1FA,4,-1.0,2,2,5991.21,5990.21
25520,U31E35C,4,3796.0,2,2,2382.0,6178.0
25521,U860F6D,4,0.0,2,2,10.0,10.0
25522,U0360AE,4,4430.0,1,3,3000.0,7430.0
25523,UF82985,4,-2363.46,4,0,2363.46,0.0
25524,U8AF868,4,-205.0,2,2,8351.0,8146.0
25525,UB2A9F3,4,9810.0,1,3,7560.0,17370.0
25526,U70967B,4,50.0,2,2,130.0,180.0
25527,UDE7A22,4,0.0,2,2,7879.0,7879.0
25528,U06B4FB,4,706.94,2,2,10.0,716.94
25529,UF9EF83,4,-705.08,4,0,705.08,0.0
25530,UE6753B,4,30.0,0,4,0.0,30.0
25531,UF46D90,4,-4586.78,2,2,5090.48,503.7
25532,UBD47D5,4,-983.34,4,0,983.34,0.0
25533,U980C57,4,-91.84,4,0,91.84,0.0
25534,U3C6F3F,4,-8859.42,4,0,8859.42,0.0
25535,UA22FE4,4,7119.0,3,1,1760.0,8879.0
25536,UE7AEC2,4,-74.96,4,0,74.96,0.0
25537,UB90E05,4,-1734.0,4,0,1734.0,0.0
25538,U964EC3,4,1.9400000000000002,2,2,2.0,3.94
25539,U3CBF00,4,-590.0,4,0,590.0,0.0
25540,UEA1987,4,1738.39,0,4,0.0,1738.39
25541,UD1E6E5,4,-2222.5,4,0,2222.5,0.0
25542,U442740,4,0.0,2,2,3618.0,3618.0
25543,U04A54B,4,198.67000000000007,2,2,1360.0,1558.67
25544,U6DE4D0,4,905.0,2,2,4710.0,5615.0
25545,UC4C63B,4,-16188.0,4,0,16188.0,0.0
25546,UF5F9CA,4,-933.5999999999999,4,0,933.5999999999999,0.0
25547,U8EE1D6,4,-92.26,4,0,92.26,0.0
25548,U0C5E4E,4,0.0,3,1,4873.0,4873.0
25549,U56CF17,4,-1173.7800000000002,4,0,1173.7800000000002,0.0
25550,U38998C,4,-677.66,4,0,677.66,0.0
25551,U1FF10D,4,-0.010000000000218279,2,2,12495.0,12494.99
25552,U3B2962,4,1110.0,3,1,8470.0,9580.0
25553,U64388F,4,0.2599999999999909,2,2,2113.74,2114.0
25554,UC0E88E,4,-880.88,4,0,880.88,0.0
25555,U4933CE,4,-3.6300000000000097,2,2,102.85,99.22
25556,U9E9A8D,4,1450.0,0,4,0.0,1450.0
25557,U1BBC57,4,3685.0,0,4,0.0,3685.0
25558,UF3BA5D,4,15.0,2,2,15785.0,15800.0
25559,UC971AC,4,3600.0,0,4,0.0,3600.0
25560,U4FEF38,4,-3633.32,4,0,3633.32,0.0
25561,UB6F937,4,2438.24,2,2,41.8,2480.04
25562,U3EA393,4,-3933.34,4,0,3933.34,0.0
25563,U79CEDD,4,-676.98,4,0,676.98,0.0
25564,U2D0BEB,4,751.0,1,3,6000.0,6751.0
25565,U167763,4,-2894.94,3,1,3209.0,314.06
25566,U70F36B,4,75.0,2,2,2971.0,3046.0
25567,UD6D5B3,4,-343.16,4,0,343.16,0.0
25568,UD44753,4,3.4299999999999997,2,2,2.0,5.43
25569,U4DE839,4,5.0,2,2,10.0,15.0
25570,U11214C,4,-786.0,3,1,791.0,5.0
25571,U3686AA,4,1.49,2,2,201.0,202.49
25572,U24025D,4,-4691.59,4,0,4691.59,0.0
25573,UC31092,4,0.0,2,2,48.42,48.42
25574,UFC92D7,4,-551.0,4,0,551.0,0.0
25575,UF60E6F,4,-61.0,2,2,6061.0,6000.0
25576,UDBF9B7,4,3910.0,2,2,4090.0,8000.0
25577,UE052D7,4,45.0,3,1,11499.0,11544.0
25578,UE8433E,4,0.5999999999999996,2,2,10.0,10.6
25579,UE5A0D5,4,-1684.83,2,2,6680.0,4995.17
25580,UA66B1D,4,24.990000000000002,2,2,53.65,78.64
25581,U115959,4,-1928.62,4,0,1928.62,0.0
25582,UED7D5E,4,35.400000000000006,2,2,67.4,102.80000000000001
25583,U9340AA,4,6620.76,1,3,46.0,6666.76
25584,UAA4E09,4,-20.0,2,2,4020.0,4000.0
25585,U566E04,4,139.30999999999995,3,1,1060.69,1200.0
25586,U7A4FE0,4,413.66,1,3,24.88,438.54
25587,UCA3278,4,-8948.39,4,0,8948.39,0.0
25588,U7D7CC7,4,0.0,2,2,10.0,10.0
25589,U461F76,4,0.0,2,2,8000.0,8000.0
25590,U6127F8,4,100.0,3,1,420.0,520.0
25591,U0AF01F,4,-970.38,4,0,970.38,0.0
25592,UDD2D68,4,60.480000000000004,0,4,0.0,60.480000000000004
25593,UE6303C,4,149.81,2,2,240.39999999999998,390.21000000000004
25594,U5892A8,4,-46.309999999999945,3,1,3000.0,2953.69
25595,U10713E,4,-1255.6000000000001,4,0,1255.6000000000001,0.0
25596,U3C687A,4,95.0,2,2,306.0,401.0
25597,UE7627D,4,7700.0,0,4,0.0,7700.0
25598,U32D17B,4,3.0,2,2,3976.0,3979.0
25599,UC207A1,4,4.0,2,2,5956.0,5960.0
25600,UFCDE45,4,-3.9,3,1,4.0,0.1
25601,UE9E797,4,51.12,0,4,0.0,51.12
25602,U8DEA42,4,-58.58,4,0,58.58,0.0
25603,UFA980A,4,0.13000000000010914,2,2,7891.0,7891.13
25604,UD8CB46,4,4565.95,2,2,5661.58,10227.529999999999
25605,UEF633B,4,-4285.0,2,2,11570.0,7285.0
25606,UAFC931,4,1196.0,0,4,0.0,1196.0
25607,U3F746D,4,165.03999999999996,2,2,5974.0,6139.04
25608,UFD29F9,4,525.0,2,2,1475.0,2000.0
25609,UF714DF,4,100.03000000000002,0,4,0.0,100.03000000000002
25610,U20EE63,4,4541.67,2,2,4541.63,9083.3
25611,UB62C9E,4,-1362.66,4,0,1362.66,0.0
25612,U6FF461,4,0.0,2,2,150000.0,150000.0
25613,UF4B6AF,4,0.09,1,3,2998.7,2998.79
25614,U11DD7D,4,160.0,3,1,6040.0,6200.0
25615,U8E54D3,4,-148.0,2,2,984.0,836.0
25616,U70BACF,4,0.0,2,2,10.0,10.0
25617,UE86FC8,4,1014.0,2,2,31912.0,32926.0
25618,U71A34D,4,216.22,1,3,107.1,323.31999999999994
25619,UA36B7B,4,576.2,2,2,529.8,1106.0
25620,U2F5233,4,-8043.629999999999,4,0,8043.629999999999,0.0
25621,U53C96E,4,24800.0,0,4,0.0,24800.0
25622,U53D470,4,-174.8,3,1,303.2,128.4
25623,U3A4693,4,-705.08,4,0,705.08,0.0
25624,UFD867A,4,-402.7399999999999,3,1,4284.14,3881.4
25625,U82FAAD,4,400.0,2,2,7900.0,8300.0
25626,U182495,4,0.0,3,1,129.7,129.7
25627,U3C84A0,4,-53.08000000000001,1,3,161.08,108.0
25628,U0864BA,4,10000.0,1,3,10000.0,20000.0
25629,U19BD0E,4,-789.0,2,2,1010.0,221.0
25630,U37E7EC,4,1947.5,2,2,1816.63,3764.13
25631,UAF04DB,4,0.0,2,2,4000.0,4000.0
25632,U9B2D13,4,-881.3399999999999,4,0,881.3399999999999,0.0
25633,UE44293,4,-359.75,3,1,728.0,368.25
25634,U79A7C9,4,-9324.0,2,2,15000.0,5676.0
25635,U081BAF,4,500.0,2,2,4500.0,5000.0
25636,U210483,4,-170.0,3,1,220.0,50.0
25637,UCE400D,4,5.0,2,2,10.0,15.0
25638,U5BE857,4,0.0,2,2,850.0,850.0
25639,UE59C0B,4,9049.0,2,2,10001.0,19050.0
25640,U29B6E3,4,2410.6100000000006,2,2,12000.0,14410.61
25641,UE7D6E3,4,-2486.0,3,1,2684.0,198.0
25642,U654461,4,400.0,2,2,6787.0,7187.0
25643,UF9D755,4,1680.7,2,2,434.5,2115.2
25644,U8FA555,4,-293.0,3,1,475.0,182.0
25645,UF86C7A,4,0.0,3,1,7894.0,7894.0
25646,UE0C332,4,-1259.1000000000001,4,0,1259.1000000000001,0.0
25647,UE99033,4,25.0,2,2,4975.0,5000.0
25648,U1B67EC,4,1.2899999999999998,2,2,2.71,4.0
25649,U41F9EB,4,0.0,2,2,16000.0,16000.0
25650,U9FC3A8,4,3.800000000000182,2,2,9996.2,10000.0
25651,U4980B9,4,5000.0,0,4,0.0,5000.0
25652,UB03C07,4,1428.0,2,2,2016.0,3444.0
25653,UDFA303,4,1352.0,2,2,9148.0,10500.0
25654,U84A259,4,119.15000000000009,1,3,4066.05,4185.2
25655,U4C78E6,4,-435.7700000000001,3,1,435.80000000000007,0.03
25656,U189A17,4,1000.01,1,3,1000.0,2000.01
25657,UF55E88,4,-91.84,4,0,91.84,0.0
25658,U87DCE2,4,92.89999999999999,2,2,103.84,196.74
25659,UA07CB7,4,0.0,2,2,10.0,10.0
25660,U13E0C0,4,102.0,2,2,9898.0,10000.0
25661,U92842D,4,-407.0,2,2,1807.0,1400.0
25662,U980E4D,4,78.0,3,1,360.0,438.0
25663,UDC8B75,4,-1295.15,2,2,3587.98,2292.83
25664,U2C4CC9,4,-3.552713678800501e-15,2,2,39.84,39.84
25665,UA9FCBA,4,-12917.06,4,0,12917.06,0.0
25666,U62ADF1,4,-18309.0,2,2,23209.0,4900.0
25667,U5A638A,4,0.0,2,2,680.0,680.0
25668,UE10F5C,4,-9083.34,4,0,9083.34,0.0
25669,U07BD90,4,-694.5,4,0,694.5,0.0
25670,U5CF8EE,4,0.0,2,2,850.0,850.0
25671,UFC7E74,4,-2676.3,4,0,2676.3,0.0
25672,U1AE96F,4,-2143.88,4,0,2143.88,0.0
25673,U844DF5,4,500.0,2,2,3200.0,3700.0
25674,U23C9B7,4,14358.339999999997,2,2,14500.0,28858.339999999997
25675,U601D71,4,0.0,2,2,2530.0,2530.0
25676,UB1D328,4,19163.990000000005,1,3,14731.0,33894.990000000005
25677,U9E798B,4,5.0,2,2,10.0,15.0
25678,UE84E46,4,75.16,0,4,0.0,75.16
25679,UC9AFC4,4,-1405.92,3,1,1406.0,0.08
25680,UA18D68,4,-0.01999999999998181,2,2,1100.02,1100.0
25681,U9A0A21,4,-762.8499999999999,4,0,762.8499999999999,0.0
25682,UBC9D40,4,989.01,1,3,112.1,1101.1100000000001
25683,UEF5E42,4,-45.0,3,1,278.0,233.0
25684,U651030,4,-528.46,4,0,528.46,0.0
25685,U1A94C9,4,0.0,2,2,1154.98,1154.98
25686,U83EBFE,4,460.9,2,2,42.379999999999995,503.28
25687,UBE636F,4,-19.0,3,1,79.0,60.0
25688,UA06F55,4,-1036.33,2,2,5155.0,4118.67
25689,U842CF7,4,2.0,2,2,11998.0,12000.0
25690,U9F929F,4,351.61,2,2,89.66,441.27
25691,UE12C36,4,-5349.13,4,0,5349.13,0.0
25692,U0CB8F6,4,-13.48,3,1,18.0,4.52
25693,U8E26E3,4,8.881784197001252e-16,2,2,53.81,53.81
25694,U76F3F6,4,324.15999999999985,3,1,2100.9,2425.06
25695,UDA2A3C,4,-385.1,3,1,5385.1,5000.0
25696,UF313C7,4,-436.4,4,0,436.4,0.0
25697,U72E3E6,4,3880.0,2,2,128.27,4008.27
25698,U498317,4,24834.0,1,3,20000.0,44834.0
25699,UC43B01,4,0.08,1,3,0.01,0.09000000000000001
25700,UEC2760,4,150.05,0,4,0.0,150.05
25701,U1B5F1C,4,174.08000000000004,2,2,1100.0,1274.08
25702,UDF4C7D,4,3392.0,2,2,10.0,3402.0
25703,UC010E0,4,0.0,2,2,800.0,800.0
25704,U490341,4,-40.61,3,1,40.62,0.01
25705,U562669,4,5000.0,2,2,45000.0,50000.0
25706,U2C8CAB,4,-6428.6,3,1,8254.0,1825.4
25707,U0D895A,4,-1783.0,3,1,2842.0,1059.0
25708,UC4456B,4,2909.0,2,2,6013.02,8922.02
25709,U6DE953,4,-4.039999999999999,2,2,28.9,24.86
25710,U20A6B6,4,-9313.47,2,2,9863.47,550.0
25711,U7C969E,4,-1642.0,2,2,10142.0,8500.0
25712,U8A2E80,4,3148.7799999999997,1,3,3000.0,6148.78
25713,UF6E1CF,4,999.0,2,2,18999.0,19998.0
25714,UFA736F,4,-2033.0,3,1,4088.0,2055.0
25715,UBE1785,4,-51.94,3,1,52.0,0.06
25716,U1D8B9C,4,-11992.78,2,2,12000.0,7.22
25717,U9260B2,4,4.0900000000000185,2,2,226.01999999999998,230.11
25718,U79E250,4,0.0,2,2,18000.0,18000.0
25719,U4FB091,4,76.8,1,3,12.61,89.41
25720,U5F12E1,4,4744.54,0,4,0.0,4744.54
25721,UEC35F0,4,76.96999999999997,2,2,604.0,680.97
25722,UDBC3DD,4,-9619.0,3,1,19319.0,9700.0
25723,U6406D8,4,24.049999999999997,3,1,75.95,100.0
25724,U4333C8,4,-235.0,2,2,900.0,665.0
25725,UE4202C,4,112.0,2,2,54.0,166.0
25726,U4823BF,4,-795.0,1,3,9045.0,8250.0
25727,UF69512,4,-3940.6800000000003,4,0,3940.6800000000003,0.0
25728,UC78822,4,0.0,2,2,2000.0,2000.0
25729,U3403D1,4,0.0,2,2,8000.0,8000.0
25730,UCF77BF,4,0.09,2,2,1124.1,1124.1899999999998
25731,UAE659C,4,-930.56,4,0,930.56,0.0
25732,U27EB46,4,645.3199999999999,2,2,354.8,1000.12
25733,U4093F6,4,-0.9400000000000001,3,1,1.02,0.08
25734,UF140DC,4,571.31,2,2,5643.6900000000005,6215.0
25735,UD04CB1,4,-66.0,3,1,82.0,16.0
25736,U8CCDFC,4,10001.75,0,4,0.0,10001.75
25737,U2BF88A,4,90.0,3,1,410.0,500.0
25738,UD1F7C6,4,-625.0400000000002,2,2,2718.4399999999996,2093.3999999999996
25739,U711833,4,0.0,2,2,7995.0,7995.0
25740,UE3DF07,4,2699.0,2,2,9301.0,12000.0
25741,U679C8E,4,-3243.9000000000005,4,0,3243.9000000000005,0.0
25742,UF0583B,4,5.0,2,2,11987.0,11992.0
25743,U540D28,4,-3.0,1,3,2320.0,2317.0
25744,UD6ECEC,4,-499.99,2,2,1000.0,500.01
25745,UCFF94D,4,-4.979999999999563,2,2,11989.98,11985.0
25746,U528344,4,-1887.6499999999996,2,2,5850.0,3962.3500000000004
25747,U67857F,4,-738.95,1,3,1000.0,261.05
25748,UA40E88,4,107415.81,2,2,6.0,107421.81
25749,UEB5C3F,4,65.71000000000001,1,3,3701.0,3766.71
25750,U590EEA,4,-1092.86,4,0,1092.86,0.0
25751,UC5E816,4,1279.25,1,3,895.0,2174.25
25752,U670FDF,4,0.0,2,2,133.0,133.0
25753,U9EFB36,4,98.0,2,2,96.0,194.0
25754,U17D313,4,294.0,3,1,606.0,900.0
25755,UB651D3,4,4100.0,2,2,1700.0,5800.0
25756,UC18BB9,4,1790.0,2,2,10.0,1800.0
25757,UB907BB,4,-2820.74,4,0,2820.74,0.0
25758,U0B64B8,4,-118.0,1,3,136.98,18.98
25759,U2219DB,4,0.0,2,2,10.0,10.0
25760,U7DB804,4,-199.4,4,0,199.4,0.0
25761,U9ABF61,4,10.010000000000218,2,2,9979.0,9989.01
25762,U3448A0,4,-2679.0,3,1,3010.0,331.0
25763,U079EC1,4,5881.05,3,1,355.95,6237.0
25764,UB1DE70,4,700.0,2,2,1600.0,2300.0
25765,U385C92,4,23.0,2,2,1446.0,1469.0
25766,UE3CFEA,4,99.48000000000002,3,1,500.52,600.0
25767,UC350E1,4,833.0,2,2,6728.0,7561.0
25768,UD9FA3A,4,-423.49999999999994,4,0,423.49999999999994,0.0
25769,U601FF7,4,-141.71999999999997,4,0,141.71999999999997,0.0
25770,U46468A,4,5050.0,2,2,6000.0,11050.0
25771,UF9B20C,4,-17009.0,3,1,35897.0,18888.0
25772,UF53895,4,153.78999999999996,2,2,1154.51,1308.3
25773,U0C8FE7,4,0.0,2,2,10100.0,10100.0
25774,U739EF4,4,-2440.0,4,0,2440.0,0.0
25775,UF19D97,4,39.900000000000006,2,2,20.0,59.900000000000006
25776,U90067E,4,200.0,3,1,3310.0,3510.0
25777,UDD8272,4,0.0,2,2,10.0,10.0
25778,UDCCC55,4,-1407.0,3,1,3336.73,1929.73
25779,UF1DAD7,4,500.69000000000005,3,1,32.21,532.9
25780,UA4663A,4,-275.53,4,0,275.53,0.0
25781,UD1E139,4,6.600000000000364,2,2,6973.4,6980.0
25782,UEC60FF,4,-114.0,3,1,514.0,400.0
25783,U90FE1E,4,-450.0,3,1,500.0,50.0
25784,U5C32FF,4,-7900.0,3,1,10900.0,3000.0
25785,U01FCA0,4,-44.719999999999914,3,1,1029.42,984.7
25786,UB0C366,4,-1198.62,3,1,1198.65,0.03
25787,U9C2FB7,4,-1180.0,4,0,1180.0,0.0
25788,UE9D778,4,0.0,2,2,683.26,683.26
25789,UD9FB5B,4,-7236.26,4,0,7236.26,0.0
25790,UF70BDE,4,-1725.5200000000002,4,0,1725.5200000000002,0.0
25791,U1C040B,4,0.0,2,2,439.0,439.0
25792,U646DB2,4,0.8000000000000004,3,1,10.2,11.0
25793,UEB33DB,4,0.0,2,2,6000.0,6000.0
25794,UDD4A5B,4,1499.4099999999996,1,3,11500.6,13000.01
25795,UE5B42B,4,-10821.34,2,2,10835.24,13.9
25796,U5C5C1E,4,4200.0,2,2,9637.2,13837.2
25797,UC25C80,4,113.1,3,1,186.9,300.0
25798,UE2FF91,4,35.1,2,2,36.9,72.0
25799,UC27A15,4,-85.0,3,1,124.0,39.0
25800,U079E0F,4,0.0,2,2,10.0,10.0
25801,U995473,4,-890.66,4,0,890.66,0.0
25802,U8750A1,4,0.0,2,2,20000.0,20000.0
25803,U1683E4,4,166.0,2,2,11676.0,11842.0
25804,U23C13E,4,-2826.0,2,2,6790.0,3964.0
25805,U9419E3,4,0.0,2,2,13530.25,13530.25
25806,U188B71,4,48.80000000000019,1,3,1351.35,1400.15
25807,UDABB1F,4,7399.64,2,2,10.0,7409.64
25808,U770BD7,4,3500.0,2,2,10.0,3510.0
25809,U5B91BD,4,13227.08,1,3,779.0,14006.08
25810,U3244F5,4,-606.98,4,0,606.98,0.0
25811,U47D408,4,-769.96,2,2,1159.96,390.0
25812,UFB3D81,4,2.0,2,2,21996.0,21998.0
25813,U6E4197,4,0.0,2,2,12000.0,12000.0
25814,UA42F68,4,921.27,2,2,88.73,1010.0
25815,UAD62D9,4,-2172.6299999999997,2,2,2186.0,13.37
25816,U3A48EF,4,3.9799999999995634,2,2,5244.0,5247.98
25817,UABC5F2,4,-5001.0,3,1,11999.0,6998.0
25818,UCA1658,4,6258.049999999999,2,2,4040.0,10298.05
25819,U3D938F,4,840.2,2,2,10.0,850.2
25820,UD19C8F,4,-769.09,2,2,770.01,0.9199999999999999
25821,UD7ED67,4,-2444.3400000000006,4,0,2444.3400000000006,0.0
25822,UF4B9A6,4,-499.74,4,0,499.74,0.0
25823,U30360A,4,710.0,2,2,10.0,720.0
25824,U6C4C44,4,-56.91,3,1,151.91,95.0
25825,U542279,4,247.0,2,2,10.0,257.0
25826,UF12684,4,-9057.0,3,1,9243.0,186.0
25827,U434C1D,4,3321.55,2,2,10.9,3332.45
25828,UDD6F32,4,-15733.28,4,0,15733.28,0.0
25829,U262033,4,-5215.64,4,0,5215.64,0.0
25830,U2E4A2B,4,-232.42,3,1,232.57,0.15
25831,U58C0B6,4,-1.9900000000000002,2,2,13.0,11.01
25832,U093035,4,-850.0,2,2,5750.0,4900.0
25833,U652148,4,243.46000000000004,3,1,2258.0,2501.46
25834,U9F8D99,4,-337.0,3,1,405.0,68.0
25835,U732391,4,0.0,2,2,1400.0,1400.0
25836,U8B1EDA,4,-5929.92,3,1,7069.92,1140.0
25837,U88F493,4,4.547473508864641e-13,1,3,5370.44,5370.4400000000005
25838,UA0C94A,4,2138.6400000000003,2,2,2138.6299999999997,4277.27
25839,U0B2BD1,4,1500.05,1,3,3.19,1503.24
25840,U58FC71,4,-252.29999999999998,3,1,253.26,0.96
25841,U01F42E,4,0.0,2,2,30.0,30.0
25842,UE20D85,4,-89.44999999999996,3,1,341.15999999999997,251.71
25843,UD4BE59,4,-610.96,4,0,610.96,0.0
25844,UAEAB3B,4,0.0,2,2,10.0,10.0
25845,U077F8F,4,-23.77,2,2,73.78,50.01
25846,UF4F17A,4,3292.0,2,2,3828.18,7120.18
25847,U780B4E,4,-881.3399999999999,4,0,881.3399999999999,0.0
25848,UCC9618,4,-194.28,4,0,194.28,0.0
25849,U7A8B59,4,-1432.04,4,0,1432.04,0.0
25850,U545DF9,4,-10.0,3,1,810.0,800.0
25851,U34B1D0,4,-3221.73,4,0,3221.73,0.0
25852,U7E7CC5,4,-120.30000000000001,4,0,120.30000000000001,0.0
25853,U53AEF7,4,-269.8,4,0,269.8,0.0
25854,U496CCF,4,298.0,2,2,10.0,308.0
25855,U85A4F5,4,747.6,2,2,363.4,1111.0
25856,UF40CB3,4,-180.0,2,2,18990.0,18810.0
25857,U4078AE,4,-1428.18,4,0,1428.18,0.0
25858,U7AC719,4,5.37,2,2,10.0,15.37
25859,U0E9CFA,4,0.0,2,2,23990.0,23990.0
25860,U89C91D,4,152.96000000000004,2,2,500.0,652.96
25861,U75D21D,4,101.54,2,2,38.8,140.34
25862,U5E4D31,4,5538.18,1,3,98.55,5636.7300000000005
25863,U17EC2D,4,-1999.4500000000007,2,2,15200.0,13200.55
25864,UC0943A,4,-21857.0,3,1,22157.0,300.0
25865,UE8D62F,4,-183.7,4,0,183.7,0.0
25866,U48E524,4,3574.01,1,3,0.01,3574.0200000000004
25867,U38F0E7,4,428.22,2,2,1571.78,2000.0
25868,UD90B5D,4,130.2,2,2,130.2,260.4
25869,UD6AD1D,4,8.0,2,2,13.0,21.0
25870,UC9512C,4,-339.0,3,1,680.48,341.48
25871,UA74667,4,0.0,2,2,10.0,10.0
25872,U251D01,4,784.0,0,4,0.0,784.0
25873,UB72EFB,4,201.8,2,2,147.5,349.3
25874,U7127D5,4,0.0,2,2,4000.0,4000.0
25875,U967E5C,4,20.03,1,3,0.03,20.060000000000002
25876,UF39A8D,4,3.0,2,2,5997.0,6000.0
25877,UC8DF27,4,-443.0,4,0,443.0,0.0
25878,U530CDF,4,924.78,2,2,10.0,934.78
25879,UBEF390,4,0.0,2,2,10.0,10.0
25880,U4F67B0,4,-528.64,4,0,528.64,0.0
25881,UEC12EE,4,116.0,1,3,3900.0,4016.0
25882,U9E3698,4,12.069999999999927,1,3,10000.0,10012.07
25883,UD81D72,4,0.0,2,2,90.0,90.0
25884,UFFABAC,4,-26742.309999999998,4,0,26742.309999999998,0.0
25885,UDEC92E,4,-6100.44,4,0,6100.44,0.0
25886,U37618D,4,0.0,2,2,2001.0,2001.0
25887,U8BB449,4,797.0,1,3,1680.0,2477.0
25888,U10C0A0,4,-12581.33,2,2,12871.68,290.35
25889,U94CA69,4,9195.0,0,4,0.0,9195.0
25890,U7FFD94,4,-11.059999999999999,2,2,48.0,36.94
25891,U8E1CDC,4,-273.26,4,0,273.26,0.0
25892,U6CCE83,4,-480.0,2,2,19960.0,19480.0
25893,U6904DC,4,478.0,2,2,320.0,798.0
25894,UCB2E9E,4,3.0,2,2,3986.0,3989.0
25895,U6539CE,4,1057.02,2,2,10.0,1067.02
25896,U9431E7,4,13780.78,1,3,5.0,13785.78
25897,UFB72B8,4,0.0,2,2,10000.0,10000.0
25898,U21D3A2,4,-839.2,4,0,839.2,0.0
25899,U0E5C45,4,-233.0,2,2,6222.0,5989.0
25900,U044646,4,0.0,2,2,544.0,544.0
25901,U1DC56D,4,10390.0,2,2,10490.0,20880.0
25902,U428FAA,4,-9899.0,3,1,19899.0,10000.0
25903,UEFC0B7,4,100.0,2,2,1200.0,1300.0
25904,U5C160C,4,-881.0,2,2,1981.0,1100.0
25905,UE38D99,4,6.130000000000002,3,1,21.04,27.17
25906,U5BA557,4,-1012.0,3,1,4337.0,3325.0
25907,UFFAC78,4,-4916.66,4,0,4916.66,0.0
25908,UDBE492,4,-156.6,2,2,256.6,100.0
25909,UE80889,4,550.0,2,2,6150.0,6700.0
25910,U28D011,4,1308.3999999999999,2,2,373.4,1681.8
25911,UDE58F0,4,-231.54,4,0,231.54,0.0
25912,UE42746,4,2939.0,2,2,6856.0,9795.0
25913,U2A8F66,4,92.0,2,2,688.0,780.0
25914,UDF9C9F,4,360.0,3,1,6640.0,7000.0
25915,U7A6575,4,0.0,2,2,10.0,10.0
25916,U1CC6CE,4,125.65999999999997,2,2,1283.0,1408.6599999999999
25917,UC4A1F8,4,1.81903103690928e-14,2,2,500.02,500.02
25918,U2CD46D,4,-13570.059999999998,2,2,25000.0,11429.94
25919,U8D7767,4,15030.17,2,2,4658.0,19688.17
25920,U6B2158,4,-998.5600000000001,4,0,998.5600000000001,0.0
25921,UD30013,4,-1049.04,4,0,1049.04,0.0
25922,UF876B7,4,0.0,3,1,2435.95,2435.95
25923,U4484EA,4,-0.4399999999999977,3,1,210.0,209.56
25924,U8F1699,4,333.2,2,2,489.0,822.2
25925,U6DC1DD,4,-7754.68,4,0,7754.68,0.0
25926,U35E943,4,517.0,3,1,9443.0,9960.0
25927,UAD60B8,4,1.0,1,3,1001.0,1002.0
25928,U6652E4,4,-580.0,2,2,5350.0,4770.0
25929,U5AD47F,4,0.3800000000000001,2,2,2.0,2.38
25930,U51BC26,4,-1.9400000000001092,2,2,3001.94,3000.0
25931,U02FA34,4,-1615.4799999999998,4,0,1615.4799999999998,0.0
25932,UBCE7D4,4,618.1999999999998,2,2,9381.8,10000.0
25933,U169259,4,-3568.73,4,0,3568.73,0.0
25934,U27C714,4,100.0,1,3,4.03,104.03
25935,U8709DD,4,0.0,2,2,28000.0,28000.0
25936,U026C6C,4,2.130000000000109,1,3,3724.8,3726.9300000000003
25937,UBF69E3,4,-2895.8600000000006,4,0,2895.8600000000006,0.0
25938,U10A2FA,4,100.0,2,2,23794.0,23894.0
25939,UD59E84,4,-1800.0,3,1,2600.0,800.0
25940,UDDFD6B,4,1.83,0,4,0.0,1.83
25941,U544E0A,4,-5288.08,4,0,5288.08,0.0
25942,U7EFB92,4,2950.0,0,4,0.0,2950.0
25943,U732D1E,4,38.0,2,2,5582.0,5620.0
25944,UF37A93,4,34.320000000000164,2,2,5996.0,6030.32
25945,UD039A5,4,196.67000000000007,3,1,4859.7699999999995,5056.44
25946,U945B5E,4,78.71,3,1,26.0,104.71
25947,U332C91,4,0.0,2,2,10.0,10.0
25948,U78871E,4,-5207.8,4,0,5207.8,0.0
25949,UF223D6,4,1247.0,1,3,0.05,1247.05
25950,U7D40D1,4,-1867.2,4,0,1867.2,0.0
25951,U519265,4,2560.05,1,3,93.13,2653.1800000000003
25952,U552F13,4,-1233.8999999999999,4,0,1233.8999999999999,0.0
25953,U0C2521,4,0.0,2,2,3000.0,3000.0
25954,U858D11,4,-1732.66,3,1,1886.0,153.34
25955,UF713A0,4,2.0100000000002183,2,2,14777.0,14779.01
25956,U2B6E9B,4,-899.34,4,0,899.34,0.0
25957,UE7C95A,4,-1284.6,3,1,1339.36,54.76
25958,UC87FCE,4,-495.28,4,0,495.28,0.0
25959,U76ED9D,4,-1993.5900000000001,3,1,4093.59,2100.0
25960,U1F3D95,4,-12.31,3,1,12.32,0.01
25961,U31E3BB,4,-430.0,2,2,4040.0,3610.0
25962,UC5E2D1,4,11927.89,2,2,10.0,11937.89
25963,U27A085,4,6028.0,0,4,0.0,6028.0
25964,U15DE58,4,1055.0,2,2,50000.0,51055.0
25965,U6462C3,4,-10.0,3,1,4510.0,4500.0
25966,UB3908A,4,150.0,2,2,7900.0,8050.0
25967,UD90E24,4,-16.0,4,0,16.0,0.0
25968,UFE4935,4,-3844.6000000000004,4,0,3844.6000000000004,0.0
25969,UD59427,4,298.63,2,2,59.26,357.89
25970,UB014EE,4,-471.1,3,1,991.1,520.0
25971,UDB5DE4,4,117.9,2,2,740.0,857.9
25972,UCBE4A5,4,-3441.74,4,0,3441.74,0.0
25973,UAC9BB0,4,-199.69000000000005,2,2,1040.0,840.31
25974,U2D926C,4,-5464.360000000001,4,0,5464.360000000001,0.0
25975,UC976D6,4,-39.84,3,1,40.0,0.16
25976,U95EABE,4,1700.0,0,4,0.0,1700.0
25977,U745044,4,0.0,2,2,976.9,976.9
25978,U583BB6,4,-8.0,2,2,5978.0,5970.0
25979,U28D511,4,1.1368683772161603e-13,2,2,1442.0900000000001,1442.0900000000001
25980,U4DC33C,4,123.05999999999995,2,2,922.48,1045.54
25981,UBCE903,4,-1045.0,4,0,1045.0,0.0
25982,U3F9D05,4,-30630.0,3,1,32000.0,1370.0
25983,U9D6B95,4,-97.97999999999999,3,1,101.50999999999999,3.53
25984,U1F61AF,4,0.0,2,2,10000.0,10000.0
25985,U7B17FA,4,4990.0,2,2,10.0,5000.0
25986,UE4A67E,4,-3847.1,3,1,3868.0,20.9
25987,UBBE523,4,0.0,2,2,10.0,10.0
25988,UDC49B7,4,613.7600000000001,2,2,1027.24,1641.0
25989,U703EEA,4,-185.1,4,0,185.1,0.0
25990,UB7D820,4,1046.54,1,3,478.66,1525.2
25991,UFD5918,4,-5.0,3,1,265.0,260.0
25992,UC0ECE3,4,-985.5600000000001,3,1,1133.22,147.66
25993,U114B2E,4,38.76000000000002,2,2,161.07,199.83
25994,UE41A62,4,39.760000000000005,3,1,69.24,109.0
25995,U01EDE1,4,-2700.0,3,1,5400.0,2700.0
25996,UBC54F6,4,0.0,2,2,5317.0,5317.0
25997,U327447,4,0.00999999999998579,2,2,307.7,307.71
25998,UCED4FB,4,119.70999999999998,1,3,408.3,528.01
25999,UC20241,4,-705.52,4,0,705.52,0.0
26000,UF1A82B,4,-260.4,4,0,260.4,0.0
26001,UEB67CA,4,-1.0399999999999636,2,2,6000.0,5998.96
26002,UDE6E8A,4,5268.18,2,2,949.31,6217.490000000001
26003,U8C372A,4,-3521.15,4,0,3521.15,0.0
26004,UBEEF12,4,2409.2599999999993,2,2,2594.44,5003.7
26005,UA0E780,4,1077.0900000000006,2,2,8122.91,9200.0
26006,UB7B1D0,4,605.0,2,2,1358.0,1963.0
26007,UE2C038,4,5627.85,2,2,472.15,6100.0
26008,UF6F927,4,6000.0,0,4,0.0,6000.0
26009,U8CF6DA,4,-1951.4699999999998,4,0,1951.4699999999998,0.0
26010,UFFC513,4,478.0,2,2,4522.0,5000.0
26011,U4B0731,4,-2.469999999999999,2,2,20.0,17.53
26012,U24BC72,4,-1551.1799999999998,4,0,1551.1799999999998,0.0
26013,UF89296,4,0.0,2,2,378.0,378.0
26014,U86EE8F,4,300.0,1,3,5.0,305.0
26015,UE3688F,4,-1303.6100000000006,2,2,11324.04,10020.43
26016,U86BB6C,4,1164.0,2,2,7800.0,8964.0
26017,U908D7F,4,-1.1368683772161603e-13,3,1,604.3100000000001,604.31
26018,U4708EF,4,32.0,3,1,6310.0,6342.0
26019,UEEA0DE,4,40.65000000000001,2,2,109.4,150.05
26020,U0DA403,4,10001.84,1,3,10000.0,20001.84
26021,UFC5B40,4,3951.11,2,2,145.9,4097.01
26022,U7E89C1,4,1212.0,2,2,650.0,1862.0
26023,U1835A8,4,-490.0,3,1,492.0,2.0
26024,UF924DA,4,-23399.0,2,2,68777.0,45378.0
26025,UD64C93,4,11173.65,1,3,96.06,11269.710000000001
26026,U128AA4,4,367.0,0,4,0.0,367.0
26027,UD4712C,4,291.4,2,2,977.91,1269.31
26028,UF2004B,4,4630.0,2,2,4001.0,8631.0
26029,U52335D,4,-7046.97,3,1,7055.0,8.03
26030,UD7E468,4,-0.25,2,2,10000.0,9999.75
26031,UE5832E,4,0.0,1,3,10000.0,10000.0
26032,U3D6A6E,4,130.0,2,2,2020.0,2150.0
26033,U0F5015,4,0.0,2,2,6000.0,6000.0
26034,U0CA667,4,10543.0,1,3,17.0,10560.0
26035,UB15596,4,18750.0,0,4,0.0,18750.0
26036,U9856A2,4,-222.59,3,1,422.19,199.6
26037,UC215A5,4,-15.62,3,1,16.0,0.38
26038,U145F86,4,-550.62,4,0,550.62,0.0
26039,U4D9502,4,-175.0,4,0,175.0,0.0
26040,U80901A,4,8000.0,1,3,8000.0,16000.0
26041,U0558A3,4,12000.0,2,2,23000.0,35000.0
26042,U98AB38,4,0.0,2,2,60.0,60.0
26043,UFDB6E6,4,89.0,2,2,4000.0,4089.0
26044,UC85CDD,4,0.0,2,2,1009.0,1009.0
26045,U0FEB67,4,-9785.39,4,0,9785.39,0.0
26046,U27067D,4,-150.0,2,2,5900.0,5750.0
26047,U43E125,4,1108.0,2,2,106.5,1214.5
26048,U7D1864,4,-410.0,4,0,410.0,0.0
26049,U782A32,4,5990.060000000001,1,3,5996.0,11986.060000000001
26050,U145EFC,4,3078.19,2,2,3015.0,6093.1900000000005
26051,U43C7A8,4,1487.56,1,3,41.15,1528.71
26052,U06DC45,4,624.4,3,1,235.0,859.4
26053,UD682E4,4,-528.8,4,0,528.8,0.0
26054,UB5A1C4,4,-8184.299999999999,2,2,17278.3,9094.0
26055,UDB24B6,4,399.5,2,2,6000.0,6399.5
26056,UC8768A,4,673.6599999999999,2,2,9974.34,10648.0
26057,UDB5E5F,4,15990.0,2,2,10.0,16000.0
26058,U230746,4,96.02,2,2,5.01,101.03
26059,U36D0F3,4,-539.5999999999999,4,0,539.5999999999999,0.0
26060,UE52F53,4,141.1300000000001,3,1,1275.0,1416.13
26061,U425DFE,4,-0.899999999999995,3,1,153.9,153.0
26062,U21D515,4,2.842170943040401e-14,2,2,227.04,227.04000000000002
26063,UE63101,4,-5504.81,4,0,5504.81,0.0
26064,UEA389E,4,483.67999999999995,1,3,232.27,715.95
26065,U049B86,4,-971.96,4,0,971.96,0.0
26066,U254312,4,0.0,2,2,10.0,10.0
26067,UB8A77F,4,57.00999999999999,2,2,2270.99,2328.0
26068,UE0AEF7,4,3049.2,2,2,31.0,3080.2
26069,UE80308,4,2344.0200000000004,2,2,4502.0,6846.02
26070,UC80F58,4,2.83,2,2,2.0,4.83
26071,UDC4ED8,4,-175.0,4,0,175.0,0.0
26072,U1BB5D5,4,-3433.0,3,1,9433.0,6000.0
26073,UDA44B9,4,-1259.0600000000002,4,0,1259.0600000000002,0.0
26074,U029C1A,4,4827.0,2,2,10961.0,15788.0
26075,U7D38A2,4,-75.24,4,0,75.24,0.0
26076,U29273D,4,-4.21,3,1,5.4399999999999995,1.23
26077,UFC3E0A,4,136.2,3,1,45.8,182.0
26078,UCBDBEA,4,200.0,0,4,0.0,200.0
26079,UFF48E9,4,90.0,2,2,450.0,540.0
26080,UB7AE7D,4,-22700.0,4,0,22700.0,0.0
26081,U2AEEE9,4,7.5,2,2,1510.5,1518.0
26082,UDC2DFC,4,6974.0,0,4,0.0,6974.0
26083,UF71725,4,306.07,2,2,306.04,612.11
26084,U495AB9,4,1075.17,1,3,1073.0,2148.17
26085,U4F4722,4,18.0,2,2,5960.0,5978.0
26086,U59A879,4,-114.57,3,1,207.76,93.19
26087,U8DDA45,4,-2450.0,2,2,7500.0,5050.0
26088,U714422,4,2090.13,2,2,1980.0,4070.13
26089,UCE0A9D,4,-81.34,2,2,166.34,85.0
26090,U224CDB,4,1450.0,2,2,4510.0,5960.0
26091,UB9B478,4,0.0,2,2,8.07,8.07
26092,U42FF1D,4,-1819.8000000000002,4,0,1819.8000000000002,0.0
26093,U6417FF,4,0.0,2,2,103.84,103.84
26094,U45FAC1,4,-2836.56,4,0,2836.56,0.0
26095,UA061CB,4,3256.2,1,3,800.4,4056.6
26096,UD7318B,4,-912.0,4,0,912.0,0.0
26097,U130E03,4,-2810.0,2,2,3364.0,554.0
26098,U70D9A7,4,8990.0,2,2,10.0,9000.0
26099,U45D816,4,17160.37,2,2,225.4,17385.77
26100,U34ACFC,4,0.0,2,2,2896.0,2896.0
26101,U223AF0,4,-1057.44,4,0,1057.44,0.0
26102,U0CF7C6,4,-23600.0,4,0,23600.0,0.0
26103,U2E1870,4,3600.0,2,2,2000.0,5600.0
26104,U196E50,4,475.0,2,2,10.0,485.0
26105,U7EB3F6,4,-1.93,2,2,2.0,0.07
26106,U883243,4,-20.0,2,2,2611.46,2591.46
26107,U77E7E6,4,-2800.0,4,0,2800.0,0.0
26108,U907A56,4,-4.5600000000000005,2,2,9.0,4.44
26109,U3E28F5,4,2790.0,1,3,3000.0,5790.0
26110,UCE1306,4,-78.0,2,2,5978.0,5900.0
26111,U0A94A2,4,1199.1000000000004,1,3,3200.0,4399.1
26112,U9B3C71,4,-7809.57,2,2,8560.46,750.89
26113,UAE8F11,4,5070.6,2,2,29.4,5100.0
26114,U3A73A4,4,-147.39999999999964,3,1,7786.4,7639.0
26115,U641171,4,-581.5999999999999,4,0,581.5999999999999,0.0
26116,UD7605D,4,-150.89000000000001,3,1,152.53,1.64
26117,UB44CDA,4,5720.09,0,4,0.0,5720.09
26118,UA7B7B1,4,-890.16,4,0,890.16,0.0
26119,U2D7FB5,4,-4290.0,3,1,7790.0,3500.0
26120,UEB828C,4,-4084.7400000000002,4,0,4084.7400000000002,0.0
26121,UDF24D6,4,-4533.55,4,0,4533.55,0.0
26122,UE2EAE9,4,-2.0,3,1,2.29,0.29
26123,UA4F627,4,163.0,0,4,0.0,163.0
26124,U08A71A,4,350.33,2,2,350.35,700.6800000000001
26125,UAAC14C,4,-3070.1000000000004,4,0,3070.1000000000004,0.0
26126,U1EAEAE,4,1046.02,0,4,0.0,1046.02
26127,UF5F602,4,-1348.0,2,2,4348.0,3000.0
26128,UF5B856,4,0.0,2,2,1033.16,1033.16
26129,UD4B155,4,500.22,1,3,500.0,1000.22
26130,UB608D6,4,776.0,2,2,5774.0,6550.0
26131,U467914,4,-37.790000000000056,2,2,746.19,708.4
26132,U26E64C,4,910.0,2,2,6000.0,6910.0
26133,U779BD5,4,6.75,3,1,588.78,595.53
26134,U980798,4,800.0,2,2,7000.0,7800.0
26135,U23B6AA,4,572.5500000000001,2,2,1246.0,1818.55
26136,U854A64,4,0.0,2,2,14000.0,14000.0
26137,U4DCE0B,4,53.79,0,4,0.0,53.79
26138,UE762AE,4,13.02000000000001,2,2,341.58,354.6
26139,UEB5B11,4,-2020.0,4,0,2020.0,0.0
26140,U1BCA8B,4,9054.34,1,3,0.17,9054.51
26141,UD3CC01,4,-40.0,2,2,19890.0,19850.0
26142,U21D4B4,4,-566.1800000000001,4,0,566.1800000000001,0.0
26143,UD52B80,4,-1048.0,2,2,3090.0,2042.0
26144,U8188A3,4,18.019999999999982,2,2,7915.0,7933.02
26145,UA57D10,4,-1620.94,4,0,1620.94,0.0
26146,UEFAC32,4,0.0,2,2,8000.0,8000.0
26147,U346908,4,-5.970000000000001,2,2,6.0,0.03
26148,U9B4DC3,4,28.039999999999964,3,1,618.0,646.04
26149,U66D7B9,4,-6490.0,4,0,6490.0,0.0
26150,U4A8F5F,4,0.0,2,2,10.0,10.0
26151,U27725C,4,-2762.99,4,0,2762.99,0.0
26152,UBC12ED,4,-1762.5200000000002,4,0,1762.5200000000002,0.0
26153,U2F0556,4,344.70000000000005,2,2,9008.0,9352.7
26154,UA04E96,4,-3389.0,1,3,3700.0,311.0
26155,UA709D0,4,0.0,2,2,8000.0,8000.0
26156,U9809A3,4,345.11,1,3,14.07,359.18
26157,U64E974,4,-2.0199999999999996,4,0,2.0199999999999996,0.0
26158,U7E78B2,4,1742.7400000000002,3,1,1257.2599999999998,3000.0
26159,UC2929C,4,7496.76,2,2,175.5,7672.26
26160,U70D400,4,-0.09999999999999432,2,2,89.6,89.5
26161,UEC3FEE,4,-7.105427357601002e-15,2,2,149.9,149.9
26162,U79C93B,4,1165.0,1,3,500.0,1665.0
26163,UD65B30,4,8100.99,1,3,611.01,8712.0
26164,U8F1B2A,4,0.0,2,2,26000.0,26000.0
26165,U52F453,4,0.0,2,2,4099.7,4099.7
26166,U9ED859,4,-1353.9399999999998,4,0,1353.9399999999998,0.0
26167,U8850F0,4,0.0,2,2,9151.0,9151.0
26168,U70F1DD,4,1193.4199999999998,1,3,1500.0,2693.42
26169,UCFE3FB,4,-449.69,4,0,449.69,0.0
26170,U010374,4,0.0,3,1,969.0,969.0
26171,U05CA3C,4,0.0,2,2,10.0,10.0
26172,UCCAEB0,4,0.0,2,2,10.0,10.0
26173,U25478B,4,0.0,2,2,6000.0,6000.0
26174,U9B629A,4,-2006.9299999999998,2,2,3207.84,1200.91
26175,U873A20,4,3543.0,0,4,0.0,3543.0
26176,U03E08E,4,1100.0,2,2,8100.0,9200.0
26177,U03CB47,4,390.0,2,2,10.0,400.0
26178,UAABBBE,4,-400.0,3,1,566.0,166.0
26179,U28DD8A,4,29.900000000000006,3,1,4470.1,4500.0
26180,U56866F,4,0.0,2,2,41.5,41.5
26181,UAEF734,4,-738.8599999999999,4,0,738.8599999999999,0.0
26182,U8F76ED,4,-7080.0,4,0,7080.0,0.0
26183,U0C9515,4,0.0,2,2,20000.0,20000.0
26184,UFDD2A8,4,0.0,2,2,10.0,10.0
26185,U3B5D18,4,-3998.0,2,2,13996.0,9998.0
26186,UC06F12,4,3980.7,2,2,20.0,4000.7
26187,U15FF38,4,2.0,2,2,873.0,875.0
26188,U0B1215,4,-5086.66,4,0,5086.66,0.0
26189,UBAE372,4,-503.62,4,0,503.62,0.0
26190,U6BCB2D,4,-3158.48,4,0,3158.48,0.0
26191,U5C8801,4,-3930.0,3,1,4730.0,800.0
26192,U34D26E,4,-59.94,3,1,64.94,5.0
26193,UEC3F14,4,-399.16,3,1,399.23,0.07
26194,U332397,4,0.0,2,2,159.66,159.66
26195,U53C0A6,4,-2114.34,4,0,2114.34,0.0
26196,U2A373A,4,-400.5,3,1,800.5,400.0
26197,U9DF4D2,4,-6364.46,1,3,10000.0,3635.54
26198,UF63651,4,90.0,2,2,573.9,663.9
26199,U2C6E65,4,-3482.1800000000003,4,0,3482.1800000000003,0.0
26200,UF30E4D,4,490.27,2,2,210.0,700.27
26201,UCAD6E6,4,-12950.4,4,0,12950.4,0.0
26202,UB32A6D,4,-299.94,2,2,374.58,74.64
26203,UEE5A71,4,243.09,1,3,0.33,243.42000000000002
26204,UF0A8B0,4,0.0,2,2,10.0,10.0
26205,U59FC88,4,-542.04,4,0,542.04,0.0
26206,U329463,4,1800.0,1,3,100.0,1900.0
26207,UEEE1D7,4,9.2,2,2,19.2,28.4
26208,U6904C5,4,580.8399999999999,2,2,10.0,590.8399999999999
26209,U2D7861,4,-247.48999999999998,3,1,252.6,5.11
26210,UDFB542,4,-267.28000000000003,2,2,567.3,300.02
26211,U5FFB79,4,360.8099999999995,2,2,8645.0,9005.81
26212,UC7817A,4,412.0,2,2,110.0,522.0
26213,UAA63FF,4,3989.01,2,2,11.0,4000.01
26214,UB23400,4,-4064.33,3,1,4264.33,200.0
26215,UD66E9A,4,-487.78,4,0,487.78,0.0
26216,U927490,4,-458.3,4,0,458.3,0.0
26217,UBBE2E9,4,229.29999999999995,1,3,1580.0,1809.3
26218,U420809,4,28807.47,0,4,0.0,28807.47
26219,U2161A1,4,-20.0,4,0,20.0,0.0
26220,U66C1CE,4,-733.3000000000001,4,0,733.3000000000001,0.0
26221,U9F7525,4,85.01999999999998,3,1,275.98,361.0
26222,UD64DC0,4,-50.0,2,2,5900.0,5850.0
26223,UCA24F7,4,-183.7,4,0,183.7,0.0
26224,U636096,4,-590.0,4,0,590.0,0.0
26225,U5D8C77,4,414.75000000000006,2,2,310.88,725.6300000000001
26226,U0DF2C7,4,0.0,2,2,6000.0,6000.0
26227,UFA62F2,4,-4916.66,4,0,4916.66,0.0
26228,U5059C0,4,-1669.99,1,3,2518.0,848.01
26229,UD7869F,4,4.120000000000346,2,2,6000.0,6004.120000000001
26230,UBD5D56,4,-10.0,3,1,62.98,52.98
26231,UE8FC3C,4,1112.0,2,2,8260.0,9372.0
26232,U5CC36D,4,167.0,1,3,161.5,328.5
26233,U8A01CA,4,-634.0,2,2,7500.0,6866.0
26234,U3370DD,4,-11097.0,4,0,11097.0,0.0
26235,UBA9EA7,4,0.0,2,2,323.0,323.0
26236,U9ECF5A,4,-599.52,4,0,599.52,0.0
26237,U1AEE05,4,12240.0,0,4,0.0,12240.0
26238,U7CC608,4,-1.02,4,0,1.02,0.0
26239,UFB6DFE,4,-3389.2799999999997,4,0,3389.2799999999997,0.0
26240,UE80219,4,0.01999999999999602,2,2,57.66,57.68
26241,UFA91F1,4,-439.57,3,1,439.84999999999997,0.28
26242,U352765,4,-23.35,4,0,23.35,0.0
26243,U440810,4,-1079.1999999999998,4,0,1079.1999999999998,0.0
26244,UC7699D,4,0.99,2,2,3200.01,3201.0
26245,UF9D362,4,-1782.74,3,1,1783.74,1.0
26246,U0B166A,4,848.1600000000035,2,2,520000.0,520848.16
26247,U4701A6,4,-0.15999999999996817,2,2,982.16,982.0
26248,U263C33,4,-28141.489999999998,4,0,28141.489999999998,0.0
26249,U888162,4,10.0,2,2,54.91,64.91
26250,U388EDD,4,-4033.0800000000004,4,0,4033.0800000000004,0.0
26251,U833385,4,97.0,3,1,7873.0,7970.0
26252,UF81FAA,4,-771.68,4,0,771.68,0.0
26253,UE92197,4,2975.0,0,4,0.0,2975.0
26254,U06B0F0,4,0.0,2,2,20000.0,20000.0
26255,U19BF4E,4,2.1599999999999966,2,2,103.84,106.0
26256,U95FF33,4,-1137.42,4,0,1137.42,0.0
26257,U71BFD0,4,-33005.0,3,1,33010.0,5.0
26258,U988A6F,4,0.0,2,2,3470.0,3470.0
26259,U7F2DC5,4,-8.0,2,2,10777.0,10769.0
26260,UEE1AB1,4,200.0,3,1,1300.0,1500.0
26261,U9CDE2C,4,2996.7200000000003,2,2,2865.28,5862.0
26262,U7C3176,4,869.96,1,3,10.0,879.96
26263,U8896BC,4,-1065.67,4,0,1065.67,0.0
26264,U75E2F1,4,-409.0,3,1,609.0,200.0
26265,U69961A,4,0.0,2,2,10.0,10.0
26266,U45C120,4,-14.35,2,2,20014.36,20000.01
26267,U99870E,4,335.29999999999995,2,2,366.0,701.3
26268,U69D5EA,4,-996.3899999999994,2,2,9999.5,9003.11
26269,UCF6E14,4,2000.49,2,2,1999.51,4000.0
26270,U5F1C13,4,0.1600000000000108,2,2,129.8,129.96
26271,U38C7CA,4,771.84,2,2,6.0,777.84
26272,UE61F03,4,-168.0,3,1,188.0,20.0
26273,U89488F,4,2471.3,1,3,2.0,2473.3
26274,U73C936,4,4916.67,2,2,4916.59,9833.26
26275,U05BA64,4,2497.02,2,2,4518.98,7016.0
26276,U8557E9,4,-42907.77,2,2,42969.259999999995,61.49
26277,U9123C8,4,0.0,1,3,500.0,500.0
26278,U414CD1,4,61.0,2,2,338.97,399.97
26279,UF4EEB6,4,90.0,3,1,810.0,900.0
26280,U751E14,4,-161.21,3,1,161.5,0.29
26281,U2AF88A,4,0.0,2,2,58.01,58.01
26282,UEBC69A,4,104.0,2,2,646.0,750.0
26283,U8F9055,4,3095.0,1,3,1000.0,4095.0
26284,U1558B8,4,253.33000000000004,2,2,161.11,414.44000000000005
26285,U3F5415,4,15276.13,0,4,0.0,15276.13
26286,U45D96A,4,-25426.81,3,1,43250.0,17823.19
26287,U3C994D,4,55800.04,0,4,0.0,55800.04
26288,U1769B2,4,32.6,3,1,60.4,93.0
26289,U430C7F,4,5691.0,2,2,20330.0,26021.0
26290,UDDDA53,4,-9997.98,2,2,21998.0,12000.02
26291,UB9BED0,4,462.02,2,2,625.0,1087.02
26292,UBB44E7,4,-5499.75,2,2,13392.0,7892.25
26293,U73D336,4,-33969.3,3,1,34000.0,30.7
26294,U5B9F93,4,-500.0,3,1,721.0,221.0
26295,UAF3966,4,320.0,3,1,1380.0,1700.0
26296,U4091E2,4,-7.969999999999999,2,2,10.0,2.03
26297,UC9A838,4,-30.0,3,1,125.0,95.0
26298,U24E885,4,0.0,3,1,460.81,460.81
26299,UA5C210,4,0.0,2,2,15000.0,15000.0
26300,UD25FAF,4,65197.14,0,4,0.0,65197.14
26301,U7FD4A6,4,-885.0,4,0,885.0,0.0
26302,UA62051,4,1500.0,2,2,1500.13,3000.13
26303,U427BFA,4,0.0,2,2,10907.0,10907.0
26304,U3712AD,4,-162.54000000000002,2,2,378.39,215.84999999999997
26305,U05C8DA,4,3699.829999999999,2,2,3699.8500000000004,7399.68
26306,U257419,4,765.6999999999998,2,2,11803.3,12569.0
26307,U1C42B8,4,7426.0,1,3,22347.0,29773.0
26308,UFD1691,4,-125.69999999999999,2,2,330.7,205.0
26309,U13AB84,4,-82.41999999999999,4,0,82.41999999999999,0.0
26310,U3352C1,4,1.5987211554602254e-14,2,2,501.08,501.08
26311,U5DDB31,4,-280.0,2,2,808.0,528.0
26312,U6BE04A,4,6.0,2,2,15994.0,16000.0
26313,U724D10,4,-2206.16,4,0,2206.16,0.0
26314,UAAC788,4,-9561.67,4,0,9561.67,0.0
26315,U7C2C46,4,-605.02,2,2,898.0,292.98
26316,U7F4E56,4,-2065.0,4,0,2065.0,0.0
26317,U2C6E37,4,-1530.0,2,2,7560.0,6030.0
26318,UA04319,4,-0.6700000000000728,2,2,10089.0,10088.33
26319,U09BEF9,4,90.67000000000007,2,2,2048.0,2138.67
26320,UF1D5E3,4,-950.35,3,1,950.38,0.03
26321,UFF0C62,4,400.0,0,4,0.0,400.0
26322,U19E871,4,15513.63,2,2,1998.0,17511.629999999997
26323,U9A2B78,4,-2990.0,3,1,5790.0,2800.0
26324,U6256ED,4,0.0,2,2,20000.0,20000.0
26325,U77BAF4,4,34400.0,2,2,23980.0,58380.0
26326,U49F125,4,-1.8900000000000001,2,2,2.0,0.11
26327,U436A18,4,-143.38999999999987,2,2,1732.0,1588.61
26328,U015AB6,4,1000.0,2,2,12973.0,13973.0
26329,UFB3D9A,4,94.04,2,2,6.0,100.04
26330,U07967E,4,-3846.8599999999997,3,1,4188.86,342.0
26331,UD3CC2E,4,-596.0,2,2,4246.0,3650.0
26332,U2C4E95,4,37.0,2,2,5963.0,6000.0
26333,UC8D029,4,217.0,1,3,108.9,325.90000000000003
26334,U0B5E67,4,-1216.0,2,2,20216.0,19000.0
26335,U1489F4,4,-16.0,3,1,516.0,500.0
26336,U031A74,4,3812.0,1,3,1088.0,4900.0
26337,UCD1A34,4,-1816.66,4,0,1816.66,0.0
26338,U52A1D9,4,0.0,2,2,109.11,109.11
26339,U2A535A,4,249.0,2,2,1951.0,2200.0
26340,UDFCE1F,4,800.0,2,2,6000.0,6800.0
26341,UBEC5FB,4,-553.24,4,0,553.24,0.0
26342,U6A0A1F,4,6882.59,0,4,0.0,6882.59
26343,U13189C,4,105.05999999999996,1,3,1864.0,1969.06
26344,UD9AD3E,4,1680.66,1,3,1674.94,3355.6
26345,U08044D,4,18.25,1,3,12.9,31.15
26346,UABDF6C,4,114.3599999999999,3,1,1459.01,1573.37
26347,U37A4AA,4,-268.49,2,2,823.0,554.51
26348,U8237D6,4,0.0,2,2,10000.0,10000.0
26349,UF75D1D,4,-11908.880000000001,4,0,11908.880000000001,0.0
26350,UBFA824,4,-39516.12,1,3,40000.0,483.88
26351,U9DC7F5,4,0.00999999999476131,1,3,128000.0,128000.01
26352,UFB8899,4,-69.80000000000001,4,0,69.80000000000001,0.0
26353,UAC215C,4,0.0,2,2,8000.0,8000.0
26354,UD15592,4,-879.06,4,0,879.06,0.0
26355,UD0EA35,4,688.8599999999999,3,1,687.0,1375.86
26356,UB518CE,4,-1984.16,2,2,2386.0,401.84
26357,UB96855,4,-988.6600000000003,2,2,5988.66,5000.0
26358,U0CFB11,4,0.0,2,2,19050.0,19050.0
26359,UC77269,4,-8.96,3,1,9.0,0.04
26360,U6A7A38,4,-1233.8999999999999,4,0,1233.8999999999999,0.0
26361,U41536A,4,-5449.38,4,0,5449.38,0.0
26362,U798259,4,-2908.87,4,0,2908.87,0.0
26363,U44BC11,4,5990.05,2,2,10.0,6000.05
26364,U94C8E9,4,-133.0,2,2,188.0,55.0
26365,U626172,4,2650.0,3,1,595.6,3245.6
26366,UD584BE,4,-6999.400000000001,3,1,7049.400000000001,50.0
26367,U9AD489,4,2.01,2,2,15070.0,15072.01
26368,U2ADB5A,4,14.899999999999977,2,2,985.01,999.91
26369,U994E6E,4,6217.34,2,2,2122.66,8340.0
26370,U0763BF,4,-3172.84,4,0,3172.84,0.0
26371,UC16FEC,4,-1.4210854715202004e-14,2,2,273.78000000000003,273.78
26372,UD221B8,4,2295.8599999999997,2,2,1543.75,3839.6099999999997
26373,UC0A586,4,0.0,3,1,8.0,8.0
26374,U827359,4,-2.100000000000364,2,2,5265.0,5262.9
26375,UCACFBD,4,0.0,2,2,10.0,10.0
26376,UD156D7,4,-17611.44,2,2,17844.44,233.0
26377,U0877F5,4,124.0,2,2,59740.0,59864.0
26378,UC8B81D,4,0.0,2,2,10.0,10.0
26379,UEE9CA9,4,-5.78,2,2,6.0,0.22
26380,U6C9E65,4,-39.79,3,1,39.9,0.11
26381,UD02918,4,0.0,2,2,8000.0,8000.0
26382,U8FF9ED,4,-2626.3999999999996,4,0,2626.3999999999996,0.0
26383,U4CD9D5,4,-0.08000000000000007,2,2,2.0,1.92
26384,UF969DE,4,-4000.01,3,1,4000.11,0.1
26385,U2B45A5,4,112.61000000000001,2,2,99.7,212.31
26386,U9FB938,4,-2180.0,4,0,2180.0,0.0
26387,U4DE4F3,4,7969.0,2,2,6808.0,14777.0
26388,UE4805F,4,2950.0,2,2,2980.0,5930.0
26389,UA8E549,4,2133.8300000000004,2,2,1871.97,4005.8
26390,UF997D2,4,1050.0,0,4,0.0,1050.0
26391,U6E75C8,4,-9000.0,3,1,17700.0,8700.0
26392,U62F64E,4,-2439.42,4,0,2439.42,0.0
26393,UE76E75,4,-6300.0,2,2,14000.0,7700.0
26394,U4E9F94,4,-387.79999999999995,4,0,387.79999999999995,0.0
26395,UD7ACD3,4,-182.0,2,2,353.0,171.0
26396,UE8C06A,4,-470.74,3,1,471.07,0.33
26397,U658166,4,-845.18,3,1,845.9699999999999,0.79
26398,U0AFB8F,4,19718.22,2,2,10100.0,29818.22
26399,UDD2546,4,137.90999999999997,1,3,662.0,799.91
26400,U50E3F5,4,0.09999999999999953,2,2,4.39,4.489999999999999
26401,U83B369,4,1552.01,1,3,5366.0,6918.01
26402,U9FA4C4,4,-708.76,4,0,708.76,0.0
26403,U74C5CA,4,-290.0,3,1,640.0,350.0
26404,U347F0D,4,9517.46,1,3,500.0,10017.46
26405,UC19F1B,4,2108.0,3,1,5847.0,7955.0
26406,U732283,4,4.1000000000000005,1,3,0.01,4.11
26407,UC58434,4,1332.1200000000001,3,1,897.47,2229.59
26408,UBEFDF0,4,-3504.0,2,2,4049.0,545.0
26409,UE2C6EF,4,-34.0,3,1,4009.0,3975.0
26410,UBB65EB,4,756.8499999999999,2,2,1253.8500000000001,2010.7000000000003
26411,U984700,4,100.91,1,3,0.91,101.82
26412,U79CD78,4,2100.0,0,4,0.0,2100.0
26413,UD908E9,4,11.739999999999995,2,2,99.0,110.74
26414,U7BD3AE,4,9607.27,0,4,0.0,9607.27
26415,U5962C7,4,-2270.83,3,1,22685.83,20415.0
26416,UC28A38,4,1101.0,0,4,0.0,1101.0
26417,U726C7C,4,-872.4000000000001,4,0,872.4000000000001,0.0
26418,U46E3D8,4,602.21,2,2,10.0,612.21
26419,U5581C3,4,3890.0,2,2,10.0,3900.0
26420,U04740A,4,-1792.78,2,2,1794.78,2.0
26421,U8FBDB0,4,-202.0,2,2,10192.0,9990.0
26422,UFF60F7,4,0.0,2,2,0.02,0.02
26423,U714E3A,4,-539.6,4,0,539.6,0.0
26424,U3F2985,4,-2780.74,4,0,2780.74,0.0
26425,U9F26AA,4,-50.85000000000001,2,2,168.63,117.78
26426,UF31E6B,4,1.0,2,2,7999.0,8000.0
26427,UA961EA,4,-27.0,2,2,47027.0,47000.0
26428,U84628A,4,-310.0,2,2,5940.0,5630.0
26429,U20D8BE,4,12825.02,2,2,20319.98,33145.0
26430,U37A3BE,4,-457.99999999999983,3,1,3258.0,2800.0
26431,U7F5963,4,692.0,3,1,908.0,1600.0
26432,U323CFD,4,-328.0,3,1,387.0,59.0
26433,U87A3F5,4,88.79999999999998,2,2,40.03,128.82999999999998
26434,UA65D64,4,-7179.7,2,2,7194.7,15.0
26435,UDFD6A2,4,-34.3,3,1,84.3,50.0
26436,UA55AB0,4,0.0,2,2,10.0,10.0
26437,U1EC99A,4,8.980000000000018,2,2,5873.0,5881.98
26438,UA98876,4,649.12,2,2,6.0,655.12
26439,U24504A,4,0.0,2,2,150.0,150.0
26440,U066D42,4,0.8999999999999773,3,1,299.1,300.0
26441,UB6721D,4,2570.12,2,2,4000.0,6570.12
26442,U8B6C3D,4,-1771.68,4,0,1771.68,0.0
26443,U498273,4,-871.06,2,2,1971.06,1100.0
26444,UF87B1A,4,-7600.0,2,2,9600.34,2000.34
26445,UCAC950,4,-3500.0,3,1,5470.0,1970.0
26446,U180F07,4,99.80999999999995,2,2,3318.0,3417.81
26447,U3C8A19,4,3100.04,0,4,0.0,3100.04
26448,UE1383E,4,-10.0,3,1,20.0,10.0
26449,U96DE62,4,40.0,2,2,5960.0,6000.0
26450,UF6736F,4,271.0,2,2,32.78,303.78
26451,UDF3176,4,5854.52,2,2,10.0,5864.52
26452,UD00AE1,4,1494.0,2,2,11626.0,13120.0
26453,U9C137E,4,-201.18,4,0,201.18,0.0
26454,UD0B839,4,20.08,1,3,53.7,73.78
26455,U5FCA98,4,273.0,2,2,2920.0,3193.0
26456,U1BA97A,4,0.0,2,2,80.0,80.0
26457,U286AFC,4,4682.889999999999,1,3,3320.0,8002.889999999999
26458,UE91C51,4,119.14999999999998,2,2,919.1500000000001,1038.3000000000002
26459,U3665CC,4,1709.82,2,2,25.18,1735.0
26460,U60E548,4,1714.7,2,2,10.0,1724.7
26461,U72AA11,4,-4117.35,2,2,5126.66,1009.31
26462,U72CC5A,4,-134.88000000000102,2,2,25100.0,24965.12
26463,U8D97E6,4,-1200.0,2,2,7000.0,5800.0
26464,U3A93E7,4,-78.94,4,0,78.94,0.0
26465,U97C706,4,1483.0,2,2,117.0,1600.0
26466,UBE19CE,4,2899.34,1,3,1999.0,4898.34
26467,U90CD9F,4,-1760.94,4,0,1760.94,0.0
26468,U9A3646,4,2325.0,2,2,6340.0,8665.0
26469,UE25279,4,488.0,2,2,10.0,498.0
26470,U89DC25,4,-539.5999999999999,4,0,539.5999999999999,0.0
26471,UE0B948,4,13.67,3,1,86.33,100.0
26472,U60D6B4,4,440.0,2,2,10.0,450.0
26473,UEDBCA5,4,-2317.16,1,3,5000.0,2682.84
26474,UF6C396,4,-9934.4,3,1,10000.0,65.6
26475,U1010D4,4,0.31999999999993634,2,2,2224.0,2224.32
26476,U8B32A9,4,3819.02,2,2,725.0,4544.02
26477,UF1F477,4,512.87,1,3,65.15,578.02
26478,UC507BB,4,-1221.9399999999998,4,0,1221.9399999999998,0.0
26479,U48DB98,4,-1864.8,4,0,1864.8,0.0
26480,UDE41D8,4,-1959.0,3,1,2188.0,229.0
26481,U462324,4,1000.0,2,2,5000.0,6000.0
26482,UAEEB0A,4,0.0,2,2,6000.0,6000.0
26483,UBBE9BA,4,3017.4700000000003,2,2,3979.0,6996.47
26484,U46C094,4,0.0,2,2,10.0,10.0
26485,U696638,4,1579.0,2,2,660.0,2239.0
26486,UAE10DC,4,175.0,2,2,4930.0,5105.0
26487,UF85920,4,-7050.0,3,1,13050.0,6000.0
26488,U95EAFC,4,-57.0,4,0,57.0,0.0
26489,UE43698,4,-1.94,2,2,2.0,0.060000000000000005
26490,U6D214B,4,-4189.65,2,2,14000.0,9810.35
26491,U4A5B1C,4,3475.1800000000003,1,3,183.3,3658.48
26492,U4026F8,4,-365.72,4,0,365.72,0.0
26493,UFC0E21,4,-2159.58,4,0,2159.58,0.0
26494,U5921E8,4,0.0,2,2,15908.0,15908.0
26495,U02AE9D,4,2375.54,1,3,24.9,2400.44
26496,U9C6A51,4,-19028.81,4,0,19028.81,0.0
26497,U0935FF,4,-5629.9,2,2,5659.9,30.0
26498,UF3C577,4,0.0,2,2,10.0,10.0
26499,UCBDB8A,4,-1880.0600000000004,2,2,8000.0,6119.94
26500,U142667,4,590.0,2,2,10.0,600.0
26501,U83F22F,4,78.0,2,2,37505.0,37583.0
26502,UD7AEC4,4,6492.0,2,2,3508.0,10000.0
26503,U58F02F,4,-352.14,4,0,352.14,0.0
26504,U27CEB7,4,0.0,2,2,88.71,88.71
26505,UED9F35,4,-2950.0,4,0,2950.0,0.0
26506,U43B1B1,4,-16188.0,4,0,16188.0,0.0
26507,U46C1B2,4,700.0,2,2,9300.0,10000.0
26508,U7F70C1,4,0.0,2,2,10.0,10.0
26509,UDE9669,4,-346.0,4,0,346.0,0.0
26510,U414B5B,4,-2485.0,2,2,3205.0,720.0
26511,UD98B31,3,3.61,1,2,15.0,18.61
26512,UF4C735,3,-4008.0,3,0,4008.0,0.0
26513,U50E762,3,2485.0,1,2,2525.0,5010.0
26514,U0DEE1A,3,-600.0,3,0,600.0,0.0
26515,UC79817,3,-299.1,3,0,299.1,0.0
26516,UA2957D,3,357.7,1,2,2.3,360.0
26517,U16BC52,3,2825.0,2,1,2029.0,4854.0
26518,UABC749,3,0.01,1,2,0.01,0.02
26519,UE52030,3,3540.61,0,3,0.0,3540.61
26520,U7EC063,3,-1871.12,3,0,1871.12,0.0
26521,U7BD0C8,3,7139.0,0,3,0.0,7139.0
26522,UAAB7EC,3,21.039999999999974,1,2,304.54,325.58
26523,U4541DB,3,701.1,1,2,69.9,771.0
26524,U796AB7,3,490.0,2,1,10.0,500.0
26525,UDC74E0,3,-49.0,3,0,49.0,0.0
26526,U84C8F7,3,-18.34,2,1,20.0,1.66
26527,UBD34C0,3,-419.72,1,2,1888.0,1468.28
26528,UC18E3E,3,6.23,2,1,10.0,16.23
26529,UF5EA86,3,9582.0,1,2,418.0,10000.0
26530,UF39A32,3,4456.0199999999995,0,3,0.0,4456.0199999999995
26531,U471F25,3,-9600.0,2,1,18950.0,9350.0
26532,U608FB4,3,-68.93,2,1,69.0,0.07
26533,UC336D0,3,-1.99,2,1,2.0,0.01
26534,UFBBA3D,3,35.0,1,2,199.0,234.0
26535,UFF6731,3,-5.0,2,1,10.0,5.0
26536,U863E5B,3,8564.81,1,2,316.0,8880.81
26537,UDE6246,3,-394.79,2,1,494.79,100.0
26538,U20A771,3,-6.3,2,1,10.0,3.7
26539,U698F5F,3,-12916.04,3,0,12916.04,0.0
26540,U8A3C3F,3,0.0,1,2,30000.0,30000.0
26541,UBE9A77,3,-5870.0,3,0,5870.0,0.0
26542,U170B79,3,0.98,2,1,0.02,1.0
26543,UBB2CC5,3,0.009999999999999787,1,2,15.82,15.83
26544,U4C8064,3,0.03,0,3,0.0,0.03
26545,UEF8958,3,1.6399999999999864,1,2,443.37,445.01
26546,UE53784,3,-865.0,3,0,865.0,0.0
26547,UC42E7E,3,1990.9799999999996,1,2,4205.0,6195.98
26548,UAD48D0,3,-283.03000000000003,3,0,283.03000000000003,0.0
26549,UDB3074,3,0.01,1,2,0.01,0.02
26550,UEE8D7B,3,219.04,2,1,219.04,438.08
26551,U5E3260,3,300.1,1,2,99.9,400.0
26552,U2B1C2E,3,249.0,2,1,1051.0,1300.0
26553,UA340A0,3,-17.59,2,1,20.0,2.41
26554,U86F39A,3,-1.300000000000182,1,2,1411.9,1410.6
26555,UC316B3,3,400.0,2,1,2000.0,2400.0
26556,UECB3D8,3,-940.0,3,0,940.0,0.0
26557,UFC8B77,3,-242.03999999999996,1,2,808.8,566.76
26558,UC80530,3,878.0,1,2,99.0,977.0
26559,U39F102,3,-10.000000000000007,2,1,59.980000000000004,49.98
26560,UFD4113,3,1579.67,2,1,3670.33,5250.0
26561,UAA881A,3,-19.89,2,1,20.0,0.11
26562,U051B52,3,-1.97,2,1,2.0,0.03
26563,U9809DD,3,-6800.0,3,0,6800.0,0.0
26564,U0EE809,3,-21.0,2,1,43.4,22.4
26565,U6876A8,3,0.15000000000025465,1,2,7191.03,7191.18
26566,U29F130,3,3.0300000000002,2,1,3486.5,3489.53
26567,UD5BEBE,3,0.010000000000000009,1,2,1304.36,1304.37
26568,UFA8A4E,3,2053.3999999999996,0,3,0.0,2053.3999999999996
26569,U9A25DA,3,5700.0,0,3,0.0,5700.0
26570,U675141,3,0.0,1,2,10174.99,10174.99
26571,UCA9503,3,-7145.0,3,0,7145.0,0.0
26572,U75F7C7,3,7.939999999999998,1,2,502.06,510.0
26573,UD5CCBC,3,-50.0,2,1,100.0,50.0
26574,U89E059,3,443.0,0,3,0.0,443.0
26575,U6B4AC6,3,-2904.48,3,0,2904.48,0.0
26576,UDC7D6B,3,10261.17,0,3,0.0,10261.17
26577,UE1F774,3,119.99,1,2,0.01,120.0
26578,UC40661,3,-55.0,3,0,55.0,0.0
26579,U6B4479,3,-17.14,2,1,20.0,2.86
26580,U33DE05,3,0.01,1,2,120.0,120.01
26581,U72D22A,3,4748.540000000001,0,3,0.0,4748.540000000001
26582,U1AD16D,3,4998.1,1,2,4999.9,9998.0
26583,UE7618A,3,288.0,1,2,812.0,1100.0
26584,U359512,3,189.0,1,2,17.0,206.0
26585,UC8054E,3,-18.0,2,1,30.0,12.0
26586,U1349E0,3,-0.6499999999996362,2,1,2988.43,2987.78
26587,UE16374,3,157.15999999999988,2,1,1436.96,1594.12
26588,U1C91A6,3,-5.0,2,1,10.0,5.0
26589,U9B1A97,3,-260.0,3,0,260.0,0.0
26590,U25EB60,3,0.01999999999998181,1,2,300.0,300.02
26591,U3E1BF8,3,1535.0,1,2,4365.0,5900.0
26592,U04A32E,3,2450.0,1,2,200.0,2650.0
26593,U423773,3,0.7000000000007276,2,1,9080.3,9081.0
26594,U0641A1,3,-19.310000000000002,2,1,20.0,0.69
26595,UA87D03,3,-209.72,3,0,209.72,0.0
26596,UB98CAF,3,7369.92,0,3,0.0,7369.92
26597,UCAE754,3,0.31,1,2,9200.0,9200.31
26598,UE2654B,3,-44.0,3,0,44.0,0.0
26599,U457572,3,-0.4500000000000002,2,1,6.0,5.55
26600,UD3B184,3,0.03,0,3,0.0,0.03
26601,U253221,3,6150.0,1,2,120.0,6270.0
26602,UA809E0,3,3810.0,1,2,3885.0,7695.0
26603,UFB2749,3,1100.0,0,3,0.0,1100.0
26604,U8F477F,3,-95.46000000000001,3,0,95.46000000000001,0.0
26605,UEC78BA,3,31.010000000000005,1,2,69.02,100.03
26606,U2892CF,3,-10001.0,2,1,15051.0,5050.0
26607,U2DDD32,3,-5.970000000000001,2,1,6.0,0.03
26608,U563EF6,3,3999.0,1,2,4000.0,7999.0
26609,U7CC73F,3,115.3,1,2,15.0,130.3
26610,U6D7598,3,50037.53,1,2,50000.0,100037.53
26611,U13DDF5,3,-1.97,2,1,2.0,0.03
26612,UE41CC0,3,2911.0,0,3,0.0,2911.0
26613,UD8E07D,3,-166.07,1,2,190.54,24.47
26614,UE1D0F9,3,1522.0,2,1,4008.0,5530.0
26615,U07FFB2,3,4581.98,1,2,276.0,4857.98
26616,UBA40AA,3,-171.7,3,0,171.7,0.0
26617,UDC6A86,3,-800.0,1,2,3000.0,2200.0
26618,U273480,3,1486.5,0,3,0.0,1486.5
26619,U358EB1,3,0.0,2,1,2961.0,2961.0
26620,U163955,3,359.51,2,1,204.58,564.09
26621,U67331E,3,40.0,2,1,10.0,50.0
26622,U08600F,3,-418.7,2,1,506.7,88.0
26623,U3FDE51,3,1400.01,0,3,0.0,1400.01
26624,U3B4743,3,895.0,1,2,1011.0,1906.0
26625,UC29264,3,750.0,0,3,0.0,750.0
26626,UBA98D3,3,0.0,2,1,1338.0,1338.0
26627,U5E319D,3,175.0,1,2,300.0,475.0
26628,UD35BC5,3,169.2,1,2,99.8,269.0
26629,UAA47B2,3,271.0,0,3,0.0,271.0
26630,U14E86C,3,-1.95,2,1,2.0,0.05
26631,U98ED69,3,284.8,0,3,0.0,284.8
26632,U31C122,3,0.0,2,1,9286.8,9286.8
26633,U8F4FEB,3,466.60999999999996,1,2,380.0,846.6099999999999
26634,UFB6706,3,47438.22,1,2,10000.0,57438.22
26635,U3A6EFE,3,-5.0,2,1,10.0,5.0
26636,U478E3F,3,-981.9100000000001,2,1,982.69,0.78
26637,UB85922,3,802.93,1,2,200.0,1002.93
26638,UA0A511,3,500.0,1,2,4.36,504.36
26639,U8331E8,3,-622.0,3,0,622.0,0.0
26640,UF20610,3,-5050.0,2,1,10050.0,5000.0
26641,UD8B07C,3,110.0,0,3,0.0,110.0
26642,U0F704F,3,-494.0,3,0,494.0,0.0
26643,UF37731,3,-75.74,2,1,80.0,4.26
26644,U2E51C7,3,200.1,0,3,0.0,200.1
26645,UCD251B,3,0.0,2,1,10.0,10.0
26646,UC60A13,3,-0.6199999999998909,2,1,1800.62,1800.0
26647,UF5908A,3,0.010000000000218279,1,2,4000.0,4000.01
26648,U1AB4C7,3,-320.02,2,1,320.38,0.36
26649,UC32766,3,1323.8,0,3,0.0,1323.8
26650,U15B2B2,3,25.0,1,2,22.0,47.0
26651,UC495C9,3,6955.0,1,2,688.0,7643.0
26652,UE3ED57,3,1957.9899999999998,1,2,700.0,2657.99
26653,U4D93EF,3,90.0,2,1,10.0,100.0
26654,U7C4D9A,3,11415.91,0,3,0.0,11415.91
26655,U8313D3,3,-8.82,1,2,45.94,37.12
26656,UC1DAF4,3,1970.5,2,1,13029.5,15000.0
26657,U690F2C,3,1259.42,2,1,1240.58,2500.0
26658,U72A79C,3,-484.96000000000004,1,2,684.96,200.0
26659,U7BFA16,3,-725.49,2,1,726.0,0.51
26660,U881B68,3,30.0,0,3,0.0,30.0
26661,U7CD163,3,32.0,2,1,968.0,1000.0
26662,UABE1B8,3,1288.43,1,2,321.57,1610.0
26663,U37253F,3,-145.3,2,1,145.43,0.13
26664,U65A28F,3,-1536.0,2,1,3072.0,1536.0
26665,UFAC2C6,3,2275.0,1,2,750.0,3025.0
26666,UE16F96,3,0.0,2,1,59.0,59.0
26667,UF2C358,3,0.1699999999999875,1,2,156.0,156.17
26668,U441931,3,-779.0,1,2,2032.0,1253.0
26669,UDF5A22,3,30.0,1,2,0.08,30.08
26670,UF3D7A8,3,-15.77,2,1,20.0,4.23
26671,U6ABC81,3,50.05,0,3,0.0,50.05
26672,UBB75B1,3,-6999.0,2,1,16599.0,9600.0
26673,U4816B4,3,-2998.0,2,1,5997.0,2999.0
26674,UD6F07D,3,-724.92,2,1,1064.92,340.0
26675,U343609,3,-101.27,2,1,131.27,30.0
26676,U81FF87,3,130.0,1,2,11870.0,12000.0
26677,U70406B,3,17500.0,0,3,0.0,17500.0
26678,U8785A0,3,-0.51,3,0,0.51,0.0
26679,UFED864,3,177.0,1,2,149.0,326.0
26680,U0CB2D0,3,6850.15,0,3,0.0,6850.15
26681,U6DCE0A,3,-1.96,2,1,2.0,0.04
26682,UB9AB95,3,8.99,2,1,1.01,10.0
26683,UE5F56F,3,-2000.0,2,1,6000.0,4000.0
26684,UDA06E5,3,-5.91,2,1,6.0,0.09
26685,U5FE56C,3,-7105.6,1,2,10000.0,2894.4
26686,U1B11A2,3,129.0,2,1,10.0,139.0
26687,U386C9F,3,-610.0,3,0,610.0,0.0
26688,U4C7A52,3,1327.0,1,2,100.0,1427.0
26689,UBD9392,3,364.48,2,1,1960.81,2325.29
26690,UF52F54,3,-315.54,2,1,781.48,465.94
26691,U9497F5,3,0.01,1,2,0.01,0.02
26692,U95D137,3,-956.0,2,1,1356.0,400.0
26693,U316737,3,0.07,1,2,48.9,48.97
26694,UE39DF7,3,998.5,1,2,1.5,1000.0
26695,U583386,3,-10034.380000000001,1,2,16322.0,6287.62
26696,UBC1FB2,3,0.04,1,2,125.0,125.04
26697,U7F91A0,3,-22.0,2,1,2022.0,2000.0
26698,U8191B4,3,-1405.0,3,0,1405.0,0.0
26699,U06E836,3,0.0,2,1,358.25,358.25
26700,U70226C,3,0.21000000000003638,2,1,4508.0,4508.21
26701,U36E830,3,1704.0,2,1,4696.0,6400.0
26702,UFC75C8,3,-3.269999999999982,1,2,4309.08,4305.8099999999995
26703,U841494,3,131.0,0,3,0.0,131.0
26704,UD1EF7E,3,13647.0,1,2,13825.0,27472.0
26705,UAE93AA,3,-10.2,3,0,10.2,0.0
26706,UE28547,3,-1.99,2,1,2.0,0.01
26707,U5DAFB1,3,-1829.1,2,1,1905.0,75.9
26708,U62B9C5,3,21144.92,0,3,0.0,21144.92
26709,UE8272C,3,4927.4,2,1,1492.6,6420.0
26710,UC4A7FE,3,0.4,0,3,0.0,0.4
26711,U300876,3,118.94999999999999,1,2,88.57,207.51999999999998
26712,UB8BFA9,3,-0.6100000000000001,2,1,2.0,1.39
26713,U8FFA58,3,-50.0,3,0,50.0,0.0
26714,U11C647,3,180.0,2,1,720.0,900.0
26715,UBA5422,3,393.55999999999995,1,2,340.0,733.56
26716,U978A27,3,7059.16,1,2,3500.0,10559.16
26717,UDA20F1,3,-2734.5899999999997,1,2,2749.46,14.87
26718,U4A4B2E,3,4950.44,1,2,50.5,5000.94
26719,UE4B328,3,1490.0,2,1,110.0,1600.0
26720,UD45E62,3,-383.5,3,0,383.5,0.0
26721,UCB669C,3,-209.64000000000001,3,0,209.64000000000001,0.0
26722,UCC1439,3,782.2,0,3,0.0,782.2
26723,U5DA834,3,-3024.0,2,1,3600.0,576.0
26724,U90A371,3,83824.0,0,3,0.0,83824.0
26725,UCAD448,3,2740.0,2,1,960.0,3700.0
26726,UB46791,3,-10700.0,2,1,15700.0,5000.0
26727,U35BAB0,3,-5.41,2,1,6.0,0.59
26728,U1A020E,3,0.0,1,2,398.0,398.0
26729,UB61646,3,10.430000000000003,1,2,29.94,40.370000000000005
26730,UE416D5,3,-9731.0,2,1,19031.0,9300.0
26731,U2AD2D3,3,0.28,1,2,0.28,0.56
26732,U41FC41,3,-916.0,3,0,916.0,0.0
26733,UBED5D4,3,3148.0,1,2,20700.0,23848.0
26734,UFE7D42,3,4999.0,1,2,5001.0,10000.0
26735,UE4B503,3,1500.0,1,2,1200.0,2700.0
26736,UC5AB95,3,-20.0,3,0,20.0,0.0
26737,U0A2E12,3,-16654.99,2,1,16655.0,0.01
26738,U02C96A,3,1660.0,1,2,2320.0,3980.0
26739,UD6A71A,3,10000.0,0,3,0.0,10000.0
26740,UA303D6,3,-1025.99,2,1,1042.9,16.91
26741,U5852BA,3,50.010000000000005,0,3,0.0,50.010000000000005
26742,U3D7478,3,-4000.0,2,1,6428.0,2428.0
26743,UB106C0,3,-246.0,2,1,2261.0,2015.0
26744,UF7526A,3,-3800.0,2,1,7680.0,3880.0
26745,U2629AA,3,4998.0,1,2,1050.0,6048.0
26746,UF0C83D,3,-598.37,2,1,600.0,1.63
26747,U8FCDCF,3,60.380000000000024,2,1,159.64999999999998,220.03
26748,U4E9AC1,3,-300.0,1,2,1000.0,700.0
26749,U5F08C8,3,-1033.33,2,1,1859.33,826.0
26750,U2EA8B6,3,0.0,2,1,968.12,968.12
26751,UCB8CC8,3,-3000.0,2,1,4000.0,1000.0
26752,U33D74D,3,1665.0,2,1,1005.0,2670.0
26753,UAAEE3C,3,-2798.0,2,1,2800.0,2.0
26754,UBA9FC3,3,700.0,1,2,5100.0,5800.0
26755,U5589CA,3,0.3099999999999996,1,2,6.05,6.359999999999999
26756,U3530AE,3,-805.8299999999999,2,1,3840.0,3034.17
26757,UA613FD,3,290.0,2,1,10.0,300.0
26758,UBE1A6E,3,-784.84,3,0,784.84,0.0
26759,U823774,3,825.0,1,2,1224.0,2049.0
26760,UC478B3,3,176.15,1,2,3338.0,3514.15
26761,U5A8E1F,3,-1208.0,1,2,10000.0,8792.0
26762,U41EF95,3,1835.0800000000002,1,2,150.0,1985.0800000000002
26763,UB060BD,3,-5.98,2,1,6.0,0.02
26764,U5D4133,3,748.96,0,3,0.0,748.96
26765,U92388D,3,6721.0,1,2,1299.0,8020.0
26766,U99BA5D,3,-1850.05,3,0,1850.05,0.0
26767,U60D88B,3,-423.52000000000044,1,2,4948.01,4524.49
26768,U7EB8E3,3,-337.4,3,0,337.4,0.0
26769,U8F663E,3,0.0,2,1,123.0,123.0
26770,UD1E9A7,3,1990.0,2,1,10.0,2000.0
26771,U6537AE,3,-908.64,2,1,911.28,2.64
26772,U8FB71B,3,5.0,2,1,10.0,15.0
26773,UAAF883,3,900.0,1,2,1000.0,1900.0
26774,U1A5542,3,-168.0,2,1,573.0,405.0
26775,U92FBEC,3,0.0,2,1,299.0,299.0
26776,U5B78EA,3,3000.0,1,2,9000.0,12000.0
26777,U2C0895,3,-1910.0,3,0,1910.0,0.0
26778,UE1A743,3,528.6,2,1,222.0,750.6
26779,UCB9389,3,1068.3999999999999,1,2,1179.68,2248.08
26780,U178EE5,3,-1.79,2,1,2.0,0.21
26781,UA1FF61,3,0.0,1,2,10000.0,10000.0
26782,U17F4C7,3,-189.9,3,0,189.9,0.0
26783,U81B34E,3,100437.1,0,3,0.0,100437.1
26784,U795EBF,3,-520.1699999999996,1,2,5011.0,4490.83
26785,U2F530F,3,797.38,2,1,99.8,897.18
26786,UF69A61,3,-50.0,2,1,1050.0,1000.0
26787,UB83263,3,-57.58,3,0,57.58,0.0
26788,UE435A0,3,-2029.0,2,1,5714.0,3685.0
26789,U7927F3,3,-44.95,2,1,45.0,0.05
26790,UDC7427,3,-22132.6,3,0,22132.6,0.0
26791,U0EC4F0,3,-5153.0,2,1,7788.0,2635.0
26792,U1ACFE6,3,0.0,1,2,1131.0,1131.0
26793,U181331,3,1500.0,0,3,0.0,1500.0
26794,U115C35,3,750.8399999999999,2,1,399.16,1150.0
26795,U3623AC,3,396.0,0,3,0.0,396.0
26796,U360F7D,3,0.0,2,1,3970.0,3970.0
26797,U367ACF,3,17500.0,0,3,0.0,17500.0
26798,UD13CB4,3,7800.0,0,3,0.0,7800.0
26799,UD6CFE7,3,39.0,1,2,24.0,63.0
26800,UBE5BEE,3,236.05,0,3,0.0,236.05
26801,UCA9974,3,-9.93,2,1,10.0,0.07
26802,U31ED10,3,1995.0,1,2,5.0,2000.0
26803,U2F95A0,3,57531.03,0,3,0.0,57531.03
26804,U5CE4AA,3,-1.98,2,1,2.0,0.02
26805,UE9D6FD,3,-8013.52,1,2,8220.0,206.48000000000002
26806,U92A7FC,3,16.53,0,3,0.0,16.53
26807,U87C144,3,-3620.0,2,1,15143.0,11523.0
26808,U375C38,3,0.5199999999999996,1,2,9.5,10.02
26809,U13450D,3,1729.0,1,2,120.6,1849.6
26810,U517722,3,-1.88,2,1,2.0,0.12
26811,UC823C5,3,2207.0,1,2,1399.0,3606.0
26812,UF72C0C,3,-3992.0,2,1,4793.0,801.0
26813,UDF5375,3,-5016.72,2,1,5020.0,3.28
26814,U010CC7,3,-5.79,2,1,6.0,0.21
26815,UD6E2F4,3,601.0,1,2,4899.0,5500.0
26816,UFB1BFB,3,1202.03,1,2,307.97,1510.0
26817,U776B50,3,62.390000000000015,2,1,246.41,308.8
26818,U553058,3,0.0,2,1,200.0,200.0
26819,U5135CE,3,-5.99,2,1,6.0,0.01
26820,UBF3CE8,3,0.1,1,2,0.1,0.2
26821,U561D2E,3,1042.41,1,2,0.59,1043.0
26822,U2E32B3,3,0.04,1,2,0.01,0.05
26823,U51FF8A,3,9980.03,1,2,20.0,10000.03
26824,U5B7AF9,3,-5.99,2,1,6.0,0.01
26825,U366C3D,3,740.01,1,2,5260.0,6000.01
26826,UC39969,3,10600.0,0,3,0.0,10600.0
26827,U26D17E,3,1632.36,1,2,3000.0,4632.36
26828,U187B1D,3,0.0,2,1,124.0,124.0
26829,UA80BAD,3,169.0,2,1,1831.0,2000.0
26830,U1CA443,3,3.552713678800501e-15,2,1,51.599999999999994,51.6
26831,U48E68F,3,90.0,2,1,10.0,100.0
26832,UFB43FE,3,-1957.62,2,1,2057.62,100.0
26833,U478766,3,8990.0,1,2,3010.0,12000.0
26834,U12C21D,3,0.01,1,2,3000.0,3000.01
26835,UE73F4F,3,1028.0,2,1,72.0,1100.0
26836,U79C2B3,3,0.42000000000007276,1,2,2399.0,2399.42
26837,U3F6E84,3,60.010000000000005,0,3,0.0,60.010000000000005
26838,U5F58E8,3,700.0,1,2,300.0,1000.0
26839,UF0B5F1,3,0.0,1,2,200.0,200.0
26840,UCA4AD7,3,-9.89,2,1,10.0,0.11
26841,U087A74,3,-99.0,2,1,198.0,99.0
26842,UE61E73,3,3015.0,0,3,0.0,3015.0
26843,U6805B9,3,259625.68,0,3,0.0,259625.68
26844,UB8ACC3,3,-5.9399999999999995,2,1,6.0,0.06
26845,U996E82,3,0.21,1,2,300.0,300.21
26846,UF29A4E,3,417.36,1,2,191.0,608.36
26847,U535119,3,213.1,1,2,21.9,235.0
26848,UE7FC84,3,50612.78,1,2,4549.0,55161.78
26849,U15E612,3,-34.580000000000005,2,1,34.7,0.12
26850,U859A4B,3,1.3,1,2,0.01,1.31
26851,UC9BF0F,3,7915.05,1,2,3085.0,11000.05
26852,U4BFA6C,3,108.36000000000001,1,2,128.98,237.34
26853,U91AA7C,3,2560.0,1,2,3030.0,5590.0
26854,U70AF9B,3,-485.9,1,2,500.0,14.1
26855,U3BC176,3,30.0,1,2,30.0,60.0
26856,U73CD9A,3,623.0,2,1,10.0,633.0
26857,U78772F,3,3100.0,0,3,0.0,3100.0
26858,U975C62,3,4440.0,1,2,60.0,4500.0
26859,U2BC09D,3,2997.12,1,2,500.0,3497.12
26860,UDBF4BA,3,5115.05,0,3,0.0,5115.05
26861,U7CC24A,3,-2691.0,1,2,9000.0,6309.0
26862,UFD5C59,3,2101.0,1,2,3899.0,6000.0
26863,UF38413,3,-18.370000000000008,1,2,680.0,661.63
26864,UE966EF,3,-11.0,3,0,11.0,0.0
26865,U12492C,3,5975.58,0,3,0.0,5975.58
26866,UFC6C7E,3,1000.0,1,2,1000.0,2000.0
26867,U36414E,3,-12060.810000000001,2,1,13060.810000000001,1000.0
26868,U577E12,3,1.29,2,1,2.0,3.29
26869,U37C53B,3,-3.0,2,1,8553.0,8550.0
26870,U593EF0,3,-83.17,2,1,166.34,83.17
26871,UB0B895,3,0.0,1,2,15000.0,15000.0
26872,UACD7E6,3,9.260000000000005,2,1,62.5,71.76
26873,UAAD4DE,3,1345.0,1,2,967.0,2312.0
26874,UA3DC8B,3,200.0,1,2,0.07,200.07
26875,UD28107,3,-3510.0,3,0,3510.0,0.0
26876,U9483F4,3,-1001.0,2,1,2001.0,1000.0
26877,U5054F0,3,0.0,2,1,14850.0,14850.0
26878,U2C6282,3,7.0,0,3,0.0,7.0
26879,U2A0EDC,3,800.0,1,2,1000.0,1800.0
26880,UD290DE,3,11.729999999999563,1,2,5000.0,5011.73
26881,U87CCA2,3,-154.0,2,1,2950.0,2796.0
26882,UF17225,3,-28.939999999999998,3,0,28.939999999999998,0.0
26883,UC4606E,3,6000.0,0,3,0.0,6000.0
26884,U73AF34,3,-15.7,2,1,20.0,4.3
26885,UFEFB42,3,1379.0,1,2,500.0,1879.0
26886,UF36600,3,1110.0,1,2,6500.0,7610.0
26887,UC191B7,3,1430.0400000000009,1,2,13968.0,15398.04
26888,U58D666,3,2.1827852025868566e-13,2,1,8000.01,8000.01
26889,U494D4D,3,-1.98,2,1,2.0,0.02
26890,UEABFD3,3,-9998.0,2,1,19998.0,10000.0
26891,UA39369,3,1.0,1,2,19.96,20.96
26892,U84B80E,3,-267.0,2,1,276.94,9.94
26893,UC8C40A,3,-203.0,2,1,214.82,11.82
26894,UE132E9,3,-19.82,2,1,20.0,0.18
26895,U047295,3,-5.73,2,1,6.0,0.27
26896,U5E47C0,3,90.0,1,2,4010.0,4100.0
26897,UC67EF2,3,33.33999999999651,1,2,200000.0,200033.34
26898,UE63B70,3,96.0,2,1,178.0,274.0
26899,U4E4F93,3,-33.6,3,0,33.6,0.0
26900,U3478A9,3,0.0,2,1,3500.0,3500.0
26901,UA34666,3,439.6199999999999,1,2,3694.0,4133.62
26902,UA8EB0F,3,-52.97,2,1,53.0,0.03
26903,U6937AD,3,-5980.0,2,1,11970.0,5990.0
26904,U55F579,3,-79.56,3,0,79.56,0.0
26905,U5343BB,3,-3.0,3,0,3.0,0.0
26906,U84F1EA,3,413.0,1,2,0.01,413.01
26907,UC92130,3,-2662.5,2,1,3030.0,367.5
26908,UA6D344,3,-497.59,1,2,5800.0,5302.41
26909,UEFF429,3,0.05,1,2,0.05,0.1
26910,U63E812,3,113.54999999999998,2,1,274.9,388.45
26911,UA2BEFB,3,-7500.0,2,1,11380.0,3880.0
26912,U1409CE,3,5605.060000000001,1,2,5321.0,10926.060000000001
26913,U15085C,3,0.0,1,2,4030.0,4030.0
26914,UEEBD99,3,6977.0,1,2,6997.0,13974.0
26915,U1504A9,3,2014.0,1,2,1327.0,3341.0
26916,UBF6FD0,3,11009.01,0,3,0.0,11009.01
26917,UE8A7EE,3,742.9299999999998,2,1,2465.0,3207.93
26918,UEFAA0A,3,300.0,1,2,300.0,600.0
26919,U1B6804,3,0.9600000000000364,1,2,4377.44,4378.4
26920,U36FF96,3,-6.3,2,1,6.319999999999999,0.02
26921,U2B726D,3,-5.91,2,1,6.0,0.09
26922,UE61807,3,-3265.98,2,1,4120.1,854.12
26923,U4C1A4D,3,-28.9,2,1,28.91,0.01
26924,U4F1D38,3,3.849999999999909,1,2,1159.0,1162.85
26925,UC988DD,3,0.06,1,2,7588.0,7588.06
26926,UA3FC7D,3,-98.15,3,0,98.15,0.0
26927,UF160AC,3,1990.0,2,1,10.0,2000.0
26928,U8D2555,3,-19923.06,1,2,20000.0,76.94000000000001
26929,U31ED9D,3,-9.99,2,1,10.0,0.01
26930,U03762E,3,10000.0,1,2,100.0,10100.0
26931,U4B5C9D,3,-99.72,1,2,300.0,200.28
26932,U81F499,3,-3608.0,2,1,7008.0,3400.0
26933,U51602D,3,55.039999999999964,2,1,544.96,600.0
26934,U72B6B0,3,-0.03,3,0,0.03,0.0
26935,U93F760,3,-41.800000000000004,3,0,41.800000000000004,0.0
26936,U975369,3,2621.0,0,3,0.0,2621.0
26937,UF95399,3,-2009.99,2,1,2010.0,0.01
26938,U392EE0,3,30.699999999999996,1,2,12.1,42.8
26939,U081420,3,-160.0,3,0,160.0,0.0
26940,UE4BB4C,3,-99.69999999999999,2,1,129.7,30.0
26941,U9BE9AE,3,1000.0,1,2,2000.0,3000.0
26942,U19881D,3,671.6499999999996,2,1,3405.3,4076.95
26943,UA1A9B3,3,0.0,1,2,10000.0,10000.0
26944,U814494,3,0.029999999999972715,1,2,300.0,300.03
26945,U7927D9,3,-250.0,3,0,250.0,0.0
26946,UC9053F,3,-339.95,3,0,339.95,0.0
26947,U004588,3,290.0,2,1,10.0,300.0
26948,U5D59A5,3,186.0,1,2,186.0,372.0
26949,U0F6065,3,-117.99,2,1,118.0,0.01
26950,UB210D3,3,141.58999999999997,2,1,308.41,450.0
26951,U4F6945,3,90.0,1,2,5000.0,5090.0
26952,UF000B9,3,7566.65,0,3,0.0,7566.65
26953,U9FD5D0,3,0.11999999999989086,1,2,2320.0,2320.12
26954,U3E196D,3,800.4,2,1,199.6,1000.0
26955,U6847CB,3,0.0,2,1,100.0,100.0
26956,U23968E,3,-3029.98,2,1,3030.0,0.02
26957,UB486A1,3,5826.11,0,3,0.0,5826.11
26958,UF558D4,3,555.0,1,2,3500.0,4055.0
26959,U035C16,3,-260.0,2,1,860.0,600.0
26960,UF1B608,3,0.11000000000000001,0,3,0.0,0.11000000000000001
26961,U88D411,3,-723.0,2,1,3473.0,2750.0
26962,UF38E20,3,-1025.0,2,1,1243.0,218.0
26963,U9CC394,3,164.47,0,3,0.0,164.47
26964,U0CA202,3,-69000.0,3,0,69000.0,0.0
26965,UE6DA3B,3,8.326672684688674e-17,2,1,2.0,2.0
26966,UCBCD8A,3,282.01,0,3,0.0,282.01
26967,U78AA9C,3,14990.0,2,1,10.0,15000.0
26968,U455E35,3,0.01,1,2,0.01,0.02
26969,U8ADA36,3,-153.88,2,1,154.0,0.12
26970,UF7C4C4,3,-5.970000000000001,2,1,6.0,0.03
26971,U02DC1F,3,11.0,1,2,16.5,27.5
26972,U16D84C,3,-8585.0,2,1,16169.0,7584.0
26973,U36737C,3,-29.98,3,0,29.98,0.0
26974,UF505A1,3,-10.0,2,1,10.01,0.01
26975,UFB556A,3,806.36,1,2,0.01,806.37
26976,U2B57AA,3,42.0,1,2,19.9,61.9
26977,U29F6D6,3,119.0,2,1,10.0,129.0
26978,U770F77,3,-277.0,3,0,277.0,0.0
26979,U5D62E3,3,568.78,1,2,30.0,598.78
26980,U488BD6,3,350.47999999999996,0,3,0.0,350.47999999999996
26981,U742756,3,-213.45999999999998,1,2,484.3,270.84000000000003
26982,UC44A78,3,1002.29,1,2,0.01,1002.3
26983,U01C5BD,3,0.35999999999989996,1,2,1752.0,1752.36
26984,UCDC2A1,3,11602.48,0,3,0.0,11602.48
26985,UEB656A,3,0.0,2,1,112.9,112.9
26986,U1FFC0F,3,22.319999999999993,2,1,334.04,356.36
26987,UF887E1,3,3014.5,1,2,408.0,3422.5
26988,U86FCE9,3,-300.0,2,1,357.8,57.8
26989,UE0DD15,3,1820.07,1,2,500.0,2320.0699999999997
26990,U73C6F1,3,-2423.71,2,1,2424.0,0.29
26991,U254F5F,3,0.0,2,1,19805.0,19805.0
26992,UA92F7B,3,410.0,0,3,0.0,410.0
26993,UE6ACE1,3,690.09,1,2,210.0,900.09
26994,U5DB055,3,-97.0,2,1,100.0,3.0
26995,U678113,3,1103.0,0,3,0.0,1103.0
26996,U355D9F,3,495.0,1,2,2499.0,2994.0
26997,UE8C2C6,3,14.610000000000001,2,1,4.28,18.89
26998,U18B4A2,3,0.11000000000001364,1,2,300.0,300.11
26999,U3AD297,3,-600.0,2,1,1100.0,500.0
27000,U933059,3,1652.99,0,3,0.0,1652.99
27001,UD8D88F,3,-4940.0,3,0,4940.0,0.0
27002,UFE31A6,3,-0.03999999999999915,2,1,115.78,115.74
27003,UBE9FA0,3,-5.27,2,1,6.0,0.73
27004,UCBF6A0,3,-35.94,2,1,40.0,4.06
27005,U7E36EE,3,4538.05,1,2,491.95,5030.0
27006,U7B1027,3,-55.2,2,1,60.0,4.8
27007,UBF46C9,3,-17.0,2,1,20.0,3.0
27008,U5F21F0,3,-5000.0,2,1,15000.0,10000.0
27009,U180C8B,3,-1917.9099999999999,2,1,2525.0,607.09
27010,U892DCD,3,1420.01,0,3,0.0,1420.01
27011,U784436,3,-1913.0,2,1,2013.0,100.0
27012,UD3CF11,3,0.0,2,1,1104.0,1104.0
27013,UE4ACB6,3,2800.0,1,2,2765.0,5565.0
27014,U422875,3,-5.0,2,1,10.0,5.0
27015,UB0A2CE,3,-93.0,2,1,306.0,213.0
27016,U07C289,3,122.71,2,1,1040.3,1163.01
27017,U4516C7,3,4.07,2,1,10.0,14.07
27018,U8AC872,3,3910.0,1,2,666.0,4576.0
27019,U472D57,3,-240.47,3,0,240.47,0.0
27020,U96D949,3,3100.0,0,3,0.0,3100.0
27021,U4063B6,3,-223.2,3,0,223.2,0.0
27022,UE9D3A8,3,0.0,2,1,10.0,10.0
27023,U1BFE36,3,290.0,2,1,10.0,300.0
27024,U5BDB6B,3,91.25,0,3,0.0,91.25
27025,UBD4B2B,3,900.0,1,2,700.0,1600.0
27026,UE368E2,3,-3934.55,2,1,5000.0,1065.45
27027,UF68347,3,4003.61,0,3,0.0,4003.61
27028,U727244,3,-114.98,3,0,114.98,0.0
27029,UA0C05F,3,-4288.24,1,2,4428.0,139.76
27030,U21C543,3,2994.66,0,3,0.0,2994.66
27031,U5C4D5C,3,738.0,1,2,277.66,1015.6600000000001
27032,U59A33D,3,478.0,1,2,2987.0,3465.0
27033,UBAB006,3,-5.01,2,1,6.0,0.99
27034,U427430,3,-160.0,3,0,160.0,0.0
27035,UA21743,3,0.0,2,1,11950.0,11950.0
27036,U83F558,3,0.01,1,2,8000.0,8000.01
27037,U610E87,3,4204.0,0,3,0.0,4204.0
27038,U02318C,3,490.0,2,1,10.0,500.0
27039,UC213F8,3,1205.0,1,2,995.0,2200.0
27040,U6E85EE,3,97.0,2,1,10.0,107.0
27041,U908264,3,0.98,2,1,0.02,1.0
27042,UE6BC7F,3,-16.95,2,1,20.0,3.05
27043,UDE05EB,3,1709.25,0,3,0.0,1709.25
27044,U44875B,3,-2750.0,2,1,8450.0,5700.0
27045,UE44C31,3,690.0,0,3,0.0,690.0
27046,U820787,3,-286.36,1,2,288.0,1.6400000000000001
27047,U2F378B,3,-2019.77,2,1,2020.0,0.23
27048,U56A8D6,3,-300.0,3,0,300.0,0.0
27049,U154B81,3,-17.99,2,1,18.0,0.01
27050,U933132,3,-3971.0,2,1,7971.0,4000.0
27051,U8E7202,3,4007.0299999999997,0,3,0.0,4007.0299999999997
27052,UE41B60,3,-808.0900000000001,1,2,4890.0,4081.91
27053,UD5B3A8,3,3080.0,0,3,0.0,3080.0
27054,UFADFD9,3,30.0,0,3,0.0,30.0
27055,UF61C78,3,1000.0,1,2,240.0,1240.0
27056,U2E27B5,3,219.68,0,3,0.0,219.68
27057,U93956F,3,203.0,2,1,274.0,477.0
27058,UB9D91F,3,-458.0,2,1,1210.0,752.0
27059,U89F711,3,-1.99,2,1,2.0,0.01
27060,UFB17E9,3,-369.84000000000003,3,0,369.84000000000003,0.0
27061,UA1E4DC,3,859.9,1,2,8.0,867.9
27062,U902109,3,16008.0,0,3,0.0,16008.0
27063,U21B22B,3,13.0,2,1,249.32,262.32
27064,U2D58C3,3,140662.32,0,3,0.0,140662.32
27065,UD9AB3D,3,860.87,0,3,0.0,860.87
27066,UC8F79E,3,50.0,1,2,60.0,110.0
27067,U4D7F10,3,3700.0,0,3,0.0,3700.0
27068,UF3C784,3,-28020.0,2,1,28320.0,300.0
27069,U6AFD5E,3,-43.89,2,1,93.89,50.0
27070,U4899C6,3,185.52,0,3,0.0,185.52
27071,U1325FB,3,1450.0,1,2,1100.0,2550.0
27072,UA1F021,3,2280.0,1,2,2858.0,5138.0
27073,UE39D25,3,0.01,1,2,2788.0,2788.01
27074,U013B4D,3,-4990.0,2,1,7890.0,2900.0
27075,UF88EC5,3,-28411.0,1,2,33211.0,4800.0
27076,UE661DB,3,1300.0,0,3,0.0,1300.0
27077,U73F9AE,3,130.0,0,3,0.0,130.0
27078,U849ED4,3,55216.0,0,3,0.0,55216.0
27079,U998673,3,387.8499999999999,1,2,2212.15,2600.0
27080,U2A0F8C,3,3000.04,0,3,0.0,3000.04
27081,UF4FF35,3,-103.09999999999991,2,1,1103.1,1000.0
27082,U5C9EBE,3,9.9,1,2,0.01,9.91
27083,U5EE475,3,712.2800000000002,1,2,1674.54,2386.82
27084,U23A644,3,0.0,2,1,760.0,760.0
27085,U01D25B,3,4070.0,1,2,8480.0,12550.0
27086,U4D285F,3,-11.100000000000001,2,1,98.1,87.0
27087,U0CF581,3,0.01999999999999602,2,1,99.98,100.0
27088,UF87E34,3,171.6,1,2,30.8,202.4
27089,UC44C9A,3,2600.0,0,3,0.0,2600.0
27090,UBCA42E,3,100.0,1,2,3.88,103.88
27091,U001DE7,3,-60.0,2,1,10900.0,10840.0
27092,U4B44E9,3,-322.35,3,0,322.35,0.0
27093,U8266E4,3,70.0,1,2,30.0,100.0
27094,U627DD5,3,1005.67,2,1,194.4,1200.07
27095,UF07C64,3,0.01,1,2,10.0,10.01
27096,U888633,3,-900.0,3,0,900.0,0.0
27097,UB2A6BE,3,-58.84000000000003,2,1,258.84000000000003,200.0
27098,UEE581A,3,1.0,1,2,29.9,30.9
27099,UEB8852,3,48.97,2,1,6.0,54.97
27100,UB8162A,3,5350.0,1,2,5826.0,11176.0
27101,U97574E,3,-3585.0,2,1,3985.0,400.0
27102,U6E9E85,3,-5.5,2,1,6.0,0.5
27103,UF9F0E3,3,-5.87,2,1,6.0,0.13
27104,U83AD40,3,-956.98,2,1,1010.0,53.02
27105,UA9A528,3,1702.9,1,2,377.0,2079.9
27106,U09514C,3,11515.8,0,3,0.0,11515.8
27107,U6431BA,3,-15.0,2,1,30.0,15.0
27108,U5DEE69,3,3570.0,1,2,1066.0,4636.0
27109,U6B7E00,3,5190.0,0,3,0.0,5190.0
27110,UD9FB8A,3,-3000.0,3,0,3000.0,0.0
27111,U155985,3,5900.0,1,2,6000.0,11900.0
27112,U5476FA,3,15130.07,1,2,14986.0,30116.07
27113,U310F22,3,-501.64,2,1,502.0,0.36
27114,UEF626E,3,677.09,0,3,0.0,677.09
27115,U630854,3,313.59,0,3,0.0,313.59
27116,UFE8168,3,80.63,1,2,611.74,692.37
27117,U39496D,3,2310.13,0,3,0.0,2310.13
27118,UBA6AD8,3,-3755.69,2,1,6202.0,2446.31
27119,UF98EE7,3,382.0,1,2,168.0,550.0
27120,UF2220C,3,-400.0,2,1,500.0,100.0
27121,U5D9620,3,170.08,2,1,6.0,176.08
27122,UC28D58,3,5800.0,1,2,200.0,6000.0
27123,UE0DF54,3,290.0,0,3,0.0,290.0
27124,UE373A6,3,-889.0100000000002,1,2,3330.01,2441.0
27125,UF1F051,3,18.99,2,1,1.01,20.0
27126,U34AC67,3,610.0,0,3,0.0,610.0
27127,U7F517F,3,0.04999999999999999,1,2,0.13,0.18
27128,U09A963,3,43.2,2,1,106.8,150.0
27129,UAC5A92,3,-11370.1,2,1,11370.87,0.77
27130,U0447E3,3,490.0,2,1,10.0,500.0
27131,UB66954,3,-2579.0,3,0,2579.0,0.0
27132,U8636C5,3,93.88999999999999,2,1,806.11,900.0
27133,U4E808B,3,12959.0,0,3,0.0,12959.0
27134,U238CD2,3,52.4,1,2,52.9,105.3
27135,UEDDA78,3,90.02,1,2,10.0,100.02
27136,UE6214D,3,14955.0,1,2,9995.0,24950.0
27137,UCD7BEC,3,-2987.0,3,0,2987.0,0.0
27138,U5D43AA,3,200.01999999999998,0,3,0.0,200.01999999999998
27139,U03A10C,3,-5.0,2,1,10.0,5.0
27140,UEB2B24,3,-12252.6,2,1,14432.6,2180.0
27141,U5782DC,3,-5000.0,1,2,45000.0,40000.0
27142,UA26016,3,0.0,2,1,1650.0,1650.0
27143,U8BD2E3,3,0.01,1,2,0.01,0.02
27144,U983731,3,-81.86,2,1,81.9,0.04
27145,UF8423C,3,1614.0,1,2,2069.0,3683.0
27146,U79B749,3,-9.0951551845464e-15,2,1,1001.0,1001.0
27147,U7C7EF5,3,0.009999999999990905,1,2,1000.0,1000.01
27148,U4C78E3,3,-15.0,2,1,47.1,32.1
27149,U4A4147,3,-136.09,2,1,174.08,37.99
27150,U80AB75,3,0.0,1,2,26.0,26.0
27151,UE0D143,3,6200.0,0,3,0.0,6200.0
27152,U3C7B78,3,-19.97,2,1,20.0,0.03
27153,UEFF868,3,-1988.0,2,1,2015.84,27.84
27154,U4B56A4,3,255.0,1,2,750.0,1005.0
27155,UD2C05B,3,1601.0,0,3,0.0,1601.0
27156,UE1EFE5,3,0.0,2,1,1165.0,1165.0
27157,U7B149F,3,-5999.76,1,2,6000.0,0.24000000000000002
27158,U6BB035,3,-1694.2700000000004,1,2,12968.0,11273.73
27159,U845C13,3,41603.5,1,2,118.5,41722.0
27160,UF94CA9,3,0.010000000000218279,1,2,4000.0,4000.01
27161,UC020A4,3,440.0,1,2,8900.0,9340.0
27162,UAC9336,3,0.0,2,1,10.0,10.0
27163,UA31C96,3,3.8300000000017462,1,2,20000.0,20003.83
27164,UE1C65B,3,88.15000000000146,1,2,17308.0,17396.15
27165,UB18788,3,-2812.5,3,0,2812.5,0.0
27166,U6D5DD0,3,2000.04,1,2,0.01,2000.05
27167,UEC8EE5,3,-322.0,2,1,322.63,0.63
27168,UC55B33,3,100.13,0,3,0.0,100.13
27169,UF32EC0,3,10000.05,0,3,0.0,10000.05
27170,U6412D9,3,3980.59,1,2,20.0,4000.59
27171,U07EFFD,3,-1390.0,2,1,6390.0,5000.0
27172,UF339F9,3,0.7699999999999818,1,2,502.0,502.77
27173,UD3E24A,3,108.0,1,2,605.0,713.0
27174,U97D3A3,3,-10000.0,2,1,10020.0,20.0
27175,UC746E8,3,0.08999999999999997,1,2,0.86,0.95
27176,U68DF58,3,26.310000000000002,2,1,6.0,32.31
27177,U1036F4,3,-1765.0,2,1,1804.8,39.8
27178,UE3BE93,3,0.49,0,3,0.0,0.49
27179,UEBDA30,3,-19.560000000000002,2,1,20.0,0.44
27180,UA4D75A,3,-220.1,3,0,220.1,0.0
27181,UFFB27A,3,0.0,2,1,110.0,110.0
27182,U679F18,3,929.7700000000004,1,2,5000.0,5929.77
27183,U9E6FAD,3,3.33,1,2,3.34,6.67
27184,UCB224D,3,5354.78,0,3,0.0,5354.78
27185,UF3E8C7,3,14010.72,0,3,0.0,14010.72
27186,U09128B,3,-1.78,2,1,2.0,0.22
27187,UC9A7F3,3,0.010000000000001563,1,2,17.55,17.560000000000002
27188,UE2766D,3,40.0,2,1,10.0,50.0
27189,U86D7C7,3,-4999.0,2,1,9998.0,4999.0
27190,U6C3369,3,55.33,2,1,10.0,65.33
27191,U4BAA9E,3,-4500.0,2,1,9000.0,4500.0
27192,U4AAEDE,3,350.0,0,3,0.0,350.0
27193,U17E146,3,138.20000000000005,2,1,531.8,670.0
27194,U2598A3,3,-7800.0,2,1,15800.0,8000.0
27195,UF17D65,3,1038.72,1,2,9985.0,11023.72
27196,U776C51,3,0.0,2,1,15000.0,15000.0
27197,U36A2A7,3,0.0,2,1,37.2,37.2
27198,UC39DB6,3,0.05,1,2,0.05,0.1
27199,U70EAF5,3,-3000.0,2,1,6000.0,3000.0
27200,U825398,3,-119.0,3,0,119.0,0.0
27201,UA6A445,3,74.24,2,1,10.0,84.24
27202,U0640D7,3,13777.779999999999,0,3,0.0,13777.779999999999
27203,UD7B594,3,7.62,1,2,170.0,177.62
27204,U52890D,3,-62.15,1,2,66.3,4.15
27205,U5D5ABA,3,-191.17,2,1,382.34,191.17
27206,U1578CC,3,-28401.08,3,0,28401.08,0.0
27207,U5F1B97,3,0.02,1,2,4100.0,4100.02
27208,U86AC8D,3,-200.99,2,1,400.99,200.0
27209,U7920BF,3,6803.0,1,2,4000.0,10803.0
27210,U1FBFB8,3,200.0,1,2,2310.0,2510.0
27211,UCF7B55,3,-1001.8,2,1,1071.8,70.0
27212,UB0ADFA,3,3935.02,1,2,3898.0,7833.02
27213,U194733,3,1080.0,1,2,138.0,1218.0
27214,U89D7B2,3,8020.0,1,2,8920.0,16940.0
27215,UD390B5,3,0.34,1,2,100.0,100.34
27216,U33CF0A,3,-5.970000000000001,2,1,6.0,0.03
27217,U972518,3,1659.0,0,3,0.0,1659.0
27218,U4DC2C1,3,-25.869999999999994,2,1,49.989999999999995,24.12
27219,U2016C8,3,-74.0,1,2,95.0,21.0
27220,U349CEC,3,1000.25,1,2,0.01,1000.26
27221,U1D8667,3,300.0,1,2,2.42,302.42
27222,UE65C3D,3,-3530.0,2,1,6530.0,3000.0
27223,U372248,3,-8.84,2,1,8.85,0.01
27224,U06EE43,3,-0.7700000000002092,1,2,1249.13,1248.36
27225,U45CAC1,3,-3040.0,3,0,3040.0,0.0
27226,UAA59C1,3,1.5,1,2,224.0,225.5
27227,UF43C7D,3,312.0,0,3,0.0,312.0
27228,U4765B2,3,-14983.0,3,0,14983.0,0.0
27229,UB37F1A,3,9926.0,1,2,10000.0,19926.0
27230,UE1DF46,3,-2524.0,3,0,2524.0,0.0
27231,U1D837B,3,507.20000000001164,1,2,202493.0,203000.2
27232,UE56EA8,3,-3.95,2,1,4.0,0.05
27233,UB14712,3,7531.6,2,1,809.4,8341.0
27234,UE5AA6E,3,3000.0,1,2,3000.0,6000.0
27235,U3B0027,3,15.0,0,3,0.0,15.0
27236,UD5A6B5,3,1013.58,0,3,0.0,1013.58
27237,U32BAB0,3,0.16999999999999998,0,3,0.0,0.16999999999999998
27238,UED0D95,3,-4525.0,2,1,7025.0,2500.0
27239,UE77ED5,3,0.62,0,3,0.0,0.62
27240,UC787BC,3,700.99,1,2,59.7,760.69
27241,UE357C6,3,207.08,0,3,0.0,207.08
27242,U59D5A2,3,9443.82,0,3,0.0,9443.82
27243,UA41A5B,3,-357.0,1,2,2100.0,1743.0
27244,U06E162,3,-1.96,2,1,2.0,0.04
27245,UFFEE27,3,-19.130000000000003,2,1,20.0,0.87
27246,U79D895,3,-1.26,2,1,2.0,0.74
27247,UF13AB9,3,28.5,1,2,30000.0,30028.5
27248,U7DBF13,3,-1.1600000000000001,2,1,2.0,0.84
27249,U5F0B10,3,1371.84,2,1,359.4,1731.24
27250,UEC21A6,3,-3033.27,2,1,3033.3,0.03
27251,U07413E,3,-1301.39,2,1,1302.0,0.61
27252,UEEDC39,3,4677.28,1,2,305.0,4982.28
27253,U5227C9,3,0.0,2,1,5500.0,5500.0
27254,UB924B4,3,4140.0,1,2,549.0,4689.0
27255,UEBC584,3,25000.0,1,2,24900.0,49900.0
27256,UBEAEB6,3,-1.96,2,1,2.0,0.04
27257,UDC6A9B,3,-3000.0,2,1,5800.0,2800.0
27258,UF104E5,3,-1140.0,3,0,1140.0,0.0
27259,U85FAD7,3,-2724.14,1,2,2816.16,92.02
27260,U0C1389,3,-399.84000000000003,2,1,400.0,0.16
27261,U20B1C5,3,-5.0,2,1,20.0,15.0
27262,UFF812C,3,2600.0,1,2,2600.0,5200.0
27263,UC192CC,3,-10.1,3,0,10.1,0.0
27264,U1D0A1E,3,11236.25,0,3,0.0,11236.25
27265,UA7DE2B,3,-1.88,2,1,2.0,0.12
27266,U069DB8,3,500.0,1,2,3000.0,3500.0
27267,UFDA206,3,-9.969999999999999,2,1,10.0,0.03
27268,UC174C8,3,15098.0,0,3,0.0,15098.0
27269,UF783A8,3,1380.0,1,2,120.0,1500.0
27270,U110CB1,3,34.8,1,2,302.7,337.5
27271,U196415,3,27.75,1,2,722.3,750.05
27272,UD9135A,3,-23580.61,3,0,23580.61,0.0
27273,UA4F489,3,-412.7,3,0,412.7,0.0
27274,UD6626F,3,-55.0,2,1,105.0,50.0
27275,U23A821,3,-499.98,1,2,1000.0,500.02
27276,UA0E4AA,3,-2119.21,3,0,2119.21,0.0
27277,U1821A6,3,194.0,2,1,306.0,500.0
27278,UF37C6B,3,7987.0,1,2,3085.0,11072.0
27279,UFB5358,3,-73.0,2,1,105.45,32.45
27280,U65958E,3,-1.75,2,1,1.76,0.01
27281,U26FE77,3,-21974.0,2,1,43824.0,21850.0
27282,U78A196,3,3581.04,1,2,18.96,3600.0
27283,U004563,3,49990.0,2,1,10.0,50000.0
27284,UBC1EE4,3,20665.04,0,3,0.0,20665.04
27285,U0E40F4,3,-2.88,1,2,3.0,0.12000000000000001
27286,U1C43B9,3,488.70000000000005,1,2,49.85,538.5500000000001
27287,U47175B,3,-40.0,3,0,40.0,0.0
27288,UA1CFBF,3,0.0,1,2,1900.0,1900.0
27289,UF8017D,3,-1.88,2,1,2.0,0.12
27290,U348CD9,3,-4020.0,2,1,8020.0,4000.0
27291,UC3AF17,3,21500.0,0,3,0.0,21500.0
27292,U6D4BA8,3,-1998.43,1,2,2000.0,1.57
27293,U702EE1,3,1880.0,1,2,51.1,1931.1
27294,U15FA1C,3,0.0,2,1,228.98,228.98
27295,UE0C377,3,534.0,0,3,0.0,534.0
27296,U4FDC73,3,-5.99,2,1,6.0,0.01
27297,UB14B20,3,-320.0,3,0,320.0,0.0
27298,U465388,3,-2218.0,3,0,2218.0,0.0
27299,UB353AB,3,8378.439999999999,1,2,4651.56,13030.0
27300,U99E26C,3,0.0,1,2,2890.0,2890.0
27301,U61EE67,3,-3.552713678800501e-15,2,1,24.240000000000002,24.24
27302,U84EFD1,3,-1000.0,1,2,14230.0,13230.0
27303,U792B40,3,-9899.81,2,1,10000.0,100.19
27304,UA38B98,3,0.0,1,2,15000.0,15000.0
27305,UFBED05,3,-64.12,2,1,337.0,272.88
27306,UB93656,3,-4560.0,2,1,9475.0,4915.0
27307,U2EEBA4,3,-170.76,3,0,170.76,0.0
27308,U6A3459,3,33.720000000000006,1,2,4.59,38.31
27309,U78D39A,3,-14900.0,2,1,29800.0,14900.0
27310,UF3F994,3,734.19,1,2,99.0,833.19
27311,U2212D7,3,-4014.8,3,0,4014.8,0.0
27312,UF1866B,3,2030.36,0,3,0.0,2030.36
27313,UEBF577,3,-7797.98,2,1,7798.0,0.02
27314,U922B24,3,-9638.95,2,1,19630.0,9991.05
27315,U772FFE,3,84.6,0,3,0.0,84.6
27316,UBB6488,3,-600.0,2,1,900.0,300.0
27317,U6E316C,3,600.01,0,3,0.0,600.01
27318,U290D3B,3,2920.0,1,2,3600.0,6520.0
27319,U2501A9,3,-1.5100000000000051,2,1,10050.51,10049.0
27320,U7403A8,3,0.5,1,2,137.5,138.0
27321,U410634,3,0.0,2,1,200.0,200.0
27322,U18C997,3,-12.0,3,0,12.0,0.0
27323,U50FCC8,3,150.0,0,3,0.0,150.0
27324,UF4CA1B,3,0.0,2,1,10.0,10.0
27325,UEF22AE,3,0.0,1,2,2500.0,2500.0
27326,U39DB6C,3,3365.0,1,2,3800.0,7165.0
27327,U763CD2,3,-1.1102230246251565e-16,2,1,3.58,3.58
27328,U48F2E4,3,-1000.0,1,2,2000.0,1000.0
27329,U2B6A21,3,-78.0,2,1,278.0,200.0
27330,UAE8906,3,120.0,2,1,320.0,440.0
27331,UE0F088,3,-1326.0,2,1,14591.0,13265.0
27332,U1C0A73,3,3346.1400000000003,0,3,0.0,3346.1400000000003
27333,U25DBFF,3,-19.9,2,1,20.0,0.1
27334,U971270,3,15000.99,1,2,0.01,15001.0
27335,U4C8B68,3,0.0,2,1,2500.0,2500.0
27336,U095FC0,3,-16.87,2,1,20.0,3.13
27337,U7438A2,3,2999.0,1,2,2995.0,5994.0
27338,UF6D338,3,40.0,2,1,10.0,50.0
27339,UA07513,3,390.0,2,1,10.0,400.0
27340,U5F52AF,3,-8826.76,2,1,8826.79,0.03
27341,U59A4B1,3,107.08,1,2,3788.97,3896.0499999999997
27342,U08595E,3,-19.42,2,1,20.0,0.58
27343,UB33803,3,-1044.2,3,0,1044.2,0.0
27344,UDAA903,3,1851.02,1,2,1513.0,3364.02
27345,U393077,3,28.0,1,2,200.0,228.0
27346,UA0DF19,3,-19.369999999999997,2,1,20.0,0.63
27347,U79B6C0,3,385.5,0,3,0.0,385.5
27348,U2FB29B,3,2900.23,0,3,0.0,2900.23
27349,U7FF9D8,3,-5.98,2,1,6.0,0.02
27350,U5535AB,3,-49.85,2,1,149.55,99.7
27351,U4F6A3F,3,-3900.0,1,2,10000.0,6100.0
27352,U439F51,3,-7500.0,2,1,7800.0,300.0
27353,U5BBBA5,3,30.599999999999994,2,1,99.0,129.6
27354,UDC5F3B,3,1151.0,2,1,7249.0,8400.0
27355,U195D16,3,-5.99,2,1,6.0,0.01
27356,U53DB4C,3,5.3400000000001455,2,1,6814.66,6820.0
27357,UB9F9EC,3,0.0,2,1,3000.0,3000.0
27358,U8742A9,3,-74.45999999999998,2,1,174.45999999999998,100.0
27359,U1C804E,3,1000.0,1,2,1000.0,2000.0
27360,U7C2040,3,-6336.0,2,1,9225.0,2889.0
27361,U8A6B8D,3,-18.670000000000016,2,1,311.67,293.0
27362,UF7E263,3,4344.0,2,1,10.0,4354.0
27363,U4D1818,3,-1910.0,3,0,1910.0,0.0
27364,UD5E7C9,3,29.6,1,2,2250.0,2279.6
27365,U3C5ADF,3,4407.95,1,2,411.05,4819.0
27366,U5E836B,3,-5.0,2,1,1005.0,1000.0
27367,U19D17B,3,-1.94,2,1,2.0,0.06
27368,U46DE6D,3,770.65,2,1,186.0,956.65
27369,U86DED3,3,123.0,1,2,7000.0,7123.0
27370,UCF40DB,3,664.63,1,2,0.01,664.64
27371,U1AB458,3,-7197.13,2,1,7247.13,50.0
27372,UA23E69,3,-5.72,2,1,6.0,0.28
27373,UC9BD71,3,5500.0,1,2,728.0,6228.0
27374,U95CE7A,3,-5.41,2,1,10.0,4.59
27375,U69418A,3,-1.0,2,1,601.0,600.0
27376,U8AE84C,3,-19.869999999999997,2,1,20.0,0.13
27377,U75A0C7,3,-117.16999999999996,2,1,276.46999999999997,159.3
27378,U766940,3,-1000.0,2,1,2200.0,1200.0
27379,UD53285,3,-3020.0,3,0,3020.0,0.0
27380,U51220F,3,-1676.0,3,0,1676.0,0.0
27381,UD1C237,3,-1.1368683772161603e-13,2,1,1044.8600000000001,1044.86
27382,UD5DB41,3,-5.98,2,1,6.0,0.02
27383,U30BDA3,3,508.7,1,2,1.3,510.0
27384,U59F348,3,15000.03,0,3,0.0,15000.03
27385,UFE7264,3,-9.93,2,1,10.0,0.07
27386,U4BFF18,3,7189.75,1,2,83.55,7273.3
27387,U942310,3,-2864.98,2,1,2865.0,0.02
27388,UFD8E9B,3,1462.07,0,3,0.0,1462.07
27389,UAA6536,3,-62.97,1,2,75.0,12.03
27390,U1D3D9A,3,5168.0,1,2,1252.0,6420.0
27391,U84E529,3,-11207.09,2,1,11209.49,2.4
27392,U8939CF,3,965.0,0,3,0.0,965.0
27393,U451183,3,0.06,1,2,0.06,0.12
27394,U0C87AD,3,0.0,2,1,92.83,92.83
27395,UF7A995,3,8560.0,0,3,0.0,8560.0
27396,U7CF04C,3,40.0,2,1,10.0,50.0
27397,U3CDC7D,3,-5395.5,2,1,6000.0,604.5
27398,U6C996E,3,-5.9399999999999995,2,1,6.0,0.06
27399,U0BC31D,3,-367.78999999999996,2,1,368.0,0.21
27400,UDBA405,3,494.09999999999997,2,1,229.94,724.04
27401,U6678A4,3,290.0,2,1,10.0,300.0
27402,U55AB9D,3,-17.98,2,1,18.0,0.02
27403,U6A90A6,3,0.0,2,1,152.3,152.3
27404,U46AEB2,3,0.0,2,1,376.0,376.0
27405,UA44C98,3,-1.99,2,1,2.0,0.01
27406,U71A956,3,-67.80000000000001,2,1,356.8,289.0
27407,U521234,3,-5.48,2,1,6.0,0.52
27408,U7E7BA0,3,5.79,0,3,0.0,5.79
27409,U34FB43,3,-5.970000000000001,2,1,6.0,0.03
27410,UF438E8,3,-5.99,2,1,6.0,0.01
27411,U2BBAF1,3,1020.0,0,3,0.0,1020.0
27412,UF2E51E,3,9320.0,1,2,122.0,9442.0
27413,UCA812D,3,-23.0,2,1,23.95,0.95
27414,U5F4351,3,79.6,1,2,0.4,80.0
27415,UACBEC6,3,1127.75,0,3,0.0,1127.75
27416,UD50E0F,3,800.0,2,1,67.0,867.0
27417,U117D8C,3,15275.0,1,2,3925.0,19200.0
27418,UA99CBD,3,12100.0,1,2,10070.0,22170.0
27419,U1D83D7,3,-19.83,2,1,20.0,0.17
27420,U7BCECC,3,748.0,2,1,5052.0,5800.0
27421,U9E9795,3,-0.09999999999999432,2,1,130.1,130.0
27422,UE9C3BA,3,11.739999999999995,2,1,79.0,90.74
27423,U001B15,3,-325.04,3,0,325.04,0.0
27424,U1BFA2A,3,6208.0599999999995,0,3,0.0,6208.0599999999995
27425,UD98941,3,0.339999999999975,1,2,324.48,324.82
27426,U4D6561,3,501.0,1,2,500.0,1001.0
27427,U9D8453,3,-448.0,2,1,584.2,136.2
27428,U62E54C,3,-5.9399999999999995,2,1,6.0,0.06
27429,UCA627D,3,0.0,1,2,15050.0,15050.0
27430,U3F8F6A,3,-1365.0,2,1,1549.0,184.0
27431,U2415B6,3,-5.99,2,1,6.0,0.01
27432,UF4B0F1,3,15.0,1,2,85.0,100.0
27433,U9BD2F1,3,9.02,1,2,2001.0,2010.02
27434,UEC3341,3,0.0,1,2,2492.0,2492.0
27435,U882901,3,-1.97,2,1,2.0,0.03
27436,U9A611E,3,1000.0,1,2,0.01,1000.01
27437,UAAAE87,3,2304.4700000000003,2,1,2831.0,5135.47
27438,UF962FE,3,490.0,1,2,15600.0,16090.0
27439,U6CA7E2,3,-5.84,2,1,6.0,0.16
27440,U2E5D32,3,0.04,1,2,0.04,0.08
27441,UE3E767,3,2292.0,1,2,469.0,2761.0
27442,U186001,3,99.02,1,2,1.0,100.02
27443,U2C90F1,3,120.0,1,2,4030.0,4150.0
27444,U65FD1E,3,3416.88,0,3,0.0,3416.88
27445,U9B6DFB,3,6.869999999999998,1,2,100.0,106.87
27446,U871E52,3,-225.0,3,0,225.0,0.0
27447,UB6B973,3,3024.82,0,3,0.0,3024.82
27448,UB936A1,3,-5.53,2,1,6.0,0.47
27449,U26B3C1,3,399.9899999999998,1,2,4700.0,5099.99
27450,U0DDF9F,3,0.0,1,2,5300.0,5300.0
27451,UC74402,3,2108.2,0,3,0.0,2108.2
27452,U7E0516,3,7799.950000000001,1,2,7950.0,15749.95
27453,U692274,3,-39.0,2,1,3508.0,3469.0
27454,U02B893,3,200.46,0,3,0.0,200.46
27455,U811BFD,3,0.0,1,2,2866.29,2866.29
27456,U7A4BAD,3,2400.0,1,2,15000.0,17400.0
27457,UAD9373,3,-0.15000000000000568,1,2,250.0,249.85
27458,U871D4F,3,-5.970000000000001,2,1,6.0,0.03
27459,U89385F,3,-15.58,2,1,20.0,4.42
27460,U9DE0E4,3,5094.0,0,3,0.0,5094.0
27461,U582463,3,8000.0,1,2,40000.0,48000.0
27462,UBC3357,3,393.70000000000005,2,1,300.0,693.7
27463,U33EABE,3,1400.0,0,3,0.0,1400.0
27464,U014B58,3,215.0,1,2,5.0,220.0
27465,U0736E3,3,229.12,1,2,133.2,362.32
27466,U8F7751,3,2076.04,0,3,0.0,2076.04
27467,U8889E9,3,-17930.0,2,1,31230.0,13300.0
27468,U9F97E1,3,1000.11,0,3,0.0,1000.11
27469,U9311DA,3,847.1099999999997,1,2,7188.0,8035.11
27470,U19DADA,3,3849.0,2,1,10.0,3859.0
27471,U2F1C30,3,28952.3,1,2,220.0,29172.3
27472,U0BE6B7,3,0.02,1,2,0.02,0.04
27473,UDC2D82,3,0.0,2,1,200.0,200.0
27474,U25A8B9,3,-350.0,2,1,3240.0,2890.0
27475,U7DB4ED,3,20600.1,1,2,56.9,20657.0
27476,U6F3600,3,2145.5,1,2,21.0,2166.5
27477,UAB7D4A,3,4609.3,1,2,120.0,4729.3
27478,UEBDFF6,3,1.0,2,1,10.0,11.0
27479,UE6999B,3,5900.0,0,3,0.0,5900.0
27480,UD7187D,3,235.44,2,1,29.8,265.24
27481,UE64A12,3,8.0,2,1,332.0,340.0
27482,UC2404B,3,5500.0,0,3,0.0,5500.0
27483,UAE7941,3,-288.53,3,0,288.53,0.0
27484,UF5B31D,3,10.0,1,2,10.0,20.0
27485,UAC6E15,3,2.87,1,2,148.0,150.87
27486,U62601C,3,102.12,1,2,129.92,232.04
27487,U339B52,3,6.279999999999973,1,2,693.72,700.0
27488,U33214E,3,-2.8200000000000003,1,2,2.85,0.03
27489,U35C3C6,3,6160.6,0,3,0.0,6160.6
27490,U9CB664,3,-101.31999999999971,2,1,49400.0,49298.68
27491,UAD50F4,3,0.0,2,1,346.3,346.3
27492,UA2B67F,3,-5.95,2,1,6.0,0.05
27493,U6CD61D,3,395.16,1,2,271.0,666.16
27494,U1D2CA6,3,1.7763568394002505e-15,2,1,54.67,54.67
27495,UF55DAF,3,4000.04,0,3,0.0,4000.04
27496,U7919D0,3,-10999.47,2,1,11000.0,0.53
27497,UAE3F8F,3,12389.91,0,3,0.0,12389.91
27498,UBD7D68,3,21888.88,0,3,0.0,21888.88
27499,UC8E1B5,3,90.0,2,1,10.0,100.0
27500,UDCCC35,3,-5.890000000000001,2,1,6.0,0.11
27501,U82A19D,3,0.3500000000003638,2,1,9899.65,9900.0
27502,U98107E,3,316.0,1,2,2400.0,2716.0
27503,U6450C8,3,-837.0,2,1,910.0,73.0
27504,U4AC90F,3,0.07,1,2,0.07,0.14
27505,U8BFA78,3,1836.33,0,3,0.0,1836.33
27506,UD99F2A,3,0.0,1,2,10000.0,10000.0
27507,UB26DD6,3,1300.0,0,3,0.0,1300.0
27508,UD8C63A,3,-20.0,3,0,20.0,0.0
27509,U782CF9,3,4.009999999999991,1,2,1380.0,1384.01
27510,U07E542,3,3172.3599999999997,1,2,1005.0,4177.36
27511,U029A2D,3,819.65,1,2,200.0,1019.65
27512,U396B05,3,195.0,1,2,1325.0,1520.0
27513,UF36E21,3,-4809.3,3,0,4809.3,0.0
27514,U116378,3,-1.97,2,1,2.0,0.03
27515,U357865,3,-5.96,2,1,6.0,0.04
27516,U52D44E,3,30.599999999999994,1,2,132.72,163.32
27517,U95CFE5,3,-5.99,2,1,6.0,0.01
27518,UCFF478,3,-3715.1800000000003,3,0,3715.1800000000003,0.0
27519,UE95F82,3,1.1599999999999682,2,1,818.84,820.0
27520,U1212E1,3,1456.36,1,2,1148.74,2605.1
27521,UD8079C,3,-9.0,2,1,10.0,1.0
27522,UEEE903,3,-6355.0,2,1,7323.0,968.0
27523,UBBED92,3,-1766.59,2,1,1966.59,200.0
27524,U33C1CA,3,0.0,2,1,1469.0,1469.0
27525,U7EB3DE,3,445.5,1,2,838.0,1283.5
27526,U36C1C8,3,-5.0,2,1,1205.0,1200.0
27527,U1524FF,3,-5.98,2,1,6.0,0.02
27528,U737D08,3,943.9699999999999,2,1,139.35000000000002,1083.32
27529,UCEA6B4,3,0.0,2,1,1138.92,1138.92
27530,UB66F22,3,2.270000000000003,1,2,50.0,52.27
27531,U43560D,3,55.3,1,2,10.0,65.3
27532,UC89DBA,3,-18.0,2,1,33.0,15.0
27533,U13B64C,3,1009.28,2,1,113.0,1122.28
27534,U46E80E,3,125.19999999999999,2,1,374.8,500.0
27535,U5B0443,3,0.0,2,1,12680.0,12680.0
27536,U36BC89,3,-1.0,2,1,1.5899999999999999,0.59
27537,U1C8C9A,3,1340.0,0,3,0.0,1340.0
27538,U66CCBD,3,2749.0,1,2,2985.0,5734.0
27539,U674A7E,3,-3599.2200000000003,2,1,3600.0,0.78
27540,UC8DEC7,3,200.01,0,3,0.0,200.01
27541,U708100,3,2775.0299999999997,0,3,0.0,2775.0299999999997
27542,U7B2F83,3,-168.3,2,1,248.2,79.9
27543,UFCA4E8,3,-147.18,2,1,147.8,0.62
27544,U02440D,3,-2.7755575615628914e-17,2,1,0.41000000000000003,0.41
27545,U1A02EA,3,-496.26,2,1,498.26,2.0
27546,U6F65F1,3,-10000.0,2,1,10300.0,300.0
27547,UD4D78C,3,-150.0,3,0,150.0,0.0
27548,U459492,3,639.21,1,2,0.79,640.0
27549,U40E567,3,-11997.0,2,1,12000.0,3.0
27550,U0CE8BF,3,0.0,2,1,162.0,162.0
27551,U456CEB,3,15220.52,0,3,0.0,15220.52
27552,U6E2C1C,3,9914.0,1,2,7388.0,17302.0
27553,UF09154,3,1469.0,0,3,0.0,1469.0
27554,U815D33,3,2425.0,1,2,1000.0,3425.0
27555,U739865,3,-1.0,2,1,1.01,0.01
27556,UA92278,3,-1.0599999999999996,2,1,6.0,4.94
27557,U006208,3,0.0,2,1,200.0,200.0
27558,UCFBB34,3,-0.94,2,1,0.96,0.02
27559,UF7E1B8,3,-2995.0,2,1,3005.0,10.0
27560,UCFB0E8,3,-478.04,2,1,557.54,79.5
27561,UE0C536,3,-667.0,2,1,4615.0,3948.0
27562,UE15C7E,3,-382.6,3,0,382.6,0.0
27563,U2C8D83,3,-5111.53,2,1,5111.82,0.29
27564,U1EE277,3,5000.06,0,3,0.0,5000.06
27565,U846B40,3,-5.0,2,1,10.0,5.0
27566,U2BB785,3,206.0,0,3,0.0,206.0
27567,U0B2CBB,3,2974.8,1,2,5000.0,7974.8
27568,UD80878,3,351.6399999999999,1,2,3148.36,3500.0
27569,UEFB909,3,-1751.0,1,2,2500.0,749.0
27570,UD763B0,3,664.8199999999999,1,2,435.18,1100.0
27571,U71C4CC,3,-1000.0,1,2,16000.0,15000.0
27572,U30AAC2,3,0.0,2,1,106.3,106.3
27573,U1988E2,3,13000.01,0,3,0.0,13000.01
27574,U0E46EC,3,560.0,0,3,0.0,560.0
27575,UD9C305,3,-16850.0,2,1,17150.0,300.0
27576,U8F875B,3,0.01,1,2,268.98,268.99
27577,UE1E61B,3,30.039999999999964,1,2,3950.0,3980.04
27578,UC44E7A,3,-13226.69,2,1,13230.0,3.31
27579,U93B389,3,4700.0,0,3,0.0,4700.0
27580,U120720,3,2847.56,0,3,0.0,2847.56
27581,U7C6825,3,2800.0,0,3,0.0,2800.0
27582,UC5CE92,3,5000.0,0,3,0.0,5000.0
27583,UF6F079,3,-5.99,2,1,6.0,0.01
27584,UDF9013,3,0.020000000000000018,1,2,0.61,0.63
27585,U1FE62E,3,-300.0,2,1,300.01,0.01
27586,U7C8499,3,-1251.55,2,1,1252.3999999999999,0.85
27587,U4D5FCC,3,-6865.0,2,1,15065.0,8200.0
27588,U25AEBF,3,-3010.0,1,2,12886.0,9876.0
27589,U5B1B8F,3,-3.0,2,1,455.61,452.61
27590,U14BED8,3,19.799999999999997,1,2,67.62,87.42
27591,U56CF46,3,-9730.05,2,1,9730.06,0.01
27592,U585879,3,415.1500000000001,1,2,710.0,1125.15
27593,U3F2C24,3,0.12000000000000455,1,2,260.74,260.86
27594,U60A4DB,3,900.0,1,2,1600.0,2500.0
27595,U22D78D,3,299.5,1,2,299.5,599.0
27596,U542B59,3,-20000.0,2,1,20300.0,300.0
27597,U898396,3,390.0,2,1,10.0,400.0
27598,UF9B7CC,3,3995.0,1,2,3800.0,7795.0
27599,U3AA684,3,71.84999999999991,1,2,4000.0,4071.85
27600,UC7C665,3,1467.03,0,3,0.0,1467.03
27601,UAF4DCE,3,0.06,1,2,225.0,225.06
27602,UA2EF4E,3,-178.29999999999995,1,2,1985.0,1806.7
27603,U567565,3,0.0,2,1,10.0,10.0
27604,U3CB47A,3,0.3199999999999932,1,2,488.76,489.08
27605,U981DC5,3,12.71,1,2,12.0,24.71
27606,UB5386B,3,19.0,1,2,22978.0,22997.0
27607,U6119DC,3,-5.76,2,1,6.0,0.24
27608,U09D1AC,3,87.02999999999997,1,2,463.0,550.03
27609,UD5DAB0,3,79.44,1,2,79.44,158.88
27610,U9B86F1,3,-9380.0,3,0,9380.0,0.0
27611,UA1A78A,3,0.0,1,2,10000.0,10000.0
27612,U6D5E5C,3,130.0,1,2,139.0,269.0
27613,U58EA4E,3,3438.7,1,2,277.66,3716.3599999999997
27614,UBB727E,3,7000.0,0,3,0.0,7000.0
27615,U0F0EC3,3,-6512.74,2,1,6797.74,285.0
27616,U80BF72,3,989.25,2,1,2110.75,3100.0
27617,U15FEB1,3,0.0,2,1,176.77,176.77
27618,UD6F906,3,-4376.6,3,0,4376.6,0.0
27619,UE30563,3,-5.88,2,1,6.0,0.12
27620,U2A6BCF,3,3000.0,1,2,621.0,3621.0
27621,U7ED2B1,3,-5.9,2,1,6.0,0.1
27622,UC3FC41,3,2.1300000000000523,1,2,272.15,274.28000000000003
27623,UEE7F39,3,1080.0,1,2,5800.0,6880.0
27624,U946617,3,0.0,1,2,41680.0,41680.0
27625,UA60E55,3,0.09,1,2,90.86,90.95
27626,U4958CE,3,-435.6,3,0,435.6,0.0
27627,U3881A0,3,1.0,2,1,2199.0,2200.0
27628,U81DB22,3,0.3100000000000023,1,2,181.0,181.31
27629,UFD948F,3,-3589.5299999999997,3,0,3589.5299999999997,0.0
27630,U8A8CB8,3,523.0,0,3,0.0,523.0
27631,U0E7686,3,-35473.57,2,1,35533.2,59.63
27632,U7742DF,3,0.0,2,1,19.5,19.5
27633,U0423FC,3,-7067.929999999993,1,2,65768.0,58700.07
27634,UE4D69D,3,-104.32000000000001,2,1,104.4,0.08
27635,U738141,3,223.89999999999998,2,1,76.1,300.0
27636,U8620FE,3,310.0,1,2,1000.0,1310.0
27637,U46EE54,3,0.0,2,1,550.12,550.12
27638,UD4E5E8,3,-160.0,3,0,160.0,0.0
27639,U3731FA,3,3027.0299999999997,1,2,281.0,3308.0299999999997
27640,U9B469D,3,-543.4799999999999,2,1,573.4799999999999,30.0
27641,UA93270,3,-487.20000000000005,3,0,487.20000000000005,0.0
27642,UFD9B0A,3,94.7,1,2,39.0,133.7
27643,U740D5A,3,-99.86,1,2,100.0,0.14
27644,U7DBBA3,3,3000.0,0,3,0.0,3000.0
27645,U2AE9EF,3,157.37,2,1,314.74,472.11
27646,UC8286E,3,100.03999999999999,2,1,399.96000000000004,500.0
27647,U3DFEEA,3,104.28000000000003,1,2,325.9,430.18
27648,U0C95FB,3,6774.78,2,1,285.38,7060.16
27649,U0E94B8,3,0.010000000000218279,1,2,5239.0,5239.01
27650,UB6A28B,3,2280.0,1,2,2520.0,4800.0
27651,UCA6532,3,0.01,1,2,18.81,18.82
27652,UF6985E,3,-1266.8600000000001,2,1,1269.0,2.14
27653,U77A049,3,0.009999999999999787,1,2,14.56,14.57
27654,U42A521,3,-40.94,3,0,40.94,0.0
27655,U63B69D,3,30350.17,0,3,0.0,30350.17
27656,U7A593F,3,-425.59000000000003,3,0,425.59000000000003,0.0
27657,U2EBF74,3,251.09,1,2,98.0,349.09000000000003
27658,U065A5D,3,-3239.0,2,1,3239.01,0.01
27659,U55FA31,3,100.0,1,2,3963.0,4063.0
27660,U7DE807,3,4001.01,1,2,999.0,5000.01
27661,U2E55D0,3,895.02,1,2,5.0,900.02
27662,U1826F6,3,39.42000000000001,1,2,172.98,212.4
27663,U520170,3,2310.76,1,2,60.0,2370.76
27664,U310F26,3,-374.7800000000001,1,2,930.21,555.4300000000001
27665,U354296,3,93.62,0,3,0.0,93.62
27666,U4F0440,3,8497.9,1,2,1500.0,9997.9
27667,UF2161B,3,-2291.7599999999998,2,1,2301.7,9.94
27668,U8DA85B,3,0.0,2,1,10.0,10.0
27669,UA9E79D,3,7.105427357601002e-15,2,1,238.9,238.9
27670,U8F0E37,3,0.0,1,2,1012.0,1012.0
27671,U195F57,3,350.0,1,2,3600.0,3950.0
27672,U5FE417,3,2475.0,0,3,0.0,2475.0
27673,UB91599,3,-1500.0,1,2,2500.0,1000.0
27674,UED82E4,3,18.0,0,3,0.0,18.0
27675,UAAEC10,3,446.38,1,2,63.0,509.38
27676,U329208,3,0.03,1,2,0.07,0.1
27677,UC518A2,3,0.0,2,1,459.0,459.0
27678,UE288EA,3,0.0,2,1,3253.0,3253.0
27679,UC09D86,3,5.0,1,2,100.0,105.0
27680,UB6A481,3,-518.0,2,1,1111.56,593.56
27681,U6321D9,3,0.24000000000000002,0,3,0.0,0.24000000000000002
27682,UE3780F,3,-1175.0,1,2,5000.0,3825.0
27683,UAD1617,3,0.06999999999999318,2,1,119.93,120.0
27684,UB3722A,3,596.0,1,2,19108.0,19704.0
27685,UF8B175,3,-7987.87,1,2,8000.0,12.13
27686,U9DCDD2,3,2261.6200000000003,2,1,237.24,2498.86
27687,U282295,3,35777.78000000003,1,2,344000.0,379777.78
27688,U7D9FE0,3,0.4900000000000002,2,1,2.0,2.49
27689,UDDC35A,3,1600.71,1,2,362.0,1962.71
27690,UFB24BF,3,-941.73,3,0,941.73,0.0
27691,U3352C5,3,-3.95,2,1,4.0,0.05
27692,UF0A0A7,3,3276.01,0,3,0.0,3276.01
27693,UFC15E0,3,0.0,1,2,3000.0,3000.0
27694,U559136,3,1490.0,2,1,10.0,1500.0
27695,UBE96C6,3,161027.78,0,3,0.0,161027.78
27696,U0C9123,3,40.0,1,2,320.0,360.0
27697,UD7E32B,3,-20000.0,2,1,40000.0,20000.0
27698,U2A5D0C,3,2.540000000000873,1,2,56000.0,56002.54
27699,U3C39D4,3,-38400.0,3,0,38400.0,0.0
27700,U3382D0,3,-1.99,2,1,2.0,0.01
27701,U639B0A,3,-2820.01,2,1,2821.01,1.0
27702,UFA36AD,3,0.0,1,2,4999.0,4999.0
27703,UE66514,3,19.16,1,2,2.84,22.0
27704,U218D05,3,-13.389999999999986,2,1,190.39,177.0
27705,UFC8796,3,2.209999999999127,1,2,50000.0,50002.21
27706,U0EB2B9,3,-3075.0,1,2,3125.0,50.0
27707,UA94E86,3,-329.0,2,1,9327.0,8998.0
27708,UA0AAE1,3,88.0,1,2,69.0,157.0
27709,U1104DE,3,-5.97,2,1,6.0,0.03
27710,U1C4292,3,-164.9000000000001,2,1,1063.9,899.0
27711,U9BEBEA,3,2134.55,1,2,500.0,2634.55
27712,UF0926F,3,-7820.969999999999,1,2,8999.97,1179.0
27713,UF912AC,3,-1506.84,2,1,1528.8,21.96
27714,U0672F0,3,-1025.14,2,1,2290.0,1264.86
27715,U527749,3,-3994.0,2,1,7992.0,3998.0
27716,U31DDCC,3,1055.0,1,2,5.0,1060.0
27717,U343F91,3,0.01,1,2,5.0,5.01
27718,U64E553,3,0.0,1,2,320.0,320.0
27719,U7D615C,3,-1.46,2,1,2.0,0.54
27720,U27E9C8,3,-307.09,2,1,507.09,200.0
27721,U1FA600,3,-5540.0,3,0,5540.0,0.0
27722,UCF2F49,3,9600.0,0,3,0.0,9600.0
27723,UFC362F,3,0.0,2,1,211.3,211.3
27724,UA291E1,3,-2560.0,2,1,4560.0,2000.0
27725,UD3D618,3,9.0,1,2,4950.0,4959.0
27726,U59EF6F,3,100.10000000000002,2,1,399.9,500.0
27727,U660194,3,1.0,2,1,919.0,920.0
27728,U0921C3,3,-100.0,2,1,1100.0,1000.0
27729,U64E3A6,3,3.99,2,1,1.01,5.0
27730,UF73715,3,1370.0,0,3,0.0,1370.0
27731,U34DFFD,3,-493.0,2,1,671.0,178.0
27732,UB15819,3,20.05,0,3,0.0,20.05
27733,U20533F,3,-316.5799999999999,1,2,1500.0,1183.42
27734,U1F639D,3,-5270.0,2,1,10460.0,5190.0
27735,UF6BEA4,3,-5.99,2,1,6.0,0.01
27736,UAE1DAC,3,933.58,0,3,0.0,933.58
27737,U3B118C,3,-5.95,2,1,6.0,0.05
27738,UDD78A9,3,-17425.02,2,1,17925.02,500.0
27739,U961B16,3,550.7999999999998,1,2,886.42,1437.2199999999998
27740,UA60CAF,3,35.30000000000001,1,2,159.56,194.86
27741,UF06CC8,3,7997.94,1,2,28.0,8025.94
27742,U7EB5DE,3,-0.03,3,0,0.03,0.0
27743,U488D96,3,-5000.0,2,1,7500.0,2500.0
27744,U982A9A,3,-65.63,2,1,174.6,108.97
27745,U5C71DD,3,1308.42,1,2,20.8,1329.22
27746,U48B660,3,8.673617379884035e-18,2,1,1.0,1.0
27747,UC654D5,3,30.0,1,2,17328.0,17358.0
27748,UEBB356,3,1999.0,1,2,8000.0,9999.0
27749,UA49D52,3,420.0,2,1,10.0,430.0
27750,UF6B321,3,300.0,2,1,10.0,310.0
27751,UE2EC3C,3,0.16000000000000014,2,1,6.0,6.16
27752,U481A80,3,-1000.0,2,1,2000.0,1000.0
27753,U75485A,3,-7718.0,3,0,7718.0,0.0
27754,U47BB05,3,0.0,2,1,4400.0,4400.0
27755,U91F38F,3,-338.0,2,1,473.01,135.01
27756,U5153F3,3,200.01,0,3,0.0,200.01
27757,UD977D6,3,-5060.0,2,1,6060.0,1000.0
27758,U7C7EC1,3,1853.0900000000001,1,2,1700.0,3553.09
27759,U53B0AF,3,5.86,1,2,40000.0,40005.86
27760,UD82D4C,3,-5.0,2,1,10.0,5.0
27761,UD71109,3,3923.0,1,2,3577.0,7500.0
27762,U172679,3,-1800.0,2,1,27900.0,26100.0
27763,U657F91,3,202.01,1,2,1300.0,1502.01
27764,U6F36BA,3,-1310.0,3,0,1310.0,0.0
27765,U714102,3,13.260000000000218,1,2,5006.8,5020.06
27766,UB09F89,3,3900.0,0,3,0.0,3900.0
27767,U06A37D,3,2155.16,1,2,46.0,2201.16
27768,UABC31D,3,11000.0,0,3,0.0,11000.0
27769,UDF6ECD,3,0.03,1,2,0.03,0.06
27770,U74A4F4,3,-5.99,2,1,6.0,0.01
27771,U7D8A8E,3,6.0,1,2,6.0,12.0
27772,U3143AF,3,4000.0,1,2,4000.0,8000.0
27773,UFC4B72,3,-10.56,3,0,10.56,0.0
27774,U0FFE79,3,19624.97,0,3,0.0,19624.97
27775,UC4CB16,3,96.5,1,2,36.5,133.0
27776,U29724E,3,1098.65,1,2,1728.0,2826.65
27777,U636AB3,3,-10000.0,2,1,13512.0,3512.0
27778,UB37549,3,3.0,1,2,50.0,53.0
27779,U5B0F9F,3,-119.0,2,1,1399.0,1280.0
27780,UEC5DB0,3,-87.23,2,1,87.7,0.47
27781,U1A50DB,3,9510.0,1,2,390.0,9900.0
27782,UDF56DB,3,-758.5699999999999,2,1,759.0,0.43
27783,U8FCADE,3,0.010000000000001563,1,2,30.0,30.01
27784,U638025,3,0.03,1,2,25.0,25.03
27785,U1B7084,3,197.6,2,1,1042.4,1240.0
27786,U646615,3,3658.76,0,3,0.0,3658.76
27787,UA2C536,3,100.05,0,3,0.0,100.05
27788,U5A8D88,3,-3364.0,3,0,3364.0,0.0
27789,U6539E5,3,3995.0,1,2,3892.0,7887.0
27790,UA34726,3,-2117.0,1,2,3000.0,883.0
27791,UA24056,3,-5.900000000000091,1,2,3027.0,3021.1
27792,UF49EFB,3,516.25,1,2,1200.0,1716.25
27793,U793674,3,3592.5,1,2,3000.0,6592.5
27794,U37C15D,3,-78.0,2,1,278.0,200.0
27795,U226A90,3,-7988.0,2,1,15988.0,8000.0
27796,U7DE3BF,3,-223.8,3,0,223.8,0.0
27797,U25F3FE,3,2.26,1,2,7.74,10.0
27798,U1B2047,3,289.62,1,2,114.0,403.62
27799,U5C9E08,3,7.105427357601002e-15,1,2,221.0,221.0
27800,UB0CF66,3,1.4210854715202004e-14,2,1,199.8,199.8
27801,U5CCB7C,3,45.85,2,1,62.15,108.0
27802,U0B78C2,3,755.1199999999999,2,1,1515.0,2270.12
27803,U5E8432,3,-19.07,2,1,20.0,0.93
27804,UD131CA,3,-20.0,2,1,354.3,334.3
27805,U1EB40E,3,0.0,2,1,385.0,385.0
27806,UD6A317,3,21.270000000000003,0,3,0.0,21.270000000000003
27807,U2FC05C,3,1290.0,0,3,0.0,1290.0
27808,UA738DA,3,147.0,2,1,1148.0,1295.0
27809,UF61B67,3,-83.12,2,1,192.24,109.12
27810,U2309D5,3,-0.26,2,1,0.28,0.02
27811,UDB1FB4,3,106.94,0,3,0.0,106.94
27812,U60A389,3,500.0,1,2,300.0,800.0
27813,U86431C,3,62.0,1,2,298.0,360.0
27814,U94CE8A,3,-14.99,2,1,15.0,0.01
27815,UC33F36,3,93.0,1,2,79.0,172.0
27816,U171FB2,3,4907.08,0,3,0.0,4907.08
27817,U92ECB1,3,-5.890000000000001,2,1,6.0,0.11
27818,U3628EE,3,90.0,2,1,4000.0,4090.0
27819,U3C721F,3,17899.299999999996,1,2,23346.45,41245.75
27820,U2076C4,3,-153.7,2,1,153.70999999999998,0.01
27821,UC0BFBE,3,-135.0,3,0,135.0,0.0
27822,UD235C4,3,86.0,1,2,5.0,91.0
27823,U2D243F,3,5.0,2,1,10.0,15.0
27824,UA073D8,3,1000.0,1,2,2503.0,3503.0
27825,U122D02,3,2448.88,0,3,0.0,2448.88
27826,U2C93F2,3,-1074.2,2,1,1079.2,5.0
27827,U0A70B2,3,403.89,2,1,533.26,937.15
27828,UBFD255,3,0.0,1,2,119.8,119.8
27829,U499074,3,-12929.0,2,1,19825.0,6896.0
27830,U60422E,3,-5.0,2,1,10.0,5.0
27831,U35573D,3,0.0,2,1,12.0,12.0
27832,U59A948,3,-1838.0,3,0,1838.0,0.0
27833,U952684,3,347.0,2,1,2353.0,2700.0
27834,U2AA013,3,-30000.0,1,2,50000.0,20000.0
27835,UD91A85,3,174.9400000000005,1,2,5125.2,5300.14
27836,UF514BA,3,-204.17999999999998,2,1,204.2,0.02
27837,U73E4B8,3,-5.99,2,1,6.0,0.01
27838,UA24D3F,3,0.009999999999990905,1,2,1895.0,1895.01
27839,UC64EBE,3,-5.97,2,1,6.0,0.03
27840,U91314D,3,-447.40999999999997,3,0,447.40999999999997,0.0
27841,UD70FE0,3,49.0,2,1,1451.0,1500.0
27842,UB078D7,3,1998.0,0,3,0.0,1998.0
27843,U97200B,3,-1275.0,3,0,1275.0,0.0
27844,U6D044B,3,2000.0,0,3,0.0,2000.0
27845,U9C2114,3,381.4,1,2,99.0,480.4
27846,UBC889F,3,890.0,2,1,10.0,900.0
27847,U700419,3,3605.73,0,3,0.0,3605.73
27848,UD78A7A,3,-52002.19,2,1,52172.0,169.81
27849,UCF891C,3,5.0,1,2,7995.0,8000.0
27850,UB7ACE7,3,-1030.68,3,0,1030.68,0.0
27851,U62B731,3,0.0,1,2,2980.0,2980.0
27852,UAEAB26,3,-1219.0,1,2,2626.0,1407.0
27853,U305DD5,3,1630.0,0,3,0.0,1630.0
27854,UB5DF9D,3,7051.82,1,2,1165.0,8216.82
27855,U673EAF,3,0.0,1,2,9000.0,9000.0
27856,U3D5B1E,3,-180.0,2,1,16000.0,15820.0
27857,UB11D20,3,-4707.0,1,2,5947.0,1240.0
27858,U0545E7,3,1240.15,1,2,25.0,1265.15
27859,UCCA4D6,3,-4412.49,2,1,4417.82,5.33
27860,UE24548,3,65.0,0,3,0.0,65.0
27861,UCF66A2,3,-1.99,2,1,2.0,0.01
27862,U320155,3,-447.35,2,1,597.35,150.0
27863,U1D56B5,3,-179.86000000000013,1,2,1500.0,1320.1399999999999
27864,UB391DC,3,45.800000000000004,1,2,8.9,54.7
27865,UCF0808,3,296.6199999999999,1,2,2696.38,2993.0
27866,U46E800,3,-9458.0,3,0,9458.0,0.0
27867,UFE56A8,3,4691.999999999999,2,1,5387.8,10079.8
27868,U657667,3,110000.0,0,3,0.0,110000.0
27869,UB9A345,3,13713.34,1,2,4000.0,17713.34
27870,UD874CF,3,900.0,2,1,2200.0,3100.0
27871,UF94E4C,3,-5.99,2,1,6.0,0.01
27872,U5D5515,3,-924.09,2,1,934.09,10.0
27873,U6C03BE,3,534.0,1,2,4931.0,5465.0
27874,U7B45C9,3,-19.0,2,1,1018.99,999.99
27875,U302A53,3,790.0,2,1,10.0,800.0
27876,UDB15E3,3,-5000.0,2,1,10000.0,5000.0
27877,UCA56F6,3,-19.64,2,1,20.0,0.36
27878,U09FBBC,3,-1700.0,2,1,3733.0,2033.0
27879,U1AAFB2,3,4310.0,1,2,9045.0,13355.0
27880,U74810D,3,-6.88,1,2,7.0,0.12000000000000001
27881,U1847FB,3,-1548.7,1,2,1610.0,61.3
27882,U7F0584,3,-457.0,1,2,2020.0,1563.0
27883,U7A58D1,3,4004.5,0,3,0.0,4004.5
27884,U65AF5B,3,0.24000000000000002,0,3,0.0,0.24000000000000002
27885,U39CC1A,3,-10000.0,2,1,26000.0,16000.0
27886,U8A3FC0,3,0.00999999999999801,1,2,40.0,40.01
27887,U821F81,2,0.0,1,1,100.0,100.0
27888,U738290,2,0.0,1,1,100.0,100.0
27889,U04303E,2,219.20000000000005,1,1,680.8,900.0
27890,UC775EE,2,519.63,0,2,0.0,519.63
27891,U0A87C0,2,351.93,0,2,0.0,351.93
27892,U97E1A1,2,-776.59,1,1,777.19,0.6
27893,UEBF14E,2,-35.41,1,1,35.43,0.02
27894,U4BFB56,2,0.0,1,1,1.0,1.0
27895,U3B0FF3,2,0.0,1,1,371.0,371.0
27896,U4ADA6A,2,1952.01,0,2,0.0,1952.01
27897,U38E971,2,-1966.59,2,0,1966.59,0.0
27898,U993435,2,0.0,1,1,0.01,0.01
27899,U9330A8,2,0.0,1,1,100.0,100.0
27900,UD1B8DF,2,1.1,0,2,0.0,1.1
27901,U743300,2,876.0899999999999,0,2,0.0,876.0899999999999
27902,U5E2538,2,23499.5,0,2,0.0,23499.5
27903,U351238,2,0.0,1,1,394.31,394.31
27904,UEEA1BF,2,1.01,0,2,0.0,1.01
27905,UD13E32,2,0.0,1,1,10.0,10.0
27906,UD77303,2,1.33,0,2,0.0,1.33
27907,U81F199,2,1230.0,0,2,0.0,1230.0
27908,U261B85,2,-3030.0,2,0,3030.0,0.0
27909,UE0938A,2,-10.0,2,0,10.0,0.0
27910,U459AD0,2,0.02,0,2,0.0,0.02
27911,U074218,2,0.0,1,1,300.0,300.0
27912,UF1F12D,2,-10.0,2,0,10.0,0.0
27913,UF28B14,2,12100.0,0,2,0.0,12100.0
27914,U985622,2,-10.0,2,0,10.0,0.0
27915,UD25436,2,20.0,0,2,0.0,20.0
27916,UFFE8D9,2,26.57,0,2,0.0,26.57
27917,U806641,2,99.0,1,1,900.0,999.0
27918,U60C625,2,-10.0,2,0,10.0,0.0
27919,UA6387B,2,12.0,0,2,0.0,12.0
27920,UB6CE66,2,794.31,0,2,0.0,794.31
27921,U5D9587,2,0.0,1,1,36.0,36.0
27922,U713F1D,2,400.0,0,2,0.0,400.0
27923,UDE7413,2,55.0,0,2,0.0,55.0
27924,U8F5E88,2,32713.0,0,2,0.0,32713.0
27925,U3E8458,2,0.93,0,2,0.0,0.93
27926,U895825,2,805.57,0,2,0.0,805.57
27927,UE15231,2,-909.6999999999999,2,0,909.6999999999999,0.0
27928,UDB8136,2,0.0,1,1,5.5,5.5
27929,U31BDBB,2,-44.739999999999995,2,0,44.739999999999995,0.0
27930,UA87A42,2,-90.05,2,0,90.05,0.0
27931,UF63DC5,2,0.0,1,1,300.0,300.0
27932,UF1816A,2,0.0,1,1,0.34,0.34
27933,U87214A,2,-10.0,2,0,10.0,0.0
27934,U494DF1,2,1620.08,0,2,0.0,1620.08
27935,U015DD5,2,-10.0,2,0,10.0,0.0
27936,UCD5DC3,2,5234.74,0,2,0.0,5234.74
27937,UA83333,2,0.0,1,1,615.0,615.0
27938,U6DE474,2,0.0,1,1,0.01,0.01
27939,UDD82AE,2,202.28,0,2,0.0,202.28
27940,UC00B12,2,-192.54999999999998,2,0,192.54999999999998,0.0
27941,UDE7B9F,2,-0.96,1,1,1.0,0.04
27942,U1F2E1A,2,-10.0,2,0,10.0,0.0
27943,U799547,2,0.0,1,1,100.0,100.0
27944,UFFF9D8,2,-1996.0,2,0,1996.0,0.0
27945,U91BD8D,2,91.0,1,1,909.0,1000.0
27946,UB31EDB,2,1764.73,0,2,0.0,1764.73
27947,U780BE0,2,713.0,0,2,0.0,713.0
27948,U0643E4,2,1040.0,1,1,10.0,1050.0
27949,U592DDB,2,1697.4499999999998,0,2,0.0,1697.4499999999998
27950,U155302,2,-20.0,1,1,59.0,39.0
27951,UD69672,2,0.0,1,1,2.0,2.0
27952,UB71A70,2,0.0,1,1,12900.0,12900.0
27953,U807313,2,-10.0,2,0,10.0,0.0
27954,U0C7EC7,2,-2.0,2,0,2.0,0.0
27955,U4406CA,2,600.0,0,2,0.0,600.0
27956,U648538,2,11.0,0,2,0.0,11.0
27957,UB71E67,2,-10.0,2,0,10.0,0.0
27958,U7BCCAE,2,-10.0,2,0,10.0,0.0
27959,U195638,2,0.03,0,2,0.0,0.03
27960,UFEE556,2,1500.0,0,2,0.0,1500.0
27961,UFC3882,2,-91.87,2,0,91.87,0.0
27962,U98A1D9,2,0.0,1,1,90.0,90.0
27963,U4DD785,2,100.03,0,2,0.0,100.03
27964,U759F0C,2,-10.0,2,0,10.0,0.0
27965,U3448A1,2,4110.0,0,2,0.0,4110.0
27966,U410096,2,5000.0,0,2,0.0,5000.0
27967,UBA6227,2,0.0,1,1,3.0,3.0
27968,UFD812F,2,-1.94,1,1,2.0,0.06
27969,U7ACF71,2,200.0,0,2,0.0,200.0
27970,UCF6EF0,2,0.5099999999999998,1,1,5.0,5.51
27971,U9A927D,2,400.0,0,2,0.0,400.0
27972,UF4B46B,2,-233.3100000000004,1,1,4880.0,4646.69
27973,U8498BA,2,-6315.3,2,0,6315.3,0.0
27974,U9E9D6D,2,0.0,1,1,45.0,45.0
27975,U97C5E9,2,2.03,0,2,0.0,2.03
27976,U275772,2,290.0,1,1,910.0,1200.0
27977,U468FFC,2,1.0,1,1,0.01,1.01
27978,U02F1CC,2,0.13,1,1,0.01,0.14
27979,U162355,2,1679.6599999999999,0,2,0.0,1679.6599999999999
27980,U0484A1,2,-15.0,1,1,3980.0,3965.0
27981,U0274E7,2,0.0,1,1,0.3,0.3
27982,UD626A7,2,16.0,0,2,0.0,16.0
27983,U5A3153,2,45.0,0,2,0.0,45.0
27984,UF6E9DC,2,7322.0,0,2,0.0,7322.0
27985,U420E93,2,3897.5699999999997,0,2,0.0,3897.5699999999997
27986,U46A990,2,1400.0,0,2,0.0,1400.0
27987,U55609B,2,-99.0,1,1,2998.0,2899.0
27988,UDE134D,2,1800.0,0,2,0.0,1800.0
27989,U2CE38E,2,2281.82,0,2,0.0,2281.82
27990,U30C1CD,2,-3134.99,2,0,3134.99,0.0
27991,UAC8E31,2,402.7,1,1,35.0,437.7
27992,U11FD62,2,447.33000000000004,1,1,187.0,634.33
27993,U398FD4,2,-25835.39,2,0,25835.39,0.0
27994,UAFDD8E,2,-10.0,2,0,10.0,0.0
27995,U037B6F,2,4814.72,0,2,0.0,4814.72
27996,UF04458,2,-10.0,2,0,10.0,0.0
27997,U948C74,2,-10.0,2,0,10.0,0.0
27998,UA41DCC,2,12.01,0,2,0.0,12.01
27999,U4B6668,2,6600.0,0,2,0.0,6600.0
28000,U14F6C3,2,1470.0,0,2,0.0,1470.0
28001,UD152E0,2,-675.16,2,0,675.16,0.0
28002,U9555EC,2,0.13999999999999999,0,2,0.0,0.13999999999999999
28003,UE3918B,2,1.0999999999999943,1,1,148.0,149.1
28004,UF13578,2,133.0,0,2,0.0,133.0
28005,U30E89A,2,0.0,1,1,2000.0,2000.0
28006,UB2EA13,2,0.0,1,1,6950.0,6950.0
28007,UE56B19,2,-10.0,2,0,10.0,0.0
28008,U9ABDC3,2,0.0,1,1,100.0,100.0
28009,U86396E,2,-192.26999999999998,1,1,497.0,304.73
28010,UE2559F,2,-10.0,2,0,10.0,0.0
28011,U72235C,2,-20.0,2,0,20.0,0.0
28012,U4FA238,2,-2950.9,2,0,2950.9,0.0
28013,U5BFFC1,2,-6087.0,2,0,6087.0,0.0
28014,UFAAFD8,2,6274.0,1,1,7088.0,13362.0
28015,U21FE96,2,0.0,1,1,5.0,5.0
28016,U45FE3B,2,0.0,1,1,300.0,300.0
28017,UAC96E4,2,-4.54,1,1,5.0,0.46
28018,U267BF6,2,110.0,0,2,0.0,110.0
28019,U9BF1C5,2,60.0,1,1,360.0,420.0
28020,U90767D,2,1580.24,0,2,0.0,1580.24
28021,U8A2402,2,-10.49,1,1,10.57,0.08
28022,U0C1BC4,2,-39.95,1,1,40.0,0.05
28023,U216FAE,2,-23.5,2,0,23.5,0.0
28024,U3EF49F,2,0.0,1,1,136.0,136.0
28025,UFF579C,2,-1677.02,2,0,1677.02,0.0
28026,U6AD047,2,197.0,1,1,4628.0,4825.0
28027,U988916,2,9.99,1,1,0.01,10.0
28028,U080CCF,2,16138.88,0,2,0.0,16138.88
28029,UA0957E,2,-10.0,2,0,10.0,0.0
28030,U9EA9DE,2,-0.5399999999999991,1,1,25.0,24.46
28031,U289B0D,2,0.0,1,1,3283.15,3283.15
28032,U3B8076,2,325.41,0,2,0.0,325.41
28033,U06CEC3,2,8004.61,0,2,0.0,8004.61
28034,U27FA93,2,-49969.15,1,1,50000.0,30.85
28035,UE4EBF4,2,9054.04,0,2,0.0,9054.04
28036,UA90B97,2,10000.0,0,2,0.0,10000.0
28037,U8E7B93,2,0.0,1,1,0.75,0.75
28038,UB717F3,2,0.0,1,1,100.0,100.0
28039,U5D23D3,2,10.0,0,2,0.0,10.0
28040,U36C096,2,-10.0,2,0,10.0,0.0
28041,UF1B290,2,-2924.0,1,1,11912.0,8988.0
28042,U3A44F0,2,0.0,1,1,9400.0,9400.0
28043,U54B7DE,2,-542.48,1,1,600.0,57.52
28044,U2ED320,2,0.0,1,1,631.0,631.0
28045,UF126A9,2,-10.0,2,0,10.0,0.0
28046,UE107D0,2,3.0600000000000023,1,1,22.24,25.3
28047,U20D2B5,2,-44.7,2,0,44.7,0.0
28048,UFD3B13,2,-165.0,2,0,165.0,0.0
28049,U09585C,2,-10.0,2,0,10.0,0.0
28050,U0B7216,2,0.0,1,1,49.96,49.96
28051,U2C843C,2,-10.0,2,0,10.0,0.0
28052,U90AF47,2,-3914.0,1,1,4710.0,796.0
28053,UE49F18,2,-446.68,2,0,446.68,0.0
28054,U4788FB,2,200.0,0,2,0.0,200.0
28055,UE2C179,2,0.009999999999990905,1,1,1000.0,1000.01
28056,U5B5E08,2,-10.0,2,0,10.0,0.0
28057,U9E9700,2,3060.96,0,2,0.0,3060.96
28058,UAB9B42,2,-200.0,1,1,3000.0,2800.0
28059,U78CBAF,2,-10.0,2,0,10.0,0.0
28060,UBBC858,2,-10.0,2,0,10.0,0.0
28061,U35BE54,2,1750.0,0,2,0.0,1750.0
28062,UFCEB9B,2,45.0,1,1,346.0,391.0
28063,U33B1B6,2,0.0,1,1,10.0,10.0
28064,U291A3A,2,-373.55,2,0,373.55,0.0
28065,UD0FDE9,2,-136.98,2,0,136.98,0.0
28066,UAC0B76,2,9.62,1,1,0.38,10.0
28067,U4C2F53,2,-7375.07,2,0,7375.07,0.0
28068,U5C72F7,2,1700.0,1,1,300.0,2000.0
28069,UE62DDC,2,166.0,1,1,198.0,364.0
28070,U5865D4,2,0.0,1,1,5000.0,5000.0
28071,UDC4ACA,2,13.76,0,2,0.0,13.76
28072,U9D47A0,2,-0.10000000000002274,1,1,1000.0,999.9
28073,UA6F312,2,-10.0,2,0,10.0,0.0
28074,U43DBF8,2,-0.030000000000001137,1,1,19.0,18.97
28075,U309A82,2,0.0,1,1,0.01,0.01
28076,U39C7F6,2,0.0,1,1,4200.0,4200.0
28077,UACA3A0,2,0.0,1,1,4179.0,4179.0
28078,U1376E8,2,150.0,0,2,0.0,150.0
28079,UB5FBB0,2,0.0,1,1,299.0,299.0
28080,U9621EC,2,47.86,1,1,44.14,92.0
28081,U5918B8,2,-976.39,1,1,1000.0,23.61
28082,U3E8606,2,-44.0,1,1,74.0,30.0
28083,U5F0D48,2,-4.74,2,0,4.74,0.0
28084,UC2586D,2,-20.0,2,0,20.0,0.0
28085,UE7D038,2,-1395.0,1,1,1950.0,555.0
28086,U653F68,2,-10.0,2,0,10.0,0.0
28087,U3D8EF7,2,0.0,1,1,223.0,223.0
28088,U8DE4EE,2,3000.0,0,2,0.0,3000.0
28089,U36C284,2,-10.0,2,0,10.0,0.0
28090,UEBADC3,2,20.0,0,2,0.0,20.0
28091,UAF2ED8,2,232.0,1,1,976.0,1208.0
28092,UFBDB16,2,998.89,0,2,0.0,998.89
28093,U7E6B02,2,400.0,0,2,0.0,400.0
28094,UFED024,2,0.0,1,1,690.0,690.0
28095,U2CF537,2,0.0,1,1,120.0,120.0
28096,UBA1509,2,0.0,1,1,6.23,6.23
28097,U134027,2,19084.0,0,2,0.0,19084.0
28098,UF49C22,2,0.09,0,2,0.0,0.09
28099,UEF737E,2,6934.0,0,2,0.0,6934.0
28100,U25D4F5,2,-710.0,2,0,710.0,0.0
28101,U4E546A,2,56000.0,0,2,0.0,56000.0
28102,UFA2414,2,0.0,1,1,68.7,68.7
28103,UFBA3D4,2,-904.65,2,0,904.65,0.0
28104,UFFB5A6,2,-10.0,2,0,10.0,0.0
28105,U0E13FE,2,-3154.0,1,1,9120.0,5966.0
28106,UE551FE,2,0.0,1,1,277.0,277.0
28107,U13DCE2,2,-29.96,1,1,30.0,0.04
28108,UCE5A9D,2,0.0,1,1,49.26,49.26
28109,UE52A91,2,-280.0,1,1,19855.0,19575.0
28110,U8C6202,2,220.0,0,2,0.0,220.0
28111,UB5D0F0,2,287.81,0,2,0.0,287.81
28112,UEC8786,2,34980.0,1,1,20.0,35000.0
28113,U52084C,2,-418.0,1,1,7653.0,7235.0
28114,UB2826F,2,6000.0,0,2,0.0,6000.0
28115,U6591D0,2,0.0,1,1,100.0,100.0
28116,UBED69D,2,-1389.03,1,1,1488.0,98.97
28117,UD8FFF5,2,0.0,1,1,27.5,27.5
28118,U6D1D40,2,660.0,0,2,0.0,660.0
28119,UDB91FC,2,100.0,0,2,0.0,100.0
28120,U40459E,2,0.0,1,1,104.0,104.0
28121,UB2DDE8,2,1949.0,1,1,3050.0,4999.0
28122,UC55CAF,2,2101.11,0,2,0.0,2101.11
28123,U676504,2,-999.4,1,1,1000.0,0.6
28124,U648D55,2,0.0,1,1,36.9,36.9
28125,UF12C72,2,-6572.0,1,1,7600.0,1028.0
28126,U3AF714,2,1000.0,1,1,2500.0,3500.0
28127,UDE8800,2,0.0,1,1,0.25,0.25
28128,UD39BFB,2,100.0,0,2,0.0,100.0
28129,UCB223B,2,-2525.0,2,0,2525.0,0.0
28130,U626A1F,2,0.0,1,1,15000.0,15000.0
28131,U154C06,2,-999.0,2,0,999.0,0.0
28132,UBAB06F,2,-20.0,2,0,20.0,0.0
28133,UD916C7,2,1360.0,1,1,11000.0,12360.0
28134,UC4FDFD,2,-10.0,2,0,10.0,0.0
28135,UD72B66,2,-1994.0,1,1,2394.0,400.0
28136,U1A8A57,2,83.0,1,1,2990.0,3073.0
28137,U1374BE,2,-13.069999999999993,1,1,450.82,437.75
28138,UB3094D,2,-14.9,2,0,14.9,0.0
28139,U1C7578,2,6110.16,0,2,0.0,6110.16
28140,U7F23AC,2,-10.0,2,0,10.0,0.0
28141,U80478D,2,1031.23,0,2,0.0,1031.23
28142,U460579,2,0.0,1,1,2000.0,2000.0
28143,U4F6C7C,2,-389.38,2,0,389.38,0.0
28144,U7F2FD6,2,-48495.380000000005,2,0,48495.380000000005,0.0
28145,UADBD2C,2,-10.0,2,0,10.0,0.0
28146,U9330A2,2,12400.06,0,2,0.0,12400.06
28147,U0A65AA,2,-180.0,2,0,180.0,0.0
28148,UFCE9FA,2,200.0,0,2,0.0,200.0
28149,UC3C48A,2,-10.0,2,0,10.0,0.0
28150,UA3E37F,2,-65.7,2,0,65.7,0.0
28151,UF2E668,2,3320.0,0,2,0.0,3320.0
28152,U8205CD,2,-3750.0,1,1,5000.0,1250.0
28153,U8E7E88,2,-549.1,2,0,549.1,0.0
28154,U7F42A5,2,-227.0,1,1,427.0,200.0
28155,U274F4F,2,2647.1899999999996,1,1,2835.0,5482.19
28156,UB75486,2,1955.67,0,2,0.0,1955.67
28157,U63E16E,2,0.0,1,1,5.0,5.0
28158,UE8C6D8,2,190.0,0,2,0.0,190.0
28159,UFE1948,2,4955.56,0,2,0.0,4955.56
28160,U8F1838,2,2300.02,0,2,0.0,2300.02
28161,U13C88A,2,-4799.93,1,1,4800.0,0.07
28162,U617A2B,2,0.0,1,1,3580.0,3580.0
28163,UE940E5,2,3324.0,0,2,0.0,3324.0
28164,UC74DAA,2,0.0,1,1,1836.8,1836.8
28165,UC3EE5D,2,100.0,0,2,0.0,100.0
28166,UFC0A22,2,169.16,0,2,0.0,169.16
28167,U3B977C,2,-20.0,2,0,20.0,0.0
28168,U2A6E62,2,0.0,1,1,8000.0,8000.0
28169,UCC49D5,2,0.0,1,1,4000.0,4000.0
28170,UF68E4A,2,0.0,1,1,247.0,247.0
28171,U56A832,2,970.45,1,1,29.55,1000.0
28172,U442A9A,2,0.2,0,2,0.0,0.2
28173,U5B5D02,2,0.0,1,1,10000.0,10000.0
28174,UC6D43C,2,182.0,1,1,1156.0,1338.0
28175,UD39EBC,2,20.0,0,2,0.0,20.0
28176,U8D327A,2,23.590000000000003,1,1,33.9,57.49
28177,U7E3C75,2,0.0,1,1,41.2,41.2
28178,UAF7CB4,2,0.0,1,1,5000.0,5000.0
28179,U14959B,2,200.0,0,2,0.0,200.0
28180,U8D52EE,2,242.0,0,2,0.0,242.0
28181,UF4288E,2,291.23,0,2,0.0,291.23
28182,U568D53,2,11.01,0,2,0.0,11.01
28183,U60B112,2,0.0,1,1,4859.0,4859.0
28184,UDE6749,2,0.0,1,1,360.0,360.0
28185,U6C9D68,2,5.01,0,2,0.0,5.01
28186,UC2D0AC,2,-10.0,2,0,10.0,0.0
28187,U4AF330,2,-10.5,1,1,2110.5,2100.0
28188,U803D29,2,-4266.0,1,1,7456.0,3190.0
28189,U5F5139,2,87.41999999999996,1,1,564.0,651.42
28190,UE0D1C3,2,0.0,1,1,11.0,11.0
28191,U9615DD,2,-0.010000000000000009,1,1,1.0,0.99
28192,UFF294F,2,-10.0,2,0,10.0,0.0
28193,U4AF417,2,45.01,0,2,0.0,45.01
28194,UCABBD8,2,100.0,1,1,300.0,400.0
28195,U02EF54,2,0.06999999999999999,0,2,0.0,0.06999999999999999
28196,UB023C4,2,-346.0,1,1,350.0,4.0
28197,U635DCE,2,20.0,1,1,2980.0,3000.0
28198,U386022,2,-277.66,2,0,277.66,0.0
28199,UE661A6,2,10.12,0,2,0.0,10.12
28200,U6E982B,2,-1010.0,2,0,1010.0,0.0
28201,UD936AF,2,-10.0,2,0,10.0,0.0
28202,UB35E72,2,0.0,1,1,10.0,10.0
28203,U055A92,2,-11889.82,2,0,11889.82,0.0
28204,U6B34C8,2,-420.2,2,0,420.2,0.0
28205,U62A1E4,2,-10.0,2,0,10.0,0.0
28206,U9AD718,2,-10620.0,2,0,10620.0,0.0
28207,U9D35FA,2,200.0,1,1,1480.0,1680.0
28208,U17DB36,2,202.69,0,2,0.0,202.69
28209,U9227D0,2,0.0,1,1,250.0,250.0
28210,UCBA45E,2,2695.0,0,2,0.0,2695.0
28211,UC6992E,2,4.34,0,2,0.0,4.34
28212,U4798E0,2,-290.0,1,1,7850.0,7560.0
28213,UB2AE9B,2,-10.0,2,0,10.0,0.0
28214,U8E059D,2,0.0,1,1,4990.0,4990.0
28215,U1FAD88,2,-75.0,1,1,95.0,20.0
28216,U02B635,2,0.0,1,1,6000.0,6000.0
28217,UEF7C9C,2,650.0,1,1,1500.0,2150.0
28218,UCEFDDD,2,4800.0,0,2,0.0,4800.0
28219,U647A57,2,-10.0,2,0,10.0,0.0
28220,U9C6199,2,-8.0,1,1,5000.0,4992.0
28221,UFD2818,2,0.0,1,1,0.01,0.01
28222,UF88767,2,2016.03,0,2,0.0,2016.03
28223,U1BFDA7,2,654.52,0,2,0.0,654.52
28224,UE3530A,2,-3050.0,2,0,3050.0,0.0
28225,U6CEB6E,2,-10.0,2,0,10.0,0.0
28226,U19FCB3,2,-769.37,2,0,769.37,0.0
28227,U3C7C24,2,4213.0,0,2,0.0,4213.0
28228,U54E99C,2,0.09,0,2,0.0,0.09
28229,UE45709,2,-1.8799999999999955,1,1,237.26,235.38
28230,UD83AB1,2,300.07,0,2,0.0,300.07
28231,U0F4108,2,0.0,1,1,100.0,100.0
28232,UAC2930,2,77.39999999999998,1,1,300.0,377.4
28233,UD6F130,2,20.0,0,2,0.0,20.0
28234,U8498C4,2,-10.0,2,0,10.0,0.0
28235,UE6EC25,2,-10.0,2,0,10.0,0.0
28236,U860597,2,-20.0,2,0,20.0,0.0
28237,U4865A3,2,1000.01,0,2,0.0,1000.01
28238,UF061B4,2,-10.0,2,0,10.0,0.0
28239,U9805E1,2,-277.66,2,0,277.66,0.0
28240,UE87975,2,3333.4,0,2,0.0,3333.4
28241,U5492E8,2,300.0,0,2,0.0,300.0
28242,UE01BF7,2,1517.1,0,2,0.0,1517.1
28243,U2A0C16,2,-100.0,1,1,10000.0,9900.0
28244,U692449,2,0.0,1,1,1.5,1.5
28245,UE8C366,2,-11.0,2,0,11.0,0.0
28246,U806F10,2,2577.44,0,2,0.0,2577.44
28247,U05DCF3,2,200.0,1,1,1800.0,2000.0
28248,UFA5C6E,2,1000.0,0,2,0.0,1000.0
28249,UB8018F,2,0.0,1,1,182.2,182.2
28250,UA082BE,2,0.0,1,1,40000.0,40000.0
28251,UDEEEA3,2,2200.0,0,2,0.0,2200.0
28252,U75C9A4,2,-422.22,2,0,422.22,0.0
28253,U1368B8,2,-6.35,1,1,10.0,3.65
28254,U5506D3,2,0.0,1,1,5.0,5.0
28255,UF1AE59,2,208.3,0,2,0.0,208.3
28256,U826E60,2,-4663.3,1,1,4663.45,0.15
28257,UEC51E6,2,0.0,1,1,100.0,100.0
28258,U6CD4F1,2,-10.0,2,0,10.0,0.0
28259,U76D6D8,2,-20.0,2,0,20.0,0.0
28260,U338D93,2,0.41000000000000014,1,1,8.59,9.0
28261,U598C10,2,150.0,0,2,0.0,150.0
28262,UA88FB0,2,-204.0,1,1,399.0,195.0
28263,U13A849,2,-10.0,2,0,10.0,0.0
28264,U78F33D,2,0.0,1,1,1.0,1.0
28265,U9E5857,2,281.63,0,2,0.0,281.63
28266,UAC6FE2,2,-10.0,2,0,10.0,0.0
28267,U0306B8,2,10427.42,0,2,0.0,10427.42
28268,UD364AC,2,11.0,1,1,178.0,189.0
28269,UD7F27D,2,0.0,1,1,1850.0,1850.0
28270,UE736A0,2,-10.0,2,0,10.0,0.0
28271,U198DF6,2,130.0,0,2,0.0,130.0
28272,U2FEC77,2,200.0,0,2,0.0,200.0
28273,UB134C9,2,3925.0,0,2,0.0,3925.0
28274,UD05A13,2,-421.85,2,0,421.85,0.0
28275,U698219,2,0.13,0,2,0.0,0.13
28276,U17556C,2,-40000.0,2,0,40000.0,0.0
28277,UA0B2DD,2,0.0,1,1,300.0,300.0
28278,UEF0C65,2,-10.0,2,0,10.0,0.0
28279,UABED75,2,313.0,1,1,20.0,333.0
28280,UDD2F0C,2,-322.67,2,0,322.67,0.0
28281,UBD3D7D,2,31.6,1,1,4.5,36.1
28282,U1BF848,2,4.36,0,2,0.0,4.36
28283,U55CE46,2,-10.0,2,0,10.0,0.0
28284,U2E8341,2,200.0,0,2,0.0,200.0
28285,UB3FB4F,2,0.0,1,1,5.0,5.0
28286,U88F312,2,841.46,0,2,0.0,841.46
28287,U60E661,2,25490.0,0,2,0.0,25490.0
28288,U16BD15,2,0.0,1,1,57.97,57.97
28289,UB860A1,2,9.0,1,1,1.0,10.0
28290,UD35EFC,2,0.05,0,2,0.0,0.05
28291,UCD51A7,2,-10.0,2,0,10.0,0.0
28292,UC17882,2,10834.72,0,2,0.0,10834.72
28293,U80EA94,2,0.0,1,1,5000.0,5000.0
28294,U804BF5,2,3078.1,0,2,0.0,3078.1
28295,UC3E736,2,15.0,0,2,0.0,15.0
28296,UA66ED1,2,0.0,1,1,75.0,75.0
28297,UA3080D,2,-10.0,2,0,10.0,0.0
28298,U277C29,2,161.17,1,1,138.83,300.0
28299,U1EBC83,2,2.0,0,2,0.0,2.0
28300,U7686A0,2,1.1700000000000002,0,2,0.0,1.1700000000000002
28301,U2AC4BB,2,2981.71,0,2,0.0,2981.71
28302,U75567B,2,1800.0,0,2,0.0,1800.0
28303,U1BFD23,2,0.1299999999999999,1,1,1.0,1.13
28304,U8D56F4,2,0.0,1,1,690.0,690.0
28305,U268DB7,2,0.3000000000000007,1,1,24.7,25.0
28306,U7CB46C,2,1304.55,0,2,0.0,1304.55
28307,UD3E724,2,-374.42,2,0,374.42,0.0
28308,UF26379,2,-150.0,2,0,150.0,0.0
28309,U2E52B7,2,850.0,0,2,0.0,850.0
28310,U4A5E1C,2,0.0,1,1,120.0,120.0
28311,UE75863,2,0.0,1,1,10000.0,10000.0
28312,UD78E63,2,-99.56,1,1,99.7,0.14
28313,U3AFA1F,2,-2.85,1,1,3.0,0.15
28314,U8A168A,2,1000.0,0,2,0.0,1000.0
28315,U806384,2,-10.0,2,0,10.0,0.0
28316,U3EA226,2,0.0,1,1,0.01,0.01
28317,U753B2B,2,-10.0,2,0,10.0,0.0
28318,UB2DDB9,2,0.72,0,2,0.0,0.72
28319,UDC1B46,2,2700.08,0,2,0.0,2700.08
28320,U7795A7,2,1.0,1,1,2.0,3.0
28321,U4BB1E0,2,-0.6900000000000546,1,1,2999.0,2998.31
28322,U883436,2,-68.98,2,0,68.98,0.0
28323,UC492A4,2,-9999.23,1,1,10000.0,0.77
28324,U1C990B,2,-10.0,2,0,10.0,0.0
28325,UAD04D3,2,0.0,1,1,167.0,167.0
28326,U59F286,2,-10.0,2,0,10.0,0.0
28327,UCB262D,2,4968.73,0,2,0.0,4968.73
28328,UBDCEB1,2,-14999.0,2,0,14999.0,0.0
28329,U4E07A6,2,1320.76,0,2,0.0,1320.76
28330,U5098C4,2,-10.0,2,0,10.0,0.0
28331,U5C9836,2,5005.01,0,2,0.0,5005.01
28332,UA85EBF,2,-84.5,1,1,100.0,15.5
28333,UAFA3AB,2,0.8600000000000136,1,1,277.14,278.0
28334,UA5981C,2,0.0,1,1,17000.0,17000.0
28335,U0E1949,2,-1800.0,1,1,3000.0,1200.0
28336,U8FA6DB,2,0.0,1,1,29.9,29.9
28337,UD8A308,2,800.0,0,2,0.0,800.0
28338,UA5FD1B,2,-10.0,2,0,10.0,0.0
28339,UE20803,2,0.0,1,1,8000.0,8000.0
28340,UC08714,2,1669.0699999999997,1,1,3300.0,4969.07
28341,U585C31,2,-91.87,2,0,91.87,0.0
28342,UF53A2E,2,-18417.22,1,1,20000.0,1582.78
28343,U41DC27,2,-13000.0,2,0,13000.0,0.0
28344,UBB6735,2,-10.0,2,0,10.0,0.0
28345,U6934DA,2,0.99,1,1,0.01,1.0
28346,UD7E60F,2,13998.0,1,1,1340.0,15338.0
28347,UD491F8,2,-29.75,1,1,52.0,22.25
28348,U360A13,2,6.199999999999999,1,1,19.8,26.0
28349,UD6C4BD,2,200.0,1,1,900.0,1100.0
28350,UC6C431,2,-547.3100000000001,1,1,1135.93,588.62
28351,UEBFA43,2,200.0,1,1,1500.0,1700.0
28352,U53E71F,2,80.0,1,1,620.0,700.0
28353,UB325AC,2,910.0,0,2,0.0,910.0
28354,UB82D81,2,-179.85,2,0,179.85,0.0
28355,UF064EF,2,130.13,0,2,0.0,130.13
28356,UDBD50A,2,0.0,1,1,1598.0,1598.0
28357,U545F11,2,-59.9,2,0,59.9,0.0
28358,UDBC449,2,700.0,0,2,0.0,700.0
28359,U6CC959,2,-10.0,2,0,10.0,0.0
28360,U94A481,2,-499.79999999999995,2,0,499.79999999999995,0.0
28361,UD19F77,2,40.36,0,2,0.0,40.36
28362,UC66BD7,2,-2940.0,2,0,2940.0,0.0
28363,UF0669E,2,-208.69,1,1,211.65,2.96
28364,UD84170,2,-22.5,2,0,22.5,0.0
28365,U4582DA,2,-10.0,2,0,10.0,0.0
28366,UFE8D35,2,-10.0,2,0,10.0,0.0
28367,U1C2692,2,300.0,0,2,0.0,300.0
28368,U4192AB,2,669.4300000000001,0,2,0.0,669.4300000000001
28369,U4223E8,2,2.0,1,1,68.0,70.0
28370,UF64AC5,2,428.79,0,2,0.0,428.79
28371,U1BDB56,2,-10.0,2,0,10.0,0.0
28372,U2EC43D,2,0.0,1,1,0.04,0.04
28373,U073B0B,2,0.04,0,2,0.0,0.04
28374,UE93FCC,2,4048.0,1,1,1752.0,5800.0
28375,U317FA5,2,15153.99,0,2,0.0,15153.99
28376,UE83E53,2,-49976.87,1,1,50000.0,23.13
28377,UFB2135,2,0.0,1,1,2560.0,2560.0
28378,UF09E80,2,20.19,0,2,0.0,20.19
28379,U31B0A0,2,0.0,1,1,9600.0,9600.0
28380,U02B161,2,-10.0,2,0,10.0,0.0
28381,U30DFE8,2,0.0,1,1,1.77,1.77
28382,U45EADE,2,-10.0,2,0,10.0,0.0
28383,UA0D3D5,2,-1.0,1,1,100.0,99.0
28384,U51C6F9,2,200.0,0,2,0.0,200.0
28385,U001910,2,1500.0,1,1,2500.0,4000.0
28386,U8F6A0D,2,967.0,0,2,0.0,967.0
28387,U319B22,2,400.0,1,1,4600.0,5000.0
28388,U8EC2CA,2,-10.0,2,0,10.0,0.0
28389,U9D7CBC,2,293.07000000000005,0,2,0.0,293.07000000000005
28390,U2242F9,2,0.0,1,1,42.21,42.21
28391,UF7B6C7,2,0.02,0,2,0.0,0.02
28392,U368096,2,-225.5,2,0,225.5,0.0
28393,UBB7315,2,616.14,1,1,35.99,652.13
28394,UEE897C,2,0.0,1,1,200.0,200.0
28395,U0BA7F3,2,215.0,1,1,4798.0,5013.0
28396,U61FC6A,2,13.32,0,2,0.0,13.32
28397,U61BCA2,2,-2.94,1,1,3.0,0.06
28398,U34F23B,2,-20.0,2,0,20.0,0.0
28399,UDB0C30,2,2208.1,1,1,1079.9,3288.0
28400,UFC56A9,2,1.01,0,2,0.0,1.01
28401,U0E4BF9,2,673.0,0,2,0.0,673.0
28402,UC2B3C8,2,138.0,1,1,1030.0,1168.0
28403,U8AA6AD,2,0.0,1,1,11.42,11.42
28404,UA0042C,2,470.0,0,2,0.0,470.0
28405,UA9569A,2,200.0,0,2,0.0,200.0
28406,U3FB8D4,2,-4286.0,1,1,8123.0,3837.0
28407,U85C7EA,2,0.0,1,1,100.0,100.0
28408,U2E310E,2,20.05,0,2,0.0,20.05
28409,U541155,2,0.0,1,1,17800.0,17800.0
28410,U5FDDD1,2,15.0,1,1,385.0,400.0
28411,UF48E67,2,230.0,1,1,570.0,800.0
28412,UDA912F,2,-4499.99,1,1,4500.0,0.01
28413,U99042C,2,660.28,0,2,0.0,660.28
28414,U004706,2,1685.0,1,1,15.0,1700.0
28415,U0991BE,2,-1627.99,1,1,1628.0,0.01
28416,U8A85CE,2,0.0,1,1,42200.0,42200.0
28417,U827723,2,0.0,1,1,31.12,31.12
28418,U40C76D,2,-2033.3,2,0,2033.3,0.0
28419,U9D156C,2,509.41999999999996,0,2,0.0,509.41999999999996
28420,UC164F3,2,-12.98,1,1,13.0,0.02
28421,UF6B408,2,755.0,1,1,2745.0,3500.0
28422,U8521D8,2,11970.92,0,2,0.0,11970.92
28423,U174D79,2,-10.0,2,0,10.0,0.0
28424,U6BF9F1,2,0.0,1,1,107.0,107.0
28425,U60220B,2,0.0,1,1,2880.0,2880.0
28426,U7F4EEC,2,3458.95,0,2,0.0,3458.95
28427,U693B13,2,80.0,1,1,250.0,330.0
28428,UC4670A,2,101.0,1,1,1032.0,1133.0
28429,U9EB7E0,2,-5759.51,1,1,5760.0,0.49
28430,UBCAD9C,2,365.77,0,2,0.0,365.77
28431,U00DDA6,2,4.99,1,1,0.01,5.0
28432,UD7ABC3,2,-1.8799999999999955,1,1,100.0,98.12
28433,UF94794,2,-30.0,2,0,30.0,0.0
28434,U3D31FD,2,-400.0,2,0,400.0,0.0
28435,UD84A35,2,0.0,1,1,0.01,0.01
28436,U147D3E,2,0.0,1,1,4600.0,4600.0
28437,UBC320C,2,31658.0,0,2,0.0,31658.0
28438,UBA6EC6,2,0.0,1,1,61.83,61.83
28439,U2C199E,2,378.0,0,2,0.0,378.0
28440,U759A85,2,0.0,1,1,24.0,24.0
28441,UDC0FEF,2,-138.01,2,0,138.01,0.0
28442,UD763FF,2,-41.9,2,0,41.9,0.0
28443,U2EC033,2,0.0,1,1,10.0,10.0
28444,UE44EF2,2,1184.0,1,1,1116.0,2300.0
28445,UA7F460,2,16530.01,0,2,0.0,16530.01
28446,UE9349B,2,4209.32,0,2,0.0,4209.32
28447,U058451,2,590.0,0,2,0.0,590.0
28448,U4F9FA7,2,1000.0,0,2,0.0,1000.0
28449,U3EEA35,2,10010.0,0,2,0.0,10010.0
28450,UC34112,2,350.0,0,2,0.0,350.0
28451,U615299,2,-125.0,2,0,125.0,0.0
28452,U6BBA5E,2,723.0,0,2,0.0,723.0
28453,U9579DB,2,1009.87,0,2,0.0,1009.87
28454,UA57A7B,2,0.0,1,1,205.97,205.97
28455,U4DD17B,2,-10.0,2,0,10.0,0.0
28456,U5AB64D,2,0.0,1,1,2298.0,2298.0
28457,U447021,2,0.28,0,2,0.0,0.28
28458,UA77549,2,-42.01,2,0,42.01,0.0
28459,UA30603,2,-901.0,1,1,5000.0,4099.0
28460,U092434,2,100.0,0,2,0.0,100.0
28461,UE3B18D,2,0.0,1,1,300.0,300.0
28462,U97A605,2,0.09,0,2,0.0,0.09
28463,U6773C5,2,698.0,0,2,0.0,698.0
28464,UDA8022,2,0.0,1,1,10000.0,10000.0
28465,UA571EE,2,0.0,1,1,29980.0,29980.0
28466,UC7B0D8,2,-876.0,2,0,876.0,0.0
28467,U3C7218,2,100.02,0,2,0.0,100.02
28468,U724375,2,0.0,1,1,17.0,17.0
28469,UDA18ED,2,0.0,1,1,300.0,300.0
28470,UFA111D,2,34.0,1,1,646.0,680.0
28471,UCB9C24,2,-10.0,2,0,10.0,0.0
28472,UF46269,2,200.0,0,2,0.0,200.0
28473,U18C10C,2,-298.22,1,1,300.0,1.78
28474,UC51574,2,-2999.97,1,1,3000.0,0.03
28475,U182CA9,2,-10.0,2,0,10.0,0.0
28476,U191A00,2,-10.0,2,0,10.0,0.0
28477,U619761,2,0.0,1,1,1000.0,1000.0
28478,U591301,2,200.01,0,2,0.0,200.01
28479,U13F89E,2,-10.0,2,0,10.0,0.0
28480,UC4549E,2,2575.0,0,2,0.0,2575.0
28481,UB07D66,2,-10.0,1,1,100.0,90.0
28482,UF59B36,2,300.0,0,2,0.0,300.0
28483,U3C56E0,2,-95.0,1,1,100.0,5.0
28484,UADDA7B,2,1.0299999999997453,1,1,4298.97,4300.0
28485,UD1C421,2,122.0,0,2,0.0,122.0
28486,UEBCC76,2,90.53999999999999,0,2,0.0,90.53999999999999
28487,UE4F17B,2,0.0,1,1,500.0,500.0
28488,U78CF08,2,-112.0,2,0,112.0,0.0
28489,U062121,2,5.0,1,1,5.0,10.0
28490,U79B4F5,2,0.0,1,1,100.0,100.0
28491,U250ECE,2,0.0,1,1,300.0,300.0
28492,U240EE1,2,0.0,1,1,9.9,9.9
28493,U02A4BD,2,200.0,0,2,0.0,200.0
28494,UE2A7E2,2,196.23000000000002,0,2,0.0,196.23000000000002
28495,U2A5B62,2,6669.0,0,2,0.0,6669.0
28496,UAA7157,2,-0.7199999999999989,1,1,100.0,99.28
28497,UCF7679,2,0.0,1,1,33.0,33.0
28498,U422AD1,2,608.0,0,2,0.0,608.0
28499,U49D081,2,-10.0,2,0,10.0,0.0
28500,U4AC2BC,2,-1.0,1,1,172.0,171.0
28501,U68C9C8,2,3948.54,0,2,0.0,3948.54
28502,UFD9075,2,-10.0,2,0,10.0,0.0
28503,U18FD8F,2,77.0,1,1,423.0,500.0
28504,U1789EE,2,1.0,1,1,11.0,12.0
28505,UCB5973,2,0.0,1,1,1609.0,1609.0
28506,U9C3C0D,2,5.0,1,1,5.0,10.0
28507,U8C0BEA,2,100.0,0,2,0.0,100.0
28508,UB94050,2,475.0,1,1,5.0,480.0
28509,UB67693,2,6105.13,0,2,0.0,6105.13
28510,U823F45,2,-38.84,1,1,40.0,1.16
28511,UC8571A,2,496.0,0,2,0.0,496.0
28512,U2083DE,2,-5555.0,2,0,5555.0,0.0
28513,UD0CD9F,2,-10.0,2,0,10.0,0.0
28514,U40CEEE,2,-10.0,2,0,10.0,0.0
28515,U6B47B3,2,-159.66,2,0,159.66,0.0
28516,U2FBEB1,2,400.0,0,2,0.0,400.0
28517,U1E4AF5,2,-10.0,2,0,10.0,0.0
28518,U9C56FB,2,0.0,1,1,59.0,59.0
28519,UBC6243,2,200.0,0,2,0.0,200.0
28520,U3AA815,2,11738.54,0,2,0.0,11738.54
28521,U935AF0,2,-1.82000000000005,1,1,800.0,798.18
28522,UD65A6C,2,6000.0,0,2,0.0,6000.0
28523,UE6B9B9,2,400.0,0,2,0.0,400.0
28524,UF3FB2F,2,-214.14,1,1,289.0,74.86
28525,U2ED6F2,2,-1623.91,2,0,1623.91,0.0
28526,U17768A,2,1433.81,0,2,0.0,1433.81
28527,U489B08,2,4.0,0,2,0.0,4.0
28528,UE78A0D,2,390.0,1,1,4580.0,4970.0
28529,U3D3CF2,2,6122.0,0,2,0.0,6122.0
28530,U581488,2,-35.9,1,1,39.9,4.0
28531,UC32D59,2,-10.0,2,0,10.0,0.0
28532,U18E46A,2,4187.719999999999,0,2,0.0,4187.719999999999
28533,U8BAC9E,2,26.0,0,2,0.0,26.0
28534,U249B8E,2,-20333.6,2,0,20333.6,0.0
28535,UFA2B37,2,0.0,1,1,29.5,29.5
28536,U325103,2,150.0,0,2,0.0,150.0
28537,UA6415C,2,600.0,0,2,0.0,600.0
28538,U7FB6C9,2,20.0,1,1,340.0,360.0
28539,U6F08D3,2,0.0,1,1,5000.0,5000.0
28540,UDE3C84,2,-10.0,2,0,10.0,0.0
28541,U5E1DD5,2,0.0,1,1,3000.0,3000.0
28542,UF5DEB8,2,-43.0,2,0,43.0,0.0
28543,U828076,2,-244.0,2,0,244.0,0.0
28544,UF44C24,2,267.98,0,2,0.0,267.98
28545,U5B5EB7,2,594.0,1,1,6.0,600.0
28546,U48538C,2,447.0,0,2,0.0,447.0
28547,UC85970,2,-10.0,2,0,10.0,0.0
28548,UF4DB54,2,100.0,0,2,0.0,100.0
28549,UCABC35,2,0.0,1,1,8998.0,8998.0
28550,U606BD0,2,391.1399999999999,1,1,2450.0,2841.14
28551,UA1C07B,2,0.0,1,1,19.42,19.42
28552,U6460EA,2,808.54,0,2,0.0,808.54
28553,UC427E3,2,0.0,1,1,1536.0,1536.0
28554,U0189F0,2,23.0,1,1,340.0,363.0
28555,UA562BF,2,-987.0,1,1,1000.0,13.0
28556,U02C7DC,2,380.02,0,2,0.0,380.02
28557,U1862CF,2,100.0,0,2,0.0,100.0
28558,U13C36E,2,1800.28,0,2,0.0,1800.28
28559,U7659A7,2,0.0,1,1,1.0,1.0
28560,UC86BF4,2,70.0,1,1,10000.0,10070.0
28561,UB823FA,2,-1000.0,1,1,6000.0,5000.0
28562,U27377A,2,5.759999999999998,1,1,38.99,44.75
28563,U4A5A7E,2,-6698.0,1,1,6700.0,2.0
28564,UA09B2C,2,0.0,1,1,418.82,418.82
28565,U6A0EDD,2,-42.45,2,0,42.45,0.0
28566,UEBC91C,2,87.86,0,2,0.0,87.86
28567,U60214A,2,-10.0,2,0,10.0,0.0
28568,U30929A,2,3021.66,0,2,0.0,3021.66
28569,U358236,2,-10.0,2,0,10.0,0.0
28570,U7AD652,2,0.0,1,1,7800.0,7800.0
28571,U6C3157,2,-347.0,2,0,347.0,0.0
28572,U22A927,2,1600.0,0,2,0.0,1600.0
28573,U3A0A60,2,44.809999999999995,0,2,0.0,44.809999999999995
28574,UEB32B7,2,0.0,1,1,0.52,0.52
28575,U643E16,2,0.0,1,1,100.0,100.0
28576,UCF91EC,2,-0.88,2,0,0.88,0.0
28577,U3890E3,2,0.10000000000002274,1,1,500.0,500.1
28578,U55D411,2,357.88,0,2,0.0,357.88
28579,U9335EB,2,0.8099999999999999,0,2,0.0,0.8099999999999999
28580,U0DA7B4,2,-10.0,2,0,10.0,0.0
28581,U33394D,2,0.0,1,1,5000.0,5000.0
28582,U084AD0,2,-10.0,2,0,10.0,0.0
28583,U638772,2,-257.26,2,0,257.26,0.0
28584,U6D6D51,2,0.0,1,1,4000.0,4000.0
28585,UA894A1,2,2340.0,1,1,1000.0,3340.0
28586,UEE02C2,2,0.0,1,1,3799.0,3799.0
28587,U79E3A4,2,-2730.95,2,0,2730.95,0.0
28588,U1B6188,2,0.0,1,1,9.99,9.99
28589,UDE924B,2,-50999.87,1,1,51000.0,0.13
28590,U372B86,2,-10.0,2,0,10.0,0.0
28591,U66B269,2,0.0,1,1,3000.0,3000.0
28592,U6810EA,2,0.0,1,1,6000.0,6000.0
28593,U0E1C6A,2,-10.0,2,0,10.0,0.0
28594,UB8F592,2,250.0,0,2,0.0,250.0
28595,U4B204C,2,-5369.0,1,1,9486.0,4117.0
28596,U01DCBA,2,2999.0,0,2,0.0,2999.0
28597,UB9A78F,2,-2439.0,2,0,2439.0,0.0
28598,U6B83F5,2,0.0,1,1,2100.0,2100.0
28599,U26219C,2,-10.0,2,0,10.0,0.0
28600,UCE214D,2,20000.0,0,2,0.0,20000.0
28601,U10BEEB,2,-24.94,1,1,25.0,0.06
28602,U17D613,2,-10.0,2,0,10.0,0.0
28603,U5F7474,2,-10.0,2,0,10.0,0.0
28604,U0E4920,2,-2467.76,2,0,2467.76,0.0
28605,UE90476,2,5.0,1,1,5.0,10.0
28606,UD9591F,2,353.74,0,2,0.0,353.74
28607,UB52FCF,2,545.98,1,1,189.86,735.84
28608,UC30749,2,-10.0,2,0,10.0,0.0
28609,UCF5F1B,2,-10.0,2,0,10.0,0.0
28610,UFA8EC5,2,542.49,0,2,0.0,542.49
28611,UE2015C,2,1420.0,1,1,190.0,1610.0
28612,UD59B91,2,-10.0,2,0,10.0,0.0
28613,U9FD851,2,15.0,0,2,0.0,15.0
28614,U86E8A0,2,-99.0,1,1,1199.0,1100.0
28615,UA913BE,2,0.0,1,1,57.0,57.0
28616,U2B327F,2,0.06999999999999999,0,2,0.0,0.06999999999999999
28617,U589410,2,0.0,1,1,2000.0,2000.0
28618,U5D5E4F,2,0.0,1,1,98.0,98.0
28619,UBA07C8,2,-500.0,2,0,500.0,0.0
28620,U1576E8,2,0.0,1,1,5.0,5.0
28621,U05F749,2,3795.0,1,1,5.0,3800.0
28622,UDE0725,2,-10.0,2,0,10.0,0.0
28623,UAD51B4,2,4000.0,0,2,0.0,4000.0
28624,U128583,2,0.0,1,1,100000.0,100000.0
28625,UEF1D09,2,-4.99,1,1,5.0,0.01
28626,U4355DF,2,0.0,1,1,0.01,0.01
28627,U0F93EA,2,0.0,1,1,67.62,67.62
28628,UF8397C,2,100.0,1,1,3900.0,4000.0
28629,UED4FE3,2,-499.62,1,1,500.0,0.38
28630,UD16689,2,0.0,1,1,148.98,148.98
28631,U04353F,2,-749.0,2,0,749.0,0.0
28632,U4E1A09,2,-648.76,2,0,648.76,0.0
28633,U26D03B,2,0.0,1,1,29.5,29.5
28634,UF5014A,2,-737.49,2,0,737.49,0.0
28635,U861BA1,2,183.53,0,2,0.0,183.53
28636,UFF5572,2,150.0,0,2,0.0,150.0
28637,U4DF2AD,2,-410.6,2,0,410.6,0.0
28638,UC55A9C,2,100.0,1,1,50.6,150.6
28639,UD79350,2,292.84000000000003,0,2,0.0,292.84000000000003
28640,UA06461,2,150.0,0,2,0.0,150.0
28641,UF8E856,2,200.0,0,2,0.0,200.0
28642,U57B6C9,2,0.7,0,2,0.0,0.7
28643,UD21EEC,2,38.379999999999995,0,2,0.0,38.379999999999995
28644,UC71C55,2,-10.0,2,0,10.0,0.0
28645,UF6EDB9,2,5135.0,1,1,7885.0,13020.0
28646,U772863,2,400.0,1,1,9500.0,9900.0
28647,U47CF55,2,582.3199999999999,0,2,0.0,582.3199999999999
28648,U4C3419,2,100.05,0,2,0.0,100.05
28649,U989EFE,2,0.3499999999999943,1,1,100.0,100.35
28650,UF0FE49,2,0.6799999999999997,1,1,13.32,14.0
28651,U35A693,2,55.0,1,1,10765.0,10820.0
28652,UA1F9FA,2,1559.0,1,1,15267.0,16826.0
28653,U97F986,2,-0.480000000000004,1,1,100.0,99.52
28654,UE66CF8,2,-10.0,2,0,10.0,0.0
28655,U2CA0B3,2,37.92,0,2,0.0,37.92
28656,U830659,2,0.0,1,1,107.91,107.91
28657,U0A1356,2,970.0,0,2,0.0,970.0
28658,U0B863E,2,-99.95,1,1,99.98,0.03
28659,UED4271,2,4000.0,0,2,0.0,4000.0
28660,U9E6496,2,-10.0,2,0,10.0,0.0
28661,U8BFEA8,2,-390.0,1,1,26745.0,26355.0
28662,U47AAD3,2,-25.83,1,1,100.0,74.17
28663,U5EDC0B,2,9316.84,0,2,0.0,9316.84
28664,U22CA78,2,-2353.54,2,0,2353.54,0.0
28665,U029649,2,-1708.8600000000001,2,0,1708.8600000000001,0.0
28666,UCBEAA7,2,565.0,0,2,0.0,565.0
28667,U0A20A8,2,299.78999999999996,1,1,500.0,799.79
28668,UE84F6D,2,1094.31,0,2,0.0,1094.31
28669,U92358B,2,0.0,1,1,114.15,114.15
28670,UEFAAC8,2,1.0,1,1,2499.0,2500.0
28671,U2AD778,2,-192.31,1,1,200.0,7.69
28672,U0D8C66,2,-133.92000000000002,2,0,133.92000000000002,0.0
28673,U62D490,2,-9800.01,2,0,9800.01,0.0
28674,U374E73,2,-9999.99,1,1,10000.0,0.01
28675,UC6CC0D,2,0.0,1,1,2.46,2.46
28676,U97A13D,2,3.25,0,2,0.0,3.25
28677,U4C9BE7,2,-4000.0,2,0,4000.0,0.0
28678,U9957A0,2,-2400.0,2,0,2400.0,0.0
28679,UE40F5B,2,-100.8,2,0,100.8,0.0
28680,U4477AB,2,0.0,1,1,2000.0,2000.0
28681,U9CCA78,2,0.0,1,1,29.97,29.97
28682,UD29D69,2,20.0,0,2,0.0,20.0
28683,UAB1C20,2,-1654.1999999999998,1,1,2054.2,400.0
28684,U79C900,2,-80720.0,2,0,80720.0,0.0
28685,U93037E,2,-10.0,2,0,10.0,0.0
28686,U774B24,2,-3343.4,2,0,3343.4,0.0
28687,U3D2E41,2,-299.84,2,0,299.84,0.0
28688,UB53EFA,2,-2.0,1,1,120.0,118.0
28689,UB6334C,2,530.01,0,2,0.0,530.01
28690,U7D602D,2,3599.88,1,1,0.12,3600.0
28691,U3A7384,2,15.01,0,2,0.0,15.01
28692,U0D52C2,2,0.0,1,1,20000.0,20000.0
28693,U3E581C,2,0.0,1,1,50.0,50.0
28694,UDB3C17,2,-10.0,2,0,10.0,0.0
28695,U84B34B,2,-10.0,2,0,10.0,0.0
28696,U471033,2,-10.0,2,0,10.0,0.0
28697,UE495C8,2,-209.99,1,1,210.0,0.01
28698,UF23A13,2,57000.0,0,2,0.0,57000.0
28699,UCE94EC,2,-150.81,2,0,150.81,0.0
28700,UCEB107,2,-10.0,2,0,10.0,0.0
28701,U7F4100,2,230.0,0,2,0.0,230.0
28702,UD184F1,2,216.8,1,1,1.2,218.0
28703,UEF7AD6,2,-65.0,1,1,120.0,55.0
28704,UF93B7E,2,2.0,1,1,998.0,1000.0
28705,U7F36AC,2,0.0,1,1,300.0,300.0
28706,UE4B27A,2,-10.0,2,0,10.0,0.0
28707,U483E9D,2,-2059.0,2,0,2059.0,0.0
28708,UD40642,2,240.0,1,1,1040.0,1280.0
28709,U3EBF97,2,4166.66,0,2,0.0,4166.66
28710,U5C1041,2,0.0,1,1,0.01,0.01
28711,U5782F0,2,1330.0,0,2,0.0,1330.0
28712,U4C8B04,2,1019.01,0,2,0.0,1019.01
28713,U86EFA8,2,0.0,1,1,0.01,0.01
28714,UADEA4B,2,3003.19,0,2,0.0,3003.19
28715,UC868ED,2,0.0,1,1,306.0,306.0
28716,U6999AA,2,0.0,1,1,100.0,100.0
28717,U9DD6F3,2,-10.0,2,0,10.0,0.0
28718,U0FA2B2,2,-2.0,1,1,2000.0,1998.0
28719,UF28BF9,2,51.94999999999999,1,1,368.0,419.95
28720,U58742A,2,4000.0,0,2,0.0,4000.0
28721,U33B6E6,2,-26.0,2,0,26.0,0.0
28722,U757520,2,750.0,1,1,2050.0,2800.0
28723,UDE3BCE,2,-10.0,2,0,10.0,0.0
28724,UB4917F,2,-10.0,2,0,10.0,0.0
28725,U46B3AB,2,20.0,0,2,0.0,20.0
28726,UC01F98,2,224.1,1,1,18.9,243.0
28727,U2198DC,2,-178.89,1,1,178.97,0.08
28728,UD2C71D,2,-90.0,1,1,100.0,10.0
28729,UCE1063,2,-10.0,2,0,10.0,0.0
28730,UE2580E,2,1516.65,0,2,0.0,1516.65
28731,UE0F279,2,-10.0,2,0,10.0,0.0
28732,UA5FF15,2,15.0,0,2,0.0,15.0
28733,U997BEF,2,0.0,1,1,1286.0,1286.0
28734,UD9AD1B,2,1480.0,0,2,0.0,1480.0
28735,UE7D116,2,4557.0,1,1,299.0,4856.0
28736,U9174A4,2,0.0,1,1,5.0,5.0
28737,U6E2704,2,19943.0,1,1,54.0,19997.0
28738,U666126,2,4300.0,0,2,0.0,4300.0
28739,UB3FD09,2,400.0,0,2,0.0,400.0
28740,UF805B3,2,0.0,1,1,1.0,1.0
28741,UDE3AB1,2,2500.0,0,2,0.0,2500.0
28742,UFB0227,2,1850.0,0,2,0.0,1850.0
28743,U469837,2,-10.0,2,0,10.0,0.0
28744,UCED70D,2,-200.0,1,1,600.0,400.0
28745,U17B022,2,8.700000000000001,0,2,0.0,8.700000000000001
28746,UAB3270,2,722.0,0,2,0.0,722.0
28747,UC726AB,2,500.0,1,1,1000.0,1500.0
28748,U7645C4,2,100.0,1,1,2500.0,2600.0
28749,UBF4270,2,1.0,1,1,999.0,1000.0
28750,U0EDB34,2,1240.0,1,1,160.0,1400.0
28751,UC1DAFA,2,-4512.0,1,1,6500.0,1988.0
28752,UAAA39C,2,-10.0,2,0,10.0,0.0
28753,UF12074,2,79.78,1,1,65.6,145.38
28754,U5D9F97,2,3023.02,0,2,0.0,3023.02
28755,U5FDCD8,2,0.0,1,1,3000.0,3000.0
28756,U00FB73,2,-5050.0,2,0,5050.0,0.0
28757,UA27000,2,-10.0,2,0,10.0,0.0
28758,UEF19AC,2,0.0,1,1,1.3,1.3
28759,UFE74E7,2,-10.0,2,0,10.0,0.0
28760,U0945DD,2,705.0,1,1,2455.0,3160.0
28761,U14C286,2,6712.66,0,2,0.0,6712.66
28762,U4A4D23,2,-1498.49,1,1,1500.0,1.51
28763,U13FE35,2,0.0,1,1,10.07,10.07
28764,U8DD09A,2,-10.0,2,0,10.0,0.0
28765,U5C4775,2,2620.25,0,2,0.0,2620.25
28766,U815AD2,2,4000.0,0,2,0.0,4000.0
28767,UCA9958,2,0.99,1,1,0.01,1.0
28768,U58B2F2,2,-2.25,1,1,2.31,0.06
28769,UEA3747,2,-10.0,2,0,10.0,0.0
28770,U3DA5CE,2,-1113.33,1,1,1114.09,0.76
28771,UA41EC1,2,138.45,1,1,100.3,238.75
28772,U9CE287,2,0.0,1,1,499.0,499.0
28773,U1818CC,2,-10.0,2,0,10.0,0.0
28774,UF2DA9A,2,-111.52,1,1,118.0,6.48
28775,U2CD5F5,2,-10.0,2,0,10.0,0.0
28776,UA21F84,2,-10.0,2,0,10.0,0.0
28777,U732138,2,113.73000000000002,1,1,920.0,1033.73
28778,U96B61D,2,0.9400000000000546,1,1,3599.0,3599.94
28779,U5E5C17,2,2100.0,0,2,0.0,2100.0
28780,U60993C,2,0.0,1,1,20.8,20.8
28781,U0AD2CE,2,200.0,1,1,300.0,500.0
28782,UE974D1,2,0.0,1,1,2037.9,2037.9
28783,U5B676A,2,20.9,0,2,0.0,20.9
28784,U2DBDA1,2,-104.96,1,1,105.0,0.04
28785,U708A90,2,31.0,1,1,769.0,800.0
28786,U76CFFC,2,15006.12,0,2,0.0,15006.12
28787,U349EAA,2,95.51,0,2,0.0,95.51
28788,U66891D,2,-2.2399999999999984,1,1,24.24,22.0
28789,U2E4AB9,2,299.85,0,2,0.0,299.85
28790,U332879,2,-9.97,1,1,10.0,0.03
28791,U3E8D23,2,67.0,0,2,0.0,67.0
28792,UC5D4A1,2,-10.83,2,0,10.83,0.0
28793,UFA7BA0,2,-10583.67,1,1,11187.0,603.33
28794,U637E55,2,9.960000000000036,1,1,1870.0,1879.96
28795,UBA8A7E,2,0.0,1,1,8.0,8.0
28796,U5D69E3,2,0.0,1,1,5.0,5.0
28797,U27ABB3,2,400.0,0,2,0.0,400.0
28798,U75D2D3,2,361.2,0,2,0.0,361.2
28799,U5863DF,2,-173.0,2,0,173.0,0.0
28800,UE03ED2,2,-1.6500000000000057,1,1,90.0,88.35
28801,U4B3ADD,2,980.0,1,1,20.0,1000.0
28802,U70241D,2,64.56,1,1,0.99,65.55
28803,U421579,2,6666.66,0,2,0.0,6666.66
28804,U3B6D28,2,0.0,1,1,159.03,159.03
28805,UE8F99C,2,-19156.29,2,0,19156.29,0.0
28806,U8350C1,2,100.0,1,1,20300.0,20400.0
28807,U24C531,2,-299.81,1,1,300.0,0.19
28808,U25CE83,2,-10.0,2,0,10.0,0.0
28809,UC5B60E,2,35855.200000000004,0,2,0.0,35855.200000000004
28810,U4361C0,2,2057.0,0,2,0.0,2057.0
28811,U08C3BE,2,-906.72,2,0,906.72,0.0
28812,U04182A,2,1289.9,0,2,0.0,1289.9
28813,U39C14B,2,350.0,0,2,0.0,350.0
28814,U7A41F8,2,-34.019999999999996,1,1,34.04,0.02
28815,U219CD1,2,0.0,1,1,385.0,385.0
28816,UF287B6,2,0.0,1,1,135.0,135.0
28817,UDBE887,2,0.0,1,1,3500.0,3500.0
28818,UFD4390,2,-159.0,1,1,160.0,1.0
28819,UC89AC2,2,-10.0,2,0,10.0,0.0
28820,U610256,2,0.0,1,1,3525.0,3525.0
28821,U302AAD,2,-1991.28,1,1,2000.0,8.72
28822,U868C6C,2,-10.0,2,0,10.0,0.0
28823,U2145D8,2,0.15000000000000002,0,2,0.0,0.15000000000000002
28824,U2A30B7,2,-10.0,2,0,10.0,0.0
28825,UF023FE,2,-336.0,2,0,336.0,0.0
28826,U459E9E,2,-55.0,2,0,55.0,0.0
28827,UFE3E20,2,1520.0,0,2,0.0,1520.0
28828,U3CFBA1,2,0.99,1,1,0.01,1.0
28829,U2899E8,2,-3646.98,2,0,3646.98,0.0
28830,U7519F1,2,4875.0,1,1,525.0,5400.0
28831,UE5DEB1,2,-10.0,2,0,10.0,0.0
28832,U4C511F,2,800.0,0,2,0.0,800.0
28833,U64974C,2,-41.72,1,1,42.21,0.49
28834,U8AE39F,2,0.0,1,1,1.0,1.0
28835,U96A573,2,-22.95,1,1,23.0,0.05
28836,U6DC9EB,2,881.36,0,2,0.0,881.36
28837,U36295A,2,-6772.0,2,0,6772.0,0.0
28838,UD117EE,2,3.0,0,2,0.0,3.0
28839,U269F02,2,4135.66,0,2,0.0,4135.66
28840,U2C9E7F,2,-10.0,2,0,10.0,0.0
28841,UE3F632,2,0.0,1,1,10050.0,10050.0
28842,U736EBB,2,2300.0,0,2,0.0,2300.0
28843,UDF7155,2,0.06,0,2,0.0,0.06
28844,UDDAEC1,2,220.0,0,2,0.0,220.0
28845,UEBC44B,2,0.13,0,2,0.0,0.13
28846,UCE35B0,2,-15.0,2,0,15.0,0.0
28847,U26128C,2,-10.0,2,0,10.0,0.0
28848,UDECABF,2,-96.28999999999999,1,1,246.0,149.71
28849,U3EFDAD,2,1.0,1,1,1.0,2.0
28850,UCA8008,2,731.0,0,2,0.0,731.0
28851,U285917,2,0.0,1,1,58.0,58.0
28852,U169A98,2,-68.86,2,0,68.86,0.0
28853,U3AEF4E,2,0.0,1,1,120.0,120.0
28854,U2E5055,2,1500.0,0,2,0.0,1500.0
28855,U531B0A,2,302.0,1,1,198.0,500.0
28856,U908E38,2,10105.56,0,2,0.0,10105.56
28857,U11A72F,2,0.0,1,1,10.0,10.0
28858,UF9B316,2,329.0,1,1,7739.0,8068.0
28859,UBDCBDC,2,0.91,1,1,0.01,0.92
28860,UA791AC,2,0.0,1,1,4500.0,4500.0
28861,U11ECAB,2,-10.0,2,0,10.0,0.0
28862,U86EB41,2,6000.0,0,2,0.0,6000.0
28863,UFBC0C7,2,-10.0,2,0,10.0,0.0
28864,U79D704,2,-3261.46,1,1,3264.0,2.54
28865,UCB4C61,2,6302.55,0,2,0.0,6302.55
28866,UCAF8A2,2,120.0,0,2,0.0,120.0
28867,UC9F902,2,-10.0,2,0,10.0,0.0
28868,U5552FA,2,-76.29,1,1,76.4,0.11
28869,U85F3BF,2,-10495.06,2,0,10495.06,0.0
28870,U0AF351,2,0.0,1,1,395.0,395.0
28871,U04164E,2,0.0,1,1,100.0,100.0
28872,U31CA43,2,-10.0,2,0,10.0,0.0
28873,U2748D4,2,0.0,1,1,100.0,100.0
28874,U967779,2,-1222.27,2,0,1222.27,0.0
28875,UE115EE,2,0.0,1,1,40.0,40.0
28876,U91A5A0,2,7019.85,0,2,0.0,7019.85
28877,UD97610,2,-278.0,2,0,278.0,0.0
28878,UD76C1E,2,0.0,1,1,100.0,100.0
28879,UC5DF0F,2,-64.02,2,0,64.02,0.0
28880,U2603E1,2,-498.0,2,0,498.0,0.0
28881,U19A1BE,2,17.0,1,1,8.0,25.0
28882,U72ECF7,2,11.0,0,2,0.0,11.0
28883,UBD940D,2,-102.0,1,1,3000.0,2898.0
28884,U6DECF0,2,2154.0,0,2,0.0,2154.0
28885,UB1C793,2,-2773.0,2,0,2773.0,0.0
28886,UCA006E,2,-98500.0,2,0,98500.0,0.0
28887,U23DB92,2,8203.5,0,2,0.0,8203.5
28888,UDBA8DB,2,5761.99,0,2,0.0,5761.99
28889,U4A2F2D,2,1952.0,0,2,0.0,1952.0
28890,UD47DB9,2,6359.53,0,2,0.0,6359.53
28891,UAFDC04,2,2.0,0,2,0.0,2.0
28892,U546A0A,2,-55.97,1,1,56.0,0.03
28893,UD3AF3C,2,-1.9800000000000004,1,1,9.98,8.0
28894,U2F95FB,2,9.389999999999999,0,2,0.0,9.389999999999999
28895,U9EA449,2,-248.14,2,0,248.14,0.0
28896,UCA5681,2,0.0,1,1,100.0,100.0
28897,U3897D9,2,22328.0,0,2,0.0,22328.0
28898,U3B8A54,2,0.0,1,1,99.5,99.5
28899,UA16A6E,2,4728.13,0,2,0.0,4728.13
28900,UC08C65,2,703.04,0,2,0.0,703.04
28901,U46EF52,2,-802.0,1,1,6500.0,5698.0
28902,U4A4373,2,0.0,1,1,1546.0,1546.0
28903,UD4A198,2,1590.85,0,2,0.0,1590.85
28904,U70AFA6,2,616.04,0,2,0.0,616.04
28905,UF0CF45,2,273.0,1,1,79.0,352.0
28906,UC7CA63,2,250.69,0,2,0.0,250.69
28907,U2E753A,2,-10.0,2,0,10.0,0.0
28908,U9BBBEA,2,3000.0,0,2,0.0,3000.0
28909,UCA0A30,2,-278.0,2,0,278.0,0.0
28910,U440265,2,0.0,1,1,130.0,130.0
28911,UD72A1C,2,3099.9,1,1,154.1,3254.0
28912,UA29D92,2,-9550.0,1,1,10000.0,450.0
28913,U315674,2,-3.699999999999818,1,1,6664.7,6661.0
28914,U3839EA,2,0.0,1,1,62.74,62.74
28915,UFBC4D8,2,-299.97,1,1,300.0,0.03
28916,U3EE726,2,0.43000000000000005,0,2,0.0,0.43000000000000005
28917,UE0EA08,2,0.0,1,1,6.0,6.0
28918,U64919E,2,0.0,1,1,50.0,50.0
28919,UA5F630,2,-1667.7800000000002,2,0,1667.7800000000002,0.0
28920,U49E018,2,-3084.73,2,0,3084.73,0.0
28921,U067DB9,2,-14192.0,2,0,14192.0,0.0
28922,U0B70F2,2,697.34,0,2,0.0,697.34
28923,UB0BF57,2,0.0,1,1,3500.0,3500.0
28924,U198C49,2,3583.34,0,2,0.0,3583.34
28925,UE342AF,2,29250.0,0,2,0.0,29250.0
28926,U98707F,2,0.0,1,1,400.0,400.0
28927,UB97342,2,-7.25,2,0,7.25,0.0
28928,UD77B42,2,0.0,1,1,3.0,3.0
28929,UF0A9D5,2,-264.84,2,0,264.84,0.0
28930,U552073,2,280.0,1,1,2190.0,2470.0
28931,U184EFD,2,-10.0,2,0,10.0,0.0
28932,UB6F036,2,-737.5,2,0,737.5,0.0
28933,U77514D,2,0.0,1,1,839.0,839.0
28934,UBBDBC4,2,-651.8,1,1,653.0,1.2
28935,UF9C961,2,4000.0,0,2,0.0,4000.0
28936,U463D7B,2,1084.87,0,2,0.0,1084.87
28937,U33AB7E,2,31.36,0,2,0.0,31.36
28938,U926309,2,0.0,1,1,60.0,60.0
28939,U6B6686,2,730.0,0,2,0.0,730.0
28940,U5D516F,2,-2235.0,2,0,2235.0,0.0
28941,U5DDF81,2,-10.0,2,0,10.0,0.0
28942,U44F9B2,2,6290.1,0,2,0.0,6290.1
28943,U83CA0F,2,2056.24,0,2,0.0,2056.24
28944,U484E0D,2,0.0,1,1,24963.0,24963.0
28945,UB250C5,2,296.69,0,2,0.0,296.69
28946,U3E5350,2,-9.96,1,1,10.0,0.04
28947,U99B27A,2,1300.0,0,2,0.0,1300.0
28948,UBEC182,2,6000.0,0,2,0.0,6000.0
28949,U8EDCF4,2,7.0,0,2,0.0,7.0
28950,UE519D2,2,-110.0,2,0,110.0,0.0
28951,UEBC5C5,2,-0.09999999999990905,1,1,2690.0,2689.9
28952,UE14228,2,-1924.0,2,0,1924.0,0.0
28953,UF262FF,2,-356.95000000000005,2,0,356.95000000000005,0.0
28954,UDB57E3,2,0.0,1,1,402.22,402.22
28955,U8E237F,2,0.0,1,1,0.01,0.01
28956,UCB6CEE,2,-10.0,2,0,10.0,0.0
28957,U9E0136,2,0.18999999999999773,1,1,500.0,500.19
28958,UEFCA8D,2,3255.0,1,1,300.0,3555.0
28959,U93B8BF,2,-9999.98,1,1,10000.0,0.02
28960,UC0ABBF,2,0.0,1,1,1390.0,1390.0
28961,U24814D,2,170.0,0,2,0.0,170.0
28962,UDCA2C7,2,95.0,1,1,5.0,100.0
28963,U4C1A29,2,1432.0,0,2,0.0,1432.0
28964,U996251,2,20.0,1,1,1480.0,1500.0
28965,U783047,2,-8824.0,2,0,8824.0,0.0
28966,UEBA2AB,2,340.0,0,2,0.0,340.0
28967,U584494,2,65.02,0,2,0.0,65.02
28968,UD6D1B5,2,0.0,1,1,19999.0,19999.0
28969,UF65692,2,-380.7,2,0,380.7,0.0
28970,UBE738C,2,-162.37,2,0,162.37,0.0
28971,UEC0D6B,2,-336.0,2,0,336.0,0.0
28972,UEE0979,2,70.0,0,2,0.0,70.0
28973,U9A0097,2,-10.0,2,0,10.0,0.0
28974,U5D6620,2,-165.0,1,1,9780.0,9615.0
28975,UD68EBC,2,400.0,0,2,0.0,400.0
28976,U90A7BC,2,0.0,1,1,500.0,500.0
28977,U9BEE92,2,1.52,1,1,0.06,1.58
28978,UC4E97E,2,1.01,0,2,0.0,1.01
28979,U614437,2,-11.39,1,1,11.4,0.01
28980,U5ADEBF,2,-10.0,2,0,10.0,0.0
28981,U24C7F1,2,0.0,1,1,10200.0,10200.0
28982,UBE38EE,2,0.0,1,1,1.05,1.05
28983,U81099A,2,-1.0,1,1,98.0,97.0
28984,U4233C1,2,28782.48,0,2,0.0,28782.48
28985,U293319,2,8000.0,0,2,0.0,8000.0
28986,UDF1C76,2,2.0,0,2,0.0,2.0
28987,U0C2BF4,2,-7.1,1,1,9.0,1.9
28988,UA22459,2,20.0,0,2,0.0,20.0
28989,UC639AD,2,435.0,1,1,3523.0,3958.0
28990,U7C22AC,2,-2.7,2,0,2.7,0.0
28991,UC42E74,2,999.0,1,1,1001.0,2000.0
28992,UC5D499,2,7000.0,0,2,0.0,7000.0
28993,U40B101,2,673.0,1,1,827.0,1500.0
28994,U84E690,2,-188.8,2,0,188.8,0.0
28995,U196186,2,3630.0,0,2,0.0,3630.0
28996,U9524A7,2,0.0,1,1,5.0,5.0
28997,U19C5EE,2,0.0,1,1,4000.0,4000.0
28998,UB67ABA,2,-10.0,2,0,10.0,0.0
28999,U6A9C65,2,20.0,0,2,0.0,20.0
29000,U9BA40B,2,216.0,0,2,0.0,216.0
29001,U9BD1EE,2,0.0,1,1,1000.0,1000.0
29002,UCE2749,2,-10.0,2,0,10.0,0.0
29003,U29C92E,2,-5000.0,1,1,15000.0,10000.0
29004,U6C19DC,2,435.0,0,2,0.0,435.0
29005,UEAAD89,2,590.0,1,1,7410.0,8000.0
29006,U8058D1,2,240.0,1,1,460.0,700.0
29007,U0BFE18,2,0.0,1,1,4000.0,4000.0
29008,U8048E1,2,10.57,1,1,10.0,20.57
29009,UC457B0,2,1160.74,0,2,0.0,1160.74
29010,UB57D67,2,-158.0,2,0,158.0,0.0
29011,UEFB1B0,2,-15.149999999999999,2,0,15.149999999999999,0.0
29012,UBF0DAF,2,-10.0,2,0,10.0,0.0
29013,UCD3511,2,100.0,1,1,4900.0,5000.0
29014,U309C1C,2,0.0,1,1,4400.0,4400.0
29015,U7F52E3,2,0.0,1,1,60.3,60.3
29016,UC99A04,2,-3800.0,2,0,3800.0,0.0
29017,UA4753F,2,607.0,0,2,0.0,607.0
29018,U12FECB,2,310.16,1,1,5.0,315.16
29019,UBFE083,2,412.0,0,2,0.0,412.0
29020,U005D7E,2,600.01,0,2,0.0,600.01
29021,U1037A1,2,-138.82000000000002,1,1,138.83,0.01
29022,U59D7EA,2,-91.9,1,1,128.88,36.98
29023,U401CCC,2,0.0,1,1,9000.0,9000.0
29024,UBCC161,2,3000.0,0,2,0.0,3000.0
29025,UF39732,2,0.0,1,1,2660.0,2660.0
29026,U2B8F57,2,4.33,0,2,0.0,4.33
29027,U096E6E,2,750.0,0,2,0.0,750.0
29028,UCD1BAF,2,790.86,0,2,0.0,790.86
29029,U5C3050,2,-10.0,2,0,10.0,0.0
29030,U2E96F6,2,0.0,1,1,300.0,300.0
29031,U56DC91,2,1300.0,0,2,0.0,1300.0
29032,UA9E796,2,-669.3299999999999,2,0,669.3299999999999,0.0
29033,U68F501,2,-10.0,2,0,10.0,0.0
29034,U987251,2,-10.0,2,0,10.0,0.0
29035,U638507,2,-885.0,2,0,885.0,0.0
29036,UC86EE9,2,-4749.2300000000005,2,0,4749.2300000000005,0.0
29037,UB72F53,2,-10.0,2,0,10.0,0.0
29038,U99445E,2,20.0,1,1,7980.0,8000.0
29039,UBA81A7,2,-10.0,2,0,10.0,0.0
29040,UD466B6,2,1160.0,0,2,0.0,1160.0
29041,UFBA5A7,2,0.0,1,1,9000.0,9000.0
29042,UD1E172,2,600.0,0,2,0.0,600.0
29043,UC986B5,2,43423.32,0,2,0.0,43423.32
29044,U9E957E,2,410.8600000000006,1,1,19500.0,19910.86
29045,UE2E079,2,0.0,1,1,0.1,0.1
29046,UCE173E,2,0.0,1,1,950.0,950.0
29047,U59C7D9,2,-2020.0,2,0,2020.0,0.0
29048,U4818F2,2,3016.7,1,1,983.3,4000.0
29049,U4FC8C8,2,-10.0,2,0,10.0,0.0
29050,U02F304,2,0.0,1,1,6.0,6.0
29051,U03C893,2,0.0,1,1,506.0,506.0
29052,UFDCAF0,2,0.0,1,1,100.0,100.0
29053,U4D2742,2,-46536.0,2,0,46536.0,0.0
29054,U9E523F,2,99.0,1,1,1.0,100.0
29055,U5E2084,2,0.0,1,1,5.0,5.0
29056,UCD4190,2,200.0,0,2,0.0,200.0
29057,UB00557,2,3.5599999999999996,1,1,1.0,4.56
29058,U5627E1,2,-10.0,2,0,10.0,0.0
29059,UA5D99F,2,9000.0,1,1,14000.0,23000.0
29060,UBF9448,2,-151.9,2,0,151.9,0.0
29061,UFE1D1D,2,-139.94,1,1,140.0,0.06
29062,UD64983,2,30.0,0,2,0.0,30.0
29063,U314E96,2,90.00999999999999,1,1,49.99,140.0
29064,UCB7196,2,3916.66,0,2,0.0,3916.66
29065,UDC0907,2,-1070.0,2,0,1070.0,0.0
29066,U5EAE06,2,0.0,1,1,5000.0,5000.0
29067,UF142F8,2,58.85,0,2,0.0,58.85
29068,U44E8E0,2,0.1,0,2,0.0,0.1
29069,U1ADB90,2,-10.0,2,0,10.0,0.0
29070,U406389,2,-3.0,1,1,613.0,610.0
29071,U1A8171,2,-674.99,1,1,675.0,0.01
29072,UF791E3,2,740.0,0,2,0.0,740.0
29073,U8ECB66,2,0.18000000000000002,0,2,0.0,0.18000000000000002
29074,UD424F9,2,1050.0,0,2,0.0,1050.0
29075,UD89B4C,2,-10003.0,2,0,10003.0,0.0
29076,UD4DFD4,2,-1010.0,2,0,1010.0,0.0
29077,U7BC4A9,2,0.0,1,1,4855.0,4855.0
29078,UE75B20,2,1533.58,1,1,5.5,1539.08
29079,U9B403E,2,19.95,0,2,0.0,19.95
29080,UCC7879,2,110.01,0,2,0.0,110.01
29081,U45E747,2,0.0,1,1,131.0,131.0
29082,UA06164,2,-10.0,2,0,10.0,0.0
29083,U28F51D,2,-10.0,2,0,10.0,0.0
29084,U14D72E,2,0.0,1,1,100.0,100.0
29085,U756D3B,2,0.0,1,1,0.01,0.01
29086,U14BBD4,2,249.0,1,1,2450.0,2699.0
29087,U9236AA,2,-10.0,2,0,10.0,0.0
29088,U81F372,2,-10.0,2,0,10.0,0.0
29089,U855F3D,2,2781.01,0,2,0.0,2781.01
29090,U1FE765,2,-53500.0,2,0,53500.0,0.0
29091,U682735,2,1299.0,1,1,9561.0,10860.0
29092,U5CEF7D,2,471.01,0,2,0.0,471.01
29093,U15207E,2,0.0,1,1,175.0,175.0
29094,UF0A10C,2,6000.0,0,2,0.0,6000.0
29095,U79E075,2,-1000.0,1,1,8000.0,7000.0
29096,U9801EC,2,-10.0,2,0,10.0,0.0
29097,U187728,2,9.0,1,1,1.0,10.0
29098,UF5A30A,2,-2424.0,2,0,2424.0,0.0
29099,UE2C3C6,2,-10557.3,2,0,10557.3,0.0
29100,U4811A2,2,11659.8,0,2,0.0,11659.8
29101,UE0C782,2,0.0,1,1,900.0,900.0
29102,U3EA443,2,6947.91,0,2,0.0,6947.91
29103,UC41DFE,2,-336.0,2,0,336.0,0.0
29104,U706405,2,-278.0,2,0,278.0,0.0
29105,U6C82E8,2,-10.0,2,0,10.0,0.0
29106,U6AB8A5,2,0.0,1,1,0.01,0.01
29107,UC90DCB,2,0.0,1,1,5000.0,5000.0
29108,UE635B0,2,3733.35,0,2,0.0,3733.35
29109,U76CBB4,2,-16.41,1,1,16.5,0.09
29110,U4B46AC,2,0.0,1,1,102.98,102.98
29111,U1F50F3,2,3.0700000000000003,0,2,0.0,3.0700000000000003
29112,U25826E,2,-9.97,1,1,10.0,0.03
29113,U12BA46,2,0.0,1,1,560.0,560.0
29114,U999827,2,150.0,0,2,0.0,150.0
29115,UE422D3,2,-70.8,2,0,70.8,0.0
29116,U716D27,2,-10.0,2,0,10.0,0.0
29117,UB74C8C,2,13500.0,0,2,0.0,13500.0
29118,UD0E833,2,0.0,1,1,29.97,29.97
29119,UDB7CC6,2,40.0,0,2,0.0,40.0
29120,UF5EB09,2,11000.0,0,2,0.0,11000.0
29121,UEC6168,2,-10.0,2,0,10.0,0.0
29122,U4ABCC5,2,-2698.0,2,0,2698.0,0.0
29123,U3F61D8,2,2916.66,0,2,0.0,2916.66
29124,UFE3443,2,500.0,0,2,0.0,500.0
29125,U0CEA17,2,0.0,1,1,5.0,5.0
29126,U40FFB2,2,7000.0,0,2,0.0,7000.0
29127,U2F21D5,2,6010.0,0,2,0.0,6010.0
29128,UF16A17,2,1.0,1,1,5999.0,6000.0
29129,UB6CB75,2,0.05,1,1,0.05,0.1
29130,U476FA0,2,66.78,0,2,0.0,66.78
29131,U13E78E,2,36.99,1,1,0.01,37.0
29132,U5EA436,2,169.32,1,1,62.0,231.32
29133,U8CEFD0,2,0.0,1,1,250.0,250.0
29134,U855BD7,2,1600.0,0,2,0.0,1600.0
29135,U8697D5,2,15.57,0,2,0.0,15.57
29136,UE768EF,2,0.0,1,1,298.0,298.0
29137,U2016BA,2,0.0,1,1,115.8,115.8
29138,U0F0A1E,2,-109.9,2,0,109.9,0.0
29139,UDD7C49,2,0.0,1,1,30000.0,30000.0
29140,U07C3EA,2,2000.09,0,2,0.0,2000.09
29141,U992041,2,-277.66,2,0,277.66,0.0
29142,U12429B,2,-737.0,2,0,737.0,0.0
29143,UE99DCC,2,25.0,0,2,0.0,25.0
29144,U5B898A,2,-515.66,2,0,515.66,0.0
29145,UE26793,2,62.02,0,2,0.0,62.02
29146,UEA4892,2,-10.0,2,0,10.0,0.0
29147,U343D13,2,2.4099999999998545,1,1,3000.0,3002.41
29148,U4712E9,2,0.0,1,1,4800.0,4800.0
29149,UAC3661,2,39260.01,0,2,0.0,39260.01
29150,UD5608F,2,0.0,1,1,150.0,150.0
29151,U713342,2,-0.09999999999990905,1,1,3598.1,3598.0
29152,U6E647F,2,-10.0,2,0,10.0,0.0
29153,U4D4469,2,-10.0,2,0,10.0,0.0
29154,U8208EC,2,1000.99,1,1,0.01,1001.0
29155,U97546B,2,-7096.0,1,1,8000.0,904.0
29156,UCA5873,2,0.0,1,1,3000.0,3000.0
29157,U482FF6,2,-6.5,1,1,365.97,359.47
29158,UF5A81D,2,19.0,1,1,1.0,20.0
29159,UFF3D18,2,51.0,1,1,350.0,401.0
29160,UFC4531,2,-149999.97,1,1,150000.0,0.03
29161,U9995D9,2,182.59,0,2,0.0,182.59
29162,UAACA61,2,5810.0,0,2,0.0,5810.0
29163,U8662AB,2,0.0,1,1,3000.0,3000.0
29164,U495EE2,2,83100.0,0,2,0.0,83100.0
29165,U10A602,2,0.02,0,2,0.0,0.02
29166,UF99085,2,-10.0,2,0,10.0,0.0
29167,U061D98,2,140.0,1,1,60.0,200.0
29168,UF0FE74,2,3.8200000000000003,1,1,0.01,3.83
29169,UD0A939,2,273.0,1,1,727.0,1000.0
29170,UC7717A,2,6600.0,0,2,0.0,6600.0
29171,U16F8D3,2,-279.0,1,1,299.0,20.0
29172,UB84484,2,512.0,0,2,0.0,512.0
29173,U745B0A,2,0.0,1,1,100.0,100.0
29174,UB3B27B,2,-177.5,1,1,500.0,322.5
29175,UEB3AFB,2,0.0,1,1,20.76,20.76
29176,UD1D124,2,-35.59,2,0,35.59,0.0
29177,U947F3E,2,540.0,1,1,2800.0,3340.0
29178,UF6FFC1,2,-35776.74,2,0,35776.74,0.0
29179,U1DF66E,2,-10.0,2,0,10.0,0.0
29180,U3DAF70,2,-995.42,1,1,1000.0,4.58
29181,UA70DA6,2,0.0,1,1,4500.0,4500.0
29182,U811C65,2,163.70000000000005,1,1,750.0,913.7
29183,UD46D68,2,-156.22,2,0,156.22,0.0
29184,U44E9CD,2,-10.0,2,0,10.0,0.0
29185,U59AAA1,2,150.12,1,1,899.88,1050.0
29186,U21C5A5,2,0.58,0,2,0.0,0.58
29187,U1F6B8F,2,5413.0,0,2,0.0,5413.0
29188,U5BFA33,2,0.0,1,1,138.45,138.45
29189,U893103,2,-10.0,2,0,10.0,0.0
29190,UF4FF67,2,-240.0,1,1,1000.0,760.0
29191,U71A087,2,16.04,0,2,0.0,16.04
29192,UC04398,2,900.27,0,2,0.0,900.27
29193,U002765,2,-15000.0,2,0,15000.0,0.0
29194,U8B0052,2,-500.0,1,1,9500.0,9000.0
29195,U758935,2,8000.0,0,2,0.0,8000.0
29196,U6327E8,2,-10.0,2,0,10.0,0.0
29197,U5A5360,2,0.0,1,1,100.0,100.0
29198,UFBA13A,2,1000.0,0,2,0.0,1000.0
29199,U1BD0E5,2,-20.0,2,0,20.0,0.0
29200,UF1132E,2,-10.0,2,0,10.0,0.0
29201,U1FD768,2,0.060000000000000005,0,2,0.0,0.060000000000000005
29202,U2F31BC,2,-8848.0,1,1,10348.0,1500.0
29203,UBE25FB,2,-2.0,2,0,2.0,0.0
29204,UB61450,2,0.0,1,1,100.0,100.0
29205,U5D6AA3,2,0.0,1,1,9900.0,9900.0
29206,U3E3349,2,-711.9,1,1,712.48,0.58
29207,UA10CBA,2,0.0,1,1,1.3,1.3
29208,UCA7917,2,660.02,0,2,0.0,660.02
29209,UA03DD4,2,4700.0,0,2,0.0,4700.0
29210,U09ABCD,2,130.0,0,2,0.0,130.0
29211,UC750B7,2,-97.21,1,1,100.0,2.79
29212,U4782C5,2,-48190.09,1,1,50000.0,1809.91
29213,UFEFE35,2,1600.0,0,2,0.0,1600.0
29214,UD3FC49,2,452.38,0,2,0.0,452.38
29215,U3F00D8,2,988.01,0,2,0.0,988.01
29216,U81DEF4,2,13500.0,0,2,0.0,13500.0
29217,U146386,2,517.9,0,2,0.0,517.9
29218,UF482BF,2,5000.0,0,2,0.0,5000.0
29219,U5895CB,2,-10.0,2,0,10.0,0.0
29220,U0CF1AB,2,-0.26,2,0,0.26,0.0
29221,UFE4DA3,2,9366.599999999999,1,1,8120.0,17486.6
29222,UC4BCF8,2,-10.0,2,0,10.0,0.0
29223,U50F268,2,114.0,0,2,0.0,114.0
29224,U47A84C,2,400.0,0,2,0.0,400.0
29225,UACC299,2,16754.66,0,2,0.0,16754.66
29226,U1F4C8A,2,1.03,0,2,0.0,1.03
29227,UD8D69D,2,105.0,0,2,0.0,105.0
29228,UBC4C11,2,-1000.0,1,1,2500.0,1500.0
29229,U744BCE,2,0.0,1,1,46583.0,46583.0
29230,U125DFB,2,0.0,1,1,1936.29,1936.29
29231,U1A9FDB,2,0.0,1,1,24860.0,24860.0
29232,U0C7490,2,0.0,1,1,300.0,300.0
29233,U9160A4,2,168.0,0,2,0.0,168.0
29234,U7997EF,2,1000.0,0,2,0.0,1000.0
29235,U9F6478,2,128048.38,0,2,0.0,128048.38
29236,U7B0A63,2,3300.0,0,2,0.0,3300.0
29237,U2E59BD,2,70.0,0,2,0.0,70.0
29238,U57BFF8,2,0.0,1,1,22.0,22.0
29239,UB6E008,2,-4303.78,2,0,4303.78,0.0
29240,UA0CA4D,2,0.0,1,1,10.0,10.0
29241,U2B7C2E,2,5658.99,0,2,0.0,5658.99
29242,UC977D9,2,0.0,1,1,2.86,2.86
29243,U73A655,2,0.0,1,1,100.0,100.0
29244,UB9533F,2,410.0,1,1,1350.0,1760.0
29245,UE525B2,2,-10.0,2,0,10.0,0.0
29246,U7C23B7,2,0.0,1,1,31000.0,31000.0
29247,U636F0D,2,-10.0,2,0,10.0,0.0
29248,U2E90D5,2,-309.0,2,0,309.0,0.0
29249,U77FA76,2,0.09999999999999432,1,1,100.0,100.1
29250,UB8B15C,2,1308.0,1,1,3890.0,5198.0
29251,U8D532C,2,-3002.4,2,0,3002.4,0.0
29252,U588885,2,100.0,0,2,0.0,100.0
29253,U56F0E8,2,-10.0,2,0,10.0,0.0
29254,U5CE1A0,2,1836.0,1,1,16.0,1852.0
29255,U65673A,2,-108.5,2,0,108.5,0.0
29256,UFF800D,2,0.92,0,2,0.0,0.92
29257,UE1848D,2,0.0,1,1,2500.0,2500.0
29258,U778950,2,2.01,0,2,0.0,2.01
29259,UF154ED,2,-13800.0,2,0,13800.0,0.0
29260,U8EB75C,2,3300.0,0,2,0.0,3300.0
29261,UA67B04,2,113.70000000000002,1,1,39.6,153.3
29262,UD0300D,2,0.0,1,1,8800.0,8800.0
29263,U277215,2,1241.0,0,2,0.0,1241.0
29264,U1B98B3,2,-516.0400000000001,1,1,519.94,3.9
29265,U466700,2,-10.0,2,0,10.0,0.0
29266,U0C976D,2,-550.75,2,0,550.75,0.0
29267,UC15A00,2,0.0,1,1,1100.0,1100.0
29268,U61758F,2,7576.3,0,2,0.0,7576.3
29269,U66822B,2,-52.5,2,0,52.5,0.0
29270,UCFF434,2,0.0,1,1,13.8,13.8
29271,U298D68,2,-10.0,2,0,10.0,0.0
29272,UEC18A9,2,653.06,1,1,312.94,966.0
29273,U76C51C,2,-299.96,1,1,300.0,0.04
29274,U083C1D,2,-10.0,1,1,2890.0,2880.0
29275,U9A029F,2,-10.0,2,0,10.0,0.0
29276,U617DD7,2,0.21000000000000002,0,2,0.0,0.21000000000000002
29277,U03EC53,2,0.0,1,1,32.4,32.4
29278,U6F91A2,2,-1249.99,1,1,1250.0,0.01
29279,UA0AA4A,2,0.0,1,1,3000.0,3000.0
29280,U34D970,2,-29250.0,1,1,32500.0,3250.0
29281,U0D813E,2,234.3,0,2,0.0,234.3
29282,UE9845A,2,0.0,1,1,4000.0,4000.0
29283,UEFA303,2,1.9,0,2,0.0,1.9
29284,U5DC3C6,2,0.0,1,1,120.0,120.0
29285,UD870D2,2,-464.0,2,0,464.0,0.0
29286,U41F070,2,0.0,1,1,100.0,100.0
29287,U2E5594,2,-99.93,1,1,100.0,0.07
29288,UC0E78A,2,650.0,0,2,0.0,650.0
29289,UA9AD74,2,5.0,1,1,5.0,10.0
29290,U81AD17,2,-3915.76,1,1,4000.0,84.24
29291,U562082,2,-810.0,1,1,20980.0,20170.0
29292,U79572F,2,6.06,0,2,0.0,6.06
29293,U48764B,2,-10.8,1,1,10.89,0.09
29294,UBD6950,2,-2710.0,2,0,2710.0,0.0
29295,UE3AC7A,2,-10.0,2,0,10.0,0.0
29296,U9808FC,2,-6262.2,1,1,6958.0,695.8
29297,UD0E7C2,2,20.0,0,2,0.0,20.0
29298,UC3DBA2,2,1080.0,0,2,0.0,1080.0
29299,UB84D2E,2,50.0,1,1,2950.0,3000.0
29300,U95EBDC,2,200.0,1,1,300.0,500.0
29301,UDBF0F3,2,-399.16,2,0,399.16,0.0
29302,UDD51D4,2,-309.98,2,0,309.98,0.0
29303,UBD2927,2,-510.0,2,0,510.0,0.0
29304,U6A9E3C,2,-350.20000000000005,1,1,1398.2,1048.0
29305,UFDA228,2,3.0,0,2,0.0,3.0
29306,U3F6D27,2,-1879.0,2,0,1879.0,0.0
29307,U7519EE,2,0.0,1,1,300.0,300.0
29308,UD9E5F0,2,1.04,0,2,0.0,1.04
29309,U2F55AE,2,300.11,0,2,0.0,300.11
29310,U91CF1E,2,-22.12,2,0,22.12,0.0
29311,UB23ABD,2,1000.0,0,2,0.0,1000.0
29312,U64434B,2,164.54999999999998,0,2,0.0,164.54999999999998
29313,UD889C0,2,1200.0,0,2,0.0,1200.0
29314,U4BB6F5,2,0.96,0,2,0.0,0.96
29315,U6E26B4,2,3.0900000000000034,1,1,50.61,53.7
29316,U565FA5,2,-4648.0,1,1,5168.0,520.0
29317,UD3CCD6,2,60.0,0,2,0.0,60.0
29318,UC2EF8C,2,363.55999999999995,1,1,718.0,1081.56
29319,U6CB51D,2,-548.3299999999999,2,0,548.3299999999999,0.0
29320,UDBFC6E,2,0.0,1,1,5000.0,5000.0
29321,UA83591,2,3200.0,0,2,0.0,3200.0
29322,UF9032B,2,0.5099999999999909,1,1,268.49,269.0
29323,U127B85,2,0.0,1,1,199.0,199.0
29324,U5762A4,2,114.03,1,1,215.97,330.0
29325,UD22DAD,2,95.0,1,1,5.0,100.0
29326,U7C664B,2,0.0,1,1,1.25,1.25
29327,UCEBBC9,2,-1228.0,2,0,1228.0,0.0
29328,U3FC466,2,950.9,0,2,0.0,950.9
29329,U9D3892,2,-153.94,2,0,153.94,0.0
29330,UD0A522,2,0.0,1,1,8879.0,8879.0
29331,U2141F6,2,0.0,1,1,284.0,284.0
29332,UC32276,2,-10.0,2,0,10.0,0.0
29333,U2FC16E,2,114.0,0,2,0.0,114.0
29334,U177B42,2,500.0,1,1,500.0,1000.0
29335,U719D50,2,1130.01,0,2,0.0,1130.01
29336,U284EE7,2,-10.0,2,0,10.0,0.0
29337,U36CB16,2,0.0,1,1,3700.0,3700.0
29338,U75A4AA,2,-160.0,2,0,160.0,0.0
29339,UF91D23,2,340.0,0,2,0.0,340.0
29340,UE22F29,2,-25.0,1,1,3875.0,3850.0
29341,UFCC80B,2,200.0,0,2,0.0,200.0
29342,UC16EEA,2,-288.23,1,1,289.0,0.77
29343,U7AD6FF,2,2663.66,0,2,0.0,2663.66
29344,U381968,2,7033.3,0,2,0.0,7033.3
29345,UA88BFA,2,138.5,0,2,0.0,138.5
29346,U0BC1B1,2,1.0,1,1,2899.0,2900.0
29347,U4584AF,2,-10.0,2,0,10.0,0.0
29348,UC84F23,2,0.0,1,1,58.0,58.0
29349,UCE58AC,2,6390.34,0,2,0.0,6390.34
29350,U749984,2,0.39,0,2,0.0,0.39
29351,U62AFA0,2,0.0,1,1,1599.0,1599.0
29352,UDB8EA9,2,4.6,0,2,0.0,4.6
29353,U1DE691,2,-636.0,1,1,2986.0,2350.0
29354,UA5B86D,2,44.1,1,1,5.9,50.0
29355,UB0FEE9,2,-16989.04,1,1,17000.0,10.96
29356,UD8DB23,2,-10.0,2,0,10.0,0.0
29357,U505E33,2,650.0,0,2,0.0,650.0
29358,UE2E968,2,-54.0,1,1,199.0,145.0
29359,UA3CD5C,2,-999.96,1,1,1000.0,0.04
29360,U09BC96,2,-73.98,2,0,73.98,0.0
29361,UAD7E60,2,143655.0,0,2,0.0,143655.0
29362,U076843,2,50.0,0,2,0.0,50.0
29363,UF29EC2,2,-10.0,2,0,10.0,0.0
29364,U181C3C,2,-13430.0,1,1,13500.0,70.0
29365,UB58A2F,2,0.0,1,1,3.0,3.0
29366,U167586,2,-29.89,1,1,30.0,0.11
29367,UDDCB53,2,-29982.82,1,1,30000.0,17.18
29368,U32B24F,2,800.0,0,2,0.0,800.0
29369,UE0108E,2,210.0,0,2,0.0,210.0
29370,UE6A277,2,0.0,1,1,280.0,280.0
29371,UF77BAA,2,-2.49,1,1,2.5,0.01
29372,U359506,2,0.3000000000001819,1,1,3703.7,3704.0
29373,UDBC94D,2,594.0,0,2,0.0,594.0
29374,U37B510,2,1000.0,0,2,0.0,1000.0
29375,UD7AEDD,2,600.0,0,2,0.0,600.0
29376,U4210A3,2,-28841.899999999998,2,0,28841.899999999998,0.0
29377,UC0BE79,2,5916.68,0,2,0.0,5916.68
29378,U11DD37,2,-10.0,2,0,10.0,0.0
29379,U9C48CC,2,900.0,0,2,0.0,900.0
29380,UC8692B,2,429.42999999999984,1,1,3000.0,3429.43
29381,UA757D0,2,0.0,1,1,4350.0,4350.0
29382,U95EF6F,2,-15000.0,2,0,15000.0,0.0
29383,U491AA1,2,-203.0,2,0,203.0,0.0
29384,UDA8F53,2,8333.34,0,2,0.0,8333.34
29385,UDB98D1,2,545.5,0,2,0.0,545.5
29386,UF85A02,2,40.41,0,2,0.0,40.41
29387,UC9D6F8,2,-478.89,1,1,479.2,0.31
29388,UE6F83D,2,-10.0,2,0,10.0,0.0
29389,U304F0F,2,-760.0,2,0,760.0,0.0
29390,UFC65B5,2,-10.0,2,0,10.0,0.0
29391,UD7EE28,2,460.0,0,2,0.0,460.0
29392,UF3DF3C,2,0.0,1,1,1835.0,1835.0
29393,UDDCA1B,2,-10.0,2,0,10.0,0.0
29394,U62058F,2,-24.7,1,1,24.73,0.03
29395,U498BE6,2,-49999.31,1,1,50000.0,0.69
29396,U9C18EA,2,-9123.16,2,0,9123.16,0.0
29397,UCB4F3A,2,-640.0,1,1,2200.0,1560.0
29398,U4DB71A,2,900.0,0,2,0.0,900.0
29399,U42CCC5,2,-165.1,2,0,165.1,0.0
29400,U8C2797,2,100.0,0,2,0.0,100.0
29401,U1CDE38,2,-1004.53,2,0,1004.53,0.0
29402,UD309C9,2,-421.98,2,0,421.98,0.0
29403,UF92D13,2,-10.0,2,0,10.0,0.0
29404,UD21B32,2,2400.0,0,2,0.0,2400.0
29405,U081A70,2,-10.0,2,0,10.0,0.0
29406,UD40E5C,2,-10.0,2,0,10.0,0.0
29407,U4F1F7C,2,0.0,1,1,0.01,0.01
29408,UC4AEC4,2,0.0,1,1,3000.0,3000.0
29409,U9326EB,2,0.0,1,1,26.0,26.0
29410,UD4AB27,2,18446.0,0,2,0.0,18446.0
29411,U017D93,2,400.0,0,2,0.0,400.0
29412,U66A2EE,2,2520.46,0,2,0.0,2520.46
29413,UD63622,2,0.0,1,1,12.0,12.0
29414,U25C2D1,2,401.0,1,1,300.0,701.0
29415,UF83DCE,2,-3992.0,1,1,4000.0,8.0
29416,UF96695,2,0.0,1,1,558.97,558.97
29417,U2B85F2,2,338.0,0,2,0.0,338.0
29418,UCEFA04,2,188.39,1,1,91.61,280.0
29419,UDCBE16,2,-1.0,1,1,10000.0,9999.0
29420,U0CBA8B,2,-13238.1,2,0,13238.1,0.0
29421,UF6DB57,2,263.12,0,2,0.0,263.12
29422,UE68638,2,400.0,1,1,2400.0,2800.0
29423,U6003EF,2,0.0,1,1,1.99,1.99
29424,U70D171,2,270.0,1,1,1730.0,2000.0
29425,U64FBA0,2,-30.0,1,1,1730.0,1700.0
29426,UDC14F0,2,0.0,1,1,99.8,99.8
29427,UE1100D,2,-22.97,1,1,23.0,0.03
29428,UF035CB,2,-10.0,2,0,10.0,0.0
29429,U3A8CAB,2,-99.98,1,1,100.0,0.02
29430,U301B1D,2,0.0,1,1,0.01,0.01
29431,UEB8265,2,121730.0,1,1,270.0,122000.0
29432,UBC943D,2,-206.88,2,0,206.88,0.0
29433,UFA3659,2,-10.0,2,0,10.0,0.0
29434,UD117E3,2,0.0,1,1,1100.0,1100.0
29435,U3980B6,2,-57.0,1,1,60.0,3.0
29436,U7C04C4,2,1700.0,0,2,0.0,1700.0
29437,UBCDA81,2,-804.44,2,0,804.44,0.0
29438,UEFEF11,2,42.0,0,2,0.0,42.0
29439,U299EBC,2,10.520000000000001,0,2,0.0,10.520000000000001
29440,UBD635A,2,0.0,1,1,100.0,100.0
29441,U124A6D,2,15.0,1,1,5.0,20.0
29442,U631008,2,470.0,0,2,0.0,470.0
29443,UEF69DD,2,25.48,0,2,0.0,25.48
29444,U96B754,2,700.0,0,2,0.0,700.0
29445,U0CDC05,2,1906.0,1,1,6000.0,7906.0
29446,U52FE3E,2,623.0,0,2,0.0,623.0
29447,U642951,2,0.04,1,1,0.01,0.05
29448,UDCA933,2,27.87,0,2,0.0,27.87
29449,UAEDFA7,2,-336.0,2,0,336.0,0.0
29450,UC53485,2,157.9,1,1,1.0,158.9
29451,U92F4B1,2,-5506.74,2,0,5506.74,0.0
29452,UD05503,2,-498.91,1,1,499.0,0.09
29453,U46C43B,2,-10.0,2,0,10.0,0.0
29454,UB160A1,2,218.13,0,2,0.0,218.13
29455,UD592C6,2,3100.0,0,2,0.0,3100.0
29456,U4ED897,2,700.01,0,2,0.0,700.01
29457,U0C5827,2,-19.0,1,1,169.0,150.0
29458,UF13057,2,112.0,1,1,341.0,453.0
29459,UD2194B,2,2993.55,1,1,1000.0,3993.55
29460,UE38E26,2,618.0,0,2,0.0,618.0
29461,UFB210C,2,150.0,0,2,0.0,150.0
29462,UCD9A0D,2,-30479.15,2,0,30479.15,0.0
29463,U5DFA19,2,-3.0,2,0,3.0,0.0
29464,U03A007,2,0.0,1,1,200.0,200.0
29465,U972166,2,1.1,0,2,0.0,1.1
29466,U6034B9,2,2300.0,0,2,0.0,2300.0
29467,UBF882E,2,-10.0,2,0,10.0,0.0
29468,U34E46F,2,-10.0,2,0,10.0,0.0
29469,UBBF9FE,2,0.0,1,1,300.0,300.0
29470,U46D495,2,0.0,1,1,9327.0,9327.0
29471,U7896A6,2,-10.0,2,0,10.0,0.0
29472,U1C719B,2,2000.0,0,2,0.0,2000.0
29473,U544275,2,1399.0,1,1,1.0,1400.0
29474,U548D90,2,1162.0,0,2,0.0,1162.0
29475,UD6D10C,2,1700.0,0,2,0.0,1700.0
29476,U050C1B,2,0.0,1,1,1.0,1.0
29477,UF86E3B,2,0.0,1,1,5.0,5.0
29478,UDAADD8,2,3326.51,1,1,23.49,3350.0
29479,UFCB5DE,2,-10.0,2,0,10.0,0.0
29480,U84AF95,2,20.08,0,2,0.0,20.08
29481,UC9E06D,2,0.0,1,1,700.0,700.0
29482,U534B23,2,30.0,0,2,0.0,30.0
29483,UA60CFB,2,-640.0,1,1,2800.0,2160.0
29484,U46CE8D,2,0.18000000000000682,1,1,418.82,419.0
29485,U0ACEF0,2,0.0,1,1,1.0,1.0
29486,U47B674,2,1.6500000000000001,0,2,0.0,1.6500000000000001
29487,U4068BE,2,-4.51,1,1,15.0,10.49
29488,U609843,2,-10.0,2,0,10.0,0.0
29489,U62BDE6,2,-130.66,2,0,130.66,0.0
29490,U6EA152,2,-15.81,1,1,15.9,0.09
29491,U728134,2,-11999.0,1,1,13999.0,2000.0
29492,U8B74D4,2,-10.0,2,0,10.0,0.0
29493,UC31BB5,2,4955.0,0,2,0.0,4955.0
29494,U58C88A,2,7955.0,0,2,0.0,7955.0
29495,U5A9907,2,0.27,0,2,0.0,0.27
29496,U409315,2,-3.0,2,0,3.0,0.0
29497,U2AE804,2,-10.0,2,0,10.0,0.0
29498,U1F91DF,2,20.0,0,2,0.0,20.0
29499,UDFC52F,2,0.0,1,1,20.0,20.0
29500,U416330,2,81.45,0,2,0.0,81.45
29501,U598DCA,2,700.0,0,2,0.0,700.0
29502,U38CEEA,2,0.0,1,1,116.0,116.0
29503,U4F6B50,2,30572.67,0,2,0.0,30572.67
29504,U136013,2,0.0,1,1,300.0,300.0
29505,U41E5C2,2,2000.0,0,2,0.0,2000.0
29506,U73A55C,2,-10.0,2,0,10.0,0.0
29507,UE171DF,2,70.0,0,2,0.0,70.0
29508,U08D308,2,5600.0,0,2,0.0,5600.0
29509,U4A470F,2,-7000.0,2,0,7000.0,0.0
29510,U49600D,2,-24.349999999999994,1,1,94.28,69.93
29511,U4299E0,2,0.0,1,1,280.0,280.0
29512,U982CA1,2,0.0,1,1,100.0,100.0
29513,UDBCB23,2,-110.2,2,0,110.2,0.0
29514,UDE0A83,2,0.0,1,1,0.01,0.01
29515,U3E1141,2,912.87,0,2,0.0,912.87
29516,U8CA57C,2,-10.0,2,0,10.0,0.0
29517,U503C6C,2,-10.0,2,0,10.0,0.0
29518,U6F7EF0,2,-16.5,1,1,88.54,72.04
29519,UB53725,2,19836.0,1,1,252.0,20088.0
29520,UF57DE4,2,0.0,1,1,1547.0,1547.0
29521,U568017,2,-7.98,1,1,8.0,0.02
29522,UDCE21C,2,128.20000000000002,1,1,13.6,141.8
29523,U594E85,2,-267.0,2,0,267.0,0.0
29524,U2B57BD,2,-527.39,2,0,527.39,0.0
29525,U00BD2D,2,0.0,1,1,250.0,250.0
29526,U32ACC9,2,0.0,1,1,0.27,0.27
29527,UAF2C29,2,0.0,1,1,640.0,640.0
29528,U40BCFA,2,100.01,0,2,0.0,100.01
29529,UDB09DD,2,-10.0,2,0,10.0,0.0
29530,UA50A6C,2,200.0,0,2,0.0,200.0
29531,UFAE602,2,688.0,1,1,1500.0,2188.0
29532,U513515,2,432.56,0,2,0.0,432.56
29533,U08AEE1,2,10.100000000000001,1,1,29.9,40.0
29534,UCC9FE9,2,-6.0,2,0,6.0,0.0
29535,U3494EB,2,-17400.0,2,0,17400.0,0.0
29536,UEC1D98,2,0.0,1,1,3.98,3.98
29537,U99C3E0,2,-10.0,2,0,10.0,0.0
29538,UA5570D,2,-10.0,2,0,10.0,0.0
29539,U1D7DCC,2,-16885.0,2,0,16885.0,0.0
29540,U804AD4,2,1060.0,0,2,0.0,1060.0
29541,UFD8EE0,2,9400.0,0,2,0.0,9400.0
29542,UBD4398,2,-10.0,2,0,10.0,0.0
29543,U5A6CB7,2,-18.0,1,1,449.0,431.0
29544,U98BBB7,2,0.0,1,1,3000.0,3000.0
29545,UB77078,2,0.0,1,1,99.7,99.7
29546,UAB6C4F,2,105.0,0,2,0.0,105.0
29547,U11E3A5,2,-6074.0,1,1,8074.0,2000.0
29548,U4F20CF,2,534.1,0,2,0.0,534.1
29549,UB55D01,2,0.0,1,1,4980.0,4980.0
29550,U5D0117,2,-3000.0,2,0,3000.0,0.0
29551,UBAA0F6,2,185.0,0,2,0.0,185.0
29552,U5A7FFA,2,9999.0,0,2,0.0,9999.0
29553,UC41466,2,-10.0,2,0,10.0,0.0
29554,UBAC401,2,0.0,1,1,9750.0,9750.0
29555,U69DF64,2,-539.6,2,0,539.6,0.0
29556,UD65263,2,-987.34,2,0,987.34,0.0
29557,U75F2BC,2,0.0,1,1,625.46,625.46
29558,UA225B5,2,10.0,0,2,0.0,10.0
29559,U03ECEB,2,-344.0,1,1,8275.0,7931.0
29560,U3622B9,2,-10.0,2,0,10.0,0.0
29561,U7BDE4C,2,-0.02,2,0,0.02,0.0
29562,UC92A60,2,4874.0,0,2,0.0,4874.0
29563,U129700,2,-82.93,1,1,84.0,1.07
29564,U8036C9,2,0.0,1,1,100.0,100.0
29565,U2748D6,2,7000.0,0,2,0.0,7000.0
29566,U10C3AE,2,43.0,1,1,457.0,500.0
29567,U4FD9FD,2,94.25,0,2,0.0,94.25
29568,UDA6B48,2,-8992.0,2,0,8992.0,0.0
29569,UBB3E4C,2,-15.94,1,1,16.0,0.06
29570,U7D717D,2,100.0,0,2,0.0,100.0
29571,UAEA325,2,-10.0,2,0,10.0,0.0
29572,U21A9A9,2,3300.03,0,2,0.0,3300.03
29573,U34BE99,2,370.0,1,1,1130.0,1500.0
29574,UEA03C5,2,-1.59,1,1,1.6,0.01
29575,U0540A1,2,-0.3300000000000409,1,1,800.0,799.67
29576,UD90CF3,2,0.0,1,1,373.5,373.5
29577,UCD3717,2,1194.77,0,2,0.0,1194.77
29578,U2A1FEF,2,0.0,1,1,63.5,63.5
29579,U525243,2,0.0,1,1,6000.0,6000.0
29580,U988F7A,2,0.0,1,1,300.0,300.0
29581,UA61B4D,2,5000.0,0,2,0.0,5000.0
29582,UC93E24,2,-50.0,1,1,6060.0,6010.0
29583,UA07517,2,130.02,0,2,0.0,130.02
29584,U976038,2,71.21999999999997,1,1,371.22,442.44
29585,U2C10C5,2,0.0,1,1,8000.0,8000.0
29586,U962F97,2,-10.0,2,0,10.0,0.0
29587,U930EF7,2,-10.0,2,0,10.0,0.0
29588,UE96C2B,2,0.0,1,1,30.0,30.0
29589,U440998,2,1569.1100000000001,0,2,0.0,1569.1100000000001
29590,UA569F8,2,0.0,1,1,0.02,0.02
29591,U179DD3,2,-10.0,2,0,10.0,0.0
29592,UDA7566,2,0.0,1,1,196.1,196.1
29593,U6C7675,2,-1150.0,2,0,1150.0,0.0
29594,U67E2B0,2,-120.0,2,0,120.0,0.0
29595,U5792A7,2,-950.0,1,1,3450.0,2500.0
29596,UE9E461,2,202.38,0,2,0.0,202.38
29597,U274B02,2,-600.0,1,1,21950.0,21350.0
29598,U1DEDDF,2,-2999.0,1,1,3000.0,1.0
29599,U57024D,2,20.0,0,2,0.0,20.0
29600,U779E59,2,-10.0,2,0,10.0,0.0
29601,UFE7C26,2,10900.0,0,2,0.0,10900.0
29602,U3415D5,2,0.0,1,1,251.4,251.4
29603,UC479DB,2,4225.02,0,2,0.0,4225.02
29604,U369E30,2,0.0,1,1,100.0,100.0
29605,U6CFD60,2,-522.5,2,0,522.5,0.0
29606,UF87EF0,2,-11.43,1,1,11.5,0.07
29607,U142786,2,602.0,1,1,4598.0,5200.0
29608,U1E156D,2,-15.37,1,1,27.25,11.88
29609,UC7F9CB,2,0.0,1,1,49.4,49.4
29610,U1420A8,2,-1362.0700000000002,2,0,1362.0700000000002,0.0
29611,UFA59D1,2,8300.0,0,2,0.0,8300.0
29612,U671A69,2,1340.0,0,2,0.0,1340.0
29613,U293D61,2,3083.29,0,2,0.0,3083.29
29614,U13D896,2,420.0,0,2,0.0,420.0
29615,UA32727,2,2500.0,1,1,5000.0,7500.0
29616,UE2F29B,2,260.0,0,2,0.0,260.0
29617,U9301D3,2,-510.0,2,0,510.0,0.0
29618,U283038,2,702.35,0,2,0.0,702.35
29619,UC070E4,2,-10.0,2,0,10.0,0.0
29620,U8F6BB5,2,0.0,1,1,10.0,10.0
29621,U746F1B,2,-330.7,2,0,330.7,0.0
29622,UA658B5,2,14000.0,0,2,0.0,14000.0
29623,U126F2B,2,0.06,0,2,0.0,0.06
29624,U36D649,2,-11.579999999999984,1,1,310.0,298.42
29625,U70698D,2,-8.18,1,1,8.2,0.02
29626,UF30539,2,0.0,1,1,0.01,0.01
29627,U251C57,2,150.0,1,1,250.0,400.0
29628,UCCC335,2,0.0,1,1,6320.0,6320.0
29629,U749BB6,2,-10.0,2,0,10.0,0.0
29630,U808F98,2,1988.0,0,2,0.0,1988.0
29631,UBADB5B,2,0.4199999999999591,1,1,1012.0,1012.42
29632,U9B94F6,2,0.0,1,1,120.0,120.0
29633,U0DBF76,2,0.0,1,1,15.0,15.0
29634,UFC3463,2,-10.0,2,0,10.0,0.0
29635,UF1E79A,2,0.0,1,1,2.0,2.0
29636,UD9E135,2,1850.0,1,1,2250.0,4100.0
29637,U9D18A5,2,860.0,0,2,0.0,860.0
29638,U75C448,2,400.0,0,2,0.0,400.0
29639,U912D84,2,273.0,1,1,227.0,500.0
29640,U24F293,2,-684.31,2,0,684.31,0.0
29641,U638776,2,-10.0,2,0,10.0,0.0
29642,UDF6A54,2,0.0,1,1,149.3,149.3
29643,UCAD370,2,-10.0,2,0,10.0,0.0
29644,UC8F036,2,-44.9,2,0,44.9,0.0
29645,U0F8306,2,-2448.0,2,0,2448.0,0.0
29646,U8382A4,2,600.0,0,2,0.0,600.0
29647,U325152,2,-19981.03,1,1,20000.0,18.97
29648,UC40BC8,2,30.0,0,2,0.0,30.0
29649,UAE4A36,2,0.0,1,1,28.5,28.5
29650,U9C2258,2,0.0,1,1,4327.0,4327.0
29651,UEE1B04,2,-10.0,2,0,10.0,0.0
29652,UB091B1,2,-3996.82,1,1,4000.0,3.18
29653,U860153,2,0.8500000000000014,1,1,56.15,57.0
29654,U0A2684,2,20.0,0,2,0.0,20.0
29655,U8CE09D,2,5246.0,0,2,0.0,5246.0
29656,U9B7F2A,2,-2000.0,1,1,3000.0,1000.0
29657,U42A451,2,-410.0,1,1,2563.0,2153.0
29658,U21DD8D,2,4802.0,0,2,0.0,4802.0
29659,U65F526,2,-5883.0,1,1,5998.0,115.0
29660,U039D19,2,-10.0,2,0,10.0,0.0
29661,U7632EF,2,2490.34,0,2,0.0,2490.34
29662,U4AE4CD,2,651.0,1,1,872.0,1523.0
29663,U2F8324,2,186.47000000000003,1,1,313.53,500.0
29664,U694C6E,2,700.0,0,2,0.0,700.0
29665,UAB8816,2,620.0,0,2,0.0,620.0
29666,UD5FC99,2,0.0,1,1,2776.99,2776.99
29667,U7A2286,2,4219.44,0,2,0.0,4219.44
29668,U4E9D83,2,5602.0,1,1,19998.0,25600.0
29669,U947D40,2,503.0,1,1,3800.0,4303.0
29670,U619FF5,2,-204.58,2,0,204.58,0.0
29671,U5FCCB1,2,1300.0,0,2,0.0,1300.0
29672,U9E663C,2,468.0,1,1,300.0,768.0
29673,U10B87B,2,0.0,1,1,5.0,5.0
29674,UDEB384,2,0.0,1,1,206.4,206.4
29675,UE4E964,2,0.0,1,1,9541.0,9541.0
29676,U79DFA6,2,-364.95,2,0,364.95,0.0
29677,U4C4789,2,-160.1,1,1,210.1,50.0
29678,U6C9CBF,2,3230.0,0,2,0.0,3230.0
29679,U8B2547,2,-23.53,1,1,23.55,0.02
29680,U8AA12D,2,0.0,1,1,25.23,25.23
29681,U768510,2,60.0,1,1,139.0,199.0
29682,U3E2302,2,-10.0,2,0,10.0,0.0
29683,U2AE19A,2,-0.64,2,0,0.64,0.0
29684,UEF6097,2,12209.94,0,2,0.0,12209.94
29685,UE2E814,2,-10.0,2,0,10.0,0.0
29686,U793684,2,150.0,0,2,0.0,150.0
29687,U87F3BE,2,-10.0,2,0,10.0,0.0
29688,UC689A7,2,-10.0,2,0,10.0,0.0
29689,UE19F61,2,156.39000000000001,0,2,0.0,156.39000000000001
29690,U95D048,2,0.0,1,1,100.0,100.0
29691,U45769E,2,11.0,0,2,0.0,11.0
29692,U0919CC,2,3484.59,1,1,3041.2,6525.79
29693,U9D9AE3,2,-10.0,2,0,10.0,0.0
29694,U9EBA0A,2,-150.0,1,1,2250.0,2100.0
29695,UA08E85,2,-21.93,1,1,22.0,0.07
29696,U89C9AC,2,61.660000000000004,0,2,0.0,61.660000000000004
29697,U03469A,1,0.04,0,1,0.0,0.04
29698,UDF6905,1,-2.29,1,0,2.29,0.0
29699,U5E3924,1,2.0,0,1,0.0,2.0
29700,U03F557,1,357.75,0,1,0.0,357.75
29701,U923DB5,1,10.98,0,1,0.0,10.98
29702,U9F9BFA,1,0.17,0,1,0.0,0.17
29703,UD94349,1,3000.0,0,1,0.0,3000.0
29704,U23F85B,1,350.0,0,1,0.0,350.0
29705,UB02521,1,400.0,0,1,0.0,400.0
29706,U48847D,1,0.01,0,1,0.0,0.01
29707,U036847,1,0.01,0,1,0.0,0.01
29708,U1B1CB1,1,0.04,0,1,0.0,0.04
29709,U57BC0F,1,0.01,0,1,0.0,0.01
29710,UA418F7,1,100.0,0,1,0.0,100.0
29711,U286A5F,1,240.0,0,1,0.0,240.0
29712,U037A63,1,0.73,0,1,0.0,0.73
29713,UF3B074,1,1000.0,0,1,0.0,1000.0
29714,U0087B7,1,-800.0,1,0,800.0,0.0
29715,UC82278,1,0.03,0,1,0.0,0.03
29716,UD06415,1,0.19,0,1,0.0,0.19
29717,UCB7921,1,2.55,0,1,0.0,2.55
29718,UD1FF3E,1,0.1,0,1,0.0,0.1
29719,UD4A8BF,1,0.01,0,1,0.0,0.01
29720,U8E99FF,1,100.91,0,1,0.0,100.91
29721,U162620,1,-100.0,1,0,100.0,0.0
29722,U22024D,1,200.0,0,1,0.0,200.0
29723,U2C76D4,1,0.17,0,1,0.0,0.17
29724,U076E80,1,0.77,0,1,0.0,0.77
29725,U9FC322,1,0.58,0,1,0.0,0.58
29726,U90FD0C,1,-1032.0,1,0,1032.0,0.0
29727,U5E9521,1,1662.18,0,1,0.0,1662.18
29728,UB376A9,1,200.0,0,1,0.0,200.0
29729,U26BFD2,1,-19.6,1,0,19.6,0.0
29730,U1FC532,1,6000.0,0,1,0.0,6000.0
29731,U0A909A,1,-300.0,1,0,300.0,0.0
29732,UDCA418,1,-300.0,1,0,300.0,0.0
29733,U80057A,1,89.0,0,1,0.0,89.0
29734,U05FBE8,1,6.52,0,1,0.0,6.52
29735,UC1CBA0,1,184.0,0,1,0.0,184.0
29736,UF8AAF7,1,410.0,0,1,0.0,410.0
29737,U5D4B6A,1,0.01,0,1,0.0,0.01
29738,U313C20,1,0.07,0,1,0.0,0.07
29739,U64C597,1,300.0,0,1,0.0,300.0
29740,UA13D1F,1,0.02,0,1,0.0,0.02
29741,U9F3C43,1,0.18,0,1,0.0,0.18
29742,U565643,1,4346.0,0,1,0.0,4346.0
29743,U77902F,1,0.73,0,1,0.0,0.73
29744,U515F1F,1,0.01,0,1,0.0,0.01
29745,U38A8CE,1,0.03,0,1,0.0,0.03
29746,UD84989,1,260.0,0,1,0.0,260.0
29747,U0ABF35,1,-14800.0,1,0,14800.0,0.0
29748,U493803,1,0.01,0,1,0.0,0.01
29749,UE52AFC,1,0.01,0,1,0.0,0.01
29750,U74BFE1,1,0.01,0,1,0.0,0.01
29751,U285404,1,200.0,0,1,0.0,200.0
29752,U57D88B,1,10.74,0,1,0.0,10.74
29753,U3F7B12,1,0.01,0,1,0.0,0.01
29754,UB1302D,1,0.01,0,1,0.0,0.01
29755,UE3B264,1,2050.0,0,1,0.0,2050.0
29756,UE96517,1,0.48,0,1,0.0,0.48
29757,U97C2CF,1,0.06,0,1,0.0,0.06
29758,U681A18,1,0.08,0,1,0.0,0.08
29759,U64A155,1,3800.0,0,1,0.0,3800.0
29760,U1BBEFA,1,988.0,0,1,0.0,988.0
29761,UB5CA75,1,2841.0,0,1,0.0,2841.0
29762,U31BFB6,1,-596.0,1,0,596.0,0.0
29763,U7EF984,1,-14000.0,1,0,14000.0,0.0
29764,U3CFC56,1,-24.59,1,0,24.59,0.0
29765,UBB96A4,1,100.0,0,1,0.0,100.0
29766,U924CAF,1,500.0,0,1,0.0,500.0
29767,U540BE8,1,10000.0,0,1,0.0,10000.0
29768,U88D371,1,0.39,0,1,0.0,0.39
29769,U4171A0,1,700.0,0,1,0.0,700.0
29770,U6A8C68,1,0.03,0,1,0.0,0.03
29771,U4835E6,1,4200.0,0,1,0.0,4200.0
29772,UABB761,1,0.04,0,1,0.0,0.04
29773,U286232,1,20.0,0,1,0.0,20.0
29774,U4A9D01,1,100.0,0,1,0.0,100.0
29775,U9C7AF6,1,10000.0,0,1,0.0,10000.0
29776,U910CEA,1,0.01,0,1,0.0,0.01
29777,U3AB12E,1,0.04,0,1,0.0,0.04
29778,UF28206,1,0.01,0,1,0.0,0.01
29779,U2107C9,1,3341.0,0,1,0.0,3341.0
29780,UED110B,1,-1988.0,1,0,1988.0,0.0
29781,U8F717B,1,0.03,0,1,0.0,0.03
29782,U30ACB8,1,0.02,0,1,0.0,0.02
29783,U85F70F,1,-50.0,1,0,50.0,0.0
29784,UA7981B,1,-24.0,1,0,24.0,0.0
29785,U6FC6C0,1,-18860.0,1,0,18860.0,0.0
29786,U6AE730,1,2736.92,0,1,0.0,2736.92
29787,U91233B,1,0.09,0,1,0.0,0.09
29788,UEDF943,1,0.02,0,1,0.0,0.02
29789,U4B9EF3,1,883.0,0,1,0.0,883.0
29790,UF304AE,1,2000.0,0,1,0.0,2000.0
29791,UC8E121,1,900.0,0,1,0.0,900.0
29792,U9CFB39,1,-7.0,1,0,7.0,0.0
29793,U27EFED,1,-20000.0,1,0,20000.0,0.0
29794,UF88277,1,4500.0,0,1,0.0,4500.0
29795,UD2C5B5,1,500.0,0,1,0.0,500.0
29796,UFF0142,1,14.74,0,1,0.0,14.74
29797,U1B454F,1,150.0,0,1,0.0,150.0
29798,UEF21D1,1,3.0,0,1,0.0,3.0
29799,UF08727,1,0.05,0,1,0.0,0.05
29800,U292B3A,1,0.02,0,1,0.0,0.02
29801,U44E39E,1,-2.0,1,0,2.0,0.0
29802,U01B783,1,-500.0,1,0,500.0,0.0
29803,U9B582B,1,0.18,0,1,0.0,0.18
29804,U1CB3FD,1,0.05,0,1,0.0,0.05
29805,UE89D3B,1,0.01,0,1,0.0,0.01
29806,U9F9E15,1,3.0,0,1,0.0,3.0
29807,U13973D,1,1.95,0,1,0.0,1.95
29808,U5C8983,1,112.0,0,1,0.0,112.0
29809,UC945E7,1,-100.0,1,0,100.0,0.0
29810,U59AE95,1,-0.62,1,0,0.62,0.0
29811,U1F49D5,1,16.33,0,1,0.0,16.33
29812,U4F623F,1,0.01,0,1,0.0,0.01
29813,U5A6E44,1,-5000.0,1,0,5000.0,0.0
29814,UAE105A,1,50.0,0,1,0.0,50.0
29815,U2C5D29,1,-488.88,1,0,488.88,0.0
29816,UE7A60C,1,2648.74,0,1,0.0,2648.74
29817,U8E5C52,1,55.0,0,1,0.0,55.0
29818,U30561E,1,1075.0,0,1,0.0,1075.0
29819,U9DFB07,1,-1500.0,1,0,1500.0,0.0
29820,UC0BA20,1,0.02,0,1,0.0,0.02
29821,UC83CF5,1,0.04,0,1,0.0,0.04
29822,U4B3D08,1,-10130.0,1,0,10130.0,0.0
29823,UC7FA9B,1,0.02,0,1,0.0,0.02
29824,U5EDAB4,1,-5788.0,1,0,5788.0,0.0
29825,U4EA34A,1,6034.0,0,1,0.0,6034.0
29826,UC339E5,1,700.0,0,1,0.0,700.0
29827,U645599,1,15.42,0,1,0.0,15.42
29828,U4B1FA8,1,0.01,0,1,0.0,0.01
29829,U3C4ABE,1,0.04,0,1,0.0,0.04
29830,U686247,1,0.57,0,1,0.0,0.57
29831,UAA73A1,1,1.01,0,1,0.0,1.01
29832,U7AD592,1,-200.0,1,0,200.0,0.0
29833,U3DAFC5,1,-195.0,1,0,195.0,0.0
29834,U52D46E,1,0.03,0,1,0.0,0.03
29835,U781AE8,1,100.0,0,1,0.0,100.0
29836,U4439AB,1,0.02,0,1,0.0,0.02
29837,UCAAB14,1,0.01,0,1,0.0,0.01
29838,UFD57BF,1,0.02,0,1,0.0,0.02
29839,UDDFC1A,1,19757.0,0,1,0.0,19757.0
29840,UD11DB2,1,0.25,0,1,0.0,0.25
29841,U238F6B,1,0.22,0,1,0.0,0.22
29842,UDD5611,1,300.0,0,1,0.0,300.0
29843,UDC1950,1,4018.68,0,1,0.0,4018.68
29844,UC2C12A,1,300.0,0,1,0.0,300.0
29845,U8BDBE0,1,0.02,0,1,0.0,0.02
29846,U5ECFB7,1,0.03,0,1,0.0,0.03
29847,U0C7D13,1,0.03,0,1,0.0,0.03
29848,U7207B8,1,-100.0,1,0,100.0,0.0
29849,UEC26E7,1,-5.0,1,0,5.0,0.0
29850,U31F445,1,0.01,0,1,0.0,0.01
29851,U0D3BB4,1,0.02,0,1,0.0,0.02
29852,U86A92D,1,54.9,0,1,0.0,54.9
29853,UE34A7D,1,442.0,0,1,0.0,442.0
29854,UB1C78F,1,-15.0,1,0,15.0,0.0
29855,U41240C,1,0.15,0,1,0.0,0.15
29856,UBF8D3E,1,-300.0,1,0,300.0,0.0
29857,UC35487,1,11.17,0,1,0.0,11.17
29858,U29BA4D,1,75.2,0,1,0.0,75.2
29859,U720EA9,1,15.04,0,1,0.0,15.04
29860,U5D933B,1,0.29,0,1,0.0,0.29
29861,U400138,1,-100.0,1,0,100.0,0.0
29862,UF68AEC,1,-170.0,1,0,170.0,0.0
29863,U6FBD29,1,63.07,0,1,0.0,63.07
29864,U6B3303,1,1490.32,0,1,0.0,1490.32
29865,U56EEC5,1,3.27,0,1,0.0,3.27
29866,UE45086,1,110.0,0,1,0.0,110.0
29867,U3B7F79,1,0.01,0,1,0.0,0.01
29868,UD989E5,1,2000.0,0,1,0.0,2000.0
29869,UE636DB,1,0.02,0,1,0.0,0.02
29870,U8FA99A,1,100.0,0,1,0.0,100.0
29871,U3D654F,1,0.02,0,1,0.0,0.02
29872,UF94865,1,-29.9,1,0,29.9,0.0
29873,UE9A82D,1,68.64,0,1,0.0,68.64
29874,UAD008C,1,0.22,0,1,0.0,0.22
29875,UFA0887,1,0.43,0,1,0.0,0.43
29876,U4B0CE2,1,1251.0,0,1,0.0,1251.0
29877,U897051,1,100.0,0,1,0.0,100.0
29878,UF623E4,1,-499.0,1,0,499.0,0.0
29879,U8F9EE1,1,0.24,0,1,0.0,0.24
29880,UC0430C,1,0.05,0,1,0.0,0.05
29881,U17A82B,1,20.0,0,1,0.0,20.0
29882,U98C9FF,1,0.01,0,1,0.0,0.01
29883,U16E9F4,1,1000.0,0,1,0.0,1000.0
29884,U14269F,1,15.0,0,1,0.0,15.0
29885,U0E1321,1,-0.54,1,0,0.54,0.0
29886,UF7FFA4,1,0.01,0,1,0.0,0.01
29887,UB257FB,1,20.0,0,1,0.0,20.0
29888,U3C0DBE,1,-0.22,1,0,0.22,0.0
29889,U471FD5,1,1.17,0,1,0.0,1.17
29890,U9C1989,1,0.06,0,1,0.0,0.06
29891,U417A00,1,4920.0,0,1,0.0,4920.0
29892,UBEEE02,1,3019.0,0,1,0.0,3019.0
29893,U5BCE5D,1,0.28,0,1,0.0,0.28
29894,UB4FB0A,1,0.01,0,1,0.0,0.01
29895,U74DF26,1,0.39,0,1,0.0,0.39
29896,UA55C86,1,0.06,0,1,0.0,0.06
29897,U5B9CFC,1,134.09,0,1,0.0,134.09
29898,U81FF4D,1,15500.0,0,1,0.0,15500.0
29899,UCBE4F7,1,0.13,0,1,0.0,0.13
29900,U4FC835,1,0.01,0,1,0.0,0.01
29901,UE7475D,1,0.01,0,1,0.0,0.01
29902,U910A67,1,10.0,0,1,0.0,10.0
29903,U0D701D,1,6448.2,0,1,0.0,6448.2
29904,UF5F683,1,2878.0,0,1,0.0,2878.0
29905,UFA8F99,1,3000.0,0,1,0.0,3000.0
29906,UA8C016,1,0.85,0,1,0.0,0.85
29907,U119BC5,1,0.37,0,1,0.0,0.37
29908,UDAFD94,1,200.0,0,1,0.0,200.0
29909,UD49979,1,0.08,0,1,0.0,0.08
29910,UB59DE6,1,0.01,0,1,0.0,0.01
29911,U3D1858,1,-19.9,1,0,19.9,0.0
29912,UD30F18,1,-8000.0,1,0,8000.0,0.0
29913,UBA6EB0,1,0.9,0,1,0.0,0.9
29914,UF64B61,1,10.0,0,1,0.0,10.0
29915,U3E61A0,1,100.0,0,1,0.0,100.0
29916,U241805,1,-100.0,1,0,100.0,0.0
29917,U9A9FFF,1,0.01,0,1,0.0,0.01
29918,UD91D93,1,0.21,0,1,0.0,0.21
29919,U9A91F7,1,-69.0,1,0,69.0,0.0
29920,U17CF74,1,85.62,0,1,0.0,85.62
29921,U4B8924,1,15.0,0,1,0.0,15.0
29922,UB4C79D,1,6.55,0,1,0.0,6.55
29923,UDEEA0D,1,0.06,0,1,0.0,0.06
29924,U66FEE0,1,0.03,0,1,0.0,0.03
29925,U673D8F,1,3100.0,0,1,0.0,3100.0
29926,UE43BA3,1,0.01,0,1,0.0,0.01
29927,UAE19D5,1,0.12,0,1,0.0,0.12
29928,U2E7620,1,10.0,0,1,0.0,10.0
29929,U88E8A6,1,0.01,0,1,0.0,0.01
29930,U6F36F3,1,0.01,0,1,0.0,0.01
29931,U8A09E8,1,0.01,0,1,0.0,0.01
29932,U2E5E77,1,9.0,0,1,0.0,9.0
29933,U70F49F,1,0.2,0,1,0.0,0.2
29934,U4BBED7,1,0.04,0,1,0.0,0.04
29935,U369DE8,1,2.85,0,1,0.0,2.85
29936,UD98132,1,0.51,0,1,0.0,0.51
29937,U74B165,1,0.01,0,1,0.0,0.01
29938,UE500C8,1,610.0,0,1,0.0,610.0
29939,U1DA182,1,0.78,0,1,0.0,0.78
29940,UB4115F,1,1600.0,0,1,0.0,1600.0
29941,UB9AF80,1,-129.0,1,0,129.0,0.0
29942,UE78382,1,-102.37,1,0,102.37,0.0
29943,UF6D3AC,1,205.76,0,1,0.0,205.76
29944,UD9CD08,1,0.08,0,1,0.0,0.08
29945,U2ED38C,1,0.15,0,1,0.0,0.15
29946,U098880,1,-300.0,1,0,300.0,0.0
29947,U95DD80,1,0.01,0,1,0.0,0.01
29948,U410229,1,-436.0,1,0,436.0,0.0
29949,U857C23,1,100.0,0,1,0.0,100.0
29950,U69BDFF,1,0.5,0,1,0.0,0.5
29951,U99812E,1,0.6,0,1,0.0,0.6
29952,UF3FE93,1,11481.0,0,1,0.0,11481.0
29953,UD7D57A,1,0.16,0,1,0.0,0.16
29954,U59E5EE,1,8.0,0,1,0.0,8.0
29955,U444E92,1,0.06,0,1,0.0,0.06
29956,U9A2458,1,0.01,0,1,0.0,0.01
29957,UF2ADF0,1,0.01,0,1,0.0,0.01
29958,U18E0DF,1,-3.96,1,0,3.96,0.0
29959,U936024,1,-0.2,1,0,0.2,0.0
29960,UF559BA,1,455.28,0,1,0.0,455.28
29961,UD3EFA2,1,0.01,0,1,0.0,0.01
29962,U06B9CC,1,0.38,0,1,0.0,0.38
29963,U321147,1,218.63,0,1,0.0,218.63
29964,UB5ACA3,1,0.03,0,1,0.0,0.03
29965,U3BFEF5,1,-238.0,1,0,238.0,0.0
29966,U11B87C,1,35.0,0,1,0.0,35.0
29967,UC748E4,1,21.93,0,1,0.0,21.93
29968,UD1F30D,1,0.06,0,1,0.0,0.06
29969,U9BD275,1,1.32,0,1,0.0,1.32
29970,UF901D8,1,325.0,0,1,0.0,325.0
29971,U235A8A,1,3.98,0,1,0.0,3.98
29972,U19807E,1,-15.0,1,0,15.0,0.0
29973,UF5818B,1,13.75,0,1,0.0,13.75
29974,U55D861,1,61.0,0,1,0.0,61.0
29975,U7A906D,1,-2.91,1,0,2.91,0.0
29976,UD5F331,1,-40000.0,1,0,40000.0,0.0
29977,UE82201,1,494.88,0,1,0.0,494.88
29978,U6A0283,1,5500.0,0,1,0.0,5500.0
29979,U3EA2E7,1,0.04,0,1,0.0,0.04
29980,U77BC4C,1,0.04,0,1,0.0,0.04
29981,U2B921F,1,0.04,0,1,0.0,0.04
29982,U134858,1,3113.0,0,1,0.0,3113.0
29983,UE3A082,1,200.0,0,1,0.0,200.0
29984,U9D012B,1,0.04,0,1,0.0,0.04
29985,U610A63,1,-1552.2,1,0,1552.2,0.0
29986,U4CC3B1,1,0.1,0,1,0.0,0.1
29987,U007CC9,1,-19.17,1,0,19.17,0.0
29988,U328692,1,0.21,0,1,0.0,0.21
29989,U83EDB6,1,100.0,0,1,0.0,100.0
29990,U40AA30,1,10.0,0,1,0.0,10.0
29991,UE6C513,1,-3000.0,1,0,3000.0,0.0
29992,UAF3248,1,138.85,0,1,0.0,138.85
29993,U55FC07,1,10600.0,0,1,0.0,10600.0
29994,U297306,1,-5000.0,1,0,5000.0,0.0
29995,UD12AD3,1,3491.4,0,1,0.0,3491.4
29996,U0EA63B,1,-200.0,1,0,200.0,0.0
29997,UD0C447,1,0.07,0,1,0.0,0.07
29998,UE6DDD3,1,14.95,0,1,0.0,14.95
29999,UC3002B,1,400.0,0,1,0.0,400.0
30000,U2A8B86,1,-10.5,1,0,10.5,0.0
30001,UEE6AFA,1,39.2,0,1,0.0,39.2
30002,U154E01,1,0.05,0,1,0.0,0.05
30003,UCB658A,1,2.01,0,1,0.0,2.01
30004,UD74762,1,1205.0,0,1,0.0,1205.0
30005,UFD96DE,1,-69.0,1,0,69.0,0.0
30006,UFCDF2E,1,91.7,0,1,0.0,91.7
30007,U310527,1,-120.0,1,0,120.0,0.0
30008,U86BD2D,1,1.35,0,1,0.0,1.35
30009,U026BA8,1,0.05,0,1,0.0,0.05
30010,UA4185C,1,0.01,0,1,0.0,0.01
30011,UF71BD9,1,1978.89,0,1,0.0,1978.89
30012,U1B5A90,1,0.02,0,1,0.0,0.02
30013,U026461,1,1794.24,0,1,0.0,1794.24
30014,UB7E9DD,1,0.01,0,1,0.0,0.01
30015,U1061D7,1,-2299.0,1,0,2299.0,0.0
30016,U2A6A76,1,-19.8,1,0,19.8,0.0
30017,U68619A,1,1500.0,0,1,0.0,1500.0
30018,U1B770A,1,20.0,0,1,0.0,20.0
30019,UD46B31,1,-19.0,1,0,19.0,0.0
30020,UEAB371,1,-30.14,1,0,30.14,0.0
30021,U6215D5,1,982.0,0,1,0.0,982.0
30022,UF28514,1,0.33,0,1,0.0,0.33
30023,U76E2A0,1,0.06,0,1,0.0,0.06
30024,UBB68FB,1,270.0,0,1,0.0,270.0
30025,U97D12D,1,0.05,0,1,0.0,0.05
30026,UE37008,1,20.0,0,1,0.0,20.0
30027,U55EB41,1,500.0,0,1,0.0,500.0
30028,UB9E5BC,1,0.06,0,1,0.0,0.06
30029,U69DB8E,1,-100.0,1,0,100.0,0.0
30030,U0F2F06,1,0.01,0,1,0.0,0.01
30031,UA6A50F,1,0.02,0,1,0.0,0.02
30032,UAD1F52,1,0.02,0,1,0.0,0.02
30033,U4A5F46,1,-32.98,1,0,32.98,0.0
30034,UBCBBE5,1,11.43,0,1,0.0,11.43
30035,UBF820B,1,0.02,0,1,0.0,0.02
30036,UF52379,1,0.06,0,1,0.0,0.06
30037,U3885D6,1,0.03,0,1,0.0,0.03
30038,UEED991,1,-2.0,1,0,2.0,0.0
30039,U1D02CB,1,0.02,0,1,0.0,0.02
30040,U41D07D,1,-88.0,1,0,88.0,0.0
30041,U204724,1,0.02,0,1,0.0,0.02
30042,U22AC44,1,9500.0,0,1,0.0,9500.0
30043,UEA59B7,1,0.06,0,1,0.0,0.06
30044,UA5676E,1,10.0,0,1,0.0,10.0
30045,U7FF158,1,0.07,0,1,0.0,0.07
30046,UE1E9FB,1,-246.5,1,0,246.5,0.0
30047,UD2F805,1,0.02,0,1,0.0,0.02
30048,UAE3939,1,3980.0,0,1,0.0,3980.0
30049,U72FE4C,1,0.07,0,1,0.0,0.07
30050,U7FD771,1,0.9,0,1,0.0,0.9
30051,U0E7546,1,1500.0,0,1,0.0,1500.0
30052,UF0D1EE,1,-100.0,1,0,100.0,0.0
30053,U35273E,1,0.01,0,1,0.0,0.01
30054,UE9BA48,1,0.05,0,1,0.0,0.05
30055,U073588,1,129.51,0,1,0.0,129.51
30056,UB966D3,1,3693.0,0,1,0.0,3693.0
30057,UA09CD5,1,20.0,0,1,0.0,20.0
30058,UC24B4A,1,0.01,0,1,0.0,0.01
30059,U359D05,1,0.03,0,1,0.0,0.03
30060,U48B6A2,1,-7.65,1,0,7.65,0.0
30061,U43C062,1,497.0,0,1,0.0,497.0
30062,U6F7FBF,1,0.77,0,1,0.0,0.77
30063,U8B6091,1,0.01,0,1,0.0,0.01
30064,U5DBA6E,1,0.01,0,1,0.0,0.01
30065,UE25577,1,-172.0,1,0,172.0,0.0
30066,U76F726,1,-99.8,1,0,99.8,0.0
30067,U9EFA56,1,-3000.0,1,0,3000.0,0.0
30068,UA257C6,1,150.0,0,1,0.0,150.0
30069,U6FFF94,1,0.05,0,1,0.0,0.05
30070,U50585F,1,3.7,0,1,0.0,3.7
30071,UDFD0BC,1,0.49,0,1,0.0,0.49
30072,U1029D1,1,74.0,0,1,0.0,74.0
30073,U212A51,1,0.04,0,1,0.0,0.04
30074,U19C532,1,50000.0,0,1,0.0,50000.0
30075,U14CFD2,1,-300.0,1,0,300.0,0.0
30076,U540FDA,1,4.0,0,1,0.0,4.0
30077,UF0BDC0,1,0.04,0,1,0.0,0.04
30078,U845209,1,0.05,0,1,0.0,0.05
30079,U8D8A92,1,-500.0,1,0,500.0,0.0
30080,UB9CE9B,1,-2.0,1,0,2.0,0.0
30081,U3066BC,1,287.6,0,1,0.0,287.6
30082,U4F0C82,1,0.01,0,1,0.0,0.01
30083,UD5BA92,1,-483.0,1,0,483.0,0.0
30084,U6E1C1E,1,2800.0,0,1,0.0,2800.0
30085,U1DA337,1,1.18,0,1,0.0,1.18
30086,UEE5F53,1,0.02,0,1,0.0,0.02
30087,UA222EB,1,56.97,0,1,0.0,56.97
30088,UB4B08E,1,-4999.0,1,0,4999.0,0.0
30089,U9F7045,1,574.73,0,1,0.0,574.73
30090,UFC6C18,1,-65.49,1,0,65.49,0.0
30091,U2529B6,1,0.02,0,1,0.0,0.02
30092,UDAE663,1,1.41,0,1,0.0,1.41
30093,U6CBE00,1,0.04,0,1,0.0,0.04
30094,U9115C3,1,-3.0,1,0,3.0,0.0
30095,U039F78,1,-2888.0,1,0,2888.0,0.0
30096,U3BEE9E,1,941.64,0,1,0.0,941.64
30097,U7EADF2,1,0.05,0,1,0.0,0.05
30098,U5E7E9D,1,754.2,0,1,0.0,754.2
30099,U6DA24B,1,30000.0,0,1,0.0,30000.0
30100,UBB421A,1,1.0,0,1,0.0,1.0
30101,UA05DF5,1,0.02,0,1,0.0,0.02
30102,U48F28D,1,0.01,0,1,0.0,0.01
30103,U803EC3,1,0.01,0,1,0.0,0.01
30104,U9C33F7,1,15000.0,0,1,0.0,15000.0
30105,UC4FF68,1,750.0,0,1,0.0,750.0
30106,U041FA2,1,0.08,0,1,0.0,0.08
30107,UC29DF6,1,-575.0,1,0,575.0,0.0
30108,U7E3280,1,0.03,0,1,0.0,0.03
30109,U693C54,1,0.01,0,1,0.0,0.01
30110,U1A5A67,1,0.05,0,1,0.0,0.05
30111,UACE8C8,1,30.0,0,1,0.0,30.0
30112,UE086A5,1,6000.0,0,1,0.0,6000.0
30113,U62AA74,1,1700.0,0,1,0.0,1700.0
30114,UE6CC44,1,0.03,0,1,0.0,0.03
30115,UB2172C,1,-5.0,1,0,5.0,0.0
30116,U15B3E4,1,0.04,0,1,0.0,0.04
30117,U8EB6BE,1,100.0,0,1,0.0,100.0
30118,U4D00E5,1,-0.33,1,0,0.33,0.0
30119,UA23E3A,1,12.02,0,1,0.0,12.02
30120,UFB2125,1,-15000.0,1,0,15000.0,0.0
30121,U11D1E7,1,0.05,0,1,0.0,0.05
30122,U236E94,1,-49860.0,1,0,49860.0,0.0
30123,UFEC7C7,1,-1.0,1,0,1.0,0.0
30124,U6C6E44,1,-10.0,1,0,10.0,0.0
30125,U94FD3A,1,0.04,0,1,0.0,0.04
30126,U47D6C7,1,0.01,0,1,0.0,0.01
30127,U85DAFA,1,0.02,0,1,0.0,0.02
30128,U493B6C,1,31.1,0,1,0.0,31.1
30129,UECD0D3,1,10.0,0,1,0.0,10.0
30130,U172569,1,-0.01,1,0,0.01,0.0
30131,U0D28E5,1,0.01,0,1,0.0,0.01
30132,UCCE9AC,1,284.77,0,1,0.0,284.77
30133,U7F3D32,1,-3025.0,1,0,3025.0,0.0
30134,U3B083B,1,11.92,0,1,0.0,11.92
30135,UAFBF3B,1,0.01,0,1,0.0,0.01
30136,U5765E5,1,0.02,0,1,0.0,0.02
30137,U6A9E1C,1,0.37,0,1,0.0,0.37
30138,U3A28A7,1,-40.0,1,0,40.0,0.0
30139,UBB809B,1,0.02,0,1,0.0,0.02
30140,U9631EE,1,0.04,0,1,0.0,0.04
30141,U440D61,1,1440.0,0,1,0.0,1440.0
30142,U1C64C2,1,0.2,0,1,0.0,0.2
30143,U7FDB8C,1,0.1,0,1,0.0,0.1
30144,U7E87B1,1,0.01,0,1,0.0,0.01
30145,U4268EC,1,100.0,0,1,0.0,100.0
30146,U305D7B,1,1480.0,0,1,0.0,1480.0
30147,UFA7520,1,1800.0,0,1,0.0,1800.0
30148,U3D8D61,1,200.0,0,1,0.0,200.0
30149,UAA3C97,1,100.0,0,1,0.0,100.0
30150,U402639,1,20.2,0,1,0.0,20.2
30151,U29D4A2,1,0.02,0,1,0.0,0.02
30152,UF57097,1,230.0,0,1,0.0,230.0
30153,UE18EBF,1,0.25,0,1,0.0,0.25
30154,U566073,1,0.09,0,1,0.0,0.09
30155,U0FF2C7,1,4.8,0,1,0.0,4.8
30156,U9DFFC8,1,0.01,0,1,0.0,0.01
30157,UA5F18F,1,-2239.0,1,0,2239.0,0.0
30158,UC5C0AD,1,2819.84,0,1,0.0,2819.84
30159,U3A604E,1,0.06,0,1,0.0,0.06
30160,U3D8824,1,363.29,0,1,0.0,363.29
30161,UBAE502,1,100.0,0,1,0.0,100.0
30162,UF4A954,1,0.27,0,1,0.0,0.27
30163,U115229,1,-210.1,1,0,210.1,0.0
30164,U56B168,1,120.0,0,1,0.0,120.0
30165,U375644,1,0.01,0,1,0.0,0.01
30166,U8013EF,1,0.04,0,1,0.0,0.04
30167,U143C94,1,0.01,0,1,0.0,0.01
30168,UC65F72,1,151.9,0,1,0.0,151.9
30169,U3E224A,1,-1000.0,1,0,1000.0,0.0
30170,UE19E21,1,-10.0,1,0,10.0,0.0
30171,U961E83,1,3000.0,0,1,0.0,3000.0
30172,UA95380,1,390.0,0,1,0.0,390.0
30173,U1E5B6A,1,0.15,0,1,0.0,0.15
30174,UBC419A,1,-120.0,1,0,120.0,0.0
30175,UE8143B,1,0.05,0,1,0.0,0.05
30176,U9176E5,1,2625.0,0,1,0.0,2625.0
30177,U1B22DC,1,10.0,0,1,0.0,10.0
30178,UAD95F3,1,-2.0,1,0,2.0,0.0
30179,U0262C3,1,-92.7,1,0,92.7,0.0
30180,UA5F0DC,1,5000.0,0,1,0.0,5000.0
30181,U2A4DE6,1,0.01,0,1,0.0,0.01
30182,UF551B4,1,-57.0,1,0,57.0,0.0
30183,UC38129,1,-1500.0,1,0,1500.0,0.0
30184,U673D1F,1,0.06,0,1,0.0,0.06
30185,U7C0345,1,0.06,0,1,0.0,0.06
30186,UFDE893,1,0.03,0,1,0.0,0.03
30187,U9123E5,1,-5.0,1,0,5.0,0.0
30188,U27DAFD,1,0.12,0,1,0.0,0.12
30189,U70F218,1,-45.32,1,0,45.32,0.0
30190,U04D24F,1,231.06,0,1,0.0,231.06
30191,UDEF9AC,1,0.84,0,1,0.0,0.84
30192,U4B9071,1,0.04,0,1,0.0,0.04
30193,UA0DBC5,1,107.0,0,1,0.0,107.0
30194,U5D06E7,1,0.01,0,1,0.0,0.01
30195,U8DB45B,1,-100.0,1,0,100.0,0.0
30196,U470CBB,1,0.38,0,1,0.0,0.38
30197,UBB4D81,1,-0.4,1,0,0.4,0.0
30198,U1E9204,1,-57.4,1,0,57.4,0.0
30199,UDE8EBC,1,15.0,0,1,0.0,15.0
30200,UF38412,1,0.77,0,1,0.0,0.77
30201,UF77C0B,1,0.24,0,1,0.0,0.24
30202,UE727FD,1,0.01,0,1,0.0,0.01
30203,U61A613,1,-100.0,1,0,100.0,0.0
30204,UAD018C,1,0.07,0,1,0.0,0.07
30205,U6D9264,1,100.0,0,1,0.0,100.0
30206,UEF1FC7,1,-3021.0,1,0,3021.0,0.0
30207,UFB78E8,1,0.75,0,1,0.0,0.75
30208,U03D92B,1,100.0,0,1,0.0,100.0
30209,UFFB9E0,1,0.1,0,1,0.0,0.1
30210,UD1E311,1,0.04,0,1,0.0,0.04
30211,UD49463,1,0.01,0,1,0.0,0.01
30212,U5207BF,1,0.03,0,1,0.0,0.03
30213,UBC4817,1,10.0,0,1,0.0,10.0
30214,U530895,1,1.22,0,1,0.0,1.22
30215,UDF1529,1,300.0,0,1,0.0,300.0
30216,UADC456,1,0.5,0,1,0.0,0.5
30217,U845707,1,0.01,0,1,0.0,0.01
30218,U5167A8,1,651.0,0,1,0.0,651.0
30219,U7CF607,1,500.0,0,1,0.0,500.0
30220,UF8FD15,1,-99.7,1,0,99.7,0.0
30221,U8B44EA,1,26.0,0,1,0.0,26.0
30222,U4B80AF,1,0.09,0,1,0.0,0.09
30223,U7D8DF5,1,-1000.0,1,0,1000.0,0.0
30224,U074898,1,0.02,0,1,0.0,0.02
30225,U59EBC3,1,0.03,0,1,0.0,0.03
30226,U716B0A,1,20.0,0,1,0.0,20.0
30227,UEB9F9A,1,-2600.0,1,0,2600.0,0.0
30228,U3559B6,1,0.03,0,1,0.0,0.03
30229,U3E71E5,1,3.98,0,1,0.0,3.98
30230,U25BA96,1,0.28,0,1,0.0,0.28
30231,U59F97B,1,-48.9,1,0,48.9,0.0
30232,UFBACA5,1,0.04,0,1,0.0,0.04
30233,U40688D,1,0.01,0,1,0.0,0.01
30234,UC9605C,1,-29.9,1,0,29.9,0.0
30235,U7F88F4,1,0.01,0,1,0.0,0.01
30236,U576726,1,0.08,0,1,0.0,0.08
30237,U3B6FD6,1,605.0,0,1,0.0,605.0
30238,U3AF357,1,-29.94,1,0,29.94,0.0
30239,U3D34CB,1,20.0,0,1,0.0,20.0
30240,U068947,1,15000.0,0,1,0.0,15000.0
30241,UDF548B,1,5594.0,0,1,0.0,5594.0
30242,U07C735,1,30000.0,0,1,0.0,30000.0
30243,U1F5967,1,1.37,0,1,0.0,1.37
30244,UF3E2ED,1,0.03,0,1,0.0,0.03
30245,U7526AA,1,0.03,0,1,0.0,0.03
30246,U8E562E,1,60.0,0,1,0.0,60.0
30247,UDEB34E,1,100.0,0,1,0.0,100.0
30248,UDECE0F,1,0.01,0,1,0.0,0.01
30249,UF276C6,1,0.35,0,1,0.0,0.35
30250,U43FAF9,1,0.38,0,1,0.0,0.38
30251,UB1771C,1,12.0,0,1,0.0,12.0
30252,U9F1619,1,-5.0,1,0,5.0,0.0
30253,UC7E6FF,1,0.05,0,1,0.0,0.05
30254,U8DA8C6,1,0.05,0,1,0.0,0.05
30255,U2B4499,1,0.03,0,1,0.0,0.03
30256,UEAC499,1,2.0,0,1,0.0,2.0
30257,UD6A312,1,0.01,0,1,0.0,0.01
30258,UAAC8AC,1,1999.26,0,1,0.0,1999.26
30259,UE0B38B,1,0.21,0,1,0.0,0.21
30260,UF333D1,1,-18.0,1,0,18.0,0.0
30261,UFFE094,1,0.02,0,1,0.0,0.02
30262,U923116,1,733.0,0,1,0.0,733.0
30263,U638B0A,1,-50.22,1,0,50.22,0.0
30264,UAFFD94,1,-2000.0,1,0,2000.0,0.0
30265,U120507,1,5.0,0,1,0.0,5.0
30266,UE8F519,1,-100.0,1,0,100.0,0.0
30267,UBB9C94,1,50.0,0,1,0.0,50.0
30268,U16D7CD,1,500.0,0,1,0.0,500.0
30269,U6E54E8,1,2.74,0,1,0.0,2.74
30270,U6ACBD1,1,0.06,0,1,0.0,0.06
30271,U5EC41C,1,5.0,0,1,0.0,5.0
30272,U68B3B4,1,0.49,0,1,0.0,0.49
30273,U58265E,1,0.17,0,1,0.0,0.17
30274,UD499D1,1,0.07,0,1,0.0,0.07
30275,U4EE0A4,1,0.01,0,1,0.0,0.01
30276,U57D4F3,1,-10.0,1,0,10.0,0.0
30277,U3DE5CA,1,1908.34,0,1,0.0,1908.34
30278,U8F6A98,1,1000.0,0,1,0.0,1000.0
30279,UE25D92,1,0.01,0,1,0.0,0.01
30280,U51610F,1,-13.0,1,0,13.0,0.0
30281,U969E2A,1,300.0,0,1,0.0,300.0
30282,UEF2468,1,0.01,0,1,0.0,0.01
30283,UEB44FE,1,2000.0,0,1,0.0,2000.0
30284,U167663,1,5000.0,0,1,0.0,5000.0
30285,U8F6825,1,0.01,0,1,0.0,0.01
30286,UE5E7C1,1,9000.0,0,1,0.0,9000.0
30287,U34D09B,1,0.01,0,1,0.0,0.01
30288,U217B06,1,-100.0,1,0,100.0,0.0
30289,U22FE92,1,32.05,0,1,0.0,32.05
30290,U74AAA4,1,0.12,0,1,0.0,0.12
30291,UFA6477,1,0.44,0,1,0.0,0.44
30292,U273B9C,1,1982.0,0,1,0.0,1982.0
30293,U1ECDB8,1,0.01,0,1,0.0,0.01
30294,UABAC50,1,265.0,0,1,0.0,265.0
30295,U510491,1,600.0,0,1,0.0,600.0
30296,U0D4F3B,1,300.0,0,1,0.0,300.0
30297,U4EAD8C,1,0.01,0,1,0.0,0.01
30298,U32DDF9,1,0.01,0,1,0.0,0.01
30299,UB581E8,1,0.02,0,1,0.0,0.02
30300,U94985C,1,500.0,0,1,0.0,500.0
30301,U4E79F8,1,-100.0,1,0,100.0,0.0
30302,UDB9D6A,1,-2.72,1,0,2.72,0.0
30303,UBBAE8D,1,0.14,0,1,0.0,0.14
30304,U02D539,1,0.08,0,1,0.0,0.08
30305,UE82A05,1,38.57,0,1,0.0,38.57
30306,U897709,1,272.0,0,1,0.0,272.0
30307,U5CF6C5,1,1.68,0,1,0.0,1.68
30308,UBA39B8,1,100.0,0,1,0.0,100.0
30309,UE45809,1,500.0,0,1,0.0,500.0
30310,U5723B5,1,100.0,0,1,0.0,100.0
30311,U0F3F4F,1,0.59,0,1,0.0,0.59
30312,U0BDBB1,1,-199.0,1,0,199.0,0.0
30313,U61BD0F,1,0.04,0,1,0.0,0.04
30314,UED5F85,1,0.03,0,1,0.0,0.03
30315,UA2CB8E,1,161.0,0,1,0.0,161.0
30316,U32C5C5,1,317.31,0,1,0.0,317.31
30317,UFF9247,1,3000.0,0,1,0.0,3000.0
30318,UD7798C,1,0.08,0,1,0.0,0.08
30319,UF41589,1,3.0,0,1,0.0,3.0
30320,U2489EC,1,0.02,0,1,0.0,0.02
30321,UE28103,1,0.58,0,1,0.0,0.58
30322,UDC5833,1,0.01,0,1,0.0,0.01
30323,U36E2D9,1,-4.41,1,0,4.41,0.0
30324,U9E9159,1,120.0,0,1,0.0,120.0
30325,U12FCF3,1,3000.0,0,1,0.0,3000.0
30326,U7281B2,1,-50.0,1,0,50.0,0.0
30327,U321745,1,-200.0,1,0,200.0,0.0
30328,U6D7FB8,1,0.02,0,1,0.0,0.02
30329,UF970F0,1,0.14,0,1,0.0,0.14
30330,UDA8DE0,1,0.06,0,1,0.0,0.06
30331,U0BB518,1,0.02,0,1,0.0,0.02
30332,UB38301,1,1.21,0,1,0.0,1.21
30333,UB9E15B,1,0.04,0,1,0.0,0.04
30334,UEECEDA,1,0.02,0,1,0.0,0.02
30335,UD25EAA,1,-269.0,1,0,269.0,0.0
30336,UCA16DD,1,3168.0,0,1,0.0,3168.0
30337,U6EBD15,1,-1680.0,1,0,1680.0,0.0
30338,UD4A2F3,1,0.01,0,1,0.0,0.01
30339,U3E752E,1,100.0,0,1,0.0,100.0
30340,U1B8FCF,1,-75.05,1,0,75.05,0.0
30341,U85B8CE,1,3301.0,0,1,0.0,3301.0
30342,UA5B2F2,1,0.2,0,1,0.0,0.2
30343,U77E0AF,1,0.05,0,1,0.0,0.05
30344,U1AA699,1,0.01,0,1,0.0,0.01
30345,U062E5A,1,0.12,0,1,0.0,0.12
30346,U30CE8B,1,1500.0,0,1,0.0,1500.0
30347,UE0FD79,1,0.08,0,1,0.0,0.08
30348,U033D5E,1,-2000.0,1,0,2000.0,0.0
30349,UE86DBA,1,-1930.0,1,0,1930.0,0.0
30350,U644130,1,-908.0,1,0,908.0,0.0
30351,U06EEA9,1,0.01,0,1,0.0,0.01
30352,UCA6131,1,0.01,0,1,0.0,0.01
30353,U7AD018,1,0.01,0,1,0.0,0.01
30354,U0C44A4,1,-28.0,1,0,28.0,0.0
30355,U02889D,1,134.59,0,1,0.0,134.59
30356,U4FB0DB,1,1000.0,0,1,0.0,1000.0
30357,UB9044F,1,1000.0,0,1,0.0,1000.0
30358,U80797C,1,0.06,0,1,0.0,0.06
30359,UDB5576,1,0.05,0,1,0.0,0.05
30360,U33A516,1,77.0,0,1,0.0,77.0
30361,U11E9B3,1,0.02,0,1,0.0,0.02
30362,U2C4816,1,-1100.0,1,0,1100.0,0.0
30363,UD5A0B1,1,500.0,0,1,0.0,500.0
30364,U2E7FBD,1,500.0,0,1,0.0,500.0
30365,U60E2AF,1,0.01,0,1,0.0,0.01
30366,UB0F3C0,1,0.05,0,1,0.0,0.05
30367,U2E5222,1,0.02,0,1,0.0,0.02
30368,U71F768,1,0.77,0,1,0.0,0.77
30369,U6317FD,1,-1400.0,1,0,1400.0,0.0
30370,U4648AF,1,111.0,0,1,0.0,111.0
30371,U3EBE4C,1,110.0,0,1,0.0,110.0
30372,UE1AAFF,1,2.0,0,1,0.0,2.0
30373,U7AD9B0,1,-100.0,1,0,100.0,0.0
30374,U61CDAC,1,-182.16,1,0,182.16,0.0
30375,U547B26,1,100.0,0,1,0.0,100.0
30376,U227353,1,433.0,0,1,0.0,433.0
30377,U82D8EC,1,0.54,0,1,0.0,0.54
30378,U2F9BD0,1,0.03,0,1,0.0,0.03
30379,U944403,1,0.01,0,1,0.0,0.01
30380,UE58726,1,0.01,0,1,0.0,0.01
30381,UA0719E,1,0.02,0,1,0.0,0.02
30382,U70C669,1,4.01,0,1,0.0,4.01
30383,UF537A3,1,0.01,0,1,0.0,0.01
30384,U3A6025,1,0.47,0,1,0.0,0.47
30385,UACFB7D,1,300.0,0,1,0.0,300.0
30386,UC29B55,1,2100.0,0,1,0.0,2100.0
30387,U0C9EA3,1,0.02,0,1,0.0,0.02
30388,UBBF55D,1,5235.0,0,1,0.0,5235.0
30389,U72CD49,1,0.16,0,1,0.0,0.16
30390,UF670CE,1,0.11,0,1,0.0,0.11
30391,UBFDF39,1,50.0,0,1,0.0,50.0
30392,U91CC38,1,1.35,0,1,0.0,1.35
30393,U6AE58A,1,2520.0,0,1,0.0,2520.0
30394,U1F2642,1,1116.0,0,1,0.0,1116.0
30395,U2450F0,1,0.03,0,1,0.0,0.03
30396,U6F0299,1,9.0,0,1,0.0,9.0
30397,U8E2983,1,0.02,0,1,0.0,0.02
30398,U024EFB,1,0.01,0,1,0.0,0.01
30399,U50C6E3,1,0.01,0,1,0.0,0.01
30400,U78A0FB,1,0.01,0,1,0.0,0.01
30401,UA1C481,1,0.06,0,1,0.0,0.06
30402,U89B8F3,1,0.13,0,1,0.0,0.13
30403,U8647C9,1,4.06,0,1,0.0,4.06
30404,UE481A5,1,-3000.0,1,0,3000.0,0.0
30405,UFCDC6D,1,-100.0,1,0,100.0,0.0
30406,UDA2093,1,34.66,0,1,0.0,34.66
30407,U4F7B6D,1,7000.0,0,1,0.0,7000.0
30408,U52ECAB,1,-127.28,1,0,127.28,0.0
30409,U0C85D0,1,0.01,0,1,0.0,0.01
30410,U9CA5E6,1,-35.0,1,0,35.0,0.0
30411,U5DF8BD,1,600.0,0,1,0.0,600.0
30412,UD4CB56,1,-2985.6,1,0,2985.6,0.0
30413,UD637C8,1,0.03,0,1,0.0,0.03
30414,UE17F65,1,0.01,0,1,0.0,0.01
30415,U395A91,1,600.0,0,1,0.0,600.0
30416,U7DBD5B,1,2.82,0,1,0.0,2.82
30417,U97185B,1,-32.0,1,0,32.0,0.0
30418,U285A04,1,-206.48,1,0,206.48,0.0
30419,UA2A337,1,0.02,0,1,0.0,0.02
30420,UE8DDC4,1,0.02,0,1,0.0,0.02
30421,U32646E,1,1.63,0,1,0.0,1.63
30422,U674A42,1,-100.0,1,0,100.0,0.0
30423,UA5B402,1,300.0,0,1,0.0,300.0
30424,UCCEC0A,1,10155.0,0,1,0.0,10155.0
30425,UFED186,1,0.03,0,1,0.0,0.03
30426,U07BDFE,1,0.03,0,1,0.0,0.03
30427,U9AAB29,1,0.02,0,1,0.0,0.02
30428,U1E0AEC,1,-5.0,1,0,5.0,0.0
30429,U6F7E16,1,2453.0,0,1,0.0,2453.0
30430,UCC566D,1,30.0,0,1,0.0,30.0
30431,UE223ED,1,0.08,0,1,0.0,0.08
30432,U4E06B8,1,0.01,0,1,0.0,0.01
30433,U164813,1,-510.0,1,0,510.0,0.0
30434,U2D5BE0,1,-2000.0,1,0,2000.0,0.0
30435,UCD8B18,1,10.31,0,1,0.0,10.31
30436,U409471,1,324.9,0,1,0.0,324.9
30437,U3D31F1,1,0.09,0,1,0.0,0.09
30438,U121247,1,-99.0,1,0,99.0,0.0
30439,UDE542C,1,-3900.0,1,0,3900.0,0.0
30440,U8E1363,1,-2010.0,1,0,2010.0,0.0
30441,U844330,1,-144.5,1,0,144.5,0.0
30442,U1A679B,1,1400.0,0,1,0.0,1400.0
30443,UDD5DD3,1,-0.01,1,0,0.01,0.0
30444,U589699,1,0.02,0,1,0.0,0.02
30445,UE9770D,1,0.02,0,1,0.0,0.02
30446,U945A92,1,0.2,0,1,0.0,0.2
30447,UA86A9C,1,11659.38,0,1,0.0,11659.38
30448,UCE6872,1,4.42,0,1,0.0,4.42
30449,U6B35A8,1,10.0,0,1,0.0,10.0
30450,U5CEF8F,1,0.06,0,1,0.0,0.06
30451,UE25B3C,1,0.26,0,1,0.0,0.26
30452,U052DA3,1,0.22,0,1,0.0,0.22
30453,UE4D6FD,1,1.58,0,1,0.0,1.58
30454,U11D235,1,100.0,0,1,0.0,100.0
30455,U0034E3,1,8888.0,0,1,0.0,8888.0
30456,U73117A,1,0.01,0,1,0.0,0.01
30457,UC8D9FE,1,10.0,0,1,0.0,10.0
30458,UA3511F,1,0.01,0,1,0.0,0.01
30459,UFC1C14,1,1000.0,0,1,0.0,1000.0
30460,U185872,1,157.0,0,1,0.0,157.0
30461,U408201,1,100.0,0,1,0.0,100.0
30462,UB20E7C,1,0.01,0,1,0.0,0.01
30463,UD45660,1,0.06,0,1,0.0,0.06
30464,U43BF8A,1,780.0,0,1,0.0,780.0
30465,U2E63F8,1,1650.0,0,1,0.0,1650.0
30466,U99B2EF,1,600.0,0,1,0.0,600.0
30467,U547A0D,1,0.07,0,1,0.0,0.07
30468,UCAC28B,1,0.02,0,1,0.0,0.02
30469,UDE5256,1,149.4,0,1,0.0,149.4
30470,UB8312C,1,50.0,0,1,0.0,50.0
30471,U047DB5,1,0.05,0,1,0.0,0.05
30472,U2CCDB0,1,1.12,0,1,0.0,1.12
30473,UBD0417,1,0.07,0,1,0.0,0.07
30474,U024A57,1,733.8,0,1,0.0,733.8
30475,U38A92D,1,0.16,0,1,0.0,0.16
30476,UD7E093,1,-76.95,1,0,76.95,0.0
30477,UBC7DD4,1,4990.11,0,1,0.0,4990.11
30478,U91EDDC,1,0.09,0,1,0.0,0.09
30479,U9B266E,1,100.0,0,1,0.0,100.0
30480,UB84640,1,250.0,0,1,0.0,250.0
30481,UF75949,1,2000.0,0,1,0.0,2000.0
30482,U3ABE5F,1,0.01,0,1,0.0,0.01
30483,UC4BB84,1,200.0,0,1,0.0,200.0
30484,U6DFFAB,1,40.54,0,1,0.0,40.54
30485,UDCA6FD,1,49000.0,0,1,0.0,49000.0
30486,U205755,1,-100.0,1,0,100.0,0.0
30487,U285C4F,1,0.01,0,1,0.0,0.01
30488,U8CA16F,1,0.01,0,1,0.0,0.01
30489,U59D7A7,1,-5.0,1,0,5.0,0.0
30490,UF3B692,1,19337.0,0,1,0.0,19337.0
30491,UE3E708,1,0.01,0,1,0.0,0.01
30492,U8C39CE,1,-0.65,1,0,0.65,0.0
30493,U98766B,1,5.42,0,1,0.0,5.42
30494,U413AF4,1,4100.0,0,1,0.0,4100.0
30495,U16C9EF,1,200.0,0,1,0.0,200.0
30496,UE34A1E,1,1010.0,0,1,0.0,1010.0
30497,U700E97,1,0.03,0,1,0.0,0.03
30498,UC94453,1,50.0,0,1,0.0,50.0
30499,U42A5A4,1,-218.0,1,0,218.0,0.0
30500,U14CA12,1,50.0,0,1,0.0,50.0
30501,UE3B4B8,1,0.02,0,1,0.0,0.02
30502,U004271,1,-2.0,1,0,2.0,0.0
30503,UE33BDC,1,0.01,0,1,0.0,0.01
30504,U4AAAA6,1,0.03,0,1,0.0,0.03
30505,UC43977,1,0.08,0,1,0.0,0.08
30506,UE48803,1,0.01,0,1,0.0,0.01
30507,U07BBC5,1,200.0,0,1,0.0,200.0
30508,UAADAC8,1,0.04,0,1,0.0,0.04
30509,UE576DB,1,200.0,0,1,0.0,200.0
30510,UA51EF6,1,1500.0,0,1,0.0,1500.0
30511,U8A3246,1,0.02,0,1,0.0,0.02
30512,UAB719E,1,0.17,0,1,0.0,0.17
30513,U47B847,1,0.01,0,1,0.0,0.01
30514,U292419,1,3692.0,0,1,0.0,3692.0
30515,UD0AA2B,1,0.03,0,1,0.0,0.03
30516,U7E0CF6,1,0.01,0,1,0.0,0.01
30517,U5A4DAA,1,874.98,0,1,0.0,874.98
30518,U2E4CE7,1,0.05,0,1,0.0,0.05
30519,U4BF533,1,980.0,0,1,0.0,980.0
30520,UE95CCE,1,0.01,0,1,0.0,0.01
30521,U4C32A0,1,0.22,0,1,0.0,0.22
30522,U5C22E2,1,0.04,0,1,0.0,0.04
30523,U5EA0E1,1,0.04,0,1,0.0,0.04
30524,U336C99,1,0.01,0,1,0.0,0.01
30525,U9577CB,1,900.0,0,1,0.0,900.0
30526,UC2A944,1,-3030.0,1,0,3030.0,0.0
30527,U194BF4,1,300.0,0,1,0.0,300.0
30528,UA75B09,1,-427.4,1,0,427.4,0.0
30529,U66B035,1,0.01,0,1,0.0,0.01
30530,U4845E4,1,0.06,0,1,0.0,0.06
30531,U974C47,1,1260.0,0,1,0.0,1260.0
30532,UF79735,1,-9481.17,1,0,9481.17,0.0
30533,U404A92,1,717.3,0,1,0.0,717.3
30534,UC8EAA8,1,0.15,0,1,0.0,0.15
30535,UD917D9,1,0.01,0,1,0.0,0.01
30536,U53EF0E,1,23.0,0,1,0.0,23.0
30537,UAA5BF9,1,0.02,0,1,0.0,0.02
30538,UC7A213,1,100.0,0,1,0.0,100.0
30539,UB9AB96,1,0.25,0,1,0.0,0.25
30540,UA185E5,1,79.95,0,1,0.0,79.95
30541,U9A9789,1,8000.0,0,1,0.0,8000.0
30542,UE22DBA,1,-41.78,1,0,41.78,0.0
30543,U238FA6,1,-0.2,1,0,0.2,0.0
30544,UABB15D,1,6562.0,0,1,0.0,6562.0
30545,UE70D23,1,27.3,0,1,0.0,27.3
30546,UCE3D23,1,2000.0,0,1,0.0,2000.0
30547,U0C5010,1,0.01,0,1,0.0,0.01
30548,U5DB6F4,1,-0.05,1,0,0.05,0.0
30549,UD0D782,1,0.01,0,1,0.0,0.01
30550,U483BDB,1,100.0,0,1,0.0,100.0
30551,UF60E2C,1,-1602.0,1,0,1602.0,0.0
30552,UE0CFBA,1,-300.0,1,0,300.0,0.0
30553,U0AFACA,1,0.01,0,1,0.0,0.01
30554,UA38B0F,1,-8.8,1,0,8.8,0.0
30555,U2B25A4,1,412.0,0,1,0.0,412.0
30556,U4C9D36,1,0.08,0,1,0.0,0.08
30557,U82106F,1,1.35,0,1,0.0,1.35
30558,U9F5C38,1,0.01,0,1,0.0,0.01
30559,UEE309E,1,0.06,0,1,0.0,0.06
30560,U17F364,1,0.01,0,1,0.0,0.01
30561,U3930B0,1,-500.0,1,0,500.0,0.0
30562,U57BDB2,1,58.69,0,1,0.0,58.69
30563,U56FB11,1,2850.0,0,1,0.0,2850.0
30564,U5D1770,1,0.04,0,1,0.0,0.04
30565,U87954F,1,0.01,0,1,0.0,0.01
30566,U3A7BEC,1,200.0,0,1,0.0,200.0
30567,U88C048,1,0.1,0,1,0.0,0.1
30568,U4764DC,1,400.0,0,1,0.0,400.0
30569,U88B20E,1,-148.0,1,0,148.0,0.0
30570,UE6896A,1,0.01,0,1,0.0,0.01
30571,U222DD9,1,321.09,0,1,0.0,321.09
30572,UBD690E,1,1.17,0,1,0.0,1.17
30573,U4451FF,1,3681.16,0,1,0.0,3681.16
30574,U4B80FC,1,18.0,0,1,0.0,18.0
30575,U07087B,1,3000.0,0,1,0.0,3000.0
30576,U1D263C,1,0.02,0,1,0.0,0.02
30577,UCF9526,1,0.02,0,1,0.0,0.02
30578,U53CD22,1,1.27,0,1,0.0,1.27
30579,UFDC3D3,1,649.6,0,1,0.0,649.6
30580,U6FEEB0,1,2000.0,0,1,0.0,2000.0
30581,U571A74,1,5.0,0,1,0.0,5.0
30582,UFCAF2C,1,757.0,0,1,0.0,757.0
30583,U4F27AA,1,-6000.0,1,0,6000.0,0.0
30584,UFDF648,1,0.02,0,1,0.0,0.02
30585,U4C621C,1,40.0,0,1,0.0,40.0
30586,U775B80,1,3000.0,0,1,0.0,3000.0
30587,U2D6C3C,1,150.0,0,1,0.0,150.0
30588,U3090FF,1,300.0,0,1,0.0,300.0
30589,UD092F8,1,-10.0,1,0,10.0,0.0
30590,U2879A6,1,0.09,0,1,0.0,0.09
30591,U09F173,1,3.32,0,1,0.0,3.32
30592,UF3DFAB,1,-1.0,1,0,1.0,0.0
30593,U90E2B4,1,880.0,0,1,0.0,880.0
30594,UA18C4A,1,804.03,0,1,0.0,804.03
30595,U3A6666,1,14.19,0,1,0.0,14.19
30596,U1EC820,1,1000.0,0,1,0.0,1000.0
30597,UCBB63E,1,0.05,0,1,0.0,0.05
30598,UC5CC5A,1,0.17,0,1,0.0,0.17
30599,UA177F3,1,0.01,0,1,0.0,0.01
30600,UB0E304,1,675.0,0,1,0.0,675.0
30601,U495155,1,-4890.0,1,0,4890.0,0.0
30602,UF0AAFB,1,0.05,0,1,0.0,0.05
30603,U098CAA,1,-5.0,1,0,5.0,0.0
30604,U4DF4FE,1,0.02,0,1,0.0,0.02
30605,U493A42,1,0.06,0,1,0.0,0.06
30606,UC80E4E,1,0.34,0,1,0.0,0.34
30607,U82B766,1,0.04,0,1,0.0,0.04
30608,U18A323,1,338.0,0,1,0.0,338.0
30609,U0AC085,1,0.1,0,1,0.0,0.1
30610,UC146C8,1,-4.0,1,0,4.0,0.0
30611,U3D797D,1,-6950.0,1,0,6950.0,0.0
30612,U324184,1,-5865.0,1,0,5865.0,0.0
30613,U82E9D8,1,7689.0,0,1,0.0,7689.0
30614,U9F493E,1,0.03,0,1,0.0,0.03
30615,UFE226B,1,-7011.0,1,0,7011.0,0.0
30616,UEDD60C,1,-5000.0,1,0,5000.0,0.0
30617,U47D0B0,1,0.02,0,1,0.0,0.02
30618,UE34EEB,1,0.01,0,1,0.0,0.01
30619,U5CF084,1,0.06,0,1,0.0,0.06
30620,U39F85B,1,-32.9,1,0,32.9,0.0
30621,UD4DC53,1,100.0,0,1,0.0,100.0
30622,U63DB1C,1,0.01,0,1,0.0,0.01
30623,U84FA94,1,0.1,0,1,0.0,0.1
30624,UDBD932,1,500.0,0,1,0.0,500.0
30625,UC602BC,1,0.55,0,1,0.0,0.55
30626,UE937BE,1,59.87,0,1,0.0,59.87
30627,U31312C,1,0.37,0,1,0.0,0.37
30628,UC1295B,1,0.21,0,1,0.0,0.21
30629,UD87A7E,1,10.93,0,1,0.0,10.93
30630,U2E7F16,1,0.01,0,1,0.0,0.01
30631,UA1A034,1,2.69,0,1,0.0,2.69
30632,U0512B0,1,800.0,0,1,0.0,800.0
30633,UDB3F39,1,200.0,0,1,0.0,200.0
30634,U377A40,1,2000.0,0,1,0.0,2000.0
30635,U3A79CD,1,132.0,0,1,0.0,132.0
30636,UC1E0DC,1,0.03,0,1,0.0,0.03
30637,U355A8A,1,93.0,0,1,0.0,93.0
30638,U3129C1,1,10.0,0,1,0.0,10.0
30639,UD43578,1,-0.51,1,0,0.51,0.0
30640,UCC0F2F,1,0.03,0,1,0.0,0.03
30641,U8A937D,1,-300.0,1,0,300.0,0.0
30642,U2A7229,1,100.0,0,1,0.0,100.0
30643,U920D24,1,0.01,0,1,0.0,0.01
30644,UE0C502,1,0.44,0,1,0.0,0.44
30645,UD75090,1,0.08,0,1,0.0,0.08
30646,U2CD251,1,4139.88,0,1,0.0,4139.88
30647,UA3974A,1,20.0,0,1,0.0,20.0
30648,UE8FE8B,1,0.05,0,1,0.0,0.05
30649,U1E45A9,1,100.0,0,1,0.0,100.0
30650,U540AA2,1,0.41,0,1,0.0,0.41
30651,UF264C8,1,150.0,0,1,0.0,150.0
30652,U16053D,1,100.0,0,1,0.0,100.0
30653,U4E263E,1,0.02,0,1,0.0,0.02
30654,U836D10,1,2.63,0,1,0.0,2.63
30655,UAF35FC,1,470.0,0,1,0.0,470.0
30656,UF0EBD2,1,0.03,0,1,0.0,0.03
30657,U09DF12,1,393.65,0,1,0.0,393.65
30658,U38B7B0,1,0.52,0,1,0.0,0.52
30659,U237531,1,0.03,0,1,0.0,0.03
30660,UFF8761,1,1960.0,0,1,0.0,1960.0
30661,U939031,1,-274.3,1,0,274.3,0.0
30662,U4C2757,1,0.01,0,1,0.0,0.01
30663,U265A0C,1,22800.0,0,1,0.0,22800.0
30664,U8A9BA7,1,-300.0,1,0,300.0,0.0
30665,U26DE50,1,25.0,0,1,0.0,25.0
30666,UEDA5DC,1,320.71,0,1,0.0,320.71
30667,UAD51FB,1,304.9,0,1,0.0,304.9
30668,UC65923,1,8000.0,0,1,0.0,8000.0
30669,U06B462,1,0.01,0,1,0.0,0.01
30670,U3A6A8F,1,1000.0,0,1,0.0,1000.0
30671,UE323A4,1,30.0,0,1,0.0,30.0
30672,U54C92E,1,1.36,0,1,0.0,1.36
30673,U4EC7A9,1,0.31,0,1,0.0,0.31
30674,U070183,1,0.03,0,1,0.0,0.03
30675,U892319,1,643.97,0,1,0.0,643.97
30676,U90BE8D,1,100.0,0,1,0.0,100.0
30677,UD62B2A,1,0.01,0,1,0.0,0.01
30678,U17C4A1,1,343.78,0,1,0.0,343.78
30679,U5C15CC,1,-539.0,1,0,539.0,0.0
30680,U6BFD27,1,-5.0,1,0,5.0,0.0
30681,UE336E4,1,0.01,0,1,0.0,0.01
30682,UFF4078,1,20000.0,0,1,0.0,20000.0
30683,UA32912,1,0.52,0,1,0.0,0.52
30684,U88798D,1,-364.47,1,0,364.47,0.0
30685,UEAAAD4,1,0.01,0,1,0.0,0.01
30686,UAD577A,1,0.01,0,1,0.0,0.01
30687,UF4DE80,1,-4500.0,1,0,4500.0,0.0
30688,UBDBFE8,1,-10.0,1,0,10.0,0.0
30689,U3BC7C1,1,4620.62,0,1,0.0,4620.62
30690,U0C6934,1,99.66,0,1,0.0,99.66
30691,U9139F9,1,400.0,0,1,0.0,400.0
30692,U16B367,1,17.61,0,1,0.0,17.61
30693,U7E269D,1,1000.0,0,1,0.0,1000.0
30694,UDD7A0E,1,0.01,0,1,0.0,0.01
30695,U2F8017,1,184.0,0,1,0.0,184.0
30696,UBC9BAF,1,0.06,0,1,0.0,0.06
30697,U21BA8E,1,1000.0,0,1,0.0,1000.0
30698,U001B44,1,1000.0,0,1,0.0,1000.0
30699,U89899E,1,0.05,0,1,0.0,0.05
30700,U207471,1,0.01,0,1,0.0,0.01
30701,U44637F,1,0.02,0,1,0.0,0.02
30702,UFA7048,1,0.08,0,1,0.0,0.08
30703,U2A1B5D,1,0.09,0,1,0.0,0.09
30704,UEA15AB,1,0.01,0,1,0.0,0.01
30705,U28E41F,1,0.08,0,1,0.0,0.08
30706,U470512,1,0.08,0,1,0.0,0.08
30707,U722845,1,135.4,0,1,0.0,135.4
30708,U2779FD,1,-20.0,1,0,20.0,0.0
30709,U007577,1,0.02,0,1,0.0,0.02
30710,UFB0F5F,1,10.0,0,1,0.0,10.0
30711,UD6D272,1,0.08,0,1,0.0,0.08
30712,U2B53ED,1,2900.0,0,1,0.0,2900.0
30713,UD1D748,1,2.75,0,1,0.0,2.75
30714,UFDA795,1,10.0,0,1,0.0,10.0
30715,UD94E56,1,2400.0,0,1,0.0,2400.0
30716,U043502,1,0.01,0,1,0.0,0.01
30717,U78A44C,1,150.0,0,1,0.0,150.0
30718,U17A10E,1,1.85,0,1,0.0,1.85
30719,U397DA2,1,0.01,0,1,0.0,0.01
30720,U4A09A9,1,850.0,0,1,0.0,850.0
30721,UDE386F,1,0.01,0,1,0.0,0.01
30722,U266676,1,7.06,0,1,0.0,7.06
30723,UD4BD8F,1,0.08,0,1,0.0,0.08
30724,UFE6580,1,28.84,0,1,0.0,28.84
30725,UACD36C,1,-15.0,1,0,15.0,0.0
30726,U36AD26,1,0.01,0,1,0.0,0.01
30727,U573170,1,47.96,0,1,0.0,47.96
30728,UBC4015,1,13038.0,0,1,0.0,13038.0
30729,U590422,1,0.02,0,1,0.0,0.02
30730,U9920B4,1,220.0,0,1,0.0,220.0
30731,U4A7188,1,0.28,0,1,0.0,0.28
30732,UE9851C,1,0.04,0,1,0.0,0.04
30733,UA9EAFA,1,0.12,0,1,0.0,0.12
30734,UA35457,1,20.0,0,1,0.0,20.0
30735,UDDA731,1,200.0,0,1,0.0,200.0
30736,U41EDD9,1,-127.64,1,0,127.64,0.0
30737,UC0E54E,1,1534.53,0,1,0.0,1534.53
30738,U5E04E1,1,-99.0,1,0,99.0,0.0
30739,U34E615,1,7000.0,0,1,0.0,7000.0
30740,UF4C98A,1,674.18,0,1,0.0,674.18
30741,UC72BFD,1,-0.01,1,0,0.01,0.0
30742,U5C80F8,1,-648.0,1,0,648.0,0.0
30743,UD749F7,1,0.02,0,1,0.0,0.02
30744,U37B6B7,1,0.01,0,1,0.0,0.01
30745,UB25E7C,1,0.77,0,1,0.0,0.77
30746,U873B81,1,3000.0,0,1,0.0,3000.0
30747,UE12982,1,2400.0,0,1,0.0,2400.0
30748,U95FB78,1,5000.0,0,1,0.0,5000.0
30749,U489A9D,1,0.06,0,1,0.0,0.06
30750,UC408A4,1,0.01,0,1,0.0,0.01
30751,U10EECE,1,19.8,0,1,0.0,19.8
30752,U7B69F4,1,0.11,0,1,0.0,0.11
30753,U59A9E9,1,100.0,0,1,0.0,100.0
30754,UD5059F,1,881.19,0,1,0.0,881.19
30755,UCD4CED,1,-28.9,1,0,28.9,0.0
30756,UBB4716,1,100.0,0,1,0.0,100.0
30757,UF41696,1,0.08,0,1,0.0,0.08
30758,U0BC340,1,0.01,0,1,0.0,0.01
30759,U0DB6D0,1,0.06,0,1,0.0,0.06
30760,UFE877A,1,-45.0,1,0,45.0,0.0
30761,UB5F772,1,0.03,0,1,0.0,0.03
30762,UDD3A20,1,1520.0,0,1,0.0,1520.0
30763,U420894,1,0.02,0,1,0.0,0.02
30764,U66C0C2,1,1.15,0,1,0.0,1.15
30765,U51DD67,1,0.01,0,1,0.0,0.01
30766,U4A373C,1,0.02,0,1,0.0,0.02
30767,U3CD196,1,307.31,0,1,0.0,307.31
30768,U4FB0B5,1,-50.0,1,0,50.0,0.0
30769,U16B4B5,1,0.9,0,1,0.0,0.9
30770,U8DEF03,1,1.94,0,1,0.0,1.94
30771,U889589,1,49.85,0,1,0.0,49.85
30772,U58C8DA,1,0.77,0,1,0.0,0.77
30773,UB851FC,1,0.15,0,1,0.0,0.15
30774,U527609,1,0.01,0,1,0.0,0.01
30775,U13787E,1,0.01,0,1,0.0,0.01
30776,U12BCD2,1,0.08,0,1,0.0,0.08
30777,U78813A,1,-152.0,1,0,152.0,0.0
30778,U4FAB4B,1,5000.0,0,1,0.0,5000.0
30779,U8D24DB,1,0.02,0,1,0.0,0.02
30780,U3B74C2,1,170.0,0,1,0.0,170.0
30781,U1200E7,1,530.0,0,1,0.0,530.0
30782,U9BA537,1,0.02,0,1,0.0,0.02
30783,U62A6F0,1,19.86,0,1,0.0,19.86
30784,U4E7AE1,1,100.0,0,1,0.0,100.0
30785,U458FDD,1,0.02,0,1,0.0,0.02
30786,UB5C494,1,800.0,0,1,0.0,800.0
30787,U792DC3,1,1600.0,0,1,0.0,1600.0
30788,UCAD24B,1,300.0,0,1,0.0,300.0
30789,U61F693,1,0.48,0,1,0.0,0.48
30790,U7921E0,1,0.01,0,1,0.0,0.01
30791,U913767,1,233.0,0,1,0.0,233.0
30792,UE248B8,1,10.0,0,1,0.0,10.0
30793,UCDB5CD,1,14.01,0,1,0.0,14.01
30794,UA9ACB5,1,1.01,0,1,0.0,1.01
30795,U7F849F,1,200.0,0,1,0.0,200.0
30796,U514794,1,-0.05,1,0,0.05,0.0
30797,U34F6BC,1,0.01,0,1,0.0,0.01
30798,UF4C891,1,0.01,0,1,0.0,0.01
30799,UD0F8BE,1,0.01,0,1,0.0,0.01
30800,U807211,1,270.0,0,1,0.0,270.0
30801,U2727D1,1,-24.9,1,0,24.9,0.0
30802,U40CA47,1,610.34,0,1,0.0,610.34
30803,U01C71F,1,3925.0,0,1,0.0,3925.0
30804,UED2F73,1,0.02,0,1,0.0,0.02
30805,U73C613,1,-100.0,1,0,100.0,0.0
30806,UD47CFF,1,-5.0,1,0,5.0,0.0
30807,UF8E9C9,1,-207.0,1,0,207.0,0.0
30808,U62CBC9,1,0.03,0,1,0.0,0.03
30809,UA8A222,1,1307.24,0,1,0.0,1307.24
30810,U5FEAAE,1,80.0,0,1,0.0,80.0
30811,UE8227D,1,50.0,0,1,0.0,50.0
30812,UFA4604,1,0.02,0,1,0.0,0.02
30813,UF5A119,1,2.43,0,1,0.0,2.43
30814,UFB5497,1,-2180.0,1,0,2180.0,0.0
30815,U55D964,1,500.0,0,1,0.0,500.0
30816,U38657A,1,0.01,0,1,0.0,0.01
30817,U23BD5F,1,0.07,0,1,0.0,0.07
30818,UF0DA5D,1,10.0,0,1,0.0,10.0
30819,U10537D,1,8000.0,0,1,0.0,8000.0
30820,U26386F,1,0.23,0,1,0.0,0.23
30821,U5CE240,1,1741.0,0,1,0.0,1741.0
30822,UD85259,1,0.01,0,1,0.0,0.01
30823,UC6EC46,1,10.0,0,1,0.0,10.0
30824,U2FA670,1,0.01,0,1,0.0,0.01
30825,U2BB83E,1,0.4,0,1,0.0,0.4
30826,UA80B12,1,150.0,0,1,0.0,150.0
30827,U8ABEDB,1,-4000.0,1,0,4000.0,0.0
30828,U5C5084,1,-4000.0,1,0,4000.0,0.0
30829,UA94FB7,1,100.0,0,1,0.0,100.0
30830,UED92BD,1,365.2,0,1,0.0,365.2
30831,U45FDD8,1,0.01,0,1,0.0,0.01
30832,UF36426,1,4000.0,0,1,0.0,4000.0
30833,UC36987,1,0.01,0,1,0.0,0.01
30834,U6EC0A7,1,3223.1,0,1,0.0,3223.1
30835,U438B05,1,52.0,0,1,0.0,52.0
30836,U1E4E79,1,0.04,0,1,0.0,0.04
30837,U4CFF7E,1,888.0,0,1,0.0,888.0
30838,U94DCF8,1,0.01,0,1,0.0,0.01
30839,U4CCEF9,1,500.0,0,1,0.0,500.0
30840,UC2C792,1,0.02,0,1,0.0,0.02
30841,UE00B21,1,50.0,0,1,0.0,50.0
30842,UB238D7,1,5000.0,0,1,0.0,5000.0
30843,U48ACCA,1,0.02,0,1,0.0,0.02
30844,UED2B8A,1,0.08,0,1,0.0,0.08
30845,U38B5BA,1,5.0,0,1,0.0,5.0
30846,U4C99B0,1,0.03,0,1,0.0,0.03
30847,UF9047D,1,0.05,0,1,0.0,0.05
30848,U622E1D,1,-2580.0,1,0,2580.0,0.0
30849,UC1AE85,1,0.02,0,1,0.0,0.02
30850,UE6D4A9,1,0.04,0,1,0.0,0.04
30851,U2F20E6,1,0.02,0,1,0.0,0.02
30852,UE9D6AF,1,300.0,0,1,0.0,300.0
30853,U46F2E3,1,0.01,0,1,0.0,0.01
30854,UF61ABA,1,0.03,0,1,0.0,0.03
30855,U357BE4,1,-38.45,1,0,38.45,0.0
30856,U7FB673,1,26.84,0,1,0.0,26.84
30857,U6399F5,1,-3.0,1,0,3.0,0.0
30858,U41411D,1,0.77,0,1,0.0,0.77
30859,UC19F55,1,-129.0,1,0,129.0,0.0
30860,U15B671,1,0.07,0,1,0.0,0.07
30861,U7A0ACC,1,0.04,0,1,0.0,0.04
30862,U6A4513,1,-3220.0,1,0,3220.0,0.0
30863,U11D8C6,1,4.0,0,1,0.0,4.0
30864,UA9A836,1,1128.0,0,1,0.0,1128.0
30865,UE06009,1,0.03,0,1,0.0,0.03
30866,U43DDFA,1,0.02,0,1,0.0,0.02
30867,U20B24D,1,100.0,0,1,0.0,100.0
30868,UC51240,1,0.06,0,1,0.0,0.06
30869,U0A1C12,1,28.47,0,1,0.0,28.47
30870,U7E5EA2,1,-4000.0,1,0,4000.0,0.0
30871,U56A10C,1,4000.0,0,1,0.0,4000.0
30872,U539444,1,0.01,0,1,0.0,0.01
30873,U49FB03,1,6321.24,0,1,0.0,6321.24
30874,UBF46F3,1,-299.7,1,0,299.7,0.0
30875,UCCF500,1,-464.12,1,0,464.12,0.0
30876,UC6B6D1,1,0.01,0,1,0.0,0.01
30877,UCD91F2,1,-100.0,1,0,100.0,0.0
30878,U7F74B3,1,1432.0,0,1,0.0,1432.0
30879,U0E6C34,1,0.02,0,1,0.0,0.02
30880,UE61154,1,0.18,0,1,0.0,0.18
30881,UCF4426,1,997.0,0,1,0.0,997.0
30882,U378176,1,16.0,0,1,0.0,16.0
30883,U3F4C99,1,0.01,0,1,0.0,0.01
30884,U776C53,1,7.49,0,1,0.0,7.49
30885,U5D57B2,1,0.03,0,1,0.0,0.03
30886,U4BE54E,1,1500.0,0,1,0.0,1500.0
30887,UE1A159,1,200.0,0,1,0.0,200.0
30888,U86E3E4,1,410.68,0,1,0.0,410.68
30889,UA4E384,1,0.02,0,1,0.0,0.02
30890,U306756,1,8790.0,0,1,0.0,8790.0
30891,U063AE7,1,0.09,0,1,0.0,0.09
30892,U078A09,1,0.23,0,1,0.0,0.23
30893,UC2331D,1,-1.3,1,0,1.3,0.0
30894,U615004,1,780.0,0,1,0.0,780.0
30895,UC0C489,1,0.02,0,1,0.0,0.02
30896,U2CCE98,1,-4006.0,1,0,4006.0,0.0
30897,U488807,1,515.8,0,1,0.0,515.8
30898,U5A5B46,1,100.0,0,1,0.0,100.0
30899,UE5E346,1,0.03,0,1,0.0,0.03
30900,UA07B4C,1,0.02,0,1,0.0,0.02
30901,U79DB6D,1,204.0,0,1,0.0,204.0
30902,UA61C6D,1,-713.0,1,0,713.0,0.0
30903,U797683,1,0.28,0,1,0.0,0.28
30904,UCCAC30,1,-1000.0,1,0,1000.0,0.0
30905,U6093C2,1,59.8,0,1,0.0,59.8
30906,U5699DE,1,0.33,0,1,0.0,0.33
30907,U00139F,1,0.05,0,1,0.0,0.05
30908,UE1FCF7,1,0.04,0,1,0.0,0.04
30909,U2244B1,1,500.0,0,1,0.0,500.0
30910,U256EE5,1,5500.0,0,1,0.0,5500.0
30911,U3BEB6B,1,0.6,0,1,0.0,0.6
30912,UF5E754,1,-18.0,1,0,18.0,0.0
30913,U433654,1,0.02,0,1,0.0,0.02
30914,U73D769,1,435.0,0,1,0.0,435.0
30915,U9C42CA,1,-26.0,1,0,26.0,0.0
30916,U815588,1,0.01,0,1,0.0,0.01
30917,UDE5A09,1,1700.0,0,1,0.0,1700.0
30918,UD35069,1,0.02,0,1,0.0,0.02
30919,UF8DE76,1,0.04,0,1,0.0,0.04
30920,UE37B37,1,0.02,0,1,0.0,0.02
30921,U170EA0,1,100.0,0,1,0.0,100.0
30922,U1A7B99,1,-16.98,1,0,16.98,0.0
30923,U4ADCEB,1,0.94,0,1,0.0,0.94
30924,UBA3A4E,1,0.02,0,1,0.0,0.02
30925,U843A62,1,100.0,0,1,0.0,100.0
30926,U3B020A,1,172.5,0,1,0.0,172.5
30927,UFE075F,1,500.0,0,1,0.0,500.0
30928,U413DE3,1,1196.95,0,1,0.0,1196.95
30929,UD2229C,1,0.01,0,1,0.0,0.01
30930,UC176F9,1,500.0,0,1,0.0,500.0
30931,UF23924,1,-10350.0,1,0,10350.0,0.0
30932,U90DDF6,1,4000.0,0,1,0.0,4000.0
30933,U361208,1,2200.0,0,1,0.0,2200.0
30934,UA859C4,1,0.92,0,1,0.0,0.92
30935,UBE374A,1,0.34,0,1,0.0,0.34
30936,UA04E7A,1,0.08,0,1,0.0,0.08
30937,U767BE6,1,50.0,0,1,0.0,50.0
30938,UDA18C5,1,1000.0,0,1,0.0,1000.0
30939,U28A57A,1,0.03,0,1,0.0,0.03
30940,UF711BD,1,0.01,0,1,0.0,0.01
30941,U1BDCEF,1,-100.0,1,0,100.0,0.0
30942,UF264D7,1,8000.0,0,1,0.0,8000.0
30943,UE90C62,1,0.05,0,1,0.0,0.05
30944,U488AE3,1,3000.0,0,1,0.0,3000.0
30945,UAD7E27,1,6.46,0,1,0.0,6.46
30946,UCAE915,1,2600.0,0,1,0.0,2600.0
30947,U088642,1,0.02,0,1,0.0,0.02
30948,U75BAC2,1,1500.0,0,1,0.0,1500.0
30949,U2EFE05,1,1000.0,0,1,0.0,1000.0
30950,U23C484,1,1982.76,0,1,0.0,1982.76
30951,U46ADCC,1,39.71,0,1,0.0,39.71
30952,UB28156,1,-3.0,1,0,3.0,0.0
30953,U2A8942,1,100.0,0,1,0.0,100.0
30954,U1DAC99,1,800.0,0,1,0.0,800.0
30955,U07EB1C,1,1.4,0,1,0.0,1.4
30956,UC6E9F4,1,100.0,0,1,0.0,100.0
30957,U55087E,1,0.01,0,1,0.0,0.01
30958,UEA0A49,1,0.01,0,1,0.0,0.01
30959,U7F62EA,1,0.01,0,1,0.0,0.01
30960,U221522,1,8500.0,0,1,0.0,8500.0
30961,U260E4A,1,0.02,0,1,0.0,0.02
30962,U39B9C9,1,500.0,0,1,0.0,500.0
30963,UC5D16A,1,-1020.0,1,0,1020.0,0.0
30964,U15D680,1,100.0,0,1,0.0,100.0
30965,U2AF53D,1,0.01,0,1,0.0,0.01
30966,UAF27AD,1,13.25,0,1,0.0,13.25
30967,U5C07F7,1,10.0,0,1,0.0,10.0
30968,U074295,1,0.04,0,1,0.0,0.04
30969,UD31118,1,70.0,0,1,0.0,70.0
30970,UAB8221,1,5300.0,0,1,0.0,5300.0
30971,UBDE941,1,524.46,0,1,0.0,524.46
30972,UCE1ABC,1,25000.0,0,1,0.0,25000.0
30973,UEDEBB5,1,0.05,0,1,0.0,0.05
30974,UD8B6C0,1,0.04,0,1,0.0,0.04
30975,UBEE676,1,1385.0,0,1,0.0,1385.0
30976,U3A694F,1,0.02,0,1,0.0,0.02
30977,U6EF8CC,1,0.12,0,1,0.0,0.12
30978,U824431,1,0.58,0,1,0.0,0.58
30979,U6C67AF,1,0.01,0,1,0.0,0.01
30980,UD2158C,1,0.1,0,1,0.0,0.1
30981,U82A2A2,1,2800.0,0,1,0.0,2800.0
30982,U129F93,1,0.32,0,1,0.0,0.32
30983,U1F2E12,1,0.03,0,1,0.0,0.03
30984,U5C4577,1,-5.0,1,0,5.0,0.0
30985,U952C3D,1,10578.51,0,1,0.0,10578.51
30986,U80D99D,1,0.01,0,1,0.0,0.01
30987,U429BFD,1,11008.17,0,1,0.0,11008.17
30988,U834BF1,1,3000.0,0,1,0.0,3000.0
30989,U4B13EA,1,2000.0,0,1,0.0,2000.0
30990,U44E8D5,1,0.04,0,1,0.0,0.04
30991,UD49315,1,3489.1,0,1,0.0,3489.1
30992,UF83C57,1,0.03,0,1,0.0,0.03
30993,U339A29,1,0.01,0,1,0.0,0.01
30994,U237C89,1,0.01,0,1,0.0,0.01
30995,U116D07,1,20.99,0,1,0.0,20.99
30996,UED6A4A,1,0.01,0,1,0.0,0.01
30997,U25EBC5,1,87.4,0,1,0.0,87.4
30998,U59D850,1,-500.0,1,0,500.0,0.0
30999,U858C64,1,4575.85,0,1,0.0,4575.85
31000,UF6CC5B,1,-100.0,1,0,100.0,0.0
31001,U90BF39,1,0.01,0,1,0.0,0.01
31002,U03FB38,1,-2995.0,1,0,2995.0,0.0
31003,U8A525E,1,-159.0,1,0,159.0,0.0
31004,UB7C7CC,1,0.19,0,1,0.0,0.19
31005,UC65EE9,1,0.03,0,1,0.0,0.03
31006,UAFD90A,1,-47.6,1,0,47.6,0.0
31007,U2AC6F2,1,0.07,0,1,0.0,0.07
31008,U3E2E30,1,1.0,0,1,0.0,1.0
31009,UAD33D9,1,20.0,0,1,0.0,20.0
31010,U4BC833,1,0.1,0,1,0.0,0.1
31011,U2C42C9,1,339.9,0,1,0.0,339.9
31012,U856123,1,0.01,0,1,0.0,0.01
31013,U99C7C4,1,3819.67,0,1,0.0,3819.67
31014,UE19C39,1,204.73,0,1,0.0,204.73
31015,U5F4E6F,1,150.0,0,1,0.0,150.0
31016,U07D74B,1,80.25,0,1,0.0,80.25
31017,UEDC5E0,1,0.01,0,1,0.0,0.01
31018,U0E9D60,1,10200.0,0,1,0.0,10200.0
31019,UCD7360,1,30.0,0,1,0.0,30.0
31020,U05DCB8,1,0.01,0,1,0.0,0.01
31021,U7FF0CB,1,46.18,0,1,0.0,46.18
31022,UD5A464,1,-2000.0,1,0,2000.0,0.0
31023,U006932,1,-300.0,1,0,300.0,0.0
31024,U460E6D,1,132.0,0,1,0.0,132.0
31025,U4315D4,1,0.02,0,1,0.0,0.02
31026,U9103DB,1,110.0,0,1,0.0,110.0
31027,U451A6A,1,0.78,0,1,0.0,0.78
31028,U0F910F,1,-300.0,1,0,300.0,0.0
31029,U451BDA,1,1500.0,0,1,0.0,1500.0
31030,UB291D9,1,0.01,0,1,0.0,0.01
31031,U301F6E,1,0.64,0,1,0.0,0.64
31032,UB90620,1,0.23,0,1,0.0,0.23
31033,UA4C32C,1,0.01,0,1,0.0,0.01
31034,UE5F73D,1,321.0,0,1,0.0,321.0
31035,U57C733,1,0.13,0,1,0.0,0.13
31036,U94CABD,1,592.5,0,1,0.0,592.5
31037,U7A2C38,1,210.0,0,1,0.0,210.0
31038,UD13F96,1,0.01,0,1,0.0,0.01
31039,UE39637,1,-2100.0,1,0,2100.0,0.0
31040,U5FFCC9,1,-6214.0,1,0,6214.0,0.0
31041,U76EBB0,1,0.2,0,1,0.0,0.2
31042,U604166,1,0.01,0,1,0.0,0.01
31043,U638F95,1,0.05,0,1,0.0,0.05
31044,U471DE0,1,0.02,0,1,0.0,0.02
31045,U043CFB,1,0.02,0,1,0.0,0.02
31046,U90C960,1,-300.0,1,0,300.0,0.0
31047,UF7A7C6,1,1.0,0,1,0.0,1.0
31048,UDD21BA,1,4000.0,0,1,0.0,4000.0
31049,U9E6320,1,0.01,0,1,0.0,0.01
31050,U00332D,1,79.0,0,1,0.0,79.0
31051,UF2CC32,1,-108.34,1,0,108.34,0.0
31052,UCD09B7,1,-1950.0,1,0,1950.0,0.0
31053,UEE77ED,1,0.07,0,1,0.0,0.07
31054,UF187A8,1,10.0,0,1,0.0,10.0
31055,U39D15B,1,0.01,0,1,0.0,0.01
31056,U7B352D,1,1438.06,0,1,0.0,1438.06
31057,U642668,1,2000.0,0,1,0.0,2000.0
31058,UE21494,1,0.02,0,1,0.0,0.02
31059,UB026DF,1,-15.0,1,0,15.0,0.0
31060,UFCE470,1,20.0,0,1,0.0,20.0
31061,U8AC44F,1,0.01,0,1,0.0,0.01
31062,UB9881A,1,0.06,0,1,0.0,0.06
31063,U81A1EF,1,-37.9,1,0,37.9,0.0
31064,UC392C4,1,500.0,0,1,0.0,500.0
31065,UF5B347,1,-100.0,1,0,100.0,0.0
31066,UEED9EF,1,0.02,0,1,0.0,0.02
31067,U344BE1,1,-1.48,1,0,1.48,0.0
31068,U48242B,1,-14.42,1,0,14.42,0.0
31069,U50B7DF,1,0.01,0,1,0.0,0.01
31070,UD32711,1,5000.0,0,1,0.0,5000.0
31071,U151D36,1,0.04,0,1,0.0,0.04
31072,U79FED7,1,-190.0,1,0,190.0,0.0
31073,UE0ECC5,1,0.01,0,1,0.0,0.01
31074,U19B701,1,0.01,0,1,0.0,0.01
31075,U5AA940,1,-2980.0,1,0,2980.0,0.0
31076,UFF72FA,1,0.08,0,1,0.0,0.08
31077,UE0A2AD,1,8.75,0,1,0.0,8.75
31078,U32F435,1,4100.0,0,1,0.0,4100.0
31079,UF5DF49,1,-5.0,1,0,5.0,0.0
31080,U730C20,1,0.01,0,1,0.0,0.01
31081,U951E3B,1,0.02,0,1,0.0,0.02
31082,UC77AA1,1,1.36,0,1,0.0,1.36
31083,UD80364,1,60000.0,0,1,0.0,60000.0
31084,UA759F3,1,5756.7,0,1,0.0,5756.7
31085,UFFAAC6,1,397.22,0,1,0.0,397.22
31086,UA7BFC3,1,0.42,0,1,0.0,0.42
31087,U71480E,1,-5000.0,1,0,5000.0,0.0
31088,UDA10C1,1,0.31,0,1,0.0,0.31
31089,U0B9C3F,1,1600.0,0,1,0.0,1600.0
31090,U133CDF,1,0.08,0,1,0.0,0.08
31091,U620A6E,1,276.0,0,1,0.0,276.0
31092,U79FF35,1,120.0,0,1,0.0,120.0
31093,UADBEF5,1,0.02,0,1,0.0,0.02
31094,U2AC62C,1,0.13,0,1,0.0,0.13
31095,UFD9B94,1,0.01,0,1,0.0,0.01
31096,U7B8992,1,0.08,0,1,0.0,0.08
31097,UA058C2,1,-6286.7,1,0,6286.7,0.0
31098,UD5E8E7,1,667.85,0,1,0.0,667.85
31099,U633DF1,1,0.02,0,1,0.0,0.02
31100,U66FE72,1,0.17,0,1,0.0,0.17
31101,U30E103,1,-5000.0,1,0,5000.0,0.0
31102,U583928,1,-0.8,1,0,0.8,0.0
31103,U8A291C,1,185.4,0,1,0.0,185.4
31104,UE0D1E4,1,0.05,0,1,0.0,0.05
31105,U0E7B4A,1,0.03,0,1,0.0,0.03
31106,UEB459A,1,-100.0,1,0,100.0,0.0
31107,UEE41B4,1,-0.71,1,0,0.71,0.0
31108,U008474,1,0.08,0,1,0.0,0.08
31109,UEA1A50,1,0.06,0,1,0.0,0.06
31110,UFDED68,1,70.0,0,1,0.0,70.0
31111,UE43EE5,1,1.0,0,1,0.0,1.0
31112,U618AA4,1,0.11,0,1,0.0,0.11
31113,UC2DF43,1,0.07,0,1,0.0,0.07
31114,UFD1524,1,0.01,0,1,0.0,0.01
31115,UACAAE5,1,0.02,0,1,0.0,0.02
31116,U33D69C,1,0.01,0,1,0.0,0.01
31117,U26CE8E,1,-100.0,1,0,100.0,0.0
31118,U061D67,1,0.05,0,1,0.0,0.05
31119,U51DE27,1,-49.9,1,0,49.9,0.0
31120,U236468,1,-100.0,1,0,100.0,0.0
31121,UDBA16E,1,0.04,0,1,0.0,0.04
31122,UF98CF9,1,0.03,0,1,0.0,0.03
31123,U0CAAA4,1,0.01,0,1,0.0,0.01
31124,U5BFD05,1,0.15,0,1,0.0,0.15
31125,U1F59CC,1,675.0,0,1,0.0,675.0
31126,U8E07A9,1,0.05,0,1,0.0,0.05
31127,U201569,1,-150.0,1,0,150.0,0.0
31128,UBAF52E,1,0.02,0,1,0.0,0.02
31129,UBED3E7,1,0.3,0,1,0.0,0.3
31130,U55321B,1,5504.0,0,1,0.0,5504.0
31131,U0EFDD4,1,0.01,0,1,0.0,0.01
31132,UF0D1E2,1,0.07,0,1,0.0,0.07
31133,U1ACFEB,1,0.14,0,1,0.0,0.14
31134,U300C26,1,20868.0,0,1,0.0,20868.0
31135,U6A7AEB,1,0.66,0,1,0.0,0.66
31136,U331878,1,0.14,0,1,0.0,0.14
31137,UB00A0F,1,0.01,0,1,0.0,0.01
31138,U03111F,1,0.02,0,1,0.0,0.02
31139,U20FB13,1,0.94,0,1,0.0,0.94
31140,U944615,1,0.26,0,1,0.0,0.26
31141,U3EA4BF,1,0.05,0,1,0.0,0.05
31142,U12ECB3,1,700.0,0,1,0.0,700.0
31143,UD55D89,1,0.16,0,1,0.0,0.16
31144,UC09D17,1,2460.0,0,1,0.0,2460.0
31145,UCA97DD,1,0.05,0,1,0.0,0.05
31146,UF91488,1,-2111.0,1,0,2111.0,0.0
31147,UFD110F,1,0.17,0,1,0.0,0.17
31148,U730118,1,583.0,0,1,0.0,583.0
31149,U31CCE3,1,0.01,0,1,0.0,0.01
31150,UC446B3,1,0.01,0,1,0.0,0.01
31151,U282009,1,1500.0,0,1,0.0,1500.0
31152,U207520,1,1.53,0,1,0.0,1.53
31153,U116CF6,1,700.0,0,1,0.0,700.0
31154,UF8C45D,1,0.02,0,1,0.0,0.02
31155,U52A650,1,0.23,0,1,0.0,0.23
31156,U05C1D2,1,0.01,0,1,0.0,0.01
31157,UC01B37,1,222.49,0,1,0.0,222.49
31158,UA0879B,1,0.11,0,1,0.0,0.11
31159,U7C5F5A,1,0.04,0,1,0.0,0.04
31160,U7F6A94,1,0.03,0,1,0.0,0.03
31161,U7C8675,1,0.03,0,1,0.0,0.03
31162,U665854,1,2.64,0,1,0.0,2.64
31163,U10CE01,1,-300.0,1,0,300.0,0.0
31164,U5209CB,1,4.0,0,1,0.0,4.0
31165,UD3758B,1,980.0,0,1,0.0,980.0
31166,U7AFDFE,1,31.92,0,1,0.0,31.92
31167,UA6A168,1,0.01,0,1,0.0,0.01
31168,U2D4EF9,1,0.01,0,1,0.0,0.01
31169,U515389,1,-3099.8,1,0,3099.8,0.0
31170,UCC943A,1,1000.0,0,1,0.0,1000.0
31171,UAE9759,1,3.83,0,1,0.0,3.83
31172,U2BD682,1,23.0,0,1,0.0,23.0
31173,U28C813,1,0.01,0,1,0.0,0.01
31174,U85A949,1,0.07,0,1,0.0,0.07
31175,U826617,1,0.11,0,1,0.0,0.11
31176,UACB1F0,1,-0.2,1,0,0.2,0.0
31177,U272E33,1,-120.0,1,0,120.0,0.0
31178,UD19E07,1,0.48,0,1,0.0,0.48
31179,U4AD9F0,1,50.0,0,1,0.0,50.0
31180,U71DE95,1,7.51,0,1,0.0,7.51
31181,U421171,1,20.0,0,1,0.0,20.0
31182,UF4F7E3,1,-890.0,1,0,890.0,0.0
31183,UE23937,1,3000.0,0,1,0.0,3000.0
31184,U9FA726,1,0.31,0,1,0.0,0.31
31185,U1E6165,1,-150.0,1,0,150.0,0.0
31186,UC6A563,1,0.14,0,1,0.0,0.14
31187,UA38144,1,179.0,0,1,0.0,179.0
31188,UBD41B1,1,0.15,0,1,0.0,0.15
31189,UCED992,1,0.01,0,1,0.0,0.01
31190,UDA0EBD,1,4484.0,0,1,0.0,4484.0
31191,U572D72,1,0.04,0,1,0.0,0.04
31192,U7D57FA,1,-930.0,1,0,930.0,0.0
31193,U063903,1,0.01,0,1,0.0,0.01
31194,U83B93A,1,1.06,0,1,0.0,1.06
31195,U3D039C,1,102.0,0,1,0.0,102.0
31196,U6C8109,1,0.02,0,1,0.0,0.02
31197,UB52B04,1,2000.0,0,1,0.0,2000.0
31198,UD01C19,1,1000.0,0,1,0.0,1000.0
31199,UB27DC2,1,-10.0,1,0,10.0,0.0
31200,U7EEC77,1,500.0,0,1,0.0,500.0
31201,UDD7B66,1,1.37,0,1,0.0,1.37
31202,U5547DB,1,2800.0,0,1,0.0,2800.0
31203,U3A3D83,1,0.06,0,1,0.0,0.06
31204,U9767ED,1,-0.73,1,0,0.73,0.0
31205,UD1EB75,1,0.23,0,1,0.0,0.23
31206,UED20A0,1,32.55,0,1,0.0,32.55
31207,UBD0B19,1,6446.73,0,1,0.0,6446.73
31208,U9AE2A6,1,239.0,0,1,0.0,239.0
31209,U5E4ECA,1,200.0,0,1,0.0,200.0
31210,UBB9451,1,400.0,0,1,0.0,400.0
31211,UFC4880,1,1.21,0,1,0.0,1.21
31212,U7C15F5,1,0.06,0,1,0.0,0.06
31213,U5C8018,1,-2012.54,1,0,2012.54,0.0
31214,U92A929,1,50.0,0,1,0.0,50.0
31215,UDD8641,1,10900.0,0,1,0.0,10900.0
31216,U5EB1C2,1,2.12,0,1,0.0,2.12
31217,UE52323,1,-2.0,1,0,2.0,0.0
31218,U41965A,1,40.02,0,1,0.0,40.02
31219,UBDA73A,1,127.0,0,1,0.0,127.0
31220,UA0D178,1,0.05,0,1,0.0,0.05
31221,UB5E3C5,1,9000.0,0,1,0.0,9000.0
31222,U401B0B,1,6000.0,0,1,0.0,6000.0
31223,U8FA33B,1,18598.0,0,1,0.0,18598.0
31224,UD7DA6C,1,2000.0,0,1,0.0,2000.0
31225,U4BEE08,1,-2.46,1,0,2.46,0.0
31226,U56D998,1,0.02,0,1,0.0,0.02
31227,UC5AADB,1,64.2,0,1,0.0,64.2
31228,UEB612B,1,-5.0,1,0,5.0,0.0
31229,U31B92B,1,0.13,0,1,0.0,0.13
31230,U75D1C0,1,5001.0,0,1,0.0,5001.0
31231,U07E3F0,1,1.18,0,1,0.0,1.18
31232,U6AABC8,1,400.0,0,1,0.0,400.0
31233,UD4CDFB,1,0.03,0,1,0.0,0.03
31234,U517BFF,1,3000.0,0,1,0.0,3000.0
31235,U174878,1,-5.0,1,0,5.0,0.0
31236,UCE4E62,1,-100.0,1,0,100.0,0.0
31237,UA64C37,1,285.0,0,1,0.0,285.0
31238,U0DEF34,1,1.52,0,1,0.0,1.52
31239,UD479E7,1,156.0,0,1,0.0,156.0
31240,U28CEC4,1,8.16,0,1,0.0,8.16
31241,U418627,1,0.46,0,1,0.0,0.46
31242,U69E9BD,1,3.75,0,1,0.0,3.75
31243,U7DD5B7,1,-300.0,1,0,300.0,0.0
31244,UA67664,1,-5.0,1,0,5.0,0.0
31245,U02C898,1,1924.85,0,1,0.0,1924.85
31246,U27B5BF,1,0.2,0,1,0.0,0.2
31247,UE63A99,1,0.04,0,1,0.0,0.04
31248,UB200D5,1,1172.61,0,1,0.0,1172.61
31249,U3C580D,1,-300.0,1,0,300.0,0.0
31250,UAE62C8,1,10.0,0,1,0.0,10.0
31251,U9CAABE,1,12.0,0,1,0.0,12.0
31252,UD4B1B7,1,400.0,0,1,0.0,400.0
31253,U761791,1,900.0,0,1,0.0,900.0
31254,U4EE84A,1,18000.0,0,1,0.0,18000.0
31255,UCD3F95,1,400.0,0,1,0.0,400.0
31256,UA0F53B,1,0.02,0,1,0.0,0.02
31257,U0E361C,1,7100.0,0,1,0.0,7100.0
31258,U336923,1,160.0,0,1,0.0,160.0
31259,U0884F2,1,3000.0,0,1,0.0,3000.0
31260,U418F00,1,-10000.0,1,0,10000.0,0.0
31261,UA57241,1,1507.19,0,1,0.0,1507.19
31262,U059EBE,1,0.03,0,1,0.0,0.03
31263,U7DFC37,1,0.02,0,1,0.0,0.02
31264,U083767,1,200.0,0,1,0.0,200.0
31265,UCFE265,1,0.15,0,1,0.0,0.15
31266,U5B904E,1,10.41,0,1,0.0,10.41
31267,UF50DF0,1,0.06,0,1,0.0,0.06
31268,UF199F4,1,-5998.0,1,0,5998.0,0.0
31269,U0B84ED,1,-20131.21,1,0,20131.21,0.0
31270,UAD6C15,1,-15.0,1,0,15.0,0.0
31271,UA6E021,1,341.9,0,1,0.0,341.9
31272,U32A8D8,1,420.0,0,1,0.0,420.0
31273,UC7FDC0,1,100.0,0,1,0.0,100.0
31274,UEA5731,1,0.08,0,1,0.0,0.08
31275,UF280FC,1,80.68,0,1,0.0,80.68
31276,UE597B3,1,300.0,0,1,0.0,300.0
31277,UEB76B4,1,0.06,0,1,0.0,0.06
31278,UA6C653,1,256.0,0,1,0.0,256.0
31279,UAD9BBD,1,-12.0,1,0,12.0,0.0
31280,U8366E2,1,-100.0,1,0,100.0,0.0
31281,UB80E21,1,0.03,0,1,0.0,0.03
31282,U2B014B,1,1.0,0,1,0.0,1.0
31283,UD49565,1,-650.0,1,0,650.0,0.0
31284,U287613,1,0.01,0,1,0.0,0.01
31285,UC047D6,1,300.0,0,1,0.0,300.0
31286,UEF140D,1,0.02,0,1,0.0,0.02
31287,U7A3E55,1,0.43,0,1,0.0,0.43
31288,U33CEB1,1,0.01,0,1,0.0,0.01
31289,U174F89,1,0.13,0,1,0.0,0.13
31290,U48FC8E,1,0.02,0,1,0.0,0.02
31291,U36F6F5,1,0.04,0,1,0.0,0.04
31292,UAE997E,1,0.03,0,1,0.0,0.03
31293,U5093BA,1,-100.0,1,0,100.0,0.0
31294,U43BFBE,1,0.02,0,1,0.0,0.02
31295,UA00FC7,1,915.0,0,1,0.0,915.0
31296,U0E631F,1,0.4,0,1,0.0,0.4
31297,UF79F4C,1,0.07,0,1,0.0,0.07
31298,UC6C5AB,1,9.9,0,1,0.0,9.9
31299,UD3EFC7,1,0.02,0,1,0.0,0.02
31300,UB11F82,1,40.0,0,1,0.0,40.0
31301,U67FDEA,1,-12200.0,1,0,12200.0,0.0
31302,U28AA33,1,0.01,0,1,0.0,0.01
31303,U497A12,1,18.0,0,1,0.0,18.0
31304,U35D565,1,0.07,0,1,0.0,0.07
31305,U113B2F,1,20000.0,0,1,0.0,20000.0
31306,UA50FA5,1,0.12,0,1,0.0,0.12
31307,UE45501,1,100.0,0,1,0.0,100.0
31308,U5CC152,1,500.0,0,1,0.0,500.0
31309,U76F3C8,1,0.01,0,1,0.0,0.01
31310,UDA6685,1,7000.0,0,1,0.0,7000.0
31311,U9B9A2E,1,1077.0,0,1,0.0,1077.0
31312,UC64E23,1,50.0,0,1,0.0,50.0
31313,UF23016,1,-0.37,1,0,0.37,0.0
31314,U454EA7,1,0.1,0,1,0.0,0.1
31315,U76E527,1,-2498.0,1,0,2498.0,0.0
31316,U8D1212,1,0.04,0,1,0.0,0.04
31317,U8D82C2,1,0.02,0,1,0.0,0.02
31318,U26D6C8,1,1076.5,0,1,0.0,1076.5
31319,U1023D2,1,-4000.0,1,0,4000.0,0.0
31320,UC9EBAA,1,0.04,0,1,0.0,0.04
31321,UD2E744,1,-5.0,1,0,5.0,0.0
31322,U8B1220,1,99.7,0,1,0.0,99.7
31323,U532B68,1,0.02,0,1,0.0,0.02
31324,U95DCFB,1,1.49,0,1,0.0,1.49
31325,U46E487,1,-6.71,1,0,6.71,0.0
31326,UFE9524,1,10.0,0,1,0.0,10.0
31327,UD3B263,1,2278.0,0,1,0.0,2278.0
31328,U5574E0,1,150.0,0,1,0.0,150.0
31329,U242C3E,1,0.01,0,1,0.0,0.01
31330,U359789,1,-89.0,1,0,89.0,0.0
31331,UA522E1,1,0.01,0,1,0.0,0.01
31332,U001DAE,1,2500.0,0,1,0.0,2500.0
31333,UF350AD,1,0.01,0,1,0.0,0.01
31334,UD09D2E,1,0.05,0,1,0.0,0.05
31335,U752DAA,1,100.0,0,1,0.0,100.0
31336,UDBB4A2,1,8.0,0,1,0.0,8.0
31337,U7B8CA7,1,0.23,0,1,0.0,0.23
31338,U3F0BB9,1,0.02,0,1,0.0,0.02
31339,U15A225,1,-179.38,1,0,179.38,0.0
31340,U6FA546,1,2498.0,0,1,0.0,2498.0
31341,U34A127,1,0.07,0,1,0.0,0.07
31342,UD9E0D7,1,-6829.0,1,0,6829.0,0.0
31343,U4CA535,1,24.6,0,1,0.0,24.6
31344,UD924E6,1,24.9,0,1,0.0,24.9
31345,UC5B80E,1,1000.0,0,1,0.0,1000.0
31346,UC4A8A9,1,12000.0,0,1,0.0,12000.0
31347,U013F65,1,5400.0,0,1,0.0,5400.0
31348,UD665A5,1,0.03,0,1,0.0,0.03
31349,U9A1393,1,50.0,0,1,0.0,50.0
31350,UB67E38,1,0.04,0,1,0.0,0.04
31351,U7B01BF,1,2200.0,0,1,0.0,2200.0
31352,U00AFA6,1,0.01,0,1,0.0,0.01
31353,U8E1E7B,1,0.01,0,1,0.0,0.01
31354,U68D3C4,1,2000.0,0,1,0.0,2000.0
31355,UDB723C,1,100.0,0,1,0.0,100.0
31356,U96B1B4,1,5.0,0,1,0.0,5.0
31357,UD43A60,1,-20.0,1,0,20.0,0.0
31358,U4038AA,1,53.7,0,1,0.0,53.7
31359,U5D70DB,1,10.0,0,1,0.0,10.0
31360,U1E6341,1,4000.0,0,1,0.0,4000.0
31361,U5BBB03,1,0.02,0,1,0.0,0.02
31362,U99A70B,1,-2701.0,1,0,2701.0,0.0
31363,U463EAE,1,2.32,0,1,0.0,2.32
31364,U7757DE,1,13.21,0,1,0.0,13.21
31365,U0E6856,1,-60.0,1,0,60.0,0.0
31366,UC520B6,1,980.0,0,1,0.0,980.0
31367,UE46B31,1,0.02,0,1,0.0,0.02
31368,UD73069,1,2000.0,0,1,0.0,2000.0
31369,U99B174,1,-15.0,1,0,15.0,0.0
31370,UFD4213,1,-1000.0,1,0,1000.0,0.0
31371,UE257DE,1,600.0,0,1,0.0,600.0
31372,U673BDD,1,103.0,0,1,0.0,103.0
31373,U999692,1,0.01,0,1,0.0,0.01
31374,U57AD4B,1,0.08,0,1,0.0,0.08
31375,U82CD19,1,0.02,0,1,0.0,0.02
31376,U98C157,1,2300.0,0,1,0.0,2300.0
31377,U223277,1,0.01,0,1,0.0,0.01
31378,U937C27,1,100.0,0,1,0.0,100.0
31379,U136584,1,7000.0,0,1,0.0,7000.0
31380,UC9DE71,1,130.0,0,1,0.0,130.0
31381,UD4DBE5,1,-3120.0,1,0,3120.0,0.0
31382,U8FF89A,1,100.0,0,1,0.0,100.0
31383,U89EFBB,1,100.0,0,1,0.0,100.0
31384,U0A7AD7,1,-22.45,1,0,22.45,0.0
31385,U505941,1,0.36,0,1,0.0,0.36
31386,U30C09E,1,2899.74,0,1,0.0,2899.74
31387,U1CEFCF,1,-30.0,1,0,30.0,0.0
31388,UBA41CB,1,0.01,0,1,0.0,0.01
31389,U1B2E0C,1,2992.0,0,1,0.0,2992.0
31390,UEE914C,1,200.0,0,1,0.0,200.0
31391,U1B95A6,1,-501.0,1,0,501.0,0.0
31392,UE11C74,1,932.6,0,1,0.0,932.6
31393,UB2DD5B,1,0.01,0,1,0.0,0.01
31394,UEBBE3E,1,10.0,0,1,0.0,10.0
31395,U931C06,1,0.73,0,1,0.0,0.73
31396,U8DF5F3,1,0.01,0,1,0.0,0.01
31397,UAFC942,1,-600.0,1,0,600.0,0.0
31398,UEFD753,1,-56.3,1,0,56.3,0.0
31399,UAE905C,1,0.05,0,1,0.0,0.05
31400,U6E0A0A,1,-197.9,1,0,197.9,0.0
31401,U04E94C,1,2230.0,0,1,0.0,2230.0
31402,U33B094,1,0.03,0,1,0.0,0.03
31403,U0F05C3,1,0.01,0,1,0.0,0.01
31404,U9CFD6F,1,0.53,0,1,0.0,0.53
31405,UC5EE01,1,-8000.0,1,0,8000.0,0.0
31406,UE911F7,1,-100.0,1,0,100.0,0.0
31407,U237170,1,8.35,0,1,0.0,8.35
31408,UBA0010,1,0.01,0,1,0.0,0.01
31409,U5B8E3D,1,-286.58,1,0,286.58,0.0
31410,U57F4C8,1,20.0,0,1,0.0,20.0
31411,U5A907D,1,0.02,0,1,0.0,0.02
31412,U650FA1,1,500.0,0,1,0.0,500.0
31413,UE9A0B6,1,-11100.0,1,0,11100.0,0.0
31414,U8E1B1E,1,6.81,0,1,0.0,6.81
31415,UDE260A,1,0.18,0,1,0.0,0.18
31416,U25686A,1,0.35,0,1,0.0,0.35
31417,U7D0FCE,1,9.13,0,1,0.0,9.13
31418,U7A0D30,1,100.0,0,1,0.0,100.0
31419,U4A5F36,1,200.0,0,1,0.0,200.0
31420,U8C3D57,1,0.01,0,1,0.0,0.01
31421,UE5BD97,1,1.0,0,1,0.0,1.0
31422,UFA6DF5,1,7500.0,0,1,0.0,7500.0
31423,U02C45F,1,0.89,0,1,0.0,0.89
31424,U6893EA,1,50.0,0,1,0.0,50.0
31425,U6516C6,1,-149.69,1,0,149.69,0.0
31426,U99DD72,1,178.0,0,1,0.0,178.0
31427,UEF586D,1,700.0,0,1,0.0,700.0
31428,UADC79A,1,200.0,0,1,0.0,200.0
31429,UA4DA70,1,700.0,0,1,0.0,700.0
31430,UE9361F,1,97.0,0,1,0.0,97.0
31431,UBF4FB4,1,30.0,0,1,0.0,30.0
31432,UEC8535,1,0.01,0,1,0.0,0.01
31433,U76C6BC,1,-100.0,1,0,100.0,0.0
31434,UE19410,1,27.04,0,1,0.0,27.04
31435,UBC18A7,1,392.0,0,1,0.0,392.0
31436,UFB35E4,1,0.25,0,1,0.0,0.25
31437,UD973B6,1,1.0,0,1,0.0,1.0
31438,U84DD70,1,0.08,0,1,0.0,0.08
31439,U67CEA3,1,0.02,0,1,0.0,0.02
31440,UC70E30,1,0.05,0,1,0.0,0.05
31441,U9DB13B,1,600.0,0,1,0.0,600.0
31442,UD5B8FE,1,235.87,0,1,0.0,235.87
31443,UA0F804,1,0.01,0,1,0.0,0.01
31444,U7BD3BC,1,0.01,0,1,0.0,0.01
31445,UB8735B,1,0.01,0,1,0.0,0.01
31446,UCF3A23,1,94.0,0,1,0.0,94.0
31447,U7189A2,1,-100.0,1,0,100.0,0.0
31448,U44FD1C,1,500.0,0,1,0.0,500.0
31449,U7F8272,1,0.07,0,1,0.0,0.07
31450,U5FFD74,1,-60.0,1,0,60.0,0.0
31451,U2EE1F5,1,118.92,0,1,0.0,118.92
31452,U577519,1,1.79,0,1,0.0,1.79
31453,UC94BAA,1,300.0,0,1,0.0,300.0
31454,U416A19,1,0.03,0,1,0.0,0.03
31455,UE53B40,1,-100.0,1,0,100.0,0.0
31456,U53FABE,1,-119.18,1,0,119.18,0.0
31457,UDFBCD2,1,500.0,0,1,0.0,500.0
31458,UE77FA7,1,0.06,0,1,0.0,0.06
31459,UD92EAC,1,-998.0,1,0,998.0,0.0
31460,U2A8760,1,168.0,0,1,0.0,168.0
31461,U81C56C,1,10.0,0,1,0.0,10.0
31462,UFE7536,1,0.01,0,1,0.0,0.01
31463,UC7CCED,1,0.03,0,1,0.0,0.03
31464,UB32051,1,0.09,0,1,0.0,0.09
31465,UF5F2CA,1,0.61,0,1,0.0,0.61
31466,U8B3B7E,1,-250000.0,1,0,250000.0,0.0
31467,U58CEEF,1,0.04,0,1,0.0,0.04
31468,U4EB170,1,0.02,0,1,0.0,0.02
31469,UB22A9D,1,0.01,0,1,0.0,0.01
31470,U147022,1,-150.0,1,0,150.0,0.0
31471,UC090E9,1,0.03,0,1,0.0,0.03
31472,U443819,1,960.0,0,1,0.0,960.0
31473,UA3F0A3,1,2846.16,0,1,0.0,2846.16
31474,UD0C81C,1,200.0,0,1,0.0,200.0
31475,U70D550,1,186.1,0,1,0.0,186.1
31476,U7C88ED,1,0.05,0,1,0.0,0.05
31477,U4A4C9F,1,0.01,0,1,0.0,0.01
31478,U1196A3,1,20.0,0,1,0.0,20.0
31479,U6F22B3,1,2800.0,0,1,0.0,2800.0
31480,U2C0F7B,1,0.03,0,1,0.0,0.03
31481,U34578E,1,4.78,0,1,0.0,4.78
31482,UE2A15B,1,5.0,0,1,0.0,5.0
31483,UFD2659,1,0.53,0,1,0.0,0.53
31484,U6A7DAC,1,1.33,0,1,0.0,1.33
31485,UCA9D8F,1,0.06,0,1,0.0,0.06
31486,U471E18,1,570.0,0,1,0.0,570.0
31487,UFC09BF,1,1.94,0,1,0.0,1.94
31488,UF2279F,1,0.08,0,1,0.0,0.08
31489,UC03986,1,-969.0,1,0,969.0,0.0
31490,U22A76F,1,0.02,0,1,0.0,0.02
31491,U699F8A,1,22820.0,0,1,0.0,22820.0
31492,U0E8EB6,1,418.0,0,1,0.0,418.0
31493,UDCCA5E,1,200.0,0,1,0.0,200.0
31494,UC69A69,1,-0.85,1,0,0.85,0.0
31495,UE93EDA,1,-80.0,1,0,80.0,0.0
31496,U63B14C,1,0.4,0,1,0.0,0.4
31497,U9A1963,1,0.08,0,1,0.0,0.08
31498,U6CD14C,1,0.02,0,1,0.0,0.02
31499,UE08C1D,1,0.13,0,1,0.0,0.13
31500,U8799A1,1,500.0,0,1,0.0,500.0
31501,U1608AB,1,0.08,0,1,0.0,0.08
31502,U17EC92,1,-5000.0,1,0,5000.0,0.0
31503,UA2DD4C,1,0.71,0,1,0.0,0.71
31504,U260CD9,1,0.01,0,1,0.0,0.01
31505,U519A41,1,0.01,0,1,0.0,0.01
31506,UF22604,1,200.0,0,1,0.0,200.0
31507,UF1674B,1,-4018.0,1,0,4018.0,0.0
31508,U7469D8,1,0.03,0,1,0.0,0.03
31509,UA802FE,1,0.03,0,1,0.0,0.03
31510,U22907B,1,-215.0,1,0,215.0,0.0
31511,U6AA759,1,1.08,0,1,0.0,1.08
31512,UA77207,1,0.71,0,1,0.0,0.71
31513,U3D2892,1,0.07,0,1,0.0,0.07
31514,U73C5DD,1,300.0,0,1,0.0,300.0
31515,U678EB0,1,100.0,0,1,0.0,100.0
31516,U2FC08A,1,0.84,0,1,0.0,0.84
31517,U191E68,1,0.02,0,1,0.0,0.02
31518,U362E01,1,400.0,0,1,0.0,400.0
31519,UC35F88,1,0.03,0,1,0.0,0.03
31520,U10ECCC,1,1100.0,0,1,0.0,1100.0
31521,UDBA5E4,1,0.31,0,1,0.0,0.31
31522,U2F27EE,1,0.01,0,1,0.0,0.01
31523,U6DDD80,1,1000.0,0,1,0.0,1000.0
31524,UC7B9BC,1,3500.0,0,1,0.0,3500.0
31525,U402366,1,0.03,0,1,0.0,0.03
31526,U0637B5,1,0.01,0,1,0.0,0.01
31527,UA2B887,1,1.2,0,1,0.0,1.2
31528,U7AA57A,1,0.52,0,1,0.0,0.52
31529,UE8F096,1,-24.43,1,0,24.43,0.0
31530,UB1DDBD,1,0.03,0,1,0.0,0.03
31531,UC5AB8E,1,2.0,0,1,0.0,2.0
31532,U86AC21,1,45000.0,0,1,0.0,45000.0
31533,U9C5EDC,1,0.02,0,1,0.0,0.02
31534,U256313,1,-50.0,1,0,50.0,0.0
31535,UA2E992,1,-49.9,1,0,49.9,0.0
31536,U5B0112,1,0.31,0,1,0.0,0.31
31537,UB76F6C,1,0.18,0,1,0.0,0.18
31538,U88A59A,1,1700.0,0,1,0.0,1700.0
31539,UFF9EE6,1,-1.0,1,0,1.0,0.0
31540,UFAC4E3,1,-2.16,1,0,2.16,0.0
31541,U712B30,1,-300.0,1,0,300.0,0.0
31542,UD4FDBB,1,0.04,0,1,0.0,0.04
31543,UEDE54B,1,0.06,0,1,0.0,0.06
31544,UE29C6B,1,47.81,0,1,0.0,47.81
31545,UF243D5,1,0.01,0,1,0.0,0.01
31546,U27CB44,1,9.9,0,1,0.0,9.9
31547,U9E4725,1,0.02,0,1,0.0,0.02
31548,UEBDBEE,1,0.38,0,1,0.0,0.38
31549,U1A9B56,1,-5000.0,1,0,5000.0,0.0
31550,UBD0C3E,1,0.54,0,1,0.0,0.54
31551,U4A4956,1,0.04,0,1,0.0,0.04
31552,UDE15C6,1,2544.0,0,1,0.0,2544.0
31553,U128903,1,0.01,0,1,0.0,0.01
31554,U1B2F64,1,2.91,0,1,0.0,2.91
31555,UF62C6D,1,1.01,0,1,0.0,1.01
31556,U930EAC,1,-100.0,1,0,100.0,0.0
31557,U8C83C2,1,3.53,0,1,0.0,3.53
31558,UA985B6,1,0.75,0,1,0.0,0.75
31559,U401A9E,1,500.0,0,1,0.0,500.0
31560,UF1EBDA,1,0.01,0,1,0.0,0.01
31561,U6D7AFA,1,-1.0,1,0,1.0,0.0
31562,U437F8B,1,-300.0,1,0,300.0,0.0
31563,U178C51,1,0.01,0,1,0.0,0.01
31564,U63EFC6,1,0.01,0,1,0.0,0.01
31565,UDBDC17,1,-1000.0,1,0,1000.0,0.0
31566,UDD8249,1,0.04,0,1,0.0,0.04
31567,UAF8F3E,1,0.05,0,1,0.0,0.05
31568,U8F4DA7,1,0.13,0,1,0.0,0.13
31569,UE82EC0,1,24000.0,0,1,0.0,24000.0
31570,U4892F7,1,0.01,0,1,0.0,0.01
31571,UBAD147,1,0.08,0,1,0.0,0.08
31572,U962055,1,3000.0,0,1,0.0,3000.0
31573,U26F7C8,1,0.28,0,1,0.0,0.28
31574,UFD2E31,1,0.06,0,1,0.0,0.06
31575,UC87EE5,1,0.12,0,1,0.0,0.12
31576,U40531D,1,50.0,0,1,0.0,50.0
31577,U75D565,1,0.08,0,1,0.0,0.08
31578,U130CC4,1,1.28,0,1,0.0,1.28
31579,UD5B4FB,1,-3.99,1,0,3.99,0.0
31580,U164DF1,1,1.22,0,1,0.0,1.22
31581,U345141,1,0.01,0,1,0.0,0.01
31582,U2413A0,1,10.0,0,1,0.0,10.0
31583,UD9D207,1,0.01,0,1,0.0,0.01
31584,UB01F82,1,700.0,0,1,0.0,700.0
31585,UB38643,1,-4000.0,1,0,4000.0,0.0
31586,UF4A2C5,1,40300.0,0,1,0.0,40300.0
31587,U3D7EB4,1,100.0,0,1,0.0,100.0
31588,U77A791,1,0.02,0,1,0.0,0.02
31589,U97F17C,1,5.84,0,1,0.0,5.84
31590,U8671BB,1,680.0,0,1,0.0,680.0
31591,UBCEFE6,1,1530.0,0,1,0.0,1530.0
31592,UFE37E4,1,8.0,0,1,0.0,8.0
31593,U78B5EC,1,0.03,0,1,0.0,0.03
31594,U867BEE,1,-300.0,1,0,300.0,0.0
31595,U5A83C1,1,0.05,0,1,0.0,0.05
31596,UFA8EF6,1,42.35,0,1,0.0,42.35
31597,U3B7D06,1,0.01,0,1,0.0,0.01
31598,UD23740,1,0.03,0,1,0.0,0.03
31599,UC2D16D,1,-4688.0,1,0,4688.0,0.0
31600,UB44611,1,200.0,0,1,0.0,200.0
31601,U66ED6D,1,0.01,0,1,0.0,0.01
31602,U4002CF,1,-23.0,1,0,23.0,0.0
31603,U99C021,1,0.01,0,1,0.0,0.01
31604,U3FAC02,1,-0.01,1,0,0.01,0.0
31605,U402701,1,0.06,0,1,0.0,0.06
31606,U0D9392,1,51.0,0,1,0.0,51.0
31607,UF3B6A4,1,-8750.0,1,0,8750.0,0.0
31608,U9E0A86,1,130.0,0,1,0.0,130.0
31609,U792FAC,1,50.0,0,1,0.0,50.0
31610,UB8DDC5,1,0.1,0,1,0.0,0.1
31611,UA6A50C,1,0.01,0,1,0.0,0.01
31612,U4ACC9F,1,-5.0,1,0,5.0,0.0
31613,U0DD3DC,1,26.85,0,1,0.0,26.85
31614,UE600BA,1,0.04,0,1,0.0,0.04
31615,U3827F8,1,0.04,0,1,0.0,0.04
31616,U9749A5,1,0.68,0,1,0.0,0.68
31617,UBED33D,1,-5000.0,1,0,5000.0,0.0
31618,U7CCDD3,1,100.0,0,1,0.0,100.0
31619,U7BF070,1,0.05,0,1,0.0,0.05
31620,U62F356,1,153.0,0,1,0.0,153.0
31621,UC15F83,1,1.0,0,1,0.0,1.0
31622,U7514B2,1,10.0,0,1,0.0,10.0
31623,U3C8C31,1,-5.0,1,0,5.0,0.0
31624,UF72871,1,6000.0,0,1,0.0,6000.0
31625,UE88A97,1,-5.0,1,0,5.0,0.0
31626,UB27548,1,0.04,0,1,0.0,0.04
31627,UE276EF,1,1.71,0,1,0.0,1.71
31628,U4661D0,1,0.01,0,1,0.0,0.01
31629,UB4A7E1,1,200.0,0,1,0.0,200.0
31630,UC75B75,1,0.07,0,1,0.0,0.07
31631,U2CE1E5,1,30.0,0,1,0.0,30.0
31632,U79D772,1,100.0,0,1,0.0,100.0
31633,U0FEF16,1,0.04,0,1,0.0,0.04
31634,UC98C01,1,1.13,0,1,0.0,1.13
31635,U614C76,1,0.38,0,1,0.0,0.38
31636,U833AAD,1,-120.0,1,0,120.0,0.0
31637,UFF6E2F,1,2709.0,0,1,0.0,2709.0
31638,UF23DEC,1,100.0,0,1,0.0,100.0
31639,U7FA5F5,1,-0.13,1,0,0.13,0.0
31640,U6A9268,1,60.0,0,1,0.0,60.0
31641,U422214,1,11.0,0,1,0.0,11.0
31642,UE65E56,1,0.15,0,1,0.0,0.15
31643,U764B02,1,0.03,0,1,0.0,0.03
31644,UF6C69A,1,-169.0,1,0,169.0,0.0
31645,U076762,1,9.9,0,1,0.0,9.9
31646,UE5D8D8,1,-2.0,1,0,2.0,0.0
31647,UD1F11F,1,0.01,0,1,0.0,0.01
31648,UF7B0B8,1,0.03,0,1,0.0,0.03
31649,UF2A9C4,1,26.24,0,1,0.0,26.24
31650,U70BA83,1,630.0,0,1,0.0,630.0
31651,UFC99B7,1,0.01,0,1,0.0,0.01
31652,UAB12BB,1,0.01,0,1,0.0,0.01
31653,U42EBDF,1,1500.0,0,1,0.0,1500.0
31654,UEC6E2C,1,31.41,0,1,0.0,31.41
31655,U9193B9,1,1.94,0,1,0.0,1.94
31656,U2E2167,1,437.26,0,1,0.0,437.26
31657,UF44EFE,1,10.0,0,1,0.0,10.0
31658,U70050A,1,14.81,0,1,0.0,14.81
31659,U8FC8DC,1,53.97,0,1,0.0,53.97
31660,U521A63,1,-100.0,1,0,100.0,0.0
31661,UFAA779,1,300.0,0,1,0.0,300.0
31662,UA14960,1,1400.0,0,1,0.0,1400.0
31663,U909AE0,1,0.15,0,1,0.0,0.15
31664,UE128BB,1,0.04,0,1,0.0,0.04
31665,U9D709E,1,0.01,0,1,0.0,0.01
31666,U5CCD02,1,7.07,0,1,0.0,7.07
31667,UAEAB13,1,-6288.0,1,0,6288.0,0.0
31668,UA7D3EA,1,111.19,0,1,0.0,111.19
31669,UFB698B,1,0.07,0,1,0.0,0.07
31670,U7C41DC,1,170.0,0,1,0.0,170.0
31671,U05DF33,1,56.78,0,1,0.0,56.78
31672,UDD14A3,1,5.0,0,1,0.0,5.0
31673,UAA9020,1,-97.54,1,0,97.54,0.0
31674,U9CDE52,1,0.04,0,1,0.0,0.04
31675,U3B05E6,1,0.01,0,1,0.0,0.01
31676,U963128,1,-3000.0,1,0,3000.0,0.0
31677,U7CE51F,1,0.01,0,1,0.0,0.01
31678,U027679,1,0.01,0,1,0.0,0.01
31679,UE91A9D,1,0.01,0,1,0.0,0.01
31680,UC00DA3,1,0.01,0,1,0.0,0.01
31681,U33D847,1,-100.0,1,0,100.0,0.0
31682,UE8451C,1,280.0,0,1,0.0,280.0
31683,UDA17D2,1,0.87,0,1,0.0,0.87
31684,UAAB43F,1,-14.9,1,0,14.9,0.0
31685,U15C39C,1,0.01,0,1,0.0,0.01
31686,U155A55,1,0.02,0,1,0.0,0.02
31687,U9764A6,1,-100.0,1,0,100.0,0.0
31688,U4D9E03,1,0.02,0,1,0.0,0.02
31689,UC4D8A2,1,2.19,0,1,0.0,2.19
31690,UB2F379,1,0.06,0,1,0.0,0.06
31691,U5227AE,1,10.0,0,1,0.0,10.0
31692,UF19E35,1,-1363.5,1,0,1363.5,0.0
31693,UCFE88C,1,0.01,0,1,0.0,0.01
31694,U4DC6D4,1,17.08,0,1,0.0,17.08
31695,U0989E5,1,7000.0,0,1,0.0,7000.0
31696,U9E81FA,1,330.0,0,1,0.0,330.0
31697,U72ACE5,1,1000.0,0,1,0.0,1000.0
31698,U808AB1,1,0.02,0,1,0.0,0.02
31699,U0AF220,1,127.46,0,1,0.0,127.46
31700,UA06AD3,1,1000.0,0,1,0.0,1000.0
31701,UCDC173,1,0.01,0,1,0.0,0.01
31702,UD6799E,1,0.01,0,1,0.0,0.01
31703,U94889C,1,0.04,0,1,0.0,0.04
31704,UA2B1CE,1,-39.5,1,0,39.5,0.0
31705,UB4130C,1,0.03,0,1,0.0,0.03
31706,U334FDA,1,0.17,0,1,0.0,0.17
31707,U37EC4A,1,-15.7,1,0,15.7,0.0
31708,U01979F,1,0.1,0,1,0.0,0.1
31709,UA9A3F8,1,-1315.0,1,0,1315.0,0.0
31710,U7DB4F2,1,0.77,0,1,0.0,0.77
31711,UD701EC,1,17875.0,0,1,0.0,17875.0
31712,U8E8235,1,0.01,0,1,0.0,0.01
31713,UC98DE9,1,-2900.0,1,0,2900.0,0.0
31714,U94DCA7,1,0.22,0,1,0.0,0.22
31715,U78B029,1,14.0,0,1,0.0,14.0
31716,UE26FF3,1,39.99,0,1,0.0,39.99
31717,U05A8DB,1,-46.2,1,0,46.2,0.0
31718,UC413EA,1,1000.0,0,1,0.0,1000.0
31719,U20980B,1,380.0,0,1,0.0,380.0
31720,UD6400A,1,0.29,0,1,0.0,0.29
31721,UC2057F,1,0.02,0,1,0.0,0.02
31722,U392FE4,1,0.45,0,1,0.0,0.45
31723,U1007A5,1,600.0,0,1,0.0,600.0
31724,U819A70,1,-0.07,1,0,0.07,0.0
31725,U38877D,1,1.28,0,1,0.0,1.28
31726,UE2F2F5,1,0.02,0,1,0.0,0.02
31727,UB8EA79,1,-100.0,1,0,100.0,0.0
31728,UB01C1F,1,0.01,0,1,0.0,0.01
31729,U53AAB3,1,215.0,0,1,0.0,215.0
31730,UB69315,1,540.0,0,1,0.0,540.0
31731,U13D5EC,1,1.14,0,1,0.0,1.14
31732,U3B7F54,1,-15.0,1,0,15.0,0.0
31733,UA5D016,1,0.02,0,1,0.0,0.02
31734,UD2EFF0,1,-26.31,1,0,26.31,0.0
31735,U77B113,1,-5212.39,1,0,5212.39,0.0
31736,U114373,1,1001.03,0,1,0.0,1001.03
31737,U992D56,1,0.01,0,1,0.0,0.01
31738,UDA2937,1,0.4,0,1,0.0,0.4
31739,U792737,1,-30.0,1,0,30.0,0.0
31740,U09A81E,1,100.0,0,1,0.0,100.0
31741,U63A33B,1,281.98,0,1,0.0,281.98
31742,UC69D90,1,3150.0,0,1,0.0,3150.0
31743,U3A24A6,1,0.77,0,1,0.0,0.77
31744,UBBC344,1,30.0,0,1,0.0,30.0
31745,UCFC25C,1,0.01,0,1,0.0,0.01
31746,U19D582,1,0.04,0,1,0.0,0.04
31747,U086D18,1,0.01,0,1,0.0,0.01
31748,UC65B52,1,600.0,0,1,0.0,600.0
31749,U7B4487,1,0.1,0,1,0.0,0.1
31750,UE86DED,1,-300.0,1,0,300.0,0.0
31751,U649F72,1,100.0,0,1,0.0,100.0
31752,UE20C64,1,500.0,0,1,0.0,500.0
31753,UD4B363,1,7999.0,0,1,0.0,7999.0
31754,U8AB83D,1,0.02,0,1,0.0,0.02
31755,U3EDE43,1,-100.0,1,0,100.0,0.0
31756,UC46454,1,515.2,0,1,0.0,515.2
31757,U9DCAA9,1,0.11,0,1,0.0,0.11
31758,U5BAD48,1,-200.0,1,0,200.0,0.0
31759,U9479D4,1,790.0,0,1,0.0,790.0
31760,U0FBB36,1,3300.0,0,1,0.0,3300.0
31761,UBB0D6B,1,-14.9,1,0,14.9,0.0
31762,UD98760,1,0.27,0,1,0.0,0.27
31763,U3D64F4,1,0.07,0,1,0.0,0.07
31764,UBB56D6,1,0.01,0,1,0.0,0.01
31765,U327809,1,0.01,0,1,0.0,0.01
31766,U3C9082,1,0.01,0,1,0.0,0.01
31767,UA1F5B6,1,4.24,0,1,0.0,4.24
31768,UA1F013,1,-68.68,1,0,68.68,0.0
31769,U0DF3BF,1,10000.0,0,1,0.0,10000.0
31770,U7C7317,1,0.02,0,1,0.0,0.02
31771,UA915B7,1,78.0,0,1,0.0,78.0
31772,U927C0D,1,2976.32,0,1,0.0,2976.32
31773,U04696B,1,0.01,0,1,0.0,0.01
31774,U9CC011,1,0.07,0,1,0.0,0.07
31775,U3D8658,1,0.04,0,1,0.0,0.04
31776,U6CE554,1,-168.0,1,0,168.0,0.0
31777,UB953C5,1,1.46,0,1,0.0,1.46
31778,U089CA7,1,0.06,0,1,0.0,0.06
31779,U248366,1,0.01,0,1,0.0,0.01
31780,U61D2A7,1,0.02,0,1,0.0,0.02
31781,UE23097,1,-1.0,1,0,1.0,0.0
31782,UEAA120,1,2740.78,0,1,0.0,2740.78
31783,UF457A7,1,-300.0,1,0,300.0,0.0
31784,UF0BDD8,1,-0.5,1,0,0.5,0.0
31785,UA6A37D,1,1700.0,0,1,0.0,1700.0
31786,UFC7C12,1,0.08,0,1,0.0,0.08
31787,U32627D,1,0.02,0,1,0.0,0.02
31788,U9F22CB,1,170.0,0,1,0.0,170.0
31789,UCB99B7,1,-1.97,1,0,1.97,0.0
31790,U175EBF,1,300.0,0,1,0.0,300.0
31791,U1296B2,1,0.03,0,1,0.0,0.03
31792,UE1297A,1,4200.0,0,1,0.0,4200.0
31793,U236E05,1,4.23,0,1,0.0,4.23
31794,UEC36BE,1,280.93,0,1,0.0,280.93
31795,UA97DD0,1,0.25,0,1,0.0,0.25
31796,UF28741,1,0.01,0,1,0.0,0.01
31797,UA451D9,1,-10000.0,1,0,10000.0,0.0
31798,U87410B,1,1000.0,0,1,0.0,1000.0
31799,UE7CEB2,1,0.05,0,1,0.0,0.05
31800,UF591F3,1,0.02,0,1,0.0,0.02
31801,U298295,1,207.0,0,1,0.0,207.0
31802,UFD1BCE,1,0.15,0,1,0.0,0.15
31803,U08961C,1,-601.64,1,0,601.64,0.0
31804,U9542EB,1,0.03,0,1,0.0,0.03
31805,U3BC7D6,1,0.01,0,1,0.0,0.01
31806,UDCE500,1,300.0,0,1,0.0,300.0
31807,U52A9D4,1,362.0,0,1,0.0,362.0
31808,U527A2A,1,0.02,0,1,0.0,0.02
31809,UF923D6,1,0.04,0,1,0.0,0.04
31810,UE19D57,1,16.0,0,1,0.0,16.0
31811,U3F40C9,1,50.96,0,1,0.0,50.96
31812,UD90197,1,50.0,0,1,0.0,50.0
31813,U917427,1,200.0,0,1,0.0,200.0
31814,U7BD394,1,0.68,0,1,0.0,0.68
31815,UAE21F7,1,0.77,0,1,0.0,0.77
31816,U71A616,1,124.0,0,1,0.0,124.0
31817,U008FD5,1,0.08,0,1,0.0,0.08
31818,U6448B8,1,34.9,0,1,0.0,34.9
31819,UCC1BE8,1,-50.0,1,0,50.0,0.0
31820,UE78754,1,-200.0,1,0,200.0,0.0
31821,U2EC5AA,1,0.35,0,1,0.0,0.35
31822,UC12545,1,180.0,0,1,0.0,180.0
31823,U58A992,1,300.0,0,1,0.0,300.0
31824,U151300,1,500.0,0,1,0.0,500.0
31825,U5A2679,1,-86.8,1,0,86.8,0.0
31826,UAB5364,1,0.01,0,1,0.0,0.01
31827,UF27FFA,1,-90.0,1,0,90.0,0.0
31828,UABCFD2,1,-5.0,1,0,5.0,0.0
31829,UD3E7D6,1,0.47,0,1,0.0,0.47
31830,U251355,1,-37.5,1,0,37.5,0.0
31831,U8D52B5,1,0.02,0,1,0.0,0.02
31832,UFDA97A,1,0.09,0,1,0.0,0.09
31833,UAFE670,1,99294.07,0,1,0.0,99294.07
31834,UE97D8D,1,3030.59,0,1,0.0,3030.59
31835,U8CAFD2,1,1798.0,0,1,0.0,1798.0
31836,U6DEB23,1,0.01,0,1,0.0,0.01
31837,U5384A7,1,4.16,0,1,0.0,4.16
31838,UA235A7,1,-42.0,1,0,42.0,0.0
31839,U9DFF4E,1,0.25,0,1,0.0,0.25
31840,U41C12C,1,0.02,0,1,0.0,0.02
31841,UA9725A,1,0.08,0,1,0.0,0.08
31842,U252DD4,1,9000.0,0,1,0.0,9000.0
31843,UA4757C,1,1490.78,0,1,0.0,1490.78
31844,U65347C,1,3500.0,0,1,0.0,3500.0
31845,U375B53,1,0.06,0,1,0.0,0.06
31846,UBB8477,1,-0.04,1,0,0.04,0.0
31847,UD0BB4E,1,-1283.0,1,0,1283.0,0.0
31848,UF54210,1,300.0,0,1,0.0,300.0
31849,UC29C4D,1,10.0,0,1,0.0,10.0
31850,U0A3866,1,-5.0,1,0,5.0,0.0
31851,U9A8F06,1,0.11,0,1,0.0,0.11
31852,UDFCC55,1,0.08,0,1,0.0,0.08
31853,U255E76,1,0.12,0,1,0.0,0.12
31854,UEFE35D,1,1198.53,0,1,0.0,1198.53
31855,UED6D36,1,0.04,0,1,0.0,0.04
31856,U41CB35,1,-300.0,1,0,300.0,0.0
31857,UE73E03,1,0.07,0,1,0.0,0.07
31858,U1C4330,1,0.15,0,1,0.0,0.15
31859,U61DB4F,1,1000.0,0,1,0.0,1000.0
31860,U2E3838,1,0.08,0,1,0.0,0.08
31861,UA1D4A3,1,0.07,0,1,0.0,0.07
31862,U5B18C7,1,0.02,0,1,0.0,0.02
31863,UF75D1F,1,12.8,0,1,0.0,12.8
31864,UAADB2D,1,-3022.12,1,0,3022.12,0.0
31865,U034B31,1,0.03,0,1,0.0,0.03
31866,UAE2FB3,1,686.0,0,1,0.0,686.0
31867,U8FC359,1,-1.5,1,0,1.5,0.0
31868,U603B49,1,-100.0,1,0,100.0,0.0
31869,UFEAB65,1,0.06,0,1,0.0,0.06
31870,UE078F7,1,0.03,0,1,0.0,0.03
31871,UA75B93,1,0.04,0,1,0.0,0.04
31872,U92E25F,1,0.04,0,1,0.0,0.04
31873,UCE6CC3,1,-100.0,1,0,100.0,0.0
31874,U1C3DE8,1,0.01,0,1,0.0,0.01
31875,U4250CD,1,-100.0,1,0,100.0,0.0
31876,U4DA53C,1,0.05,0,1,0.0,0.05
31877,U1E3C6D,1,500.0,0,1,0.0,500.0
31878,U0D63F9,1,0.01,0,1,0.0,0.01
31879,UF87C71,1,1600.0,0,1,0.0,1600.0
31880,UF5A2CE,1,20.0,0,1,0.0,20.0
31881,UCC838D,1,100.0,0,1,0.0,100.0
31882,U5927F8,1,450.0,0,1,0.0,450.0
31883,U124176,1,150.14,0,1,0.0,150.14
31884,U8B5460,1,3.0,0,1,0.0,3.0
31885,U38560D,1,0.05,0,1,0.0,0.05
31886,UB9D89E,1,100.0,0,1,0.0,100.0
31887,UDF0867,1,0.39,0,1,0.0,0.39
31888,U496BDB,1,0.01,0,1,0.0,0.01
31889,U643AE6,1,-15.0,1,0,15.0,0.0
31890,UF08C38,1,0.06,0,1,0.0,0.06
31891,U5E1C66,1,0.77,0,1,0.0,0.77
31892,UEB469B,1,1.92,0,1,0.0,1.92
31893,U1A1C9A,1,0.04,0,1,0.0,0.04
31894,UEBACDD,1,100.0,0,1,0.0,100.0
31895,U0A586E,1,-765.0,1,0,765.0,0.0
31896,UCE7EAE,1,100.0,0,1,0.0,100.0
31897,U8F4ECB,1,10850.0,0,1,0.0,10850.0
31898,U99F46F,1,0.05,0,1,0.0,0.05
31899,U41238A,1,205.0,0,1,0.0,205.0
31900,UA258F0,1,4.31,0,1,0.0,4.31
31901,U7F3554,1,55.43,0,1,0.0,55.43
31902,UC84612,1,0.14,0,1,0.0,0.14
31903,U5C0AFE,1,0.01,0,1,0.0,0.01
31904,UF482C7,1,-128.0,1,0,128.0,0.0
31905,U6B7807,1,28.0,0,1,0.0,28.0
31906,UEEFFA7,1,0.29,0,1,0.0,0.29
31907,UFB44F8,1,0.01,0,1,0.0,0.01
31908,U2D81B4,1,3200.0,0,1,0.0,3200.0
31909,U4A5C9B,1,-24213.0,1,0,24213.0,0.0
31910,U532AAD,1,1.47,0,1,0.0,1.47
31911,UE4C29B,1,1.0,0,1,0.0,1.0
31912,U0F3CB1,1,-300.0,1,0,300.0,0.0
31913,U9E795E,1,2500.0,0,1,0.0,2500.0
31914,U88E399,1,0.16,0,1,0.0,0.16
31915,U28655F,1,0.01,0,1,0.0,0.01
31916,U7AB672,1,-100.0,1,0,100.0,0.0
31917,U980A16,1,0.01,0,1,0.0,0.01
31918,U6609CA,1,5374.16,0,1,0.0,5374.16
31919,UEAF0D1,1,-2900.0,1,0,2900.0,0.0
31920,U2533C0,1,0.04,0,1,0.0,0.04
31921,U833886,1,-2998.0,1,0,2998.0,0.0
31922,UBFDC3B,1,0.02,0,1,0.0,0.02
31923,U40F83A,1,8018.0,0,1,0.0,8018.0
31924,U0A8311,1,0.01,0,1,0.0,0.01
31925,U89A3BF,1,2.92,0,1,0.0,2.92
31926,UF35319,1,0.02,0,1,0.0,0.02
31927,U016D6D,1,0.02,0,1,0.0,0.02
31928,UF12AB3,1,20.0,0,1,0.0,20.0
31929,U27FFB2,1,0.01,0,1,0.0,0.01
31930,U4D4EC7,1,20000.0,0,1,0.0,20000.0
31931,UF1A376,1,-59.0,1,0,59.0,0.0
31932,U06F8B5,1,0.01,0,1,0.0,0.01
31933,U80BC90,1,0.03,0,1,0.0,0.03
31934,U0ABD48,1,-4.33,1,0,4.33,0.0
31935,U2A127D,1,207.0,0,1,0.0,207.0
31936,U98D93D,1,15.0,0,1,0.0,15.0
31937,U74574E,1,0.01,0,1,0.0,0.01
31938,UFA5FF0,1,0.78,0,1,0.0,0.78
31939,U3B5A55,1,0.02,0,1,0.0,0.02
31940,UC3D67D,1,0.03,0,1,0.0,0.03
31941,U4C977B,1,0.16,0,1,0.0,0.16
31942,UCB0F38,1,800.0,0,1,0.0,800.0
31943,UFC726B,1,-5265.0,1,0,5265.0,0.0
31944,UC28B76,1,-5.0,1,0,5.0,0.0
31945,UC14B0C,1,382.0,0,1,0.0,382.0
31946,UEE8D70,1,0.1,0,1,0.0,0.1
31947,U221892,1,100.0,0,1,0.0,100.0
31948,UF1B5E9,1,26.0,0,1,0.0,26.0
31949,U396095,1,2726.5,0,1,0.0,2726.5
31950,U2C7DEB,1,50.0,0,1,0.0,50.0
31951,UCA3BB4,1,-100.0,1,0,100.0,0.0
31952,U3A2A17,1,-8000.0,1,0,8000.0,0.0
31953,UF196F0,1,4000.0,0,1,0.0,4000.0
31954,U7AC410,1,2176.0,0,1,0.0,2176.0
31955,U3242E1,1,8500.0,0,1,0.0,8500.0
31956,U3B4CF6,1,0.01,0,1,0.0,0.01
31957,UAB8174,1,0.04,0,1,0.0,0.04
31958,UFD7966,1,108.75,0,1,0.0,108.75
31959,UC153B0,1,0.01,0,1,0.0,0.01
31960,U20C7A9,1,-5314.2,1,0,5314.2,0.0
31961,U9A3BF2,1,268.8,0,1,0.0,268.8
31962,U6FC315,1,0.14,0,1,0.0,0.14
31963,UEB70F6,1,0.29,0,1,0.0,0.29
31964,U04A3AB,1,0.01,0,1,0.0,0.01
31965,UDB999F,1,0.03,0,1,0.0,0.03
31966,U3E3917,1,0.07,0,1,0.0,0.07
31967,U7A6272,1,9500.0,0,1,0.0,9500.0
31968,UAC5466,1,0.01,0,1,0.0,0.01
31969,UE5B566,1,2500.0,0,1,0.0,2500.0
31970,UB0318D,1,0.04,0,1,0.0,0.04
31971,UBF9D95,1,-249.88,1,0,249.88,0.0
31972,U85381D,1,0.01,0,1,0.0,0.01
31973,UF3ED65,1,0.02,0,1,0.0,0.02
31974,UF9B820,1,-3282.0,1,0,3282.0,0.0
31975,U6EBFD7,1,1200.0,0,1,0.0,1200.0
31976,UD16DF3,1,6.4,0,1,0.0,6.4
31977,UD56131,1,1.48,0,1,0.0,1.48
31978,U98C582,1,0.46,0,1,0.0,0.46
31979,U34DB88,1,500.0,0,1,0.0,500.0
31980,U7BDC19,1,0.02,0,1,0.0,0.02
31981,UF47AAB,1,0.02,0,1,0.0,0.02
31982,U6922A8,1,2600.0,0,1,0.0,2600.0
31983,U11D847,1,0.01,0,1,0.0,0.01
31984,UE60113,1,200.0,0,1,0.0,200.0
31985,U3B83FA,1,0.01,0,1,0.0,0.01
31986,U883669,1,-4000.0,1,0,4000.0,0.0
31987,U585BEF,1,-6000.0,1,0,6000.0,0.0
31988,U0FB42D,1,4.8,0,1,0.0,4.8
31989,U802EEF,1,0.04,0,1,0.0,0.04
31990,U0E3E25,1,-120.0,1,0,120.0,0.0
31991,U74C352,1,0.06,0,1,0.0,0.06
31992,U0D5A4C,1,2.0,0,1,0.0,2.0
